_id,accountNumber,balance,bankAccountId,bankName,category,companyId,date,description,merchantCategory,summary,transactionChannel,transactionValue
61b6f5bad8beac1599eae0e6,50200023535069,620898.46,60ec41ba55c00300382672d9,HDFC,direct expenses,5eecc6d6449e4f7cfb1c2708,2020-04-01T00:00:00.000Z,POS 514834XXXXXX9486 SEOPTIMER,,,debit_card,-2184.8
61b6f5bbd8beac1599eae0ec,50200023535069,610898.46,60ec41ba55c00300382672d9,HDFC,Marketing Expense,5eecc6d6449e4f7cfb1c2708,2020-04-01T00:00:00.000Z,POS 514834XXXXXX9486 GOOGLE INDIA PVT,,,debit_card,-10000
61b6f5bcd8beac1599eae0f4,50200023535069,469298.46,60ec41ba55c00300382672d9,HDFC,direct expenses,5eecc6d6449e4f7cfb1c2708,2020-04-01T00:00:00.000Z,57500000443889-TPT-141600-WEBKLIPPER TEC HNOLOGIES PRIVATE LIMITED,,,net_banking_transfer,-141600
61b6f5bdd8beac1599eae0f9,50200023535069,469829.41,60ec41ba55c00300382672d9,HDFC,Revenue-COD,5eecc6d6449e4f7cfb1c2708,2020-04-02T00:00:00.000Z,NEFT CR-KKBK0000958-BIGFOOT RETAIL SOLUT IONS PRIVATE LIMITED-SLICK ORGANICS PVT LTD-KKBK200931794956,,,net_banking_transfer,530.95
61b6f5bed8beac1599eae10c,50200023535069,492329.41,60ec41ba55c00300382672d9,HDFC,cash/cheque deposit/transfer in,5eecc6d6449e4f7cfb1c2708,2020-04-02T00:00:00.000Z,CASH DEP LAKE AVENUE,,,cash_deposit,22500
61b6f5bfd8beac1599eae12d,50200023535069,482905.6,60ec41ba55c00300382672d9,HDFC,direct expenses,5eecc6d6449e4f7cfb1c2708,2020-04-02T00:00:00.000Z,POS 514834XXXXXX9486 STK*SHUTTERSTOCK,,,debit_card,-9423.81
61b6f5c0d8beac1599eae137,50200023535069,478186.78,60ec41ba55c00300382672d9,HDFC,direct expenses,5eecc6d6449e4f7cfb1c2708,2020-04-02T00:00:00.000Z,POS 514834XXXXXX4081 ONLINE PAYMENT,,,debit_card,-4718.82
61b6f5c1d8beac1599eae140,50200023535069,453186.78,60ec41ba55c00300382672d9,HDFC,direct expenses,5eecc6d6449e4f7cfb1c2708,2020-04-02T00:00:00.000Z,POS 514834XXXXXX9486 BIGFOOT RETAIL S,,,debit_card,-25000
61b6f5c2d8beac1599eae146,50200023535069,953186.78,60ec41ba55c00300382672d9,HDFC,Investments-New,5eecc6d6449e4f7cfb1c2708,2020-04-03T00:00:00.000Z,50100216436008-TPT-LOAN SLICK ORGANICS P VT LTD DHRUV MADHOK-DHRUV MADHOK,loans,lender_transaction,net_banking_transfer,500000
61b6f5c3d8beac1599eae151,50200023535069,961468.24,60ec41ba55c00300382672d9,HDFC,Revenue-PG-split enabled,5eecc6d6449e4f7cfb1c2708,2020-04-03T00:00:00.000Z,NEFT CR-UTIB0001506-RAZORPAY SOFTWARE PR IVATE LIMITED-SLICK ORGANICS PVT LITD-AX ISCN0049904169,investments,,net_banking_transfer,8281.46
61b6f5c4d8beac1599eae159,50200023535069,811468.24,60ec41ba55c00300382672d9,HDFC,direct expenses,5eecc6d6449e4f7cfb1c2708,2020-04-03T00:00:00.000Z,"NEFT DR-SCBL0036025-DHRUV MADHOK-NETBANK , MUM-N094201109102051-150000",,,net_banking_transfer,-150000
61b6f5c5d8beac1599eae162,50200023535069,661468.24,60ec41ba55c00300382672d9,HDFC,direct expenses,5eecc6d6449e4f7cfb1c2708,2020-04-03T00:00:00.000Z,"NEFT DR-ICIC0003430-HASHTAG ORANGE ADVER TISING PVT LTD-NETBANK, MUM-N09420110942 7430-150000",,,net_banking_transfer,-150000
61b6f5c6d8beac1599eae16a,50200023535069,660825.09,60ec41ba55c00300382672d9,HDFC,Refund,5eecc6d6449e4f7cfb1c2708,2020-04-03T00:00:00.000Z,"NEFT DR-UTIB0003614-SHEIKH TAHIR AHMAD-N ETBANK, MUM-N094201109459192-REFUND",,,net_banking_transfer,-643.15
61b6f5c7d8beac1599eae16c,50200023535069,565826.09,60ec41ba55c00300382672d9,HDFC,direct expenses,5eecc6d6449e4f7cfb1c2708,2020-04-03T00:00:00.000Z,"NEFT DR-ICIC0000071-VIKAS MAURYA-NETBANK , MUM-N094201109704797-94999",,,net_banking_transfer,-94999
61b6f5c8d8beac1599eae170,50200023535069,565696.65,60ec41ba55c00300382672d9,HDFC,bank charges,5eecc6d6449e4f7cfb1c2708,2020-04-03T00:00:00.000Z,DEBIT CARD PUR ADJ DT 02/04/20,,,Other,-129.44
61b6f5c9d8beac1599eae197,50200023535069,566130.85,60ec41ba55c00300382672d9,HDFC,Revenue-PG-split enabled,5eecc6d6449e4f7cfb1c2708,2020-04-04T00:00:00.000Z,NEFT CR-UTIB0001506-RAZORPAY SOFTWARE PR IVATE LIMITED-SLICK ORGANICS PVT LITD-AX ISCN0049938716,investments,,net_banking_transfer,434.2
61b6f5cad8beac1599eae19c,50200023535069,1066130.85,60ec41ba55c00300382672d9,HDFC,Investments-New,5eecc6d6449e4f7cfb1c2708,2020-04-04T00:00:00.000Z,50100216436008-TPT-DHRUV MADHOK LOAN SOP,loans,lender_transaction,net_banking_transfer,500000
61b6f5cad8beac1599eae1a1,50200023535069,1041130.85,60ec41ba55c00300382672d9,HDFC,direct expenses,5eecc6d6449e4f7cfb1c2708,2020-04-05T00:00:00.000Z,50100180684854-TPT-25000-RAJAT KHULLAR,,,net_banking_transfer,-25000
61b6f5cbd8beac1599eae1a9,50200023535069,1004130.85,60ec41ba55c00300382672d9,HDFC,direct expenses,5eecc6d6449e4f7cfb1c2708,2020-04-07T00:00:00.000Z,"NEFT DR-CITI0000002-DHIRAJ-NETBANK, MUM- N098201111615759-37000",,,net_banking_transfer,-37000
61b6f5ccd8beac1599eae1ab,50200023535069,969130.85,60ec41ba55c00300382672d9,HDFC,direct expenses,5eecc6d6449e4f7cfb1c2708,2020-04-07T00:00:00.000Z,"NEFT DR-ICIC0000542-AVANTIKA SUKHIA-NETB ANK, MUM-N098201111620817-35000",,,net_banking_transfer,-35000
61b6f5cdd8beac1599eae1b2,50200023535069,961630.85,60ec41ba55c00300382672d9,HDFC,direct expenses,5eecc6d6449e4f7cfb1c2708,2020-04-07T00:00:00.000Z,"NEFT DR-SIBL0000555-JAIVEER KUMAR-NETBAN K, MUM-N098201111625998-7500",,,net_banking_transfer,-7500
61b6f5ced8beac1599eae1ba,50200023535069,956630.85,60ec41ba55c00300382672d9,HDFC,direct expenses,5eecc6d6449e4f7cfb1c2708,2020-04-07T00:00:00.000Z,"NEFT DR-PUNB0398000-MEENA SINGH-NETBANK, MUM-N098201111616554-5000",,,net_banking_transfer,-5000
61b6f5cfd8beac1599eae1bf,50200023535069,946630.85,60ec41ba55c00300382672d9,HDFC,direct expenses,5eecc6d6449e4f7cfb1c2708,2020-04-07T00:00:00.000Z,"NEFT DR-SBIN0001189-SANDEEP SINGH-NETBAN K, MUM-N098201111627674-10000",,,net_banking_transfer,-10000
61b6f5d0d8beac1599eae1c6,50200023535069,938380.85,60ec41ba55c00300382672d9,HDFC,direct expenses,5eecc6d6449e4f7cfb1c2708,2020-04-07T00:00:00.000Z,"NEFT DR-KKBK0000811-NASIR KHAN-NETBANK, MUM-N098201111584505-8250",,,net_banking_transfer,-8250
61b6f5d1d8beac1599eae1cb,50200023535069,920880.85,60ec41ba55c00300382672d9,HDFC,direct expenses,5eecc6d6449e4f7cfb1c2708,2020-04-07T00:00:00.000Z,"NEFT DR-ICIC0003374-SIDDHARTH KANOJIA-NE TBANK, MUM-N098201111617244-17500",,,net_banking_transfer,-17500
61b6f5d2d8beac1599eae1d3,50200023535069,917880.85,60ec41ba55c00300382672d9,HDFC,direct expenses,5eecc6d6449e4f7cfb1c2708,2020-04-07T00:00:00.000Z,"NEFT DR-ALLA0210591-CHAMPA DEVI-NETBANK, MUM-N098201111617349-3000",,,net_banking_transfer,-3000
61b6f5d3d8beac1599eae1d9,50200023535069,885380.85,60ec41ba55c00300382672d9,HDFC,direct expenses,5eecc6d6449e4f7cfb1c2708,2020-04-07T00:00:00.000Z,"NEFT DR-ICIC0001580-LAAVANYA SHARMA-NETB ANK, MUM-N098201111584622-32500",,,net_banking_transfer,-32500
61b6f5d4d8beac1599eae1dc,50200023535069,869380.85,60ec41ba55c00300382672d9,HDFC,direct expenses,5eecc6d6449e4f7cfb1c2708,2020-04-07T00:00:00.000Z,00901610080520-TPT-16000-POOJA KAPIL SHR OTRIYA,,,net_banking_transfer,-16000
61b6f5d5d8beac1599eae1df,50200023535069,877195.54,60ec41ba55c00300382672d9,HDFC,Revenue-PG-split enabled,5eecc6d6449e4f7cfb1c2708,2020-04-07T00:00:00.000Z,NEFT CR-UTIB0001506-RAZORPAY SOFTWARE PR IVATE LIMITED-SLICK ORGANICS PVT LITD-AX ISCN0050001767,investments,,net_banking_transfer,7814.69
61b6f5d6d8beac1599eae1e5,50200023535069,860995.54,60ec41ba55c00300382672d9,HDFC,direct expenses,5eecc6d6449e4f7cfb1c2708,2020-04-07T00:00:00.000Z,"NEFT DR-SYNB0005170-SNEHAL TAYDE-NETBANK , MUM-N098201111753372-16200",,,net_banking_transfer,-16200
61b6f5d7d8beac1599eae1ec,50200023535069,835995.54,60ec41ba55c00300382672d9,HDFC,direct expenses,5eecc6d6449e4f7cfb1c2708,2020-04-07T00:00:00.000Z,50100301160692-TPT-25000-TARUN GARG,,,net_banking_transfer,-25000
61b6f5d8d8beac1599eae1f3,50200023535069,785995.54,60ec41ba55c00300382672d9,HDFC,direct expenses,5eecc6d6449e4f7cfb1c2708,2020-04-07T00:00:00.000Z,"NEFT DR-SBIN0009817-ANIL KUMAR BHATT-NET BANK, MUM-N098201111760981-50000",,,net_banking_transfer,-50000
61b6f5d9d8beac1599eae1f6,50200023535069,775375.54,60ec41ba55c00300382672d9,HDFC,direct expenses,5eecc6d6449e4f7cfb1c2708,2020-04-07T00:00:00.000Z,"NEFT DR-UTIB0000120-ADNAN ALI-NETBANK, M",,,net_banking_transfer,-10620
61b6f5dad8beac1599eae1ff,50200023535069,754525.54,60ec41ba55c00300382672d9,HDFC,direct expenses,5eecc6d6449e4f7cfb1c2708,2020-04-07T00:00:00.000Z,"NEFT DR-UTIB0000120-ADNAN ALI-NETBANK, M UM-N098201111769041-20850",,,net_banking_transfer,-20850
61b6f5dbd8beac1599eae245,50200023535069,754401.51,60ec41ba55c00300382672d9,HDFC,bank charges,5eecc6d6449e4f7cfb1c2708,2020-04-07T00:00:00.000Z,.DC INTL POS TXN MARKUP+ST 270320 300320 -MIR2009594216671,,,international_transaction_arbitrage,-124.03
61b6f5dcd8beac1599eae25f,50200023535069,758522.12,60ec41ba55c00300382672d9,HDFC,Revenue-Mktplace,5eecc6d6449e4f7cfb1c2708,2020-04-07T00:00:00.000Z,NEFT CR-DEUT0797BGL-FLIPKART INTERNET PV TLTD-SLICK ORGANICS PVT LTD-040700415GN0 0185,shopping,,net_banking_transfer,4120.61
61b6f5ddd8beac1599eae269,50200023535069,762578.73,60ec41ba55c00300382672d9,HDFC,Revenue-Mktplace,5eecc6d6449e4f7cfb1c2708,2020-04-07T00:00:00.000Z,NEFT CR-DEUT0797BGL-FLIPKART INTERNET P LTD-INT AC FO R INTERMEDIARY-SLICK ORGAN ICS PVT LTD-040700421GN00290,shopping,,net_banking_transfer,4056.61
61b6f5ded8beac1599eae26d,50200023535069,362578.73,60ec41ba55c00300382672d9,HDFC,direct expenses,5eecc6d6449e4f7cfb1c2708,2020-04-07T00:00:00.000Z,"NEFT DR-ORBC0100707-UFLEX LIMITED-NETBAN K, MUM-N098201112510403-400000",loans,lender_transaction,net_banking_transfer,-400000
61b6f5ded8beac1599eae270,50200023535069,357094.73,60ec41ba55c00300382672d9,HDFC,direct expenses,5eecc6d6449e4f7cfb1c2708,2020-04-07T00:00:00.000Z,"NEFT DR-UTIB0000120-ADNAN ALI-NETBANK, M UM-N098201112513811-5484",,,net_banking_transfer,-5484
61b6f5dfd8beac1599eae275,50200023535069,347094.73,60ec41ba55c00300382672d9,HDFC,direct expenses,5eecc6d6449e4f7cfb1c2708,2020-04-07T00:00:00.000Z,50100203607308-TPT-10000-MONIKA MISHRA,,,net_banking_transfer,-10000
61b6f5e0d8beac1599eae279,50200023535069,347706.43,60ec41ba55c00300382672d9,HDFC,Revenue-PG-split enabled,5eecc6d6449e4f7cfb1c2708,2020-04-07T00:00:00.000Z,NEFT CR-UTIB0001506-RAZORPAY SOFTWARE PR IVATE LIMITED-SLICK ORGANICS PVT LITD-AX ISCN0050040413,investments,,net_banking_transfer,611.7
61b6f5e1d8beac1599eae280,50200023535069,347701.41,60ec41ba55c00300382672d9,HDFC,bank charges,5eecc6d6449e4f7cfb1c2708,2020-04-07T00:00:00.000Z,DEBIT CARD PUR ADJ DT 01/04/20,,,Other,-5.02
61b6f5e2d8beac1599eae287,50200023535069,322701.41,60ec41ba55c00300382672d9,HDFC,direct expenses,5eecc6d6449e4f7cfb1c2708,2020-04-07T00:00:00.000Z,POS 514834XXXXXX9486 RAZ*BIGFOOT RETA,,,debit_card,-25000
61b6f5e3d8beac1599eae28b,50200023535069,323344.56,60ec41ba55c00300382672d9,HDFC,Revenue-COD,5eecc6d6449e4f7cfb1c2708,2020-04-08T00:00:00.000Z,NEFT CR-KKBK0000958-BIGFOOT RETAIL SOLUT IONS PRIVATE LIMITED-SLICK ORGANICS PVT LTD-KKBK200993005042,,,net_banking_transfer,643.15
61b6f5e4d8beac1599eae292,50200023535069,326268.11,60ec41ba55c00300382672d9,HDFC,Revenue-PG-split enabled,5eecc6d6449e4f7cfb1c2708,2020-04-08T00:00:00.000Z,NEFT CR-UTIB0001506-RAZORPAY SOFTWARE PR IVATE LIMITED-SLICK ORGANICS PVT LITD-AX ISCN0050107910,investments,,net_banking_transfer,2923.55
61b6f5e5d8beac1599eae295,50200023535069,338382.41,60ec41ba55c00300382672d9,HDFC,Revenue-PG-split enabled,5eecc6d6449e4f7cfb1c2708,2020-04-09T00:00:00.000Z,NEFT CR-UTIB0001506-RAZORPAY SOFTWARE PR IVATE LIMITED-SLICK ORGANICS PVT LITD-AX ISCN0050117732,investments,,net_banking_transfer,12114.3
61b6f5e6d8beac1599eae2bb,50200023535069,334601.41,60ec41ba55c00300382672d9,HDFC,direct expenses,5eecc6d6449e4f7cfb1c2708,2020-04-09T00:00:00.000Z,"NEFT DR-KKBK0004611-ANAMIKA KARN-NETBANK , MUM-N100201113997071-3781",,,net_banking_transfer,-3781
61b6f5e7d8beac1599eae2c1,50200023535069,340875.93,60ec41ba55c00300382672d9,HDFC,Revenue-PG-split enabled,5eecc6d6449e4f7cfb1c2708,2020-04-09T00:00:00.000Z,NEFT CR-UTIB0001506-RAZORPAY SOFTWARE PR,,,net_banking_transfer,6274.52
61b6f5e8d8beac1599eae2c4,50200023535069,337978.93,60ec41ba55c00300382672d9,HDFC,direct expenses,5eecc6d6449e4f7cfb1c2708,2020-04-10T00:00:00.000Z,50100097355028-TPT-2897-PALLAVI JUNEJA,,,net_banking_transfer,-2897
61b6f5e9d8beac1599eae2c8,50200023535069,288178.93,60ec41ba55c00300382672d9,HDFC,agency/vendor expense,5eecc6d6449e4f7cfb1c2708,2020-04-12T00:00:00.000Z,50200025524947-TPT-AFFOY-AFFOY MEDIA PRI VATE LIMITED,,,net_banking_transfer,-49800
61b6f5ead8beac1599eae2cc,50200023535069,263178.93,60ec41ba55c00300382672d9,HDFC,direct expenses,5eecc6d6449e4f7cfb1c2708,2020-04-12T00:00:00.000Z,POS 514834XXXXXX9486 SHIPROCKET,,,debit_card,-25000
61b6f5ebd8beac1599eae2d2,50200023535069,263565.7,60ec41ba55c00300382672d9,HDFC,Revenue-Mktplace,5eecc6d6449e4f7cfb1c2708,2020-04-13T00:00:00.000Z,NEFT CR-DEUT0797BGL-FLIPKART INTERNET PV TLTD-SLICK ORGANICS PVT LTD-041300522GN0 0226,shopping,,net_banking_transfer,386.77
61b6f5ecd8beac1599eae2d9,50200023535069,382775.1,60ec41ba55c00300382672d9,HDFC,Revenue-PG-split enabled,5eecc6d6449e4f7cfb1c2708,2020-04-13T00:00:00.000Z,NEFT CR-UTIB0001506-RAZORPAY SOFTWARE PR IVATE LIMITED-SLICK ORGANICS PVT LITD-AX ISCN0050165679,investments,,net_banking_transfer,119209.4
61b6f5edd8beac1599eae2de,50200023535069,367775.1,60ec41ba55c00300382672d9,HDFC,agency/vendor expense,5eecc6d6449e4f7cfb1c2708,2020-04-13T00:00:00.000Z,50200025524947-TPT-15000-AFFOY MEDIA PRI VATE LIMITED,,,net_banking_transfer,-15000
61b6f5eed8beac1599eae2e6,50200023535069,368311.1,60ec41ba55c00300382672d9,HDFC,Revenue-Mktplace,5eecc6d6449e4f7cfb1c2708,2020-04-13T00:00:00.000Z,NEFT CR-KKBK0000958-SUPERMARKET GROCERY SUPPLIES PVT LTD-SLICK ORGANICS PVT LTD- KKBK201043358224,shopping,,net_banking_transfer,536
61b6f5efd8beac1599eae2e8,50200023535069,370045.1,60ec41ba55c00300382672d9,HDFC,Revenue-Mktplace,5eecc6d6449e4f7cfb1c2708,2020-04-13T00:00:00.000Z,NEFT CR-KKBK0000958-SUPERMARKET GROCERY SUPPLIES PVT LTD-SLICK ORGANICS PVT LTD- KKBK201043358387,shopping,,net_banking_transfer,1734
61b6f5f0d8beac1599eae2ed,50200023535069,370419.1,60ec41ba55c00300382672d9,HDFC,Revenue-Mktplace,5eecc6d6449e4f7cfb1c2708,2020-04-13T00:00:00.000Z,NEFT CR-KKBK0000958-SUPERMARKET GROCERY SUPPLIES PVT LTD-SLICK ORGANICS PVT LTD- KKBK201043360446,shopping,,net_banking_transfer,374
61b6f5f1d8beac1599eae2f5,50200023535069,374412.1,60ec41ba55c00300382672d9,HDFC,Revenue-Mktplace,5eecc6d6449e4f7cfb1c2708,2020-04-13T00:00:00.000Z,NEFT CR-KKBK0000958-SUPERMARKET GROCERY SUPPLIES PVT LTD-SLICK ORGANICS PVT LTD- KKBK201043360547,shopping,,net_banking_transfer,3993
61b6f5f2d8beac1599eae2f9,50200023535069,375564.1,60ec41ba55c00300382672d9,HDFC,Revenue-Mktplace,5eecc6d6449e4f7cfb1c2708,2020-04-13T00:00:00.000Z,NEFT CR-KKBK0000958-SUPERMARKET GROCERY SUPPLIES PVT LTD-SLICK ORGANICS PVT LTD- KKBK201043364775,shopping,,net_banking_transfer,1152
61b6f5f3d8beac1599eae2fd,50200023535069,383581.48,60ec41ba55c00300382672d9,HDFC,Revenue-PG-split enabled,5eecc6d6449e4f7cfb1c2708,2020-04-13T00:00:00.000Z,NEFT CR-UTIB0001506-RAZORPAY SOFTWARE PR,,,net_banking_transfer,8017.38
61b6f5f4d8beac1599eae301,50200023535069,238581.48,60ec41ba55c00300382672d9,HDFC,direct expenses,5eecc6d6449e4f7cfb1c2708,2020-04-14T00:00:00.000Z,"NEFT DR-ICIC0003430-HASHTAG ORANGE ADVER TISING PVT LTD-NETBANK, MUM-N10520111614 6098-145000",,,net_banking_transfer,-145000
61b6f5f4d8beac1599eae304,50200023535069,275960.33,60ec41ba55c00300382672d9,HDFC,Revenue-PG-split enabled,5eecc6d6449e4f7cfb1c2708,2020-04-15T00:00:00.000Z,NEFT CR-UTIB0001506-RAZORPAY SOFTWARE PR IVATE LIMITED-SLICK ORGANICS PVT LITD-AX ISCN0050254106,investments,,net_banking_transfer,37378.85
61b6f5f5d8beac1599eae316,50200023535069,283272.07,60ec41ba55c00300382672d9,HDFC,Revenue-PG-split enabled,5eecc6d6449e4f7cfb1c2708,2020-04-15T00:00:00.000Z,NEFT CR-UTIB0001506-RAZORPAY SOFTWARE PR IVATE LIMITED-SLICK ORGANICS PVT LITD-AX ISCN0050298150,investments,,net_banking_transfer,7311.74
61b6f5f6d8beac1599eae31d,50200023535069,295638.15,60ec41ba55c00300382672d9,HDFC,Revenue-PG-split enabled,5eecc6d6449e4f7cfb1c2708,2020-04-16T00:00:00.000Z,NEFT CR-UTIB0001506-RAZORPAY SOFTWARE PR IVATE LIMITED-SLICK ORGANICS PVT LITD-AX ISCN0050306735,investments,,net_banking_transfer,12366.08
61b6f5f7d8beac1599eae321,50200023535069,333710.16,60ec41ba55c00300382672d9,HDFC,Revenue-PG-split enabled,5eecc6d6449e4f7cfb1c2708,2020-04-16T00:00:00.000Z,NEFT CR-UTIB0001506-RAZORPAY SOFTWARE PR IVATE LIMITED-SLICK ORGANICS PVT LITD-AX ISCN0050361361,investments,,net_banking_transfer,38072.01
61b6f5f8d8beac1599eae329,50200023535069,332944.32,60ec41ba55c00300382672d9,HDFC,direct expenses,5eecc6d6449e4f7cfb1c2708,2020-04-16T00:00:00.000Z,POS 514834XXXXXX9486 MANYCHAT COM PRO,,,debit_card,-765.84
61b6f5f9d8beac1599eae32c,50200023535069,356076.07,60ec41ba55c00300382672d9,HDFC,Revenue-PG-split enabled,5eecc6d6449e4f7cfb1c2708,2020-04-17T00:00:00.000Z,NEFT CR-UTIB0001506-RAZORPAY SOFTWARE PR IVATE LIMITED-SLICK ORGANICS PVT LITD-AX ISCN0050376325,investments,,net_banking_transfer,23131.75
61b6f5fad8beac1599eae334,50200023535069,337006.78,60ec41ba55c00300382672d9,HDFC,direct expenses,5eecc6d6449e4f7cfb1c2708,2020-04-17T00:00:00.000Z,POS 514834XXXXXX9486 MAILCHIMP *MON,,,debit_card,-19069.29
61b6f5fbd8beac1599eae340,50200023535069,338688.02,60ec41ba55c00300382672d9,HDFC,Revenue-Mktplace,5eecc6d6449e4f7cfb1c2708,2020-04-17T00:00:00.000Z,4060000022-TIMES INTERNET LIMITED NODAL,,,Other,1681.24
61b6f5fcd8beac1599eae344,50200023535069,340373.35,60ec41ba55c00300382672d9,HDFC,Revenue-COD,5eecc6d6449e4f7cfb1c2708,2020-04-17T00:00:00.000Z,NEFT CR-KKBK0000958-BIGFOOT RETAIL SOLUT IONS PRIVATE LIMITED-SLICK ORGANICS PVT LTD-KKBK201083890098,,,net_banking_transfer,1685.33
61b6f5fdd8beac1599eae348,50200023535069,367697.24,60ec41ba55c00300382672d9,HDFC,Revenue-PG-split enabled,5eecc6d6449e4f7cfb1c2708,2020-04-17T00:00:00.000Z,NEFT CR-UTIB0001506-RAZORPAY SOFTWARE PR IVATE LIMITED-SLICK ORGANICS PVT LITD-AX ISCN0050403124,investments,,net_banking_transfer,27323.89
61b6f5fed8beac1599eae34b,50200023535069,391973.12,60ec41ba55c00300382672d9,HDFC,Revenue-PG-split enabled,5eecc6d6449e4f7cfb1c2708,2020-04-18T00:00:00.000Z,NEFT CR-UTIB0001506-RAZORPAY SOFTWARE PR IVATE LIMITED-SLICK ORGANICS PVT LITD-AX ISCN0050421413,investments,,net_banking_transfer,24275.88
61b6f5ffd8beac1599eae353,50200023535069,391969.95,60ec41ba55c00300382672d9,HDFC,bank charges,5eecc6d6449e4f7cfb1c2708,2020-04-18T00:00:00.000Z,DEBIT CARD PUR ADJ DT 16/04/20,,,Other,-3.17
61b6f600d8beac1599eae35a,50200023535069,412667.59,60ec41ba55c00300382672d9,HDFC,Revenue-PG-split enabled,5eecc6d6449e4f7cfb1c2708,2020-04-18T00:00:00.000Z,NEFT CR-UTIB0001506-RAZORPAY SOFTWARE PR,,,net_banking_transfer,20697.64
61b6f601d8beac1599eae360,50200023535069,473559.43,60ec41ba55c00300382672d9,HDFC,Revenue-PG-split enabled,5eecc6d6449e4f7cfb1c2708,2020-04-20T00:00:00.000Z,NEFT CR-UTIB0001506-RAZORPAY SOFTWARE PR IVATE LIMITED-SLICK ORGANICS PVT LITD-AX ISCN0050457992,investments,,net_banking_transfer,60891.84
61b6f602d8beac1599eae369,50200023535069,468203.51,60ec41ba55c00300382672d9,HDFC,direct expenses,5eecc6d6449e4f7cfb1c2708,2020-04-20T00:00:00.000Z,POS 514834XXXXXX9486 FEEDBACKFIVE,,,debit_card,-5355.92
61b6f603d8beac1599eae36d,50200023535069,426083.51,60ec41ba55c00300382672d9,HDFC,direct expenses,5eecc6d6449e4f7cfb1c2708,2020-04-20T00:00:00.000Z,"NEFT DR-ICIC0001944-TUNRAROUND CORPORATE ADVISORS PVT LTD-NETBANK, MUM-N11120111 9586684-42120",,,net_banking_transfer,-42120
61b6f604d8beac1599eae371,50200023535069,426065.09,60ec41ba55c00300382672d9,HDFC,bank charges,5eecc6d6449e4f7cfb1c2708,2020-04-20T00:00:00.000Z,DEBIT CARD PUR ADJ DT 17/04/20,,,Other,-18.42
61b6f605d8beac1599eae379,50200023535069,726065.09,60ec41ba55c00300382672d9,HDFC,Investments-New,5eecc6d6449e4f7cfb1c2708,2020-04-20T00:00:00.000Z,50100216436008-TPT-LOAN SLICK ORGANICS P VT LTD-DHRUV MADHOK,loans,lender_transaction,net_banking_transfer,300000
61b6f606d8beac1599eae381,50200023535069,740796.47,60ec41ba55c00300382672d9,HDFC,Revenue-PG-split enabled,5eecc6d6449e4f7cfb1c2708,2020-04-20T00:00:00.000Z,NEFT CR-UTIB0001506-RAZORPAY SOFTWARE PR IVATE LIMITED-SLICK ORGANICS PVT LITD-AX ISCN0050481059,investments,,net_banking_transfer,14731.38
61b6f607d8beac1599eae384,50200023535069,760026.71,60ec41ba55c00300382672d9,HDFC,Revenue-PG-split enabled,5eecc6d6449e4f7cfb1c2708,2020-04-21T00:00:00.000Z,NEFT CR-UTIB0001506-RAZORPAY SOFTWARE PR IVATE LIMITED-SLICK ORGANICS PVT LITD-AX ISCN0050489374,investments,,net_banking_transfer,19230.24
61b6f608d8beac1599eae389,50200023535069,723026.71,60ec41ba55c00300382672d9,HDFC,direct expenses,5eecc6d6449e4f7cfb1c2708,2020-04-21T00:00:00.000Z,"NEFT DR-CITI0000002-DHIRAJ-NETBANK, MUM- N112201119961120-37000",,,net_banking_transfer,-37000
61b6f609d8beac1599eae38d,50200023535069,688026.71,60ec41ba55c00300382672d9,HDFC,direct expenses,5eecc6d6449e4f7cfb1c2708,2020-04-21T00:00:00.000Z,"NEFT DR-ICIC0000542-AVANTIKA SUKHIA-NETB ANK, MUM-N112201119958152-35000",,,net_banking_transfer,-35000
61b6f60ad8beac1599eae393,50200023535069,680526.71,60ec41ba55c00300382672d9,HDFC,direct expenses,5eecc6d6449e4f7cfb1c2708,2020-04-21T00:00:00.000Z,"NEFT DR-SIBL0000555-JAIVEER KUMAR-NETBAN K, MUM-N112201119949370-7500",,,net_banking_transfer,-7500
61b6f60bd8beac1599eae39b,50200023535069,675526.71,60ec41ba55c00300382672d9,HDFC,direct expenses,5eecc6d6449e4f7cfb1c2708,2020-04-21T00:00:00.000Z,"NEFT DR-PUNB0398000-MEENA SINGH-NETBANK, MUM-N112201119968989-5000",,,net_banking_transfer,-5000
61b6f60bd8beac1599eae3a0,50200023535069,665526.71,60ec41ba55c00300382672d9,HDFC,direct expenses,5eecc6d6449e4f7cfb1c2708,2020-04-21T00:00:00.000Z,"NEFT DR-SBIN0001189-SANDEEP SINGH-NETBAN K, MUM-N112201119970543-10000",,,net_banking_transfer,-10000
61b6f60cd8beac1599eae3a8,50200023535069,746526.71,60ec41ba55c00300382672d9,HDFC,Revenue-Mktplace,5eecc6d6449e4f7cfb1c2708,2020-04-21T00:00:00.000Z,NEFT CR-HSBC0560002-AMAZON SELLER SERVIC ES PRIVATE LIMI-SLICK ORGANICS PVT LTD-H SBCN20112824164,shopping,,net_banking_transfer,81000
61b6f60dd8beac1599eae3ab,50200023535069,738276.71,60ec41ba55c00300382672d9,HDFC,direct expenses,5eecc6d6449e4f7cfb1c2708,2020-04-21T00:00:00.000Z,"NEFT DR-KKBK0000811-NASIR KHAN-NETBANK,",,,net_banking_transfer,-8250
61b6f60ed8beac1599eae3b3,50200023535069,720776.71,60ec41ba55c00300382672d9,HDFC,direct expenses,5eecc6d6449e4f7cfb1c2708,2020-04-21T00:00:00.000Z,"NEFT DR-ICIC0003374-SIDDHARTH KANOJIA-NE TBANK, MUM-N112201119962244-17500",,,net_banking_transfer,-17500
61b6f60fd8beac1599eae3bc,50200023535069,717776.71,60ec41ba55c00300382672d9,HDFC,direct expenses,5eecc6d6449e4f7cfb1c2708,2020-04-21T00:00:00.000Z,"NEFT DR-ALLA0210591-CHAMPA DEVI-NETBANK, MUM-N112201119975560-3000",,,net_banking_transfer,-3000
61b6f610d8beac1599eae3bf,50200023535069,701776.71,60ec41ba55c00300382672d9,HDFC,direct expenses,5eecc6d6449e4f7cfb1c2708,2020-04-21T00:00:00.000Z,00901610080520-TPT-16000-POOJA KAPIL SHR OTRIYA,,,net_banking_transfer,-16000
61b6f611d8beac1599eae3c3,50200023535069,669276.71,60ec41ba55c00300382672d9,HDFC,direct expenses,5eecc6d6449e4f7cfb1c2708,2020-04-21T00:00:00.000Z,"NEFT DR-ICIC0001580-LAAVANYA SHARMA-NETB ANK, MUM-N112201119976218-32500",,,net_banking_transfer,-32500
61b6f612d8beac1599eae3c6,50200023535069,644276.71,60ec41ba55c00300382672d9,HDFC,direct expenses,5eecc6d6449e4f7cfb1c2708,2020-04-21T00:00:00.000Z,50100301160692-TPT-25000-TARUN GARG,,,net_banking_transfer,-25000
61b6f613d8beac1599eae3ce,50200023535069,595276.71,60ec41ba55c00300382672d9,HDFC,direct expenses,5eecc6d6449e4f7cfb1c2708,2020-04-21T00:00:00.000Z,"NEFT DR-SBIN0009817-ANIL KUMAR BHATT-NET BANK, MUM-N112201119981630-49000",,,net_banking_transfer,-49000
61b6f614d8beac1599eae3d3,50200023535069,574426.71,60ec41ba55c00300382672d9,HDFC,direct expenses,5eecc6d6449e4f7cfb1c2708,2020-04-21T00:00:00.000Z,"NEFT DR-UTIB0000120-ADNAN ALI-NETBANK, M UM-N112201119981913-20850",,,net_banking_transfer,-20850
61b6f615d8beac1599eae3d7,50200023535069,564426.71,60ec41ba55c00300382672d9,HDFC,direct expenses,5eecc6d6449e4f7cfb1c2708,2020-04-21T00:00:00.000Z,50100203607308-TPT-10000-MONIKA MISHRA,,,net_banking_transfer,-10000
61b6f616d8beac1599eae3e0,50200023535069,560645.71,60ec41ba55c00300382672d9,HDFC,direct expenses,5eecc6d6449e4f7cfb1c2708,2020-04-21T00:00:00.000Z,"NEFT DR-KKBK0004611-ANAMIKA KARN-NETBANK , MUM-N112201119972436-3781",,,net_banking_transfer,-3781
61b6f617d8beac1599eae3eb,50200023535069,579597.89,60ec41ba55c00300382672d9,HDFC,Revenue-PG-split enabled,5eecc6d6449e4f7cfb1c2708,2020-04-21T00:00:00.000Z,NEFT CR-UTIB0001506-RAZORPAY SOFTWARE PR IVATE LIMITED-SLICK ORGANICS PVT LITD-AX ISCN0050511363,investments,,net_banking_transfer,18952.18
61b6f618d8beac1599eae3f2,50200023535069,597796.54,60ec41ba55c00300382672d9,HDFC,Revenue-PG-split enabled,5eecc6d6449e4f7cfb1c2708,2020-04-22T00:00:00.000Z,NEFT CR-UTIB0001506-RAZORPAY SOFTWARE PR IVATE LIMITED-SLICK ORGANICS PVT LITD-AX ISCN0050519554,investments,,net_banking_transfer,18198.65
61b6f619d8beac1599eae3fc,50200023535069,479796.54,60ec41ba55c00300382672d9,HDFC,direct expenses,5eecc6d6449e4f7cfb1c2708,2020-04-22T00:00:00.000Z,"NEFT DR-ICIC0003430-HASHTAG ORANGE ADVER TISING PVT LTD-NETBANK, MUM-N11320112045 1496-118000",,,net_banking_transfer,-118000
61b6f61ad8beac1599eae401,50200023535069,479787.43,60ec41ba55c00300382672d9,HDFC,bank charges,5eecc6d6449e4f7cfb1c2708,2020-04-22T00:00:00.000Z,DEBIT CARD PUR ADJ DT 20/04/20,,,Other,-9.11
61b6f61bd8beac1599eae406,50200023535069,485736.24,60ec41ba55c00300382672d9,HDFC,Revenue-PG-split enabled,5eecc6d6449e4f7cfb1c2708,2020-04-22T00:00:00.000Z,NEFT CR-UTIB0001506-RAZORPAY SOFTWARE PR IVATE LIMITED-SLICK ORGANICS PVT LITD-AX ISCN0050541370,investments,,net_banking_transfer,5948.81
61b6f61cd8beac1599eae40c,50200023535069,501648.5,60ec41ba55c00300382672d9,HDFC,Revenue-PG-split enabled,5eecc6d6449e4f7cfb1c2708,2020-04-23T00:00:00.000Z,NEFT CR-UTIB0001506-RAZORPAY SOFTWARE PR,,,net_banking_transfer,15912.26
61b6f61dd8beac1599eae40f,50200023535069,502281.5,60ec41ba55c00300382672d9,HDFC,Revenue-Mktplace,5eecc6d6449e4f7cfb1c2708,2020-04-23T00:00:00.000Z,NEFT CR-KKBK0000958-SUPERMARKET GROCERY SUPPLIES PVT LTD-SLICK ORGANICS PVT LTD- KKBK201144503403,shopping,,net_banking_transfer,633
61b6f61ed8beac1599eae416,50200023535069,510134.42,60ec41ba55c00300382672d9,HDFC,Revenue-PG-split enabled,5eecc6d6449e4f7cfb1c2708,2020-04-23T00:00:00.000Z,NEFT CR-UTIB0001506-RAZORPAY SOFTWARE PR IVATE LIMITED-SLICK ORGANICS PVT LITD-AX ISCN0050571638,investments,,net_banking_transfer,7852.92
61b6f61fd8beac1599eae41d,50200023535069,524219.66,60ec41ba55c00300382672d9,HDFC,Revenue-PG-split enabled,5eecc6d6449e4f7cfb1c2708,2020-04-24T00:00:00.000Z,NEFT CR-UTIB0001506-RAZORPAY SOFTWARE PR IVATE LIMITED-SLICK ORGANICS PVT LITD-AX ISCN0050579064,investments,,net_banking_transfer,14085.24
61b6f61fd8beac1599eae421,50200023535069,521162.34,60ec41ba55c00300382672d9,HDFC,SAAS/tech expense,5eecc6d6449e4f7cfb1c2708,2020-04-24T00:00:00.000Z,POS 514834XXXXXX9486 AMAZON SELLER RE,shopping,,debit_card,-3057.32
61b6f620d8beac1599eae429,50200023535069,521408.39,60ec41ba55c00300382672d9,HDFC,Revenue-Mktplace,5eecc6d6449e4f7cfb1c2708,2020-04-24T00:00:00.000Z,NEFT CR-ICIC0000104-GOQII TECHNOLOGIES P VT LTD-SLICK ORGANICS PRIVATE LIMITED-CM S1463916620,,,net_banking_transfer,246.05
61b6f621d8beac1599eae42c,50200023535069,546031.42,60ec41ba55c00300382672d9,HDFC,Revenue-COD,5eecc6d6449e4f7cfb1c2708,2020-04-24T00:00:00.000Z,NEFT CR-KKBK0000958-BIGFOOT RETAIL SOLUT IONS PRIVATE LIMITED-SLICK ORGANICS PVT LTD-KKBK201154711755,,,net_banking_transfer,24623.03
61b6f622d8beac1599eae434,50200023535069,571594.02,60ec41ba55c00300382672d9,HDFC,Revenue-PG-split enabled,5eecc6d6449e4f7cfb1c2708,2020-04-24T00:00:00.000Z,NEFT CR-UTIB0001506-RAZORPAY SOFTWARE PR IVATE LIMITED-SLICK ORGANICS PVT LITD-AX ISCN0050602443,investments,,net_banking_transfer,25562.6
61b6f623d8beac1599eae43d,50200023535069,521594.02,60ec41ba55c00300382672d9,HDFC,SAAS/tech expense,5eecc6d6449e4f7cfb1c2708,2020-04-24T00:00:00.000Z,POS 514834XXXXXX4081 AMAZON,shopping,,debit_card,-50000
61b6f624d8beac1599eae44b,50200023535069,517955.02,60ec41ba55c00300382672d9,HDFC,direct expenses,5eecc6d6449e4f7cfb1c2708,2020-04-26T00:00:00.000Z,POS 514834XXXXXX9486 FRESHWORKS INC,,,debit_card,-3639
61b6f625d8beac1599eae45d,50200023535069,645914.15,60ec41ba55c00300382672d9,HDFC,Revenue-PG-split enabled,5eecc6d6449e4f7cfb1c2708,2020-04-27T00:00:00.000Z,NEFT CR-UTIB0001506-RAZORPAY SOFTWARE PR IVATE LIMITED-SLICK ORGANICS PVT LITD-AX ISCN0050630989,investments,,net_banking_transfer,127959.13
61b6f626d8beac1599eae469,50200023535069,645519.61,60ec41ba55c00300382672d9,HDFC,bank charges,5eecc6d6449e4f7cfb1c2708,2020-04-27T00:00:00.000Z,.DC INTL POS TXN MARKUP+ST 020420 030420 -MIR2011608829408,,,international_transaction_arbitrage,-394.54
61b6f627d8beac1599eae47b,50200023535069,645541.97,60ec41ba55c00300382672d9,HDFC,Adjustments/Reversal,5eecc6d6449e4f7cfb1c2708,2020-04-27T00:00:00.000Z,DEBIT CARD PUR ADJ DT 24/04/20,,,Other,22.36
61b6f628d8beac1599eae485,50200023535069,665803.11,60ec41ba55c00300382672d9,HDFC,Revenue-PG-split enabled,5eecc6d6449e4f7cfb1c2708,2020-04-27T00:00:00.000Z,NEFT CR-UTIB0001506-RAZORPAY SOFTWARE PR IVATE LIMITED-SLICK ORGANICS PVT LITD-AX ISCN0050652587,investments,,net_banking_transfer,20261.14
61b6f629d8beac1599eae48d,50200023535069,556803.11,60ec41ba55c00300382672d9,HDFC,direct expenses,5eecc6d6449e4f7cfb1c2708,2020-04-28T00:00:00.000Z,NEFT DR-ICIC0003430-HASHTAG ORANGE ADVER,,,net_banking_transfer,-109000
61b6f62ad8beac1599eae498,50200023535069,580000.92,60ec41ba55c00300382672d9,HDFC,Revenue-PG-split enabled,5eecc6d6449e4f7cfb1c2708,2020-04-28T00:00:00.000Z,NEFT CR-UTIB0001506-RAZORPAY SOFTWARE PR IVATE LIMITED-SLICK ORGANICS PVT LITD-AX ISCN0050657594,investments,,net_banking_transfer,23197.81
61b6f62bd8beac1599eae4a4,50200023535069,590704.09,60ec41ba55c00300382672d9,HDFC,Revenue-Mktplace,5eecc6d6449e4f7cfb1c2708,2020-04-28T00:00:00.000Z,IMPS-011911108782-AMAZON SELLER SERVIC-H DFC-XXXXXXXX6004-30ARTCVS6AZQL3EPSLICK O RGANICS PVT LTD,shopping,,net_banking_transfer,10703.17
61b6f62cd8beac1599eae4ab,50200023535069,599114.05,60ec41ba55c00300382672d9,HDFC,Revenue-Mktplace,5eecc6d6449e4f7cfb1c2708,2020-04-28T00:00:00.000Z,NEFT CR-DEUT0797BGL-AMAZON PAY IND PVT L TD-INT AC INTM MKTPLACE-SLICK ORGANICS P VT LTD-042800075GN00054,shopping,,net_banking_transfer,8409.96
61b6f62dd8beac1599eae4b5,50200023535069,600495.05,60ec41ba55c00300382672d9,HDFC,Revenue-Mktplace,5eecc6d6449e4f7cfb1c2708,2020-04-28T00:00:00.000Z,NEFT CR-KKBK0000958-SURFBOATS SOLUTIONS PVT LTD-SLICK ORGANICS PRIVATE LIMITED-K KBKH20119836797,investments,,net_banking_transfer,1381
61b6f62ed8beac1599eae4bc,50200023535069,608962.46,60ec41ba55c00300382672d9,HDFC,Revenue-PG-split enabled,5eecc6d6449e4f7cfb1c2708,2020-04-28T00:00:00.000Z,NEFT CR-UTIB0001506-RAZORPAY SOFTWARE PR IVATE LIMITED-SLICK ORGANICS PVT LITD-AX ISCN0050702939,investments,,net_banking_transfer,8467.41
61b6f62fd8beac1599eae4c1,50200023535069,634382.35,60ec41ba55c00300382672d9,HDFC,Revenue-PG-split enabled,5eecc6d6449e4f7cfb1c2708,2020-04-29T00:00:00.000Z,NEFT CR-UTIB0001506-RAZORPAY SOFTWARE PR IVATE LIMITED-SLICK ORGANICS PVT LITD-AX ISCN0050712895,investments,,net_banking_transfer,25419.89
61b6f630d8beac1599eae4c7,50200023535069,634291.91,60ec41ba55c00300382672d9,HDFC,bank charges,5eecc6d6449e4f7cfb1c2708,2020-04-29T00:00:00.000Z,.DC INTL POS TXN MARKUP+ST 010420 070420 -MIR2011910317840,,,international_transaction_arbitrage,-90.44
61b6f631d8beac1599eae4cc,50200023535069,240369.91,60ec41ba55c00300382672d9,HDFC,direct expenses,5eecc6d6449e4f7cfb1c2708,2020-04-29T00:00:00.000Z,"NEFT DR-ORBC0100707-UFLEX LIMITED-NETBAN K, MUM-N120201123630212-393922",loans,lender_transaction,net_banking_transfer,-393922
61b6f632d8beac1599eae4d5,50200023535069,140369.91,60ec41ba55c00300382672d9,HDFC,direct expenses,5eecc6d6449e4f7cfb1c2708,2020-04-29T00:00:00.000Z,"NEFT DR-YESB0000109-JERONONE TECHNOLOGIE S-NETBANK, MUM-N120201123685039-100000",,,net_banking_transfer,-100000
61b6f633d8beac1599eae4db,50200023535069,159143.97,60ec41ba55c00300382672d9,HDFC,Revenue-COD,5eecc6d6449e4f7cfb1c2708,2020-04-29T00:00:00.000Z,NEFT CR-KKBK0000958-BIGFOOT RETAIL SOLUT IONS PRIVATE LIMITED-SLICK ORGANICS PVT LTD-KKBK201205190864,,,net_banking_transfer,18774.06
61b6f633d8beac1599eae4e2,50200023535069,173877.56,60ec41ba55c00300382672d9,HDFC,Revenue-PG-split enabled,5eecc6d6449e4f7cfb1c2708,2020-04-29T00:00:00.000Z,NEFT CR-UTIB0001506-RAZORPAY SOFTWARE PR,,,net_banking_transfer,14733.59
61b6f634d8beac1599eae4ea,50200023535069,120957.56,60ec41ba55c00300382672d9,HDFC,direct expenses,5eecc6d6449e4f7cfb1c2708,2020-04-29T00:00:00.000Z,"NEFT DR-BKDN0450123-ARTISTO DESIGNZ-NETB ANK, MUM-N120201123898726-52920",,,net_banking_transfer,-52920
61b6f635d8beac1599eae4ef,50200023535069,132896.67,60ec41ba55c00300382672d9,HDFC,Revenue-PG-split enabled,5eecc6d6449e4f7cfb1c2708,2020-04-30T00:00:00.000Z,NEFT CR-UTIB0001506-RAZORPAY SOFTWARE PR IVATE LIMITED-SLICK ORGANICS PVT LITD-AX ISCN0050750545,investments,,net_banking_transfer,11939.11
61b6f636d8beac1599eae4fb,50200023535069,141233.31,60ec41ba55c00300382672d9,HDFC,Revenue-PG-split enabled,5eecc6d6449e4f7cfb1c2708,2020-04-30T00:00:00.000Z,NEFT CR-UTIB0001506-RAZORPAY SOFTWARE PR,,,net_banking_transfer,8336.64
61b6f637d8beac1599eae504,50200023535069,139044.97,60ec41ba55c00300382672d9,HDFC,direct expenses,5eecc6d6449e4f7cfb1c2708,2020-05-01T00:00:00.000Z,POS 514834XXXXXX9486 SEOPTIMER,,,debit_card,-2188.34
61b6f638d8beac1599eae50c,50200023535069,128424.97,60ec41ba55c00300382672d9,HDFC,direct expenses,5eecc6d6449e4f7cfb1c2708,2020-05-01T00:00:00.000Z,POS 514834XXXXXX9486 RAZ*COZY VISION,,,debit_card,-10620
61b6f639d8beac1599eae511,50200023535069,184610.18,60ec41ba55c00300382672d9,HDFC,Revenue-COD,5eecc6d6449e4f7cfb1c2708,2020-05-01T00:00:00.000Z,NEFT CR-KKBK0000958-BIGFOOT RETAIL SOLUT IONS PRIVATE LIMITED-SLICK ORGANICS PVT LTD-KKBK201225609383,,,net_banking_transfer,56185.21
61b6f63ad8beac1599eae514,50200023535069,256532.13,60ec41ba55c00300382672d9,HDFC,Revenue-PG-split enabled,5eecc6d6449e4f7cfb1c2708,2020-05-02T00:00:00.000Z,NEFT CR-UTIB0001506-RAZORPAY SOFTWARE PR IVATE LIMITED-SLICK ORGANICS PVT LITD-AX ISCN0050821094,investments,,net_banking_transfer,71921.95
61b6f63bd8beac1599eae51b,50200023535069,198912.13,60ec41ba55c00300382672d9,HDFC,Utilities/bills,5eecc6d6449e4f7cfb1c2708,2020-05-02T00:00:00.000Z,IB BILLPAY DR-HDFCRM-555153XXXXXX8852,bills,,bill_payment,-57620
61b6f63cd8beac1599eae527,50200023535069,189527.75,60ec41ba55c00300382672d9,HDFC,direct expenses,5eecc6d6449e4f7cfb1c2708,2020-05-02T00:00:00.000Z,POS 514834XXXXXX9486 STK*SHUTTERSTOCK,,,debit_card,-9384.38
61b6f63dd8beac1599eae52b,50200023535069,208831.1,60ec41ba55c00300382672d9,HDFC,Revenue-PG-split enabled,5eecc6d6449e4f7cfb1c2708,2020-05-02T00:00:00.000Z,NEFT CR-UTIB0001506-RAZORPAY SOFTWARE PR IVATE LIMITED-SLICK ORGANICS PVT LITD-AX ISCN0050843131,investments,,net_banking_transfer,19303.35
61b6f63ed8beac1599eae53e,50200023535069,204112.28,60ec41ba55c00300382672d9,HDFC,direct expenses,5eecc6d6449e4f7cfb1c2708,2020-05-02T00:00:00.000Z,POS 514834XXXXXX4081 ONLINE PAYMENT,,,debit_card,-4718.82
61b6f63fd8beac1599eae541,50200023535069,204120.4,60ec41ba55c00300382672d9,HDFC,Adjustments/Reversal,5eecc6d6449e4f7cfb1c2708,2020-05-02T00:00:00.000Z,DEBIT CARD PUR ADJ DT 01/05/20,,,Other,8.12
61b6f640d8beac1599eae546,50200023535069,203672.4,60ec41ba55c00300382672d9,HDFC,direct expenses,5eecc6d6449e4f7cfb1c2708,2020-05-03T00:00:00.000Z,"NEFT DR-UTIB0000028-PREETI KAUR BHAMRA-N ETBANK, MUM-N124201127031981-448",,,net_banking_transfer,-448
61b6f641d8beac1599eae54e,50200023535069,258641.51,60ec41ba55c00300382672d9,HDFC,Revenue-PG-split enabled,5eecc6d6449e4f7cfb1c2708,2020-05-04T00:00:00.000Z,NEFT CR-UTIB0001506-RAZORPAY SOFTWARE PR IVATE LIMITED-SLICK ORGANICS PVT LITD-AX ISCN0050853743,investments,,net_banking_transfer,54969.11
61b6f642d8beac1599eae556,50200023535069,258609.75,60ec41ba55c00300382672d9,HDFC,bank charges,5eecc6d6449e4f7cfb1c2708,2020-05-04T00:00:00.000Z,.DC INTL POS TXN MARKUP+ST 160420 180420 -MIR2012316688645,,,international_transaction_arbitrage,-31.76
61b6f643d8beac1599eae55a,50200023535069,257821.42,60ec41ba55c00300382672d9,HDFC,bank charges,5eecc6d6449e4f7cfb1c2708,2020-05-04T00:00:00.000Z,.DC INTL POS TXN MARKUP+ST 170420 200420 -MIR2012417285551,,,international_transaction_arbitrage,-788.33
61b6f644d8beac1599eae565,50200023535069,257599.84,60ec41ba55c00300382672d9,HDFC,bank charges,5eecc6d6449e4f7cfb1c2708,2020-05-04T00:00:00.000Z,.DC INTL POS TXN MARKUP+ST 190420 220420 -MIR2012417474723,,,international_transaction_arbitrage,-221.58
61b6f645d8beac1599eae56c,50200023535069,264005.14,60ec41ba55c00300382672d9,HDFC,Revenue-COD,5eecc6d6449e4f7cfb1c2708,2020-05-04T00:00:00.000Z,NEFT CR-KKBK0000958-BIGFOOT RETAIL SOLUT IONS PRIVATE LIMITED-SLICK ORGANICS PVT LTD-KKBK201255992551,,,net_banking_transfer,6405.3
61b6f646d8beac1599eae575,50200023535069,264006.14,60ec41ba55c00300382672d9,HDFC,Transfer in/Revenue-other,5eecc6d6449e4f7cfb1c2708,2020-05-04T00:00:00.000Z,CRV POS 514834******9486 GOOGLE INDIA PV,,,refund,1
61b6f647d8beac1599eae579,50200023535069,264007.14,60ec41ba55c00300382672d9,HDFC,Transfer in/Revenue-other,5eecc6d6449e4f7cfb1c2708,2020-05-04T00:00:00.000Z,CRV POS 514834******9486 GOOGLE INDIA PV,,,refund,1
61b6f648d8beac1599eae57e,50200023535069,264008.14,60ec41ba55c00300382672d9,HDFC,Transfer in/Revenue-other,5eecc6d6449e4f7cfb1c2708,2020-05-04T00:00:00.000Z,CRV POS 514834******9486 GOOGLE INDIA PV,,,refund,1
61b6f649d8beac1599eae585,50200023535069,276899.63,60ec41ba55c00300382672d9,HDFC,Revenue-PG-split enabled,5eecc6d6449e4f7cfb1c2708,2020-05-04T00:00:00.000Z,NEFT CR-UTIB0001506-RAZORPAY SOFTWARE PR IVATE LIMITED-SLICK ORGANICS PVT LITD-AX ISCN0050882462,investments,,net_banking_transfer,12891.49
61b6f64ad8beac1599eae589,50200023535069,276808.01,60ec41ba55c00300382672d9,HDFC,bank charges,5eecc6d6449e4f7cfb1c2708,2020-05-04T00:00:00.000Z,DEBIT CARD PUR ADJ DT 02/05/20,,,Other,-91.62
61b6f64bd8beac1599eae595,50200023535069,292821.06,60ec41ba55c00300382672d9,HDFC,Revenue-PG-split enabled,5eecc6d6449e4f7cfb1c2708,2020-05-05T00:00:00.000Z,NEFT CR-UTIB0001506-RAZORPAY SOFTWARE PR IVATE LIMITED-SLICK ORGANICS PVT LITD-AX ISCN0050893409,investments,,net_banking_transfer,16013.05
61b6f64cd8beac1599eae59a,50200023535069,294208.31,60ec41ba55c00300382672d9,HDFC,Revenue-Mktplace,5eecc6d6449e4f7cfb1c2708,2020-05-05T00:00:00.000Z,IMPS-012611185753-AMAZON SELLER SERVIC-H DFC-XXXXXXXX6004-38MYCWCVQZE5MV44SLICK O RGANICS PVT LTD,shopping,,net_banking_transfer,1387.25
61b6f64cd8beac1599eae59d,50200023535069,359845.2,60ec41ba55c00300382672d9,HDFC,Revenue-Mktplace,5eecc6d6449e4f7cfb1c2708,2020-05-05T00:00:00.000Z,NEFT CR-DEUT0797BGL-AMAZON PAY IND PVT L TD-INT AC INTM MKTPLACE-SLICK ORGANICS P VT LTD-050500136GN00021,shopping,,net_banking_transfer,65636.89
61b6f64dd8beac1599eae5a3,50200023535069,372400.15,60ec41ba55c00300382672d9,HDFC,Revenue-PG-split enabled,5eecc6d6449e4f7cfb1c2708,2020-05-05T00:00:00.000Z,NEFT CR-UTIB0001506-RAZORPAY SOFTWARE PR IVATE LIMITED-SLICK ORGANICS PVT LITD-AX ISCN0050918614,investments,,net_banking_transfer,12554.95
61b6f64ed8beac1599eae5a5,50200023535069,386505.76,60ec41ba55c00300382672d9,HDFC,Revenue-PG-split enabled,5eecc6d6449e4f7cfb1c2708,2020-05-06T00:00:00.000Z,NEFT CR-UTIB0001506-RAZORPAY SOFTWARE PR IVATE LIMITED-SLICK ORGANICS PVT LITD-AX ISCN0050932058,investments,,net_banking_transfer,14105.61
61b6f64fd8beac1599eae5ac,50200023535069,231816.76,60ec41ba55c00300382672d9,HDFC,direct expenses,5eecc6d6449e4f7cfb1c2708,2020-05-06T00:00:00.000Z,"NEFT DR-ICIC0002445-MOVA1-NETBANK, MUM-N 127201129685873-154689",,,net_banking_transfer,-154689
61b6f650d8beac1599eae5b2,50200023535069,2731816.76,60ec41ba55c00300382672d9,HDFC,Internal Transfers,5eecc6d6449e4f7cfb1c2708,2020-05-06T00:00:00.000Z,IB FUNDS TRANSFER CR-50200035187206 -SL ICK ORGANICS PVT LTD,investments,,Other,2500000
61b6f651d8beac1599eae5b6,50200023535069,2755441.79,60ec41ba55c00300382672d9,HDFC,Revenue-COD,5eecc6d6449e4f7cfb1c2708,2020-05-06T00:00:00.000Z,NEFT CR-KKBK0000958-BIGFOOT RETAIL SOLUT IONS PRIVATE LIMITED-SLICK ORGANICS PVT LTD-KKBK201276299726,,,net_banking_transfer,23625.03
61b6f652d8beac1599eae5be,50200023535069,2758875.28,60ec41ba55c00300382672d9,HDFC,Revenue-PG-split enabled,5eecc6d6449e4f7cfb1c2708,2020-05-06T00:00:00.000Z,NEFT CR-UTIB0001506-RAZORPAY SOFTWARE PR IVATE LIMITED-SLICK ORGANICS PVT LITD-AX ISCN0050955358,investments,,net_banking_transfer,3433.49
61b6f653d8beac1599eae5c2,50200023535069,2511675.28,60ec41ba55c00300382672d9,HDFC,direct expenses,5eecc6d6449e4f7cfb1c2708,2020-05-06T00:00:00.000Z,57500000443889-TPT-FNF-WEBKLIPPER TECHNO,,,net_banking_transfer,-247200
61b6f654d8beac1599eae5ca,50200023535069,2498915.28,60ec41ba55c00300382672d9,HDFC,direct expenses,5eecc6d6449e4f7cfb1c2708,2020-05-06T00:00:00.000Z,"NEFT DR-YESB0000109-JERONONE TECHNOLOGIE S-NETBANK, MUM-N127201130434805-12760",,,net_banking_transfer,-12760
61b6f655d8beac1599eae5d3,50200023535069,2400635.28,60ec41ba55c00300382672d9,HDFC,direct expenses,5eecc6d6449e4f7cfb1c2708,2020-05-06T00:00:00.000Z,"NEFT DR-ICIC0001944-TUNRAROUND CORPORATE ADVISORS PVT LTD-NETBANK, MUM-N12720113 0434904-98280",,,net_banking_transfer,-98280
61b6f656d8beac1599eae5d9,50200023535069,2310635.28,60ec41ba55c00300382672d9,HDFC,direct expenses,5eecc6d6449e4f7cfb1c2708,2020-05-06T00:00:00.000Z,50200031284040-TPT-90000-BURGEON LAW LLP,,,net_banking_transfer,-90000
61b6f657d8beac1599eae5dd,50200023535069,2201457.28,60ec41ba55c00300382672d9,HDFC,Rental expense,5eecc6d6449e4f7cfb1c2708,2020-05-06T00:00:00.000Z,00921000075586-TPT-MAY RENT 207-ROET BIN DRA,,,net_banking_transfer,-109178
61b6f658d8beac1599eae5e1,50200023535069,2156457.28,60ec41ba55c00300382672d9,HDFC,direct expenses,5eecc6d6449e4f7cfb1c2708,2020-05-06T00:00:00.000Z,"NEFT DR-ANDB0002029-HITESH ARORA-NETBANK , MUM-N127201130451367-45000",,,net_banking_transfer,-45000
61b6f659d8beac1599eae5e8,50200023535069,1833875.28,60ec41ba55c00300382672d9,HDFC,direct expenses,5eecc6d6449e4f7cfb1c2708,2020-05-06T00:00:00.000Z,05892560000649-TPT-322582-DECORPAC INDIA PRIVATE LIMITED,,,net_banking_transfer,-322582
61b6f65ad8beac1599eae5ee,50200023535069,1633875.28,60ec41ba55c00300382672d9,HDFC,direct expenses,5eecc6d6449e4f7cfb1c2708,2020-05-06T00:00:00.000Z,"NEFT DR-YESB0000551-VISTTA COSMETICS-NET BANK, MUM-N127201130443685-200000",,,net_banking_transfer,-200000
61b6f65bd8beac1599eae5f2,50200023535069,1433875.28,60ec41ba55c00300382672d9,HDFC,direct expenses,5eecc6d6449e4f7cfb1c2708,2020-05-07T00:00:00.000Z,"NEFT DR-YESB0000551-VISTTA COSMETICS-NET BANK, MUM-N128201130587573-200000",,,net_banking_transfer,-200000
61b6f65cd8beac1599eae5f8,50200023535069,810606.28,60ec41ba55c00300382672d9,HDFC,direct expenses,5eecc6d6449e4f7cfb1c2708,2020-05-07T00:00:00.000Z,"NEFT DR-YESB0000551-VISTTA COSMETICS-NET BANK, MUM-N128201130597013-623269",,,net_banking_transfer,-623269
61b6f65dd8beac1599eae5fe,50200023535069,736606.28,60ec41ba55c00300382672d9,HDFC,direct expenses,5eecc6d6449e4f7cfb1c2708,2020-05-07T00:00:00.000Z,"NEFT DR-CITI0000002-DHIRAJ-NETBANK, MUM- N128201130597396-74000",,,net_banking_transfer,-74000
61b6f65ed8beac1599eae602,50200023535069,666606.28,60ec41ba55c00300382672d9,HDFC,direct expenses,5eecc6d6449e4f7cfb1c2708,2020-05-07T00:00:00.000Z,"NEFT DR-ICIC0000542-AVANTIKA SUKHIA-NETB ANK, MUM-N128201130597761-70000",,,net_banking_transfer,-70000
61b6f65fd8beac1599eae60b,50200023535069,651606.28,60ec41ba55c00300382672d9,HDFC,direct expenses,5eecc6d6449e4f7cfb1c2708,2020-05-07T00:00:00.000Z,"NEFT DR-SIBL0000555-JAIVEER KUMAR-NETBAN K, MUM-N128201130597891-15000",,,net_banking_transfer,-15000
61b6f660d8beac1599eae60f,50200023535069,641606.28,60ec41ba55c00300382672d9,HDFC,direct expenses,5eecc6d6449e4f7cfb1c2708,2020-05-07T00:00:00.000Z,"NEFT DR-PUNB0398000-MEENA SINGH-NETBANK, MUM-N128201130588847-10000",,,net_banking_transfer,-10000
61b6f661d8beac1599eae612,50200023535069,621606.28,60ec41ba55c00300382672d9,HDFC,direct expenses,5eecc6d6449e4f7cfb1c2708,2020-05-07T00:00:00.000Z,"NEFT DR-SBIN0001189-SANDEEP SINGH-NETBAN K, MUM-N128201130598735-20000",,,net_banking_transfer,-20000
61b6f662d8beac1599eae617,50200023535069,605106.28,60ec41ba55c00300382672d9,HDFC,direct expenses,5eecc6d6449e4f7cfb1c2708,2020-05-07T00:00:00.000Z,"NEFT DR-KKBK0000811-NASIR KHAN-NETBANK, MUM-N128201130599100-16500",,,net_banking_transfer,-16500
61b6f663d8beac1599eae68a,50200023535069,570106.28,60ec41ba55c00300382672d9,HDFC,direct expenses,5eecc6d6449e4f7cfb1c2708,2020-05-07T00:00:00.000Z,NEFT DR-ICIC0003374-SIDDHARTH KANOJIA-NE,,,net_banking_transfer,-35000
61b6f664d8beac1599eae690,50200023535069,564106.28,60ec41ba55c00300382672d9,HDFC,direct expenses,5eecc6d6449e4f7cfb1c2708,2020-05-07T00:00:00.000Z,"NEFT DR-ALLA0210591-CHAMPA DEVI-NETBANK, MUM-N128201130605802-6000",,,net_banking_transfer,-6000
61b6f665d8beac1599eae694,50200023535069,537106.28,60ec41ba55c00300382672d9,HDFC,direct expenses,5eecc6d6449e4f7cfb1c2708,2020-05-07T00:00:00.000Z,"NEFT DR-SYNB0005170-SNEHAL TAYDE-NETBANK , MUM-N128201130602709-27000",,,net_banking_transfer,-27000
61b6f666d8beac1599eae69a,50200023535069,438106.28,60ec41ba55c00300382672d9,HDFC,direct expenses,5eecc6d6449e4f7cfb1c2708,2020-05-07T00:00:00.000Z,"NEFT DR-SBIN0009817-ANIL KUMAR BHATT-NET BANK, MUM-N128201130606029-99000",,,net_banking_transfer,-99000
61b6f667d8beac1599eae69f,50200023535069,396406.28,60ec41ba55c00300382672d9,HDFC,direct expenses,5eecc6d6449e4f7cfb1c2708,2020-05-07T00:00:00.000Z,"NEFT DR-UTIB0000120-ADNAN ALI-NETBANK, M UM-N128201130599707-41700",,,net_banking_transfer,-41700
61b6f668d8beac1599eae6a2,50200023535069,2396406.28,60ec41ba55c00300382672d9,HDFC,Internal Transfers,5eecc6d6449e4f7cfb1c2708,2020-05-07T00:00:00.000Z,IB FUNDS TRANSFER CR-50200035187206 -SL ICK ORGANICS PVT LTD,investments,,Other,2000000
61b6f669d8beac1599eae6ab,50200023535069,2364406.28,60ec41ba55c00300382672d9,HDFC,direct expenses,5eecc6d6449e4f7cfb1c2708,2020-05-07T00:00:00.000Z,00901610080520-TPT-32000-POOJA KAPIL SHR OTRIYA,,,net_banking_transfer,-32000
61b6f66ad8beac1599eae6af,50200023535069,2314406.28,60ec41ba55c00300382672d9,HDFC,direct expenses,5eecc6d6449e4f7cfb1c2708,2020-05-07T00:00:00.000Z,50100301160692-TPT-50000-TARUN GARG,,,net_banking_transfer,-50000
61b6f66bd8beac1599eae6b3,50200023535069,1514406.28,60ec41ba55c00300382672d9,HDFC,direct expenses,5eecc6d6449e4f7cfb1c2708,2020-05-07T00:00:00.000Z,"NEFT DR-YESB0000551-VISTTA COSMETICS-NET BANK, MUM-N128201130607584-800000",,,net_banking_transfer,-800000
61b6f66cd8beac1599eae6b7,50200023535069,1449406.28,60ec41ba55c00300382672d9,HDFC,direct expenses,5eecc6d6449e4f7cfb1c2708,2020-05-07T00:00:00.000Z,"NEFT DR-ICIC0001580-LAAVANYA SHARMA-NETB ANK, MUM-N128201130669668-65000",,,net_banking_transfer,-65000
61b6f66cd8beac1599eae6ba,50200023535069,1439406.28,60ec41ba55c00300382672d9,HDFC,direct expenses,5eecc6d6449e4f7cfb1c2708,2020-05-07T00:00:00.000Z,"NEFT DR-KKBK0004611-ANAMIKA KARN-NETBANK , MUM-N128201130678977-10000",,,net_banking_transfer,-10000
61b6f66dd8beac1599eae6c2,50200023535069,1403776.28,60ec41ba55c00300382672d9,HDFC,Salary/Emp/consultant Expense,5eecc6d6449e4f7cfb1c2708,2020-05-07T00:00:00.000Z,"NEFT DR-UTIB0003142-ARIA DESAI UG ELIZAB ETH THOMAS ALEX-NETBANK, MUM-N1282011306 89025-35630",,,net_banking_transfer,-35630
61b6f66ed8beac1599eae6c7,50200023535069,1404093.28,60ec41ba55c00300382672d9,HDFC,Revenue-Mktplace,5eecc6d6449e4f7cfb1c2708,2020-05-07T00:00:00.000Z,NEFT CR-KKBK0000958-SUPERMARKET GROCERY SUPPLIES PVT LTD-SLICK ORGANICS PVT LTD- KKBK201286458563,shopping,,net_banking_transfer,317
61b6f66fd8beac1599eae6cd,50200023535069,1411396.28,60ec41ba55c00300382672d9,HDFC,Revenue-Mktplace,5eecc6d6449e4f7cfb1c2708,2020-05-07T00:00:00.000Z,NEFT CR-KKBK0000958-SUPERMARKET GROCERY SUPPLIES PVT LTD-SLICK ORGANICS PVT LTD- KKBK201286458566,shopping,,net_banking_transfer,7303
61b6f670d8beac1599eae6d4,50200023535069,1416833.28,60ec41ba55c00300382672d9,HDFC,Revenue-Mktplace,5eecc6d6449e4f7cfb1c2708,2020-05-07T00:00:00.000Z,NEFT CR-KKBK0000958-SUPERMARKET GROCERY,shopping,,net_banking_transfer,5437
61b6f671d8beac1599eae6d7,50200023535069,1333080.28,60ec41ba55c00300382672d9,HDFC,direct expenses,5eecc6d6449e4f7cfb1c2708,2020-05-07T00:00:00.000Z,50100330586095-TPT-83753-DIWAKAR UNIYAL,,,net_banking_transfer,-83753
61b6f672d8beac1599eae6dd,50200023535069,1360001.38,60ec41ba55c00300382672d9,HDFC,Revenue-PG-split enabled,5eecc6d6449e4f7cfb1c2708,2020-05-08T00:00:00.000Z,NEFT CR-UTIB0001506-RAZORPAY SOFTWARE PR IVATE LIMITED-SLICK ORGANICS PVT LITD-AX ISCN0051005881,investments,,net_banking_transfer,26921.1
61b6f673d8beac1599eae6e4,50200023535069,671840.52,60ec41ba55c00300382672d9,HDFC,direct expenses,5eecc6d6449e4f7cfb1c2708,2020-05-08T00:00:00.000Z,ADVANCE PAYMENT OF IMPORT BILL,bills,,Other,-688160.86
61b6f674d8beac1599eae6e7,50200023535069,421840.52,60ec41ba55c00300382672d9,HDFC,direct expenses,5eecc6d6449e4f7cfb1c2708,2020-05-08T00:00:00.000Z,"NEFT DR-ICIC0003430-HASHTAG ORANGE ADVER TISING PVT LTD-NETBANK, MUM-N12920113142 4455-250000",,,net_banking_transfer,-250000
61b6f675d8beac1599eae6eb,50200023535069,426779.09,60ec41ba55c00300382672d9,HDFC,Revenue-COD,5eecc6d6449e4f7cfb1c2708,2020-05-08T00:00:00.000Z,NEFT CR-KKBK0000958-BIGFOOT RETAIL SOLUT IONS PRIVATE LIMITED-SLICK ORGANICS PVT LTD-KKBK201296641710,,,net_banking_transfer,4938.57
61b6f676d8beac1599eae6ee,50200023535069,229422.09,60ec41ba55c00300382672d9,HDFC,Tax,5eecc6d6449e4f7cfb1c2708,2020-05-08T00:00:00.000Z,051030808052005090- CBDT TAX,,,Other,-197357
61b6f677d8beac1599eae6f5,50200023535069,153898.09,60ec41ba55c00300382672d9,HDFC,Tax,5eecc6d6449e4f7cfb1c2708,2020-05-08T00:00:00.000Z,051030808052005136- CBDT TAX,,,Other,-75524
61b6f678d8beac1599eae6fd,50200023535069,143789.09,60ec41ba55c00300382672d9,HDFC,Tax,5eecc6d6449e4f7cfb1c2708,2020-05-08T00:00:00.000Z,051030808052005240- CBDT TAX,,,Other,-10109
61b6f679d8beac1599eae701,50200023535069,111630.09,60ec41ba55c00300382672d9,HDFC,Tax,5eecc6d6449e4f7cfb1c2708,2020-05-08T00:00:00.000Z,051030808052005303- CBDT TAX,,,Other,-32159
61b6f67ad8beac1599eae70a,50200023535069,121759.48,60ec41ba55c00300382672d9,HDFC,Revenue-PG-split enabled,5eecc6d6449e4f7cfb1c2708,2020-05-08T00:00:00.000Z,NEFT CR-UTIB0001506-RAZORPAY SOFTWARE PR IVATE LIMITED-SLICK ORGANICS PVT LITD-AX ISCN0051055583,investments,,net_banking_transfer,10129.39
61b6f67bd8beac1599eae70d,50200023535069,97319.48,60ec41ba55c00300382672d9,HDFC,Tax,5eecc6d6449e4f7cfb1c2708,2020-05-09T00:00:00.000Z,051030809052000052- CBDT TAX,,,Other,-24440
61b6f67cd8beac1599eae710,50200023535069,80040.48,60ec41ba55c00300382672d9,HDFC,Tax,5eecc6d6449e4f7cfb1c2708,2020-05-09T00:00:00.000Z,051030809052000098- CBDT TAX,,,Other,-17279
61b6f67dd8beac1599eae717,50200023535069,79696.48,60ec41ba55c00300382672d9,HDFC,Tax,5eecc6d6449e4f7cfb1c2708,2020-05-09T00:00:00.000Z,051030809052000099- CBDT TAX,,,Other,-344
61b6f67ed8beac1599eae73d,50200023535069,53146.48,60ec41ba55c00300382672d9,HDFC,direct expenses,5eecc6d6449e4f7cfb1c2708,2020-05-09T00:00:00.000Z,POS 514834XXXXXX9486 RAZ*COZY VISION,,,debit_card,-26550
61b6f67fd8beac1599eae740,50200023535069,117701.02,60ec41ba55c00300382672d9,HDFC,Revenue-PG-split enabled,5eecc6d6449e4f7cfb1c2708,2020-05-11T00:00:00.000Z,NEFT CR-UTIB0001506-RAZORPAY SOFTWARE PR IVATE LIMITED-SLICK ORGANICS PVT LITD-AX ISCN0051077241,investments,,net_banking_transfer,64554.54
61b6f680d8beac1599eae744,50200023535069,67453.02,60ec41ba55c00300382672d9,HDFC,direct expenses,5eecc6d6449e4f7cfb1c2708,2020-05-11T00:00:00.000Z,"NEFT DR-PUNB0003500-ADWAIT WEB SOLUTIONS PVT LTD-NETBANK, MUM-N132201133801422-5 0248",,,net_banking_transfer,-50248
61b6f681d8beac1599eae747,50200023535069,29804.02,60ec41ba55c00300382672d9,HDFC,direct expenses,5eecc6d6449e4f7cfb1c2708,2020-05-11T00:00:00.000Z,50200021241300-TPT-37649-AFFLE INDIA LIM ITED,,,net_banking_transfer,-37649
61b6f682d8beac1599eae74f,50200023535069,35628.87,60ec41ba55c00300382672d9,HDFC,Revenue-COD,5eecc6d6449e4f7cfb1c2708,2020-05-11T00:00:00.000Z,NEFT CR-KKBK0000958-BIGFOOT RETAIL SOLUT,,,net_banking_transfer,5824.85
61b6f683d8beac1599eae756,50200023535069,49912.92,60ec41ba55c00300382672d9,HDFC,Revenue-PG-split enabled,5eecc6d6449e4f7cfb1c2708,2020-05-11T00:00:00.000Z,NEFT CR-UTIB0001506-RAZORPAY SOFTWARE PR IVATE LIMITED-SLICK ORGANICS PVT LITD-AX ISCN0051115495,investments,,net_banking_transfer,14284.05
61b6f684d8beac1599eae75c,50200023535069,61715.29,60ec41ba55c00300382672d9,HDFC,Revenue-PG-split enabled,5eecc6d6449e4f7cfb1c2708,2020-05-12T00:00:00.000Z,NEFT CR-UTIB0001506-RAZORPAY SOFTWARE PR IVATE LIMITED-SLICK ORGANICS PVT LITD-AX ISCN0051138723,investments,,net_banking_transfer,11802.37
61b6f684d8beac1599eae763,50200023535069,180110.43,60ec41ba55c00300382672d9,HDFC,Revenue-Mktplace,5eecc6d6449e4f7cfb1c2708,2020-05-12T00:00:00.000Z,NEFT CR-DEUT0797BGL-AMAZON PAY IND PVT L TD-INT AC INTM MKTPLACE-SLICK ORGANICS P VT LTD-051200102GN00001,shopping,,net_banking_transfer,118395.14
61b6f685d8beac1599eae766,50200023535069,90108.43,60ec41ba55c00300382672d9,HDFC,agency/vendor expense,5eecc6d6449e4f7cfb1c2708,2020-05-12T00:00:00.000Z,"NEFT DR-IDFB0021001-CLIKCONIK DIGITAL ME DIA PRIVATE LIMITED-NETBANK, MUM-N133201 134510681-90002",,,net_banking_transfer,-90002
61b6f686d8beac1599eae777,50200023535069,60208.43,60ec41ba55c00300382672d9,HDFC,direct expenses,5eecc6d6449e4f7cfb1c2708,2020-05-12T00:00:00.000Z,"NEFT DR-UTIB0004007-SANJAY PARIHAR-NETBA NK, MUM-N133201134634636-29900",,,net_banking_transfer,-29900
61b6f687d8beac1599eae77e,50200023535069,70861.92,60ec41ba55c00300382672d9,HDFC,Revenue-PG-split enabled,5eecc6d6449e4f7cfb1c2708,2020-05-12T00:00:00.000Z,NEFT CR-UTIB0001506-RAZORPAY SOFTWARE PR IVATE LIMITED-SLICK ORGANICS PVT LITD-AX ISCN0051170001,investments,,net_banking_transfer,10653.49
61b6f688d8beac1599eae784,50200023535069,520861.92,60ec41ba55c00300382672d9,HDFC,Internal Transfers,5eecc6d6449e4f7cfb1c2708,2020-05-13T00:00:00.000Z,IB FUNDS TRANSFER CR-50200035187206 -SL ICK ORGANICS PVT LTD,investments,,Other,450000
61b6f689d8beac1599eae789,50200023535069,533950.09,60ec41ba55c00300382672d9,HDFC,Revenue-PG-split enabled,5eecc6d6449e4f7cfb1c2708,2020-05-13T00:00:00.000Z,NEFT CR-UTIB0001506-RAZORPAY SOFTWARE PR IVATE LIMITED-SLICK ORGANICS PVT LITD-AX ISCN0051183169,investments,,net_banking_transfer,13088.17
61b6f68ad8beac1599eae78c,50200023535069,487150.09,60ec41ba55c00300382672d9,HDFC,direct expenses,5eecc6d6449e4f7cfb1c2708,2020-05-13T00:00:00.000Z,02771610131904-TPT-46800-DIGANT BHATT,,,net_banking_transfer,-46800
61b6f68bd8beac1599eae792,50200023535069,498863.7,60ec41ba55c00300382672d9,HDFC,Revenue-COD,5eecc6d6449e4f7cfb1c2708,2020-05-13T00:00:00.000Z,NEFT CR-KKBK0000958-BIGFOOT RETAIL SOLUT IONS PRIVATE LIMITED-SLICK ORGANICS PVT LTD-KKBK201347304394,,,net_banking_transfer,11713.61
61b6f68cd8beac1599eae79f,50200023535069,530295.7,60ec41ba55c00300382672d9,HDFC,Revenue-Mktplace,5eecc6d6449e4f7cfb1c2708,2020-05-13T00:00:00.000Z,NEFT CR-KKBK0000958-NATURALLY YOU AND ME -SLICK ORGANICS PVT LTD-KKBKH20134746394,investments,,net_banking_transfer,31432
61b6f68dd8beac1599eae7a3,50200023535069,540721.95,60ec41ba55c00300382672d9,HDFC,Revenue-PG-split enabled,5eecc6d6449e4f7cfb1c2708,2020-05-13T00:00:00.000Z,NEFT CR-UTIB0001506-RAZORPAY SOFTWARE PR,,,net_banking_transfer,10426.25
61b6f68ed8beac1599eae7ae,50200023535069,520661.95,60ec41ba55c00300382672d9,HDFC,direct expenses,5eecc6d6449e4f7cfb1c2708,2020-05-13T00:00:00.000Z,"NEFT DR-UTIB0001262-MRN DIGITAL-NETBANK, MUM-N134201135720389-20060",,,net_banking_transfer,-20060
61b6f68fd8beac1599eae7b3,50200023535069,529275.27,60ec41ba55c00300382672d9,HDFC,Revenue-PG-split enabled,5eecc6d6449e4f7cfb1c2708,2020-05-14T00:00:00.000Z,NEFT CR-UTIB0001506-RAZORPAY SOFTWARE PR IVATE LIMITED-SLICK ORGANICS PVT LITD-AX ISCN0051219440,investments,,net_banking_transfer,8613.32
61b6f690d8beac1599eae7b8,50200023535069,535548.74,60ec41ba55c00300382672d9,HDFC,Revenue-PG-split enabled,5eecc6d6449e4f7cfb1c2708,2020-05-14T00:00:00.000Z,NEFT CR-UTIB0001506-RAZORPAY SOFTWARE PR IVATE LIMITED-SLICK ORGANICS PVT LITD-AX ISCN0051243924,investments,,net_banking_transfer,6273.47
61b6f691d8beac1599eae7c4,50200023535069,541180.27,60ec41ba55c00300382672d9,HDFC,Revenue-PG-split enabled,5eecc6d6449e4f7cfb1c2708,2020-05-15T00:00:00.000Z,NEFT CR-UTIB0001506-RAZORPAY SOFTWARE PR IVATE LIMITED-SLICK ORGANICS PVT LITD-AX ISCN0051255822,investments,,net_banking_transfer,5631.53
61b6f692d8beac1599eae7cc,50200023535069,209361.27,60ec41ba55c00300382672d9,HDFC,Utilities/bills,5eecc6d6449e4f7cfb1c2708,2020-05-15T00:00:00.000Z,IB BILLPAY DR-HDFCRM-555153XXXXXX2449,bills,,bill_payment,-331819
61b6f693d8beac1599eae7d4,50200023535069,159361.27,60ec41ba55c00300382672d9,HDFC,direct expenses,5eecc6d6449e4f7cfb1c2708,2020-05-15T00:00:00.000Z,50100106249659-TPT-50000-SAMRIDDH DASGUP TA,,,net_banking_transfer,-50000
61b6f694d8beac1599eae7d8,50200023535069,175023.19,60ec41ba55c00300382672d9,HDFC,Revenue-COD,5eecc6d6449e4f7cfb1c2708,2020-05-15T00:00:00.000Z,NEFT CR-KKBK0000958-BIGFOOT RETAIL SOLUT IONS PRIVATE LIMITED-SLICK ORGANICS PVT LTD-KKBK201367596517,,,net_banking_transfer,15661.92
61b6f695d8beac1599eae7dd,50200023535069,188656.95,60ec41ba55c00300382672d9,HDFC,Revenue-PG-split enabled,5eecc6d6449e4f7cfb1c2708,2020-05-15T00:00:00.000Z,NEFT CR-UTIB0001506-RAZORPAY SOFTWARE PR IVATE LIMITED-SLICK ORGANICS PVT LITD-AX ISCN0051306720,investments,,net_banking_transfer,13633.76
61b6f696d8beac1599eae7e4,50200023535069,163656.95,60ec41ba55c00300382672d9,HDFC,direct expenses,5eecc6d6449e4f7cfb1c2708,2020-05-16T00:00:00.000Z,50100106249659-TPT-25000-SAMRIDDH DASGUP TA,,,net_banking_transfer,-25000
61b6f697d8beac1599eae7e7,50200023535069,176470.11,60ec41ba55c00300382672d9,HDFC,Revenue-PG-split enabled,5eecc6d6449e4f7cfb1c2708,2020-05-16T00:00:00.000Z,NEFT CR-UTIB0001506-RAZORPAY SOFTWARE PR IVATE LIMITED-SLICK ORGANICS PVT LITD-AX ISCN0051312379,investments,,net_banking_transfer,12813.16
61b6f698d8beac1599eae7f1,50200023535069,176344.77,60ec41ba55c00300382672d9,HDFC,bank charges,5eecc6d6449e4f7cfb1c2708,2020-05-16T00:00:00.000Z,.DC INTL POS TXN MARKUP+ST 240420 270420 -MIR2013042505683,,,international_transaction_arbitrage,-125.34
61b6f699d8beac1599eae7f5,50200023535069,192922.34,60ec41ba55c00300382672d9,HDFC,Revenue-PG-split enabled,5eecc6d6449e4f7cfb1c2708,2020-05-16T00:00:00.000Z,NEFT CR-UTIB0001506-RAZORPAY SOFTWARE PR IVATE LIMITED-SLICK ORGANICS PVT LITD-AX ISCN0051336971,investments,,net_banking_transfer,16577.57
61b6f69ad8beac1599eae7fc,50200023535069,192166.93,60ec41ba55c00300382672d9,HDFC,direct expenses,5eecc6d6449e4f7cfb1c2708,2020-05-16T00:00:00.000Z,POS 514834XXXXXX9486 MANYCHAT COM PRO,,,debit_card,-755.41
61b6f69bd8beac1599eae804,50200023535069,195001.93,60ec41ba55c00300382672d9,HDFC,Revenue-Mktplace,5eecc6d6449e4f7cfb1c2708,2020-05-18T00:00:00.000Z,NEFT CR-KKBK0000958-NATURALLY YOU AND ME,,,net_banking_transfer,2835
61b6f69cd8beac1599eae812,50200023535069,247946.19,60ec41ba55c00300382672d9,HDFC,Revenue-PG-split enabled,5eecc6d6449e4f7cfb1c2708,2020-05-18T00:00:00.000Z,NEFT CR-UTIB0001506-RAZORPAY SOFTWARE PR IVATE LIMITED-SLICK ORGANICS PVT LITD-AX ISCN0051346475,investments,,net_banking_transfer,52944.26
61b6f69dd8beac1599eae821,50200023535069,267109.8,60ec41ba55c00300382672d9,HDFC,Revenue-PG-split enabled,5eecc6d6449e4f7cfb1c2708,2020-05-18T00:00:00.000Z,NEFT CR-UTIB0001506-RAZORPAY SOFTWARE PR IVATE LIMITED-SLICK ORGANICS PVT LITD-AX ISCN0051379777,investments,,net_banking_transfer,19163.61
61b6f69ed8beac1599eae833,50200023535069,281591.04,60ec41ba55c00300382672d9,HDFC,Revenue-COD,5eecc6d6449e4f7cfb1c2708,2020-05-18T00:00:00.000Z,NEFT CR-KKBK0000958-BIGFOOT RETAIL SOLUT IONS PRIVATE LIMITED-SLICK ORGANICS PVT LTD-KKBK201397959553,,,net_banking_transfer,14481.24
61b6f69fd8beac1599eae83d,50200023535069,171431.04,60ec41ba55c00300382672d9,HDFC,direct expenses,5eecc6d6449e4f7cfb1c2708,2020-05-18T00:00:00.000Z,"NEFT DR-CITI0000002-OMG NETWORK INDIA PR IVATE LIMITED-NETBANK, MUM-N139201138580 485-110160",,,net_banking_transfer,-110160
61b6f69fd8beac1599eae84c,50200023535069,71431.04,60ec41ba55c00300382672d9,HDFC,direct expenses,5eecc6d6449e4f7cfb1c2708,2020-05-18T00:00:00.000Z,"NEFT DR-INDB0000148-ACQUISORY INDIA CONS ULTING PVT LTD-NETBANK, MUM-N13920113857 6757-100000",,,net_banking_transfer,-100000
61b6f6a0d8beac1599eae855,50200023535069,70456.04,60ec41ba55c00300382672d9,HDFC,direct expenses,5eecc6d6449e4f7cfb1c2708,2020-05-19T00:00:00.000Z,50100097355028-TPT-975-PALLAVI JUNEJA,,,net_banking_transfer,-975
61b6f6a1d8beac1599eae861,50200023535069,86082.09,60ec41ba55c00300382672d9,HDFC,Revenue-PG-split enabled,5eecc6d6449e4f7cfb1c2708,2020-05-19T00:00:00.000Z,NEFT CR-UTIB0001506-RAZORPAY SOFTWARE PR IVATE LIMITED-SLICK ORGANICS PVT LITD-AX ISCN0051390841,investments,,net_banking_transfer,15626.05
61b6f6a2d8beac1599eae873,50200023535069,89960.7,60ec41ba55c00300382672d9,HDFC,Revenue-Mktplace,5eecc6d6449e4f7cfb1c2708,2020-05-19T00:00:00.000Z,IMPS-014011059500-AMAZON SELLER SERVIC-H DFC-XXXXXXXX6004-1344E9OGLEUTHF8ESLICK O RGANICS PVT LTD,shopping,,net_banking_transfer,3878.61
61b6f6a3d8beac1599eae879,50200023535069,177238.25,60ec41ba55c00300382672d9,HDFC,Revenue-Mktplace,5eecc6d6449e4f7cfb1c2708,2020-05-19T00:00:00.000Z,NEFT CR-DEUT0797BGL-AMAZON PAY IND PVT L TD-INT AC INTM MKTPLACE-SLICK ORGANICS P VT LTD-051900106GN00013,shopping,,net_banking_transfer,87277.55
61b6f6a4d8beac1599eae881,50200023535069,177148.2,60ec41ba55c00300382672d9,HDFC,bank charges,5eecc6d6449e4f7cfb1c2708,2020-05-19T00:00:00.000Z,.DC INTL POS TXN MARKUP+ST 010520 020520 -MIR2013850000630,,,international_transaction_arbitrage,-90.05
61b6f6a5d8beac1599eae88b,50200023535069,176756.84,60ec41ba55c00300382672d9,HDFC,bank charges,5eecc6d6449e4f7cfb1c2708,2020-05-19T00:00:00.000Z,.DC INTL POS TXN MARKUP+ST 020520 040520 -MIR2013951879613,,,international_transaction_arbitrage,-391.36
61b6f6a6d8beac1599eae894,50200023535069,176752.81,60ec41ba55c00300382672d9,HDFC,bank charges,5eecc6d6449e4f7cfb1c2708,2020-05-19T00:00:00.000Z,DEBIT CARD PUR ADJ DT 16/05/20,,,Other,-4.03
61b6f6a7d8beac1599eae89a,50200023535069,193706.07,60ec41ba55c00300382672d9,HDFC,Revenue-PG-split enabled,5eecc6d6449e4f7cfb1c2708,2020-05-19T00:00:00.000Z,NEFT CR-UTIB0001506-RAZORPAY SOFTWARE PR,,,net_banking_transfer,16953.26
61b6f6a8d8beac1599eae89f,50200023535069,209407.22,60ec41ba55c00300382672d9,HDFC,Revenue-PG-split enabled,5eecc6d6449e4f7cfb1c2708,2020-05-20T00:00:00.000Z,NEFT CR-UTIB0001506-RAZORPAY SOFTWARE PR IVATE LIMITED-SLICK ORGANICS PVT LITD-AX ISCN0051430452,investments,,net_banking_transfer,15701.15
61b6f6a9d8beac1599eae8a6,50200023535069,204106.58,60ec41ba55c00300382672d9,HDFC,direct expenses,5eecc6d6449e4f7cfb1c2708,2020-05-20T00:00:00.000Z,POS 514834XXXXXX9486 FEEDBACKFIVE,,,debit_card,-5300.64
61b6f6aad8beac1599eae8ae,50200023535069,210925.39,60ec41ba55c00300382672d9,HDFC,Revenue-COD,5eecc6d6449e4f7cfb1c2708,2020-05-20T00:00:00.000Z,NEFT CR-KKBK0000958-BIGFOOT RETAIL SOLUT IONS PRIVATE LIMITED-SLICK ORGANICS PVT LTD-KKBK201418181519,,,net_banking_transfer,6818.81
61b6f6abd8beac1599eae8b3,50200023535069,536644.84,60ec41ba55c00300382672d9,HDFC,Revenue-PG-split enabled,5eecc6d6449e4f7cfb1c2708,2020-05-20T00:00:00.000Z,RTGS CR-UTIB0001506-RAZORPAY SOFTWARE PR IVATE LIMITED --SLICK ORGANICS PVT LITD- UTIBR52020052000334166,,,net_banking_transfer,325719.45
61b6f6acd8beac1599eae8bf,50200023535069,521644.84,60ec41ba55c00300382672d9,HDFC,direct expenses,5eecc6d6449e4f7cfb1c2708,2020-05-20T00:00:00.000Z,50200043297657-TPT-15000-AIDC PRODUCTS I NDIA PRIVATE LIMITED,,,net_banking_transfer,-15000
61b6f6add8beac1599eae8c5,50200023535069,476644.84,60ec41ba55c00300382672d9,HDFC,direct expenses,5eecc6d6449e4f7cfb1c2708,2020-05-20T00:00:00.000Z,"NEFT DR-KKBK0000193-EMPIRICAL PARTNERS L LP-NETBANK, MUM-N141201139937740-45000",,,net_banking_transfer,-45000
61b6f6aed8beac1599eae8cb,50200023535069,472514.84,60ec41ba55c00300382672d9,HDFC,direct expenses,5eecc6d6449e4f7cfb1c2708,2020-05-20T00:00:00.000Z,"NEFT DR-UTIB0000723-VEDIC COMECEUTICALS PVT LTD-NETBANK, MUM-N141201139942525-41 30",,,net_banking_transfer,-4130
61b6f6afd8beac1599eae8d6,50200023535069,586480.06,60ec41ba55c00300382672d9,HDFC,Revenue-PG-split enabled,5eecc6d6449e4f7cfb1c2708,2020-05-21T00:00:00.000Z,NEFT CR-UTIB0001506-RAZORPAY SOFTWARE PR IVATE LIMITED-SLICK ORGANICS PVT LITD-AX ISCN0051468203,investments,,net_banking_transfer,113965.22
61b6f6b0d8beac1599eae8df,50200023535069,599028.96,60ec41ba55c00300382672d9,HDFC,Revenue-PG-split enabled,5eecc6d6449e4f7cfb1c2708,2020-05-21T00:00:00.000Z,NEFT CR-UTIB0001506-RAZORPAY SOFTWARE PR IVATE LIMITED-SLICK ORGANICS PVT LITD-AX ISCN0051489126,investments,,net_banking_transfer,12548.9
61b6f6b1d8beac1599eae8e3,50200023535069,529028.96,60ec41ba55c00300382672d9,HDFC,direct expenses,5eecc6d6449e4f7cfb1c2708,2020-05-21T00:00:00.000Z,"NEFT DR-YESB0000551-VISTTA COSMETICS-NET BANK, MUM-N142201140620400-70000",,,net_banking_transfer,-70000
61b6f6b2d8beac1599eae8e7,50200023535069,412028.96,60ec41ba55c00300382672d9,HDFC,direct expenses,5eecc6d6449e4f7cfb1c2708,2020-05-21T00:00:00.000Z,"NEFT DR-ICIC0001144-FIT TUBER-NETBANK, M UM-N142201140620752-117000",travel,,net_banking_transfer,-117000
61b6f6b3d8beac1599eae8ea,50200023535069,222012.96,60ec41ba55c00300382672d9,HDFC,direct expenses,5eecc6d6449e4f7cfb1c2708,2020-05-21T00:00:00.000Z,NEFT DR-ICIC0003430-HASHTAG ORANGE ADVER,,,net_banking_transfer,-190016
61b6f6b4d8beac1599eae8f2,50200023535069,243141.99,60ec41ba55c00300382672d9,HDFC,Revenue-PG-split enabled,5eecc6d6449e4f7cfb1c2708,2020-05-22T00:00:00.000Z,NEFT CR-UTIB0001506-RAZORPAY SOFTWARE PR IVATE LIMITED-SLICK ORGANICS PVT LITD-AX ISCN0051498459,investments,,net_banking_transfer,21129.03
61b6f6b5d8beac1599eae8f5,50200023535069,240122.74,60ec41ba55c00300382672d9,HDFC,SAAS/tech expense,5eecc6d6449e4f7cfb1c2708,2020-05-22T00:00:00.000Z,POS 514834XXXXXX9486 AMAZON SELLER RE,shopping,,debit_card,-3019.25
61b6f6b6d8beac1599eae8fa,50200023535069,242801.74,60ec41ba55c00300382672d9,HDFC,Revenue-Mktplace,5eecc6d6449e4f7cfb1c2708,2020-05-22T00:00:00.000Z,NEFT CR-KKBK0000958-SUPERMARKET GROCERY SUPPLIES PVT LTD-SLICK ORGANICS PVT LTD- KKBK201438485862,shopping,,net_banking_transfer,2679
61b6f6b7d8beac1599eae902,50200023535069,253595.74,60ec41ba55c00300382672d9,HDFC,Revenue-Mktplace,5eecc6d6449e4f7cfb1c2708,2020-05-22T00:00:00.000Z,NEFT CR-KKBK0000958-SUPERMARKET GROCERY SUPPLIES PVT LTD-SLICK ORGANICS PVT LTD- KKBK201438485974,shopping,,net_banking_transfer,10794
61b6f6b8d8beac1599eae906,50200023535069,265828.74,60ec41ba55c00300382672d9,HDFC,Revenue-Mktplace,5eecc6d6449e4f7cfb1c2708,2020-05-22T00:00:00.000Z,NEFT CR-KKBK0000958-SUPERMARKET GROCERY SUPPLIES PVT LTD-SLICK ORGANICS PVT LTD- KKBK201438485978,shopping,,net_banking_transfer,12233
61b6f6b8d8beac1599eae90c,50200023535069,265990.74,60ec41ba55c00300382672d9,HDFC,Revenue-Mktplace,5eecc6d6449e4f7cfb1c2708,2020-05-22T00:00:00.000Z,NEFT CR-KKBK0000958-SUPERMARKET GROCERY SUPPLIES PVT LTD-SLICK ORGANICS PVT LTD- KKBK201438485966,shopping,,net_banking_transfer,162
61b6f6b9d8beac1599eae913,50200023535069,281708.73,60ec41ba55c00300382672d9,HDFC,Revenue-PG-split enabled,5eecc6d6449e4f7cfb1c2708,2020-05-22T00:00:00.000Z,NEFT CR-UTIB0001506-RAZORPAY SOFTWARE PR IVATE LIMITED-SLICK ORGANICS PVT LITD-AX ISCN0051525353,investments,,net_banking_transfer,15717.99
61b6f6bad8beac1599eae918,50200023535069,281722.27,60ec41ba55c00300382672d9,HDFC,Adjustments/Reversal,5eecc6d6449e4f7cfb1c2708,2020-05-22T00:00:00.000Z,DEBIT CARD PUR ADJ DT 20/05/20,,,Other,13.54
61b6f6bbd8beac1599eae91c,50200023535069,281968.32,60ec41ba55c00300382672d9,HDFC,Revenue-Mktplace,5eecc6d6449e4f7cfb1c2708,2020-05-22T00:00:00.000Z,NEFT CR-ICIC0000104-GOQII TECHNOLOGIES P VT LTD-SLICK ORGANICS PRIVATE LIMITED-CM S1486863466,,,net_banking_transfer,246.05
61b6f6bcd8beac1599eae91f,50200023535069,81968.32,60ec41ba55c00300382672d9,HDFC,direct expenses,5eecc6d6449e4f7cfb1c2708,2020-05-22T00:00:00.000Z,"NEFT DR-KKBK0000208-SYSCOM PACKAGING COM PANY-NETBANK, MUM-N143201141342595-20000 0",,,net_banking_transfer,-200000
61b6f6bdd8beac1599eae925,50200023535069,81958.49,60ec41ba55c00300382672d9,HDFC,bank charges,5eecc6d6449e4f7cfb1c2708,2020-05-23T00:00:00.000Z,DEBIT CARD PUR ADJ DT 22/05/20,,,Other,-9.83
61b6f6bed8beac1599eae92d,50200023535069,62458.49,60ec41ba55c00300382672d9,HDFC,Salary/Emp/consultant Expense,5eecc6d6449e4f7cfb1c2708,2020-05-24T00:00:00.000Z,07072020000661-TPT-BADDI AND GURGAON-BAN SAL TRANSPORT SERVICE,travel,,net_banking_transfer,-19500
61b6f6bfd8beac1599eae930,50200023535069,58819.49,60ec41ba55c00300382672d9,HDFC,direct expenses,5eecc6d6449e4f7cfb1c2708,2020-05-26T00:00:00.000Z,POS 514834XXXXXX9486 FRESHWORKS INC,,,debit_card,-3639
61b6f6c0d8beac1599eae939,50200023535069,233423.86,60ec41ba55c00300382672d9,HDFC,Revenue-PG-split enabled,5eecc6d6449e4f7cfb1c2708,2020-05-26T00:00:00.000Z,NEFT CR-UTIB0001506-RAZORPAY SOFTWARE PR,,,net_banking_transfer,174604.37
61b6f6c1d8beac1599eae93d,50200023535069,447465.36,60ec41ba55c00300382672d9,HDFC,Revenue-Mktplace,5eecc6d6449e4f7cfb1c2708,2020-05-26T00:00:00.000Z,NEFT CR-DEUT0797BGL-AMAZON PAY IND PVT L TD-INT AC INTM MKTPLACE-SLICK ORGANICS P VT LTD-052600539GN00074,shopping,,net_banking_transfer,214041.5
61b6f6c2d8beac1599eae941,50200023535069,447434,60ec41ba55c00300382672d9,HDFC,bank charges,5eecc6d6449e4f7cfb1c2708,2020-05-26T00:00:00.000Z,.DC INTL POS TXN MARKUP+ST 160520 190520 -MIR2014565250857,,,international_transaction_arbitrage,-31.36
61b6f6c3d8beac1599eae948,50200023535069,464499.01,60ec41ba55c00300382672d9,HDFC,Revenue-PG-split enabled,5eecc6d6449e4f7cfb1c2708,2020-05-26T00:00:00.000Z,NEFT CR-UTIB0001506-RAZORPAY SOFTWARE PR IVATE LIMITED-SLICK ORGANICS PVT LITD-AX ISCN0051591404,investments,,net_banking_transfer,17065.01
61b6f6c4d8beac1599eae94d,50200023535069,464678.99,60ec41ba55c00300382672d9,HDFC,Revenue-PG-non-split,5eecc6d6449e4f7cfb1c2708,2020-05-26T00:00:00.000Z,NEFT CR-ICIC0000031-PAYTM E COMMERCE PVT LTD-SLICK ORGANICS PVT LTD-CMS148857585 4,investments,,net_banking_transfer,179.98
61b6f6c5d8beac1599eae951,50200023535069,491592.12,60ec41ba55c00300382672d9,HDFC,Revenue-PG-split enabled,5eecc6d6449e4f7cfb1c2708,2020-05-27T00:00:00.000Z,NEFT CR-UTIB0001506-RAZORPAY SOFTWARE PR IVATE LIMITED-SLICK ORGANICS PVT LITD-AX ISCN0051603770,investments,,net_banking_transfer,26913.13
61b6f6c6d8beac1599eae955,50200023535069,420592.12,60ec41ba55c00300382672d9,HDFC,direct expenses,5eecc6d6449e4f7cfb1c2708,2020-05-27T00:00:00.000Z,"NEFT DR-YESB0000551-VISTTA COSMETICS-NET BANK, MUM-N148201143499684-PART",,,net_banking_transfer,-71000
61b6f6c7d8beac1599eae958,50200023535069,421013.34,60ec41ba55c00300382672d9,HDFC,Revenue-COD,5eecc6d6449e4f7cfb1c2708,2020-05-27T00:00:00.000Z,NEFT CR-KKBK0000958-BIGFOOT RETAIL SOLUT IONS PRIVATE LIMITED-SLICK ORGANICS PVT LTD-KKBK201488888862,,,net_banking_transfer,421.22
61b6f6c8d8beac1599eae961,50200023535069,450674.22,60ec41ba55c00300382672d9,HDFC,Revenue-PG-split enabled,5eecc6d6449e4f7cfb1c2708,2020-05-27T00:00:00.000Z,NEFT CR-UTIB0001506-RAZORPAY SOFTWARE PR IVATE LIMITED-SLICK ORGANICS PVT LITD-AX ISCN0051634027,investments,,net_banking_transfer,29660.88
61b6f6c9d8beac1599eae963,50200023535069,451635.71,60ec41ba55c00300382672d9,HDFC,Revenue-PG-non-split,5eecc6d6449e4f7cfb1c2708,2020-05-27T00:00:00.000Z,NEFT CR-ICIC0000031-PAYTM E COMMERCE PVT LTD-SLICK ORGANICS PVT LTD-CMS148972172 6,investments,,net_banking_transfer,961.49
61b6f6cad8beac1599eae969,50200023535069,473671.24,60ec41ba55c00300382672d9,HDFC,Revenue-PG-split enabled,5eecc6d6449e4f7cfb1c2708,2020-05-28T00:00:00.000Z,NEFT CR-UTIB0001506-RAZORPAY SOFTWARE PR IVATE LIMITED-SLICK ORGANICS PVT LITD-AX ISCN0051646836,investments,,net_banking_transfer,22035.53
61b6f6cbd8beac1599eae977,50200023535069,488161.08,60ec41ba55c00300382672d9,HDFC,Revenue-PG-split enabled,5eecc6d6449e4f7cfb1c2708,2020-05-28T00:00:00.000Z,NEFT CR-UTIB0001506-RAZORPAY SOFTWARE PR,,,net_banking_transfer,14489.84
61b6f6ccd8beac1599eae97e,50200023535069,438161.08,60ec41ba55c00300382672d9,HDFC,direct expenses,5eecc6d6449e4f7cfb1c2708,2020-05-28T00:00:00.000Z,"NEFT DR-DBSS0IN0811-ESSEL PROPACK LIMITE D-NETBANK, MUM-N149201144470089-ADVANCE",,,net_banking_transfer,-50000
61b6f6cdd8beac1599eae989,50200023535069,388161.08,60ec41ba55c00300382672d9,HDFC,SAAS/tech expense,5eecc6d6449e4f7cfb1c2708,2020-05-28T00:00:00.000Z,POS 514834XXXXXX9486 AMAZON PAY INDIA,shopping,,debit_card,-50000
61b6f6ced8beac1599eae98d,50200023535069,402324.49,60ec41ba55c00300382672d9,HDFC,Revenue-PG-split enabled,5eecc6d6449e4f7cfb1c2708,2020-05-29T00:00:00.000Z,NEFT CR-UTIB0001506-RAZORPAY SOFTWARE PR IVATE LIMITED-SLICK ORGANICS PVT LITD-AX ISCN0051688059,investments,,net_banking_transfer,14163.41
61b6f6cfd8beac1599eae99e,50200023535069,454832.86,60ec41ba55c00300382672d9,HDFC,Revenue-COD,5eecc6d6449e4f7cfb1c2708,2020-05-29T00:00:00.000Z,NEFT CR-KKBK0000958-BIGFOOT RETAIL SOLUT IONS PRIVATE LIMITED-SLICK ORGANICS PVT LTD-KKBK201509313189,,,net_banking_transfer,52508.37
61b6f6d0d8beac1599eae9a3,50200023535069,473170.66,60ec41ba55c00300382672d9,HDFC,Revenue-PG-split enabled,5eecc6d6449e4f7cfb1c2708,2020-05-29T00:00:00.000Z,NEFT CR-UTIB0001506-RAZORPAY SOFTWARE PR IVATE LIMITED-SLICK ORGANICS PVT LITD-AX ISCN0051724009,investments,,net_banking_transfer,18337.8
61b6f6d1d8beac1599eae9a5,50200023535069,273170.66,60ec41ba55c00300382672d9,HDFC,direct expenses,5eecc6d6449e4f7cfb1c2708,2020-05-29T00:00:00.000Z,IMPS-015019368059-HASHTAG ORANGE ADVERTI SING PVT LTD-ICIC-XXXXXXXX0094-ABC,,,net_banking_transfer,-200000
61b6f6d2d8beac1599eae9ac,50200023535069,291435.5,60ec41ba55c00300382672d9,HDFC,Revenue-PG-split enabled,5eecc6d6449e4f7cfb1c2708,2020-05-30T00:00:00.000Z,NEFT CR-UTIB0001506-RAZORPAY SOFTWARE PR IVATE LIMITED-SLICK ORGANICS PVT LITD-AX ISCN0051735082,investments,,net_banking_transfer,18264.84
61b6f6d2d8beac1599eae9b1,50200023535069,309799.57,60ec41ba55c00300382672d9,HDFC,Revenue-PG-split enabled,5eecc6d6449e4f7cfb1c2708,2020-05-30T00:00:00.000Z,NEFT CR-UTIB0001506-RAZORPAY SOFTWARE PR IVATE LIMITED-SLICK ORGANICS PVT LITD-AX ISCN0051755058,investments,,net_banking_transfer,18364.07
61b6f6d3d8beac1599eae9b4,50200023535069,259799.57,60ec41ba55c00300382672d9,HDFC,direct expenses,5eecc6d6449e4f7cfb1c2708,2020-05-30T00:00:00.000Z,IMPS-015120370435-HASHTAG ORANGE ADVERTI SING PVT LTD-ICIC-XXXXXXXX0094-ABC,,,net_banking_transfer,-50000
61b6f6d4d8beac1599eae9c4,50200023535069,244506.77,60ec41ba55c00300382672d9,HDFC,direct expenses,5eecc6d6449e4f7cfb1c2708,2020-05-31T00:00:00.000Z,POS 514834XXXXXX9486 RAZ*COZY VISION,,,debit_card,-15292.8
61b6f6d5d8beac1599eae9c9,50200023535069,2744506.77,60ec41ba55c00300382672d9,HDFC,Internal Transfers,5eecc6d6449e4f7cfb1c2708,2020-06-01T00:00:00.000Z,IB FUNDS TRANSFER CR-50200035187206 -SL ICK ORGANICS PVT LTD,investments,,Other,2500000
61b6f6d6d8beac1599eae9ce,50200023535069,1744506.77,60ec41ba55c00300382672d9,HDFC,direct expenses,5eecc6d6449e4f7cfb1c2708,2020-06-01T00:00:00.000Z,"NEFT DR-SCBL0036025-DHRUV MADHOK-NETBANK , MUM-N153201147093214-1000000",,,net_banking_transfer,-1000000
61b6f6d7d8beac1599eae9d6,50200023535069,1680506.77,60ec41ba55c00300382672d9,HDFC,direct expenses,5eecc6d6449e4f7cfb1c2708,2020-06-01T00:00:00.000Z,"NEFT DR-DBSS0IN0811-ESSEL PROPACK LIMITE D-NETBANK, MUM-N153201147095216-64000",,,net_banking_transfer,-64000
61b6f6d8d8beac1599eae9d9,50200023535069,1666346.77,60ec41ba55c00300382672d9,HDFC,direct expenses,5eecc6d6449e4f7cfb1c2708,2020-06-01T00:00:00.000Z,50200032082770-TPT-14160-DAERA HOME & DE SIGN LLP,,,net_banking_transfer,-14160
61b6f6d9d8beac1599eae9de,50200023535069,1654546.77,60ec41ba55c00300382672d9,HDFC,direct expenses,5eecc6d6449e4f7cfb1c2708,2020-06-01T00:00:00.000Z,"NEFT DR-DBSS0IN0811-SARANSH KULKARNI-NET BANK, MUM-N153201147160739-11800",,,net_banking_transfer,-11800
61b6f6dad8beac1599eae9e4,50200023535069,1759864.12,60ec41ba55c00300382672d9,HDFC,Revenue-PG-split enabled,5eecc6d6449e4f7cfb1c2708,2020-06-01T00:00:00.000Z,NEFT CR-UTIB0001506-RAZORPAY SOFTWARE PR IVATE LIMITED-SLICK ORGANICS PVT LITD-AX ISCN0051775372,investments,,net_banking_transfer,105317.35
61b6f6dbd8beac1599eae9eb,50200023535069,1694364.12,60ec41ba55c00300382672d9,HDFC,direct expenses,5eecc6d6449e4f7cfb1c2708,2020-06-01T00:00:00.000Z,"NEFT DR-KKBK0000208-SYSCOM PACKAGING COM PANY-NETBANK, MUM-N153201147196755-65500",,,net_banking_transfer,-65500
61b6f6dcd8beac1599eae9f1,50200023535069,956364.12,60ec41ba55c00300382672d9,HDFC,direct expenses,5eecc6d6449e4f7cfb1c2708,2020-06-01T00:00:00.000Z,"NEFT DR-UTIB0000166-KRAUTER HEALTHCARE LIMITED-NETBANK, MUM-N153201147218936-73 8000",,,net_banking_transfer,-738000
61b6f6ddd8beac1599eae9f3,50200023535069,954171.79,60ec41ba55c00300382672d9,HDFC,direct expenses,5eecc6d6449e4f7cfb1c2708,2020-06-01T00:00:00.000Z,POS 514834XXXXXX9486 SEOPTIMER,,,debit_card,-2192.33
61b6f6ded8beac1599eae9fd,50200023535069,951792.79,60ec41ba55c00300382672d9,HDFC,SAAS/tech expense,5eecc6d6449e4f7cfb1c2708,2020-06-01T00:00:00.000Z,POS 514834XXXXXX9486 AMAZON,shopping,,debit_card,-2379
61b6f6dfd8beac1599eaea01,50200023535069,973793.58,60ec41ba55c00300382672d9,HDFC,Revenue-PG-split enabled,5eecc6d6449e4f7cfb1c2708,2020-06-01T00:00:00.000Z,NEFT CR-UTIB0001506-RAZORPAY SOFTWARE PR IVATE LIMITED-SLICK ORGANICS PVT LITD-AX ISCN0051817616,investments,,net_banking_transfer,22000.79
61b6f6e0d8beac1599eaea05,50200023535069,973094.58,60ec41ba55c00300382672d9,HDFC,direct expenses,5eecc6d6449e4f7cfb1c2708,2020-06-01T00:00:00.000Z,IMPS-015317325743-DISHA THAKKAR-ICIC-XXX XXXXX0188-45689,,,net_banking_transfer,-699
61b6f6e1d8beac1599eaea0c,50200023535069,985932.78,60ec41ba55c00300382672d9,HDFC,Revenue-PG-split enabled,5eecc6d6449e4f7cfb1c2708,2020-06-02T00:00:00.000Z,NEFT CR-UTIB0001506-RAZORPAY SOFTWARE PR IVATE LIMITED-SLICK ORGANICS PVT LITD-AX ISCN0051839062,investments,,net_banking_transfer,12838.2
61b6f6e2d8beac1599eaea12,50200023535069,1199170.52,60ec41ba55c00300382672d9,HDFC,Revenue-Mktplace,5eecc6d6449e4f7cfb1c2708,2020-06-02T00:00:00.000Z,NEFT CR-DEUT0797BGL-AMAZON PAY IND PVT L,shopping,,net_banking_transfer,213237.74
61b6f6e3d8beac1599eaea15,50200023535069,1189720.83,60ec41ba55c00300382672d9,HDFC,direct expenses,5eecc6d6449e4f7cfb1c2708,2020-06-02T00:00:00.000Z,POS 514834XXXXXX9486 STK*SHUTTERSTOCK,,,debit_card,-9449.69
61b6f6e4d8beac1599eaea19,50200023535069,1111960.83,60ec41ba55c00300382672d9,HDFC,agency/vendor expense,5eecc6d6449e4f7cfb1c2708,2020-06-02T00:00:00.000Z,"NEFT DR-IDFB0021001-CLIKCONIK DIGITAL ME DIA PRIVATE LIMITED-NETBANK, MUM-N154201 148972276-77760",,,net_banking_transfer,-77760
61b6f6e5d8beac1599eaea1c,50200023535069,1021888.83,60ec41ba55c00300382672d9,HDFC,direct expenses,5eecc6d6449e4f7cfb1c2708,2020-06-02T00:00:00.000Z,"NEFT DR-CITI0000002-OMG NETWORK INDIA PR IVATE LIMITED-NETBANK, MUM-N154201148960 072-90072",,,net_banking_transfer,-90072
61b6f6e6d8beac1599eaea25,50200023535069,789888.83,60ec41ba55c00300382672d9,HDFC,agency/vendor expense,5eecc6d6449e4f7cfb1c2708,2020-06-02T00:00:00.000Z,"NEFT DR-HSBC0110002-RUSK MEDIA PRIVATE L IMITED-NETBANK, MUM-N154201148982394-232 000",,,net_banking_transfer,-232000
61b6f6e7d8beac1599eaea28,50200023535069,692915.83,60ec41ba55c00300382672d9,HDFC,direct expenses,5eecc6d6449e4f7cfb1c2708,2020-06-02T00:00:00.000Z,57500000443889-TPT-96973-WEBKLIPPER TECH NOLOGIES PRIVATE LIMITED,,,net_banking_transfer,-96973
61b6f6e8d8beac1599eaea2b,50200023535069,692912.76,60ec41ba55c00300382672d9,HDFC,bank charges,5eecc6d6449e4f7cfb1c2708,2020-06-02T00:00:00.000Z,DEBIT CARD PUR ADJ DT 01/06/20,,,Other,-3.07
61b6f6e9d8beac1599eaea34,50200023535069,705247.67,60ec41ba55c00300382672d9,HDFC,Revenue-PG-split enabled,5eecc6d6449e4f7cfb1c2708,2020-06-02T00:00:00.000Z,NEFT CR-UTIB0001506-RAZORPAY SOFTWARE PR IVATE LIMITED-SLICK ORGANICS PVT LITD-AX ISCN0051870277,investments,,net_banking_transfer,12334.91
61b6f6ead8beac1599eaea39,50200023535069,700528.85,60ec41ba55c00300382672d9,HDFC,direct expenses,5eecc6d6449e4f7cfb1c2708,2020-06-02T00:00:00.000Z,POS 514834XXXXXX4081 ONLINE PAYMENT,,,debit_card,-4718.82
61b6f6ebd8beac1599eaea3f,50200023535069,157534.85,60ec41ba55c00300382672d9,HDFC,direct expenses,5eecc6d6449e4f7cfb1c2708,2020-06-03T00:00:00.000Z,"NEFT DR-ICIC0003430-HASHTAG ORANGE ADVER TISING PVT LTD-NETBANK, MUM-N15520114957 5709-542994",,,net_banking_transfer,-542994
61b6f6ebd8beac1599eaea46,50200023535069,167691.49,60ec41ba55c00300382672d9,HDFC,Revenue-PG-split enabled,5eecc6d6449e4f7cfb1c2708,2020-06-03T00:00:00.000Z,NEFT CR-UTIB0001506-RAZORPAY SOFTWARE PR IVATE LIMITED-SLICK ORGANICS PVT LITD-AX ISCN0051899174,investments,,net_banking_transfer,10156.64
61b6f6ecd8beac1599eaea4a,50200023535069,47691.49,60ec41ba55c00300382672d9,HDFC,direct expenses,5eecc6d6449e4f7cfb1c2708,2020-06-03T00:00:00.000Z,"NEFT DR-YESB0000551-VISTTA COSMETICS-NET BANK, MUM-N155201150001218-120000",,,net_banking_transfer,-120000
61b6f6edd8beac1599eaea4e,50200023535069,47683.18,60ec41ba55c00300382672d9,HDFC,bank charges,5eecc6d6449e4f7cfb1c2708,2020-06-03T00:00:00.000Z,DEBIT CARD PUR ADJ DT 02/06/20,,,Other,-8.31
61b6f6eed8beac1599eaea51,50200023535069,129032.46,60ec41ba55c00300382672d9,HDFC,Revenue-COD,5eecc6d6449e4f7cfb1c2708,2020-06-03T00:00:00.000Z,NEFT CR-KKBK0000958-BIGFOOT RETAIL SOLUT IONS PRIVATE LIMITED-SLICK ORGANICS PVT LTD-KKBK201551194040,,,net_banking_transfer,81349.28
61b6f6efd8beac1599eaea57,50200023535069,139819.14,60ec41ba55c00300382672d9,HDFC,Revenue-PG-split enabled,5eecc6d6449e4f7cfb1c2708,2020-06-03T00:00:00.000Z,NEFT CR-UTIB0001506-RAZORPAY SOFTWARE PR,,,net_banking_transfer,10786.68
61b6f6f0d8beac1599eaea5d,50200023535069,154060.74,60ec41ba55c00300382672d9,HDFC,Revenue-PG-split enabled,5eecc6d6449e4f7cfb1c2708,2020-06-04T00:00:00.000Z,NEFT CR-UTIB0001506-RAZORPAY SOFTWARE PR IVATE LIMITED-SLICK ORGANICS PVT LITD-AX ISCN0051951179,investments,,net_banking_transfer,14241.6
61b6f6f1d8beac1599eaea61,50200023535069,151535.74,60ec41ba55c00300382672d9,HDFC,direct expenses,5eecc6d6449e4f7cfb1c2708,2020-06-04T00:00:00.000Z,50200043297657-TPT-2525-AIDC PRODUCTS IN DIA PRIVATE LIMITED,,,net_banking_transfer,-2525
61b6f6f2d8beac1599eaea6a,50200023535069,159462.42,60ec41ba55c00300382672d9,HDFC,Revenue-PG-split enabled,5eecc6d6449e4f7cfb1c2708,2020-06-04T00:00:00.000Z,NEFT CR-UTIB0001506-RAZORPAY SOFTWARE PR IVATE LIMITED-SLICK ORGANICS PVT LITD-AX ISCN0051983080,investments,,net_banking_transfer,7926.68
61b6f6f3d8beac1599eaea6e,50200023535069,92052.42,60ec41ba55c00300382672d9,HDFC,direct expenses,5eecc6d6449e4f7cfb1c2708,2020-06-04T00:00:00.000Z,IMPS-015622305923-VINAY REDDY-YESB-XXXXX XXXXXX3761-ABC,,,net_banking_transfer,-67410
61b6f6f4d8beac1599eaea72,50200023535069,108446.43,60ec41ba55c00300382672d9,HDFC,Revenue-PG-split enabled,5eecc6d6449e4f7cfb1c2708,2020-06-05T00:00:00.000Z,NEFT CR-UTIB0001506-RAZORPAY SOFTWARE PR IVATE LIMITED-SLICK ORGANICS PVT LITD-AX ISCN0051995699,investments,,net_banking_transfer,16394.01
61b6f6f5d8beac1599eaea79,50200023535069,78446.43,60ec41ba55c00300382672d9,HDFC,Internal Transfers,5eecc6d6449e4f7cfb1c2708,2020-06-05T00:00:00.000Z,"SELF - CHQ PAID - KALKAJI, NEW",,,chq,-30000
61b6f6f6d8beac1599eaea81,50200023535069,106840.67,60ec41ba55c00300382672d9,HDFC,Revenue-COD,5eecc6d6449e4f7cfb1c2708,2020-06-05T00:00:00.000Z,NEFT CR-KKBK0000958-BIGFOOT RETAIL SOLUT IONS PRIVATE LIMITED-SLICK ORGANICS PVT LTD-KKBK201571492554,,,net_banking_transfer,28394.24
61b6f6f7d8beac1599eaea84,50200023535069,114615.11,60ec41ba55c00300382672d9,HDFC,Revenue-PG-split enabled,5eecc6d6449e4f7cfb1c2708,2020-06-05T00:00:00.000Z,NEFT CR-UTIB0001506-RAZORPAY SOFTWARE PR IVATE LIMITED-SLICK ORGANICS PVT LITD-AX ISCN0052023133,investments,,net_banking_transfer,7774.44
61b6f6f8d8beac1599eaea88,50200023535069,73063.11,60ec41ba55c00300382672d9,HDFC,direct expenses,5eecc6d6449e4f7cfb1c2708,2020-06-06T00:00:00.000Z,CHQ PAID-MICR CTS-NO-YADAV PACKAGING,,,chq,-41552
61b6f6f9d8beac1599eaea8b,50200023535069,90346.39,60ec41ba55c00300382672d9,HDFC,Revenue-PG-split enabled,5eecc6d6449e4f7cfb1c2708,2020-06-06T00:00:00.000Z,NEFT CR-UTIB0001506-RAZORPAY SOFTWARE PR IVATE LIMITED-SLICK ORGANICS PVT LITD-AX ISCN0052030435,investments,,net_banking_transfer,17283.28
61b6f6fad8beac1599eaea96,50200023535069,57946.39,60ec41ba55c00300382672d9,HDFC,direct expenses,5eecc6d6449e4f7cfb1c2708,2020-06-06T00:00:00.000Z,"NEFT DR-CITI0000014-SURFBOATS SOLUTIONS PRIVATE LIMITED-NETBANK, MUM-N1582011527 88227-32400",,,net_banking_transfer,-32400
61b6f6fbd8beac1599eaea98,50200023535069,72880.1,60ec41ba55c00300382672d9,HDFC,Revenue-PG-split enabled,5eecc6d6449e4f7cfb1c2708,2020-06-06T00:00:00.000Z,NEFT CR-UTIB0001506-RAZORPAY SOFTWARE PR IVATE LIMITED-SLICK ORGANICS PVT LITD-AX ISCN0052051972,investments,,net_banking_transfer,14933.71
61b6f6fcd8beac1599eaea9f,50200023535069,84782.1,60ec41ba55c00300382672d9,HDFC,Revenue-Mktplace,5eecc6d6449e4f7cfb1c2708,2020-06-06T00:00:00.000Z,NEFT CR-KKBK0000958-SUPERMARKET GROCERY,shopping,,net_banking_transfer,11902
61b6f6fdd8beac1599eaeaa6,50200023535069,86015.1,60ec41ba55c00300382672d9,HDFC,Revenue-Mktplace,5eecc6d6449e4f7cfb1c2708,2020-06-06T00:00:00.000Z,NEFT CR-KKBK0000958-SUPERMARKET GROCERY SUPPLIES PVT LTD-SLICK ORGANICS PVT LTD- KKBK201581728517,shopping,,net_banking_transfer,1233
61b6f6fed8beac1599eaeaaa,50200023535069,90885.1,60ec41ba55c00300382672d9,HDFC,Revenue-Mktplace,5eecc6d6449e4f7cfb1c2708,2020-06-06T00:00:00.000Z,NEFT CR-KKBK0000958-SUPERMARKET GROCERY SUPPLIES PVT LTD-SLICK ORGANICS PVT LTD- KKBK201581728522,shopping,,net_banking_transfer,4870
61b6f6ffd8beac1599eaeab2,50200023535069,91274.6,60ec41ba55c00300382672d9,HDFC,Revenue-Mktplace,5eecc6d6449e4f7cfb1c2708,2020-06-06T00:00:00.000Z,NEFT CR-KKBK0000958-SUPERMARKET GROCERY SUPPLIES PVT LTD-SLICK ORGANICS PVT LTD- KKBK201581728484,shopping,,net_banking_transfer,389.5
61b6f700d8beac1599eaeab6,50200023535069,92134.1,60ec41ba55c00300382672d9,HDFC,Revenue-Mktplace,5eecc6d6449e4f7cfb1c2708,2020-06-06T00:00:00.000Z,NEFT CR-KKBK0000958-SUPERMARKET GROCERY SUPPLIES PVT LTD-SLICK ORGANICS PVT LTD- KKBK201581728566,shopping,,net_banking_transfer,859.5
61b6f701d8beac1599eaeabb,50200023535069,97325.6,60ec41ba55c00300382672d9,HDFC,Revenue-Mktplace,5eecc6d6449e4f7cfb1c2708,2020-06-06T00:00:00.000Z,NEFT CR-KKBK0000958-SUPERMARKET GROCERY SUPPLIES PVT LTD-SLICK ORGANICS PVT LTD- KKBK201581728654,shopping,,net_banking_transfer,5191.5
61b6f702d8beac1599eaeabf,50200023535069,2597325.6,60ec41ba55c00300382672d9,HDFC,Internal Transfers,5eecc6d6449e4f7cfb1c2708,2020-06-07T00:00:00.000Z,IB FUNDS TRANSFER CR-50200035187206 -SL ICK ORGANICS PVT LTD,investments,,Other,2500000
61b6f703d8beac1599eaeac1,50200023535069,2523325.6,60ec41ba55c00300382672d9,HDFC,direct expenses,5eecc6d6449e4f7cfb1c2708,2020-06-07T00:00:00.000Z,"NEFT DR-CITI0000002-DHIRAJ-NETBANK, MUM- N159201153622261-74000",,,net_banking_transfer,-74000
61b6f704d8beac1599eaeac8,50200023535069,2453325.6,60ec41ba55c00300382672d9,HDFC,direct expenses,5eecc6d6449e4f7cfb1c2708,2020-06-07T00:00:00.000Z,"NEFT DR-ICIC0000542-AVANTIKA SUKHIA-NETB ANK, MUM-N159201153622328-70000",,,net_banking_transfer,-70000
61b6f704d8beac1599eaeacd,50200023535069,2438325.6,60ec41ba55c00300382672d9,HDFC,direct expenses,5eecc6d6449e4f7cfb1c2708,2020-06-07T00:00:00.000Z,"NEFT DR-SIBL0000555-JAIVEER KUMAR-NETBAN K, MUM-N159201153618757-15000",,,net_banking_transfer,-15000
61b6f705d8beac1599eaead0,50200023535069,2428325.6,60ec41ba55c00300382672d9,HDFC,direct expenses,5eecc6d6449e4f7cfb1c2708,2020-06-07T00:00:00.000Z,"NEFT DR-PUNB0398000-MEENA SINGH-NETBANK, MUM-N159201153618784-10000",,,net_banking_transfer,-10000
61b6f706d8beac1599eaead9,50200023535069,2408325.6,60ec41ba55c00300382672d9,HDFC,direct expenses,5eecc6d6449e4f7cfb1c2708,2020-06-07T00:00:00.000Z,"NEFT DR-SBIN0001189-SANDEEP SINGH-NETBAN K, MUM-N159201153630390-20000",,,net_banking_transfer,-20000
61b6f707d8beac1599eaeae1,50200023535069,2391825.6,60ec41ba55c00300382672d9,HDFC,direct expenses,5eecc6d6449e4f7cfb1c2708,2020-06-07T00:00:00.000Z,"NEFT DR-KKBK0000811-NASIR KHAN-NETBANK, MUM-N159201153618853-16500",,,net_banking_transfer,-16500
61b6f708d8beac1599eaeae7,50200023535069,2356825.6,60ec41ba55c00300382672d9,HDFC,direct expenses,5eecc6d6449e4f7cfb1c2708,2020-06-07T00:00:00.000Z,NEFT DR-ICIC0003374-SIDDHARTH KANOJIA-NE,,,net_banking_transfer,-35000
61b6f709d8beac1599eaeaef,50200023535069,2350825.6,60ec41ba55c00300382672d9,HDFC,direct expenses,5eecc6d6449e4f7cfb1c2708,2020-06-07T00:00:00.000Z,"NEFT DR-ALLA0210591-CHAMPA DEVI-NETBANK, MUM-N159201153618933-6000",,,net_banking_transfer,-6000
61b6f70ad8beac1599eaeaf4,50200023535069,2323825.6,60ec41ba55c00300382672d9,HDFC,direct expenses,5eecc6d6449e4f7cfb1c2708,2020-06-07T00:00:00.000Z,"NEFT DR-SYNB0005170-SNEHAL TAYDE-NETBANK , MUM-N159201153626019-27000",,,net_banking_transfer,-27000
61b6f70bd8beac1599eaeaf9,50200023535069,2282125.6,60ec41ba55c00300382672d9,HDFC,direct expenses,5eecc6d6449e4f7cfb1c2708,2020-06-07T00:00:00.000Z,"NEFT DR-UTIB0000120-ADNAN ALI-NETBANK, M UM-N159201153619042-41700",,,net_banking_transfer,-41700
61b6f70cd8beac1599eaeafe,50200023535069,2250125.6,60ec41ba55c00300382672d9,HDFC,direct expenses,5eecc6d6449e4f7cfb1c2708,2020-06-07T00:00:00.000Z,00901610080520-TPT-32000-POOJA KAPIL SHR OTRIYA,,,net_banking_transfer,-32000
61b6f70dd8beac1599eaeb03,50200023535069,2215125.6,60ec41ba55c00300382672d9,HDFC,direct expenses,5eecc6d6449e4f7cfb1c2708,2020-06-07T00:00:00.000Z,50100301160692-TPT-35000-TARUN GARG,,,net_banking_transfer,-35000
61b6f70ed8beac1599eaeb0a,50200023535069,2214677.6,60ec41ba55c00300382672d9,HDFC,direct expenses,5eecc6d6449e4f7cfb1c2708,2020-06-07T00:00:00.000Z,50100097355028-TPT-448-PALLAVI JUNEJA,,,net_banking_transfer,-448
61b6f70fd8beac1599eaeb0c,50200023535069,2183372.6,60ec41ba55c00300382672d9,HDFC,Salary/Emp/consultant Expense,5eecc6d6449e4f7cfb1c2708,2020-06-07T00:00:00.000Z,"NEFT DR-UTIB0003142-ARIA DESAI UG ELIZAB ETH THOMAS ALEX-NETBANK, MUM-N1592011536 19351-31305",,,net_banking_transfer,-31305
61b6f710d8beac1599eaeb15,50200023535069,2117372.6,60ec41ba55c00300382672d9,HDFC,direct expenses,5eecc6d6449e4f7cfb1c2708,2020-06-07T00:00:00.000Z,50100330586095-TPT-66000-DIWAKAR UNIYAL,,,net_banking_transfer,-66000
61b6f711d8beac1599eaeb1a,50200023535069,1917372.6,60ec41ba55c00300382672d9,HDFC,direct expenses,5eecc6d6449e4f7cfb1c2708,2020-06-07T00:00:00.000Z,02711930004579-TPT-200000-DHRUV BHASIN,,,net_banking_transfer,-200000
61b6f712d8beac1599eaeb1e,50200023535069,1717372.6,60ec41ba55c00300382672d9,HDFC,direct expenses,5eecc6d6449e4f7cfb1c2708,2020-06-07T00:00:00.000Z,"NEFT DR-SCBL0036025-DHRUV MADHOK-NETBANK , MUM-N159201153620329-200000",,,net_banking_transfer,-200000
61b6f713d8beac1599eaeb26,50200023535069,1517372.6,60ec41ba55c00300382672d9,HDFC,direct expenses,5eecc6d6449e4f7cfb1c2708,2020-06-07T00:00:00.000Z,"NEFT DR-SCBL0036025-DHRUV MADHOK-NETBANK , MUM-N159201153635379-200000",,,net_banking_transfer,-200000
61b6f714d8beac1599eaeb33,50200023535069,1317372.6,60ec41ba55c00300382672d9,HDFC,direct expenses,5eecc6d6449e4f7cfb1c2708,2020-06-07T00:00:00.000Z,"NEFT DR-SCBL0036025-DHRUV MADHOK-NETBANK , MUM-N159201153632480-200000",,,net_banking_transfer,-200000
61b6f715d8beac1599eaeb3b,50200023535069,1117372.6,60ec41ba55c00300382672d9,HDFC,direct expenses,5eecc6d6449e4f7cfb1c2708,2020-06-07T00:00:00.000Z,"NEFT DR-SCBL0036025-DHRUV MADHOK-NETBANK , MUM-N159201153635471-200000",,,net_banking_transfer,-200000
61b6f716d8beac1599eaeb4e,50200023535069,1099372.6,60ec41ba55c00300382672d9,HDFC,direct expenses,5eecc6d6449e4f7cfb1c2708,2020-06-07T00:00:00.000Z,50100301160692-TPT-MAY BALANCE-TARUN GAR G,,,net_banking_transfer,-18000
61b6f717d8beac1599eaeb63,50200023535069,1093572.6,60ec41ba55c00300382672d9,HDFC,Tax,5eecc6d6449e4f7cfb1c2708,2020-06-07T00:00:00.000Z,051030807062012078- CBDT TAX,,,Other,-5800
61b6f718d8beac1599eaeb77,50200023535069,1073878.6,60ec41ba55c00300382672d9,HDFC,Tax,5eecc6d6449e4f7cfb1c2708,2020-06-07T00:00:00.000Z,051030807062012241- CBDT TAX,,,Other,-19694
61b6f719d8beac1599eaeb7e,50200023535069,1058640.6,60ec41ba55c00300382672d9,HDFC,Tax,5eecc6d6449e4f7cfb1c2708,2020-06-07T00:00:00.000Z,051030807062012398- CBDT TAX,,,Other,-15238
61b6f71ad8beac1599eaeb84,50200023535069,1051642.6,60ec41ba55c00300382672d9,HDFC,Tax,5eecc6d6449e4f7cfb1c2708,2020-06-07T00:00:00.000Z,051030807062012558- CBDT TAX,,,Other,-6998
61b6f71bd8beac1599eaeb8e,50200023535069,957107.6,60ec41ba55c00300382672d9,HDFC,Tax,5eecc6d6449e4f7cfb1c2708,2020-06-07T00:00:00.000Z,051030807062012671- CBDT TAX,,,Other,-94535
61b6f71cd8beac1599eaeb95,50200023535069,858107.6,60ec41ba55c00300382672d9,HDFC,direct expenses,5eecc6d6449e4f7cfb1c2708,2020-06-08T00:00:00.000Z,02771610131904-TPT-MAY-DIGANT BHATT,,,net_banking_transfer,-99000
61b6f71cd8beac1599eaeb9d,50200023535069,828207.6,60ec41ba55c00300382672d9,HDFC,direct expenses,5eecc6d6449e4f7cfb1c2708,2020-06-08T00:00:00.000Z,"NEFT DR-UTIB0004007-SANJAY PARIHAR-NETBA NK, MUM-N160201153857505-29900",,,net_banking_transfer,-29900
61b6f71ed8beac1599eaebb3,50200023535069,828665.94,60ec41ba55c00300382672d9,HDFC,Revenue-Mktplace,5eecc6d6449e4f7cfb1c2708,2020-06-08T00:00:00.000Z,NEFT CR-DEUT0797BGL-FLIPKART INTERNET P LTD-INT AC FO R INTERMEDIARY-SLICK ORGAN ICS PVT LTD-060800132GN00015,shopping,,net_banking_transfer,458.34
61b6f71fd8beac1599eaebba,50200023535069,873459.31,60ec41ba55c00300382672d9,HDFC,Revenue-PG-split enabled,5eecc6d6449e4f7cfb1c2708,2020-06-08T00:00:00.000Z,NEFT CR-UTIB0001506-RAZORPAY SOFTWARE PR IVATE LIMITED-SLICK ORGANICS PVT LITD-AX ISCN0052065649,investments,,net_banking_transfer,44793.37
61b6f720d8beac1599eaebc0,50200023535069,794403.31,60ec41ba55c00300382672d9,HDFC,direct expenses,5eecc6d6449e4f7cfb1c2708,2020-06-08T00:00:00.000Z,"NEFT DR-CITI0000032-TRADETRACKER INDIA L LP-NETBANK, MUM-N160201153935721-79056",,,net_banking_transfer,-79056
61b6f720d8beac1599eaebc5,50200023535069,594403.31,60ec41ba55c00300382672d9,HDFC,direct expenses,5eecc6d6449e4f7cfb1c2708,2020-06-08T00:00:00.000Z,"NEFT DR-SCBL0036025-DHRUV MADHOK-NETBANK , MUM-N160201153936185-200000",,,net_banking_transfer,-200000
61b6f721d8beac1599eaebcd,50200023535069,394403.31,60ec41ba55c00300382672d9,HDFC,direct expenses,5eecc6d6449e4f7cfb1c2708,2020-06-08T00:00:00.000Z,"NEFT DR-SCBL0036025-DHRUV MADHOK-NETBANK , MUM-N160201153931656-200000",,,net_banking_transfer,-200000
61b6f722d8beac1599eaebd5,50200023535069,394385.61,60ec41ba55c00300382672d9,HDFC,direct expenses,5eecc6d6449e4f7cfb1c2708,2020-06-08T00:00:00.000Z,.IMPS P2P 015019368059#29/05/2020 300520 -MIR2015878319293,,,net_banking_transfer,-17.7
61b6f723d8beac1599eaebdd,50200023535069,388422.95,60ec41ba55c00300382672d9,HDFC,direct expenses,5eecc6d6449e4f7cfb1c2708,2020-06-08T00:00:00.000Z,POS 514834XXXXXX9486 CCAVENUE IT,bills,,debit_card,-5962.66
61b6f724d8beac1599eaebe8,50200023535069,388297.85,60ec41ba55c00300382672d9,HDFC,bank charges,5eecc6d6449e4f7cfb1c2708,2020-06-08T00:00:00.000Z,.DC INTL POS TXN MARKUP+ST 220520 300520 -MIR2015878338663,,,international_transaction_arbitrage,-125.1
61b6f725d8beac1599eaebee,50200023535069,388079.5,60ec41ba55c00300382672d9,HDFC,bank charges,5eecc6d6449e4f7cfb1c2708,2020-06-08T00:00:00.000Z,.DC INTL POS TXN MARKUP+ST 190520 300520 -MIR2015878338650,,,international_transaction_arbitrage,-218.35
61b6f726d8beac1599eaebf4,50200023535069,273751.5,60ec41ba55c00300382672d9,HDFC,direct expenses,5eecc6d6449e4f7cfb1c2708,2020-06-08T00:00:00.000Z,"NEFT DR-INDB0000148-ACQUISORY INDIA CONS ULTING PVT LTD-NETBANK, MUM-N16020115436 2785-114328",,,net_banking_transfer,-114328
61b6f727d8beac1599eaebfe,50200023535069,183751.5,60ec41ba55c00300382672d9,HDFC,direct expenses,5eecc6d6449e4f7cfb1c2708,2020-06-08T00:00:00.000Z,05892560000649-TPT-90000-DECORPAC INDIA PRIVATE LIMITED,,,net_banking_transfer,-90000
61b6f728d8beac1599eaec06,50200023535069,185144.89,60ec41ba55c00300382672d9,HDFC,Revenue-Mktplace,5eecc6d6449e4f7cfb1c2708,2020-06-08T00:00:00.000Z,NEFT CR-DEUT0797BGL-FLIPKART INTERNET PV TLTD-SLICK ORGANICS PVT LTD-060800144GN0 0039,shopping,,net_banking_transfer,1393.39
61b6f729d8beac1599eaec0d,50200023535069,194353.05,60ec41ba55c00300382672d9,HDFC,Revenue-COD,5eecc6d6449e4f7cfb1c2708,2020-06-08T00:00:00.000Z,NEFT CR-KKBK0000958-BIGFOOT RETAIL SOLUT,,,net_banking_transfer,9208.16
61b6f72ad8beac1599eaec14,50200023535069,164353.05,60ec41ba55c00300382672d9,HDFC,direct expenses,5eecc6d6449e4f7cfb1c2708,2020-06-08T00:00:00.000Z,FCGPR052052365 : MISC COMMISSION INC TRA DE FINANCE,loans,lender_transaction,Other,-30000
61b6f72bd8beac1599eaec19,50200023535069,177592.6,60ec41ba55c00300382672d9,HDFC,Revenue-PG-split enabled,5eecc6d6449e4f7cfb1c2708,2020-06-08T00:00:00.000Z,NEFT CR-UTIB0001506-RAZORPAY SOFTWARE PR IVATE LIMITED-SLICK ORGANICS PVT LITD-AX ISCN0052124447,investments,,net_banking_transfer,13239.55
61b6f72cd8beac1599eaec21,50200023535069,114592.6,60ec41ba55c00300382672d9,HDFC,direct expenses,5eecc6d6449e4f7cfb1c2708,2020-06-08T00:00:00.000Z,"NEFT DR-BKDN0450123-ARTISTO DESIGNZ-NETB ANK, MUM-N160201154913573-63000",,,net_banking_transfer,-63000
61b6f72dd8beac1599eaec23,50200023535069,111892.6,60ec41ba55c00300382672d9,HDFC,Tax,5eecc6d6449e4f7cfb1c2708,2020-06-09T00:00:00.000Z,CGST-MISC COMMISSION INC TRADE FINANCE-N CB2016180423091,loans,lender_transaction,Other,-2700
61b6f72ed8beac1599eaec2b,50200023535069,109192.6,60ec41ba55c00300382672d9,HDFC,Tax,5eecc6d6449e4f7cfb1c2708,2020-06-09T00:00:00.000Z,SGST-MISC COMMISSION INC TRADE FINANCE-N CB2016180423091,loans,lender_transaction,Other,-2700
61b6f72fd8beac1599eaec31,50200023535069,109410.34,60ec41ba55c00300382672d9,HDFC,Revenue-PG-non-split,5eecc6d6449e4f7cfb1c2708,2020-06-09T00:00:00.000Z,NEFT CR-ICIC0000031-PAYTM E COMMERCE PVT LTD-SLICK ORGANICS PVT LTD-CMS150302098 4,investments,,net_banking_transfer,217.74
61b6f730d8beac1599eaec34,50200023535069,128500.51,60ec41ba55c00300382672d9,HDFC,Revenue-PG-split enabled,5eecc6d6449e4f7cfb1c2708,2020-06-09T00:00:00.000Z,NEFT CR-UTIB0001506-RAZORPAY SOFTWARE PR IVATE LIMITED-SLICK ORGANICS PVT LITD-AX ISCN0052138528,investments,,net_banking_transfer,19090.17
61b6f731d8beac1599eaec3c,50200023535069,128596.8,60ec41ba55c00300382672d9,HDFC,Revenue-Mktplace,5eecc6d6449e4f7cfb1c2708,2020-06-09T00:00:00.000Z,IMPS-016111348996-AMAZON SELLER SERVIC-H DFC-XXXXXXXX6004-2VEJJJBISK2AZ1TBSLICK O RGANICS PVT LTD,shopping,,net_banking_transfer,96.29
61b6f732d8beac1599eaec42,50200023535069,51790.8,60ec41ba55c00300382672d9,HDFC,direct expenses,5eecc6d6449e4f7cfb1c2708,2020-06-09T00:00:00.000Z,"NEFT DR-DBSS0IN0811-ESSEL PROPACK LIMITE D-NETBANK, MUM-N161201155283744-76806",,,net_banking_transfer,-76806
61b6f733d8beac1599eaec51,50200023535069,335295.98,60ec41ba55c00300382672d9,HDFC,Revenue-Mktplace,5eecc6d6449e4f7cfb1c2708,2020-06-09T00:00:00.000Z,NEFT CR-DEUT0797BGL-AMAZON PAY IND PVT L TD-INT AC INTM MKTPLACE-SLICK ORGANICS P VT LTD-060900191GN00205,shopping,,net_banking_transfer,283505.18
61b6f734d8beac1599eaec55,50200023535069,344470,60ec41ba55c00300382672d9,HDFC,Revenue-PG-split enabled,5eecc6d6449e4f7cfb1c2708,2020-06-09T00:00:00.000Z,NEFT CR-UTIB0001506-RAZORPAY SOFTWARE PR IVATE LIMITED-SLICK ORGANICS PVT LITD-AX ISCN0052171192,investments,,net_banking_transfer,9174.02
61b6f735d8beac1599eaec58,50200023535069,356979.91,60ec41ba55c00300382672d9,HDFC,Revenue-PG-split enabled,5eecc6d6449e4f7cfb1c2708,2020-06-10T00:00:00.000Z,NEFT CR-UTIB0001506-RAZORPAY SOFTWARE PR IVATE LIMITED-SLICK ORGANICS PVT LITD-AX ISCN0052185831,investments,,net_banking_transfer,12509.91
61b6f736d8beac1599eaec5f,50200023535069,191979.91,60ec41ba55c00300382672d9,HDFC,direct expenses,5eecc6d6449e4f7cfb1c2708,2020-06-10T00:00:00.000Z,NEFT DR-YESB0000551-VISTTA COSMETICS-NET,,,net_banking_transfer,-165000
61b6f737d8beac1599eaec66,50200023535069,191974.01,60ec41ba55c00300382672d9,HDFC,direct expenses,5eecc6d6449e4f7cfb1c2708,2020-06-10T00:00:00.000Z,.IMPS P2P 015120370435#30/05/2020 310520 -MIR2016180682182,,,net_banking_transfer,-5.9
61b6f738d8beac1599eaec6f,50200023535069,179152.01,60ec41ba55c00300382672d9,HDFC,direct expenses,5eecc6d6449e4f7cfb1c2708,2020-06-10T00:00:00.000Z,"NEFT DR-KKBK0004611-ANAMIKA KARN-NETBANK , MUM-N162201156695372-12822",,,net_banking_transfer,-12822
61b6f739d8beac1599eaec78,50200023535069,154152.01,60ec41ba55c00300382672d9,HDFC,direct expenses,5eecc6d6449e4f7cfb1c2708,2020-06-10T00:00:00.000Z,50200017446840-TPT-INVERTER-JMD MANCHAND A ELECTRONICS,,,net_banking_transfer,-25000
61b6f739d8beac1599eaec94,50200023535069,179602.67,60ec41ba55c00300382672d9,HDFC,Revenue-COD,5eecc6d6449e4f7cfb1c2708,2020-06-10T00:00:00.000Z,NEFT CR-KKBK0000958-BIGFOOT RETAIL SOLUT IONS PRIVATE LIMITED-SLICK ORGANICS PVT LTD-KKBK201622306070,,,net_banking_transfer,25450.66
61b6f73ad8beac1599eaec98,50200023535069,192655.34,60ec41ba55c00300382672d9,HDFC,Revenue-PG-split enabled,5eecc6d6449e4f7cfb1c2708,2020-06-10T00:00:00.000Z,NEFT CR-UTIB0001506-RAZORPAY SOFTWARE PR IVATE LIMITED-SLICK ORGANICS PVT LITD-AX ISCN0052216803,investments,,net_banking_transfer,13052.67
61b6f73bd8beac1599eaec9f,50200023535069,142655.34,60ec41ba55c00300382672d9,HDFC,SAAS/tech expense,5eecc6d6449e4f7cfb1c2708,2020-06-10T00:00:00.000Z,POS 514834XXXXXX9486 AMAZON PAY INDIA,shopping,,debit_card,-50000
61b6f73cd8beac1599eaeca4,50200023535069,154548.82,60ec41ba55c00300382672d9,HDFC,Revenue-PG-split enabled,5eecc6d6449e4f7cfb1c2708,2020-06-11T00:00:00.000Z,NEFT CR-UTIB0001506-RAZORPAY SOFTWARE PR IVATE LIMITED-SLICK ORGANICS PVT LITD-AX ISCN0052236351,investments,,net_banking_transfer,11893.48
61b6f73dd8beac1599eaecae,50200023535069,153414.82,60ec41ba55c00300382672d9,HDFC,SAAS/tech expense,5eecc6d6449e4f7cfb1c2708,2020-06-11T00:00:00.000Z,POS 514834XXXXXX9486 AMAZON,shopping,,debit_card,-1134
61b6f73ed8beac1599eaecb2,50200023535069,175097.63,60ec41ba55c00300382672d9,HDFC,Revenue-PG-split enabled,5eecc6d6449e4f7cfb1c2708,2020-06-11T00:00:00.000Z,NEFT CR-UTIB0001506-RAZORPAY SOFTWARE PR IVATE LIMITED-SLICK ORGANICS PVT LITD-AX ISCN0052265071,investments,,net_banking_transfer,21682.81
61b6f73fd8beac1599eaecb8,50200023535069,175505.61,60ec41ba55c00300382672d9,HDFC,Revenue-Mktplace,5eecc6d6449e4f7cfb1c2708,2020-06-12T00:00:00.000Z,NEFT CR-DEUT0797BGL-FLIPKART INTERNET P LTD-INT AC FO R INTERMEDIARY-SLICK ORGAN ICS PVT LTD-061200092GN00250,shopping,,net_banking_transfer,407.98
61b6f740d8beac1599eaece1,50200023535069,197272.16,60ec41ba55c00300382672d9,HDFC,Revenue-PG-split enabled,5eecc6d6449e4f7cfb1c2708,2020-06-12T00:00:00.000Z,NEFT CR-UTIB0001506-RAZORPAY SOFTWARE PR IVATE LIMITED-SLICK ORGANICS PVT LITD-AX ISCN0052279768,investments,,net_banking_transfer,21766.55
61b6f741d8beac1599eaece4,50200023535069,219340.35,60ec41ba55c00300382672d9,HDFC,Revenue-COD,5eecc6d6449e4f7cfb1c2708,2020-06-12T00:00:00.000Z,NEFT CR-KKBK0000958-BIGFOOT RETAIL SOLUT IONS PRIVATE LIMITED-SLICK ORGANICS PVT LTD-KKBK201642612152,,,net_banking_transfer,22068.19
61b6f742d8beac1599eaeced,50200023535069,238693.84,60ec41ba55c00300382672d9,HDFC,Revenue-PG-split enabled,5eecc6d6449e4f7cfb1c2708,2020-06-12T00:00:00.000Z,NEFT CR-UTIB0001506-RAZORPAY SOFTWARE PR,,,net_banking_transfer,19353.49
61b6f743d8beac1599eaed03,50200023535069,237768.7,60ec41ba55c00300382672d9,HDFC,direct expenses,5eecc6d6449e4f7cfb1c2708,2020-06-14T00:00:00.000Z,POS 514834XXXXXX9486 DNH*GODADDY.COM,,,debit_card,-925.14
61b6f744d8beac1599eaed18,50200023535069,228092.7,60ec41ba55c00300382672d9,HDFC,direct expenses,5eecc6d6449e4f7cfb1c2708,2020-06-14T00:00:00.000Z,POS 514834XXXXXX9486 PAYPAL *ORGANICB,,,debit_card,-9676
61b6f745d8beac1599eaed21,50200023535069,230185.15,60ec41ba55c00300382672d9,HDFC,Revenue-Mktplace,5eecc6d6449e4f7cfb1c2708,2020-06-15T00:00:00.000Z,NEFT CR-DEUT0797BGL-FLIPKART INTERNET P LTD-INT AC FO R INTERMEDIARY-SLICK ORGAN ICS PVT LTD-061500298GN00171,shopping,,net_banking_transfer,2092.45
61b6f746d8beac1599eaed26,50200023535069,322887.66,60ec41ba55c00300382672d9,HDFC,Revenue-PG-split enabled,5eecc6d6449e4f7cfb1c2708,2020-06-15T00:00:00.000Z,NEFT CR-UTIB0001506-RAZORPAY SOFTWARE PR IVATE LIMITED-SLICK ORGANICS PVT LITD-AX ISCN0052339020,investments,,net_banking_transfer,92702.51
61b6f747d8beac1599eaed2c,50200023535069,326298.66,60ec41ba55c00300382672d9,HDFC,Revenue-Mktplace,5eecc6d6449e4f7cfb1c2708,2020-06-15T00:00:00.000Z,NEFT CR-KKBK0000958-SUPERMARKET GROCERY SUPPLIES PVT LTD-SLICK ORGANICS PVT LTD- KKBK201672825200,shopping,,net_banking_transfer,3411
61b6f748d8beac1599eaed30,50200023535069,331147.93,60ec41ba55c00300382672d9,HDFC,Revenue-Mktplace,5eecc6d6449e4f7cfb1c2708,2020-06-15T00:00:00.000Z,4060000130-TIMES INTERNET LIMITED NODAL,,,Other,4849.27
61b6f749d8beac1599eaed34,50200023535069,331057.25,60ec41ba55c00300382672d9,HDFC,bank charges,5eecc6d6449e4f7cfb1c2708,2020-06-15T00:00:00.000Z,.DC INTL POS TXN MARKUP+ST 010620 020620 -MIR2016384699849,,,international_transaction_arbitrage,-90.68
61b6f74ad8beac1599eaed3c,50200023535069,331051.35,60ec41ba55c00300382672d9,HDFC,direct expenses,5eecc6d6449e4f7cfb1c2708,2020-06-15T00:00:00.000Z,.IMPS P2P 015317325743#01/06/2020 020620 -MIR2016384712140,,,net_banking_transfer,-5.9
61b6f74bd8beac1599eaed3f,50200023535069,330660.74,60ec41ba55c00300382672d9,HDFC,bank charges,5eecc6d6449e4f7cfb1c2708,2020-06-15T00:00:00.000Z,.DC INTL POS TXN MARKUP+ST 020620 030620 -MIR2016385245472,,,international_transaction_arbitrage,-390.61
61b6f74cd8beac1599eaed42,50200023535069,330654.84,60ec41ba55c00300382672d9,HDFC,direct expenses,5eecc6d6449e4f7cfb1c2708,2020-06-15T00:00:00.000Z,.IMPS P2P 015622305923#04/06/2020 050620 -MIR2016486158665,,,net_banking_transfer,-5.9
61b6f74dd8beac1599eaed4a,50200023535069,339543.19,60ec41ba55c00300382672d9,HDFC,Revenue-PG-split enabled,5eecc6d6449e4f7cfb1c2708,2020-06-15T00:00:00.000Z,NEFT CR-UTIB0001506-RAZORPAY SOFTWARE PR IVATE LIMITED-SLICK ORGANICS PVT LITD-AX ISCN0052414125,investments,,net_banking_transfer,8888.35
61b6f74ed8beac1599eaed4f,50200023535069,346201.73,60ec41ba55c00300382672d9,HDFC,Revenue-Mktplace,5eecc6d6449e4f7cfb1c2708,2020-06-15T00:00:00.000Z,NEFT CR-ICIC0000105-MANASH LIFETYLE PVT LTD-SLICKORGANICSPRIVATELIMITEDMPGGN-ICI B201670094621,,,net_banking_transfer,6658.54
61b6f74fd8beac1599eaed56,50200023535069,370370.12,60ec41ba55c00300382672d9,HDFC,Revenue-PG-split enabled,5eecc6d6449e4f7cfb1c2708,2020-06-16T00:00:00.000Z,NEFT CR-UTIB0001506-RAZORPAY SOFTWARE PR IVATE LIMITED-SLICK ORGANICS PVT LITD-AX ISCN0052439904,investments,,net_banking_transfer,24168.39
61b6f750d8beac1599eaed60,50200023535069,386096.01,60ec41ba55c00300382672d9,HDFC,Revenue-Mktplace,5eecc6d6449e4f7cfb1c2708,2020-06-16T00:00:00.000Z,IMPS-016811374912-AMAZON SELLER SERVIC-H,shopping,,net_banking_transfer,15725.89
61b6f751d8beac1599eaed68,50200023535069,664668.05,60ec41ba55c00300382672d9,HDFC,Revenue-Mktplace,5eecc6d6449e4f7cfb1c2708,2020-06-16T00:00:00.000Z,NEFT CR-DEUT0797BGL-AMAZON PAY IND PVT L TD-INT AC INTM MKTPLACE-SLICK ORGANICS P VT LTD-061600168GN00322,shopping,,net_banking_transfer,278572.04
61b6f751d8beac1599eaed6d,50200023535069,664666.85,60ec41ba55c00300382672d9,HDFC,bank charges,5eecc6d6449e4f7cfb1c2708,2020-06-16T00:00:00.000Z,DEBIT CARD PUR ADJ DT 14/06/20,,,Other,-1.2
61b6f752d8beac1599eaed70,50200023535069,725532.17,60ec41ba55c00300382672d9,HDFC,Revenue-PG-split enabled,5eecc6d6449e4f7cfb1c2708,2020-06-16T00:00:00.000Z,NEFT CR-UTIB0001506-RAZORPAY SOFTWARE PR IVATE LIMITED-SLICK ORGANICS PVT LITD-AX ISCN0052482359,investments,,net_banking_transfer,60865.32
61b6f753d8beac1599eaed7c,50200023535069,724772.49,60ec41ba55c00300382672d9,HDFC,direct expenses,5eecc6d6449e4f7cfb1c2708,2020-06-16T00:00:00.000Z,POS 514834XXXXXX9486 MANYCHAT COM PRO,,,debit_card,-759.68
61b6f754d8beac1599eaed82,50200023535069,674772.49,60ec41ba55c00300382672d9,HDFC,SAAS/tech expense,5eecc6d6449e4f7cfb1c2708,2020-06-17T00:00:00.000Z,POS 514834XXXXXX9486 AMAZON,shopping,,debit_card,-50000
61b6f755d8beac1599eaed88,50200023535069,676174.84,60ec41ba55c00300382672d9,HDFC,Revenue-Mktplace,5eecc6d6449e4f7cfb1c2708,2020-06-17T00:00:00.000Z,NEFT CR-DEUT0797BGL-FLIPKART INTERNET P LTD-INT AC FO R INTERMEDIARY-SLICK ORGAN ICS PVT LTD-061700086GN00104,shopping,,net_banking_transfer,1402.35
61b6f756d8beac1599eaed90,50200023535069,754732.45,60ec41ba55c00300382672d9,HDFC,Revenue-PG-split enabled,5eecc6d6449e4f7cfb1c2708,2020-06-17T00:00:00.000Z,NEFT CR-UTIB0001506-RAZORPAY SOFTWARE PR IVATE LIMITED-SLICK ORGANICS PVT LITD-AX ISCN0052498969,investments,,net_banking_transfer,78557.61
61b6f757d8beac1599eaeda1,50200023535069,755195.07,60ec41ba55c00300382672d9,HDFC,Revenue-PG-non-split,5eecc6d6449e4f7cfb1c2708,2020-06-17T00:00:00.000Z,NEFT CR-ICIC0000031-PAYTM E COMMERCE PVT LTD-SLICK ORGANICS PVT LTD-CMS151083549 9,investments,,net_banking_transfer,462.62
61b6f758d8beac1599eaeda9,50200023535069,777958.16,60ec41ba55c00300382672d9,HDFC,Revenue-COD,5eecc6d6449e4f7cfb1c2708,2020-06-17T00:00:00.000Z,NEFT CR-KKBK0000958-BIGFOOT RETAIL SOLUT IONS PRIVATE LIMITED-SLICK ORGANICS PVT LTD-KKBK201693274079,,,net_banking_transfer,22763.09
61b6f759d8beac1599eaedb0,50200023535069,778769,60ec41ba55c00300382672d9,HDFC,Revenue-Mktplace,5eecc6d6449e4f7cfb1c2708,2020-06-17T00:00:00.000Z,NEFT CR-DEUT0797BGL-FLIPKART INTERNET PV TLTD-SLICK ORGANICS PVT LTD-061700090GN0 0144,shopping,,net_banking_transfer,810.84
61b6f75ad8beac1599eaedb5,50200023535069,785270.24,60ec41ba55c00300382672d9,HDFC,Revenue-PG-split enabled,5eecc6d6449e4f7cfb1c2708,2020-06-17T00:00:00.000Z,NEFT CR-UTIB0001506-RAZORPAY SOFTWARE PR IVATE LIMITED-SLICK ORGANICS PVT LITD-AX ISCN0052527641,investments,,net_banking_transfer,6501.24
61b6f75bd8beac1599eaedbf,50200023535069,620270.24,60ec41ba55c00300382672d9,HDFC,direct expenses,5eecc6d6449e4f7cfb1c2708,2020-06-17T00:00:00.000Z,IMPS-016920354531-VISTTA COSMETICS-YESB- XXXXXXXXXXX1450-ABC,,,net_banking_transfer,-165000
61b6f75cd8beac1599eaedc2,50200023535069,600178.24,60ec41ba55c00300382672d9,HDFC,direct expenses,5eecc6d6449e4f7cfb1c2708,2020-06-18T00:00:00.000Z,50100301160692-TPT-20092-TARUN GARG,,,net_banking_transfer,-20092
61b6f75dd8beac1599eaedc7,50200023535069,558778.24,60ec41ba55c00300382672d9,HDFC,direct expenses,5eecc6d6449e4f7cfb1c2708,2020-06-18T00:00:00.000Z,02771610131904-TPT-41400-DIGANT BHATT,,,net_banking_transfer,-41400
61b6f75ed8beac1599eaedce,50200023535069,2058778.24,60ec41ba55c00300382672d9,HDFC,Internal Transfers,5eecc6d6449e4f7cfb1c2708,2020-06-18T00:00:00.000Z,IB FUNDS TRANSFER CR-50200035187206 -SL ICK ORGANICS PVT LTD,investments,,Other,1500000
61b6f75fd8beac1599eaedd5,50200023535069,2073489.63,60ec41ba55c00300382672d9,HDFC,Revenue-PG-split enabled,5eecc6d6449e4f7cfb1c2708,2020-06-18T00:00:00.000Z,NEFT CR-UTIB0001506-RAZORPAY SOFTWARE PR IVATE LIMITED-SLICK ORGANICS PVT LITD-AX ISCN0052558280,investments,,net_banking_transfer,14711.39
61b6f760d8beac1599eaede8,50200023535069,2073451.37,60ec41ba55c00300382672d9,HDFC,bank charges,5eecc6d6449e4f7cfb1c2708,2020-06-18T00:00:00.000Z,.DC INTL POS TXN MARKUP+ST 140620 160620 -MIR2017099136796,,,international_transaction_arbitrage,-38.26
61b6f761d8beac1599eaedee,50200023535069,2031753.37,60ec41ba55c00300382672d9,HDFC,direct expenses,5eecc6d6449e4f7cfb1c2708,2020-06-18T00:00:00.000Z,"NEFT DR-CNRB0000349-USHA ENGINEERING WOR KS-NETBANK, MUM-N170201163511816-41698",,,net_banking_transfer,-41698
61b6f762d8beac1599eaedf1,50200023535069,2033965.14,60ec41ba55c00300382672d9,HDFC,Revenue-PG-non-split,5eecc6d6449e4f7cfb1c2708,2020-06-18T00:00:00.000Z,CRV POS 514834XXXXXX9486 160620 PAYPAL *,,,refund,2211.77
61b6f763d8beac1599eaedf8,50200023535069,2033961.56,60ec41ba55c00300382672d9,HDFC,bank charges,5eecc6d6449e4f7cfb1c2708,2020-06-18T00:00:00.000Z,DEBIT CARD PUR ADJ DT 16/06/20,,,Other,-3.58
61b6f764d8beac1599eaedfd,50200023535069,2042343.91,60ec41ba55c00300382672d9,HDFC,Revenue-PG-split enabled,5eecc6d6449e4f7cfb1c2708,2020-06-18T00:00:00.000Z,NEFT CR-UTIB0001506-RAZORPAY SOFTWARE PR IVATE LIMITED-SLICK ORGANICS PVT LITD-AX ISCN0052594633,investments,,net_banking_transfer,8382.35
61b6f765d8beac1599eaee02,50200023535069,2057358.11,60ec41ba55c00300382672d9,HDFC,Revenue-PG-split enabled,5eecc6d6449e4f7cfb1c2708,2020-06-19T00:00:00.000Z,NEFT CR-UTIB0001506-RAZORPAY SOFTWARE PR IVATE LIMITED-SLICK ORGANICS PVT LITD-AX ISCN0052609391,investments,,net_banking_transfer,15014.2
61b6f766d8beac1599eaee06,50200023535069,2058912.25,60ec41ba55c00300382672d9,HDFC,Revenue-Mktplace,5eecc6d6449e4f7cfb1c2708,2020-06-19T00:00:00.000Z,NEFT CR-DEUT0797BGL-FLIPKART INTERNET P LTD-INT AC FO R INTERMEDIARY-SLICK ORGAN ICS PVT LTD-061900093GN00018,shopping,,net_banking_transfer,1554.14
61b6f767d8beac1599eaee10,50200023535069,2060636.09,60ec41ba55c00300382672d9,HDFC,Revenue-Mktplace,5eecc6d6449e4f7cfb1c2708,2020-06-19T00:00:00.000Z,NEFT CR-DEUT0797BGL-FLIPKART INTERNET PV TLTD-SLICK ORGANICS PVT LTD-061900110GN0 0069,shopping,,net_banking_transfer,1723.84
61b6f768d8beac1599eaee18,50200023535069,2057586.61,60ec41ba55c00300382672d9,HDFC,SAAS/tech expense,5eecc6d6449e4f7cfb1c2708,2020-06-19T00:00:00.000Z,POS 514834XXXXXX9486 AMAZON SELLER RE,shopping,,debit_card,-3049.48
61b6f769d8beac1599eaee21,50200023535069,436462.91,60ec41ba55c00300382672d9,HDFC,direct expenses,5eecc6d6449e4f7cfb1c2708,2020-06-19T00:00:00.000Z,ADVANCE PAYMENT OF IMPORT BILL,bills,,Other,-1621123.7
61b6f76ad8beac1599eaee26,50200023535069,448215.17,60ec41ba55c00300382672d9,HDFC,Revenue-COD,5eecc6d6449e4f7cfb1c2708,2020-06-19T00:00:00.000Z,NEFT CR-KKBK0000958-BIGFOOT RETAIL SOLUT IONS PRIVATE LIMITED-SLICK ORGANICS PVT LTD-KKBK201713605202,,,net_banking_transfer,11752.26
61b6f76bd8beac1599eaee2d,50200023535069,460743.63,60ec41ba55c00300382672d9,HDFC,Revenue-PG-split enabled,5eecc6d6449e4f7cfb1c2708,2020-06-19T00:00:00.000Z,NEFT CR-UTIB0001506-RAZORPAY SOFTWARE PR IVATE LIMITED-SLICK ORGANICS PVT LITD-AX ISCN0052642327,investments,,net_banking_transfer,12528.46
61b6f76cd8beac1599eaee32,50200023535069,468708.07,60ec41ba55c00300382672d9,HDFC,Revenue-PG-split enabled,5eecc6d6449e4f7cfb1c2708,2020-06-20T00:00:00.000Z,NEFT CR-UTIB0001506-RAZORPAY SOFTWARE PR,,,net_banking_transfer,7964.44
61b6f76dd8beac1599eaee3d,50200023535069,463367.27,60ec41ba55c00300382672d9,HDFC,direct expenses,5eecc6d6449e4f7cfb1c2708,2020-06-20T00:00:00.000Z,POS 514834XXXXXX9486 FEEDBACKFIVE,,,debit_card,-5340.8
61b6f76ed8beac1599eaee41,50200023535069,463349.57,60ec41ba55c00300382672d9,HDFC,direct expenses,5eecc6d6449e4f7cfb1c2708,2020-06-20T00:00:00.000Z,.IMPS P2P 016920354531#17/06/2020 180620 -MIR2017204164933,,,net_banking_transfer,-17.7
61b6f76fd8beac1599eaee47,50200023535069,463318.06,60ec41ba55c00300382672d9,HDFC,bank charges,5eecc6d6449e4f7cfb1c2708,2020-06-20T00:00:00.000Z,.DC INTL POS TXN MARKUP+ST 160620 180620 -MIR2017204164921,,,international_transaction_arbitrage,-31.51
61b6f76fd8beac1599eaee4c,50200023535069,463312.57,60ec41ba55c00300382672d9,HDFC,bank charges,5eecc6d6449e4f7cfb1c2708,2020-06-20T00:00:00.000Z,DEBIT CARD PUR ADJ DT 19/06/20,,,Other,-5.49
61b6f770d8beac1599eaee4f,50200023535069,472009.19,60ec41ba55c00300382672d9,HDFC,Revenue-PG-split enabled,5eecc6d6449e4f7cfb1c2708,2020-06-20T00:00:00.000Z,NEFT CR-UTIB0001506-RAZORPAY SOFTWARE PR IVATE LIMITED-SLICK ORGANICS PVT LITD-AX ISCN0052675902,investments,,net_banking_transfer,8696.62
61b6f771d8beac1599eaee55,50200023535069,465216.8,60ec41ba55c00300382672d9,HDFC,direct expenses,5eecc6d6449e4f7cfb1c2708,2020-06-20T00:00:00.000Z,POS 514834XXXXXX9486 HOTJAR,,,debit_card,-6792.39
61b6f772d8beac1599eaee5d,50200023535069,469845.56,60ec41ba55c00300382672d9,HDFC,Revenue-Mktplace,5eecc6d6449e4f7cfb1c2708,2020-06-22T00:00:00.000Z,NEFT CR-DEUT0797BGL-FLIPKART INTERNET PV TLTD-SLICK ORGANICS PVT LTD-062200110GN0 0068,shopping,,net_banking_transfer,4628.76
61b6f773d8beac1599eaee5f,50200023535069,473631.78,60ec41ba55c00300382672d9,HDFC,Revenue-Mktplace,5eecc6d6449e4f7cfb1c2708,2020-06-22T00:00:00.000Z,NEFT CR-DEUT0797BGL-FLIPKART INTERNET P LTD-INT AC FO R INTERMEDIARY-SLICK ORGAN ICS PVT LTD-062200123GN00134,shopping,,net_banking_transfer,3786.22
61b6f774d8beac1599eaee68,50200023535069,527058.12,60ec41ba55c00300382672d9,HDFC,Revenue-PG-split enabled,5eecc6d6449e4f7cfb1c2708,2020-06-22T00:00:00.000Z,NEFT CR-UTIB0001506-RAZORPAY SOFTWARE PR IVATE LIMITED-SLICK ORGANICS PVT LITD-AX ISCN0052688808,investments,,net_banking_transfer,53426.34
61b6f775d8beac1599eaee6d,50200023535069,510566.37,60ec41ba55c00300382672d9,HDFC,Refund,5eecc6d6449e4f7cfb1c2708,2020-06-22T00:00:00.000Z,"NEFT DR-SBIN0001181-SHIV SUMAN-NETBANK, MUM-N174201165360129-REFUND",,,net_banking_transfer,-16491.75
61b6f776d8beac1599eaee70,50200023535069,460566.37,60ec41ba55c00300382672d9,HDFC,SAAS/tech expense,5eecc6d6449e4f7cfb1c2708,2020-06-22T00:00:00.000Z,POS 514834XXXXXX9486 AMAZON PAY INDIA,shopping,,debit_card,-50000
61b6f777d8beac1599eaee7e,50200023535069,465079.37,60ec41ba55c00300382672d9,HDFC,Revenue-Mktplace,5eecc6d6449e4f7cfb1c2708,2020-06-22T00:00:00.000Z,NEFT CR-KKBK0000958-SUPERMARKET GROCERY SUPPLIES PVT LTD-SLICK ORGANICS PVT LTD- KKBK201743860296,shopping,,net_banking_transfer,4513
61b6f778d8beac1599eaee83,50200023535069,468926.37,60ec41ba55c00300382672d9,HDFC,Revenue-Mktplace,5eecc6d6449e4f7cfb1c2708,2020-06-22T00:00:00.000Z,NEFT CR-KKBK0000958-SUPERMARKET GROCERY SUPPLIES PVT LTD-SLICK ORGANICS PVT LTD- KKBK201743860344,shopping,,net_banking_transfer,3847
61b6f779d8beac1599eaee87,50200023535069,476730.37,60ec41ba55c00300382672d9,HDFC,Revenue-Mktplace,5eecc6d6449e4f7cfb1c2708,2020-06-22T00:00:00.000Z,NEFT CR-KKBK0000958-SUPERMARKET GROCERY,shopping,,net_banking_transfer,7804
61b6f77ad8beac1599eaee8b,50200023535069,478498.87,60ec41ba55c00300382672d9,HDFC,Revenue-Mktplace,5eecc6d6449e4f7cfb1c2708,2020-06-22T00:00:00.000Z,NEFT CR-KKBK0000958-SUPERMARKET GROCERY SUPPLIES PVT LTD-SLICK ORGANICS PVT LTD- KKBK201743860373,shopping,,net_banking_transfer,1768.5
61b6f77bd8beac1599eaee8e,50200023535069,483192.37,60ec41ba55c00300382672d9,HDFC,Revenue-Mktplace,5eecc6d6449e4f7cfb1c2708,2020-06-22T00:00:00.000Z,NEFT CR-KKBK0000958-SUPERMARKET GROCERY SUPPLIES PVT LTD-SLICK ORGANICS PVT LTD- KKBK201743860713,shopping,,net_banking_transfer,4693.5
61b6f77cd8beac1599eaee97,50200023535069,485481.87,60ec41ba55c00300382672d9,HDFC,Revenue-Mktplace,5eecc6d6449e4f7cfb1c2708,2020-06-22T00:00:00.000Z,NEFT CR-KKBK0000958-SUPERMARKET GROCERY SUPPLIES PVT LTD-SLICK ORGANICS PVT LTD- KKBK201743861140,shopping,,net_banking_transfer,2289.5
61b6f77dd8beac1599eaee99,50200023535069,500636.37,60ec41ba55c00300382672d9,HDFC,Revenue-Mktplace,5eecc6d6449e4f7cfb1c2708,2020-06-22T00:00:00.000Z,NEFT CR-KKBK0000958-SUPERMARKET GROCERY SUPPLIES PVT LTD-SLICK ORGANICS PVT LTD- KKBK201743861134,shopping,,net_banking_transfer,15154.5
61b6f77ed8beac1599eaee9d,50200023535069,391458.37,60ec41ba55c00300382672d9,HDFC,direct expenses,5eecc6d6449e4f7cfb1c2708,2020-06-22T00:00:00.000Z,00921000075586-TPT-JUNE20-ROET BINDRA,,,net_banking_transfer,-109178
61b6f77fd8beac1599eaeea4,50200023535069,391775.37,60ec41ba55c00300382672d9,HDFC,Revenue-Mktplace,5eecc6d6449e4f7cfb1c2708,2020-06-22T00:00:00.000Z,POS REF 514834******9486-06/21 AMAZON,shopping,,refund,317
61b6f780d8beac1599eaeead,50200023535069,431848.37,60ec41ba55c00300382672d9,HDFC,Revenue-Mktplace,5eecc6d6449e4f7cfb1c2708,2020-06-22T00:00:00.000Z,NEFT CR-KKBK0000958-NATURALLY YOU AND ME -SLICK ORGANICS PVT LTD-KKBKH20174645220,investments,,net_banking_transfer,40073
61b6f781d8beac1599eaeeb6,50200023535069,455096.49,60ec41ba55c00300382672d9,HDFC,Revenue-PG-split enabled,5eecc6d6449e4f7cfb1c2708,2020-06-22T00:00:00.000Z,NEFT CR-UTIB0001506-RAZORPAY SOFTWARE PR IVATE LIMITED-SLICK ORGANICS PVT LITD-AX ISCN0052721898,investments,,net_banking_transfer,23248.12
61b6f782d8beac1599eaeeba,50200023535069,420096.49,60ec41ba55c00300382672d9,HDFC,direct expenses,5eecc6d6449e4f7cfb1c2708,2020-06-22T00:00:00.000Z,IMPS-017418376784-VINAY REDDY-YESB-XXXXX XXXXXX3761-ADVANCE,,,net_banking_transfer,-35000
61b6f783d8beac1599eaeec2,50200023535069,420097.49,60ec41ba55c00300382672d9,HDFC,Revenue-PG-split enabled,5eecc6d6449e4f7cfb1c2708,2020-06-22T00:00:00.000Z,IMPS-017423436915-CASHFREE PRIVATE LIM-H DFC-XXXXXX7325-BANK DETAILS VALIDATION M EESHO,,,net_banking_transfer,1
61b6f784d8beac1599eaeec6,50200023535069,433823.15,60ec41ba55c00300382672d9,HDFC,Revenue-PG-split enabled,5eecc6d6449e4f7cfb1c2708,2020-06-23T00:00:00.000Z,NEFT CR-UTIB0001506-RAZORPAY SOFTWARE PR IVATE LIMITED-SLICK ORGANICS PVT LITD-AX ISCN0052736368,investments,,net_banking_transfer,13725.66
61b6f785d8beac1599eaeec9,50200023535069,452091.63,60ec41ba55c00300382672d9,HDFC,Revenue-Mktplace,5eecc6d6449e4f7cfb1c2708,2020-06-23T00:00:00.000Z,IMPS-017511062056-AMAZON SELLER SERVIC-H,shopping,,net_banking_transfer,18268.48
61b6f786d8beac1599eaeecf,50200023535069,714431.7,60ec41ba55c00300382672d9,HDFC,Revenue-Mktplace,5eecc6d6449e4f7cfb1c2708,2020-06-23T00:00:00.000Z,NEFT CR-DEUT0797BGL-AMAZON PAY IND PVT L TD-INT AC INTM MKTPLACE-SLICK ORGANICS P VT LTD-062300139GN00190,shopping,,net_banking_transfer,262340.07
61b6f786d8beac1599eaeed5,50200023535069,714305.54,60ec41ba55c00300382672d9,HDFC,bank charges,5eecc6d6449e4f7cfb1c2708,2020-06-23T00:00:00.000Z,.DC INTL POS TXN MARKUP+ST 190620 200620 -MIR2017406862832,,,international_transaction_arbitrage,-126.16
61b6f787d8beac1599eaeeea,50200023535069,714309.11,60ec41ba55c00300382672d9,HDFC,Adjustments/Reversal,5eecc6d6449e4f7cfb1c2708,2020-06-23T00:00:00.000Z,DEBIT CARD PUR ADJ DT 20/06/20,,,Other,3.57
61b6f788d8beac1599eaeef1,50200023535069,714313.66,60ec41ba55c00300382672d9,HDFC,Adjustments/Reversal,5eecc6d6449e4f7cfb1c2708,2020-06-23T00:00:00.000Z,DEBIT CARD PUR ADJ DT 20/06/20,,,Other,4.55
61b6f789d8beac1599eaeef6,50200023535069,723662.7,60ec41ba55c00300382672d9,HDFC,Revenue-PG-split enabled,5eecc6d6449e4f7cfb1c2708,2020-06-23T00:00:00.000Z,NEFT CR-UTIB0001506-RAZORPAY SOFTWARE PR IVATE LIMITED-SLICK ORGANICS PVT LITD-AX ISCN0052772527,investments,,net_banking_transfer,9349.04
61b6f78ad8beac1599eaeefa,50200023535069,690032.7,60ec41ba55c00300382672d9,HDFC,direct expenses,5eecc6d6449e4f7cfb1c2708,2020-06-24T00:00:00.000Z,"NEFT DR-ORBC0100707-UFLEX LIMITED-NETBAN K, MUM-N176201167014628-33630",loans,lender_transaction,net_banking_transfer,-33630
61b6f78bd8beac1599eaef03,50200023535069,691491.95,60ec41ba55c00300382672d9,HDFC,Revenue-Mktplace,5eecc6d6449e4f7cfb1c2708,2020-06-24T00:00:00.000Z,NEFT CR-DEUT0797BGL-FLIPKART INTERNET P LTD-INT AC FO R INTERMEDIARY-SLICK ORGAN ICS PVT LTD-062400093GN00152,shopping,,net_banking_transfer,1459.25
61b6f78cd8beac1599eaef15,50200023535069,713303.55,60ec41ba55c00300382672d9,HDFC,Revenue-PG-split enabled,5eecc6d6449e4f7cfb1c2708,2020-06-24T00:00:00.000Z,NEFT CR-UTIB0001506-RAZORPAY SOFTWARE PR IVATE LIMITED-SLICK ORGANICS PVT LITD-AX ISCN0052787286,investments,,net_banking_transfer,21811.6
61b6f78dd8beac1599eaef26,50200023535069,713830.68,60ec41ba55c00300382672d9,HDFC,Revenue-Mktplace,5eecc6d6449e4f7cfb1c2708,2020-06-24T00:00:00.000Z,NEFT CR-DEUT0797BGL-FLIPKART INTERNET PV TLTD-SLICK ORGANICS PVT LTD-062400108GN0 0209,shopping,,net_banking_transfer,527.13
61b6f78ed8beac1599eaef31,50200023535069,733682.86,60ec41ba55c00300382672d9,HDFC,Revenue-COD,5eecc6d6449e4f7cfb1c2708,2020-06-24T00:00:00.000Z,NEFT CR-KKBK0000958-BIGFOOT RETAIL SOLUT IONS PRIVATE LIMITED-SLICK ORGANICS PVT LTD-KKBK201764293636,,,net_banking_transfer,19852.18
61b6f78fd8beac1599eaef37,50200023535069,755109.79,60ec41ba55c00300382672d9,HDFC,Revenue-PG-split enabled,5eecc6d6449e4f7cfb1c2708,2020-06-24T00:00:00.000Z,NEFT CR-UTIB0001506-RAZORPAY SOFTWARE PR IVATE LIMITED-SLICK ORGANICS PVT LITD-AX ISCN0052822597,investments,,net_banking_transfer,21426.93
61b6f790d8beac1599eaef4a,50200023535069,640109.79,60ec41ba55c00300382672d9,HDFC,direct expenses,5eecc6d6449e4f7cfb1c2708,2020-06-24T00:00:00.000Z,IMPS-017620316503-VISTTA COSMETICS-YESB- XXXXXXXXXXX1450-PART,,,net_banking_transfer,-115000
61b6f791d8beac1599eaef4e,50200023535069,590109.79,60ec41ba55c00300382672d9,HDFC,SAAS/tech expense,5eecc6d6449e4f7cfb1c2708,2020-06-24T00:00:00.000Z,POS 514834XXXXXX9486 AMAZON,shopping,,debit_card,-50000
61b6f792d8beac1599eaef58,50200023535069,604076.69,60ec41ba55c00300382672d9,HDFC,Revenue-PG-split enabled,5eecc6d6449e4f7cfb1c2708,2020-06-25T00:00:00.000Z,NEFT CR-UTIB0001506-RAZORPAY SOFTWARE PR,,,net_banking_transfer,13966.9
61b6f793d8beac1599eaef66,50200023535069,604070.79,60ec41ba55c00300382672d9,HDFC,direct expenses,5eecc6d6449e4f7cfb1c2708,2020-06-25T00:00:00.000Z,.IMPS P2P 017418376784#22/06/2020 230620 -MIR2017711733491,,,net_banking_transfer,-5.9
61b6f794d8beac1599eaef7b,50200023535069,603850.37,60ec41ba55c00300382672d9,HDFC,bank charges,5eecc6d6449e4f7cfb1c2708,2020-06-25T00:00:00.000Z,.DC INTL POS TXN MARKUP+ST 190620 230620 -MIR2017711733486,,,international_transaction_arbitrage,-220.42
61b6f795d8beac1599eaef8a,50200023535069,603570.04,60ec41ba55c00300382672d9,HDFC,bank charges,5eecc6d6449e4f7cfb1c2708,2020-06-25T00:00:00.000Z,.DC INTL POS TXN MARKUP+ST 200620 230620 -MIR2017711733479,,,international_transaction_arbitrage,-280.33
61b6f796d8beac1599eaef90,50200023535069,617594.68,60ec41ba55c00300382672d9,HDFC,Revenue-PG-split enabled,5eecc6d6449e4f7cfb1c2708,2020-06-25T00:00:00.000Z,NEFT CR-UTIB0001506-RAZORPAY SOFTWARE PR IVATE LIMITED-SLICK ORGANICS PVT LITD-AX ISCN0052885494,investments,,net_banking_transfer,14024.64
61b6f797d8beac1599eaefaa,50200023535069,613955.68,60ec41ba55c00300382672d9,HDFC,direct expenses,5eecc6d6449e4f7cfb1c2708,2020-06-26T00:00:00.000Z,POS 514834XXXXXX9486 FRESHWORKS INC,,,debit_card,-3639
61b6f798d8beac1599eaefb0,50200023535069,641035.86,60ec41ba55c00300382672d9,HDFC,Revenue-PG-split enabled,5eecc6d6449e4f7cfb1c2708,2020-06-26T00:00:00.000Z,NEFT CR-UTIB0001506-RAZORPAY SOFTWARE PR IVATE LIMITED-SLICK ORGANICS PVT LITD-AX ISCN0052900364,investments,,net_banking_transfer,27080.18
61b6f799d8beac1599eaefbe,50200023535069,643735.13,60ec41ba55c00300382672d9,HDFC,Revenue-Mktplace,5eecc6d6449e4f7cfb1c2708,2020-06-26T00:00:00.000Z,NEFT CR-DEUT0797BGL-FLIPKART INTERNET PV TLTD-SLICK ORGANICS PVT LTD-062600055GN0 0186,shopping,,net_banking_transfer,2699.27
61b6f79ad8beac1599eaefc8,50200023535069,648604.13,60ec41ba55c00300382672d9,HDFC,Revenue-Mktplace,5eecc6d6449e4f7cfb1c2708,2020-06-26T00:00:00.000Z,NEFT CR-DEUT0797BGL-FLIPKART INTERNET P LTD-INT AC FO R INTERMEDIARY-SLICK ORGAN ICS PVT LTD-062600080GN00198,shopping,,net_banking_transfer,4869
61b6f79bd8beac1599eaefcc,50200023535069,650597.67,60ec41ba55c00300382672d9,HDFC,Revenue-COD,5eecc6d6449e4f7cfb1c2708,2020-06-26T00:00:00.000Z,NEFT CR-KKBK0000958-BIGFOOT RETAIL SOLUT IONS PRIVATE LIMITED-SLICK ORGANICS PVT LTD-KKBK201784696366,,,net_banking_transfer,1993.54
61b6f79cd8beac1599eaefd5,50200023535069,662771.76,60ec41ba55c00300382672d9,HDFC,Revenue-PG-split enabled,5eecc6d6449e4f7cfb1c2708,2020-06-26T00:00:00.000Z,NEFT CR-UTIB0001506-RAZORPAY SOFTWARE PR IVATE LIMITED-SLICK ORGANICS PVT LITD-AX ISCN0052942485,investments,,net_banking_transfer,12174.09
61b6f79dd8beac1599eaefe2,50200023535069,612771.76,60ec41ba55c00300382672d9,HDFC,SAAS/tech expense,5eecc6d6449e4f7cfb1c2708,2020-06-27T00:00:00.000Z,POS 514834XXXXXX9486 AMAZON PAY INDIA,shopping,,debit_card,-50000
61b6f79ed8beac1599eaefe6,50200023535069,611638.04,60ec41ba55c00300382672d9,HDFC,direct expenses,5eecc6d6449e4f7cfb1c2708,2020-06-29T00:00:00.000Z,POS 514834XXXXXX9486 ZOOM.US,,,debit_card,-1133.72
61b6f79fd8beac1599eaefef,50200023535069,1059409.06,60ec41ba55c00300382672d9,HDFC,Revenue-PG-split enabled,5eecc6d6449e4f7cfb1c2708,2020-06-29T00:00:00.000Z,RTGS CR-UTIB0001506-RAZORPAY SOFTWARE PR IVATE LIMITED --SLICK ORGANICS PVT LITD- UTIBR52020062900330010,,,net_banking_transfer,447771.02
61b6f7a0d8beac1599eaeff6,50200023535069,1065128.14,60ec41ba55c00300382672d9,HDFC,Revenue-Mktplace,5eecc6d6449e4f7cfb1c2708,2020-06-29T00:00:00.000Z,NEFT CR-DEUT0797BGL-FLIPKART INTERNET P,shopping,,net_banking_transfer,5719.08
61b6f7a1d8beac1599eaeffd,50200023535069,1065110.44,60ec41ba55c00300382672d9,HDFC,direct expenses,5eecc6d6449e4f7cfb1c2708,2020-06-29T00:00:00.000Z,.IMPS P2P 017620316503#24/06/2020 250620 -MIR2017915680350,,,net_banking_transfer,-17.7
61b6f7a2d8beac1599eaf005,50200023535069,1071775.79,60ec41ba55c00300382672d9,HDFC,Revenue-Mktplace,5eecc6d6449e4f7cfb1c2708,2020-06-29T00:00:00.000Z,NEFT CR-DEUT0797BGL-FLIPKART INTERNET PV TLTD-SLICK ORGANICS PVT LTD-062900263GN0 0260,shopping,,net_banking_transfer,6665.35
61b6f7a3d8beac1599eaf00a,50200023535069,1101232.01,60ec41ba55c00300382672d9,HDFC,Revenue-PG-split enabled,5eecc6d6449e4f7cfb1c2708,2020-06-29T00:00:00.000Z,NEFT CR-UTIB0001506-RAZORPAY SOFTWARE PR IVATE LIMITED-SLICK ORGANICS PVT LITD-AX ISCN0053016873,investments,,net_banking_transfer,29456.22
61b6f7a4d8beac1599eaf015,50200023535069,1117994.7,60ec41ba55c00300382672d9,HDFC,Revenue-PG-split enabled,5eecc6d6449e4f7cfb1c2708,2020-06-30T00:00:00.000Z,NEFT CR-UTIB0001506-RAZORPAY SOFTWARE PR IVATE LIMITED-SLICK ORGANICS PVT LITD-AX ISCN0053032970,investments,,net_banking_transfer,16762.69
61b6f7a5d8beac1599eaf01b,50200023535069,1140836.83,60ec41ba55c00300382672d9,HDFC,Revenue-Mktplace,5eecc6d6449e4f7cfb1c2708,2020-06-30T00:00:00.000Z,IMPS-018211031281-AMAZON SELLER SERVIC-H DFC-XXXXXXXX6004-4EVS2ENDH1CJF03VSLICK O RGANICS PVT LTD,shopping,,net_banking_transfer,22842.13
61b6f7a6d8beac1599eaf023,50200023535069,1382709.53,60ec41ba55c00300382672d9,HDFC,Revenue-Mktplace,5eecc6d6449e4f7cfb1c2708,2020-06-30T00:00:00.000Z,NEFT CR-DEUT0797BGL-AMAZON PAY IND PVT L TD-INT AC INTM MKTPLACE-SLICK ORGANICS P VT LTD-063000147GN00203,shopping,,net_banking_transfer,241872.7
61b6f7a7d8beac1599eaf02b,50200023535069,1382708.79,60ec41ba55c00300382672d9,HDFC,bank charges,5eecc6d6449e4f7cfb1c2708,2020-06-30T00:00:00.000Z,DEBIT CARD PUR ADJ DT 29/06/20,,,Other,-0.74
61b6f7a8d8beac1599eaf031,50200023535069,1401165.33,60ec41ba55c00300382672d9,HDFC,Revenue-PG-split enabled,5eecc6d6449e4f7cfb1c2708,2020-06-30T00:00:00.000Z,NEFT CR-UTIB0001506-RAZORPAY SOFTWARE PR,,,net_banking_transfer,18456.54
61b6f7a9d8beac1599eaf040,50200023535069,1333665.33,60ec41ba55c00300382672d9,HDFC,direct expenses,5eecc6d6449e4f7cfb1c2708,2020-07-01T00:00:00.000Z,"NEFT DR-SBIN0009073-ABHISHEK SHARMA-NETB ANK, MUM-N183201173802997-67500",,,net_banking_transfer,-67500
61b6f7aad8beac1599eaf04d,50200023535069,1289985.33,60ec41ba55c00300382672d9,HDFC,direct expenses,5eecc6d6449e4f7cfb1c2708,2020-07-01T00:00:00.000Z,"NEFT DR-KKBK0000173-MATRIX PRINTING SOLU TIONS PRIVATE LIMITE-NETBANK, MUM-N18320 1173809105-43680",,,net_banking_transfer,-43680
61b6f7abd8beac1599eaf053,50200023535069,1229985.33,60ec41ba55c00300382672d9,HDFC,direct expenses,5eecc6d6449e4f7cfb1c2708,2020-07-01T00:00:00.000Z,50100106249659-TPT-60000-SAMRIDDH DASGUP TA,,,net_banking_transfer,-60000
61b6f7acd8beac1599eaf05b,50200023535069,1199915.33,60ec41ba55c00300382672d9,HDFC,direct expenses,5eecc6d6449e4f7cfb1c2708,2020-07-01T00:00:00.000Z,"NEFT DR-YESB0000162-VINAY REDDY-NETBANK, MUM-N183201173826753-30070",,,net_banking_transfer,-30070
61b6f7acd8beac1599eaf061,50200023535069,1149915.33,60ec41ba55c00300382672d9,HDFC,direct expenses,5eecc6d6449e4f7cfb1c2708,2020-07-01T00:00:00.000Z,"NEFT DR-SCBL0036025-DHRUV MADHOK-NETBANK , MUM-N183201173805266-50000",,,net_banking_transfer,-50000
61b6f7add8beac1599eaf06b,50200023535069,1150393.77,60ec41ba55c00300382672d9,HDFC,Revenue-Mktplace,5eecc6d6449e4f7cfb1c2708,2020-07-01T00:00:00.000Z,NEFT CR-DEUT0797BGL-FLIPKART INTERNET P LTD-INT AC FO R INTERMEDIARY-SLICK ORGAN ICS PVT LTD-070100125GN00218,shopping,,net_banking_transfer,478.44
61b6f7aed8beac1599eaf07c,50200023535069,1148203.79,60ec41ba55c00300382672d9,HDFC,direct expenses,5eecc6d6449e4f7cfb1c2708,2020-07-01T00:00:00.000Z,POS 514834XXXXXX9486 SEOPTIMER,,,debit_card,-2189.98
61b6f7afd8beac1599eaf083,50200023535069,1154994.31,60ec41ba55c00300382672d9,HDFC,Revenue-PG-split enabled,5eecc6d6449e4f7cfb1c2708,2020-07-01T00:00:00.000Z,NEFT CR-UTIB0001506-RAZORPAY SOFTWARE PR IVATE LIMITED-SLICK ORGANICS PVT LITD-AX ISCN0053138342,investments,,net_banking_transfer,6790.52
61b6f7b0d8beac1599eaf08d,50200023535069,1104994.31,60ec41ba55c00300382672d9,HDFC,SAAS/tech expense,5eecc6d6449e4f7cfb1c2708,2020-07-01T00:00:00.000Z,POS 514834XXXXXX9486 AMAZON PAY INDIA,shopping,,debit_card,-50000
61b6f7b1d8beac1599eaf092,50200023535069,1104995.31,60ec41ba55c00300382672d9,HDFC,Transfer in/Revenue-other,5eecc6d6449e4f7cfb1c2708,2020-07-01T00:00:00.000Z,IMPS-018313023422-DIGIOTECH SOLUTIONS -H DFC-XXXXXXXX1214-XQOPSVJIIDP9Q12,,,net_banking_transfer,1
61b6f7b2d8beac1599eaf09e,50200023535069,1122582.89,60ec41ba55c00300382672d9,HDFC,Revenue-PG-split enabled,5eecc6d6449e4f7cfb1c2708,2020-07-01T00:00:00.000Z,NEFT CR-UTIB0001506-RAZORPAY SOFTWARE PR IVATE LIMITED-SLICK ORGANICS PVT LITD-AX ISCN0053183964,investments,,net_banking_transfer,17587.58
61b6f7b3d8beac1599eaf0a5,50200023535069,1102582.89,60ec41ba55c00300382672d9,HDFC,direct expenses,5eecc6d6449e4f7cfb1c2708,2020-07-02T00:00:00.000Z,"NEFT DR-UTIB0001771-NEERAJ CARPET CLEANI NG-NETBANK, MUM-N184201175112004-20000",,,net_banking_transfer,-20000
61b6f7b4d8beac1599eaf0ad,50200023535069,1130076.63,60ec41ba55c00300382672d9,HDFC,Revenue-PG-split enabled,5eecc6d6449e4f7cfb1c2708,2020-07-02T00:00:00.000Z,NEFT CR-UTIB0001506-RAZORPAY SOFTWARE PR IVATE LIMITED-SLICK ORGANICS PVT LITD-AX ISCN0053210946,investments,,net_banking_transfer,27493.74
61b6f7b5d8beac1599eaf0b2,50200023535069,864576.63,60ec41ba55c00300382672d9,HDFC,direct expenses,5eecc6d6449e4f7cfb1c2708,2020-07-02T00:00:00.000Z,NEFT DR-KKBK0000208-SYSCOM PACKAGING COM,,,net_banking_transfer,-265500
61b6f7b6d8beac1599eaf0b7,50200023535069,864577.63,60ec41ba55c00300382672d9,HDFC,Transfer in/Revenue-other,5eecc6d6449e4f7cfb1c2708,2020-07-02T00:00:00.000Z,IMPS-018412247073-ACC VALIDATION BY ME-H DFC-XXXXXXXX1002-BANK ACCOUNT VALIDATION,,,net_banking_transfer,1
61b6f7b7d8beac1599eaf0ba,50200023535069,855135.63,60ec41ba55c00300382672d9,HDFC,direct expenses,5eecc6d6449e4f7cfb1c2708,2020-07-02T00:00:00.000Z,POS 514834XXXXXX9486 STK*SHUTTERSTOCK,,,debit_card,-9442
61b6f7b8d8beac1599eaf0c3,50200023535069,863595.42,60ec41ba55c00300382672d9,HDFC,Revenue-PG-split enabled,5eecc6d6449e4f7cfb1c2708,2020-07-02T00:00:00.000Z,NEFT CR-UTIB0001506-RAZORPAY SOFTWARE PR IVATE LIMITED-SLICK ORGANICS PVT LITD-AX ISCN0053251779,investments,,net_banking_transfer,8459.79
61b6f7b9d8beac1599eaf0c6,50200023535069,858876.6,60ec41ba55c00300382672d9,HDFC,direct expenses,5eecc6d6449e4f7cfb1c2708,2020-07-02T00:00:00.000Z,POS 514834XXXXXX4081 ONLINE PAYMENT,,,debit_card,-4718.82
61b6f7bad8beac1599eaf0cb,50200023535069,858872.92,60ec41ba55c00300382672d9,HDFC,bank charges,5eecc6d6449e4f7cfb1c2708,2020-07-02T00:00:00.000Z,DEBIT CARD PUR ADJ DT 01/07/20,,,Other,-3.68
61b6f7bbd8beac1599eaf0d1,50200023535069,764872.92,60ec41ba55c00300382672d9,HDFC,direct expenses,5eecc6d6449e4f7cfb1c2708,2020-07-03T00:00:00.000Z,"NEFT DR-YESB0000551-VISTTA COSMETICS-NET BANK, MUM-N185201176239289-94000",,,net_banking_transfer,-94000
61b6f7bcd8beac1599eaf0d9,50200023535069,734568.92,60ec41ba55c00300382672d9,HDFC,Tax,5eecc6d6449e4f7cfb1c2708,2020-07-03T00:00:00.000Z,051030803072000173- CBDT TAX,,,Other,-30304
61b6f7bdd8beac1599eaf0e2,50200023535069,707568.92,60ec41ba55c00300382672d9,HDFC,agency/vendor expense,5eecc6d6449e4f7cfb1c2708,2020-07-03T00:00:00.000Z,50200019195361-TPT-27000-ILUMINAR MEDIA PVT LTD,,,net_banking_transfer,-27000
61b6f7bed8beac1599eaf0e7,50200023535069,722147.25,60ec41ba55c00300382672d9,HDFC,Revenue-PG-split enabled,5eecc6d6449e4f7cfb1c2708,2020-07-03T00:00:00.000Z,NEFT CR-UTIB0001506-RAZORPAY SOFTWARE PR IVATE LIMITED-SLICK ORGANICS PVT LITD-AX ISCN0053287428,investments,,net_banking_transfer,14578.33
61b6f7bfd8beac1599eaf0ed,50200023535069,672147.25,60ec41ba55c00300382672d9,HDFC,direct expenses,5eecc6d6449e4f7cfb1c2708,2020-07-03T00:00:00.000Z,"NEFT DR-ORBC0101001-KRAUTER HEALTHCARE L TD-NETBANK, MUM-N185201176298164-RM OF L B",,,net_banking_transfer,-50000
61b6f7c0d8beac1599eaf0f4,50200023535069,658647.25,60ec41ba55c00300382672d9,HDFC,direct expenses,5eecc6d6449e4f7cfb1c2708,2020-07-03T00:00:00.000Z,50200031284040-TPT-13500-BURGEON LAW LLP,,,net_banking_transfer,-13500
61b6f7c1d8beac1599eaf0f7,50200023535069,660464.31,60ec41ba55c00300382672d9,HDFC,Revenue-Mktplace,5eecc6d6449e4f7cfb1c2708,2020-07-03T00:00:00.000Z,4060000190-TIMES INTERNET LIMITED NODAL,,,Other,1817.06
61b6f7c2d8beac1599eaf0fc,50200023535069,682441.35,60ec41ba55c00300382672d9,HDFC,Revenue-COD,5eecc6d6449e4f7cfb1c2708,2020-07-03T00:00:00.000Z,NEFT CR-KKBK0000958-BIGFOOT RETAIL SOLUT IONS PRIVATE LIMITED-SLICK ORGANICS PVT LTD-KKBK201856017361,,,net_banking_transfer,21977.04
61b6f7c3d8beac1599eaf102,50200023535069,704423.44,60ec41ba55c00300382672d9,HDFC,Revenue-Mktplace,5eecc6d6449e4f7cfb1c2708,2020-07-03T00:00:00.000Z,NEFT CR-ICIC0000105-MANASH LIFETYLE PVT LTD-SLICKORGANICSPRIVATELIMITEDMPMUM-ICI B201850037098,,,net_banking_transfer,21982.09
61b6f7c4d8beac1599eaf106,50200023535069,713951.25,60ec41ba55c00300382672d9,HDFC,Revenue-PG-split enabled,5eecc6d6449e4f7cfb1c2708,2020-07-03T00:00:00.000Z,NEFT CR-UTIB0001506-RAZORPAY SOFTWARE PR IVATE LIMITED-SLICK ORGANICS PVT LITD-AX ISCN0053329415,investments,,net_banking_transfer,9527.81
61b6f7c5d8beac1599eaf10d,50200023535069,713950.59,60ec41ba55c00300382672d9,HDFC,bank charges,5eecc6d6449e4f7cfb1c2708,2020-07-03T00:00:00.000Z,DEBIT CARD PUR ADJ DT 02/07/20,,,Other,-0.66
61b6f7c5d8beac1599eaf111,50200023535069,513950.59,60ec41ba55c00300382672d9,HDFC,direct expenses,5eecc6d6449e4f7cfb1c2708,2020-07-03T00:00:00.000Z,"NEFT DR-ICIC0003430-HASHTAG ORANGE ADVER TISING PVT LTD-NETBANK, MUM-N18520117716 1237-JUNE",,,net_banking_transfer,-200000
61b6f7c6d8beac1599eaf116,50200023535069,313950.59,60ec41ba55c00300382672d9,HDFC,direct expenses,5eecc6d6449e4f7cfb1c2708,2020-07-03T00:00:00.000Z,"NEFT DR-ICIC0003430-HASHTAG ORANGE ADVER TISING PVT LTD-NETBANK, MUM-N18520117715 5122-JUNE",,,net_banking_transfer,-200000
61b6f7c7d8beac1599eaf11c,50200023535069,213950.59,60ec41ba55c00300382672d9,HDFC,direct expenses,5eecc6d6449e4f7cfb1c2708,2020-07-03T00:00:00.000Z,"NEFT DR-ICIC0003430-HASHTAG ORANGE ADVER TISING PVT LTD-NETBANK, MUM-N18520117715 9515-JUNE",,,net_banking_transfer,-100000
61b6f7c8d8beac1599eaf121,50200023535069,233013.4,60ec41ba55c00300382672d9,HDFC,Revenue-PG-split enabled,5eecc6d6449e4f7cfb1c2708,2020-07-04T00:00:00.000Z,NEFT CR-UTIB0001506-RAZORPAY SOFTWARE PR IVATE LIMITED-SLICK ORGANICS PVT LITD-AX ISCN0053348499,investments,,net_banking_transfer,19062.81
61b6f7c9d8beac1599eaf126,50200023535069,113020.4,60ec41ba55c00300382672d9,HDFC,direct expenses,5eecc6d6449e4f7cfb1c2708,2020-07-04T00:00:00.000Z,"NEFT DR-ORBC0101001-KRAUTER HEALTHCARE L TD-NETBANK, MUM-N186201177714400-RM OF L B",,,net_banking_transfer,-119993
61b6f7cad8beac1599eaf12a,50200023535069,13020.4,60ec41ba55c00300382672d9,HDFC,direct expenses,5eecc6d6449e4f7cfb1c2708,2020-07-04T00:00:00.000Z,"NEFT DR-ORBC0101001-KRAUTER HEALTHCARE L TD-NETBANK, MUM-N186201177745941-100000",,,net_banking_transfer,-100000
61b6f7cbd8beac1599eaf12e,50200023535069,31836.08,60ec41ba55c00300382672d9,HDFC,Revenue-PG-split enabled,5eecc6d6449e4f7cfb1c2708,2020-07-04T00:00:00.000Z,NEFT CR-UTIB0001506-RAZORPAY SOFTWARE PR IVATE LIMITED-SLICK ORGANICS PVT LITD-AX ISCN0053375521,investments,,net_banking_transfer,18815.68
61b6f7ccd8beac1599eaf137,50200023535069,6836.08,60ec41ba55c00300382672d9,HDFC,SAAS/tech expense,5eecc6d6449e4f7cfb1c2708,2020-07-05T00:00:00.000Z,POS 514834XXXXXX9486 AMAZON,shopping,,debit_card,-25000
61b6f7cdd8beac1599eaf139,50200023535069,7989.08,60ec41ba55c00300382672d9,HDFC,Revenue-Mktplace,5eecc6d6449e4f7cfb1c2708,2020-07-06T00:00:00.000Z,NEFT CR-KKBK0000958-SUPERMARKET GROCERY SUPPLIES PVT LTD-SLICK ORGANICS PVT LTD- KKBK201886259713,shopping,,net_banking_transfer,1153
61b6f7ced8beac1599eaf142,50200023535069,8768.08,60ec41ba55c00300382672d9,HDFC,Revenue-Mktplace,5eecc6d6449e4f7cfb1c2708,2020-07-06T00:00:00.000Z,NEFT CR-KKBK0000958-SUPERMARKET GROCERY SUPPLIES PVT LTD-SLICK ORGANICS PVT LTD- KKBK201886265873,shopping,,net_banking_transfer,779
61b6f7cfd8beac1599eaf145,50200023535069,19816.08,60ec41ba55c00300382672d9,HDFC,Revenue-Mktplace,5eecc6d6449e4f7cfb1c2708,2020-07-06T00:00:00.000Z,NEFT CR-KKBK0000958-SUPERMARKET GROCERY SUPPLIES PVT LTD-SLICK ORGANICS PVT LTD- KKBK201886265959,shopping,,net_banking_transfer,11048
61b6f7d0d8beac1599eaf14a,50200023535069,43183.58,60ec41ba55c00300382672d9,HDFC,Revenue-Mktplace,5eecc6d6449e4f7cfb1c2708,2020-07-06T00:00:00.000Z,NEFT CR-KKBK0000958-SUPERMARKET GROCERY,shopping,,net_banking_transfer,23367.5
61b6f7d1d8beac1599eaf150,50200023535069,52321.58,60ec41ba55c00300382672d9,HDFC,Revenue-Mktplace,5eecc6d6449e4f7cfb1c2708,2020-07-06T00:00:00.000Z,NEFT CR-KKBK0000958-SUPERMARKET GROCERY SUPPLIES PVT LTD-SLICK ORGANICS PVT LTD- KKBK201886266582,shopping,,net_banking_transfer,9138
61b6f7d2d8beac1599eaf155,50200023535069,53798.58,60ec41ba55c00300382672d9,HDFC,Revenue-Mktplace,5eecc6d6449e4f7cfb1c2708,2020-07-06T00:00:00.000Z,NEFT CR-KKBK0000958-SUPERMARKET GROCERY SUPPLIES PVT LTD-SLICK ORGANICS PVT LTD- KKBK201886271335,shopping,,net_banking_transfer,1477
61b6f7d3d8beac1599eaf159,50200023535069,56981.08,60ec41ba55c00300382672d9,HDFC,Revenue-Mktplace,5eecc6d6449e4f7cfb1c2708,2020-07-06T00:00:00.000Z,NEFT CR-KKBK0000958-SUPERMARKET GROCERY SUPPLIES PVT LTD-SLICK ORGANICS PVT LTD- KKBK201886271331,shopping,,net_banking_transfer,3182.5
61b6f7d4d8beac1599eaf15e,50200023535069,156981.08,60ec41ba55c00300382672d9,HDFC,Internal Transfers,5eecc6d6449e4f7cfb1c2708,2020-07-06T00:00:00.000Z,IB FUNDS TRANSFER CR-50200035187206 -SL ICK ORGANICS PVT LTD,investments,,Other,100000
61b6f7d5d8beac1599eaf162,50200023535069,214988.65,60ec41ba55c00300382672d9,HDFC,Revenue-PG-split enabled,5eecc6d6449e4f7cfb1c2708,2020-07-06T00:00:00.000Z,NEFT CR-UTIB0001506-RAZORPAY SOFTWARE PR IVATE LIMITED-SLICK ORGANICS PVT LITD-AX ISCN0053397530,investments,,net_banking_transfer,58007.57
61b6f7d6d8beac1599eaf16a,50200023535069,214941.8,60ec41ba55c00300382672d9,HDFC,bank charges,5eecc6d6449e4f7cfb1c2708,2020-07-06T00:00:00.000Z,.DC INTL POS TXN MARKUP+ST 280620 300620 -MIR2018723895614,,,international_transaction_arbitrage,-46.85
61b6f7d7d8beac1599eaf16e,50200023535069,214823.8,60ec41ba55c00300382672d9,HDFC,Tax,5eecc6d6449e4f7cfb1c2708,2020-07-06T00:00:00.000Z,ADHOC STMT CHGS INCL GST 300620-MIR20187 23949037,,,bank_charge,-118
61b6f7d8d8beac1599eaf171,50200023535069,220573.8,60ec41ba55c00300382672d9,HDFC,Transfer in/Revenue-other,5eecc6d6449e4f7cfb1c2708,2020-07-06T00:00:00.000Z,IMPS-018814100175-NAINA-HDFC-XXXXXXXXXXX 0887-VANITY WAGON,,,net_banking_transfer,5750
61b6f7d9d8beac1599eaf179,50200023535069,120573.8,60ec41ba55c00300382672d9,HDFC,direct expenses,5eecc6d6449e4f7cfb1c2708,2020-07-06T00:00:00.000Z,50200001182150-TPT-ADVANCE-DEXTER CAPITA L ADVISORS PVT LTD,,,net_banking_transfer,-100000
61b6f7dad8beac1599eaf17d,50200023535069,126432.67,60ec41ba55c00300382672d9,HDFC,Revenue-PG-split enabled,5eecc6d6449e4f7cfb1c2708,2020-07-06T00:00:00.000Z,NEFT CR-UTIB0001506-RAZORPAY SOFTWARE PR IVATE LIMITED-SLICK ORGANICS PVT LITD-AX ISCN0053436084,investments,,net_banking_transfer,5858.87
61b6f7dbd8beac1599eaf182,50200023535069,126915.07,60ec41ba55c00300382672d9,HDFC,Revenue-PG-non-split,5eecc6d6449e4f7cfb1c2708,2020-07-06T00:00:00.000Z,NEFT CR-ICIC0000031-PAYTM E COMMERCE PVT LTD-SLICK ORGANICS PVT LTD-CMS153148430 6,investments,,net_banking_transfer,482.4
61b6f7dbd8beac1599eaf1b6,50200023535069,134503.23,60ec41ba55c00300382672d9,HDFC,Revenue-PG-split enabled,5eecc6d6449e4f7cfb1c2708,2020-07-07T00:00:00.000Z,NEFT CR-UTIB0001506-RAZORPAY SOFTWARE PR,,,net_banking_transfer,7588.16
61b6f7dcd8beac1599eaf1bc,50200023535069,634503.23,60ec41ba55c00300382672d9,HDFC,Internal Transfers,5eecc6d6449e4f7cfb1c2708,2020-07-07T00:00:00.000Z,IB FUNDS TRANSFER CR-50200035187206 -SL ICK ORGANICS PVT LTD,investments,,Other,500000
61b6f7ddd8beac1599eaf1c1,50200023535069,597503.23,60ec41ba55c00300382672d9,HDFC,direct expenses,5eecc6d6449e4f7cfb1c2708,2020-07-07T00:00:00.000Z,"NEFT DR-CITI0000002-DHIRAJ-NETBANK, MUM- N189201179723102-37000",,,net_banking_transfer,-37000
61b6f7ded8beac1599eaf1c5,50200023535069,562503.23,60ec41ba55c00300382672d9,HDFC,direct expenses,5eecc6d6449e4f7cfb1c2708,2020-07-07T00:00:00.000Z,"NEFT DR-ICIC0000542-AVANTIKA SUKHIA-NETB ANK, MUM-N189201179718445-35000",,,net_banking_transfer,-35000
61b6f7dfd8beac1599eaf1ca,50200023535069,555003.23,60ec41ba55c00300382672d9,HDFC,direct expenses,5eecc6d6449e4f7cfb1c2708,2020-07-07T00:00:00.000Z,"NEFT DR-SIBL0000555-JAIVEER KUMAR-NETBAN K, MUM-N189201179709093-7500",,,net_banking_transfer,-7500
61b6f7e0d8beac1599eaf1d1,50200023535069,550003.23,60ec41ba55c00300382672d9,HDFC,direct expenses,5eecc6d6449e4f7cfb1c2708,2020-07-07T00:00:00.000Z,"NEFT DR-PUNB0398000-MEENA SINGH-NETBANK, MUM-N189201179723489-5000",,,net_banking_transfer,-5000
61b6f7e1d8beac1599eaf1d4,50200023535069,540003.23,60ec41ba55c00300382672d9,HDFC,direct expenses,5eecc6d6449e4f7cfb1c2708,2020-07-07T00:00:00.000Z,"NEFT DR-SBIN0001189-SANDEEP SINGH-NETBAN K, MUM-N189201179723540-10000",,,net_banking_transfer,-10000
61b6f7e2d8beac1599eaf1dc,50200023535069,531753.23,60ec41ba55c00300382672d9,HDFC,direct expenses,5eecc6d6449e4f7cfb1c2708,2020-07-07T00:00:00.000Z,"NEFT DR-KKBK0000811-NASIR KHAN-NETBANK, MUM-N189201179709525-8250",,,net_banking_transfer,-8250
61b6f7e3d8beac1599eaf1df,50200023535069,514253.23,60ec41ba55c00300382672d9,HDFC,direct expenses,5eecc6d6449e4f7cfb1c2708,2020-07-07T00:00:00.000Z,"NEFT DR-ICIC0003374-SIDDHARTH KANOJIA-NE TBANK, MUM-N189201179727107-17500",,,net_banking_transfer,-17500
61b6f7e4d8beac1599eaf1e5,50200023535069,511253.23,60ec41ba55c00300382672d9,HDFC,direct expenses,5eecc6d6449e4f7cfb1c2708,2020-07-07T00:00:00.000Z,"NEFT DR-ALLA0210591-CHAMPA DEVI-NETBANK, MUM-N189201179724243-3000",,,net_banking_transfer,-3000
61b6f7e5d8beac1599eaf1eb,50200023535069,495253.23,60ec41ba55c00300382672d9,HDFC,direct expenses,5eecc6d6449e4f7cfb1c2708,2020-07-07T00:00:00.000Z,00901610080520-TPT-16000-POOJA KAPIL SHR OTRIYA,,,net_banking_transfer,-16000
61b6f7e6d8beac1599eaf1f2,50200023535069,481753.23,60ec41ba55c00300382672d9,HDFC,direct expenses,5eecc6d6449e4f7cfb1c2708,2020-07-07T00:00:00.000Z,"NEFT DR-SYNB0005170-SNEHAL TAYDE-NETBANK , MUM-N189201179731682-13500",,,net_banking_transfer,-13500
61b6f7e7d8beac1599eaf205,50200023535069,456753.23,60ec41ba55c00300382672d9,HDFC,direct expenses,5eecc6d6449e4f7cfb1c2708,2020-07-07T00:00:00.000Z,50100301160692-TPT-25000-TARUN GARG,,,net_banking_transfer,-25000
61b6f7e8d8beac1599eaf20a,50200023535069,406753.23,60ec41ba55c00300382672d9,HDFC,direct expenses,5eecc6d6449e4f7cfb1c2708,2020-07-07T00:00:00.000Z,02771610131904-TPT-50000-DIGANT BHATT,,,net_banking_transfer,-50000
61b6f7e9d8beac1599eaf21f,50200023535069,396753.23,60ec41ba55c00300382672d9,HDFC,direct expenses,5eecc6d6449e4f7cfb1c2708,2020-07-07T00:00:00.000Z,50100301160692-TPT-10000-TARUN GARG,,,net_banking_transfer,-10000
61b6f7ead8beac1599eaf228,50200023535069,375903.23,60ec41ba55c00300382672d9,HDFC,direct expenses,5eecc6d6449e4f7cfb1c2708,2020-07-07T00:00:00.000Z,"NEFT DR-UTIB0000120-ADNAN ALI-NETBANK, M UM-N189201179747318-20850",,,net_banking_transfer,-20850
61b6f7ebd8beac1599eaf22c,50200023535069,342903.23,60ec41ba55c00300382672d9,HDFC,direct expenses,5eecc6d6449e4f7cfb1c2708,2020-07-07T00:00:00.000Z,50100330586095-TPT-33000-DIWAKAR UNIYAL,,,net_banking_transfer,-33000
61b6f7ecd8beac1599eaf237,50200023535069,317903.23,60ec41ba55c00300382672d9,HDFC,SAAS/tech expense,5eecc6d6449e4f7cfb1c2708,2020-07-07T00:00:00.000Z,POS 514834XXXXXX9486 AMAZON,shopping,,debit_card,-25000
61b6f7edd8beac1599eaf23d,50200023535069,352027.26,60ec41ba55c00300382672d9,HDFC,Revenue-Mktplace,5eecc6d6449e4f7cfb1c2708,2020-07-07T00:00:00.000Z,IMPS-018911206075-AMAZON SELLER SERVIC-H,shopping,,net_banking_transfer,34124.03
61b6f7eed8beac1599eaf241,50200023535069,621099.97,60ec41ba55c00300382672d9,HDFC,Revenue-Mktplace,5eecc6d6449e4f7cfb1c2708,2020-07-07T00:00:00.000Z,NEFT CR-DEUT0797BGL-AMAZON PAY IND PVT L TD-INT AC INTM MKTPLACE-SLICK ORGANICS P VT LTD-070700475GN00082,shopping,,net_banking_transfer,269072.71
61b6f7efd8beac1599eaf248,50200023535069,571099.97,60ec41ba55c00300382672d9,HDFC,direct expenses,5eecc6d6449e4f7cfb1c2708,2020-07-07T00:00:00.000Z,"NEFT DR-BKDN0450123-ARTISTO DESIGNZ-NETB ANK, MUM-N189201179985993-50000",,,net_banking_transfer,-50000
61b6f7f0d8beac1599eaf24d,50200023535069,591306.97,60ec41ba55c00300382672d9,HDFC,Revenue-PG-split enabled,5eecc6d6449e4f7cfb1c2708,2020-07-07T00:00:00.000Z,NEFT CR-UTIB0001506-RAZORPAY SOFTWARE PR IVATE LIMITED-SLICK ORGANICS PVT LITD-AX ISCN0053491069,investments,,net_banking_transfer,20207
61b6f7f1d8beac1599eaf25b,50200023535069,617614.42,60ec41ba55c00300382672d9,HDFC,Revenue-PG-split enabled,5eecc6d6449e4f7cfb1c2708,2020-07-08T00:00:00.000Z,NEFT CR-UTIB0001506-RAZORPAY SOFTWARE PR IVATE LIMITED-SLICK ORGANICS PVT LITD-AX ISCN0053506505,investments,,net_banking_transfer,26307.45
61b6f7f2d8beac1599eaf268,50200023535069,617496.42,60ec41ba55c00300382672d9,HDFC,Tax,5eecc6d6449e4f7cfb1c2708,2020-07-08T00:00:00.000Z,ADHOC STMT CHGS INCL GST 010720-MIR20189 27144030,,,bank_charge,-118
61b6f7f2d8beac1599eaf26b,50200023535069,572522.42,60ec41ba55c00300382672d9,HDFC,direct expenses,5eecc6d6449e4f7cfb1c2708,2020-07-08T00:00:00.000Z,"NEFT DR-YESB0000551-VISTTA COSMETICS-NET BANK, MUM-N190201181528214-44974",,,net_banking_transfer,-44974
61b6f7f3d8beac1599eaf271,50200023535069,572431.82,60ec41ba55c00300382672d9,HDFC,bank charges,5eecc6d6449e4f7cfb1c2708,2020-07-08T00:00:00.000Z,.DC INTL POS TXN MARKUP+ST 010720 020720 -MIR2019028345482,,,international_transaction_arbitrage,-90.6
61b6f7f4d8beac1599eaf278,50200023535069,617107.43,60ec41ba55c00300382672d9,HDFC,Revenue-COD,5eecc6d6449e4f7cfb1c2708,2020-07-08T00:00:00.000Z,NEFT CR-KKBK0000958-BIGFOOT RETAIL SOLUT IONS PRIVATE LIMITED-SLICK ORGANICS PVT LTD-KKBK201906897717,,,net_banking_transfer,44675.61
61b6f7f5d8beac1599eaf27a,50200023535069,621179.58,60ec41ba55c00300382672d9,HDFC,Revenue-Mktplace,5eecc6d6449e4f7cfb1c2708,2020-07-08T00:00:00.000Z,NEFT CR-ICIC0000105-MANASH LIFETYLE PVT LTD-SLICKORGANICSPRIVATELIMITEDMPMUM-ICI B201900055052,,,net_banking_transfer,4072.15
61b6f7f6d8beac1599eaf2a1,50200023535069,627490.25,60ec41ba55c00300382672d9,HDFC,Revenue-PG-split enabled,5eecc6d6449e4f7cfb1c2708,2020-07-08T00:00:00.000Z,NEFT CR-UTIB0001506-RAZORPAY SOFTWARE PR IVATE LIMITED-SLICK ORGANICS PVT LITD-AX ISCN0053576571,investments,,net_banking_transfer,6310.67
61b6f7f7d8beac1599eaf2b1,50200023535069,645698.62,60ec41ba55c00300382672d9,HDFC,Revenue-PG-split enabled,5eecc6d6449e4f7cfb1c2708,2020-07-09T00:00:00.000Z,NEFT CR-UTIB0001506-RAZORPAY SOFTWARE PR IVATE LIMITED-SLICK ORGANICS PVT LITD-AX ISCN0053598344,investments,,net_banking_transfer,18208.37
61b6f7f8d8beac1599eaf2b5,50200023535069,635698.62,60ec41ba55c00300382672d9,HDFC,Salary/Emp/consultant Expense,5eecc6d6449e4f7cfb1c2708,2020-07-09T00:00:00.000Z,"NEFT DR-KKBK0000291-ROLI GARG-NETBANK, M UM-N191201182352885-SALARY",,,net_banking_transfer,-10000
61b6f7f9d8beac1599eaf2bf,50200023535069,610698.62,60ec41ba55c00300382672d9,HDFC,SAAS/tech expense,5eecc6d6449e4f7cfb1c2708,2020-07-09T00:00:00.000Z,POS 514834XXXXXX9486 AMAZON PAY INDIA,shopping,,debit_card,-25000
61b6f7fad8beac1599eaf2c5,50200023535069,600698.62,60ec41ba55c00300382672d9,HDFC,direct expenses,5eecc6d6449e4f7cfb1c2708,2020-07-09T00:00:00.000Z,SARVAN KUMAR - CHQ PAID - K G MARG,,,chq,-10000
61b6f7fbd8beac1599eaf2ca,50200023535069,612926.44,60ec41ba55c00300382672d9,HDFC,Revenue-PG-split enabled,5eecc6d6449e4f7cfb1c2708,2020-07-09T00:00:00.000Z,NEFT CR-UTIB0001506-RAZORPAY SOFTWARE PR IVATE LIMITED-SLICK ORGANICS PVT LITD-AX ISCN0053633909,investments,,net_banking_transfer,12227.82
61b6f7fcd8beac1599eaf2cf,50200023535069,617832.88,60ec41ba55c00300382672d9,HDFC,Revenue-PG-split enabled,5eecc6d6449e4f7cfb1c2708,2020-07-10T00:00:00.000Z,NEFT CR-UTIB0001506-RAZORPAY SOFTWARE PR IVATE LIMITED-SLICK ORGANICS PVT LITD-AX ISCN0053648922,investments,,net_banking_transfer,4906.44
61b6f7fdd8beac1599eaf2d6,50200023535069,620322.87,60ec41ba55c00300382672d9,HDFC,Revenue-Mktplace,5eecc6d6449e4f7cfb1c2708,2020-07-10T00:00:00.000Z,NEFT CR-DEUT0797BGL-FLIPKART INTERNET P LTD-INT AC FO R INTERMEDIARY-SLICK ORGAN ICS PVT LTD-071000117GN00057,shopping,,net_banking_transfer,2489.99
61b6f7fed8beac1599eaf2df,50200023535069,620995.03,60ec41ba55c00300382672d9,HDFC,Revenue-Mktplace,5eecc6d6449e4f7cfb1c2708,2020-07-10T00:00:00.000Z,NEFT CR-DEUT0784BBY-TATA UNISTORE LTD-NO DAL-SLICK ORGANICS PVT LTD-071000600GN00 592,investments,,net_banking_transfer,672.16
61b6f7ffd8beac1599eaf2e1,50200023535069,626462.12,60ec41ba55c00300382672d9,HDFC,Revenue-Mktplace,5eecc6d6449e4f7cfb1c2708,2020-07-10T00:00:00.000Z,NEFT CR-DEUT0797BGL-FLIPKART INTERNET PV TLTD-SLICK ORGANICS PVT LTD-071000127GN0 0115,shopping,,net_banking_transfer,5467.09
61b6f800d8beac1599eaf2ea,50200023535069,675515.53,60ec41ba55c00300382672d9,HDFC,Revenue-COD,5eecc6d6449e4f7cfb1c2708,2020-07-10T00:00:00.000Z,NEFT CR-KKBK0000958-BIGFOOT RETAIL SOLUT IONS PRIVATE LIMITED-SLICK ORGANICS PVT LTD-KKBK201927371144,,,net_banking_transfer,49053.41
61b6f801d8beac1599eaf2f1,50200023535069,684092.44,60ec41ba55c00300382672d9,HDFC,Revenue-PG-split enabled,5eecc6d6449e4f7cfb1c2708,2020-07-10T00:00:00.000Z,NEFT CR-UTIB0001506-RAZORPAY SOFTWARE PR IVATE LIMITED-SLICK ORGANICS PVT LITD-AX ISCN0053690185,investments,,net_banking_transfer,8576.91
61b6f802d8beac1599eaf2f5,50200023535069,693952.55,60ec41ba55c00300382672d9,HDFC,Revenue-Mktplace,5eecc6d6449e4f7cfb1c2708,2020-07-10T00:00:00.000Z,NEFT CR-ICIC0000105-MANASH LIFETYLE PVT LTD-SLICKORGANICSPRIVATELIMITEDMPGGN-ICI B201920064143,,,net_banking_transfer,9860.11
61b6f803d8beac1599eaf2fd,50200023535069,668952.55,60ec41ba55c00300382672d9,HDFC,SAAS/tech expense,5eecc6d6449e4f7cfb1c2708,2020-07-10T00:00:00.000Z,POS 514834XXXXXX9486 AMAZON PAY INDIA,shopping,,debit_card,-25000
61b6f804d8beac1599eaf308,50200023535069,702650.55,60ec41ba55c00300382672d9,HDFC,Transfer in/Revenue-other,5eecc6d6449e4f7cfb1c2708,2020-07-13T00:00:00.000Z,NEFT CR-KKBK0000958-EKANEK NETWORKS PRIV ATE LIMITED-SLICK ORGANICS PVT LTD-KKBK2 01957502429,,,net_banking_transfer,33698
61b6f805d8beac1599eaf314,50200023535069,677650.55,60ec41ba55c00300382672d9,HDFC,SAAS/tech expense,5eecc6d6449e4f7cfb1c2708,2020-07-13T00:00:00.000Z,POS 514834XXXXXX9486 AMAZON,shopping,,debit_card,-25000
61b6f806d8beac1599eaf325,50200023535069,748031.21,60ec41ba55c00300382672d9,HDFC,Revenue-PG-split enabled,5eecc6d6449e4f7cfb1c2708,2020-07-13T00:00:00.000Z,NEFT CR-UTIB0001506-RAZORPAY SOFTWARE PR,,,net_banking_transfer,70380.66
61b6f807d8beac1599eaf330,50200023535069,750899.23,60ec41ba55c00300382672d9,HDFC,Revenue-Mktplace,5eecc6d6449e4f7cfb1c2708,2020-07-13T00:00:00.000Z,NEFT CR-DEUT0797BGL-FLIPKART INTERNET P LTD-INT AC FO R INTERMEDIARY-SLICK ORGAN ICS PVT LTD-071300303GN00003,shopping,,net_banking_transfer,2868.02
61b6f808d8beac1599eaf350,50200023535069,756649.23,60ec41ba55c00300382672d9,HDFC,Transfer in/Revenue-other,5eecc6d6449e4f7cfb1c2708,2020-07-13T00:00:00.000Z,IMPS-019511013306-NAINA-HDFC-XXXXXXXXXXX 0887-VANITY WAGON,,,net_banking_transfer,5750
61b6f809d8beac1599eaf35f,50200023535069,756891.46,60ec41ba55c00300382672d9,HDFC,Revenue-Mktplace,5eecc6d6449e4f7cfb1c2708,2020-07-13T00:00:00.000Z,4060000223-TIMES INTERNET LIMITED NODAL,,,Other,242.23
61b6f809d8beac1599eaf369,50200023535069,756501.49,60ec41ba55c00300382672d9,HDFC,bank charges,5eecc6d6449e4f7cfb1c2708,2020-07-13T00:00:00.000Z,.DC INTL POS TXN MARKUP+ST 020720 030720 -MIR2019130293900,,,international_transaction_arbitrage,-389.97
61b6f80ad8beac1599eaf374,50200023535069,758013.56,60ec41ba55c00300382672d9,HDFC,Revenue-Mktplace,5eecc6d6449e4f7cfb1c2708,2020-07-13T00:00:00.000Z,NEFT CR-DEUT0797BGL-FLIPKART INTERNET PV TLTD-SLICK ORGANICS PVT LTD-071300345GN0 0263,shopping,,net_banking_transfer,1512.07
61b6f80bd8beac1599eaf389,50200023535069,718249.56,60ec41ba55c00300382672d9,HDFC,direct expenses,5eecc6d6449e4f7cfb1c2708,2020-07-13T00:00:00.000Z,"NEFT DR-UTIB0001771-NEERAJ CARPET CLEANI NG-NETBANK, MUM-N195201185858106-39764",,,net_banking_transfer,-39764
61b6f80cd8beac1599eaf397,50200023535069,727526.4,60ec41ba55c00300382672d9,HDFC,Revenue-COD,5eecc6d6449e4f7cfb1c2708,2020-07-13T00:00:00.000Z,NEFT CR-KKBK0000958-BIGFOOT RETAIL SOLUT IONS PRIVATE LIMITED-SLICK ORGANICS PVT LTD-KKBK201957637144,,,net_banking_transfer,9276.84
61b6f80dd8beac1599eaf3a3,50200023535069,739857.59,60ec41ba55c00300382672d9,HDFC,Revenue-PG-split enabled,5eecc6d6449e4f7cfb1c2708,2020-07-13T00:00:00.000Z,NEFT CR-UTIB0001506-RAZORPAY SOFTWARE PR IVATE LIMITED-SLICK ORGANICS PVT LITD-AX ISCN0053755007,investments,,net_banking_transfer,12331.19
61b6f80ed8beac1599eaf3aa,50200023535069,749455.89,60ec41ba55c00300382672d9,HDFC,Revenue-PG-split enabled,5eecc6d6449e4f7cfb1c2708,2020-07-14T00:00:00.000Z,NEFT CR-UTIB0001506-RAZORPAY SOFTWARE PR IVATE LIMITED-SLICK ORGANICS PVT LITD-AX ISCN0053774274,investments,,net_banking_transfer,9598.3
61b6f80fd8beac1599eaf3b0,50200023535069,766419.91,60ec41ba55c00300382672d9,HDFC,Revenue-Mktplace,5eecc6d6449e4f7cfb1c2708,2020-07-14T00:00:00.000Z,IMPS-019611092276-AMAZON SELLER SERVIC-H DFC-XXXXXXXX6004-5DUBN9R0P272L4CQSLICK O RGANICS PVT LTD,shopping,,net_banking_transfer,16964.02
61b6f810d8beac1599eaf3b7,50200023535069,1005204.44,60ec41ba55c00300382672d9,HDFC,Revenue-Mktplace,5eecc6d6449e4f7cfb1c2708,2020-07-14T00:00:00.000Z,NEFT CR-DEUT0797BGL-AMAZON PAY IND PVT L TD-INT AC INTM MKTPLACE-SLICK ORGANICS P VT LTD-071400176GN00132,shopping,,net_banking_transfer,238784.53
61b6f811d8beac1599eaf3bc,50200023535069,1005086.44,60ec41ba55c00300382672d9,HDFC,Tax,5eecc6d6449e4f7cfb1c2708,2020-07-14T00:00:00.000Z,ADHOC STMT CHGS INCL GST 040720-MIR20194 31774748,,,bank_charge,-118
61b6f812d8beac1599eaf3cb,50200023535069,1013968.42,60ec41ba55c00300382672d9,HDFC,Revenue-PG-split enabled,5eecc6d6449e4f7cfb1c2708,2020-07-14T00:00:00.000Z,NEFT CR-UTIB0001506-RAZORPAY SOFTWARE PR,,,net_banking_transfer,8881.98
61b6f813d8beac1599eaf3ce,50200023535069,1015176.99,60ec41ba55c00300382672d9,HDFC,Revenue-Mktplace,5eecc6d6449e4f7cfb1c2708,2020-07-15T00:00:00.000Z,NEFT CR-DEUT0797BGL-FLIPKART INTERNET P LTD-INT AC FO R INTERMEDIARY-SLICK ORGAN ICS PVT LTD-071500098GN00196,shopping,,net_banking_transfer,1208.57
61b6f814d8beac1599eaf3d8,50200023535069,1034899.43,60ec41ba55c00300382672d9,HDFC,Revenue-PG-split enabled,5eecc6d6449e4f7cfb1c2708,2020-07-15T00:00:00.000Z,NEFT CR-UTIB0001506-RAZORPAY SOFTWARE PR IVATE LIMITED-SLICK ORGANICS PVT LITD-AX ISCN0053838585,investments,,net_banking_transfer,19722.44
61b6f815d8beac1599eaf3df,50200023535069,1009899.43,60ec41ba55c00300382672d9,HDFC,SAAS/tech expense,5eecc6d6449e4f7cfb1c2708,2020-07-15T00:00:00.000Z,POS 514834XXXXXX9486 AMAZON,shopping,,debit_card,-25000
61b6f816d8beac1599eaf3e4,50200023535069,928899.43,60ec41ba55c00300382672d9,HDFC,direct expenses,5eecc6d6449e4f7cfb1c2708,2020-07-15T00:00:00.000Z,50200012495494-TPT-81000-BEAM AND WORDS LLP,,,net_banking_transfer,-81000
61b6f817d8beac1599eaf3ef,50200023535069,930059.9,60ec41ba55c00300382672d9,HDFC,Revenue-Mktplace,5eecc6d6449e4f7cfb1c2708,2020-07-15T00:00:00.000Z,NEFT CR-DEUT0797BGL-FLIPKART INTERNET PV TLTD-SLICK ORGANICS PVT LTD-071500106GN0 0058,shopping,,net_banking_transfer,1160.47
61b6f818d8beac1599eaf3f7,50200023535069,989207.85,60ec41ba55c00300382672d9,HDFC,Revenue-COD,5eecc6d6449e4f7cfb1c2708,2020-07-15T00:00:00.000Z,NEFT CR-KKBK0000958-BIGFOOT RETAIL SOLUT IONS PRIVATE LIMITED-SLICK ORGANICS PVT LTD-KKBK201978025861,,,net_banking_transfer,59147.95
61b6f819d8beac1599eaf3fe,50200023535069,1010667.59,60ec41ba55c00300382672d9,HDFC,Revenue-PG-split enabled,5eecc6d6449e4f7cfb1c2708,2020-07-15T00:00:00.000Z,NEFT CR-UTIB0001506-RAZORPAY SOFTWARE PR IVATE LIMITED-SLICK ORGANICS PVT LITD-AX ISCN0053882494,investments,,net_banking_transfer,21459.74
61b6f81ad8beac1599eaf404,50200023535069,1011222.21,60ec41ba55c00300382672d9,HDFC,Revenue-Mktplace,5eecc6d6449e4f7cfb1c2708,2020-07-15T00:00:00.000Z,NEFT CR-ICIC0000105-MANASH LIFETYLE PVT LTD-SLICKORGANICSPRIVATELIMITEDMPGGN-ICI B201970054057,,,net_banking_transfer,554.62
61b6f81bd8beac1599eaf40d,50200023535069,1027625.69,60ec41ba55c00300382672d9,HDFC,Revenue-PG-split enabled,5eecc6d6449e4f7cfb1c2708,2020-07-16T00:00:00.000Z,NEFT CR-UTIB0001506-RAZORPAY SOFTWARE PR IVATE LIMITED-SLICK ORGANICS PVT LITD-AX ISCN0053910838,investments,,net_banking_transfer,16403.48
61b6f81cd8beac1599eaf414,50200023535069,927625.69,60ec41ba55c00300382672d9,HDFC,direct expenses,5eecc6d6449e4f7cfb1c2708,2020-07-16T00:00:00.000Z,"NEFT DR-YESB0000551-VISTTA COSMETICS-NET BANK, MUM-N198201189068059-100000",,,net_banking_transfer,-100000
61b6f81dd8beac1599eaf419,50200023535069,947197.07,60ec41ba55c00300382672d9,HDFC,Revenue-PG-split enabled,5eecc6d6449e4f7cfb1c2708,2020-07-16T00:00:00.000Z,NEFT CR-UTIB0001506-RAZORPAY SOFTWARE PR IVATE LIMITED-SLICK ORGANICS PVT LITD-AX ISCN0053949698,investments,,net_banking_transfer,19571.38
61b6f81ed8beac1599eaf41b,50200023535069,949437.78,60ec41ba55c00300382672d9,HDFC,Revenue-Mktplace,5eecc6d6449e4f7cfb1c2708,2020-07-16T00:00:00.000Z,NEFT CR-ICIC0000105-MANASH LIFETYLE PVT,,,net_banking_transfer,2240.71
61b6f81fd8beac1599eaf423,50200023535069,948686.67,60ec41ba55c00300382672d9,HDFC,direct expenses,5eecc6d6449e4f7cfb1c2708,2020-07-16T00:00:00.000Z,POS 514834XXXXXX9486 MANYCHAT COM PRO,,,debit_card,-751.11
61b6f820d8beac1599eaf427,50200023535069,927446.67,60ec41ba55c00300382672d9,HDFC,direct expenses,5eecc6d6449e4f7cfb1c2708,2020-07-17T00:00:00.000Z,"NEFT DR-UTIB0000723-VEDIC COMECEUTICALS PVT LTD-NETBANK, MUM-N199201189645433-21 240",,,net_banking_transfer,-21240
61b6f820d8beac1599eaf42b,50200023535069,902446.67,60ec41ba55c00300382672d9,HDFC,SAAS/tech expense,5eecc6d6449e4f7cfb1c2708,2020-07-17T00:00:00.000Z,POS 514834XXXXXX9486 AMAZON,shopping,,debit_card,-25000
61b6f821d8beac1599eaf432,50200023535069,877446.67,60ec41ba55c00300382672d9,HDFC,direct expenses,5eecc6d6449e4f7cfb1c2708,2020-07-17T00:00:00.000Z,"NEFT DR-YESB0000162-VINAY REDDY-NETBANK, MUM-N199201189707919-25000",,,net_banking_transfer,-25000
61b6f822d8beac1599eaf439,50200023535069,885540.04,60ec41ba55c00300382672d9,HDFC,Revenue-PG-split enabled,5eecc6d6449e4f7cfb1c2708,2020-07-17T00:00:00.000Z,NEFT CR-UTIB0001506-RAZORPAY SOFTWARE PR IVATE LIMITED-SLICK ORGANICS PVT LITD-AX ISCN0053967776,investments,,net_banking_transfer,8093.37
61b6f823d8beac1599eaf43e,50200023535069,896028.32,60ec41ba55c00300382672d9,HDFC,Revenue-Mktplace,5eecc6d6449e4f7cfb1c2708,2020-07-17T00:00:00.000Z,NEFT CR-DEUT0797BGL-FLIPKART INTERNET P LTD-INT AC FO R INTERMEDIARY-SLICK ORGAN ICS PVT LTD-071700293GN00160,shopping,,net_banking_transfer,10488.28
61b6f824d8beac1599eaf442,50200023535069,898683.97,60ec41ba55c00300382672d9,HDFC,Transfer in/Revenue-other,5eecc6d6449e4f7cfb1c2708,2020-07-17T00:00:00.000Z,NEFT CR-ICIC0SF0002-ICICI BANK NODAL ACC -SLICK ORGANICS-22489548871DC,investments,,net_banking_transfer,2655.65
61b6f825d8beac1599eaf446,50200023535069,906197.84,60ec41ba55c00300382672d9,HDFC,Revenue-Mktplace,5eecc6d6449e4f7cfb1c2708,2020-07-17T00:00:00.000Z,NEFT CR-DEUT0797BGL-FLIPKART INTERNET PV TLTD-SLICK ORGANICS PVT LTD-071700294GN0 0035,shopping,,net_banking_transfer,7513.87
61b6f826d8beac1599eaf452,50200023535069,933703.14,60ec41ba55c00300382672d9,HDFC,Revenue-COD,5eecc6d6449e4f7cfb1c2708,2020-07-17T00:00:00.000Z,NEFT CR-KKBK0000958-BIGFOOT RETAIL SOLUT IONS PRIVATE LIMITED-SLICK ORGANICS PVT LTD-KKBK201998381661,,,net_banking_transfer,27505.3
61b6f827d8beac1599eaf454,50200023535069,936070.25,60ec41ba55c00300382672d9,HDFC,Revenue-Mktplace,5eecc6d6449e4f7cfb1c2708,2020-07-17T00:00:00.000Z,NEFT CR-DEUT0784BBY-TATA UNISTORE LTD-NO DAL-SLICK ORGANICS PVT LTD-071701029GN00 482,investments,,net_banking_transfer,2367.11
61b6f828d8beac1599eaf45c,50200023535069,945803.37,60ec41ba55c00300382672d9,HDFC,Revenue-PG-split enabled,5eecc6d6449e4f7cfb1c2708,2020-07-17T00:00:00.000Z,NEFT CR-UTIB0001506-RAZORPAY SOFTWARE PR IVATE LIMITED-SLICK ORGANICS PVT LITD-AX ISCN0054001835,investments,,net_banking_transfer,9733.12
61b6f829d8beac1599eaf45f,50200023535069,961070.17,60ec41ba55c00300382672d9,HDFC,Revenue-PG-split enabled,5eecc6d6449e4f7cfb1c2708,2020-07-18T00:00:00.000Z,NEFT CR-UTIB0001506-RAZORPAY SOFTWARE PR,,,net_banking_transfer,15266.8
61b6f82ad8beac1599eaf462,50200023535069,961069.12,60ec41ba55c00300382672d9,HDFC,bank charges,5eecc6d6449e4f7cfb1c2708,2020-07-18T00:00:00.000Z,DEBIT CARD PUR ADJ DT 16/07/20,,,Other,-1.05
61b6f82bd8beac1599eaf46a,50200023535069,984494.08,60ec41ba55c00300382672d9,HDFC,Revenue-PG-split enabled,5eecc6d6449e4f7cfb1c2708,2020-07-18T00:00:00.000Z,NEFT CR-UTIB0001506-RAZORPAY SOFTWARE PR IVATE LIMITED-SLICK ORGANICS PVT LITD-AX ISCN0054035446,investments,,net_banking_transfer,23424.96
61b6f82cd8beac1599eaf46f,50200023535069,980658.08,60ec41ba55c00300382672d9,HDFC,direct expenses,5eecc6d6449e4f7cfb1c2708,2020-07-18T00:00:00.000Z,"NEFT DR-ORBC0100707-UFLEX LIMITED-NETBAN K, MUM-N200201191019000-3836",loans,lender_transaction,net_banking_transfer,-3836
61b6f82dd8beac1599eaf474,50200023535069,955658.08,60ec41ba55c00300382672d9,HDFC,SAAS/tech expense,5eecc6d6449e4f7cfb1c2708,2020-07-19T00:00:00.000Z,POS 514834XXXXXX9486 AMAZON PAY INDIA,shopping,,debit_card,-25000
61b6f82ed8beac1599eaf478,50200023535069,990388.39,60ec41ba55c00300382672d9,HDFC,Revenue-PG-split enabled,5eecc6d6449e4f7cfb1c2708,2020-07-20T00:00:00.000Z,NEFT CR-UTIB0001506-RAZORPAY SOFTWARE PR IVATE LIMITED-SLICK ORGANICS PVT LITD-AX ISCN0054053194,investments,,net_banking_transfer,34730.31
61b6f82fd8beac1599eaf47c,50200023535069,993016.77,60ec41ba55c00300382672d9,HDFC,Revenue-Mktplace,5eecc6d6449e4f7cfb1c2708,2020-07-20T00:00:00.000Z,NEFT CR-DEUT0797BGL-FLIPKART INTERNET P LTD-INT AC FO R INTERMEDIARY-SLICK ORGAN ICS PVT LTD-072000144GN00294,shopping,,net_banking_transfer,2628.38
61b6f830d8beac1599eaf484,50200023535069,987773.52,60ec41ba55c00300382672d9,HDFC,direct expenses,5eecc6d6449e4f7cfb1c2708,2020-07-20T00:00:00.000Z,POS 514834XXXXXX9486 FEEDBACKFIVE,,,debit_card,-5243.25
61b6f831d8beac1599eaf489,50200023535069,977773.52,60ec41ba55c00300382672d9,HDFC,direct expenses,5eecc6d6449e4f7cfb1c2708,2020-07-20T00:00:00.000Z,SARVAN - CHQ PAID - DEVLI ROAD K,,,chq,-10000
61b6f832d8beac1599eaf48c,50200023535069,981499.66,60ec41ba55c00300382672d9,HDFC,Revenue-Mktplace,5eecc6d6449e4f7cfb1c2708,2020-07-20T00:00:00.000Z,NEFT CR-DEUT0797BGL-FLIPKART INTERNET PV TLTD-SLICK ORGANICS PVT LTD-072000187GN0 0185,shopping,,net_banking_transfer,3726.14
61b6f833d8beac1599eaf493,50200023535069,987019.67,60ec41ba55c00300382672d9,HDFC,Revenue-PG-split enabled,5eecc6d6449e4f7cfb1c2708,2020-07-20T00:00:00.000Z,NEFT CR-UTIB0001506-RAZORPAY SOFTWARE PR IVATE LIMITED-SLICK ORGANICS PVT LITD-AX ISCN0054090739,investments,,net_banking_transfer,5520.01
61b6f834d8beac1599eaf49b,50200023535069,980351.34,60ec41ba55c00300382672d9,HDFC,direct expenses,5eecc6d6449e4f7cfb1c2708,2020-07-20T00:00:00.000Z,POS 514834XXXXXX9486 HOTJAR,,,debit_card,-6668.33
61b6f835d8beac1599eaf4a2,50200023535069,943351.34,60ec41ba55c00300382672d9,HDFC,direct expenses,5eecc6d6449e4f7cfb1c2708,2020-07-21T00:00:00.000Z,"NEFT DR-CITI0000002-DHIRAJ-NETBANK, MUM- N203201192077331-37000",,,net_banking_transfer,-37000
61b6f836d8beac1599eaf4a8,50200023535069,908351.34,60ec41ba55c00300382672d9,HDFC,direct expenses,5eecc6d6449e4f7cfb1c2708,2020-07-21T00:00:00.000Z,"NEFT DR-ICIC0000542-AVANTIKA SUKHIA-NETB ANK, MUM-N203201192074211-35000",,,net_banking_transfer,-35000
61b6f836d8beac1599eaf4ae,50200023535069,900851.34,60ec41ba55c00300382672d9,HDFC,direct expenses,5eecc6d6449e4f7cfb1c2708,2020-07-21T00:00:00.000Z,"NEFT DR-SIBL0000555-JAIVEER KUMAR-NETBAN K, MUM-N203201192077767-7500",,,net_banking_transfer,-7500
61b6f837d8beac1599eaf4b3,50200023535069,895851.34,60ec41ba55c00300382672d9,HDFC,direct expenses,5eecc6d6449e4f7cfb1c2708,2020-07-21T00:00:00.000Z,"NEFT DR-PUNB0398000-MEENA SINGH-NETBANK, MUM-N203201192077793-5000",,,net_banking_transfer,-5000
61b6f838d8beac1599eaf4b8,50200023535069,885851.34,60ec41ba55c00300382672d9,HDFC,direct expenses,5eecc6d6449e4f7cfb1c2708,2020-07-21T00:00:00.000Z,NEFT DR-SBIN0001189-SANDEEP SINGH-NETBAN,,,net_banking_transfer,-10000
61b6f839d8beac1599eaf4c4,50200023535069,877601.34,60ec41ba55c00300382672d9,HDFC,direct expenses,5eecc6d6449e4f7cfb1c2708,2020-07-21T00:00:00.000Z,"NEFT DR-KKBK0000811-NASIR KHAN-NETBANK, MUM-N203201192074623-8250",,,net_banking_transfer,-8250
61b6f83ad8beac1599eaf4d0,50200023535069,860101.34,60ec41ba55c00300382672d9,HDFC,direct expenses,5eecc6d6449e4f7cfb1c2708,2020-07-21T00:00:00.000Z,"NEFT DR-ICIC0003374-SIDDHARTH KANOJIA-NE TBANK, MUM-N203201192064906-17500",,,net_banking_transfer,-17500
61b6f83bd8beac1599eaf4d3,50200023535069,857101.34,60ec41ba55c00300382672d9,HDFC,direct expenses,5eecc6d6449e4f7cfb1c2708,2020-07-21T00:00:00.000Z,"NEFT DR-ALLA0210591-CHAMPA DEVI-NETBANK, MUM-N203201192074647-3000",,,net_banking_transfer,-3000
61b6f83cd8beac1599eaf4db,50200023535069,843601.34,60ec41ba55c00300382672d9,HDFC,direct expenses,5eecc6d6449e4f7cfb1c2708,2020-07-21T00:00:00.000Z,"NEFT DR-SYNB0005170-SNEHAL TAYDE-NETBANK , MUM-N203201192077940-13500",,,net_banking_transfer,-13500
61b6f83dd8beac1599eaf4de,50200023535069,822751.34,60ec41ba55c00300382672d9,HDFC,direct expenses,5eecc6d6449e4f7cfb1c2708,2020-07-21T00:00:00.000Z,"NEFT DR-UTIB0000120-ADNAN ALI-NETBANK, M UM-N203201192074702-20850",,,net_banking_transfer,-20850
61b6f83ed8beac1599eaf4e2,50200023535069,776251.34,60ec41ba55c00300382672d9,HDFC,direct expenses,5eecc6d6449e4f7cfb1c2708,2020-07-21T00:00:00.000Z,"NEFT DR-BKDN0450123-ARTISTO DESIGNZ-NETB ANK, MUM-N203201192074733-46500",,,net_banking_transfer,-46500
61b6f83fd8beac1599eaf4e9,50200023535069,760251.34,60ec41ba55c00300382672d9,HDFC,direct expenses,5eecc6d6449e4f7cfb1c2708,2020-07-21T00:00:00.000Z,00901610080520-TPT-16000-POOJA KAPIL SHR OTRIYA,,,net_banking_transfer,-16000
61b6f840d8beac1599eaf4f5,50200023535069,704217.34,60ec41ba55c00300382672d9,HDFC,direct expenses,5eecc6d6449e4f7cfb1c2708,2020-07-21T00:00:00.000Z,50100301160692-TPT-56034-TARUN GARG,,,net_banking_transfer,-56034
61b6f841d8beac1599eaf4f9,50200023535069,648567.34,60ec41ba55c00300382672d9,HDFC,direct expenses,5eecc6d6449e4f7cfb1c2708,2020-07-21T00:00:00.000Z,02771610131904-TPT-55650-DIGANT BHATT,,,net_banking_transfer,-55650
61b6f842d8beac1599eaf4fd,50200023535069,615567.34,60ec41ba55c00300382672d9,HDFC,direct expenses,5eecc6d6449e4f7cfb1c2708,2020-07-21T00:00:00.000Z,50100330586095-TPT-33000-DIWAKAR UNIYAL,,,net_banking_transfer,-33000
61b6f843d8beac1599eaf502,50200023535069,605567.34,60ec41ba55c00300382672d9,HDFC,direct expenses,5eecc6d6449e4f7cfb1c2708,2020-07-21T00:00:00.000Z,"NEFT DR-KKBK0000291-ROLI GARG-NETBANK, M UM-N203201192075221-10000",,,net_banking_transfer,-10000
61b6f844d8beac1599eaf50b,50200023535069,594767.34,60ec41ba55c00300382672d9,HDFC,direct expenses,5eecc6d6449e4f7cfb1c2708,2020-07-21T00:00:00.000Z,16392000002047-TPT-10800-INCNUT DIGITAL PRIVATE LIMITED,,,net_banking_transfer,-10800
61b6f845d8beac1599eaf50f,50200023535069,494767.34,60ec41ba55c00300382672d9,HDFC,direct expenses,5eecc6d6449e4f7cfb1c2708,2020-07-21T00:00:00.000Z,"NEFT DR-INDB0000148-ACQUISORY INDIA CONS ULTING PVT LTD-NETBANK, MUM-N20320119207 8315-100000",,,net_banking_transfer,-100000
61b6f846d8beac1599eaf517,50200023535069,487269.34,60ec41ba55c00300382672d9,HDFC,Salary/Emp/consultant Expense,5eecc6d6449e4f7cfb1c2708,2020-07-21T00:00:00.000Z,"NEFT DR-UTIB0003142-ARIA DESAI UG ELIZAB ETH THOMAS ALEX-NETBANK, MUM-N2032011920 78835-7498",,,net_banking_transfer,-7498
61b6f847d8beac1599eaf51d,50200023535069,486717.34,60ec41ba55c00300382672d9,HDFC,direct expenses,5eecc6d6449e4f7cfb1c2708,2020-07-21T00:00:00.000Z,"NEFT DR-UTIB0000028-PREETI KAUR BHAMRA-N ETBANK, MUM-N203201192083179-552",,,net_banking_transfer,-552
61b6f848d8beac1599eaf521,50200023535069,484222.34,60ec41ba55c00300382672d9,HDFC,direct expenses,5eecc6d6449e4f7cfb1c2708,2020-07-21T00:00:00.000Z,"NEFT DR-SBIN0008078-PANDIT PLASTICS-NETB ANK, MUM-N203201192090844-2495",,,net_banking_transfer,-2495
61b6f849d8beac1599eaf527,50200023535069,483467.34,60ec41ba55c00300382672d9,HDFC,direct expenses,5eecc6d6449e4f7cfb1c2708,2020-07-21T00:00:00.000Z,50100097355028-TPT-755-PALLAVI JUNEJA,,,net_banking_transfer,-755
61b6f84ad8beac1599eaf52c,50200023535069,492152.53,60ec41ba55c00300382672d9,HDFC,Revenue-PG-split enabled,5eecc6d6449e4f7cfb1c2708,2020-07-21T00:00:00.000Z,NEFT CR-UTIB0001506-RAZORPAY SOFTWARE PR IVATE LIMITED-SLICK ORGANICS PVT LITD-AX ISCN0054106442,investments,,net_banking_transfer,8685.19
61b6f84bd8beac1599eaf530,50200023535069,467152.53,60ec41ba55c00300382672d9,HDFC,SAAS/tech expense,5eecc6d6449e4f7cfb1c2708,2020-07-21T00:00:00.000Z,POS 514834XXXXXX9486 AMAZON PAY INDIA,shopping,,debit_card,-25000
61b6f84cd8beac1599eaf563,50200023535069,495058.81,60ec41ba55c00300382672d9,HDFC,Revenue-Mktplace,5eecc6d6449e4f7cfb1c2708,2020-07-21T00:00:00.000Z,IMPS-020311369672-AMAZON SELLER SERVIC-H DFC-XXXXXXXX6004-14WMA0OMWJFP7M4XSLICK O RGANICS PVT LTD,shopping,,net_banking_transfer,27906.28
61b6f84cd8beac1599eaf567,50200023535069,759850.88,60ec41ba55c00300382672d9,HDFC,Revenue-Mktplace,5eecc6d6449e4f7cfb1c2708,2020-07-21T00:00:00.000Z,NEFT CR-DEUT0797BGL-AMAZON PAY IND PVT L TD-INT AC INTM MKTPLACE-SLICK ORGANICS P VT LTD-072100234GN00558,shopping,,net_banking_transfer,264792.07
61b6f84dd8beac1599eaf56b,50200023535069,774965.41,60ec41ba55c00300382672d9,HDFC,Revenue-PG-split enabled,5eecc6d6449e4f7cfb1c2708,2020-07-21T00:00:00.000Z,NEFT CR-UTIB0001506-RAZORPAY SOFTWARE PR IVATE LIMITED-SLICK ORGANICS PVT LITD-AX ISCN0054144935,investments,,net_banking_transfer,15114.53
61b6f84ed8beac1599eaf574,50200023535069,777033.75,60ec41ba55c00300382672d9,HDFC,Revenue-Mktplace,5eecc6d6449e4f7cfb1c2708,2020-07-22T00:00:00.000Z,NEFT CR-DEUT0797BGL-FLIPKART INTERNET P LTD-INT AC FO R INTERMEDIARY-SLICK ORGAN ICS PVT LTD-072200094GN00012,shopping,,net_banking_transfer,2068.34
61b6f84fd8beac1599eaf577,50200023535069,794442.95,60ec41ba55c00300382672d9,HDFC,Revenue-PG-split enabled,5eecc6d6449e4f7cfb1c2708,2020-07-22T00:00:00.000Z,NEFT CR-UTIB0001506-RAZORPAY SOFTWARE PR IVATE LIMITED-SLICK ORGANICS PVT LITD-AX ISCN0054157533,investments,,net_banking_transfer,17409.2
61b6f850d8beac1599eaf580,50200023535069,294442.95,60ec41ba55c00300382672d9,HDFC,direct expenses,5eecc6d6449e4f7cfb1c2708,2020-07-22T00:00:00.000Z,"NEFT DR-ICIC0003430-HASHTAG ORANGE ADVER TISING PVT LTD-NETBANK, MUM-N20420119293 5003-500000",,,net_banking_transfer,-500000
61b6f851d8beac1599eaf583,50200023535069,299624.95,60ec41ba55c00300382672d9,HDFC,Revenue-Mktplace,5eecc6d6449e4f7cfb1c2708,2020-07-22T00:00:00.000Z,NEFT CR-KKBK0000958-SUPERMARKET GROCERY SUPPLIES PVT LTD-SLICK ORGANICS PVT LTD- KKBK202049010343,shopping,,net_banking_transfer,5182
61b6f852d8beac1599eaf587,50200023535069,304967.45,60ec41ba55c00300382672d9,HDFC,Revenue-Mktplace,5eecc6d6449e4f7cfb1c2708,2020-07-22T00:00:00.000Z,NEFT CR-KKBK0000958-SUPERMARKET GROCERY SUPPLIES PVT LTD-SLICK ORGANICS PVT LTD- KKBK202049010701,shopping,,net_banking_transfer,5342.5
61b6f853d8beac1599eaf59d,50200023535069,308536.45,60ec41ba55c00300382672d9,HDFC,Revenue-Mktplace,5eecc6d6449e4f7cfb1c2708,2020-07-22T00:00:00.000Z,NEFT CR-KKBK0000958-SUPERMARKET GROCERY,shopping,,net_banking_transfer,3569
61b6f854d8beac1599eaf5a3,50200023535069,316593.95,60ec41ba55c00300382672d9,HDFC,Revenue-Mktplace,5eecc6d6449e4f7cfb1c2708,2020-07-22T00:00:00.000Z,NEFT CR-KKBK0000958-SUPERMARKET GROCERY SUPPLIES PVT LTD-SLICK ORGANICS PVT LTD- KKBK202049011469,shopping,,net_banking_transfer,8057.5
61b6f855d8beac1599eaf5b7,50200023535069,325785.95,60ec41ba55c00300382672d9,HDFC,Revenue-Mktplace,5eecc6d6449e4f7cfb1c2708,2020-07-22T00:00:00.000Z,NEFT CR-KKBK0000958-SUPERMARKET GROCERY SUPPLIES PVT LTD-SLICK ORGANICS PVT LTD- KKBK202049011481,shopping,,net_banking_transfer,9192
61b6f856d8beac1599eaf5bb,50200023535069,327227.2,60ec41ba55c00300382672d9,HDFC,Revenue-Mktplace,5eecc6d6449e4f7cfb1c2708,2020-07-22T00:00:00.000Z,NEFT CR-DEUT0797BGL-FLIPKART INTERNET PV TLTD-SLICK ORGANICS PVT LTD-072200102GN0 0029,shopping,,net_banking_transfer,1441.25
61b6f857d8beac1599eaf5bf,50200023535069,336056.58,60ec41ba55c00300382672d9,HDFC,Revenue-COD,5eecc6d6449e4f7cfb1c2708,2020-07-22T00:00:00.000Z,NEFT CR-KKBK0000958-BIGFOOT RETAIL SOLUT IONS PRIVATE LIMITED-SLICK ORGANICS PVT LTD-KKBK202049051398,,,net_banking_transfer,8829.38
61b6f858d8beac1599eaf5c7,50200023535069,341516.32,60ec41ba55c00300382672d9,HDFC,Revenue-PG-split enabled,5eecc6d6449e4f7cfb1c2708,2020-07-22T00:00:00.000Z,NEFT CR-UTIB0001506-RAZORPAY SOFTWARE PR IVATE LIMITED-SLICK ORGANICS PVT LITD-AX ISCN0054194155,investments,,net_banking_transfer,5459.74
61b6f859d8beac1599eaf5cc,50200023535069,341524.83,60ec41ba55c00300382672d9,HDFC,Adjustments/Reversal,5eecc6d6449e4f7cfb1c2708,2020-07-22T00:00:00.000Z,DEBIT CARD PUR ADJ DT 20/07/20,,,Other,8.51
61b6f85ad8beac1599eaf5d6,50200023535069,341535.66,60ec41ba55c00300382672d9,HDFC,Adjustments/Reversal,5eecc6d6449e4f7cfb1c2708,2020-07-22T00:00:00.000Z,DEBIT CARD PUR ADJ DT 20/07/20,,,Other,10.83
61b6f85bd8beac1599eaf5dd,50200023535069,214359.66,60ec41ba55c00300382672d9,HDFC,direct expenses,5eecc6d6449e4f7cfb1c2708,2020-07-23T00:00:00.000Z,"NEFT DR-CITI0000032-TRADETRACKER INDIA L LP-NETBANK, MUM-N205201193762016-127176",,,net_banking_transfer,-127176
61b6f85cd8beac1599eaf5e1,50200023535069,231092.51,60ec41ba55c00300382672d9,HDFC,Revenue-PG-split enabled,5eecc6d6449e4f7cfb1c2708,2020-07-23T00:00:00.000Z,NEFT CR-UTIB0001506-RAZORPAY SOFTWARE PR IVATE LIMITED-SLICK ORGANICS PVT LITD-AX ISCN0054215051,investments,,net_banking_transfer,16732.85
61b6f85dd8beac1599eaf5e7,50200023535069,227777.51,60ec41ba55c00300382672d9,HDFC,agency/vendor expense,5eecc6d6449e4f7cfb1c2708,2020-07-23T00:00:00.000Z,50200025524947-TPT-3315-AFFOY MEDIA PRIV ATE LIMITED,,,net_banking_transfer,-3315
61b6f85ed8beac1599eaf5ee,50200023535069,202777.51,60ec41ba55c00300382672d9,HDFC,SAAS/tech expense,5eecc6d6449e4f7cfb1c2708,2020-07-23T00:00:00.000Z,POS 514834XXXXXX9486 AMAZON,shopping,,debit_card,-25000
61b6f85fd8beac1599eaf5f3,50200023535069,203449.81,60ec41ba55c00300382672d9,HDFC,Revenue-Mktplace,5eecc6d6449e4f7cfb1c2708,2020-07-23T00:00:00.000Z,NEFT CR-ICIC0000104-GOQII TECHNOLOGIES P VT LTD-SLICK ORGANICS PRIVATE LIMITED-CM S1551299368,,,net_banking_transfer,672.3
61b6f860d8beac1599eaf5f7,50200023535069,203737.81,60ec41ba55c00300382672d9,HDFC,Transfer in/Revenue-other,5eecc6d6449e4f7cfb1c2708,2020-07-23T00:00:00.000Z,NEFT CR-KKBK0000958-LIFEFRONT COVER PRIV ATE LIMITED-ARATA-KKBK202059203527,,,net_banking_transfer,288
61b6f861d8beac1599eaf5fb,50200023535069,216879.01,60ec41ba55c00300382672d9,HDFC,Revenue-PG-split enabled,5eecc6d6449e4f7cfb1c2708,2020-07-23T00:00:00.000Z,NEFT CR-UTIB0001506-RAZORPAY SOFTWARE PR,,,net_banking_transfer,13141.2
61b6f862d8beac1599eaf600,50200023535069,220325.36,60ec41ba55c00300382672d9,HDFC,Revenue-Mktplace,5eecc6d6449e4f7cfb1c2708,2020-07-23T00:00:00.000Z,NEFT CR-ICIC0000105-MANASH LIFETYLE PVT LTD-SLICKORGANICSPRIVATELIMITEDMPMUM-ICI B202050049809,,,net_banking_transfer,3446.35
61b6f862d8beac1599eaf609,50200023535069,234822.07,60ec41ba55c00300382672d9,HDFC,Revenue-PG-split enabled,5eecc6d6449e4f7cfb1c2708,2020-07-24T00:00:00.000Z,NEFT CR-UTIB0001506-RAZORPAY SOFTWARE PR IVATE LIMITED-SLICK ORGANICS PVT LITD-AX ISCN0054268734,investments,,net_banking_transfer,14496.71
61b6f863d8beac1599eaf60d,50200023535069,240243.68,60ec41ba55c00300382672d9,HDFC,Revenue-Mktplace,5eecc6d6449e4f7cfb1c2708,2020-07-24T00:00:00.000Z,NEFT CR-DEUT0797BGL-FLIPKART INTERNET P LTD-INT AC FO R INTERMEDIARY-SLICK ORGAN ICS PVT LTD-072400093GN00196,shopping,,net_banking_transfer,5421.61
61b6f864d8beac1599eaf615,50200023535069,235243.68,60ec41ba55c00300382672d9,HDFC,direct expenses,5eecc6d6449e4f7cfb1c2708,2020-07-24T00:00:00.000Z,"NEFT DR-ICIC0000250-SHOBHA RANA-NETBANK, MUM-N206201194871481-5000",,,net_banking_transfer,-5000
61b6f865d8beac1599eaf618,50200023535069,225243.68,60ec41ba55c00300382672d9,HDFC,direct expenses,5eecc6d6449e4f7cfb1c2708,2020-07-24T00:00:00.000Z,"SELF - CHQ PAID - KALKAJI, NEW",,,chq,-10000
61b6f866d8beac1599eaf61d,50200023535069,228846.98,60ec41ba55c00300382672d9,HDFC,Revenue-Mktplace,5eecc6d6449e4f7cfb1c2708,2020-07-24T00:00:00.000Z,NEFT CR-DEUT0797BGL-FLIPKART INTERNET PV TLTD-SLICK ORGANICS PVT LTD-072400103GN0 0145,shopping,,net_banking_transfer,3603.3
61b6f867d8beac1599eaf624,50200023535069,229376.28,60ec41ba55c00300382672d9,HDFC,Transfer in/Revenue-other,5eecc6d6449e4f7cfb1c2708,2020-07-24T00:00:00.000Z,NEFT CR-ICIC0SF0002-ICICI BANK NODAL ACC -SLICK ORGANICS-22516533331DC,investments,,net_banking_transfer,529.3
61b6f868d8beac1599eaf629,50200023535069,229832.75,60ec41ba55c00300382672d9,HDFC,Revenue-Mktplace,5eecc6d6449e4f7cfb1c2708,2020-07-24T00:00:00.000Z,NEFT CR-DEUT0784BBY-TATA UNISTORE LTD-NO DAL-SLICK ORGANICS PVT LTD-072400958GN00 583,investments,,net_banking_transfer,456.47
61b6f869d8beac1599eaf62d,50200023535069,271678.49,60ec41ba55c00300382672d9,HDFC,Revenue-COD,5eecc6d6449e4f7cfb1c2708,2020-07-24T00:00:00.000Z,NEFT CR-KKBK0000958-BIGFOOT RETAIL SOLUT IONS PRIVATE LIMITED-SLICK ORGANICS PVT LTD-KKBK202069402936,,,net_banking_transfer,41845.74
61b6f86ad8beac1599eaf631,50200023535069,282511.82,60ec41ba55c00300382672d9,HDFC,Revenue-PG-split enabled,5eecc6d6449e4f7cfb1c2708,2020-07-24T00:00:00.000Z,NEFT CR-UTIB0001506-RAZORPAY SOFTWARE PR IVATE LIMITED-SLICK ORGANICS PVT LITD-AX ISCN0054304721,investments,,net_banking_transfer,10833.33
61b6f86bd8beac1599eaf635,50200023535069,257511.82,60ec41ba55c00300382672d9,HDFC,SAAS/tech expense,5eecc6d6449e4f7cfb1c2708,2020-07-25T00:00:00.000Z,POS 514834XXXXXX9486 AMAZON,shopping,,debit_card,-25000
61b6f86cd8beac1599eaf63d,50200023535069,253872.82,60ec41ba55c00300382672d9,HDFC,direct expenses,5eecc6d6449e4f7cfb1c2708,2020-07-26T00:00:00.000Z,POS 514834XXXXXX9486 FRESHWORKS INC,,,debit_card,-3639
61b6f86dd8beac1599eaf640,50200023535069,258897.91,60ec41ba55c00300382672d9,HDFC,Revenue-Mktplace,5eecc6d6449e4f7cfb1c2708,2020-07-27T00:00:00.000Z,NEFT CR-DEUT0797BGL-FLIPKART INTERNET P,shopping,,net_banking_transfer,5025.09
61b6f86ed8beac1599eaf645,50200023535069,313934.9,60ec41ba55c00300382672d9,HDFC,Revenue-PG-split enabled,5eecc6d6449e4f7cfb1c2708,2020-07-27T00:00:00.000Z,NEFT CR-UTIB0001506-RAZORPAY SOFTWARE PR IVATE LIMITED-SLICK ORGANICS PVT LITD-AX ISCN0054329972,investments,,net_banking_transfer,55036.99
61b6f86fd8beac1599eaf64c,50200023535069,288934.9,60ec41ba55c00300382672d9,HDFC,SAAS/tech expense,5eecc6d6449e4f7cfb1c2708,2020-07-27T00:00:00.000Z,POS 514834XXXXXX9486 AMAZON,shopping,,debit_card,-25000
61b6f870d8beac1599eaf654,50200023535069,292345.58,60ec41ba55c00300382672d9,HDFC,Revenue-Mktplace,5eecc6d6449e4f7cfb1c2708,2020-07-27T00:00:00.000Z,NEFT CR-DEUT0797BGL-FLIPKART INTERNET PV TLTD-SLICK ORGANICS PVT LTD-072700269GN0 0267,shopping,,net_banking_transfer,3410.68
61b6f871d8beac1599eaf65d,50200023535069,292314.51,60ec41ba55c00300382672d9,HDFC,bank charges,5eecc6d6449e4f7cfb1c2708,2020-07-27T00:00:00.000Z,.DC INTL POS TXN MARKUP+ST 160720 180720 -MIR2020563880989,,,international_transaction_arbitrage,-31.07
61b6f872d8beac1599eaf662,50200023535069,312298.28,60ec41ba55c00300382672d9,HDFC,Revenue-PG-split enabled,5eecc6d6449e4f7cfb1c2708,2020-07-27T00:00:00.000Z,NEFT CR-UTIB0001506-RAZORPAY SOFTWARE PR IVATE LIMITED-SLICK ORGANICS PVT LITD-AX ISCN0054374950,investments,,net_banking_transfer,19983.77
61b6f873d8beac1599eaf669,50200023535069,341797.15,60ec41ba55c00300382672d9,HDFC,Revenue-PG-split enabled,5eecc6d6449e4f7cfb1c2708,2020-07-28T00:00:00.000Z,NEFT CR-UTIB0001506-RAZORPAY SOFTWARE PR IVATE LIMITED-SLICK ORGANICS PVT LITD-AX ISCN0054390676,investments,,net_banking_transfer,29498.87
61b6f874d8beac1599eaf66d,50200023535069,339663.15,60ec41ba55c00300382672d9,HDFC,SAAS/tech expense,5eecc6d6449e4f7cfb1c2708,2020-07-28T00:00:00.000Z,POS 514834XXXXXX9486 AMAZON,shopping,,debit_card,-2134
61b6f875d8beac1599eaf670,50200023535069,355331.27,60ec41ba55c00300382672d9,HDFC,Revenue-Mktplace,5eecc6d6449e4f7cfb1c2708,2020-07-28T00:00:00.000Z,IMPS-021011236811-AMAZON SELLER SERVIC-H DFC-XXXXXXXX6004-2G019DFFI6S10D44SLICK O RGANICS PVT LTD,shopping,,net_banking_transfer,15668.12
61b6f876d8beac1599eaf676,50200023535069,557205.69,60ec41ba55c00300382672d9,HDFC,Revenue-Mktplace,5eecc6d6449e4f7cfb1c2708,2020-07-28T00:00:00.000Z,NEFT CR-DEUT0797BGL-AMAZON PAY IND PVT L TD-INT AC INTM MKTPLACE-SLICK ORGANICS P VT LTD-072800302GN00171,shopping,,net_banking_transfer,201874.42
61b6f877d8beac1599eaf684,50200023535069,558655.38,60ec41ba55c00300382672d9,HDFC,Revenue-Mktplace,5eecc6d6449e4f7cfb1c2708,2020-07-28T00:00:00.000Z,4060000374-TIMES INTERNET LIMITED NODAL,,,Other,1449.69
61b6f878d8beac1599eaf686,50200023535069,533655.38,60ec41ba55c00300382672d9,HDFC,SAAS/tech expense,5eecc6d6449e4f7cfb1c2708,2020-07-28T00:00:00.000Z,POS 514834XXXXXX9486 AMAZON PAY INDIA,shopping,,debit_card,-25000
61b6f878d8beac1599eaf68f,50200023535069,513655.38,60ec41ba55c00300382672d9,HDFC,direct expenses,5eecc6d6449e4f7cfb1c2708,2020-07-28T00:00:00.000Z,"NEFT DR-HSBC0400002-MAERSK LINE INDIA PV T LTD-NETBANK, MUM-N210201197569357-2000 0",,,net_banking_transfer,-20000
61b6f879d8beac1599eaf692,50200023535069,513439.18,60ec41ba55c00300382672d9,HDFC,bank charges,5eecc6d6449e4f7cfb1c2708,2020-07-28T00:00:00.000Z,.DC INTL POS TXN MARKUP+ST 190720 220720 -MIR2020767412605,,,international_transaction_arbitrage,-216.2
61b6f87ad8beac1599eaf698,50200023535069,513164.23,60ec41ba55c00300382672d9,HDFC,bank charges,5eecc6d6449e4f7cfb1c2708,2020-07-28T00:00:00.000Z,.DC INTL POS TXN MARKUP+ST 200720 220720 -MIR2020767389364,,,international_transaction_arbitrage,-274.95
61b6f87bd8beac1599eaf6a2,50200023535069,520263.37,60ec41ba55c00300382672d9,HDFC,Revenue-PG-split enabled,5eecc6d6449e4f7cfb1c2708,2020-07-28T00:00:00.000Z,NEFT CR-UTIB0001506-RAZORPAY SOFTWARE PR,,,net_banking_transfer,7099.14
61b6f87cd8beac1599eaf6b1,50200023535069,519142.73,60ec41ba55c00300382672d9,HDFC,direct expenses,5eecc6d6449e4f7cfb1c2708,2020-07-29T00:00:00.000Z,POS 514834XXXXXX9486 ZOOM.US,,,debit_card,-1120.64
61b6f87dd8beac1599eaf6ba,50200023535069,535147.54,60ec41ba55c00300382672d9,HDFC,Revenue-PG-split enabled,5eecc6d6449e4f7cfb1c2708,2020-07-29T00:00:00.000Z,NEFT CR-UTIB0001506-RAZORPAY SOFTWARE PR IVATE LIMITED-SLICK ORGANICS PVT LITD-AX ISCN0054449264,investments,,net_banking_transfer,16004.81
61b6f87ed8beac1599eaf6ce,50200023535069,543597.05,60ec41ba55c00300382672d9,HDFC,Revenue-PG-non-split,5eecc6d6449e4f7cfb1c2708,2020-07-29T00:00:00.000Z,NEFT CR-SCBL0036001-STRIPE INDIA PRIVATE -SLICK ORGANICS PRIVATE LIMITED-SSG17413 Q0068131,investments,,net_banking_transfer,8449.51
61b6f87fd8beac1599eaf6e1,50200023535069,551544.11,60ec41ba55c00300382672d9,HDFC,Revenue-Mktplace,5eecc6d6449e4f7cfb1c2708,2020-07-29T00:00:00.000Z,NEFT CR-DEUT0797BGL-FLIPKART INTERNET P LTD-INT AC FO R INTERMEDIARY-SLICK ORGAN ICS PVT LTD-072900114GN00075,shopping,,net_banking_transfer,7947.06
61b6f880d8beac1599eaf6ef,50200023535069,574795.11,60ec41ba55c00300382672d9,HDFC,Transfer in/Revenue-other,5eecc6d6449e4f7cfb1c2708,2020-07-29T00:00:00.000Z,IMPS-021111017648-NAINA-HDFC-XXXXXXXXXXX 0887-VANITY WAGON,,,net_banking_transfer,23251
61b6f881d8beac1599eaf6f1,50200023535069,581965.08,60ec41ba55c00300382672d9,HDFC,Revenue-Mktplace,5eecc6d6449e4f7cfb1c2708,2020-07-29T00:00:00.000Z,NEFT CR-DEUT0797BGL-FLIPKART INTERNET PV TLTD-SLICK ORGANICS PVT LTD-072900119GN0 0111,shopping,,net_banking_transfer,7169.97
61b6f882d8beac1599eaf710,50200023535069,582214.35,60ec41ba55c00300382672d9,HDFC,Revenue-COD,5eecc6d6449e4f7cfb1c2708,2020-07-29T00:00:00.000Z,NEFT CR-KKBK0000958-BIGFOOT RETAIL SOLUT IONS PRIVATE LIMITED-SLICK ORGANICS PVT LTD-KKBK202111003035,,,net_banking_transfer,249.27
61b6f883d8beac1599eaf715,50200023535069,790586.96,60ec41ba55c00300382672d9,HDFC,Revenue-PG-split enabled,5eecc6d6449e4f7cfb1c2708,2020-07-29T00:00:00.000Z,RTGS CR-UTIB0001506-RAZORPAY SOFTWARE PR IVATE LIMITED --SLICK ORGANICS PVT LITD- UTIBR52020072900342898,,,net_banking_transfer,208372.61
61b6f884d8beac1599eaf73a,50200023535069,781514.96,60ec41ba55c00300382672d9,HDFC,direct expenses,5eecc6d6449e4f7cfb1c2708,2020-07-30T00:00:00.000Z,CHQ PAID-MICR CTS-NO-YADAV PACKAGING,,,chq,-9072
61b6f885d8beac1599eaf74a,50200023535069,1281514.96,60ec41ba55c00300382672d9,HDFC,Internal Transfers,5eecc6d6449e4f7cfb1c2708,2020-07-30T00:00:00.000Z,IB FUNDS TRANSFER CR-50200035187206 -SL ICK ORGANICS PVT LTD,investments,,Other,500000
61b6f886d8beac1599eaf755,50200023535069,1389516.49,60ec41ba55c00300382672d9,HDFC,Revenue-PG-split enabled,5eecc6d6449e4f7cfb1c2708,2020-07-30T00:00:00.000Z,NEFT CR-UTIB0001506-RAZORPAY SOFTWARE PR IVATE LIMITED-SLICK ORGANICS PVT LITD-AX ISCN0054515808,investments,,net_banking_transfer,108001.53
61b6f887d8beac1599eaf75c,50200023535069,1339516.49,60ec41ba55c00300382672d9,HDFC,direct expenses,5eecc6d6449e4f7cfb1c2708,2020-07-30T00:00:00.000Z,NEFT DR-SCBL0036020-FREIGHT SYSTEMS INDI,,,net_banking_transfer,-50000
61b6f888d8beac1599eaf77a,50200023535069,525248.49,60ec41ba55c00300382672d9,HDFC,direct expenses,5eecc6d6449e4f7cfb1c2708,2020-07-30T00:00:00.000Z,"RTGS DR-SBIN0005937-CONCORD MARITIME AND LOGISTICS -KALKAJI, NEW-HDFCR5202007309 0518219",,,net_banking_transfer,-814268
61b6f889d8beac1599eaf789,50200023535069,278005.49,60ec41ba55c00300382672d9,HDFC,direct expenses,5eecc6d6449e4f7cfb1c2708,2020-07-30T00:00:00.000Z,"RTGS DR-SCBL0036020-FREIGHT SYSTEMS (IND IA) PVT LTD-KALKAJI, NEW-HDFCR5202007309 0522271",,,net_banking_transfer,-247243
61b6f88ad8beac1599eaf794,50200023535069,279313.49,60ec41ba55c00300382672d9,HDFC,Revenue-Mktplace,5eecc6d6449e4f7cfb1c2708,2020-07-30T00:00:00.000Z,POS REF 514834******9486-07/30 AMAZON,shopping,,refund,1308
61b6f88bd8beac1599eaf799,50200023535069,279310.64,60ec41ba55c00300382672d9,HDFC,bank charges,5eecc6d6449e4f7cfb1c2708,2020-07-30T00:00:00.000Z,DEBIT CARD PUR ADJ DT 29/07/20,,,Other,-2.85
61b6f88cd8beac1599eaf79e,50200023535069,287076.91,60ec41ba55c00300382672d9,HDFC,Revenue-PG-split enabled,5eecc6d6449e4f7cfb1c2708,2020-07-30T00:00:00.000Z,NEFT CR-UTIB0001506-RAZORPAY SOFTWARE PR IVATE LIMITED-SLICK ORGANICS PVT LITD-AX ISCN0054561196,investments,,net_banking_transfer,7766.27
61b6f88dd8beac1599eaf7a8,50200023535069,262076.91,60ec41ba55c00300382672d9,HDFC,SAAS/tech expense,5eecc6d6449e4f7cfb1c2708,2020-07-30T00:00:00.000Z,POS 514834XXXXXX9486 AMAZON,shopping,,debit_card,-25000
61b6f88ed8beac1599eaf7ae,50200023535069,237830.91,60ec41ba55c00300382672d9,HDFC,direct expenses,5eecc6d6449e4f7cfb1c2708,2020-07-31T00:00:00.000Z,"NEFT DR-IOBA0001834-VINDHYA SINGH-NETBAN K, MUM-N213201200255383-24246",,,net_banking_transfer,-24246
61b6f88fd8beac1599eaf7b9,50200023535069,246974.7,60ec41ba55c00300382672d9,HDFC,Revenue-PG-split enabled,5eecc6d6449e4f7cfb1c2708,2020-07-31T00:00:00.000Z,NEFT CR-UTIB0001506-RAZORPAY SOFTWARE PR IVATE LIMITED-SLICK ORGANICS PVT LITD-AX ISCN0054590972,investments,,net_banking_transfer,9143.79
61b6f890d8beac1599eaf7c2,50200023535069,243977.53,60ec41ba55c00300382672d9,HDFC,SAAS/tech expense,5eecc6d6449e4f7cfb1c2708,2020-07-31T00:00:00.000Z,POS 514834XXXXXX9486 AMAZON SELLER RE,shopping,,debit_card,-2997.17
61b6f891d8beac1599eaf7c9,50200023535069,244506.83,60ec41ba55c00300382672d9,HDFC,Transfer in/Revenue-other,5eecc6d6449e4f7cfb1c2708,2020-07-31T00:00:00.000Z,NEFT CR-ICIC0SF0002-ICICI BANK NODAL ACC -SLICK ORGANICS-22544501011DC,investments,,net_banking_transfer,529.3
61b6f892d8beac1599eaf7cf,50200023535069,251534.47,60ec41ba55c00300382672d9,HDFC,Revenue-PG-split enabled,5eecc6d6449e4f7cfb1c2708,2020-07-31T00:00:00.000Z,NEFT CR-UTIB0001506-RAZORPAY SOFTWARE PR IVATE LIMITED-SLICK ORGANICS PVT LITD-AX ISCN0054647633,investments,,net_banking_transfer,7027.64
61b6f893d8beac1599eaf7d4,50200023535069,253171.45,60ec41ba55c00300382672d9,HDFC,Revenue-Mktplace,5eecc6d6449e4f7cfb1c2708,2020-07-31T00:00:00.000Z,NEFT CR-DEUT0784BBY-TATA UNISTORE LTD-NO DAL-SLICK ORGANICS PVT LTD-073101223GN00 330,investments,,net_banking_transfer,1636.98
61b6f894d8beac1599eaf7dc,50200023535069,174979.45,60ec41ba55c00300382672d9,HDFC,direct expenses,5eecc6d6449e4f7cfb1c2708,2020-07-31T00:00:00.000Z,00921000075586-TPT-78192-ROET BINDRA,,,net_banking_transfer,-78192
61b6f895d8beac1599eaf7ec,50200023535069,184057.66,60ec41ba55c00300382672d9,HDFC,Revenue-COD,5eecc6d6449e4f7cfb1c2708,2020-07-31T00:00:00.000Z,NEFT CR-KKBK0000958-BIGFOOT RETAIL SOLUT,,,net_banking_transfer,9078.21
61b6f896d8beac1599eaf7f2,50200023535069,181884.62,60ec41ba55c00300382672d9,HDFC,direct expenses,5eecc6d6449e4f7cfb1c2708,2020-08-01T00:00:00.000Z,POS 514834XXXXXX9486 SEOPTIMER,,,debit_card,-2173.04
61b6f896d8beac1599eaf7fd,50200023535069,481884.62,60ec41ba55c00300382672d9,HDFC,Internal Transfers,5eecc6d6449e4f7cfb1c2708,2020-08-01T00:00:00.000Z,IB FUNDS TRANSFER CR-50200035187206-SLIC K ORGANICS PVT LTD,investments,,Other,300000
61b6f897d8beac1599eaf800,50200023535069,379389.62,60ec41ba55c00300382672d9,HDFC,direct expenses,5eecc6d6449e4f7cfb1c2708,2020-08-01T00:00:00.000Z,IMPS-021411330963-HASHTAG ORANGE ADVERTI SING PVT LTD-ICIC-XXXXXXXX0094-FNF TILL JUNE,,,net_banking_transfer,-102495
61b6f898d8beac1599eaf804,50200023535069,354389.62,60ec41ba55c00300382672d9,HDFC,SAAS/tech expense,5eecc6d6449e4f7cfb1c2708,2020-08-01T00:00:00.000Z,POS 514834XXXXXX9486 AMAZON,shopping,,debit_card,-25000
61b6f899d8beac1599eaf80a,50200023535069,347299.62,60ec41ba55c00300382672d9,HDFC,direct expenses,5eecc6d6449e4f7cfb1c2708,2020-08-01T00:00:00.000Z,"NEFT DR-YESB0000162-VINAY REDDY-NETBANK, MUM-N214201201998988-ABC",,,net_banking_transfer,-7090
61b6f89ad8beac1599eaf813,50200023535069,147299.62,60ec41ba55c00300382672d9,HDFC,direct expenses,5eecc6d6449e4f7cfb1c2708,2020-08-01T00:00:00.000Z,"NEFT DR-ICIC0003430-HASHTAG ORANGE ADVER TISING PVT LTD-NETBANK, MUM-N21420120201 3299-ADVANCE FOR JULY",,,net_banking_transfer,-200000
61b6f89bd8beac1599eaf818,50200023535069,47299.62,60ec41ba55c00300382672d9,HDFC,direct expenses,5eecc6d6449e4f7cfb1c2708,2020-08-01T00:00:00.000Z,"NEFT DR-ICIC0003430-HASHTAG ORANGE ADVER TISING PVT LTD-NETBANK, MUM-N21420120200 8705-ADVANCE FOR JULY",,,net_banking_transfer,-100000
61b6f89cd8beac1599eaf81c,50200023535069,48022.62,60ec41ba55c00300382672d9,HDFC,Revenue-Mktplace,5eecc6d6449e4f7cfb1c2708,2020-08-01T00:00:00.000Z,NEFT CR-KKBK0000958-SURFBOATS SOLUTIONS PVT LTD-SLICK ORGANICS PRIVATE LIMITED-K KBKH20214693856,investments,,net_banking_transfer,723
61b6f89dd8beac1599eaf820,50200023535069,38658.01,60ec41ba55c00300382672d9,HDFC,direct expenses,5eecc6d6449e4f7cfb1c2708,2020-08-02T00:00:00.000Z,POS 514834XXXXXX9486 STK*SHUTTERSTOCK,,,debit_card,-9364.61
61b6f89ed8beac1599eaf82b,50200023535069,33939.19,60ec41ba55c00300382672d9,HDFC,direct expenses,5eecc6d6449e4f7cfb1c2708,2020-08-02T00:00:00.000Z,POS 514834XXXXXX4081 ONLINE PAYMENT,,,debit_card,-4718.82
61b6f89fd8beac1599eaf834,50200023535069,34673.29,60ec41ba55c00300382672d9,HDFC,Revenue-Mktplace,5eecc6d6449e4f7cfb1c2708,2020-08-03T00:00:00.000Z,NEFT CR-DEUT0797BGL-FLIPKART INTERNET P LTD-INT AC FO R INTERMEDIARY-SLICK ORGAN ICS PVT LTD-080300271GN00187,shopping,,net_banking_transfer,734.1
61b6f8a0d8beac1599eaf838,50200023535069,69332.41,60ec41ba55c00300382672d9,HDFC,Revenue-PG-split enabled,5eecc6d6449e4f7cfb1c2708,2020-08-03T00:00:00.000Z,NEFT CR-UTIB0001506-RAZORPAY SOFTWARE PR IVATE LIMITED-SLICK ORGANICS PVT LITD-AX ISCN0054708202,investments,,net_banking_transfer,34659.12
61b6f8a1d8beac1599eaf840,50200023535069,44332.41,60ec41ba55c00300382672d9,HDFC,SAAS/tech expense,5eecc6d6449e4f7cfb1c2708,2020-08-03T00:00:00.000Z,POS 514834XXXXXX9486 AMAZON,shopping,,debit_card,-25000
61b6f8a2d8beac1599eaf843,50200023535069,45585.3,60ec41ba55c00300382672d9,HDFC,Revenue-Mktplace,5eecc6d6449e4f7cfb1c2708,2020-08-03T00:00:00.000Z,NEFT CR-DEUT0797BGL-FLIPKART INTERNET PV,shopping,,net_banking_transfer,1252.89
61b6f8a3d8beac1599eaf84a,50200023535069,45958.64,60ec41ba55c00300382672d9,HDFC,Revenue-Mktplace,5eecc6d6449e4f7cfb1c2708,2020-08-03T00:00:00.000Z,NEFT CR-DEUT0797BGL-MYNTRA DESIGNS PRIVA TE LIMITED-SLICK ORGANICS PRIVATE LIMITE D-080300378GN00066,shopping,,net_banking_transfer,373.34
61b6f8a4d8beac1599eaf850,50200023535069,45958.19,60ec41ba55c00300382672d9,HDFC,bank charges,5eecc6d6449e4f7cfb1c2708,2020-08-03T00:00:00.000Z,DEBIT CARD PUR ADJ DT 31/07/20,,,Other,-0.45
61b6f8a5d8beac1599eaf854,50200023535069,45957.41,60ec41ba55c00300382672d9,HDFC,bank charges,5eecc6d6449e4f7cfb1c2708,2020-08-03T00:00:00.000Z,DEBIT CARD PUR ADJ DT 01/08/20,,,Other,-0.78
61b6f8a6d8beac1599eaf859,50200023535069,64188.84,60ec41ba55c00300382672d9,HDFC,Revenue-PG-split enabled,5eecc6d6449e4f7cfb1c2708,2020-08-03T00:00:00.000Z,NEFT CR-UTIB0001506-RAZORPAY SOFTWARE PR IVATE LIMITED-SLICK ORGANICS PVT LITD-AX ISCN0054762206,investments,,net_banking_transfer,18231.43
61b6f8a7d8beac1599eaf85d,50200023535069,65776.66,60ec41ba55c00300382672d9,HDFC,Revenue-PG-non-split,5eecc6d6449e4f7cfb1c2708,2020-08-03T00:00:00.000Z,NEFT CR-ICIC0000031-PAYTM E COMMERCE PVT LTD-SLICK ORGANICS PVT LTD-CMS156610274 2,investments,,net_banking_transfer,1587.82
61b6f8a8d8beac1599eaf864,50200023535069,81699.91,60ec41ba55c00300382672d9,HDFC,Revenue-PG-split enabled,5eecc6d6449e4f7cfb1c2708,2020-08-04T00:00:00.000Z,NEFT CR-UTIB0001506-RAZORPAY SOFTWARE PR IVATE LIMITED-SLICK ORGANICS PVT LITD-AX ISCN0054779881,investments,,net_banking_transfer,15923.25
61b6f8a9d8beac1599eaf86a,50200023535069,56699.91,60ec41ba55c00300382672d9,HDFC,direct expenses,5eecc6d6449e4f7cfb1c2708,2020-08-04T00:00:00.000Z,SARVAN - CHQ PAID - DEVLI ROAD K,,,chq,-25000
61b6f8aad8beac1599eaf86c,50200023535069,86374.97,60ec41ba55c00300382672d9,HDFC,Revenue-Mktplace,5eecc6d6449e4f7cfb1c2708,2020-08-04T00:00:00.000Z,IMPS-021711058068-AMAZON SELLER SERVIC-H DFC-XXXXXXXX6004-550RB4AEJJHW69ZDSLICK O RGANICS PVT LTD,shopping,,net_banking_transfer,29675.06
61b6f8abd8beac1599eaf875,50200023535069,309866.54,60ec41ba55c00300382672d9,HDFC,Revenue-Mktplace,5eecc6d6449e4f7cfb1c2708,2020-08-04T00:00:00.000Z,NEFT CR-DEUT0797BGL-AMAZON PAY IND PVT L TD-INT AC INTM MKTPLACE-SLICK ORGANICS P VT LTD-080400441GN00207,shopping,,net_banking_transfer,223491.57
61b6f8acd8beac1599eaf87c,50200023535069,309831.14,60ec41ba55c00300382672d9,HDFC,Tax,5eecc6d6449e4f7cfb1c2708,2020-08-04T00:00:00.000Z,RTGS CHGS BRN INCL GST 300720-MIR2021474 345516,,,bank_charge,-35.4
61b6f8add8beac1599eaf881,50200023535069,309784.74,60ec41ba55c00300382672d9,HDFC,bank charges,5eecc6d6449e4f7cfb1c2708,2020-08-04T00:00:00.000Z,.DC INTL POS TXN MARKUP+ST 280720 300720 -MIR2021474201603,,,international_transaction_arbitrage,-46.4
61b6f8add8beac1599eaf889,50200023535069,309779.44,60ec41ba55c00300382672d9,HDFC,bank charges,5eecc6d6449e4f7cfb1c2708,2020-08-04T00:00:00.000Z,DEBIT CARD PUR ADJ DT 02/08/20,,,Other,-5.3
61b6f8aed8beac1599eaf890,50200023535069,326112.9,60ec41ba55c00300382672d9,HDFC,Revenue-PG-split enabled,5eecc6d6449e4f7cfb1c2708,2020-08-04T00:00:00.000Z,NEFT CR-UTIB0001506-RAZORPAY SOFTWARE PR IVATE LIMITED-SLICK ORGANICS PVT LITD-AX ISCN0054824445,investments,,net_banking_transfer,16333.46
61b6f8afd8beac1599eaf896,50200023535069,328587.19,60ec41ba55c00300382672d9,HDFC,Revenue-Mktplace,5eecc6d6449e4f7cfb1c2708,2020-08-04T00:00:00.000Z,NEFT CR-ICIC0000105-MANASH LIFETYLE PVT,,,net_banking_transfer,2474.29
61b6f8b0d8beac1599eaf899,50200023535069,329740.91,60ec41ba55c00300382672d9,HDFC,Revenue-Mktplace,5eecc6d6449e4f7cfb1c2708,2020-08-04T00:00:00.000Z,NEFT CR-ICIC0000105-MANASH LIFETYLE PVT LTD-SLICKORGANICSPRIVATELIMITEDMPGGN-ICI B202170058839,,,net_banking_transfer,1153.72
61b6f8b1d8beac1599eaf89e,50200023535069,311011.7,60ec41ba55c00300382672d9,HDFC,direct expenses,5eecc6d6449e4f7cfb1c2708,2020-08-04T00:00:00.000Z,POS 514834XXXXXX9486 FAT*CLEARFORME,,,debit_card,-18729.21
61b6f8b2d8beac1599eaf8a7,50200023535069,325512.45,60ec41ba55c00300382672d9,HDFC,Revenue-PG-split enabled,5eecc6d6449e4f7cfb1c2708,2020-08-05T00:00:00.000Z,NEFT CR-UTIB0001506-RAZORPAY SOFTWARE PR IVATE LIMITED-SLICK ORGANICS PVT LITD-AX ISCN0054843663,investments,,net_banking_transfer,14500.75
61b6f8b3d8beac1599eaf8aa,50200023535069,285512.45,60ec41ba55c00300382672d9,HDFC,direct expenses,5eecc6d6449e4f7cfb1c2708,2020-08-05T00:00:00.000Z,"NEFT DR-ORBC0100707-UFLEX LIMITED-NETBAN K, MUM-N218201205815262-011",loans,lender_transaction,net_banking_transfer,-40000
61b6f8b4d8beac1599eaf8af,50200023535069,309868.9,60ec41ba55c00300382672d9,HDFC,Revenue-COD,5eecc6d6449e4f7cfb1c2708,2020-08-05T00:00:00.000Z,NEFT CR-KKBK0000958-BIGFOOT RETAIL SOLUT IONS PRIVATE LIMITED-SLICK ORGANICS PVT LTD-KKBK202182234956,,,net_banking_transfer,24356.45
61b6f8b5d8beac1599eaf8b6,50200023535069,54868.9,60ec41ba55c00300382672d9,HDFC,SAAS/tech expense,5eecc6d6449e4f7cfb1c2708,2020-08-05T00:00:00.000Z,POS 514834XXXXXX9486 AMAZON,shopping,,debit_card,-255000
61b6f8b6d8beac1599eaf8b9,50200023535069,67157.96,60ec41ba55c00300382672d9,HDFC,Revenue-PG-split enabled,5eecc6d6449e4f7cfb1c2708,2020-08-05T00:00:00.000Z,NEFT CR-UTIB0001506-RAZORPAY SOFTWARE PR IVATE LIMITED-SLICK ORGANICS PVT LITD-AX ISCN0054884549,investments,,net_banking_transfer,12289.06
61b6f8b7d8beac1599eaf8c0,50200023535069,79393.18,60ec41ba55c00300382672d9,HDFC,Revenue-PG-split enabled,5eecc6d6449e4f7cfb1c2708,2020-08-06T00:00:00.000Z,NEFT CR-UTIB0001506-RAZORPAY SOFTWARE PR IVATE LIMITED-SLICK ORGANICS PVT LITD-AX ISCN0054916139,investments,,net_banking_transfer,12235.22
61b6f8b8d8beac1599eaf8c6,50200023535069,79394.18,60ec41ba55c00300382672d9,HDFC,Transfer in/Revenue-other,5eecc6d6449e4f7cfb1c2708,2020-08-06T00:00:00.000Z,IMPS-021912369436-DIGIOTECH SOLUTIONS -H DFC-XXXXXXXX1214-SBHKW6PLHXIX6SF,,,net_banking_transfer,1
61b6f8b9d8beac1599eaf8ca,50200023535069,66702.18,60ec41ba55c00300382672d9,HDFC,direct expenses,5eecc6d6449e4f7cfb1c2708,2020-08-06T00:00:00.000Z,"NEFT DR-KKBK0004585-DIVIJA JAIN-NETBANK, MUM-N219201206966702-12692",,,net_banking_transfer,-12692
61b6f8bad8beac1599eaf8cd,50200023535069,57582.18,60ec41ba55c00300382672d9,HDFC,direct expenses,5eecc6d6449e4f7cfb1c2708,2020-08-06T00:00:00.000Z,"NEFT DR-BOFA0MM6205-FEDEX EXPRESS TRANSP ORTATION SUPPLY CHAI-NETBANK, MUM-N21920 1206953509-9120",loans,lender_transaction,net_banking_transfer,-9120
61b6f8bbd8beac1599eaf8d2,50200023535069,13332.18,60ec41ba55c00300382672d9,HDFC,direct expenses,5eecc6d6449e4f7cfb1c2708,2020-08-06T00:00:00.000Z,"NEFT DR-SBIN0001189-SANDEEP SINGH-NETBAN K, MUM-N219201207034330-44250",,,net_banking_transfer,-44250
61b6f8bcd8beac1599eaf8da,50200023535069,-4367.82,60ec41ba55c00300382672d9,HDFC,direct expenses,5eecc6d6449e4f7cfb1c2708,2020-08-06T00:00:00.000Z,IMPS-021914140724-UDAAN-ICIC-XXXXXXXXXXX XX0326-17700,,,net_banking_transfer,-17700
61b6f8bdd8beac1599eaf8e0,50200023535069,95632.18,60ec41ba55c00300382672d9,HDFC,Internal Transfers,5eecc6d6449e4f7cfb1c2708,2020-08-06T00:00:00.000Z,IB FUNDS TRANSFER CR-50200035187206 -SL,,,Other,100000
61b6f8bed8beac1599eaf8e3,50200023535069,145632.18,60ec41ba55c00300382672d9,HDFC,Internal Transfers,5eecc6d6449e4f7cfb1c2708,2020-08-06T00:00:00.000Z,IB FUNDS TRANSFER CR-50200035187206 -SL ICK ORGANICS PVT LTD,investments,,Other,50000
61b6f8bfd8beac1599eaf8ea,50200023535069,139082.18,60ec41ba55c00300382672d9,HDFC,direct expenses,5eecc6d6449e4f7cfb1c2708,2020-08-06T00:00:00.000Z,IMPS-021914132936-UDAAN-ICIC-XXXXXXXXXXX XX2314-6550,,,net_banking_transfer,-6550
61b6f8c0d8beac1599eaf8ee,50200023535069,129082.18,60ec41ba55c00300382672d9,HDFC,direct expenses,5eecc6d6449e4f7cfb1c2708,2020-08-06T00:00:00.000Z,IMPS-021914143963-UDAAN-ICIC-XXXXXXXXXXX XX2314-10000,,,net_banking_transfer,-10000
61b6f8c1d8beac1599eaf8f4,50200023535069,124082.18,60ec41ba55c00300382672d9,HDFC,direct expenses,5eecc6d6449e4f7cfb1c2708,2020-08-06T00:00:00.000Z,IMPS-021914144408-UDAAN-ICIC-XXXXXXXXXXX XX2314-5000,,,net_banking_transfer,-5000
61b6f8c2d8beac1599eaf8f9,50200023535069,121582.18,60ec41ba55c00300382672d9,HDFC,direct expenses,5eecc6d6449e4f7cfb1c2708,2020-08-06T00:00:00.000Z,IMPS-021914148239-UDAAN-ICIC-XXXXXXXXXXX XX2314-2500,,,net_banking_transfer,-2500
61b6f8c3d8beac1599eaf8fe,50200023535069,120082.18,60ec41ba55c00300382672d9,HDFC,direct expenses,5eecc6d6449e4f7cfb1c2708,2020-08-06T00:00:00.000Z,IMPS-021914145320-UDAAN-ICIC-XXXXXXXXXXX XX2314-1500,,,net_banking_transfer,-1500
61b6f8c4d8beac1599eaf903,50200023535069,120004.64,60ec41ba55c00300382672d9,HDFC,bank charges,5eecc6d6449e4f7cfb1c2708,2020-08-06T00:00:00.000Z,DEBIT CARD PUR ADJ DT 04/08/20,,,Other,-77.54
61b6f8c4d8beac1599eaf907,50200023535069,164254.64,60ec41ba55c00300382672d9,HDFC,Revenue-UPI,5eecc6d6449e4f7cfb1c2708,2020-08-06T00:00:00.000Z,UPI-SANDEEP SINGH-9717243022@APL-SBIN000 1189-021915745879-UPI,,,upi,44250
61b6f8c5d8beac1599eaf90a,50200023535069,189254.64,60ec41ba55c00300382672d9,HDFC,Internal Transfers,5eecc6d6449e4f7cfb1c2708,2020-08-06T00:00:00.000Z,IB FUNDS TRANSFER CR-50200035187206 -SL ICK ORGANICS PVT LTD,investments,,Other,25000
61b6f8c6d8beac1599eaf915,50200023535069,248958.02,60ec41ba55c00300382672d9,HDFC,Transfer in/Revenue-other,5eecc6d6449e4f7cfb1c2708,2020-08-06T00:00:00.000Z,NEFT CR-RATN0000999-HIVELOOP CAPITAL PRI VATE LIMITED-SLICK ORGANICS PVT L-000132 191096,,,net_banking_transfer,59703.38
61b6f8c7d8beac1599eaf918,50200023535069,308661.4,60ec41ba55c00300382672d9,HDFC,Transfer in/Revenue-other,5eecc6d6449e4f7cfb1c2708,2020-08-06T00:00:00.000Z,NEFT CR-RATN0000999-HIVELOOP CAPITAL PRI VATE LIMITED-SLICK ORGANICS PVT L-000132 191093,,,net_banking_transfer,59703.38
61b6f8c8d8beac1599eaf920,50200023535069,386473.55,60ec41ba55c00300382672d9,HDFC,Transfer in/Revenue-other,5eecc6d6449e4f7cfb1c2708,2020-08-06T00:00:00.000Z,NEFT CR-RATN0000999-HIVELOOP CAPITAL PRI VATE LIMITED-SLICK ORGANICS PVT L-000132 191092,,,net_banking_transfer,77812.15
61b6f8c9d8beac1599eaf924,50200023535069,476927.55,60ec41ba55c00300382672d9,HDFC,Transfer in/Revenue-other,5eecc6d6449e4f7cfb1c2708,2020-08-06T00:00:00.000Z,NEFT CR-RATN0000999-HIVELOOP CAPITAL PRI VATE LIMITED-SLICK ORGANICS PVT L-000132 191091,,,net_banking_transfer,90454
61b6f8cad8beac1599eaf928,50200023535069,526680.9,60ec41ba55c00300382672d9,HDFC,Transfer in/Revenue-other,5eecc6d6449e4f7cfb1c2708,2020-08-06T00:00:00.000Z,NEFT CR-RATN0000999-HIVELOOP CAPITAL PRI,,,net_banking_transfer,49753.35
61b6f8cbd8beac1599eaf939,50200023535069,587663.25,60ec41ba55c00300382672d9,HDFC,Transfer in/Revenue-other,5eecc6d6449e4f7cfb1c2708,2020-08-06T00:00:00.000Z,NEFT CR-RATN0000999-HIVELOOP CAPITAL PRI VATE LIMITED-SLICK ORGANICS PVT L-000132 191090,,,net_banking_transfer,60982.35
61b6f8ccd8beac1599eaf940,50200023535069,595334.15,60ec41ba55c00300382672d9,HDFC,Revenue-PG-split enabled,5eecc6d6449e4f7cfb1c2708,2020-08-06T00:00:00.000Z,NEFT CR-UTIB0001506-RAZORPAY SOFTWARE PR IVATE LIMITED-SLICK ORGANICS PVT LITD-AX ISCN0054966701,investments,,net_banking_transfer,7670.9
61b6f8cdd8beac1599eaf944,50200023535069,596334.15,60ec41ba55c00300382672d9,HDFC,Internal Transfers,5eecc6d6449e4f7cfb1c2708,2020-08-06T00:00:00.000Z,IB FUNDS TRANSFER CR-50200035187206 -SL ICK ORGANICS PVT LTD,investments,,Other,1000
61b6f8ced8beac1599eaf948,50200023535069,597334.15,60ec41ba55c00300382672d9,HDFC,Internal Transfers,5eecc6d6449e4f7cfb1c2708,2020-08-06T00:00:00.000Z,IB FUNDS TRANSFER CR-50200035187206 -SL ICK ORGANICS PVT LTD,investments,,Other,1000
61b6f8cfd8beac1599eaf95e,50200023535069,598334.15,60ec41ba55c00300382672d9,HDFC,Internal Transfers,5eecc6d6449e4f7cfb1c2708,2020-08-06T00:00:00.000Z,IB FUNDS TRANSFER CR-50200035187206 -SL ICK ORGANICS PVT LTD,investments,,Other,1000
61b6f8d0d8beac1599eaf968,50200023535069,599334.15,60ec41ba55c00300382672d9,HDFC,Internal Transfers,5eecc6d6449e4f7cfb1c2708,2020-08-06T00:00:00.000Z,IB FUNDS TRANSFER CR-50200035187206 -SL ICK ORGANICS PVT LTD,investments,,Other,1000
61b6f8d1d8beac1599eaf970,50200023535069,599734.15,60ec41ba55c00300382672d9,HDFC,Internal Transfers,5eecc6d6449e4f7cfb1c2708,2020-08-06T00:00:00.000Z,IB FUNDS TRANSFER CR-50200035187206 -SL ICK ORGANICS PVT LTD,investments,,Other,400
61b6f8d2d8beac1599eaf978,50200023535069,562734.15,60ec41ba55c00300382672d9,HDFC,direct expenses,5eecc6d6449e4f7cfb1c2708,2020-08-07T00:00:00.000Z,"NEFT DR-CITI0000002-DHIRAJ-NETBANK, MUM- N220201207834713-37000",,,net_banking_transfer,-37000
61b6f8d3d8beac1599eaf983,50200023535069,527734.15,60ec41ba55c00300382672d9,HDFC,direct expenses,5eecc6d6449e4f7cfb1c2708,2020-08-07T00:00:00.000Z,"NEFT DR-ICIC0000542-AVANTIKA SUKHIA-NETB ANK, MUM-N220201207834744-35000",,,net_banking_transfer,-35000
61b6f8d4d8beac1599eaf987,50200023535069,520234.15,60ec41ba55c00300382672d9,HDFC,direct expenses,5eecc6d6449e4f7cfb1c2708,2020-08-07T00:00:00.000Z,"NEFT DR-SIBL0000555-JAIVEER KUMAR-NETBAN K, MUM-N220201207837641-7500",,,net_banking_transfer,-7500
61b6f8d5d8beac1599eaf994,50200023535069,515234.15,60ec41ba55c00300382672d9,HDFC,direct expenses,5eecc6d6449e4f7cfb1c2708,2020-08-07T00:00:00.000Z,"NEFT DR-PUNB0398000-MEENA SINGH-NETBANK, MUM-N220201207837673-5000",,,net_banking_transfer,-5000
61b6f8d6d8beac1599eaf99b,50200023535069,505234.15,60ec41ba55c00300382672d9,HDFC,direct expenses,5eecc6d6449e4f7cfb1c2708,2020-08-07T00:00:00.000Z,"NEFT DR-SBIN0001189-SANDEEP SINGH-NETBAN K, MUM-N220201207837702-10000",,,net_banking_transfer,-10000
61b6f8d7d8beac1599eaf9a0,50200023535069,496984.15,60ec41ba55c00300382672d9,HDFC,direct expenses,5eecc6d6449e4f7cfb1c2708,2020-08-07T00:00:00.000Z,"NEFT DR-KKBK0000811-NASIR KHAN-NETBANK, MUM-N220201207841806-8250",,,net_banking_transfer,-8250
61b6f8d8d8beac1599eaf9a6,50200023535069,479484.15,60ec41ba55c00300382672d9,HDFC,direct expenses,5eecc6d6449e4f7cfb1c2708,2020-08-07T00:00:00.000Z,"NEFT DR-ICIC0003374-SIDDHARTH KANOJIA-NE TBANK, MUM-N220201207841840-17500",,,net_banking_transfer,-17500
61b6f8d9d8beac1599eaf9aa,50200023535069,476484.15,60ec41ba55c00300382672d9,HDFC,direct expenses,5eecc6d6449e4f7cfb1c2708,2020-08-07T00:00:00.000Z,"NEFT DR-ALLA0210591-CHAMPA DEVI-NETBANK,",,,net_banking_transfer,-3000
61b6f8dad8beac1599eaf9b4,50200023535069,462984.15,60ec41ba55c00300382672d9,HDFC,direct expenses,5eecc6d6449e4f7cfb1c2708,2020-08-07T00:00:00.000Z,"NEFT DR-SYNB0005170-SNEHAL TAYDE-NETBANK , MUM-N220201207845571-13500",,,net_banking_transfer,-13500
61b6f8dbd8beac1599eaf9ba,50200023535069,442134.15,60ec41ba55c00300382672d9,HDFC,direct expenses,5eecc6d6449e4f7cfb1c2708,2020-08-07T00:00:00.000Z,"NEFT DR-UTIB0000120-ADNAN ALI-NETBANK, M UM-N220201207835172-20850",,,net_banking_transfer,-20850
61b6f8dcd8beac1599eaf9bd,50200023535069,396134.15,60ec41ba55c00300382672d9,HDFC,direct expenses,5eecc6d6449e4f7cfb1c2708,2020-08-07T00:00:00.000Z,"NEFT DR-BKDN0450123-ARTISTO DESIGNZ-NETB ANK, MUM-N220201207845772-46000",,,net_banking_transfer,-46000
61b6f8ddd8beac1599eaf9c5,50200023535069,380134.15,60ec41ba55c00300382672d9,HDFC,direct expenses,5eecc6d6449e4f7cfb1c2708,2020-08-07T00:00:00.000Z,00901610080520-TPT-16000-POOJA KAPIL SHR OTRIYA,,,net_banking_transfer,-16000
61b6f8ded8beac1599eaf9c9,50200023535069,345134.15,60ec41ba55c00300382672d9,HDFC,direct expenses,5eecc6d6449e4f7cfb1c2708,2020-08-07T00:00:00.000Z,50100301160692-TPT-35000-TARUN GARG,,,net_banking_transfer,-35000
61b6f8dfd8beac1599eaf9d0,50200023535069,295134.15,60ec41ba55c00300382672d9,HDFC,direct expenses,5eecc6d6449e4f7cfb1c2708,2020-08-07T00:00:00.000Z,02771610131904-TPT-50000-DIGANT BHATT,,,net_banking_transfer,-50000
61b6f8e0d8beac1599eaf9d4,50200023535069,262134.15,60ec41ba55c00300382672d9,HDFC,direct expenses,5eecc6d6449e4f7cfb1c2708,2020-08-07T00:00:00.000Z,50100330586095-TPT-33000-DIWAKAR UNIYAL,,,net_banking_transfer,-33000
61b6f8e1d8beac1599eaf9d9,50200023535069,264591.68,60ec41ba55c00300382672d9,HDFC,Revenue-Mktplace,5eecc6d6449e4f7cfb1c2708,2020-08-07T00:00:00.000Z,NEFT CR-DEUT0797BGL-FLIPKART INTERNET P LTD-INT AC FO R INTERMEDIARY-SLICK ORGAN ICS PVT LTD-080700115GN00081,shopping,,net_banking_transfer,2457.53
61b6f8e2d8beac1599eaf9de,50200023535069,286035.28,60ec41ba55c00300382672d9,HDFC,Revenue-PG-split enabled,5eecc6d6449e4f7cfb1c2708,2020-08-07T00:00:00.000Z,NEFT CR-UTIB0001506-RAZORPAY SOFTWARE PR IVATE LIMITED-SLICK ORGANICS PVT LITD-AX ISCN0054982001,investments,,net_banking_transfer,21443.6
61b6f8e3d8beac1599eaf9e1,50200023535069,244410.28,60ec41ba55c00300382672d9,HDFC,direct expenses,5eecc6d6449e4f7cfb1c2708,2020-08-07T00:00:00.000Z,"NEFT DR-UBIN0531855-MOHANISH KOTHARI-NET BANK, MUM-N220201207903581-41625",,,net_banking_transfer,-41625
61b6f8e3d8beac1599eaf9e5,50200023535069,245993.28,60ec41ba55c00300382672d9,HDFC,Internal Transfers,5eecc6d6449e4f7cfb1c2708,2020-08-07T00:00:00.000Z,IB FUNDS TRANSFER CR-50200035187206 -SL ICK ORGANICS PVT LTD,investments,,Other,1583
61b6f8e4d8beac1599eaf9f0,50200023535069,195993.28,60ec41ba55c00300382672d9,HDFC,direct expenses,5eecc6d6449e4f7cfb1c2708,2020-08-07T00:00:00.000Z,"NEFT DR-SCBL0036025-DHRUV MADHOK-NETBANK , MUM-N220201207953959-50000",,,net_banking_transfer,-50000
61b6f8e5d8beac1599eaf9f2,50200023535069,255990.88,60ec41ba55c00300382672d9,HDFC,Transfer in/Revenue-other,5eecc6d6449e4f7cfb1c2708,2020-08-07T00:00:00.000Z,NEFT CR-RATN0000999-HIVELOOP CAPITAL PRI VATE LIMITED-SLICK ORGANICS PVT L-000132 287407,,,net_banking_transfer,59997.6
61b6f8e7d8beac1599eafa29,50200023535069,262858.88,60ec41ba55c00300382672d9,HDFC,Transfer in/Revenue-other,5eecc6d6449e4f7cfb1c2708,2020-08-07T00:00:00.000Z,NEFT CR-RATN0000999-HIVELOOP CAPITAL PRI VATE LIMITED-SLICK ORGANICS PVT L-000132 287409,,,net_banking_transfer,6868
61b6f8e8d8beac1599eafa31,50200023535069,269415.38,60ec41ba55c00300382672d9,HDFC,Transfer in/Revenue-other,5eecc6d6449e4f7cfb1c2708,2020-08-07T00:00:00.000Z,NEFT CR-RATN0000999-HIVELOOP CAPITAL PRI,,,net_banking_transfer,6556.5
61b6f8e9d8beac1599eafa3a,50200023535069,287340.38,60ec41ba55c00300382672d9,HDFC,Transfer in/Revenue-other,5eecc6d6449e4f7cfb1c2708,2020-08-07T00:00:00.000Z,NEFT CR-RATN0000999-HIVELOOP CAPITAL PRI VATE LIMITED-SLICK ORGANICS PVT L-000132 287410,,,net_banking_transfer,17925
61b6f8ead8beac1599eafa3f,50200023535069,287869.68,60ec41ba55c00300382672d9,HDFC,Revenue-PG-split enabled,5eecc6d6449e4f7cfb1c2708,2020-08-07T00:00:00.000Z,NEFT CR-YESB0000001-RAZORPAY SOFTWARE P L NODAL ACCOUNT-SLICKORGANICS-N220200419 898022,investments,,net_banking_transfer,529.3
61b6f8ebd8beac1599eafa46,50200023535069,291607.18,60ec41ba55c00300382672d9,HDFC,Transfer in/Revenue-other,5eecc6d6449e4f7cfb1c2708,2020-08-07T00:00:00.000Z,NEFT CR-RATN0000999-HIVELOOP CAPITAL PRI VATE LIMITED-SLICK ORGANICS PVT L-000132 315449,,,net_banking_transfer,3737.5
61b6f8ecd8beac1599eafa4b,50200023535069,293475.93,60ec41ba55c00300382672d9,HDFC,Transfer in/Revenue-other,5eecc6d6449e4f7cfb1c2708,2020-08-07T00:00:00.000Z,NEFT CR-RATN0000999-HIVELOOP CAPITAL PRI VATE LIMITED-SLICK ORGANICS PVT L-000132 315454,,,net_banking_transfer,1868.75
61b6f8ecd8beac1599eafa58,50200023535069,302576.43,60ec41ba55c00300382672d9,HDFC,Transfer in/Revenue-other,5eecc6d6449e4f7cfb1c2708,2020-08-07T00:00:00.000Z,NEFT CR-RATN0000999-HIVELOOP CAPITAL PRI VATE LIMITED-SLICK ORGANICS PVT L-000132 315453,,,net_banking_transfer,9100.5
61b6f8edd8beac1599eafa5b,50200023535069,315820.83,60ec41ba55c00300382672d9,HDFC,Transfer in/Revenue-other,5eecc6d6449e4f7cfb1c2708,2020-08-07T00:00:00.000Z,NEFT CR-RATN0000999-HIVELOOP CAPITAL PRI VATE LIMITED-SLICK ORGANICS PVT L-000132 316979,,,net_banking_transfer,13244.4
61b6f8eed8beac1599eafa6b,50200023535069,316114.83,60ec41ba55c00300382672d9,HDFC,Investment/FD redeem,5eecc6d6449e4f7cfb1c2708,2020-08-07T00:00:00.000Z,FD REDEEM INTEREST -50300381096053/1,,,Other,294
61b6f8efd8beac1599eafa6e,50200023535069,323880.83,60ec41ba55c00300382672d9,HDFC,Investment/FD redeem,5eecc6d6449e4f7cfb1c2708,2020-08-07T00:00:00.000Z,FD REDEEM PRINCIPAL -50300381096053/1,,,Other,7766
61b6f8f0d8beac1599eafa76,50200023535069,329384.67,60ec41ba55c00300382672d9,HDFC,Revenue-Mktplace,5eecc6d6449e4f7cfb1c2708,2020-08-07T00:00:00.000Z,NEFT CR-DEUT0797BGL-FLIPKART INTERNET PV TLTD-SLICK ORGANICS PVT LTD-080700074GN0 0082,shopping,,net_banking_transfer,5503.84
61b6f8f1d8beac1599eafa79,50200023535069,336880.67,60ec41ba55c00300382672d9,HDFC,Transfer in/Revenue-other,5eecc6d6449e4f7cfb1c2708,2020-08-07T00:00:00.000Z,IMPS-022016084653-EARTH LOVE ECOMMERCE-H DFC-XXXXXXXX1048-PAYOUT,,,net_banking_transfer,7496
61b6f8f2d8beac1599eafa7e,50200023535069,352624.64,60ec41ba55c00300382672d9,HDFC,Revenue-PG-split enabled,5eecc6d6449e4f7cfb1c2708,2020-08-07T00:00:00.000Z,NEFT CR-UTIB0001506-RAZORPAY SOFTWARE PR IVATE LIMITED-SLICK ORGANICS PVT LITD-AX ISCN0055048241,investments,,net_banking_transfer,15743.97
61b6f8f3d8beac1599eafa87,50200023535069,364019.82,60ec41ba55c00300382672d9,HDFC,Revenue-Mktplace,5eecc6d6449e4f7cfb1c2708,2020-08-07T00:00:00.000Z,NEFT CR-KKBK0000958-SUPERMARKET GROCERY SUPPLIES PVT LTD-SLICK ORGANICS PVT LTD- KKBK202202771819,shopping,,net_banking_transfer,11395.18
61b6f8f4d8beac1599eafa98,50200023535069,364782.92,60ec41ba55c00300382672d9,HDFC,Revenue-Mktplace,5eecc6d6449e4f7cfb1c2708,2020-08-07T00:00:00.000Z,NEFT CR-KKBK0000958-SUPERMARKET GROCERY,shopping,,net_banking_transfer,763.1
61b6f8f5d8beac1599eafaaa,50200023535069,372872.49,60ec41ba55c00300382672d9,HDFC,Revenue-Mktplace,5eecc6d6449e4f7cfb1c2708,2020-08-07T00:00:00.000Z,NEFT CR-KKBK0000958-SUPERMARKET GROCERY SUPPLIES PVT LTD-SLICK ORGANICS PVT LTD- KKBK202202783058,shopping,,net_banking_transfer,8089.57
61b6f8f6d8beac1599eafabd,50200023535069,374834.19,60ec41ba55c00300382672d9,HDFC,Revenue-Mktplace,5eecc6d6449e4f7cfb1c2708,2020-08-07T00:00:00.000Z,NEFT CR-KKBK0000958-SUPERMARKET GROCERY SUPPLIES PVT LTD-SLICK ORGANICS PVT LTD- KKBK202202783244,shopping,,net_banking_transfer,1961.7
61b6f8f7d8beac1599eafacc,50200023535069,392586.29,60ec41ba55c00300382672d9,HDFC,Revenue-COD,5eecc6d6449e4f7cfb1c2708,2020-08-07T00:00:00.000Z,NEFT CR-KKBK0000958-BIGFOOT RETAIL SOLUT IONS PRIVATE LIMITED-SLICK ORGANICS PVT LTD-KKBK202202791096,,,net_banking_transfer,17752.1
61b6f8f8d8beac1599eafad9,50200023535069,392975.64,60ec41ba55c00300382672d9,HDFC,Revenue-Mktplace,5eecc6d6449e4f7cfb1c2708,2020-08-07T00:00:00.000Z,NEFT CR-KKBK0000958-SUPERMARKET GROCERY SUPPLIES PVT LTD-SLICK ORGANICS PVT LTD- KKBK202202794158,shopping,,net_banking_transfer,389.35
61b6f8f9d8beac1599eafae6,50200023535069,403154.07,60ec41ba55c00300382672d9,HDFC,Revenue-Mktplace,5eecc6d6449e4f7cfb1c2708,2020-08-07T00:00:00.000Z,NEFT CR-KKBK0000958-SUPERMARKET GROCERY SUPPLIES PVT LTD-SLICK ORGANICS PVT LTD- KKBK202202794284,shopping,,net_banking_transfer,10178.43
61b6f8fad8beac1599eafaf3,50200023535069,203154.07,60ec41ba55c00300382672d9,HDFC,direct expenses,5eecc6d6449e4f7cfb1c2708,2020-08-08T00:00:00.000Z,IMPS-022110343064-HASHTAG ORANGE ADVERTI SING PVT LTD-ICIC-XXXXXXXX0094-ABC,,,net_banking_transfer,-200000
61b6f8fbd8beac1599eafafc,50200023535069,53154.07,60ec41ba55c00300382672d9,HDFC,direct expenses,5eecc6d6449e4f7cfb1c2708,2020-08-08T00:00:00.000Z,IMPS-022110342301-HASHTAG ORANGE ADVERTI SING PVT LTD-ICIC-XXXXXXXX0094-ABC,,,net_banking_transfer,-150000
61b6f8fcd8beac1599eafb02,50200023535069,9504.07,60ec41ba55c00300382672d9,HDFC,direct expenses,5eecc6d6449e4f7cfb1c2708,2020-08-10T00:00:00.000Z,CHQ PAID-MICR CTS-NO-THE UNITED INDIA IN,,,chq,-43650
61b6f8fdd8beac1599eafb0a,50200023535069,9524.07,60ec41ba55c00300382672d9,HDFC,Internal Transfers,5eecc6d6449e4f7cfb1c2708,2020-08-10T00:00:00.000Z,IB FUNDS TRANSFER CR-50200035187206 -SL ICK ORGANICS PVT LTD,investments,,Other,20
61b6f8fed8beac1599eafb17,50200023535069,57234.4,60ec41ba55c00300382672d9,HDFC,Revenue-PG-split enabled,5eecc6d6449e4f7cfb1c2708,2020-08-10T00:00:00.000Z,NEFT CR-UTIB0001506-RAZORPAY SOFTWARE PR IVATE LIMITED-SLICK ORGANICS PVT LITD-AX ISCN0055074045,investments,,net_banking_transfer,47710.33
61b6f8ffd8beac1599eafb1c,50200023535069,47234.4,60ec41ba55c00300382672d9,HDFC,direct expenses,5eecc6d6449e4f7cfb1c2708,2020-08-10T00:00:00.000Z,"NEFT DR-KKBK0000291-ROLI GARG-NETBANK, M UM-N223201210127111-10000",,,net_banking_transfer,-10000
61b6f900d8beac1599eafb25,50200023535069,48462.7,60ec41ba55c00300382672d9,HDFC,Revenue-Mktplace,5eecc6d6449e4f7cfb1c2708,2020-08-10T00:00:00.000Z,NEFT CR-DEUT0797BGL-MYNTRA DESIGNS PRIVA,shopping,,net_banking_transfer,1228.3
61b6f901d8beac1599eafb47,50200023535069,49344.73,60ec41ba55c00300382672d9,HDFC,Revenue-Mktplace,5eecc6d6449e4f7cfb1c2708,2020-08-10T00:00:00.000Z,NEFT CR-DEUT0797BGL-MYNTRA DESIGNS PRIVA TE LIMITED-SLICK ORGANICS PRIVATE LIMITE D-081000222GN00015,shopping,,net_banking_transfer,882.03
61b6f902d8beac1599eafb50,50200023535069,41094.73,60ec41ba55c00300382672d9,HDFC,direct expenses,5eecc6d6449e4f7cfb1c2708,2020-08-10T00:00:00.000Z,"NEFT DR-KKBK0000811-NASIR KHAN-NETBANK, MUM-N223201210830357-8250",,,net_banking_transfer,-8250
61b6f903d8beac1599eafb58,50200023535069,26094.73,60ec41ba55c00300382672d9,HDFC,direct expenses,5eecc6d6449e4f7cfb1c2708,2020-08-10T00:00:00.000Z,SARVAN KUMAR - CHQ PAID - DEVLI ROAD K,,,chq,-15000
61b6f904d8beac1599eafb5e,50200023535069,29958.68,60ec41ba55c00300382672d9,HDFC,Revenue-Mktplace,5eecc6d6449e4f7cfb1c2708,2020-08-10T00:00:00.000Z,NEFT CR-DEUT0797BGL-FLIPKART INTERNET PV TLTD-SLICK ORGANICS PVT LTD-081000723GN0 0134,shopping,,net_banking_transfer,3863.95
61b6f905d8beac1599eafb67,50200023535069,33649.65,60ec41ba55c00300382672d9,HDFC,Revenue-Mktplace,5eecc6d6449e4f7cfb1c2708,2020-08-10T00:00:00.000Z,NEFT CR-DEUT0797BGL-FLIPKART INTERNET P LTD-INT AC FO R INTERMEDIARY-SLICK ORGAN ICS PVT LTD-081000623GN00143,shopping,,net_banking_transfer,3690.97
61b6f906d8beac1599eafb6c,50200023535069,50631.13,60ec41ba55c00300382672d9,HDFC,Revenue-PG-split enabled,5eecc6d6449e4f7cfb1c2708,2020-08-10T00:00:00.000Z,NEFT CR-UTIB0001506-RAZORPAY SOFTWARE PR IVATE LIMITED-SLICK ORGANICS PVT LITD-AX ISCN0055115895,investments,,net_banking_transfer,16981.48
61b6f907d8beac1599eafb76,50200023535069,51154.12,60ec41ba55c00300382672d9,HDFC,Revenue-PG-non-split,5eecc6d6449e4f7cfb1c2708,2020-08-11T00:00:00.000Z,NEFT CR-ICIC0000031-PAYTM E COMMERCE PVT LTD-SLICK ORGANICS PVT LTD-CMS157440856 7,investments,,net_banking_transfer,522.99
61b6f908d8beac1599eafb7e,50200023535069,62639.83,60ec41ba55c00300382672d9,HDFC,Revenue-PG-split enabled,5eecc6d6449e4f7cfb1c2708,2020-08-11T00:00:00.000Z,NEFT CR-UTIB0001506-RAZORPAY SOFTWARE PR IVATE LIMITED-SLICK ORGANICS PVT LITD-AX ISCN0055132255,investments,,net_banking_transfer,11485.71
61b6f909d8beac1599eafb89,50200023535069,62642.83,60ec41ba55c00300382672d9,HDFC,Internal Transfers,5eecc6d6449e4f7cfb1c2708,2020-08-11T00:00:00.000Z,IB FUNDS TRANSFER CR-50200035187206 -SL ICK ORGANICS PVT LTD,investments,,Other,3
61b6f90ad8beac1599eafb8e,50200023535069,110361,60ec41ba55c00300382672d9,HDFC,Revenue-Mktplace,5eecc6d6449e4f7cfb1c2708,2020-08-11T00:00:00.000Z,IMPS-022411347849-AMAZON SELLER SERVIC-H DFC-XXXXXXXX6004-6OEIKM716APSM3PCSLICK O RGANICS PVT LTD,shopping,,net_banking_transfer,47718.17
61b6f90ad8beac1599eafb91,50200023535069,364248.56,60ec41ba55c00300382672d9,HDFC,Revenue-Mktplace,5eecc6d6449e4f7cfb1c2708,2020-08-11T00:00:00.000Z,NEFT CR-DEUT0797BGL-AMAZON PAY IND PVT L TD-INT AC INTM MKTPLACE-SLICK ORGANICS P VT LTD-081100088GN00461,shopping,,net_banking_transfer,253887.56
61b6f90bd8beac1599eafb94,50200023535069,359361.56,60ec41ba55c00300382672d9,HDFC,direct expenses,5eecc6d6449e4f7cfb1c2708,2020-08-11T00:00:00.000Z,NEFT DR-BOFA0MM6205-FEDEX EXPRESS TRANSP,loans,lender_transaction,net_banking_transfer,-4887
61b6f90cd8beac1599eafb9e,50200023535069,358456.56,60ec41ba55c00300382672d9,HDFC,direct expenses,5eecc6d6449e4f7cfb1c2708,2020-08-11T00:00:00.000Z,50100097355028-TPT-905-PALLAVI JUNEJA,,,net_banking_transfer,-905
61b6f90dd8beac1599eafba1,50200023535069,368584.23,60ec41ba55c00300382672d9,HDFC,Revenue-PG-split enabled,5eecc6d6449e4f7cfb1c2708,2020-08-11T00:00:00.000Z,NEFT CR-UTIB0001506-RAZORPAY SOFTWARE PR IVATE LIMITED-SLICK ORGANICS PVT LITD-AX ISCN0055179428,investments,,net_banking_transfer,10127.67
61b6f90ed8beac1599eafbaa,50200023535069,380203.18,60ec41ba55c00300382672d9,HDFC,Revenue-PG-split enabled,5eecc6d6449e4f7cfb1c2708,2020-08-12T00:00:00.000Z,NEFT CR-UTIB0001506-RAZORPAY SOFTWARE PR IVATE LIMITED-SLICK ORGANICS PVT LITD-AX ISCN0055194528,investments,,net_banking_transfer,11618.95
61b6f90fd8beac1599eafbad,50200023535069,380710.78,60ec41ba55c00300382672d9,HDFC,Revenue-Mktplace,5eecc6d6449e4f7cfb1c2708,2020-08-12T00:00:00.000Z,NEFT CR-DEUT0797BGL-MYNTRA DESIGNS PRIVA TE LIMITED-SLICK ORGANICS PRIVATE LIMITE D-081200177GN00252,shopping,,net_banking_transfer,507.6
61b6f910d8beac1599eafbb1,50200023535069,330710.78,60ec41ba55c00300382672d9,HDFC,agency/vendor expense,5eecc6d6449e4f7cfb1c2708,2020-08-12T00:00:00.000Z,05012560004409-TPT-50000-IDEA SHOP WEB A ND MEDIA PRIVATE LIMITED,bills,,net_banking_transfer,-50000
61b6f911d8beac1599eafbb8,50200023535069,280710.78,60ec41ba55c00300382672d9,HDFC,direct expenses,5eecc6d6449e4f7cfb1c2708,2020-08-12T00:00:00.000Z,NEW A/C - SLICK ORGANICS PVT LTD DR - 02 712990000014 - KALKAJI CHQ TRANSITORY,,,Other,-50000
61b6f912d8beac1599eafbbf,50200023535069,281085.71,60ec41ba55c00300382672d9,HDFC,Revenue-Mktplace,5eecc6d6449e4f7cfb1c2708,2020-08-12T00:00:00.000Z,NEFT CR-DEUT0797BGL-MYNTRA DESIGNS PRIVA TE LIMITED-SLICK ORGANICS PRIVATE LIMITE D-081200218GN00034,shopping,,net_banking_transfer,374.93
61b6f913d8beac1599eafbc3,50200023535069,334017.73,60ec41ba55c00300382672d9,HDFC,Revenue-COD,5eecc6d6449e4f7cfb1c2708,2020-08-12T00:00:00.000Z,NEFT CR-KKBK0000958-BIGFOOT RETAIL SOLUT IONS PRIVATE LIMITED-SLICK ORGANICS PVT LTD-KKBK202253383985,,,net_banking_transfer,52932.02
61b6f914d8beac1599eafbd3,50200023535069,346163.27,60ec41ba55c00300382672d9,HDFC,Revenue-PG-split enabled,5eecc6d6449e4f7cfb1c2708,2020-08-12T00:00:00.000Z,NEFT CR-UTIB0001506-RAZORPAY SOFTWARE PR IVATE LIMITED-SLICK ORGANICS PVT LITD-AX ISCN0055233302,investments,,net_banking_transfer,12145.54
61b6f915d8beac1599eafbd7,50200023535069,340913.27,60ec41ba55c00300382672d9,HDFC,agency/vendor expense,5eecc6d6449e4f7cfb1c2708,2020-08-13T00:00:00.000Z,05012560004409-TPT-5250-IDEA SHOP WEB AN D MEDIA PRIVATE LIMITED,bills,,net_banking_transfer,-5250
61b6f916d8beac1599eafbe1,50200023535069,351320.27,60ec41ba55c00300382672d9,HDFC,Revenue-PG-split enabled,5eecc6d6449e4f7cfb1c2708,2020-08-13T00:00:00.000Z,NEFT CR-UTIB0001506-RAZORPAY SOFTWARE PR IVATE LIMITED-SLICK ORGANICS PVT LITD-AX ISCN0055257025,investments,,net_banking_transfer,10407
61b6f917d8beac1599eafbe6,50200023535069,359974.3,60ec41ba55c00300382672d9,HDFC,Revenue-PG-split enabled,5eecc6d6449e4f7cfb1c2708,2020-08-13T00:00:00.000Z,NEFT CR-UTIB0001506-RAZORPAY SOFTWARE PR IVATE LIMITED-SLICK ORGANICS PVT LITD-AX ISCN0055304712,investments,,net_banking_transfer,8654.03
61b6f918d8beac1599eafbe9,50200023535069,363736.04,60ec41ba55c00300382672d9,HDFC,Revenue-Mktplace,5eecc6d6449e4f7cfb1c2708,2020-08-14T00:00:00.000Z,NEFT CR-DEUT0797BGL-FLIPKART INTERNET P,shopping,,net_banking_transfer,3761.74
61b6f919d8beac1599eafc03,50200023535069,382196.69,60ec41ba55c00300382672d9,HDFC,Revenue-PG-split enabled,5eecc6d6449e4f7cfb1c2708,2020-08-14T00:00:00.000Z,NEFT CR-UTIB0001506-RAZORPAY SOFTWARE PR IVATE LIMITED-SLICK ORGANICS PVT LITD-AX ISCN0055321758,investments,,net_banking_transfer,18460.65
61b6f91ad8beac1599eafc0c,50200023535069,381116.29,60ec41ba55c00300382672d9,HDFC,direct expenses,5eecc6d6449e4f7cfb1c2708,2020-08-14T00:00:00.000Z,"NEFT DR-UTIB0004494-AVINASH SAIRAM-NETBA NK, MUM-N227201214994084-53513",,,net_banking_transfer,-1080.4
61b6f91bd8beac1599eafc14,50200023535069,371116.29,60ec41ba55c00300382672d9,HDFC,Internal Transfers,5eecc6d6449e4f7cfb1c2708,2020-08-14T00:00:00.000Z,IB FUNDS TRANSFER DR-50200035187206 -SL ICK ORGANICS PVT LTD,investments,,net_banking_transfer,-10000
61b6f91cd8beac1599eafc19,50200023535069,373308.75,60ec41ba55c00300382672d9,HDFC,Revenue-Mktplace,5eecc6d6449e4f7cfb1c2708,2020-08-14T00:00:00.000Z,NEFT CR-DEUT0797BGL-MYNTRA DESIGNS PRIVA TE LIMITED-SLICK ORGANICS PRIVATE LIMITE D-081400193GN00273,shopping,,net_banking_transfer,2192.46
61b6f91dd8beac1599eafc1f,50200023535069,374302.51,60ec41ba55c00300382672d9,HDFC,Transfer in/Revenue-other,5eecc6d6449e4f7cfb1c2708,2020-08-14T00:00:00.000Z,NEFT CR-ICIC0SF0002-ICICI BANK NODAL ACC -SLICK ORGANICS-22609012511DC,investments,,net_banking_transfer,993.76
61b6f91ed8beac1599eafc23,50200023535069,374750.68,60ec41ba55c00300382672d9,HDFC,Revenue-Mktplace,5eecc6d6449e4f7cfb1c2708,2020-08-14T00:00:00.000Z,NEFT CR-DEUT0784BBY-TATA UNISTORE LTD-NO DAL-SLICK ORGANICS PVT LTD-081400418GN00 336,investments,,net_banking_transfer,448.17
61b6f91fd8beac1599eafc28,50200023535069,376690.99,60ec41ba55c00300382672d9,HDFC,Transfer in/Revenue-other,5eecc6d6449e4f7cfb1c2708,2020-08-14T00:00:00.000Z,NEFT CR-ICIC0SF0002-ICICI BANK NODAL ACC -SLICK ORGANICS-22609226401DC,investments,,net_banking_transfer,1940.31
61b6f920d8beac1599eafc2e,50200023535069,382284.45,60ec41ba55c00300382672d9,HDFC,Revenue-Mktplace,5eecc6d6449e4f7cfb1c2708,2020-08-14T00:00:00.000Z,NEFT CR-DEUT0797BGL-FLIPKART INTERNET PV TLTD-SLICK ORGANICS PVT LTD-081400078GN0 0248,shopping,,net_banking_transfer,5593.46
61b6f921d8beac1599eafc38,50200023535069,388276.76,60ec41ba55c00300382672d9,HDFC,Revenue-COD,5eecc6d6449e4f7cfb1c2708,2020-08-14T00:00:00.000Z,NEFT CR-KKBK0000958-BIGFOOT RETAIL SOLUT IONS PRIVATE LIMITED-SLICK ORGANICS PVT LTD-KKBK202273765066,,,net_banking_transfer,5992.31
61b6f921d8beac1599eafc3b,50200023535069,406984.61,60ec41ba55c00300382672d9,HDFC,Revenue-PG-split enabled,5eecc6d6449e4f7cfb1c2708,2020-08-14T00:00:00.000Z,NEFT CR-UTIB0001506-RAZORPAY SOFTWARE PR IVATE LIMITED-SLICK ORGANICS PVT LITD-AX ISCN0055370885,investments,,net_banking_transfer,18707.85
61b6f922d8beac1599eafc53,50200023535069,406234.71,60ec41ba55c00300382672d9,HDFC,direct expenses,5eecc6d6449e4f7cfb1c2708,2020-08-16T00:00:00.000Z,POS 514834XXXXXX9486 MANYCHAT COM PRO,,,debit_card,-749.9
61b6f923d8beac1599eafc5a,50200023535069,510873.98,60ec41ba55c00300382672d9,HDFC,Revenue-PG-split enabled,5eecc6d6449e4f7cfb1c2708,2020-08-17T00:00:00.000Z,NEFT CR-UTIB0001506-RAZORPAY SOFTWARE PR,,,net_banking_transfer,104639.27
61b6f924d8beac1599eafc5e,50200023535069,514808.86,60ec41ba55c00300382672d9,HDFC,Revenue-Mktplace,5eecc6d6449e4f7cfb1c2708,2020-08-17T00:00:00.000Z,NEFT CR-DEUT0797BGL-FLIPKART INTERNET P LTD-INT AC FO R INTERMEDIARY-SLICK ORGAN ICS PVT LTD-081700209GN00028,shopping,,net_banking_transfer,3934.88
61b6f925d8beac1599eafc67,50200023535069,515510,60ec41ba55c00300382672d9,HDFC,Revenue-Mktplace,5eecc6d6449e4f7cfb1c2708,2020-08-17T00:00:00.000Z,NEFT CR-DEUT0797BGL-MYNTRA DESIGNS PRIVA TE LIMITED-SLICK ORGANICS PRIVATE LIMITE D-081700269GN00290,shopping,,net_banking_transfer,701.14
61b6f926d8beac1599eafc89,50200023535069,516465.01,60ec41ba55c00300382672d9,HDFC,Revenue-Mktplace,5eecc6d6449e4f7cfb1c2708,2020-08-17T00:00:00.000Z,4060000424-TIMES INTERNET LIMITED NODAL,,,Other,955.01
61b6f927d8beac1599eafc8e,50200023535069,446895.01,60ec41ba55c00300382672d9,HDFC,direct expenses,5eecc6d6449e4f7cfb1c2708,2020-08-17T00:00:00.000Z,"NEFT DR-UTIB0000166-KRAUTER HEALTHCARE LIMITED-NETBANK, MUM-N230201216591885-69 570",,,net_banking_transfer,-69570
61b6f928d8beac1599eafc91,50200023535069,448006.31,60ec41ba55c00300382672d9,HDFC,Revenue-Mktplace,5eecc6d6449e4f7cfb1c2708,2020-08-17T00:00:00.000Z,NEFT CR-DEUT0797BGL-FLIPKART INTERNET PV TLTD-SLICK ORGANICS PVT LTD-081700252GN0 0139,shopping,,net_banking_transfer,1111.3
61b6f929d8beac1599eafc95,50200023535069,459173.24,60ec41ba55c00300382672d9,HDFC,Revenue-PG-split enabled,5eecc6d6449e4f7cfb1c2708,2020-08-17T00:00:00.000Z,NEFT CR-UTIB0001506-RAZORPAY SOFTWARE PR IVATE LIMITED-SLICK ORGANICS PVT LITD-AX ISCN0055448847,investments,,net_banking_transfer,11166.93
61b6f92ad8beac1599eafc9e,50200023535069,460178.37,60ec41ba55c00300382672d9,HDFC,Revenue-PG-non-split,5eecc6d6449e4f7cfb1c2708,2020-08-17T00:00:00.000Z,NEFT CR-ICIC0000031-PAYTM E COMMERCE PVT LTD-SLICK ORGANICS PVT LTD-CMS158190236 6,investments,,net_banking_transfer,1005.13
61b6f92bd8beac1599eafca3,50200023535069,457486.37,60ec41ba55c00300382672d9,HDFC,direct expenses,5eecc6d6449e4f7cfb1c2708,2020-08-18T00:00:00.000Z,"NEFT DR-PUNB0298700-AANCHAL AGARWAL-NETB ANK, MUM-N231201217378525-2692",,,net_banking_transfer,-2692
61b6f92cd8beac1599eafca6,50200023535069,473800.84,60ec41ba55c00300382672d9,HDFC,Revenue-PG-split enabled,5eecc6d6449e4f7cfb1c2708,2020-08-18T00:00:00.000Z,NEFT CR-UTIB0001506-RAZORPAY SOFTWARE PR IVATE LIMITED-SLICK ORGANICS PVT LITD-AX ISCN0055472061,investments,,net_banking_transfer,16314.47
61b6f92dd8beac1599eafcaf,50200023535069,473783.14,60ec41ba55c00300382672d9,HDFC,direct expenses,5eecc6d6449e4f7cfb1c2708,2020-08-18T00:00:00.000Z,.IMPS P2P 021411330963#01/08/2020 010820 -MIR2022888329116,,,net_banking_transfer,-17.7
61b6f92ed8beac1599eafcb2,50200023535069,523604.31,60ec41ba55c00300382672d9,HDFC,Revenue-Mktplace,5eecc6d6449e4f7cfb1c2708,2020-08-18T00:00:00.000Z,IMPS-023111337839-AMAZON SELLER SERVIC-H DFC-XXXXXXXX6004-65SEM94XDOM7BHPFSLICK O RGANICS PVT LTD,shopping,,net_banking_transfer,49821.17
61b6f92fd8beac1599eafcba,50200023535069,791424,60ec41ba55c00300382672d9,HDFC,Revenue-Mktplace,5eecc6d6449e4f7cfb1c2708,2020-08-18T00:00:00.000Z,NEFT CR-DEUT0797BGL-AMAZON PAY IND PVT L,shopping,,net_banking_transfer,267819.69
61b6f930d8beac1599eafcc0,50200023535069,791300.2,60ec41ba55c00300382672d9,HDFC,bank charges,5eecc6d6449e4f7cfb1c2708,2020-08-18T00:00:00.000Z,.DC INTL POS TXN MARKUP+ST 310720 030820 -MIR2022888905645,,,international_transaction_arbitrage,-123.8
61b6f931d8beac1599eafcc6,50200023535069,791210.42,60ec41ba55c00300382672d9,HDFC,bank charges,5eecc6d6449e4f7cfb1c2708,2020-08-18T00:00:00.000Z,.DC INTL POS TXN MARKUP+ST 010820 030820 -MIR2022888905638,,,international_transaction_arbitrage,-89.78
61b6f932d8beac1599eafcca,50200023535069,790823.43,60ec41ba55c00300382672d9,HDFC,bank charges,5eecc6d6449e4f7cfb1c2708,2020-08-18T00:00:00.000Z,.DC INTL POS TXN MARKUP+ST 020820 040820 -MIR2022990555582,,,international_transaction_arbitrage,-386.99
61b6f933d8beac1599eafccd,50200023535069,790046.71,60ec41ba55c00300382672d9,HDFC,bank charges,5eecc6d6449e4f7cfb1c2708,2020-08-18T00:00:00.000Z,.DC INTL POS TXN MARKUP+ST 040820 060820 -MIR2022991836825,,,international_transaction_arbitrage,-776.72
61b6f934d8beac1599eafce1,50200023535069,790040.81,60ec41ba55c00300382672d9,HDFC,direct expenses,5eecc6d6449e4f7cfb1c2708,2020-08-18T00:00:00.000Z,.IMPS P2P 021914132936#06/08/2020 060820 -MIR2022991827487,,,net_banking_transfer,-5.9
61b6f935d8beac1599eafcec,50200023535069,790034.91,60ec41ba55c00300382672d9,HDFC,direct expenses,5eecc6d6449e4f7cfb1c2708,2020-08-18T00:00:00.000Z,.IMPS P2P 021914140724#06/08/2020 060820 -MIR2022991818615,,,net_banking_transfer,-5.9
61b6f935d8beac1599eafcef,50200023535069,790029.01,60ec41ba55c00300382672d9,HDFC,direct expenses,5eecc6d6449e4f7cfb1c2708,2020-08-18T00:00:00.000Z,.IMPS P2P 021914143963#06/08/2020 060820 -MIR2022991824372,,,net_banking_transfer,-5.9
61b6f936d8beac1599eafcf7,50200023535069,790023.11,60ec41ba55c00300382672d9,HDFC,direct expenses,5eecc6d6449e4f7cfb1c2708,2020-08-18T00:00:00.000Z,.IMPS P2P 021914144408#06/08/2020 060820 -MIR2022991824394,,,net_banking_transfer,-5.9
61b6f937d8beac1599eafcfb,50200023535069,790017.21,60ec41ba55c00300382672d9,HDFC,direct expenses,5eecc6d6449e4f7cfb1c2708,2020-08-18T00:00:00.000Z,.IMPS P2P 021914145320#06/08/2020 060820 -MIR2022991843222,,,net_banking_transfer,-5.9
61b6f938d8beac1599eafcff,50200023535069,790011.31,60ec41ba55c00300382672d9,HDFC,direct expenses,5eecc6d6449e4f7cfb1c2708,2020-08-18T00:00:00.000Z,.IMPS P2P 021914148239#06/08/2020 060820 -MIR2022991823881,,,net_banking_transfer,-5.9
61b6f939d8beac1599eafd05,50200023535069,789993.61,60ec41ba55c00300382672d9,HDFC,direct expenses,5eecc6d6449e4f7cfb1c2708,2020-08-18T00:00:00.000Z,.IMPS P2P 022110342301#08/08/2020 080820 -MIR2023193621844,,,net_banking_transfer,-17.7
61b6f93ad8beac1599eafd0b,50200023535069,789975.91,60ec41ba55c00300382672d9,HDFC,direct expenses,5eecc6d6449e4f7cfb1c2708,2020-08-18T00:00:00.000Z,.IMPS P2P 022110343064#08/08/2020 080820 -MIR2023193621848,,,net_banking_transfer,-17.7
61b6f93bd8beac1599eafd10,50200023535069,854462.74,60ec41ba55c00300382672d9,HDFC,Revenue-PG-split enabled,5eecc6d6449e4f7cfb1c2708,2020-08-18T00:00:00.000Z,NEFT CR-UTIB0001506-RAZORPAY SOFTWARE PR IVATE LIMITED-SLICK ORGANICS PVT LITD-AX ISCN0055518752,investments,,net_banking_transfer,64486.83
61b6f93cd8beac1599eafd14,50200023535069,855945.69,60ec41ba55c00300382672d9,HDFC,Revenue-Mktplace,5eecc6d6449e4f7cfb1c2708,2020-08-18T00:00:00.000Z,NEFT CR-ICIC0000105-MANASH LIFETYLE PVT LTD-SLICK ORGANICS PRIVATE LIMITED MP GG N-ICIB202310053736,,,net_banking_transfer,1482.95
61b6f93dd8beac1599eafd17,50200023535069,849385.69,60ec41ba55c00300382672d9,HDFC,Tax,5eecc6d6449e4f7cfb1c2708,2020-08-19T00:00:00.000Z,GST/BANK REFERENCE NO: R2023220163360/CI,,,Other,-6560
61b6f93ed8beac1599eafd1f,50200023535069,850039.87,60ec41ba55c00300382672d9,HDFC,Revenue-Mktplace,5eecc6d6449e4f7cfb1c2708,2020-08-19T00:00:00.000Z,NEFT CR-DEUT0797BGL-FLIPKART INTERNET P LTD-INT AC FO R INTERMEDIARY-SLICK ORGAN ICS PVT LTD-081900117GN00027,shopping,,net_banking_transfer,654.18
61b6f93fd8beac1599eafd24,50200023535069,910789.77,60ec41ba55c00300382672d9,HDFC,Revenue-PG-split enabled,5eecc6d6449e4f7cfb1c2708,2020-08-19T00:00:00.000Z,NEFT CR-UTIB0001506-RAZORPAY SOFTWARE PR IVATE LIMITED-SLICK ORGANICS PVT LITD-AX ISCN0055536818,investments,,net_banking_transfer,60749.9
61b6f940d8beac1599eafd28,50200023535069,911564.53,60ec41ba55c00300382672d9,HDFC,Revenue-Mktplace,5eecc6d6449e4f7cfb1c2708,2020-08-19T00:00:00.000Z,NEFT CR-DEUT0797BGL-MYNTRA DESIGNS PRIVA TE LIMITED-SLICK ORGANICS PRIVATE LIMITE D-081900174GN00151,shopping,,net_banking_transfer,774.76
61b6f941d8beac1599eafd30,50200023535069,861564.53,60ec41ba55c00300382672d9,HDFC,SAAS/tech expense,5eecc6d6449e4f7cfb1c2708,2020-08-19T00:00:00.000Z,SHDF9130482364/BILLDKAMAZONSELLERSE,shopping,,Other,-50000
61b6f942d8beac1599eafd34,50200023535069,862608.14,60ec41ba55c00300382672d9,HDFC,Revenue-Mktplace,5eecc6d6449e4f7cfb1c2708,2020-08-19T00:00:00.000Z,NEFT CR-DEUT0797BGL-MYNTRA DESIGNS PRIVA TE LIMITED-SLICK ORGANICS PRIVATE LIMITE D-081900205GN00010,shopping,,net_banking_transfer,1043.61
61b6f943d8beac1599eafd3a,50200023535069,863046.86,60ec41ba55c00300382672d9,HDFC,Revenue-Mktplace,5eecc6d6449e4f7cfb1c2708,2020-08-19T00:00:00.000Z,NEFT CR-DEUT0797BGL-FLIPKART INTERNET PV TLTD-SLICK ORGANICS PVT LTD-081900075GN0 0034,shopping,,net_banking_transfer,438.72
61b6f944d8beac1599eafd40,50200023535069,875192.54,60ec41ba55c00300382672d9,HDFC,Revenue-PG-split enabled,5eecc6d6449e4f7cfb1c2708,2020-08-19T00:00:00.000Z,NEFT CR-UTIB0001506-RAZORPAY SOFTWARE PR IVATE LIMITED-SLICK ORGANICS PVT LITD-AX ISCN0055585166,investments,,net_banking_transfer,12145.68
61b6f945d8beac1599eafd46,50200023535069,898308.61,60ec41ba55c00300382672d9,HDFC,Revenue-PG-split enabled,5eecc6d6449e4f7cfb1c2708,2020-08-20T00:00:00.000Z,NEFT CR-UTIB0001506-RAZORPAY SOFTWARE PR IVATE LIMITED-SLICK ORGANICS PVT LITD-AX ISCN0055609931,investments,,net_banking_transfer,23116.07
61b6f946d8beac1599eafd4a,50200023535069,887773.61,60ec41ba55c00300382672d9,HDFC,direct expenses,5eecc6d6449e4f7cfb1c2708,2020-08-20T00:00:00.000Z,"NEFT DR-YESB0000551-VISTTA COSMETICS-NET BANK, MUM-N233201219448270-10535",,,net_banking_transfer,-10535
61b6f947d8beac1599eafd4e,50200023535069,882529.31,60ec41ba55c00300382672d9,HDFC,direct expenses,5eecc6d6449e4f7cfb1c2708,2020-08-20T00:00:00.000Z,POS 514834XXXXXX9486 FEEDBACKFIVE,,,debit_card,-5244.3
61b6f948d8beac1599eafd55,50200023535069,910387.66,60ec41ba55c00300382672d9,HDFC,Transfer in/Revenue-other,5eecc6d6449e4f7cfb1c2708,2020-08-20T00:00:00.000Z,NEFT CR-RATN0000999-HIVELOOP CAPITAL PRI VATE LIMITED-SLICK ORGANICS PVT L-000133 748310,,,net_banking_transfer,27858.35
61b6f949d8beac1599eafd5f,50200023535069,991470.61,60ec41ba55c00300382672d9,HDFC,Transfer in/Revenue-other,5eecc6d6449e4f7cfb1c2708,2020-08-20T00:00:00.000Z,NEFT CR-RATN0000999-HIVELOOP CAPITAL PRI VATE LIMITED-SLICK ORGANICS PVT L-000133 750406,,,net_banking_transfer,81082.95
61b6f94ad8beac1599eafd61,50200023535069,1058284.76,60ec41ba55c00300382672d9,HDFC,Transfer in/Revenue-other,5eecc6d6449e4f7cfb1c2708,2020-08-20T00:00:00.000Z,NEFT CR-RATN0000999-HIVELOOP CAPITAL PRI,,,net_banking_transfer,66814.15
61b6f94bd8beac1599eafd6a,50200023535069,1116267.36,60ec41ba55c00300382672d9,HDFC,Transfer in/Revenue-other,5eecc6d6449e4f7cfb1c2708,2020-08-20T00:00:00.000Z,NEFT CR-RATN0000999-HIVELOOP CAPITAL PRI VATE LIMITED-SLICK ORGANICS PVT L-000133 768325,,,net_banking_transfer,57982.6
61b6f94cd8beac1599eafd6d,50200023535069,1174249.96,60ec41ba55c00300382672d9,HDFC,Transfer in/Revenue-other,5eecc6d6449e4f7cfb1c2708,2020-08-20T00:00:00.000Z,NEFT CR-RATN0000999-HIVELOOP CAPITAL PRI VATE LIMITED-SLICK ORGANICS PVT L-000133 768324,,,net_banking_transfer,57982.6
61b6f94dd8beac1599eafd72,50200023535069,1185076.47,60ec41ba55c00300382672d9,HDFC,Revenue-PG-split enabled,5eecc6d6449e4f7cfb1c2708,2020-08-20T00:00:00.000Z,NEFT CR-UTIB0001506-RAZORPAY SOFTWARE PR IVATE LIMITED-SLICK ORGANICS PVT LITD-AX ISCN0055652252,investments,,net_banking_transfer,10826.51
61b6f94dd8beac1599eafd78,50200023535069,1178406.81,60ec41ba55c00300382672d9,HDFC,direct expenses,5eecc6d6449e4f7cfb1c2708,2020-08-20T00:00:00.000Z,POS 514834XXXXXX9486 HOTJAR,,,debit_card,-6669.66
61b6f94ed8beac1599eafd80,50200023535069,1141406.81,60ec41ba55c00300382672d9,HDFC,direct expenses,5eecc6d6449e4f7cfb1c2708,2020-08-21T00:00:00.000Z,"NEFT DR-CITI0000002-DHIRAJ-NETBANK, MUM- N234201220432883-37000",,,net_banking_transfer,-37000
61b6f94fd8beac1599eafd85,50200023535069,1106406.81,60ec41ba55c00300382672d9,HDFC,direct expenses,5eecc6d6449e4f7cfb1c2708,2020-08-21T00:00:00.000Z,"NEFT DR-ICIC0000542-AVANTIKA SUKHIA-NETB ANK, MUM-N234201220430102-35000",,,net_banking_transfer,-35000
61b6f950d8beac1599eafd89,50200023535069,1098906.81,60ec41ba55c00300382672d9,HDFC,direct expenses,5eecc6d6449e4f7cfb1c2708,2020-08-21T00:00:00.000Z,"NEFT DR-SIBL0000555-JAIVEER KUMAR-NETBAN K, MUM-N234201220430113-7500",,,net_banking_transfer,-7500
61b6f951d8beac1599eafd8c,50200023535069,1093906.81,60ec41ba55c00300382672d9,HDFC,direct expenses,5eecc6d6449e4f7cfb1c2708,2020-08-21T00:00:00.000Z,"NEFT DR-PUNB0398000-MEENA SINGH-NETBANK, MUM-N234201220432912-5000",,,net_banking_transfer,-5000
61b6f952d8beac1599eafd96,50200023535069,1083906.81,60ec41ba55c00300382672d9,HDFC,direct expenses,5eecc6d6449e4f7cfb1c2708,2020-08-21T00:00:00.000Z,"NEFT DR-SBIN0001189-SANDEEP SINGH-NETBAN K, MUM-N234201220432926-10000",,,net_banking_transfer,-10000
61b6f953d8beac1599eafd9b,50200023535069,1066406.81,60ec41ba55c00300382672d9,HDFC,direct expenses,5eecc6d6449e4f7cfb1c2708,2020-08-21T00:00:00.000Z,"NEFT DR-ICIC0003374-SIDDHARTH KANOJIA-NE TBANK, MUM-N234201220438101-17500",,,net_banking_transfer,-17500
61b6f954d8beac1599eafd9f,50200023535069,1063406.81,60ec41ba55c00300382672d9,HDFC,direct expenses,5eecc6d6449e4f7cfb1c2708,2020-08-21T00:00:00.000Z,"NEFT DR-ALLA0210591-CHAMPA DEVI-NETBANK, MUM-N234201220425321-3000",,,net_banking_transfer,-3000
61b6f955d8beac1599eafdc5,50200023535069,1049281.81,60ec41ba55c00300382672d9,HDFC,direct expenses,5eecc6d6449e4f7cfb1c2708,2020-08-21T00:00:00.000Z,"NEFT DR-SYNB0005170-SNEHAL TAYDE-NETBANK , MUM-N234201220425334-14125",,,net_banking_transfer,-14125
61b6f956d8beac1599eafdc9,50200023535069,1028431.81,60ec41ba55c00300382672d9,HDFC,direct expenses,5eecc6d6449e4f7cfb1c2708,2020-08-21T00:00:00.000Z,"NEFT DR-UTIB0000120-ADNAN ALI-NETBANK, M UM-N234201220430322-20850",,,net_banking_transfer,-20850
61b6f957d8beac1599eafddc,50200023535069,981931.81,60ec41ba55c00300382672d9,HDFC,direct expenses,5eecc6d6449e4f7cfb1c2708,2020-08-21T00:00:00.000Z,NEFT DR-BKDN0450123-ARTISTO DESIGNZ-NETB,,,net_banking_transfer,-46500
61b6f958d8beac1599eafde2,50200023535069,965931.81,60ec41ba55c00300382672d9,HDFC,direct expenses,5eecc6d6449e4f7cfb1c2708,2020-08-21T00:00:00.000Z,00901610080520-TPT-16000-POOJA KAPIL SHR OTRIYA,,,net_banking_transfer,-16000
61b6f959d8beac1599eafde8,50200023535069,930931.81,60ec41ba55c00300382672d9,HDFC,direct expenses,5eecc6d6449e4f7cfb1c2708,2020-08-21T00:00:00.000Z,50100301160692-TPT-35000-TARUN GARG,,,net_banking_transfer,-35000
61b6f95ad8beac1599eafdec,50200023535069,880931.81,60ec41ba55c00300382672d9,HDFC,direct expenses,5eecc6d6449e4f7cfb1c2708,2020-08-21T00:00:00.000Z,02771610131904-TPT-50000-DIGANT BHATT,,,net_banking_transfer,-50000
61b6f95bd8beac1599eafdf0,50200023535069,847931.81,60ec41ba55c00300382672d9,HDFC,direct expenses,5eecc6d6449e4f7cfb1c2708,2020-08-21T00:00:00.000Z,50100330586095-TPT-33000-DIWAKAR UNIYAL,,,net_banking_transfer,-33000
61b6f95cd8beac1599eafdf9,50200023535069,837931.81,60ec41ba55c00300382672d9,HDFC,direct expenses,5eecc6d6449e4f7cfb1c2708,2020-08-21T00:00:00.000Z,"NEFT DR-KKBK0000291-ROLI GARG-NETBANK, M UM-N234201220445495-10000",,,net_banking_transfer,-10000
61b6f95dd8beac1599eafe08,50200023535069,614832.81,60ec41ba55c00300382672d9,HDFC,direct expenses,5eecc6d6449e4f7cfb1c2708,2020-08-21T00:00:00.000Z,"NEFT DR-ORBC0101001-KRAUTER HEALTHCARE L TD-NETBANK, MUM-N234201220433392-100 PER CENT RM",,,net_banking_transfer,-223099
61b6f95ed8beac1599eafe12,50200023535069,498132.81,60ec41ba55c00300382672d9,HDFC,direct expenses,5eecc6d6449e4f7cfb1c2708,2020-08-21T00:00:00.000Z,"NEFT DR-ORBC0101001-KRAUTER HEALTHCARE L TD-NETBANK, MUM-N234201220438665-50 PERC ENT PI 14",,,net_banking_transfer,-116700
61b6f95fd8beac1599eafe19,50200023535069,491147.81,60ec41ba55c00300382672d9,HDFC,direct expenses,5eecc6d6449e4f7cfb1c2708,2020-08-21T00:00:00.000Z,"NEFT DR-BOFA0MM6205-FEDEX EXPRESS TRANSP ORTATION SUPPLY CHAI-NETBANK, MUM-N23420 1220433521-6985",loans,lender_transaction,net_banking_transfer,-6985
61b6f960d8beac1599eafe20,50200023535069,68760.81,60ec41ba55c00300382672d9,HDFC,direct expenses,5eecc6d6449e4f7cfb1c2708,2020-08-21T00:00:00.000Z,"NEFT DR-ICIC0003430-HASHTAG ORANGE ADVER TISING PVT LTD-NETBANK, MUM-N23420122043 8742-422387",,,net_banking_transfer,-422387
61b6f961d8beac1599eafe2a,50200023535069,88033.81,60ec41ba55c00300382672d9,HDFC,Transfer in/Revenue-other,5eecc6d6449e4f7cfb1c2708,2020-08-21T00:00:00.000Z,NEFT CR-RATN0000999-HIVELOOP CAPITAL PRI VATE LIMITED-SLICK ORGANICS PVT L-000133 820215,,,net_banking_transfer,19273
61b6f962d8beac1599eafe2e,50200023535069,90552.24,60ec41ba55c00300382672d9,HDFC,Revenue-Mktplace,5eecc6d6449e4f7cfb1c2708,2020-08-21T00:00:00.000Z,NEFT CR-DEUT0797BGL-FLIPKART INTERNET P LTD-INT AC FO R INTERMEDIARY-SLICK ORGAN ICS PVT LTD-082100113GN00164,shopping,,net_banking_transfer,2518.43
61b6f963d8beac1599eafe3d,50200023535069,109607.41,60ec41ba55c00300382672d9,HDFC,Revenue-PG-split enabled,5eecc6d6449e4f7cfb1c2708,2020-08-21T00:00:00.000Z,NEFT CR-UTIB0001506-RAZORPAY SOFTWARE PR IVATE LIMITED-SLICK ORGANICS PVT LITD-AX ISCN0055669399,investments,,net_banking_transfer,19055.17
61b6f964d8beac1599eafe43,50200023535069,109926.22,60ec41ba55c00300382672d9,HDFC,Revenue-Mktplace,5eecc6d6449e4f7cfb1c2708,2020-08-21T00:00:00.000Z,NEFT CR-DEUT0797BGL-MYNTRA DESIGNS PRIVA TE LIMITED-SLICK ORGANICS PRIVATE LIMITE D-082100178GN00276,shopping,,net_banking_transfer,318.81
61b6f965d8beac1599eafe46,50200023535069,117945.25,60ec41ba55c00300382672d9,HDFC,Revenue-Mktplace,5eecc6d6449e4f7cfb1c2708,2020-08-21T00:00:00.000Z,NEFT CR-KKBK0000958-SUPERMARKET GROCERY,shopping,,net_banking_transfer,8019.03
61b6f965d8beac1599eafe49,50200023535069,118708.35,60ec41ba55c00300382672d9,HDFC,Revenue-Mktplace,5eecc6d6449e4f7cfb1c2708,2020-08-21T00:00:00.000Z,NEFT CR-KKBK0000958-SUPERMARKET GROCERY SUPPLIES PVT LTD-SLICK ORGANICS PVT LTD- KKBK202344795597,shopping,,net_banking_transfer,763.1
61b6f966d8beac1599eafe53,50200023535069,121013.2,60ec41ba55c00300382672d9,HDFC,Revenue-Mktplace,5eecc6d6449e4f7cfb1c2708,2020-08-21T00:00:00.000Z,NEFT CR-KKBK0000958-SUPERMARKET GROCERY SUPPLIES PVT LTD-SLICK ORGANICS PVT LTD- KKBK202344795623,shopping,,net_banking_transfer,2304.85
61b6f967d8beac1599eafe57,50200023535069,122555,60ec41ba55c00300382672d9,HDFC,Revenue-Mktplace,5eecc6d6449e4f7cfb1c2708,2020-08-21T00:00:00.000Z,NEFT CR-KKBK0000958-SUPERMARKET GROCERY SUPPLIES PVT LTD-SLICK ORGANICS PVT LTD- KKBK202344795828,shopping,,net_banking_transfer,1541.8
61b6f968d8beac1599eafe62,50200023535069,133057.02,60ec41ba55c00300382672d9,HDFC,Revenue-Mktplace,5eecc6d6449e4f7cfb1c2708,2020-08-21T00:00:00.000Z,NEFT CR-KKBK0000958-SUPERMARKET GROCERY SUPPLIES PVT LTD-SLICK ORGANICS PVT LTD- KKBK202344797057,shopping,,net_banking_transfer,10502.02
61b6f969d8beac1599eafe65,50200023535069,137922.17,60ec41ba55c00300382672d9,HDFC,Revenue-Mktplace,5eecc6d6449e4f7cfb1c2708,2020-08-21T00:00:00.000Z,NEFT CR-KKBK0000958-SUPERMARKET GROCERY SUPPLIES PVT LTD-SLICK ORGANICS PVT LTD- KKBK202344797004,shopping,,net_banking_transfer,4865.15
61b6f96ad8beac1599eafe69,50200023535069,140249.33,60ec41ba55c00300382672d9,HDFC,Transfer in/Revenue-other,5eecc6d6449e4f7cfb1c2708,2020-08-21T00:00:00.000Z,NEFT CR-ICIC0SF0002-ICICI BANK NODAL ACC -SLICK ORGANICS-22637382321DC,investments,,net_banking_transfer,2327.16
61b6f96bd8beac1599eafe71,50200023535069,115249.33,60ec41ba55c00300382672d9,HDFC,SAAS/tech expense,5eecc6d6449e4f7cfb1c2708,2020-08-21T00:00:00.000Z,SHDF9137380236/BILLDKAMAZONSELLERSE,shopping,,Other,-25000
61b6f96cd8beac1599eafe82,50200023535069,115713.77,60ec41ba55c00300382672d9,HDFC,Transfer in/Revenue-other,5eecc6d6449e4f7cfb1c2708,2020-08-21T00:00:00.000Z,NEFT CR-YESB0000001-ILUMINAR MEDIA-SLICK ORGANICS PVT. LTD-N234200423981850,,,net_banking_transfer,464.44
61b6f96dd8beac1599eafe99,50200023535069,116327.03,60ec41ba55c00300382672d9,HDFC,Revenue-Mktplace,5eecc6d6449e4f7cfb1c2708,2020-08-21T00:00:00.000Z,NEFT CR-DEUT0797BGL-MYNTRA DESIGNS PRIVA TE LIMITED-SLICK ORGANICS PRIVATE LIMITE D-082100219GN00039,shopping,,net_banking_transfer,613.26
61b6f96ed8beac1599eafea6,50200023535069,118792.15,60ec41ba55c00300382672d9,HDFC,Revenue-Mktplace,5eecc6d6449e4f7cfb1c2708,2020-08-21T00:00:00.000Z,NEFT CR-DEUT0784BBY-TATA UNISTORE LTD-NO DAL-SLICK ORGANICS PVT LTD-082100494GN00 304,investments,,net_banking_transfer,2465.12
61b6f96fd8beac1599eafeab,50200023535069,119276.67,60ec41ba55c00300382672d9,HDFC,Revenue-Mktplace,5eecc6d6449e4f7cfb1c2708,2020-08-21T00:00:00.000Z,NEFT CR-ICIC0000104-GOQII TECHNOLOGIES P VT LTD-SLICK ORGANICS PRIVATE LIMITED-CM S1585939475,,,net_banking_transfer,484.52
61b6f970d8beac1599eafebd,50200023535069,120952.31,60ec41ba55c00300382672d9,HDFC,Revenue-Mktplace,5eecc6d6449e4f7cfb1c2708,2020-08-21T00:00:00.000Z,NEFT CR-DEUT0797BGL-FLIPKART INTERNET PV,shopping,,net_banking_transfer,1675.64
61b6f971d8beac1599eaff29,50200023535069,135386.01,60ec41ba55c00300382672d9,HDFC,Revenue-COD,5eecc6d6449e4f7cfb1c2708,2020-08-21T00:00:00.000Z,NEFT CR-KKBK0000958-BIGFOOT RETAIL SOLUT IONS PRIVATE LIMITED-SLICK ORGANICS PVT LTD-KKBK202344858058,,,net_banking_transfer,14433.7
61b6f972d8beac1599eaff2e,50200023535069,152841.04,60ec41ba55c00300382672d9,HDFC,Revenue-PG-split enabled,5eecc6d6449e4f7cfb1c2708,2020-08-21T00:00:00.000Z,NEFT CR-UTIB0001506-RAZORPAY SOFTWARE PR IVATE LIMITED-SLICK ORGANICS PVT LITD-AX ISCN0055711847,investments,,net_banking_transfer,17455.03
61b6f973d8beac1599eaff3d,50200023535069,153336.9,60ec41ba55c00300382672d9,HDFC,Revenue-PG-non-split,5eecc6d6449e4f7cfb1c2708,2020-08-21T00:00:00.000Z,NEFT CR-ICIC0000031-PAYTM E COMMERCE PVT LTD-SLICK ORGANICS PVT LTD-CMS158687417 5,investments,,net_banking_transfer,495.86
61b6f974d8beac1599eaff42,50200023535069,128336.9,60ec41ba55c00300382672d9,HDFC,SAAS/tech expense,5eecc6d6449e4f7cfb1c2708,2020-08-24T00:00:00.000Z,POS 514834XXXXXX9486 AMAZON,shopping,,debit_card,-25000
61b6f975d8beac1599eaff4c,50200023535069,132263.44,60ec41ba55c00300382672d9,HDFC,Revenue-Mktplace,5eecc6d6449e4f7cfb1c2708,2020-08-24T00:00:00.000Z,NEFT CR-DEUT0797BGL-FLIPKART INTERNET P LTD-INT AC FO R INTERMEDIARY-SLICK ORGAN ICS PVT LTD-082400271GN00011,shopping,,net_banking_transfer,3926.54
61b6f976d8beac1599eaff52,50200023535069,135276.07,60ec41ba55c00300382672d9,HDFC,Revenue-Mktplace,5eecc6d6449e4f7cfb1c2708,2020-08-24T00:00:00.000Z,NEFT CR-DEUT0797BGL-FLIPKART INTERNET PV TLTD-SLICK ORGANICS PVT LTD-082400307GN0 0142,shopping,,net_banking_transfer,3012.63
61b6f977d8beac1599eaff62,50200023535069,174948.62,60ec41ba55c00300382672d9,HDFC,Revenue-PG-split enabled,5eecc6d6449e4f7cfb1c2708,2020-08-24T00:00:00.000Z,NEFT CR-UTIB0001506-RAZORPAY SOFTWARE PR IVATE LIMITED-SLICK ORGANICS PVT LITD-AX ISCN0055744020,investments,,net_banking_transfer,39672.55
61b6f978d8beac1599eaff69,50200023535069,176805.39,60ec41ba55c00300382672d9,HDFC,Revenue-Mktplace,5eecc6d6449e4f7cfb1c2708,2020-08-24T00:00:00.000Z,NEFT CR-DEUT0797BGL-MYNTRA DESIGNS PRIVA TE LIMITED-SLICK ORGANICS PRIVATE LIMITE D-082400330GN00032,shopping,,net_banking_transfer,1856.77
61b6f979d8beac1599eaff6f,50200023535069,214351.83,60ec41ba55c00300382672d9,HDFC,Revenue-PG-non-split,5eecc6d6449e4f7cfb1c2708,2020-08-24T00:00:00.000Z,NEFT CR-SCBL0036001-STRIPE INDIA PRIVATE -SLICK ORGANICS PRIVATE LIMITED-SSG17413 Q0080878,investments,,net_banking_transfer,37546.44
61b6f97ad8beac1599eaff74,50200023535069,235482.97,60ec41ba55c00300382672d9,HDFC,Revenue-PG-split enabled,5eecc6d6449e4f7cfb1c2708,2020-08-24T00:00:00.000Z,NEFT CR-UTIB0001506-RAZORPAY SOFTWARE PR IVATE LIMITED-SLICK ORGANICS PVT LITD-AX ISCN0055787068,investments,,net_banking_transfer,21131.14
61b6f97bd8beac1599eaff7d,50200023535069,235469,60ec41ba55c00300382672d9,HDFC,bank charges,5eecc6d6449e4f7cfb1c2708,2020-08-24T00:00:00.000Z,DEBIT CARD PUR ADJ DT 20/08/20,,,Other,-13.97
61b6f97cd8beac1599eaff83,50200023535069,235419,60ec41ba55c00300382672d9,HDFC,direct expenses,5eecc6d6449e4f7cfb1c2708,2020-08-25T00:00:00.000Z,CHQ PAID-MICR CTS-CH-HIVE LOOP CAPITAL P,,,chq,-50
61b6f97dd8beac1599eaff8d,50200023535069,235369,60ec41ba55c00300382672d9,HDFC,direct expenses,5eecc6d6449e4f7cfb1c2708,2020-08-25T00:00:00.000Z,CHQ PAID-MICR CTS-CH-HIVE LAAP CAPITAL P,,,chq,-50
61b6f97ed8beac1599eaff91,50200023535069,194069,60ec41ba55c00300382672d9,HDFC,direct expenses,5eecc6d6449e4f7cfb1c2708,2020-08-25T00:00:00.000Z,"NEFT DR-ICIC0000037-PURPLE PANDA FASHION S PVT LTD-NETBANK, MUM-N238201222888800- ADVANCE",shopping,,net_banking_transfer,-41300
61b6f97fd8beac1599eaff98,50200023535069,209066.07,60ec41ba55c00300382672d9,HDFC,Revenue-PG-split enabled,5eecc6d6449e4f7cfb1c2708,2020-08-25T00:00:00.000Z,NEFT CR-UTIB0001506-RAZORPAY SOFTWARE PR IVATE LIMITED-SLICK ORGANICS PVT LITD-AX ISCN0055807377,investments,,net_banking_transfer,14997.07
61b6f980d8beac1599eaffa2,50200023535069,263829.81,60ec41ba55c00300382672d9,HDFC,Revenue-Mktplace,5eecc6d6449e4f7cfb1c2708,2020-08-25T00:00:00.000Z,IMPS-023811026839-AMAZON SELLER SERVIC-H DFC-XXXXXXXX6004-PTOCJRS0Y93HBOT8SLICK O RGANICS PVT LTD,shopping,,net_banking_transfer,54763.74
61b6f980d8beac1599eaffac,50200023535069,238829.81,60ec41ba55c00300382672d9,HDFC,SAAS/tech expense,5eecc6d6449e4f7cfb1c2708,2020-08-25T00:00:00.000Z,SHDF9150040808/BILLDKAMAZONSELLERSE,shopping,,Other,-25000
61b6f981d8beac1599eaffc6,50200023535069,238798.84,60ec41ba55c00300382672d9,HDFC,bank charges,5eecc6d6449e4f7cfb1c2708,2020-08-25T00:00:00.000Z,.DC INTL POS TXN MARKUP+ST 160820 180820 -MIR2023606584363,,,international_transaction_arbitrage,-30.97
61b6f982d8beac1599eaffcc,50200023535069,513882.59,60ec41ba55c00300382672d9,HDFC,Revenue-Mktplace,5eecc6d6449e4f7cfb1c2708,2020-08-25T00:00:00.000Z,NEFT CR-DEUT0797BGL-AMAZON PAY IND PVT L TD-INT AC INTM MKTPLACE-SLICK ORGANICS P VT LTD-082500168GN00087,shopping,,net_banking_transfer,275083.75
61b6f983d8beac1599eaffd2,50200023535069,515839.19,60ec41ba55c00300382672d9,HDFC,Revenue-Mktplace,5eecc6d6449e4f7cfb1c2708,2020-08-25T00:00:00.000Z,4060000538-TIMES INTERNET LIMITED NODAL,,,Other,1956.6
61b6f984d8beac1599eaffdd,50200023535069,437646.19,60ec41ba55c00300382672d9,HDFC,direct expenses,5eecc6d6449e4f7cfb1c2708,2020-08-25T00:00:00.000Z,00921000075586-TPT-78193-ROET BINDRA,,,net_banking_transfer,-78193
61b6f985d8beac1599eaffe6,50200023535069,362646.19,60ec41ba55c00300382672d9,HDFC,direct expenses,5eecc6d6449e4f7cfb1c2708,2020-08-25T00:00:00.000Z,"NEFT DR-YESB0000109-JERONONE TECHNOLOGIE S-NETBANK, MUM-N238201223263706-75000",,,net_banking_transfer,-75000
61b6f986d8beac1599eaffea,50200023535069,595105.15,60ec41ba55c00300382672d9,HDFC,Revenue-PG-split enabled,5eecc6d6449e4f7cfb1c2708,2020-08-25T00:00:00.000Z,RTGS CR-UTIB0001506-RAZORPAY SOFTWARE PR IVATE LIMITED --SLICK ORGANICS PVT LITD- UTIBR52020082500329250,,,net_banking_transfer,232458.96
61b6f987d8beac1599eafff1,50200023535069,599102.72,60ec41ba55c00300382672d9,HDFC,Revenue-Mktplace,5eecc6d6449e4f7cfb1c2708,2020-08-26T00:00:00.000Z,NEFT CR-DEUT0797BGL-FLIPKART INTERNET P LTD-INT AC FO R INTERMEDIARY-SLICK ORGAN ICS PVT LTD-082600116GN00227,shopping,,net_banking_transfer,3997.57
61b6f988d8beac1599eafff4,50200023535069,595463.72,60ec41ba55c00300382672d9,HDFC,direct expenses,5eecc6d6449e4f7cfb1c2708,2020-08-26T00:00:00.000Z,POS 514834XXXXXX9486 FRESHWORKS INC,,,debit_card,-3639
61b6f989d8beac1599eafffa,50200023535069,668395.42,60ec41ba55c00300382672d9,HDFC,Revenue-PG-split enabled,5eecc6d6449e4f7cfb1c2708,2020-08-26T00:00:00.000Z,NEFT CR-UTIB0001506-RAZORPAY SOFTWARE PR IVATE LIMITED-SLICK ORGANICS PVT LITD-AX ISCN0055880947,investments,,net_banking_transfer,72931.7
61b6f98ad8beac1599eb0001,50200023535069,555022.42,60ec41ba55c00300382672d9,HDFC,direct expenses,5eecc6d6449e4f7cfb1c2708,2020-08-26T00:00:00.000Z,NEFT DR-CITI0000002-OMG NETWORK INDIA PR,,,net_banking_transfer,-113373
61b6f98bd8beac1599eb0005,50200023535069,477636.42,60ec41ba55c00300382672d9,HDFC,direct expenses,5eecc6d6449e4f7cfb1c2708,2020-08-26T00:00:00.000Z,"NEFT DR-CITI0000032-TRADETRACKER INDIA L LP-NETBANK, MUM-N239201223953673-MARCH",,,net_banking_transfer,-77386
61b6f98cd8beac1599eb000c,50200023535069,453105.42,60ec41ba55c00300382672d9,HDFC,agency/vendor expense,5eecc6d6449e4f7cfb1c2708,2020-08-26T00:00:00.000Z,"NEFT DR-IDFB0021001-CLIKCONIK DIGITAL ME DIA PRIVATE LIMITED-NETBANK, MUM-N239201 224038179-MARCH",,,net_banking_transfer,-24531
61b6f98dd8beac1599eb0011,50200023535069,447580.42,60ec41ba55c00300382672d9,HDFC,agency/vendor expense,5eecc6d6449e4f7cfb1c2708,2020-08-26T00:00:00.000Z,"NEFT DR-IDFB0021001-CLIKCONIK DIGITAL ME DIA PRIVATE LIMITED-NETBANK, MUM-N239201 224042097-APRIL",,,net_banking_transfer,-5525
61b6f98ed8beac1599eb0019,50200023535069,439929.42,60ec41ba55c00300382672d9,HDFC,agency/vendor expense,5eecc6d6449e4f7cfb1c2708,2020-08-26T00:00:00.000Z,"NEFT DR-IDFB0021001-CLIKCONIK DIGITAL ME DIA PRIVATE LIMITED-NETBANK, MUM-N239201 224042805-MAY",,,net_banking_transfer,-7651
61b6f98fd8beac1599eb003e,50200023535069,430976.42,60ec41ba55c00300382672d9,HDFC,agency/vendor expense,5eecc6d6449e4f7cfb1c2708,2020-08-26T00:00:00.000Z,"NEFT DR-IDFB0021001-CLIKCONIK DIGITAL ME DIA PRIVATE LIMITED-NETBANK, MUM-N239201 224043112-JUNE",,,net_banking_transfer,-8953
61b6f990d8beac1599eb0042,50200023535069,415976.42,60ec41ba55c00300382672d9,HDFC,direct expenses,5eecc6d6449e4f7cfb1c2708,2020-08-26T00:00:00.000Z,SITA RAM - CHQ PAID - DEVLI ROAD K,,,chq,-15000
61b6f991d8beac1599eb0049,50200023535069,419211.35,60ec41ba55c00300382672d9,HDFC,Revenue-Mktplace,5eecc6d6449e4f7cfb1c2708,2020-08-26T00:00:00.000Z,NEFT CR-DEUT0797BGL-FLIPKART INTERNET PV TLTD-SLICK ORGANICS PVT LTD-082600071GN0 0119,shopping,,net_banking_transfer,3234.93
61b6f992d8beac1599eb004c,50200023535069,434938.82,60ec41ba55c00300382672d9,HDFC,Revenue-COD,5eecc6d6449e4f7cfb1c2708,2020-08-26T00:00:00.000Z,NEFT CR-KKBK0000958-BIGFOOT RETAIL SOLUT IONS PRIVATE LIMITED-SLICK ORGANICS PVT LTD-KKBK202395455481,,,net_banking_transfer,15727.47
61b6f993d8beac1599eb0052,50200023535069,442062.97,60ec41ba55c00300382672d9,HDFC,Revenue-PG-split enabled,5eecc6d6449e4f7cfb1c2708,2020-08-26T00:00:00.000Z,NEFT CR-UTIB0001506-RAZORPAY SOFTWARE PR IVATE LIMITED-SLICK ORGANICS PVT LITD-AX ISCN0055924425,investments,,net_banking_transfer,7124.15
61b6f994d8beac1599eb0056,50200023535069,400575.97,60ec41ba55c00300382672d9,HDFC,agency/vendor expense,5eecc6d6449e4f7cfb1c2708,2020-08-27T00:00:00.000Z,"NEFT DR-KKBK0000298-ADMITAD MEDIA PRIVAT E LIMITED-NETBANK, MUM-N240201224901297- MARCH",loans,lender_transaction,net_banking_transfer,-41487
61b6f995d8beac1599eb005b,50200023535069,423488.43,60ec41ba55c00300382672d9,HDFC,Revenue-PG-split enabled,5eecc6d6449e4f7cfb1c2708,2020-08-27T00:00:00.000Z,NEFT CR-UTIB0001506-RAZORPAY SOFTWARE PR IVATE LIMITED-SLICK ORGANICS PVT LITD-AX ISCN0055952552,investments,,net_banking_transfer,22912.46
61b6f996d8beac1599eb0062,50200023535069,423271.84,60ec41ba55c00300382672d9,HDFC,bank charges,5eecc6d6449e4f7cfb1c2708,2020-08-27T00:00:00.000Z,.DC INTL POS TXN MARKUP+ST 190820 240820,,,international_transaction_arbitrage,-216.59
61b6f997d8beac1599eb0066,50200023535069,422995.81,60ec41ba55c00300382672d9,HDFC,bank charges,5eecc6d6449e4f7cfb1c2708,2020-08-27T00:00:00.000Z,.DC INTL POS TXN MARKUP+ST 200820 240820 -MIR2024012685683,,,international_transaction_arbitrage,-276.03
61b6f997d8beac1599eb006a,50200023535069,438337.9,60ec41ba55c00300382672d9,HDFC,Revenue-PG-split enabled,5eecc6d6449e4f7cfb1c2708,2020-08-27T00:00:00.000Z,NEFT CR-UTIB0001506-RAZORPAY SOFTWARE PR IVATE LIMITED-SLICK ORGANICS PVT LITD-AX ISCN0055997717,investments,,net_banking_transfer,15342.09
61b6f998d8beac1599eb0072,50200023535069,413337.9,60ec41ba55c00300382672d9,HDFC,SAAS/tech expense,5eecc6d6449e4f7cfb1c2708,2020-08-27T00:00:00.000Z,SHDF9159022585/BILLDKAMAZONSELLERSE,shopping,,Other,-25000
61b6f999d8beac1599eb0078,50200023535069,427901.92,60ec41ba55c00300382672d9,HDFC,Revenue-Mktplace,5eecc6d6449e4f7cfb1c2708,2020-08-28T00:00:00.000Z,NEFT CR-DEUT0797BGL-FLIPKART INTERNET P LTD-INT AC FO R INTERMEDIARY-SLICK ORGAN ICS PVT LTD-082800111GN00123,shopping,,net_banking_transfer,14564.02
61b6f99ad8beac1599eb007f,50200023535069,446661.86,60ec41ba55c00300382672d9,HDFC,Revenue-PG-split enabled,5eecc6d6449e4f7cfb1c2708,2020-08-28T00:00:00.000Z,NEFT CR-UTIB0001506-RAZORPAY SOFTWARE PR IVATE LIMITED-SLICK ORGANICS PVT LITD-AX ISCN0056020751,investments,,net_banking_transfer,18759.94
61b6f99bd8beac1599eb0083,50200023535069,390293.86,60ec41ba55c00300382672d9,HDFC,direct expenses,5eecc6d6449e4f7cfb1c2708,2020-08-28T00:00:00.000Z,"NEFT DR-YESB0000551-VISTTA COSMETICS-NET BANK, MUM-N241201225870415-56368",,,net_banking_transfer,-56368
61b6f99cd8beac1599eb008a,50200023535069,389986.86,60ec41ba55c00300382672d9,HDFC,direct expenses,5eecc6d6449e4f7cfb1c2708,2020-08-28T00:00:00.000Z,"NEFT DR-SBIN0070155-ASHITHA THOMAS-NETBA NK, MUM-N241201225976648-307",,,net_banking_transfer,-307
61b6f99dd8beac1599eb0092,50200023535069,387027.3,60ec41ba55c00300382672d9,HDFC,SAAS/tech expense,5eecc6d6449e4f7cfb1c2708,2020-08-28T00:00:00.000Z,POS 514834XXXXXX9486 AMAZON SELLER RE,shopping,,debit_card,-2959.56
61b6f99ed8beac1599eb0098,50200023535069,381027.3,60ec41ba55c00300382672d9,HDFC,direct expenses,5eecc6d6449e4f7cfb1c2708,2020-08-28T00:00:00.000Z,POS 514834XXXXXX9486 PAY*PAYU MONEY,,,debit_card,-6000
61b6f99fd8beac1599eb009d,50200023535069,274237.3,60ec41ba55c00300382672d9,HDFC,direct expenses,5eecc6d6449e4f7cfb1c2708,2020-08-28T00:00:00.000Z,"NEFT DR-ORBC0100707-UFLEX LIMITED-NETBAN K, MUM-N241201226200354-106790",loans,lender_transaction,net_banking_transfer,-106790
61b6f9a0d8beac1599eb00a3,50200023535069,281328.87,60ec41ba55c00300382672d9,HDFC,Revenue-Mktplace,5eecc6d6449e4f7cfb1c2708,2020-08-28T00:00:00.000Z,NEFT CR-DEUT0797BGL-FLIPKART INTERNET PV TLTD-SLICK ORGANICS PVT LTD-082800081GN0 0119,shopping,,net_banking_transfer,7091.57
61b6f9a1d8beac1599eb00a7,50200023535069,309645.79,60ec41ba55c00300382672d9,HDFC,Revenue-COD,5eecc6d6449e4f7cfb1c2708,2020-08-28T00:00:00.000Z,NEFT CR-KKBK0000958-BIGFOOT RETAIL SOLUT IONS PRIVATE LIMITED-SLICK ORGANICS PVT LTD-KKBK202415863419,,,net_banking_transfer,28316.92
61b6f9a2d8beac1599eb00b0,50200023535069,323317.82,60ec41ba55c00300382672d9,HDFC,Revenue-PG-split enabled,5eecc6d6449e4f7cfb1c2708,2020-08-28T00:00:00.000Z,NEFT CR-UTIB0001506-RAZORPAY SOFTWARE PR IVATE LIMITED-SLICK ORGANICS PVT LITD-AX ISCN0056064604,investments,,net_banking_transfer,13672.03
61b6f9a3d8beac1599eb00b6,50200023535069,325794.81,60ec41ba55c00300382672d9,HDFC,Revenue-Mktplace,5eecc6d6449e4f7cfb1c2708,2020-08-28T00:00:00.000Z,NEFT CR-DEUT0784BBY-TATA UNISTORE LTD-NO,,,net_banking_transfer,2476.99
61b6f9a4d8beac1599eb00ba,50200023535069,324698.81,60ec41ba55c00300382672d9,HDFC,direct expenses,5eecc6d6449e4f7cfb1c2708,2020-08-29T00:00:00.000Z,POS 514834XXXXXX9486 ZOOM.US,,,debit_card,-1096
61b6f9a5d8beac1599eb00cd,50200023535069,325397.95,60ec41ba55c00300382672d9,HDFC,Transfer in/Revenue-other,5eecc6d6449e4f7cfb1c2708,2020-08-29T00:00:00.000Z,NEFT CR-YESB0000001-ILUMINAR MEDIA-SLICK ORGANICS-N242200426279973,,,net_banking_transfer,699.14
61b6f9a6d8beac1599eb00cf,50200023535069,346502.44,60ec41ba55c00300382672d9,HDFC,Revenue-PG-split enabled,5eecc6d6449e4f7cfb1c2708,2020-08-29T00:00:00.000Z,NEFT CR-UTIB0001506-RAZORPAY SOFTWARE PR IVATE LIMITED-SLICK ORGANICS PVT LITD-AX ISCN0056080374,investments,,net_banking_transfer,21104.49
61b6f9a7d8beac1599eb00da,50200023535069,321502.44,60ec41ba55c00300382672d9,HDFC,SAAS/tech expense,5eecc6d6449e4f7cfb1c2708,2020-08-29T00:00:00.000Z,SHDF9164397100/BILLDKAMAZONSELLERSE,shopping,,Other,-25000
61b6f9a8d8beac1599eb00df,50200023535069,338125.84,60ec41ba55c00300382672d9,HDFC,Revenue-PG-split enabled,5eecc6d6449e4f7cfb1c2708,2020-08-29T00:00:00.000Z,NEFT CR-UTIB0001506-RAZORPAY SOFTWARE PR IVATE LIMITED-SLICK ORGANICS PVT LITD-AX ISCN0056123725,investments,,net_banking_transfer,16623.4
61b6f9a9d8beac1599eb00e3,50200023535069,313125.84,60ec41ba55c00300382672d9,HDFC,SAAS/tech expense,5eecc6d6449e4f7cfb1c2708,2020-08-31T00:00:00.000Z,POS 514834XXXXXX9486 AMAZON,shopping,,debit_card,-25000
61b6f9aad8beac1599eb00e8,50200023535069,372139.15,60ec41ba55c00300382672d9,HDFC,Revenue-PG-split enabled,5eecc6d6449e4f7cfb1c2708,2020-08-31T00:00:00.000Z,NEFT CR-UTIB0001506-RAZORPAY SOFTWARE PR IVATE LIMITED-SLICK ORGANICS PVT LITD-AX ISCN0056159681,investments,,net_banking_transfer,59013.31
61b6f9abd8beac1599eb00f3,50200023535069,374466.31,60ec41ba55c00300382672d9,HDFC,Transfer in/Revenue-other,5eecc6d6449e4f7cfb1c2708,2020-08-31T00:00:00.000Z,NEFT CR-ICIC0SF0002-ICICI BANK NODAL ACC -SLICK ORGANICS-22678495741DC,investments,,net_banking_transfer,2327.16
61b6f9acd8beac1599eb00f8,50200023535069,398135.76,60ec41ba55c00300382672d9,HDFC,Revenue-PG-split enabled,5eecc6d6449e4f7cfb1c2708,2020-08-31T00:00:00.000Z,NEFT CR-UTIB0001506-RAZORPAY SOFTWARE PR,,,net_banking_transfer,23669.45
61b6f9add8beac1599eb0101,50200023535069,422677.1,60ec41ba55c00300382672d9,HDFC,Revenue-PG-split enabled,5eecc6d6449e4f7cfb1c2708,2020-09-01T00:00:00.000Z,NEFT CR-UTIB0001506-RAZORPAY SOFTWARE PR IVATE LIMITED-SLICK ORGANICS PVT LITD-AX ISCN0056227235,investments,,net_banking_transfer,24541.34
61b6f9aed8beac1599eb0106,50200023535069,110980.1,60ec41ba55c00300382672d9,HDFC,direct expenses,5eecc6d6449e4f7cfb1c2708,2020-09-01T00:00:00.000Z,"NEFT DR-ORBC0101001-KRAUTER HEALTHCARE L TD-NETBANK, MUM-N245201230088668-311697",,,net_banking_transfer,-311697
61b6f9afd8beac1599eb010e,50200023535069,8834.1,60ec41ba55c00300382672d9,HDFC,Utilities/bills,5eecc6d6449e4f7cfb1c2708,2020-09-01T00:00:00.000Z,IB BILLPAY DR-HDFCRM-555153XXXXXX8852,bills,,bill_payment,-102146
61b6f9b0d8beac1599eb0112,50200023535069,508834.1,60ec41ba55c00300382672d9,HDFC,Internal Transfers,5eecc6d6449e4f7cfb1c2708,2020-09-01T00:00:00.000Z,IB FUNDS TRANSFER CR-50200035187206 -SL ICK ORGANICS PVT LTD,investments,,Other,500000
61b6f9b1d8beac1599eb0116,50200023535069,149501.1,60ec41ba55c00300382672d9,HDFC,Utilities/bills,5eecc6d6449e4f7cfb1c2708,2020-09-01T00:00:00.000Z,IB BILLPAY DR-HDFCRM-555153XXXXXX2449,bills,,bill_payment,-359333
61b6f9b1d8beac1599eb0123,50200023535069,144501.1,60ec41ba55c00300382672d9,HDFC,Internal Transfers,5eecc6d6449e4f7cfb1c2708,2020-09-01T00:00:00.000Z,IB FUNDS TRANSFER DR-50200050976833 -SL ICK ORGANICS PVT LTD,investments,,net_banking_transfer,-5000
61b6f9b2d8beac1599eb0128,50200023535069,145984.32,60ec41ba55c00300382672d9,HDFC,Revenue-Mktplace,5eecc6d6449e4f7cfb1c2708,2020-09-01T00:00:00.000Z,NEFT CR-DEUT0797BGL-MYNTRA DESIGNS PRIVA TE LIMITED-SLICK ORGANICS PRIVATE LIMITE D-090100119GN00092,shopping,,net_banking_transfer,1483.22
61b6f9b3d8beac1599eb012b,50200023535069,143856.91,60ec41ba55c00300382672d9,HDFC,direct expenses,5eecc6d6449e4f7cfb1c2708,2020-09-01T00:00:00.000Z,POS 514834XXXXXX9486 SEOPTIMER,,,debit_card,-2127.41
61b6f9b4d8beac1599eb0132,50200023535069,118856.91,60ec41ba55c00300382672d9,HDFC,SAAS/tech expense,5eecc6d6449e4f7cfb1c2708,2020-09-01T00:00:00.000Z,SHDF9173938453/BILLDKAMAZONSELLERSE,shopping,,Other,-25000
61b6f9b5d8beac1599eb0135,50200023535069,175051.61,60ec41ba55c00300382672d9,HDFC,Revenue-Mktplace,5eecc6d6449e4f7cfb1c2708,2020-09-01T00:00:00.000Z,IMPS-024511071759-AMAZON SELLER SERVIC-H DFC-XXXXXXXX6004-1H9SORBGRMNERNDCSLICK O RGANICS PVT LTD,shopping,,net_banking_transfer,56194.7
61b6f9b6d8beac1599eb013c,50200023535069,398743.4,60ec41ba55c00300382672d9,HDFC,Revenue-Mktplace,5eecc6d6449e4f7cfb1c2708,2020-09-01T00:00:00.000Z,NEFT CR-DEUT0797BGL-AMAZON PAY IND PVT L TD-INT AC INTM MKTPLACE-SLICK ORGANICS P VT LTD-090100150GN00199,shopping,,net_banking_transfer,223691.79
61b6f9b7d8beac1599eb0143,50200023535069,399085.31,60ec41ba55c00300382672d9,HDFC,Revenue-Mktplace,5eecc6d6449e4f7cfb1c2708,2020-09-01T00:00:00.000Z,NEFT CR-DEUT0797BGL-MYNTRA DESIGNS PRIVA TE LIMITED-SLICK ORGANICS PRIVATE LIMITE D-090100125GN00140,shopping,,net_banking_transfer,341.91
61b6f9b8d8beac1599eb0148,50200023535069,422563.5,60ec41ba55c00300382672d9,HDFC,Revenue-PG-split enabled,5eecc6d6449e4f7cfb1c2708,2020-09-01T00:00:00.000Z,NEFT CR-UTIB0001506-RAZORPAY SOFTWARE PR IVATE LIMITED-SLICK ORGANICS PVT LITD-AX ISCN0056287618,investments,,net_banking_transfer,23478.19
61b6f9b9d8beac1599eb0150,50200023535069,410167.5,60ec41ba55c00300382672d9,HDFC,Utilities/bills,5eecc6d6449e4f7cfb1c2708,2020-09-02T00:00:00.000Z,IB BILLPAY DR-HDFCRM-555153XXXXXX2449,bills,,bill_payment,-12396
61b6f9bad8beac1599eb0156,50200023535069,406658.5,60ec41ba55c00300382672d9,HDFC,Utilities/bills,5eecc6d6449e4f7cfb1c2708,2020-09-02T00:00:00.000Z,IB BILLPAY DR-HDFCRM-555153XXXXXX8852,bills,,bill_payment,-3509
61b6f9bbd8beac1599eb015d,50200023535069,431240.85,60ec41ba55c00300382672d9,HDFC,Revenue-PG-split enabled,5eecc6d6449e4f7cfb1c2708,2020-09-02T00:00:00.000Z,NEFT CR-UTIB0001506-RAZORPAY SOFTWARE PR IVATE LIMITED-SLICK ORGANICS PVT LITD-AX ISCN0056311012,investments,,net_banking_transfer,24582.35
61b6f9bcd8beac1599eb0166,50200023535069,431740.49,60ec41ba55c00300382672d9,HDFC,Revenue-Mktplace,5eecc6d6449e4f7cfb1c2708,2020-09-02T00:00:00.000Z,NEFT CR-DEUT0797BGL-MYNTRA DESIGNS PRIVA TE LIMITED-SLICK ORGANICS PRIVATE LIMITE D-090200169GN00026,shopping,,net_banking_transfer,499.64
61b6f9bdd8beac1599eb016b,50200023535069,431319.49,60ec41ba55c00300382672d9,HDFC,Utilities/bills,5eecc6d6449e4f7cfb1c2708,2020-09-02T00:00:00.000Z,IB BILLPAY DR-HDFCRM-555153XXXXXX2449,bills,,bill_payment,-421
61b6f9bed8beac1599eb019b,50200023535069,381319.49,60ec41ba55c00300382672d9,HDFC,SAAS/tech expense,5eecc6d6449e4f7cfb1c2708,2020-09-02T00:00:00.000Z,SHDF9178062642/BILLDKAMAZONSELLERSE,shopping,,Other,-50000
61b6f9bfd8beac1599eb01a1,50200023535069,381197.27,60ec41ba55c00300382672d9,HDFC,bank charges,5eecc6d6449e4f7cfb1c2708,2020-09-02T00:00:00.000Z,.DC INTL POS TXN MARKUP+ST 280820 290820 -MIR2024520533919,,,international_transaction_arbitrage,-122.22
61b6f9c0d8beac1599eb01b4,50200023535069,372058.14,60ec41ba55c00300382672d9,HDFC,direct expenses,5eecc6d6449e4f7cfb1c2708,2020-09-02T00:00:00.000Z,POS 514834XXXXXX9486 STK*SHUTTERSTOCK,,,debit_card,-9139.13
61b6f9c1d8beac1599eb01c1,50200023535069,373234.54,60ec41ba55c00300382672d9,HDFC,Revenue-Mktplace,5eecc6d6449e4f7cfb1c2708,2020-09-02T00:00:00.000Z,NEFT CR-DEUT0797BGL-FLIPKART INTERNET PV TLTD-SLICK ORGANICS PVT LTD-090200086GN0 0179,shopping,,net_banking_transfer,1176.4
61b6f9c2d8beac1599eb01d7,50200023535069,173514.08,60ec41ba55c00300382672d9,HDFC,direct expenses,5eecc6d6449e4f7cfb1c2708,2020-09-02T00:00:00.000Z,02711600008220-TPT-199720.46-VARUN SINGH,,,net_banking_transfer,-199720.46
61b6f9c3d8beac1599eb01df,50200023535069,238488.89,60ec41ba55c00300382672d9,HDFC,Revenue-COD,5eecc6d6449e4f7cfb1c2708,2020-09-02T00:00:00.000Z,NEFT CR-KKBK0000958-BIGFOOT RETAIL SOLUT IONS PRIVATE LIMITED-SLICK ORGANICS PVT LTD-KKBK202466802729,,,net_banking_transfer,64974.81
61b6f9c4d8beac1599eb01e8,50200023535069,250669.14,60ec41ba55c00300382672d9,HDFC,Revenue-PG-split enabled,5eecc6d6449e4f7cfb1c2708,2020-09-02T00:00:00.000Z,NEFT CR-UTIB0001506-RAZORPAY SOFTWARE PR IVATE LIMITED-SLICK ORGANICS PVT LITD-AX ISCN0056365726,investments,,net_banking_transfer,12180.25
61b6f9c5d8beac1599eb01ee,50200023535069,264992.63,60ec41ba55c00300382672d9,HDFC,Revenue-PG-split enabled,5eecc6d6449e4f7cfb1c2708,2020-09-03T00:00:00.000Z,NEFT CR-UTIB0001506-RAZORPAY SOFTWARE PR IVATE LIMITED-SLICK ORGANICS PVT LITD-AX ISCN0056391072,investments,,net_banking_transfer,14323.49
61b6f9c6d8beac1599eb01f4,50200023535069,135334.63,60ec41ba55c00300382672d9,HDFC,direct expenses,5eecc6d6449e4f7cfb1c2708,2020-09-03T00:00:00.000Z,"NEFT DR-YESB0000551-VISTTA COSMETICS-NET BANK, MUM-N247201232534035-129658",,,net_banking_transfer,-129658
61b6f9c7d8beac1599eb01f9,50200023535069,335334.63,60ec41ba55c00300382672d9,HDFC,Internal Transfers,5eecc6d6449e4f7cfb1c2708,2020-09-03T00:00:00.000Z,IB FUNDS TRANSFER CR-50200035187206 -SL ICK ORGANICS PVT LTD,investments,,Other,200000
61b6f9c8d8beac1599eb01fd,50200023535069,158334.63,60ec41ba55c00300382672d9,HDFC,direct expenses,5eecc6d6449e4f7cfb1c2708,2020-09-03T00:00:00.000Z,NEFT DR-KKBK0000208-SYSCOM PACKAGING COM,,,net_banking_transfer,-177000
61b6f9c9d8beac1599eb0203,50200023535069,166207.45,60ec41ba55c00300382672d9,HDFC,Revenue-PG-non-split,5eecc6d6449e4f7cfb1c2708,2020-09-03T00:00:00.000Z,NEFT CR-CITI0000002-ONE97 COMMUNICATIONS LIMITED-SLICK ORGANICS PVT LTD-CITIN201 25184849,investments,,net_banking_transfer,7872.82
61b6f9c9d8beac1599eb0206,50200023535069,181652.32,60ec41ba55c00300382672d9,HDFC,Revenue-PG-split enabled,5eecc6d6449e4f7cfb1c2708,2020-09-03T00:00:00.000Z,NEFT CR-UTIB0001506-RAZORPAY SOFTWARE PR IVATE LIMITED-SLICK ORGANICS PVT LITD-AX ISCN0056441813,investments,,net_banking_transfer,15444.87
61b6f9cad8beac1599eb020f,50200023535069,199341.69,60ec41ba55c00300382672d9,HDFC,Revenue-PG-split enabled,5eecc6d6449e4f7cfb1c2708,2020-09-04T00:00:00.000Z,NEFT CR-UTIB0001506-RAZORPAY SOFTWARE PR IVATE LIMITED-SLICK ORGANICS PVT LITD-AX ISCN0056473501,investments,,net_banking_transfer,17689.37
61b6f9cbd8beac1599eb0215,50200023535069,203701.44,60ec41ba55c00300382672d9,HDFC,Revenue-Mktplace,5eecc6d6449e4f7cfb1c2708,2020-09-04T00:00:00.000Z,NEFT CR-DEUT0797BGL-FLIPKART INTERNET P LTD-INT AC FO R INTERMEDIARY-SLICK ORGAN ICS PVT LTD-090400122GN00142,shopping,,net_banking_transfer,4359.75
61b6f9ccd8beac1599eb021d,50200023535069,204599.94,60ec41ba55c00300382672d9,HDFC,Transfer in/Revenue-other,5eecc6d6449e4f7cfb1c2708,2020-09-04T00:00:00.000Z,NEFT CR-ICIC0SF0002-ICICI BANK NODAL ACC -SLICK ORGANICS-22700703641DC,investments,,net_banking_transfer,898.5
61b6f9cdd8beac1599eb0221,50200023535069,191361.94,60ec41ba55c00300382672d9,HDFC,direct expenses,5eecc6d6449e4f7cfb1c2708,2020-09-04T00:00:00.000Z,"NEFT DR-BOFA0MM6205-FEDEX EXPRESS TRANSP ORTATION SUPPLY CHAI-NETBANK, MUM-N24820 1233905583-13238",loans,lender_transaction,net_banking_transfer,-13238
61b6f9ced8beac1599eb0225,50200023535069,193009.58,60ec41ba55c00300382672d9,HDFC,Revenue-Mktplace,5eecc6d6449e4f7cfb1c2708,2020-09-04T00:00:00.000Z,NEFT CR-DEUT0797BGL-MYNTRA DESIGNS PRIVA TE LIMITED-SLICK ORGANICS PRIVATE LIMITE D-090400223GN00124,shopping,,net_banking_transfer,1647.64
61b6f9cfd8beac1599eb022b,50200023535069,206081.91,60ec41ba55c00300382672d9,HDFC,Revenue-PG-non-split,5eecc6d6449e4f7cfb1c2708,2020-09-04T00:00:00.000Z,NEFT CR-CITI0000002-ONE97 COMMUNICATIONS LIMITED-SLICK ORGANICS PVT LTD-CITIN201 25885714,investments,,net_banking_transfer,13072.33
61b6f9d0d8beac1599eb0230,50200023535069,204189.91,60ec41ba55c00300382672d9,HDFC,Utilities/bills,5eecc6d6449e4f7cfb1c2708,2020-09-04T00:00:00.000Z,IB BILLPAY DR-HDFCRM-555153XXXXXX2449,bills,,bill_payment,-1892
61b6f9d1d8beac1599eb0234,50200023535069,203653.91,60ec41ba55c00300382672d9,HDFC,Utilities/bills,5eecc6d6449e4f7cfb1c2708,2020-09-04T00:00:00.000Z,IB BILLPAY DR-HDFCRM-555153XXXXXX8852,bills,,bill_payment,-536
61b6f9d2d8beac1599eb0239,50200023535069,207675.74,60ec41ba55c00300382672d9,HDFC,Revenue-Mktplace,5eecc6d6449e4f7cfb1c2708,2020-09-04T00:00:00.000Z,NEFT CR-DEUT0797BGL-FLIPKART INTERNET PV TLTD-SLICK ORGANICS PVT LTD-090400087GN0 0002,shopping,,net_banking_transfer,4021.83
61b6f9d3d8beac1599eb023e,50200023535069,209541.42,60ec41ba55c00300382672d9,HDFC,Revenue-Mktplace,5eecc6d6449e4f7cfb1c2708,2020-09-04T00:00:00.000Z,NEFT CR-DEUT0784BBY-TATA UNISTORE LTD-NO DAL-SLICK ORGANICS PVT LTD-090401106GN00 308,investments,,net_banking_transfer,1865.68
61b6f9d4d8beac1599eb0245,50200023535069,255123.19,60ec41ba55c00300382672d9,HDFC,Revenue-COD,5eecc6d6449e4f7cfb1c2708,2020-09-04T00:00:00.000Z,NEFT CR-KKBK0000958-BIGFOOT RETAIL SOLUT,,,net_banking_transfer,45581.77
61b6f9d5d8beac1599eb024a,50200023535069,278427.49,60ec41ba55c00300382672d9,HDFC,Revenue-PG-split enabled,5eecc6d6449e4f7cfb1c2708,2020-09-04T00:00:00.000Z,NEFT CR-UTIB0001506-RAZORPAY SOFTWARE PR IVATE LIMITED-SLICK ORGANICS PVT LITD-AX ISCN0056517986,investments,,net_banking_transfer,23304.3
61b6f9d6d8beac1599eb025d,50200023535069,289247.06,60ec41ba55c00300382672d9,HDFC,Revenue-PG-split enabled,5eecc6d6449e4f7cfb1c2708,2020-09-05T00:00:00.000Z,NEFT CR-UTIB0001506-RAZORPAY SOFTWARE PR IVATE LIMITED-SLICK ORGANICS PVT LITD-AX ISCN0056530572,investments,,net_banking_transfer,10819.57
61b6f9d7d8beac1599eb0266,50200023535069,264247.06,60ec41ba55c00300382672d9,HDFC,SAAS/tech expense,5eecc6d6449e4f7cfb1c2708,2020-09-05T00:00:00.000Z,SHDF9190012881/BILLDKAMAZONSELLERSE,shopping,,Other,-25000
61b6f9d8d8beac1599eb027c,50200023535069,271514.39,60ec41ba55c00300382672d9,HDFC,Revenue-PG-non-split,5eecc6d6449e4f7cfb1c2708,2020-09-05T00:00:00.000Z,NEFT CR-CITI0000002-ONE97 COMMUNICATIONS LIMITED-SLICK ORGANICS PVT LTD-CITIN201 26793233,investments,,net_banking_transfer,7267.33
61b6f9d9d8beac1599eb0285,50200023535069,247709.61,60ec41ba55c00300382672d9,HDFC,Marketing Expense,5eecc6d6449e4f7cfb1c2708,2020-09-05T00:00:00.000Z,POS 514834XXXXXX9486 GOOGLE ADWORDS,,,debit_card,-23804.78
61b6f9dad8beac1599eb028a,50200023535069,262173.73,60ec41ba55c00300382672d9,HDFC,Revenue-PG-split enabled,5eecc6d6449e4f7cfb1c2708,2020-09-05T00:00:00.000Z,NEFT CR-UTIB0001506-RAZORPAY SOFTWARE PR IVATE LIMITED-SLICK ORGANICS PVT LITD-AX ISCN0056560073,investments,,net_banking_transfer,14464.12
61b6f9dbd8beac1599eb0297,50200023535069,257173.73,60ec41ba55c00300382672d9,HDFC,Marketing Expense,5eecc6d6449e4f7cfb1c2708,2020-09-05T00:00:00.000Z,POS 514834XXXXXX9486 GOOGLE ADWORDS,,,debit_card,-5000
61b6f9dcd8beac1599eb029b,50200023535069,252454.91,60ec41ba55c00300382672d9,HDFC,direct expenses,5eecc6d6449e4f7cfb1c2708,2020-09-06T00:00:00.000Z,POS 514834XXXXXX4081 ONLINE PAYMENT,,,debit_card,-4718.82
61b6f9ddd8beac1599eb029f,50200023535069,227454.91,60ec41ba55c00300382672d9,HDFC,SAAS/tech expense,5eecc6d6449e4f7cfb1c2708,2020-09-06T00:00:00.000Z,POS 514834XXXXXX9486 AMAZON,shopping,,debit_card,-25000
61b6f9ded8beac1599eb02a3,50200023535069,190454.91,60ec41ba55c00300382672d9,HDFC,direct expenses,5eecc6d6449e4f7cfb1c2708,2020-09-07T00:00:00.000Z,"NEFT DR-CITI0000002-DHIRAJ-NETBANK, MUM- N251201236052554-37000",,,net_banking_transfer,-37000
61b6f9dfd8beac1599eb02ac,50200023535069,155454.91,60ec41ba55c00300382672d9,HDFC,direct expenses,5eecc6d6449e4f7cfb1c2708,2020-09-07T00:00:00.000Z,"NEFT DR-ICIC0000542-AVANTIKA SUKHIA-NETB ANK, MUM-N251201236047970-35000",,,net_banking_transfer,-35000
61b6f9e0d8beac1599eb02af,50200023535069,147954.91,60ec41ba55c00300382672d9,HDFC,direct expenses,5eecc6d6449e4f7cfb1c2708,2020-09-07T00:00:00.000Z,"NEFT DR-SIBL0000555-JAIVEER KUMAR-NETBAN K, MUM-N251201236043049-7500",,,net_banking_transfer,-7500
61b6f9e1d8beac1599eb02b9,50200023535069,142954.91,60ec41ba55c00300382672d9,HDFC,direct expenses,5eecc6d6449e4f7cfb1c2708,2020-09-07T00:00:00.000Z,"NEFT DR-PUNB0398000-MEENA SINGH-NETBANK, MUM-N251201236057180-5000",,,net_banking_transfer,-5000
61b6f9e1d8beac1599eb02bc,50200023535069,132954.91,60ec41ba55c00300382672d9,HDFC,direct expenses,5eecc6d6449e4f7cfb1c2708,2020-09-07T00:00:00.000Z,"NEFT DR-SBIN0001189-SANDEEP SINGH-NETBAN K, MUM-N251201236043142-10000",,,net_banking_transfer,-10000
61b6f9e2d8beac1599eb02c0,50200023535069,115454.91,60ec41ba55c00300382672d9,HDFC,direct expenses,5eecc6d6449e4f7cfb1c2708,2020-09-07T00:00:00.000Z,"NEFT DR-ICIC0003374-SIDDHARTH KANOJIA-NE TBANK, MUM-N251201236048108-17500",,,net_banking_transfer,-17500
61b6f9e3d8beac1599eb02c8,50200023535069,112454.91,60ec41ba55c00300382672d9,HDFC,direct expenses,5eecc6d6449e4f7cfb1c2708,2020-09-07T00:00:00.000Z,"NEFT DR-ALLA0210591-CHAMPA DEVI-NETBANK,",,,net_banking_transfer,-3000
61b6f9e4d8beac1599eb02d9,50200023535069,98329.91,60ec41ba55c00300382672d9,HDFC,direct expenses,5eecc6d6449e4f7cfb1c2708,2020-09-07T00:00:00.000Z,"NEFT DR-SYNB0005170-SNEHAL TAYDE-NETBANK , MUM-N251201236043357-14125",,,net_banking_transfer,-14125
61b6f9e5d8beac1599eb02ea,50200023535069,77479.91,60ec41ba55c00300382672d9,HDFC,direct expenses,5eecc6d6449e4f7cfb1c2708,2020-09-07T00:00:00.000Z,"NEFT DR-UTIB0000120-ADNAN ALI-NETBANK, M UM-N251201236057499-20850",,,net_banking_transfer,-20850
61b6f9e6d8beac1599eb02f6,50200023535069,30979.91,60ec41ba55c00300382672d9,HDFC,direct expenses,5eecc6d6449e4f7cfb1c2708,2020-09-07T00:00:00.000Z,"NEFT DR-BKDN0450123-ARTISTO DESIGNZ-NETB ANK, MUM-N251201236057544-46500",,,net_banking_transfer,-46500
61b6f9e7d8beac1599eb0303,50200023535069,14979.91,60ec41ba55c00300382672d9,HDFC,direct expenses,5eecc6d6449e4f7cfb1c2708,2020-09-07T00:00:00.000Z,00901610080520-TPT-16000-POOJA KAPIL SHR OTRIYA,,,net_banking_transfer,-16000
61b6f9e8d8beac1599eb0312,50200023535069,15173.78,60ec41ba55c00300382672d9,HDFC,Revenue-Mktplace,5eecc6d6449e4f7cfb1c2708,2020-09-07T00:00:00.000Z,NEFT CR-DEUT0797BGL-FLIPKART INTERNET P LTD-INT AC FO R INTERMEDIARY-SLICK ORGAN ICS PVT LTD-090700167GN00112,shopping,,net_banking_transfer,193.87
61b6f9e9d8beac1599eb031b,50200023535069,88037.65,60ec41ba55c00300382672d9,HDFC,Revenue-PG-split enabled,5eecc6d6449e4f7cfb1c2708,2020-09-07T00:00:00.000Z,NEFT CR-UTIB0001506-RAZORPAY SOFTWARE PR IVATE LIMITED-SLICK ORGANICS PVT LITD-AX ISCN0056582634,investments,,net_banking_transfer,72863.87
61b6f9ead8beac1599eb0322,50200023535069,89409.32,60ec41ba55c00300382672d9,HDFC,Revenue-Mktplace,5eecc6d6449e4f7cfb1c2708,2020-09-07T00:00:00.000Z,NEFT CR-DEUT0797BGL-MYNTRA DESIGNS PRIVA TE LIMITED-SLICK ORGANICS PRIVATE LIMITE D-090700246GN00083,shopping,,net_banking_transfer,1371.67
61b6f9ebd8beac1599eb0333,50200023535069,69409.32,60ec41ba55c00300382672d9,HDFC,direct expenses,5eecc6d6449e4f7cfb1c2708,2020-09-07T00:00:00.000Z,"SELF - CHQ PAID - KALKAJI, NEW",,,chq,-20000
61b6f9ecd8beac1599eb0338,50200023535069,84097.32,60ec41ba55c00300382672d9,HDFC,Investment/FD redeem,5eecc6d6449e4f7cfb1c2708,2020-09-07T00:00:00.000Z,FD REDEEM INTEREST -50300312484281/2,,,Other,14688
61b6f9edd8beac1599eb0350,50200023535069,620767.32,60ec41ba55c00300382672d9,HDFC,Investment/FD redeem,5eecc6d6449e4f7cfb1c2708,2020-09-07T00:00:00.000Z,FD REDEEM PRINCIPAL -50300312484281/2,,,Other,536670
61b6f9eed8beac1599eb0361,50200023535069,575267.32,60ec41ba55c00300382672d9,HDFC,direct expenses,5eecc6d6449e4f7cfb1c2708,2020-09-07T00:00:00.000Z,50100301160692-TPT-45500-TARUN GARG,,,net_banking_transfer,-45500
61b6f9efd8beac1599eb037a,50200023535069,525267.32,60ec41ba55c00300382672d9,HDFC,direct expenses,5eecc6d6449e4f7cfb1c2708,2020-09-07T00:00:00.000Z,02771610131904-TPT-50000-DIGANT BHATT,,,net_banking_transfer,-50000
61b6f9f0d8beac1599eb0386,50200023535069,525222.06,60ec41ba55c00300382672d9,HDFC,bank charges,5eecc6d6449e4f7cfb1c2708,2020-09-07T00:00:00.000Z,.DC INTL POS TXN MARKUP+ST 280820 310820 -MIR2024927672274,,,international_transaction_arbitrage,-45.26
61b6f9f1d8beac1599eb038d,50200023535069,536771.95,60ec41ba55c00300382672d9,HDFC,Revenue-PG-non-split,5eecc6d6449e4f7cfb1c2708,2020-09-07T00:00:00.000Z,NEFT CR-CITI0000002-ONE97 COMMUNICATIONS LIMITED-SLICK ORGANICS PVT LTD-CITIN201 27518327,investments,,net_banking_transfer,11549.89
61b6f9f2d8beac1599eb0394,50200023535069,537030,60ec41ba55c00300382672d9,HDFC,Revenue-Mktplace,5eecc6d6449e4f7cfb1c2708,2020-09-07T00:00:00.000Z,NEFT CR-DEUT0797BGL-MYNTRA DESIGNS PRIVA TE LIMITED-SLICK ORGANICS PRIVATE LIMITE D-090700268GN00116,shopping,,net_banking_transfer,258.05
61b6f9f3d8beac1599eb039c,50200023535069,537300.84,60ec41ba55c00300382672d9,HDFC,Revenue-Mktplace,5eecc6d6449e4f7cfb1c2708,2020-09-07T00:00:00.000Z,NEFT CR-DEUT0797BGL-FLIPKART INTERNET PV,shopping,,net_banking_transfer,270.84
61b6f9f4d8beac1599eb03a9,50200023535069,548458.4,60ec41ba55c00300382672d9,HDFC,Revenue-PG-split enabled,5eecc6d6449e4f7cfb1c2708,2020-09-07T00:00:00.000Z,NEFT CR-UTIB0001506-RAZORPAY SOFTWARE PR IVATE LIMITED-SLICK ORGANICS PVT LITD-AX ISCN0056636074,investments,,net_banking_transfer,11157.56
61b6f9f5d8beac1599eb03b3,50200023535069,561887.4,60ec41ba55c00300382672d9,HDFC,Revenue-Mktplace,5eecc6d6449e4f7cfb1c2708,2020-09-07T00:00:00.000Z,NEFT CR-SCBL0036001-M/S DREAMPLUG TECHNO -ARATAARATA-SIN31436Q0005183,,,net_banking_transfer,13429
61b6f9f6d8beac1599eb03ba,50200023535069,553637.4,60ec41ba55c00300382672d9,HDFC,direct expenses,5eecc6d6449e4f7cfb1c2708,2020-09-07T00:00:00.000Z,IMPS-025118358470-NASIR KHAN-KKBK-XXXXXX 0380-ABC,,,net_banking_transfer,-8250
61b6f9f7d8beac1599eb03c3,50200023535069,528637.4,60ec41ba55c00300382672d9,HDFC,SAAS/tech expense,5eecc6d6449e4f7cfb1c2708,2020-09-08T00:00:00.000Z,SHDF9198955441/BILLDKAMAZONSELLERSE,shopping,,Other,-25000
61b6f9f8d8beac1599eb03c9,50200023535069,542481.01,60ec41ba55c00300382672d9,HDFC,Revenue-PG-split enabled,5eecc6d6449e4f7cfb1c2708,2020-09-08T00:00:00.000Z,NEFT CR-UTIB0001506-RAZORPAY SOFTWARE PR IVATE LIMITED-SLICK ORGANICS PVT LITD-AX ISCN0056659477,investments,,net_banking_transfer,13843.61
61b6f9f9d8beac1599eb03d2,50200023535069,550936.28,60ec41ba55c00300382672d9,HDFC,Revenue-Mktplace,5eecc6d6449e4f7cfb1c2708,2020-09-08T00:00:00.000Z,NEFT CR-KKBK0000958-SUPERMARKET GROCERY SUPPLIES PVT LTD-SLICK ORGANICS PVT LTD- KKBK202527789576,shopping,,net_banking_transfer,8455.27
61b6f9fad8beac1599eb03d9,50200023535069,556262.38,60ec41ba55c00300382672d9,HDFC,Revenue-Mktplace,5eecc6d6449e4f7cfb1c2708,2020-09-08T00:00:00.000Z,NEFT CR-KKBK0000958-SUPERMARKET GROCERY SUPPLIES PVT LTD-SLICK ORGANICS PVT LTD- KKBK202527790244,shopping,,net_banking_transfer,5326.1
61b6f9fbd8beac1599eb03df,50200023535069,560551.08,60ec41ba55c00300382672d9,HDFC,Revenue-Mktplace,5eecc6d6449e4f7cfb1c2708,2020-09-08T00:00:00.000Z,NEFT CR-KKBK0000958-SUPERMARKET GROCERY SUPPLIES PVT LTD-SLICK ORGANICS PVT LTD- KKBK202527791134,shopping,,net_banking_transfer,4288.7
61b6f9fbd8beac1599eb03e3,50200023535069,562855.98,60ec41ba55c00300382672d9,HDFC,Revenue-Mktplace,5eecc6d6449e4f7cfb1c2708,2020-09-08T00:00:00.000Z,NEFT CR-KKBK0000958-SUPERMARKET GROCERY SUPPLIES PVT LTD-SLICK ORGANICS PVT LTD- KKBK202527791241,shopping,,net_banking_transfer,2304.9
61b6f9fcd8beac1599eb03ea,50200023535069,568586.98,60ec41ba55c00300382672d9,HDFC,Revenue-Mktplace,5eecc6d6449e4f7cfb1c2708,2020-09-08T00:00:00.000Z,NEFT CR-KKBK0000958-SUPERMARKET GROCERY SUPPLIES PVT LTD-SLICK ORGANICS PVT LTD- KKBK202527791196,shopping,,net_banking_transfer,5731
61b6f9fdd8beac1599eb03ef,50200023535069,575936.56,60ec41ba55c00300382672d9,HDFC,Revenue-Mktplace,5eecc6d6449e4f7cfb1c2708,2020-09-08T00:00:00.000Z,NEFT CR-KKBK0000958-SUPERMARKET GROCERY SUPPLIES PVT LTD-SLICK ORGANICS PVT LTD- KKBK202527791332,shopping,,net_banking_transfer,7349.58
61b6f9fed8beac1599eb03f3,50200023535069,579524.56,60ec41ba55c00300382672d9,HDFC,Revenue-Mktplace,5eecc6d6449e4f7cfb1c2708,2020-09-08T00:00:00.000Z,NEFT CR-KKBK0000958-SUPERMARKET GROCERY,shopping,,net_banking_transfer,3588
61b6f9ffd8beac1599eb03fb,50200023535069,580661.41,60ec41ba55c00300382672d9,HDFC,Revenue-Mktplace,5eecc6d6449e4f7cfb1c2708,2020-09-08T00:00:00.000Z,NEFT CR-KKBK0000958-SUPERMARKET GROCERY SUPPLIES PVT LTD-SLICK ORGANICS PVT LTD- KKBK202527791503,shopping,,net_banking_transfer,1136.85
61b6fa00d8beac1599eb03fe,50200023535069,555661.41,60ec41ba55c00300382672d9,HDFC,SAAS/tech expense,5eecc6d6449e4f7cfb1c2708,2020-09-08T00:00:00.000Z,SHDF9199704159/BILLDKAMAZONSELLERSE,shopping,,Other,-25000
61b6fa01d8beac1599eb040a,50200023535069,778248.85,60ec41ba55c00300382672d9,HDFC,Revenue-Mktplace,5eecc6d6449e4f7cfb1c2708,2020-09-08T00:00:00.000Z,NEFT CR-DEUT0797BGL-AMAZON PAY IND PVT L TD-INT AC INTM MKTPLACE-SLICK ORGANICS P VT LTD-090800134GN00516,shopping,,net_banking_transfer,222587.44
61b6fa02d8beac1599eb0410,50200023535069,468337.85,60ec41ba55c00300382672d9,HDFC,direct expenses,5eecc6d6449e4f7cfb1c2708,2020-09-08T00:00:00.000Z,05892560000649-TPT-309911-DECORPAC INDIA PRIVATE LIMITED,,,net_banking_transfer,-309911
61b6fa03d8beac1599eb041a,50200023535069,480247.96,60ec41ba55c00300382672d9,HDFC,Revenue-PG-non-split,5eecc6d6449e4f7cfb1c2708,2020-09-08T00:00:00.000Z,NEFT CR-CITI0000002-ONE97 COMMUNICATIONS LIMITED-SLICK ORGANICS PVT LTD-CITIN201 28175713,investments,,net_banking_transfer,11910.11
61b6fa04d8beac1599eb0423,50200023535069,465247.96,60ec41ba55c00300382672d9,HDFC,direct expenses,5eecc6d6449e4f7cfb1c2708,2020-09-08T00:00:00.000Z,IMPS-025214167114-PAYTM-PYTM-XXXXXXXX383 9-15000,ewallet,,net_banking_transfer,-15000
61b6fa05d8beac1599eb0429,50200023535069,475344.1,60ec41ba55c00300382672d9,HDFC,Revenue-PG-split enabled,5eecc6d6449e4f7cfb1c2708,2020-09-08T00:00:00.000Z,NEFT CR-UTIB0001506-RAZORPAY SOFTWARE PR IVATE LIMITED-SLICK ORGANICS PVT LITD-AX ISCN0056729414,investments,,net_banking_transfer,10096.14
61b6fa06d8beac1599eb0438,50200023535069,470344.1,60ec41ba55c00300382672d9,HDFC,direct expenses,5eecc6d6449e4f7cfb1c2708,2020-09-09T00:00:00.000Z,"NEFT DR-PYTM0123456-PAYTM-NETBANK, MUM-N 253201238814088-5000",ewallet,,net_banking_transfer,-5000
61b6fa07d8beac1599eb0442,50200023535069,470608.12,60ec41ba55c00300382672d9,HDFC,Revenue-Mktplace,5eecc6d6449e4f7cfb1c2708,2020-09-09T00:00:00.000Z,NEFT CR-DEUT0797BGL-FLIPKART INTERNET P LTD-INT AC FO R INTERMEDIARY-SLICK ORGAN ICS PVT LTD-090900110GN00108,shopping,,net_banking_transfer,264.02
61b6fa08d8beac1599eb0446,50200023535069,491116.29,60ec41ba55c00300382672d9,HDFC,Revenue-PG-split enabled,5eecc6d6449e4f7cfb1c2708,2020-09-09T00:00:00.000Z,NEFT CR-UTIB0001506-RAZORPAY SOFTWARE PR IVATE LIMITED-SLICK ORGANICS PVT LITD-AX ISCN0056751394,investments,,net_banking_transfer,20508.17
61b6fa09d8beac1599eb044e,50200023535069,466116.29,60ec41ba55c00300382672d9,HDFC,SAAS/tech expense,5eecc6d6449e4f7cfb1c2708,2020-09-09T00:00:00.000Z,SHDF9203279622/BILLDKAMAZONSELLERSE,shopping,,Other,-25000
61b6fa0ad8beac1599eb0455,50200023535069,467469.78,60ec41ba55c00300382672d9,HDFC,Revenue-Mktplace,5eecc6d6449e4f7cfb1c2708,2020-09-09T00:00:00.000Z,NEFT CR-DEUT0797BGL-MYNTRA DESIGNS PRIVA TE LIMITED-SLICK ORGANICS PRIVATE LIMITE D-090900166GN00253,shopping,,net_banking_transfer,1353.49
61b6fa0bd8beac1599eb045b,50200023535069,478966.92,60ec41ba55c00300382672d9,HDFC,Revenue-PG-non-split,5eecc6d6449e4f7cfb1c2708,2020-09-09T00:00:00.000Z,NEFT CR-CITI0000002-ONE97 COMMUNICATIONS,ewallet,,net_banking_transfer,11497.14
61b6fa0cd8beac1599eb0461,50200023535069,478879.06,60ec41ba55c00300382672d9,HDFC,bank charges,5eecc6d6449e4f7cfb1c2708,2020-09-09T00:00:00.000Z,.DC INTL POS TXN MARKUP+ST 010920 020920 -CDT2025201211390,,,international_transaction_arbitrage,-87.86
61b6fa0dd8beac1599eb0466,50200023535069,363879.06,60ec41ba55c00300382672d9,HDFC,direct expenses,5eecc6d6449e4f7cfb1c2708,2020-09-09T00:00:00.000Z,"NEFT DR-YESB0000551-VISTTA COSMETICS-NET BANK, MUM-N253201239731092-115000",,,net_banking_transfer,-115000
61b6fa0ed8beac1599eb0479,50200023535069,444049.97,60ec41ba55c00300382672d9,HDFC,Revenue-COD,5eecc6d6449e4f7cfb1c2708,2020-09-09T00:00:00.000Z,NEFT CR-KKBK0000958-BIGFOOT RETAIL SOLUT IONS PRIVATE LIMITED-SLICK ORGANICS PVT LTD-KKBK202538142960,,,net_banking_transfer,80170.91
61b6fa0fd8beac1599eb047e,50200023535069,473804.28,60ec41ba55c00300382672d9,HDFC,Revenue-PG-split enabled,5eecc6d6449e4f7cfb1c2708,2020-09-09T00:00:00.000Z,NEFT CR-UTIB0001506-RAZORPAY SOFTWARE PR IVATE LIMITED-SLICK ORGANICS PVT LITD-AX ISCN0056796397,investments,,net_banking_transfer,29754.31
61b6fa10d8beac1599eb0491,50200023535069,446054.28,60ec41ba55c00300382672d9,HDFC,direct expenses,5eecc6d6449e4f7cfb1c2708,2020-09-09T00:00:00.000Z,"NEFT DR-UBIN0531855-MOHANISH KOTHARI-NET BANK, MUM-N253201240083585-27750",,,net_banking_transfer,-27750
61b6fa11d8beac1599eb049a,50200023535069,452511.62,60ec41ba55c00300382672d9,HDFC,Revenue-PG-non-split,5eecc6d6449e4f7cfb1c2708,2020-09-10T00:00:00.000Z,UPI-PAYTM-PAYOUTS@PAYTM-PYTM0123456-0254 87446091-ALL202009102168200,ewallet,,upi,6457.34
61b6fa12d8beac1599eb049e,50200023535069,471024.41,60ec41ba55c00300382672d9,HDFC,Revenue-PG-split enabled,5eecc6d6449e4f7cfb1c2708,2020-09-10T00:00:00.000Z,NEFT CR-UTIB0001506-RAZORPAY SOFTWARE PR IVATE LIMITED-SLICK ORGANICS PVT LITD-AX ISCN0056824464,investments,,net_banking_transfer,18512.79
61b6fa13d8beac1599eb04a7,50200023535069,496024.41,60ec41ba55c00300382672d9,HDFC,Transfer in/Revenue-other,5eecc6d6449e4f7cfb1c2708,2020-09-10T00:00:00.000Z,REF-BILLDKAMAZO-SHDF9198955441-8/9/20,,,refund,25000
61b6fa14d8beac1599eb04b4,50200023535069,508864.43,60ec41ba55c00300382672d9,HDFC,Revenue-PG-split enabled,5eecc6d6449e4f7cfb1c2708,2020-09-10T00:00:00.000Z,NEFT CR-UTIB0001506-RAZORPAY SOFTWARE PR IVATE LIMITED-SLICK ORGANICS PVT LITD-AX ISCN0056872734,investments,,net_banking_transfer,12840.02
61b6fa14d8beac1599eb04b8,50200023535069,526918.44,60ec41ba55c00300382672d9,HDFC,Revenue-PG-non-split,5eecc6d6449e4f7cfb1c2708,2020-09-11T00:00:00.000Z,UPI-PAYTM-PAYOUTS@PAYTM-PYTM0123456-0255 02653422-ALL202009112168200,ewallet,,upi,18054.01
61b6fa15d8beac1599eb04c1,50200023535069,302918.44,60ec41ba55c00300382672d9,HDFC,direct expenses,5eecc6d6449e4f7cfb1c2708,2020-09-11T00:00:00.000Z,05892560000649-TPT-224000-DECORPAC INDIA PRIVATE LIMITED,,,net_banking_transfer,-224000
61b6fa16d8beac1599eb04c9,50200023535069,314192.66,60ec41ba55c00300382672d9,HDFC,Revenue-PG-split enabled,5eecc6d6449e4f7cfb1c2708,2020-09-11T00:00:00.000Z,NEFT CR-UTIB0001506-RAZORPAY SOFTWARE PR IVATE LIMITED-SLICK ORGANICS PVT LITD-AX ISCN0056897473,investments,,net_banking_transfer,11274.22
61b6fa17d8beac1599eb04cc,50200023535069,315473.14,60ec41ba55c00300382672d9,HDFC,Revenue-Mktplace,5eecc6d6449e4f7cfb1c2708,2020-09-11T00:00:00.000Z,NEFT CR-DEUT0797BGL-FLIPKART INTERNET P,shopping,,net_banking_transfer,1280.48
61b6fa18d8beac1599eb04d0,50200023535069,290473.14,60ec41ba55c00300382672d9,HDFC,SAAS/tech expense,5eecc6d6449e4f7cfb1c2708,2020-09-11T00:00:00.000Z,SHDF9210802673/BILLDKAMAZONSELLERSE,shopping,,Other,-25000
61b6fa19d8beac1599eb04d5,50200023535069,290095.69,60ec41ba55c00300382672d9,HDFC,bank charges,5eecc6d6449e4f7cfb1c2708,2020-09-11T00:00:00.000Z,.DC INTL POS TXN MARKUP+ST 020920 030920 -CDT2025201211390,,,international_transaction_arbitrage,-377.45
61b6fa1ad8beac1599eb04de,50200023535069,290935.17,60ec41ba55c00300382672d9,HDFC,Revenue-Mktplace,5eecc6d6449e4f7cfb1c2708,2020-09-11T00:00:00.000Z,NEFT CR-DEUT0784BBY-TATA UNISTORE LTD-NO DAL-SLICK ORGANICS PVT LTD-091102907GN00 292,investments,,net_banking_transfer,839.48
61b6fa1bd8beac1599eb04e3,50200023535069,291339.38,60ec41ba55c00300382672d9,HDFC,Revenue-Mktplace,5eecc6d6449e4f7cfb1c2708,2020-09-11T00:00:00.000Z,NEFT CR-DEUT0797BGL-MYNTRA DESIGNS PRIVA TE LIMITED-SLICK ORGANICS PRIVATE LIMITE D-091102107GN00125,shopping,,net_banking_transfer,404.21
61b6fa1cd8beac1599eb04e7,50200023535069,292093.67,60ec41ba55c00300382672d9,HDFC,Revenue-Mktplace,5eecc6d6449e4f7cfb1c2708,2020-09-11T00:00:00.000Z,NEFT CR-DEUT0797BGL-FLIPKART INTERNET PV TLTD-SLICK ORGANICS PVT LTD-091102011GN0 0053,shopping,,net_banking_transfer,754.29
61b6fa1dd8beac1599eb04ef,50200023535069,304733.67,60ec41ba55c00300382672d9,HDFC,Transfer in/Revenue-other,5eecc6d6449e4f7cfb1c2708,2020-09-11T00:00:00.000Z,NEFT CR-KKBK0000958-EKANEK NETWORKS PRIV ATE LIMITED-SLICK ORGANICS PVT LTD-KKBK2 02558489491,,,net_banking_transfer,12640
61b6fa1ed8beac1599eb04f1,50200023535069,355637.84,60ec41ba55c00300382672d9,HDFC,Revenue-COD,5eecc6d6449e4f7cfb1c2708,2020-09-11T00:00:00.000Z,NEFT CR-KKBK0000958-BIGFOOT RETAIL SOLUT IONS PRIVATE LIMITED-SLICK ORGANICS PVT LTD-KKBK202558511651,,,net_banking_transfer,50904.17
61b6fa1fd8beac1599eb04f8,50200023535069,365133.85,60ec41ba55c00300382672d9,HDFC,Revenue-Mktplace,5eecc6d6449e4f7cfb1c2708,2020-09-11T00:00:00.000Z,NEFT CR-ICIC0000105-MANASH LIFETYLE PVT LTD-SLICKORGANICSPRIVATELIMITEDMPGGN-ICI B202550049910,,,net_banking_transfer,9496.01
61b6fa20d8beac1599eb04fc,50200023535069,373004.58,60ec41ba55c00300382672d9,HDFC,Revenue-Mktplace,5eecc6d6449e4f7cfb1c2708,2020-09-11T00:00:00.000Z,NEFT CR-ICIC0000105-MANASH LIFETYLE PVT LTD-SLICKORGANICSPRIVATELIMITEDMPMUM-ICI B202550049911,,,net_banking_transfer,7870.73
61b6fa21d8beac1599eb0501,50200023535069,390247.01,60ec41ba55c00300382672d9,HDFC,Revenue-PG-split enabled,5eecc6d6449e4f7cfb1c2708,2020-09-11T00:00:00.000Z,NEFT CR-UTIB0001506-RAZORPAY SOFTWARE PR IVATE LIMITED-SLICK ORGANICS PVT LITD-AX ISCN0056946380,investments,,net_banking_transfer,17242.43
61b6fa22d8beac1599eb0506,50200023535069,400046.77,60ec41ba55c00300382672d9,HDFC,Revenue-PG-non-split,5eecc6d6449e4f7cfb1c2708,2020-09-12T00:00:00.000Z,UPI-PAYTM-PAYOUTS@PAYTM-PYTM0123456-0256 17468913-ALL202009122168200,ewallet,,upi,9799.76
61b6fa23d8beac1599eb050b,50200023535069,420186.07,60ec41ba55c00300382672d9,HDFC,Revenue-PG-non-split,5eecc6d6449e4f7cfb1c2708,2020-09-13T00:00:00.000Z,UPI-PAYTM-PAYOUTS@PAYTM-PYTM0123456-0257,ewallet,,upi,20139.3
61b6fa24d8beac1599eb050f,50200023535069,395186.07,60ec41ba55c00300382672d9,HDFC,SAAS/tech expense,5eecc6d6449e4f7cfb1c2708,2020-09-13T00:00:00.000Z,POS 514834XXXXXX9486 AMAZON,shopping,,debit_card,-25000
61b6fa25d8beac1599eb0518,50200023535069,375186.07,60ec41ba55c00300382672d9,HDFC,direct expenses,5eecc6d6449e4f7cfb1c2708,2020-09-13T00:00:00.000Z,IMPS-025712186361-PAYTM-PYTM-XXXXXXXX383 9-20000,ewallet,,net_banking_transfer,-20000
61b6fa26d8beac1599eb051c,50200023535069,384189.22,60ec41ba55c00300382672d9,HDFC,Revenue-PG-non-split,5eecc6d6449e4f7cfb1c2708,2020-09-14T00:00:00.000Z,UPI-PAYTM-PAYOUTS@PAYTM-PYTM0123456-0258 47480500-ALL202009142168200,ewallet,,upi,9003.15
61b6fa27d8beac1599eb0524,50200023535069,378361.22,60ec41ba55c00300382672d9,HDFC,direct expenses,5eecc6d6449e4f7cfb1c2708,2020-09-14T00:00:00.000Z,"NEFT DR-SBIN0050004-FULCRUM MARKETING PV T LTD-NETBANK, MUM-N258201243585084-5828",,,net_banking_transfer,-5828
61b6fa28d8beac1599eb052c,50200023535069,378457.3,60ec41ba55c00300382672d9,HDFC,Revenue-Mktplace,5eecc6d6449e4f7cfb1c2708,2020-09-14T00:00:00.000Z,NEFT CR-DEUT0797BGL-FLIPKART INTERNET P LTD-INT AC FO R INTERMEDIARY-SLICK ORGAN ICS PVT LTD-091400297GN00074,shopping,,net_banking_transfer,96.08
61b6fa29d8beac1599eb0532,50200023535069,452927.33,60ec41ba55c00300382672d9,HDFC,Revenue-PG-split enabled,5eecc6d6449e4f7cfb1c2708,2020-09-14T00:00:00.000Z,NEFT CR-UTIB0001506-RAZORPAY SOFTWARE PR IVATE LIMITED-SLICK ORGANICS PVT LITD-AX ISCN0056983019,investments,,net_banking_transfer,74470.03
61b6fa2ad8beac1599eb0536,50200023535069,454380.95,60ec41ba55c00300382672d9,HDFC,Revenue-Mktplace,5eecc6d6449e4f7cfb1c2708,2020-09-14T00:00:00.000Z,NEFT CR-DEUT0797BGL-MYNTRA DESIGNS PRIVA TE LIMITED-SLICK ORGANICS PRIVATE LIMITE D-091400329GN00283,shopping,,net_banking_transfer,1453.62
61b6fa2bd8beac1599eb053b,50200023535069,454597.98,60ec41ba55c00300382672d9,HDFC,Transfer in/Revenue-other,5eecc6d6449e4f7cfb1c2708,2020-09-14T00:00:00.000Z,NEFT CR-ICIC0SF0002-ICICI BANK NODAL ACC -SLICK ORGANICS-22749660591DC,investments,,net_banking_transfer,217.03
61b6fa2cd8beac1599eb054e,50200023535069,429597.98,60ec41ba55c00300382672d9,HDFC,SAAS/tech expense,5eecc6d6449e4f7cfb1c2708,2020-09-14T00:00:00.000Z,SHDF9220643420/BILLDKAMAZONSELLERSE,shopping,,Other,-25000
61b6fa2dd8beac1599eb055e,50200023535069,396597.98,60ec41ba55c00300382672d9,HDFC,direct expenses,5eecc6d6449e4f7cfb1c2708,2020-09-14T00:00:00.000Z,50100330586095-TPT-33000-DIWAKAR UNIYAL,,,net_banking_transfer,-33000
61b6fa2ed8beac1599eb0567,50200023535069,361716.98,60ec41ba55c00300382672d9,HDFC,agency/vendor expense,5eecc6d6449e4f7cfb1c2708,2020-09-14T00:00:00.000Z,"NEFT DR-KKBK0000298-ADMITAD MEDIA PRIVAT E LIMITED-NETBANK, MUM-N258201243973551- 34881",loans,lender_transaction,net_banking_transfer,-34881
61b6fa2fd8beac1599eb056f,50200023535069,340129.98,60ec41ba55c00300382672d9,HDFC,agency/vendor expense,5eecc6d6449e4f7cfb1c2708,2020-09-14T00:00:00.000Z,"NEFT DR-KKBK0000298-ADMITAD MEDIA PRIVAT E LIMITED-NETBANK, MUM-N258201243964991- 21587",loans,lender_transaction,net_banking_transfer,-21587
61b6fa2fd8beac1599eb057b,50200023535069,328128.98,60ec41ba55c00300382672d9,HDFC,direct expenses,5eecc6d6449e4f7cfb1c2708,2020-09-14T00:00:00.000Z,"NEFT DR-CITI0000002-OMG NETWORK INDIA PR IVATE LIMITED-NETBANK, MUM-N258201243969 642-12001",,,net_banking_transfer,-12001
61b6fa30d8beac1599eb0582,50200023535069,325775.98,60ec41ba55c00300382672d9,HDFC,direct expenses,5eecc6d6449e4f7cfb1c2708,2020-09-14T00:00:00.000Z,"NEFT DR-CITI0000032-TRADETRACKER INDIA L LP-NETBANK, MUM-N258201243976646-2353",,,net_banking_transfer,-2353
61b6fa31d8beac1599eb0587,50200023535069,320775.98,60ec41ba55c00300382672d9,HDFC,direct expenses,5eecc6d6449e4f7cfb1c2708,2020-09-14T00:00:00.000Z,"NEFT DR-ICIC0000250-SHOBHA RANA-NETBANK,",,,net_banking_transfer,-5000
61b6fa32d8beac1599eb0589,50200023535069,321485.03,60ec41ba55c00300382672d9,HDFC,Revenue-Mktplace,5eecc6d6449e4f7cfb1c2708,2020-09-14T00:00:00.000Z,NEFT CR-DEUT0797BGL-MYNTRA DESIGNS PRIVA TE LIMITED-SLICK ORGANICS PRIVATE LIMITE D-091400351GN00263,shopping,,net_banking_transfer,709.05
61b6fa33d8beac1599eb0590,50200023535069,322887.2,60ec41ba55c00300382672d9,HDFC,Revenue-Mktplace,5eecc6d6449e4f7cfb1c2708,2020-09-14T00:00:00.000Z,NEFT CR-DEUT0797BGL-FLIPKART INTERNET PV TLTD-SLICK ORGANICS PVT LTD-091400330GN0 0202,shopping,,net_banking_transfer,1402.17
61b6fa34d8beac1599eb0595,50200023535069,333050.15,60ec41ba55c00300382672d9,HDFC,Revenue-PG-split enabled,5eecc6d6449e4f7cfb1c2708,2020-09-14T00:00:00.000Z,NEFT CR-UTIB0001506-RAZORPAY SOFTWARE PR IVATE LIMITED-SLICK ORGANICS PVT LITD-AX ISCN0057035851,investments,,net_banking_transfer,10162.95
61b6fa35d8beac1599eb059a,50200023535069,337927.48,60ec41ba55c00300382672d9,HDFC,Revenue-PG-non-split,5eecc6d6449e4f7cfb1c2708,2020-09-15T00:00:00.000Z,UPI-PAYTM-PAYOUTS@PAYTM-PYTM0123456-0259 62949591-ALL202009152168200,ewallet,,upi,4877.33
61b6fa36d8beac1599eb05a9,50200023535069,255495.48,60ec41ba55c00300382672d9,HDFC,direct expenses,5eecc6d6449e4f7cfb1c2708,2020-09-15T00:00:00.000Z,"NEFT DR-KKBK0000173-MATRIX PRINTING SOLU TIONS PRIVATE LIMITE-NETBANK, MUM-N25920 1244926345-82432",,,net_banking_transfer,-82432
61b6fa37d8beac1599eb05af,50200023535069,298657,60ec41ba55c00300382672d9,HDFC,Revenue-PG-split enabled,5eecc6d6449e4f7cfb1c2708,2020-09-15T00:00:00.000Z,NEFT CR-UTIB0001506-RAZORPAY SOFTWARE PR IVATE LIMITED-SLICK ORGANICS PVT LITD-AX ISCN0057078963,investments,,net_banking_transfer,43161.52
61b6fa38d8beac1599eb05b6,50200023535069,2303632.85,60ec41ba55c00300382672d9,HDFC,Investments-New,5eecc6d6449e4f7cfb1c2708,2020-09-15T00:00:00.000Z,02711930004579-TPT-2004975.85-DHRUV BHAS IN,,,net_banking_transfer,2004975.85
61b6fa39d8beac1599eb05bb,50200023535069,2328649.3,60ec41ba55c00300382672d9,HDFC,Revenue-Mktplace,5eecc6d6449e4f7cfb1c2708,2020-09-15T00:00:00.000Z,IMPS-025911040278-AMAZON SELLER SERVIC-H DFC-XXXXXXXX6004-4VM3FI73C15Y3OHQSLICK O RGANICS PVT LTD,shopping,,net_banking_transfer,25016.45
61b6fa3ad8beac1599eb05c0,50200023535069,2128649.3,60ec41ba55c00300382672d9,HDFC,direct expenses,5eecc6d6449e4f7cfb1c2708,2020-09-15T00:00:00.000Z,IMPS-025911152768-PAYTM-PYTM-XXXXXXXX383 9-200000,ewallet,,net_banking_transfer,-200000
61b6fa3bd8beac1599eb05c9,50200023535069,123673.45,60ec41ba55c00300382672d9,HDFC,Internal Transfers,5eecc6d6449e4f7cfb1c2708,2020-09-15T00:00:00.000Z,02711930004579-TPT-2004975.85-DHRUV BHAS IN,,,net_banking_transfer,-2004975.85
61b6fa3cd8beac1599eb05d2,50200023535069,323673.45,60ec41ba55c00300382672d9,HDFC,Internal Transfers,5eecc6d6449e4f7cfb1c2708,2020-09-15T00:00:00.000Z,IMPS-025912852934-ARATA-HDFC-XXXXXXXXXX0 001-,,,net_banking_transfer,200000
61b6fa3dd8beac1599eb05da,50200023535069,575825.77,60ec41ba55c00300382672d9,HDFC,Revenue-Mktplace,5eecc6d6449e4f7cfb1c2708,2020-09-15T00:00:00.000Z,NEFT CR-DEUT0797BGL-AMAZON PAY IND PVT L,shopping,,net_banking_transfer,252152.32
61b6fa3ed8beac1599eb05e0,50200023535069,576308.17,60ec41ba55c00300382672d9,HDFC,Revenue-PG-non-split,5eecc6d6449e4f7cfb1c2708,2020-09-15T00:00:00.000Z,NEFT CR-ICIC0000031-PAYTM E COMMERCE PVT LTD-SLICK ORGANICS PVT LTD-CMS161350251 2,investments,,net_banking_transfer,482.4
61b6fa3fd8beac1599eb05e5,50200023535069,376308.17,60ec41ba55c00300382672d9,HDFC,direct expenses,5eecc6d6449e4f7cfb1c2708,2020-09-15T00:00:00.000Z,IMPS-025913106523-PAYTM-PYTM-XXXXXXXX383 9-200000,ewallet,,net_banking_transfer,-200000
61b6fa40d8beac1599eb05e9,50200023535069,176308.17,60ec41ba55c00300382672d9,HDFC,direct expenses,5eecc6d6449e4f7cfb1c2708,2020-09-15T00:00:00.000Z,IMPS-025913112147-PAYTM-PYTM-XXXXXXXX383 9-200000,ewallet,,net_banking_transfer,-200000
61b6fa41d8beac1599eb05ef,50200023535069,76308.17,60ec41ba55c00300382672d9,HDFC,direct expenses,5eecc6d6449e4f7cfb1c2708,2020-09-15T00:00:00.000Z,57500000443889-TPT-100000-WEBKLIPPER TEC HNOLOGIES PRIVATE LIMITED,,,net_banking_transfer,-100000
61b6fa42d8beac1599eb05f6,50200023535069,476308.17,60ec41ba55c00300382672d9,HDFC,Transfer in/Revenue-other,5eecc6d6449e4f7cfb1c2708,2020-09-15T00:00:00.000Z,NEFT CR-PYTM0000001-ARATA-SLICK ORGANICS PRIVATE LIMITED-PYTMH20259049621,investments,,net_banking_transfer,400000
61b6fa43d8beac1599eb0601,50200023535069,466308.17,60ec41ba55c00300382672d9,HDFC,direct expenses,5eecc6d6449e4f7cfb1c2708,2020-09-15T00:00:00.000Z,IMPS-025914156809-PAYTM-PYTM-XXXXXXXX383 9-10000,ewallet,,net_banking_transfer,-10000
61b6fa44d8beac1599eb0605,50200023535069,266308.17,60ec41ba55c00300382672d9,HDFC,direct expenses,5eecc6d6449e4f7cfb1c2708,2020-09-15T00:00:00.000Z,IMPS-025915169049-PAYTM-PYTM-XXXXXXXX383 9-200000,ewallet,,net_banking_transfer,-200000
61b6fa45d8beac1599eb060d,50200023535069,266791.55,60ec41ba55c00300382672d9,HDFC,Revenue-Mktplace,5eecc6d6449e4f7cfb1c2708,2020-09-15T00:00:00.000Z,4060000740-TIMES INTERNET LIMITED NODAL,,,Other,483.38
61b6fa46d8beac1599eb0611,50200023535069,273854.63,60ec41ba55c00300382672d9,HDFC,Revenue-PG-split enabled,5eecc6d6449e4f7cfb1c2708,2020-09-15T00:00:00.000Z,NEFT CR-UTIB0001506-RAZORPAY SOFTWARE PR IVATE LIMITED-SLICK ORGANICS PVT LITD-AX ISCN0057131557,investments,,net_banking_transfer,7063.08
61b6fa47d8beac1599eb0617,50200023535069,279476.42,60ec41ba55c00300382672d9,HDFC,Revenue-PG-non-split,5eecc6d6449e4f7cfb1c2708,2020-09-16T00:00:00.000Z,IMPS-026005541738-PAYTM-HDFC-XXXXXXXXXX0 007-,ewallet,,net_banking_transfer,5621.79
61b6fa48d8beac1599eb061b,50200023535069,2679476.42,60ec41ba55c00300382672d9,HDFC,Internal Transfers,5eecc6d6449e4f7cfb1c2708,2020-09-16T00:00:00.000Z,IB FUNDS TRANSFER CR-50200035187206 -SL ICK ORGANICS PVT LTD,investments,,Other,2400000
61b6fa49d8beac1599eb062f,50200023535069,2279476.42,60ec41ba55c00300382672d9,HDFC,direct expenses,5eecc6d6449e4f7cfb1c2708,2020-09-16T00:00:00.000Z,02711600008220-TPT-400000-VARUN SINGH,,,net_banking_transfer,-400000
61b6fa4ad8beac1599eb0632,50200023535069,2292804.35,60ec41ba55c00300382672d9,HDFC,Revenue-PG-split enabled,5eecc6d6449e4f7cfb1c2708,2020-09-16T00:00:00.000Z,NEFT CR-UTIB0001506-RAZORPAY SOFTWARE PR IVATE LIMITED-SLICK ORGANICS PVT LITD-AX ISCN0057156096,investments,,net_banking_transfer,13327.93
61b6fa4bd8beac1599eb0648,50200023535069,2272804.35,60ec41ba55c00300382672d9,HDFC,direct expenses,5eecc6d6449e4f7cfb1c2708,2020-09-16T00:00:00.000Z,"SELF - CHQ PAID - KALKAJI, NEW",,,chq,-20000
61b6fa4cd8beac1599eb064b,50200023535069,2222804.35,60ec41ba55c00300382672d9,HDFC,SAAS/tech expense,5eecc6d6449e4f7cfb1c2708,2020-09-16T00:00:00.000Z,SHDF9227476295/BILLDKAMAZONSELLERSE,shopping,,Other,-50000
61b6fa4dd8beac1599eb0659,50200023535069,2195074.35,60ec41ba55c00300382672d9,HDFC,direct expenses,5eecc6d6449e4f7cfb1c2708,2020-09-16T00:00:00.000Z,NEFT DR-UTIB0000723-VEDIC COMECEUTICALS,,,net_banking_transfer,-27730
61b6fa4dd8beac1599eb065f,50200023535069,1695074.35,60ec41ba55c00300382672d9,HDFC,direct expenses,5eecc6d6449e4f7cfb1c2708,2020-09-16T00:00:00.000Z,"NEFT DR-UTIB0000723-VEDIC COMECEUTICALS PVT LTD-NETBANK, MUM-N260201246223880-50 0000",,,net_banking_transfer,-500000
61b6fa4ed8beac1599eb0666,50200023535069,1651074.35,60ec41ba55c00300382672d9,HDFC,direct expenses,5eecc6d6449e4f7cfb1c2708,2020-09-16T00:00:00.000Z,IMPS-026011104775-PAYTM-PYTM-XXXXXXXX383 9-44000,ewallet,,net_banking_transfer,-44000
61b6fa4fd8beac1599eb066f,50200023535069,1586074.35,60ec41ba55c00300382672d9,HDFC,direct expenses,5eecc6d6449e4f7cfb1c2708,2020-09-16T00:00:00.000Z,"NEFT DR-YESB0000109-JERONONE TECHNOLOGIE S-NETBANK, MUM-N260201246316048-65000",,,net_banking_transfer,-65000
61b6fa50d8beac1599eb0671,50200023535069,1584042.35,60ec41ba55c00300382672d9,HDFC,direct expenses,5eecc6d6449e4f7cfb1c2708,2020-09-16T00:00:00.000Z,50100097355028-TPT-2032-PALLAVI JUNEJA,,,net_banking_transfer,-2032
61b6fa51d8beac1599eb067a,50200023535069,1584306.37,60ec41ba55c00300382672d9,HDFC,Revenue-Mktplace,5eecc6d6449e4f7cfb1c2708,2020-09-16T00:00:00.000Z,NEFT CR-DEUT0797BGL-FLIPKART INTERNET P LTD-INT AC FO R INTERMEDIARY-SLICK ORGAN ICS PVT LTD-091600312GN00035,shopping,,net_banking_transfer,264.02
61b6fa52d8beac1599eb067f,50200023535069,1564306.37,60ec41ba55c00300382672d9,HDFC,direct expenses,5eecc6d6449e4f7cfb1c2708,2020-09-16T00:00:00.000Z,IMPS-026014100306-RISHIEKA JAINI-CITI-XX XXXX8487-20000,,,net_banking_transfer,-20000
61b6fa53d8beac1599eb0684,50200023535069,1513243.37,60ec41ba55c00300382672d9,HDFC,Salary/Emp/consultant Expense,5eecc6d6449e4f7cfb1c2708,2020-09-16T00:00:00.000Z,"NEFT DR-UTIB0003142-ARIA DESAI UG ELIZAB ETH THOMAS ALEX-NETBANK, MUM-N2602012464 96577-51663",,,net_banking_transfer,-51063
61b6fa54d8beac1599eb0689,50200023535069,1514161.69,60ec41ba55c00300382672d9,HDFC,Revenue-Mktplace,5eecc6d6449e4f7cfb1c2708,2020-09-16T00:00:00.000Z,NEFT CR-DEUT0797BGL-MYNTRA DESIGNS PRIVA TE LIMITED-SLICK ORGANICS PRIVATE LIMITE D-091600621GN00010,shopping,,net_banking_transfer,918.32
61b6fa55d8beac1599eb068e,50200023535069,1515834.53,60ec41ba55c00300382672d9,HDFC,Revenue-Mktplace,5eecc6d6449e4f7cfb1c2708,2020-09-16T00:00:00.000Z,NEFT CR-DEUT0797BGL-MYNTRA DESIGNS PRIVA TE LIMITED-SLICK ORGANICS PRIVATE LIMITE D-091600623GN00178,shopping,,net_banking_transfer,1672.84
61b6fa56d8beac1599eb0696,50200023535069,1368037.53,60ec41ba55c00300382672d9,HDFC,direct expenses,5eecc6d6449e4f7cfb1c2708,2020-09-16T00:00:00.000Z,"NEFT DR-ORBC0101001-KRAUTER HEALTHCARE L TD-NETBANK, MUM-N260201246494803-147797",,,net_banking_transfer,-147797
61b6fa57d8beac1599eb069a,50200023535069,1253023.53,60ec41ba55c00300382672d9,HDFC,direct expenses,5eecc6d6449e4f7cfb1c2708,2020-09-16T00:00:00.000Z,"NEFT DR-YESB0000551-VISTTA COSMETICS-NET BANK, MUM-N260201246518184-115014",,,net_banking_transfer,-115014
61b6fa58d8beac1599eb069f,50200023535069,1255209.46,60ec41ba55c00300382672d9,HDFC,Revenue-Mktplace,5eecc6d6449e4f7cfb1c2708,2020-09-16T00:00:00.000Z,NEFT CR-DEUT0797BGL-FLIPKART INTERNET PV TLTD-SLICK ORGANICS PVT LTD-091600291GN0 0098,shopping,,net_banking_transfer,2185.93
61b6fa59d8beac1599eb06a8,50200023535069,1315035.84,60ec41ba55c00300382672d9,HDFC,Revenue-COD,5eecc6d6449e4f7cfb1c2708,2020-09-16T00:00:00.000Z,NEFT CR-KKBK0000958-BIGFOOT RETAIL SOLUT,,,net_banking_transfer,59826.38
61b6fa5ad8beac1599eb06aa,50200023535069,1315486.66,60ec41ba55c00300382672d9,HDFC,Revenue-Mktplace,5eecc6d6449e4f7cfb1c2708,2020-09-16T00:00:00.000Z,NEFT CR-ICIC0000105-MANASH LIFETYLE PVT LTD-SLICKORGANICSPRIVATELIMITEDMPMUM-ICI B202600040239,,,net_banking_transfer,450.82
61b6fa5bd8beac1599eb06b1,50200023535069,1315775.09,60ec41ba55c00300382672d9,HDFC,Revenue-Mktplace,5eecc6d6449e4f7cfb1c2708,2020-09-16T00:00:00.000Z,NEFT CR-ICIC0000105-MANASH LIFETYLE PVT LTD-SLICKORGANICSPRIVATELIMITEDMPGGN-ICI B202600038973,,,net_banking_transfer,288.43
61b6fa5cd8beac1599eb06be,50200023535069,1328004.1,60ec41ba55c00300382672d9,HDFC,Revenue-PG-split enabled,5eecc6d6449e4f7cfb1c2708,2020-09-16T00:00:00.000Z,NEFT CR-UTIB0001506-RAZORPAY SOFTWARE PR IVATE LIMITED-SLICK ORGANICS PVT LITD-AX ISCN0057211051,investments,,net_banking_transfer,12229.01
61b6fa5dd8beac1599eb06ce,50200023535069,1327267.05,60ec41ba55c00300382672d9,HDFC,direct expenses,5eecc6d6449e4f7cfb1c2708,2020-09-16T00:00:00.000Z,POS 514834XXXXXX9486 MANYCHAT COM PRO,,,debit_card,-737.05
61b6fa5ed8beac1599eb06e0,50200023535069,1277267.05,60ec41ba55c00300382672d9,HDFC,direct expenses,5eecc6d6449e4f7cfb1c2708,2020-09-17T00:00:00.000Z,CHQ PAID-MICR CTS-NO-DLF UTILITIES LTD,,,chq,-50000
61b6fa5fd8beac1599eb06ed,50200023535069,1292630.41,60ec41ba55c00300382672d9,HDFC,Revenue-PG-non-split,5eecc6d6449e4f7cfb1c2708,2020-09-17T00:00:00.000Z,IMPS-026105535508-PAYTM-HDFC-XXXXXXXXXX0 007-,ewallet,,net_banking_transfer,15363.36
61b6fa60d8beac1599eb06f4,50200023535069,1300877.95,60ec41ba55c00300382672d9,HDFC,Revenue-PG-split enabled,5eecc6d6449e4f7cfb1c2708,2020-09-17T00:00:00.000Z,NEFT CR-UTIB0001506-RAZORPAY SOFTWARE PR IVATE LIMITED-SLICK ORGANICS PVT LITD-AX ISCN0057243718,investments,,net_banking_transfer,8247.54
61b6fa61d8beac1599eb0701,50200023535069,1215877.95,60ec41ba55c00300382672d9,HDFC,direct expenses,5eecc6d6449e4f7cfb1c2708,2020-09-17T00:00:00.000Z,"NEFT DR-UTIB0000723-VEDIC COMECEUTICALS PVT LTD-NETBANK, MUM-N261201247325088-85 000",,,net_banking_transfer,-85000
61b6fa62d8beac1599eb0709,50200023535069,1179877.95,60ec41ba55c00300382672d9,HDFC,direct expenses,5eecc6d6449e4f7cfb1c2708,2020-09-17T00:00:00.000Z,"NEFT DR-PYTM0123456-PAYTM-NETBANK, MUM-N 261201247478515-36000",ewallet,,net_banking_transfer,-36000
61b6fa63d8beac1599eb0715,50200023535069,1187854.36,60ec41ba55c00300382672d9,HDFC,Revenue-PG-split enabled,5eecc6d6449e4f7cfb1c2708,2020-09-17T00:00:00.000Z,NEFT CR-UTIB0001506-RAZORPAY SOFTWARE PR IVATE LIMITED-SLICK ORGANICS PVT LITD-AX ISCN0057288253,investments,,net_banking_transfer,7976.41
61b6fa64d8beac1599eb0721,50200023535069,1195614.86,60ec41ba55c00300382672d9,HDFC,Revenue-PG-non-split,5eecc6d6449e4f7cfb1c2708,2020-09-18T00:00:00.000Z,IMPS-026205640542-PAYTM-HDFC-XXXXXXXXXX0 007-,ewallet,,net_banking_transfer,7760.5
61b6fa65d8beac1599eb0726,50200023535069,1206520.49,60ec41ba55c00300382672d9,HDFC,Revenue-PG-split enabled,5eecc6d6449e4f7cfb1c2708,2020-09-18T00:00:00.000Z,NEFT CR-UTIB0001506-RAZORPAY SOFTWARE PR IVATE LIMITED-SLICK ORGANICS PVT LITD-AX ISCN0057312630,investments,,net_banking_transfer,10905.63
61b6fa66d8beac1599eb072d,50200023535069,1170520.49,60ec41ba55c00300382672d9,HDFC,direct expenses,5eecc6d6449e4f7cfb1c2708,2020-09-18T00:00:00.000Z,NEFT DR-ICIC0001641-TURNAROUND CORPORATE,,,net_banking_transfer,-36000
61b6fa67d8beac1599eb0735,50200023535069,1171732.92,60ec41ba55c00300382672d9,HDFC,Revenue-Mktplace,5eecc6d6449e4f7cfb1c2708,2020-09-18T00:00:00.000Z,NEFT CR-DEUT0797BGL-MYNTRA DESIGNS PRIVA TE LIMITED-SLICK ORGANICS PRIVATE LIMITE D-091800051GN00276,shopping,,net_banking_transfer,1212.43
61b6fa67d8beac1599eb073a,50200023535069,1135907.92,60ec41ba55c00300382672d9,HDFC,direct expenses,5eecc6d6449e4f7cfb1c2708,2020-09-18T00:00:00.000Z,"NEFT DR-ICIC0001944-TUNRAROUND CORPORATE ADVISORS PVT LTD-NETBANK, MUM-N26220124 8191554-35825",,,net_banking_transfer,-35825
61b6fa68d8beac1599eb0740,50200023535069,1136547.35,60ec41ba55c00300382672d9,HDFC,Revenue-Mktplace,5eecc6d6449e4f7cfb1c2708,2020-09-18T00:00:00.000Z,NEFT CR-DEUT0797BGL-FLIPKART INTERNET P LTD-INT AC FO R INTERMEDIARY-SLICK ORGAN ICS PVT LTD-091800267GN00210,shopping,,net_banking_transfer,639.43
61b6fa69d8beac1599eb0747,50200023535069,1136932.46,60ec41ba55c00300382672d9,HDFC,Revenue-Mktplace,5eecc6d6449e4f7cfb1c2708,2020-09-18T00:00:00.000Z,NEFT CR-DEUT0797BGL-MYNTRA DESIGNS PRIVA TE LIMITED-SLICK ORGANICS PRIVATE LIMITE D-091800058GN00211,shopping,,net_banking_transfer,385.11
61b6fa6ad8beac1599eb0750,50200023535069,1137913.52,60ec41ba55c00300382672d9,HDFC,Revenue-Mktplace,5eecc6d6449e4f7cfb1c2708,2020-09-18T00:00:00.000Z,NEFT CR-DEUT0797BGL-FLIPKART INTERNET PV TLTD-SLICK ORGANICS PVT LTD-091800259GN0 0152,shopping,,net_banking_transfer,981.06
61b6fa6bd8beac1599eb0756,50200023535069,1150192.52,60ec41ba55c00300382672d9,HDFC,Revenue-Mktplace,5eecc6d6449e4f7cfb1c2708,2020-09-18T00:00:00.000Z,NEFT CR-SCBL0036001-DREAMPLUG TECHNOLOGI ES PRIVATE LIMI-ARATAARATA-SIN31436Q0005 473,,,net_banking_transfer,12279
61b6fa6cd8beac1599eb075c,50200023535069,1209114.39,60ec41ba55c00300382672d9,HDFC,Revenue-COD,5eecc6d6449e4f7cfb1c2708,2020-09-18T00:00:00.000Z,NEFT CR-KKBK0000958-BIGFOOT RETAIL SOLUT IONS PRIVATE LIMITED-SLICK ORGANICS PVT LTD-KKBK202629644997,,,net_banking_transfer,58921.87
61b6fa6dd8beac1599eb0768,50200023535069,1217618.52,60ec41ba55c00300382672d9,HDFC,Revenue-PG-split enabled,5eecc6d6449e4f7cfb1c2708,2020-09-18T00:00:00.000Z,NEFT CR-UTIB0001506-RAZORPAY SOFTWARE PR IVATE LIMITED-SLICK ORGANICS PVT LITD-AX ISCN0057354987,investments,,net_banking_transfer,8504.13
61b6fa6ed8beac1599eb076d,50200023535069,1219851.3,60ec41ba55c00300382672d9,HDFC,Revenue-Mktplace,5eecc6d6449e4f7cfb1c2708,2020-09-18T00:00:00.000Z,NEFT CR-DEUT0784BBY-TATA UNISTORE LTD-NO DAL-SLICK ORGANICS PVT LTD-091801136GN00 298,investments,,net_banking_transfer,2232.78
61b6fa6fd8beac1599eb0775,50200023535069,1232043.98,60ec41ba55c00300382672d9,HDFC,Revenue-PG-non-split,5eecc6d6449e4f7cfb1c2708,2020-09-19T00:00:00.000Z,IMPS-026305752990-PAYTM-HDFC-XXXXXXXXXX0 007-,ewallet,,net_banking_transfer,12192.68
61b6fa70d8beac1599eb077e,50200023535069,1044954.98,60ec41ba55c00300382672d9,HDFC,direct expenses,5eecc6d6449e4f7cfb1c2708,2020-09-19T00:00:00.000Z,"NEFT DR-ORBC0101001-KRAUTER HEALTHCARE L TD-NETBANK, MUM-N263201249317876-187089",,,net_banking_transfer,-187089
61b6fa71d8beac1599eb0785,50200023535069,1054453.2,60ec41ba55c00300382672d9,HDFC,Revenue-PG-split enabled,5eecc6d6449e4f7cfb1c2708,2020-09-19T00:00:00.000Z,NEFT CR-UTIB0001506-RAZORPAY SOFTWARE PR,,,net_banking_transfer,9498.22
61b6fa72d8beac1599eb078a,50200023535069,1004453.2,60ec41ba55c00300382672d9,HDFC,SAAS/tech expense,5eecc6d6449e4f7cfb1c2708,2020-09-19T00:00:00.000Z,POS 514834XXXXXX9486 AMAZON,shopping,,debit_card,-50000
61b6fa73d8beac1599eb078f,50200023535069,1014428.32,60ec41ba55c00300382672d9,HDFC,Revenue-PG-split enabled,5eecc6d6449e4f7cfb1c2708,2020-09-19T00:00:00.000Z,NEFT CR-UTIB0001506-RAZORPAY SOFTWARE PR IVATE LIMITED-SLICK ORGANICS PVT LITD-AX ISCN0057402806,investments,,net_banking_transfer,9975.12
61b6fa74d8beac1599eb0794,50200023535069,1017307.94,60ec41ba55c00300382672d9,HDFC,Revenue-PG-non-split,5eecc6d6449e4f7cfb1c2708,2020-09-20T00:00:00.000Z,UPI-PAYTM-PAYOUTS@PAYTM-PYTM0123456-0264 42661702-ALL202009202168200,ewallet,,upi,2879.62
61b6fa75d8beac1599eb079a,50200023535069,1012156.01,60ec41ba55c00300382672d9,HDFC,direct expenses,5eecc6d6449e4f7cfb1c2708,2020-09-20T00:00:00.000Z,POS 514834XXXXXX9486 FEEDBACKFIVE,,,debit_card,-5151.93
61b6fa76d8beac1599eb079e,50200023535069,1005603.83,60ec41ba55c00300382672d9,HDFC,direct expenses,5eecc6d6449e4f7cfb1c2708,2020-09-20T00:00:00.000Z,POS 514834XXXXXX9486 HOTJAR,,,debit_card,-6552.18
61b6fa77d8beac1599eb07a7,50200023535069,1016456.97,60ec41ba55c00300382672d9,HDFC,Revenue-PG-non-split,5eecc6d6449e4f7cfb1c2708,2020-09-21T00:00:00.000Z,IMPS-026505982800-PAYTM-HDFC-XXXXXXXXXX0 007-,ewallet,,net_banking_transfer,10853.14
61b6fa78d8beac1599eb07ab,50200023535069,933581.97,60ec41ba55c00300382672d9,HDFC,direct expenses,5eecc6d6449e4f7cfb1c2708,2020-09-21T00:00:00.000Z,50200012495494-TPT-82875-BEAM AND WORDS LLP,,,net_banking_transfer,-82875
61b6fa79d8beac1599eb07b0,50200023535069,896581.97,60ec41ba55c00300382672d9,HDFC,direct expenses,5eecc6d6449e4f7cfb1c2708,2020-09-21T00:00:00.000Z,"NEFT DR-CITI0000002-DHIRAJ-NETBANK, MUM- N265201250191001-37000",,,net_banking_transfer,-37000
61b6fa7ad8beac1599eb07b6,50200023535069,861581.97,60ec41ba55c00300382672d9,HDFC,direct expenses,5eecc6d6449e4f7cfb1c2708,2020-09-21T00:00:00.000Z,"NEFT DR-ICIC0000542-AVANTIKA SUKHIA-NETB ANK, MUM-N265201250191038-35000",,,net_banking_transfer,-35000
61b6fa7bd8beac1599eb07bc,50200023535069,854081.97,60ec41ba55c00300382672d9,HDFC,direct expenses,5eecc6d6449e4f7cfb1c2708,2020-09-21T00:00:00.000Z,"NEFT DR-SIBL0000555-JAIVEER KUMAR-NETBAN K, MUM-N265201250180140-7500",,,net_banking_transfer,-7500
61b6fa7cd8beac1599eb07be,50200023535069,849081.97,60ec41ba55c00300382672d9,HDFC,direct expenses,5eecc6d6449e4f7cfb1c2708,2020-09-21T00:00:00.000Z,"NEFT DR-PUNB0398000-MEENA SINGH-NETBANK, MUM-N265201250180155-5000",,,net_banking_transfer,-5000
61b6fa7dd8beac1599eb07c4,50200023535069,839081.97,60ec41ba55c00300382672d9,HDFC,direct expenses,5eecc6d6449e4f7cfb1c2708,2020-09-21T00:00:00.000Z,"NEFT DR-SBIN0001189-SANDEEP SINGH-NETBAN K, MUM-N265201250195607-10000",,,net_banking_transfer,-10000
61b6fa7ed8beac1599eb07c8,50200023535069,821581.97,60ec41ba55c00300382672d9,HDFC,direct expenses,5eecc6d6449e4f7cfb1c2708,2020-09-21T00:00:00.000Z,"NEFT DR-ICIC0003374-SIDDHARTH KANOJIA-NE TBANK, MUM-N265201250195627-17500",,,net_banking_transfer,-17500
61b6fa7fd8beac1599eb07d9,50200023535069,818581.97,60ec41ba55c00300382672d9,HDFC,direct expenses,5eecc6d6449e4f7cfb1c2708,2020-09-21T00:00:00.000Z,"NEFT DR-ALLA0210591-CHAMPA DEVI-NETBANK, MUM-N265201250191170-3000",,,net_banking_transfer,-3000
61b6fa80d8beac1599eb07e1,50200023535069,805081.97,60ec41ba55c00300382672d9,HDFC,direct expenses,5eecc6d6449e4f7cfb1c2708,2020-09-21T00:00:00.000Z,"NEFT DR-SYNB0005170-SNEHAL TAYDE-NETBANK , MUM-N265201250195695-13500",,,net_banking_transfer,-13500
61b6fa81d8beac1599eb07e9,50200023535069,784231.97,60ec41ba55c00300382672d9,HDFC,direct expenses,5eecc6d6449e4f7cfb1c2708,2020-09-21T00:00:00.000Z,"NEFT DR-UTIB0000120-ADNAN ALI-NETBANK, M",,,net_banking_transfer,-20850
61b6fa82d8beac1599eb07ee,50200023535069,738231.97,60ec41ba55c00300382672d9,HDFC,direct expenses,5eecc6d6449e4f7cfb1c2708,2020-09-21T00:00:00.000Z,"NEFT DR-BKDN0450123-ARTISTO DESIGNZ-NETB ANK, MUM-N265201250191519-46000",,,net_banking_transfer,-46000
61b6fa82d8beac1599eb07f1,50200023535069,722231.97,60ec41ba55c00300382672d9,HDFC,direct expenses,5eecc6d6449e4f7cfb1c2708,2020-09-21T00:00:00.000Z,00901610080520-TPT-16000-POOJA KAPIL SHR OTRIYA,,,net_banking_transfer,-16000
61b6fa83d8beac1599eb07f7,50200023535069,687231.97,60ec41ba55c00300382672d9,HDFC,direct expenses,5eecc6d6449e4f7cfb1c2708,2020-09-21T00:00:00.000Z,50100301160692-TPT-35000-TARUN GARG,,,net_banking_transfer,-35000
61b6fa84d8beac1599eb07fc,50200023535069,638981.97,60ec41ba55c00300382672d9,HDFC,direct expenses,5eecc6d6449e4f7cfb1c2708,2020-09-21T00:00:00.000Z,02771610131904-TPT-48250-DIGANT BHATT,,,net_banking_transfer,-48250
61b6fa85d8beac1599eb0807,50200023535069,630731.97,60ec41ba55c00300382672d9,HDFC,direct expenses,5eecc6d6449e4f7cfb1c2708,2020-09-21T00:00:00.000Z,"NEFT DR-KKBK0000811-NASIR KHAN-NETBANK, MUM-N265201250190322-8250",,,net_banking_transfer,-8250
61b6fa86d8beac1599eb080b,50200023535069,597731.97,60ec41ba55c00300382672d9,HDFC,direct expenses,5eecc6d6449e4f7cfb1c2708,2020-09-21T00:00:00.000Z,50100330586095-TPT-33000-DIWAKAR UNIYAL,,,net_banking_transfer,-33000
61b6fa87d8beac1599eb0810,50200023535069,643992.95,60ec41ba55c00300382672d9,HDFC,Revenue-PG-split enabled,5eecc6d6449e4f7cfb1c2708,2020-09-21T00:00:00.000Z,NEFT CR-UTIB0001506-RAZORPAY SOFTWARE PR IVATE LIMITED-SLICK ORGANICS PVT LITD-AX ISCN0057424786,investments,,net_banking_transfer,46260.98
61b6fa88d8beac1599eb0818,50200023535069,644946.79,60ec41ba55c00300382672d9,HDFC,Revenue-Mktplace,5eecc6d6449e4f7cfb1c2708,2020-09-21T00:00:00.000Z,NEFT CR-DEUT0797BGL-MYNTRA DESIGNS PRIVA TE LIMITED-SLICK ORGANICS PRIVATE LIMITE D-092100365GN00298,shopping,,net_banking_transfer,953.84
61b6fa89d8beac1599eb081d,50200023535069,1344946.79,60ec41ba55c00300382672d9,HDFC,Internal Transfers,5eecc6d6449e4f7cfb1c2708,2020-09-21T00:00:00.000Z,IB FUNDS TRANSFER CR-50200035187206 -SL ICK ORGANICS PVT LTD,investments,,Other,700000
61b6fa8ad8beac1599eb0821,50200023535069,1347277.94,60ec41ba55c00300382672d9,HDFC,Revenue-Mktplace,5eecc6d6449e4f7cfb1c2708,2020-09-21T00:00:00.000Z,NEFT CR-DEUT0797BGL-FLIPKART INTERNET P LTD-INT AC FO R INTERMEDIARY-SLICK ORGAN ICS PVT LTD-092100524GN00013,shopping,,net_banking_transfer,2331.15
61b6fa8bd8beac1599eb082f,50200023535069,1348947.86,60ec41ba55c00300382672d9,HDFC,Revenue-Mktplace,5eecc6d6449e4f7cfb1c2708,2020-09-21T00:00:00.000Z,NEFT CR-DEUT0797BGL-FLIPKART INTERNET PV TLTD-SLICK ORGANICS PVT LTD-092100521GN0 0048,shopping,,net_banking_transfer,1669.92
61b6fa8cd8beac1599eb0834,50200023535069,1361916.95,60ec41ba55c00300382672d9,HDFC,Revenue-PG-split enabled,5eecc6d6449e4f7cfb1c2708,2020-09-21T00:00:00.000Z,NEFT CR-UTIB0001506-RAZORPAY SOFTWARE PR IVATE LIMITED-SLICK ORGANICS PVT LITD-AX ISCN0057467121,investments,,net_banking_transfer,12969.09
61b6fa8dd8beac1599eb083b,50200023535069,211117.83,60ec41ba55c00300382672d9,HDFC,direct expenses,5eecc6d6449e4f7cfb1c2708,2020-09-21T00:00:00.000Z,ADVANCE PAYMENT OF IMPORT BILL,bills,,Other,-1150799.12
61b6fa8ed8beac1599eb0841,50200023535069,221540.68,60ec41ba55c00300382672d9,HDFC,Revenue-PG-non-split,5eecc6d6449e4f7cfb1c2708,2020-09-22T00:00:00.000Z,UPI-PAYTM-PAYOUTS@PAYTM-PYTM0123456-0266 74174579-ALL202009222168200,ewallet,,upi,10422.85
61b6fa8fd8beac1599eb0849,50200023535069,244233.29,60ec41ba55c00300382672d9,HDFC,Revenue-PG-split enabled,5eecc6d6449e4f7cfb1c2708,2020-09-22T00:00:00.000Z,NEFT CR-UTIB0001506-RAZORPAY SOFTWARE PR,,,net_banking_transfer,22692.61
61b6fa90d8beac1599eb084d,50200023535069,248744.76,60ec41ba55c00300382672d9,HDFC,Revenue-PG-non-split,5eecc6d6449e4f7cfb1c2708,2020-09-22T00:00:00.000Z,NEFT CR-SCBL0036001-STRIPE INDIA PRIVATE LIMITED-SLICK ORGANICS PRIVATE LIMITED- SSG17413Q0096632,investments,,net_banking_transfer,4511.47
61b6fa91d8beac1599eb0851,50200023535069,198744.76,60ec41ba55c00300382672d9,HDFC,SAAS/tech expense,5eecc6d6449e4f7cfb1c2708,2020-09-22T00:00:00.000Z,SHDF9248580908/BILLDKAMAZONSELLERSE,shopping,,Other,-50000
61b6fa92d8beac1599eb0856,50200023535069,455096.37,60ec41ba55c00300382672d9,HDFC,Revenue-Mktplace,5eecc6d6449e4f7cfb1c2708,2020-09-22T00:00:00.000Z,NEFT CR-DEUT0797BGL-AMAZON PAY IND PVT L TD-INT AC INTM MKTPLACE-SLICK ORGANICS P VT LTD-092201415GN00163,shopping,,net_banking_transfer,256351.61
61b6fa93d8beac1599eb085d,50200023535069,521830.81,60ec41ba55c00300382672d9,HDFC,Revenue-Mktplace,5eecc6d6449e4f7cfb1c2708,2020-09-22T00:00:00.000Z,IMPS-026612094707-AMAZON SELLER SERVIC-H DFC-XXXXXXXX6004-139UJ7NZFGD0W8H1SLICK O RGANICS PVT LTD,shopping,,net_banking_transfer,66734.44
61b6fa94d8beac1599eb0862,50200023535069,535900.35,60ec41ba55c00300382672d9,HDFC,Revenue-PG-split enabled,5eecc6d6449e4f7cfb1c2708,2020-09-22T00:00:00.000Z,NEFT CR-UTIB0001506-RAZORPAY SOFTWARE PR IVATE LIMITED-SLICK ORGANICS PVT LITD-AX ISCN0057547201,investments,,net_banking_transfer,14069.54
61b6fa95d8beac1599eb086a,50200023535069,541247.85,60ec41ba55c00300382672d9,HDFC,Revenue-Mktplace,5eecc6d6449e4f7cfb1c2708,2020-09-22T00:00:00.000Z,NEFT CR-ICIC0000105-MANASH LIFETYLE PVT LTD-SLICK ORGANICS PRIVATE LIMITED MP GG N-ICIB202660049028,,,net_banking_transfer,5347.5
61b6fa96d8beac1599eb086e,50200023535069,549811.89,60ec41ba55c00300382672d9,HDFC,Revenue-Mktplace,5eecc6d6449e4f7cfb1c2708,2020-09-22T00:00:00.000Z,NEFT CR-ICIC0000105-MANASH LIFETYLE PVT LTD-SLICK ORGANICS PRIVATE LIMITED MP MU M-ICIB202660049029,,,net_banking_transfer,8564.04
61b6fa97d8beac1599eb0873,50200023535069,539811.89,60ec41ba55c00300382672d9,HDFC,Marketing Expense,5eecc6d6449e4f7cfb1c2708,2020-09-22T00:00:00.000Z,POS 514834XXXXXX9486 GOOGLE ADWORDS,,,debit_card,-10000
61b6fa98d8beac1599eb0877,50200023535069,546072.88,60ec41ba55c00300382672d9,HDFC,Revenue-PG-non-split,5eecc6d6449e4f7cfb1c2708,2020-09-23T00:00:00.000Z,IMPS-026705149878-PAYTM-HDFC-XXXXXXXXXX0 007-,ewallet,,net_banking_transfer,6260.99
61b6fa99d8beac1599eb087c,50200023535069,531072.88,60ec41ba55c00300382672d9,HDFC,direct expenses,5eecc6d6449e4f7cfb1c2708,2020-09-23T00:00:00.000Z,"NEFT DR-SBIN0007976-SHLAGHA BORAH-NETBAN K, MUM-N267201252251537-15000",,,net_banking_transfer,-15000
61b6fa9ad8beac1599eb0880,50200023535069,532102.79,60ec41ba55c00300382672d9,HDFC,Revenue-Mktplace,5eecc6d6449e4f7cfb1c2708,2020-09-23T00:00:00.000Z,NEFT CR-DEUT0797BGL-FLIPKART INTERNET P LTD-INT AC FO R INTERMEDIARY-SLICK ORGAN ICS PVT LTD-092301882GN00004,shopping,,net_banking_transfer,1029.91
61b6fa9bd8beac1599eb0885,50200023535069,546997.58,60ec41ba55c00300382672d9,HDFC,Revenue-PG-split enabled,5eecc6d6449e4f7cfb1c2708,2020-09-23T00:00:00.000Z,NEFT CR-UTIB0001506-RAZORPAY SOFTWARE PR IVATE LIMITED-SLICK ORGANICS PVT LITD-AX ISCN0057568936,investments,,net_banking_transfer,14894.79
61b6fa9bd8beac1599eb0889,50200023535069,547246.38,60ec41ba55c00300382672d9,HDFC,Revenue-Mktplace,5eecc6d6449e4f7cfb1c2708,2020-09-23T00:00:00.000Z,NEFT CR-DEUT0797BGL-MYNTRA DESIGNS PRIVA,shopping,,net_banking_transfer,248.8
61b6fa9cd8beac1599eb0890,50200023535069,552298.2,60ec41ba55c00300382672d9,HDFC,Revenue-PG-non-split,5eecc6d6449e4f7cfb1c2708,2020-09-23T00:00:00.000Z,NEFT CR-SCBL0036001-STRIPE INDIA PRIVATE LIMITED-SLICK ORGANICS PRIVATE LIMITED- SSG17413Q0097806,investments,,net_banking_transfer,5051.82
61b6fa9ed8beac1599eb0896,50200023535069,555755.5,60ec41ba55c00300382672d9,HDFC,Revenue-Mktplace,5eecc6d6449e4f7cfb1c2708,2020-09-23T00:00:00.000Z,NEFT CR-KKBK0000958-SUPERMARKET GROCERY SUPPLIES PVT LTD-SLICK ORGANICS PVT LTD- KKBK202671231789,shopping,,net_banking_transfer,3457.3
61b6fa9fd8beac1599eb089e,50200023535069,558172.16,60ec41ba55c00300382672d9,HDFC,Revenue-Mktplace,5eecc6d6449e4f7cfb1c2708,2020-09-23T00:00:00.000Z,NEFT CR-KKBK0000958-SUPERMARKET GROCERY SUPPLIES PVT LTD-SLICK ORGANICS PVT LTD- KKBK202671231766,shopping,,net_banking_transfer,2416.66
61b6faa0d8beac1599eb08a3,50200023535069,564361.3,60ec41ba55c00300382672d9,HDFC,Revenue-Mktplace,5eecc6d6449e4f7cfb1c2708,2020-09-23T00:00:00.000Z,NEFT CR-KKBK0000958-SUPERMARKET GROCERY SUPPLIES PVT LTD-SLICK ORGANICS PVT LTD- KKBK202671231826,shopping,,net_banking_transfer,6189.14
61b6faa1d8beac1599eb08a6,50200023535069,567429.26,60ec41ba55c00300382672d9,HDFC,Revenue-Mktplace,5eecc6d6449e4f7cfb1c2708,2020-09-23T00:00:00.000Z,NEFT CR-KKBK0000958-SUPERMARKET GROCERY SUPPLIES PVT LTD-SLICK ORGANICS PVT LTD- KKBK202671231746,shopping,,net_banking_transfer,3067.96
61b6faa2d8beac1599eb08ab,50200023535069,584421.79,60ec41ba55c00300382672d9,HDFC,Revenue-Mktplace,5eecc6d6449e4f7cfb1c2708,2020-09-23T00:00:00.000Z,NEFT CR-KKBK0000958-SUPERMARKET GROCERY SUPPLIES PVT LTD-SLICK ORGANICS PVT LTD- KKBK202671232743,shopping,,net_banking_transfer,16992.53
61b6faa3d8beac1599eb08b1,50200023535069,609380.6,60ec41ba55c00300382672d9,HDFC,Revenue-Mktplace,5eecc6d6449e4f7cfb1c2708,2020-09-23T00:00:00.000Z,NEFT CR-KKBK0000958-SUPERMARKET GROCERY SUPPLIES PVT LTD-SLICK ORGANICS PVT LTD- KKBK202671232924,shopping,,net_banking_transfer,24958.81
61b6faa3d8beac1599eb08b5,50200023535069,610527.32,60ec41ba55c00300382672d9,HDFC,Revenue-Mktplace,5eecc6d6449e4f7cfb1c2708,2020-09-23T00:00:00.000Z,NEFT CR-DEUT0797BGL-FLIPKART INTERNET PV TLTD-SLICK ORGANICS PVT LTD-092301839GN0 0221,shopping,,net_banking_transfer,1146.72
61b6faa4d8beac1599eb08b9,50200023535069,629737.34,60ec41ba55c00300382672d9,HDFC,Revenue-COD,5eecc6d6449e4f7cfb1c2708,2020-09-23T00:00:00.000Z,NEFT CR-KKBK0000958-BIGFOOT RETAIL SOLUT IONS PRIVATE LIMITED-SLICK ORGANICS PVT LTD-KKBK202671274228,,,net_banking_transfer,19210.02
61b6faa5d8beac1599eb08bd,50200023535069,803261.15,60ec41ba55c00300382672d9,HDFC,Revenue-PG-split enabled,5eecc6d6449e4f7cfb1c2708,2020-09-23T00:00:00.000Z,NEFT CR-UTIB0001506-RAZORPAY SOFTWARE PR IVATE LIMITED-SLICK ORGANICS PVT LITD-AX ISCN0057615358,investments,,net_banking_transfer,173523.81
61b6faa6d8beac1599eb08c5,50200023535069,805568.59,60ec41ba55c00300382672d9,HDFC,Revenue-Mktplace,5eecc6d6449e4f7cfb1c2708,2020-09-23T00:00:00.000Z,NEFT CR-ICIC0000105-MANASH LIFETYLE PVT,,,net_banking_transfer,2307.44
61b6faa7d8beac1599eb08c9,50200023535069,806711.2,60ec41ba55c00300382672d9,HDFC,Revenue-Mktplace,5eecc6d6449e4f7cfb1c2708,2020-09-23T00:00:00.000Z,NEFT CR-ICIC0000105-MANASH LIFETYLE PVT LTD-SLICK ORGANICS PRIVATE LIMITED MP MU M-ICIB202670031640,,,net_banking_transfer,1142.61
61b6faa8d8beac1599eb08ce,50200023535069,906127.27,60ec41ba55c00300382672d9,HDFC,Revenue-PG-non-split,5eecc6d6449e4f7cfb1c2708,2020-09-24T00:00:00.000Z,UPI-PAYTM-PAYOUTS@PAYTM-PYTM0123456-0268 05216672-ALL202009242168200,ewallet,,upi,99416.07
61b6faa9d8beac1599eb08d8,50200023535069,806127.27,60ec41ba55c00300382672d9,HDFC,direct expenses,5eecc6d6449e4f7cfb1c2708,2020-09-24T00:00:00.000Z,50200001182150-TPT-100000-DEXTER CAPITAL ADVISORS PVT LTD,,,net_banking_transfer,-100000
61b6faaad8beac1599eb08da,50200023535069,805124.27,60ec41ba55c00300382672d9,HDFC,direct expenses,5eecc6d6449e4f7cfb1c2708,2020-09-24T00:00:00.000Z,02711600008220-TPT-1003-VARUN SINGH,,,net_banking_transfer,-1003
61b6faabd8beac1599eb08e0,50200023535069,505124.27,60ec41ba55c00300382672d9,HDFC,Internal Transfers,5eecc6d6449e4f7cfb1c2708,2020-09-24T00:00:00.000Z,02711600008220-TPT-300000-VARUN SINGH,,,net_banking_transfer,-300000
61b6faacd8beac1599eb08e5,50200023535069,205124.27,60ec41ba55c00300382672d9,HDFC,direct expenses,5eecc6d6449e4f7cfb1c2708,2020-09-24T00:00:00.000Z,IB FUNDS TRANSFER DR-50200035187206 -SL ICK ORGANICS PVT LTD,investments,,net_banking_transfer,-300000
61b6faadd8beac1599eb08ea,50200023535069,322516.54,60ec41ba55c00300382672d9,HDFC,Revenue-PG-split enabled,5eecc6d6449e4f7cfb1c2708,2020-09-24T00:00:00.000Z,NEFT CR-UTIB0001506-RAZORPAY SOFTWARE PR IVATE LIMITED-SLICK ORGANICS PVT LITD-AX ISCN0057644676,investments,,net_banking_transfer,117392.27
61b6faaed8beac1599eb08ef,50200023535069,323919.8,60ec41ba55c00300382672d9,HDFC,Revenue-Mktplace,5eecc6d6449e4f7cfb1c2708,2020-09-24T00:00:00.000Z,4060000929-TIMES INTERNET LIMITED NODAL,,,Other,1403.26
61b6faafd8beac1599eb08f3,50200023535069,339917.85,60ec41ba55c00300382672d9,HDFC,Revenue-PG-split enabled,5eecc6d6449e4f7cfb1c2708,2020-09-24T00:00:00.000Z,NEFT CR-UTIB0001506-RAZORPAY SOFTWARE PR IVATE LIMITED-SLICK ORGANICS PVT LITD-AX ISCN0057709102,investments,,net_banking_transfer,15998.05
61b6fab0d8beac1599eb08f8,50200023535069,348252.09,60ec41ba55c00300382672d9,HDFC,Revenue-PG-non-split,5eecc6d6449e4f7cfb1c2708,2020-09-25T00:00:00.000Z,IMPS-026905200308-PAYTM-HDFC-XXXXXXXXXX0 007-,ewallet,,net_banking_transfer,8334.24
61b6fab1d8beac1599eb08fe,50200023535069,353544.19,60ec41ba55c00300382672d9,HDFC,Revenue-Mktplace,5eecc6d6449e4f7cfb1c2708,2020-09-25T00:00:00.000Z,NEFT CR-DEUT0797BGL-FLIPKART INTERNET P LTD-INT AC FO R INTERMEDIARY-SLICK ORGAN ICS PVT LTD-092500113GN00207,shopping,,net_banking_transfer,5292.1
61b6fab2d8beac1599eb0904,50200023535069,375313.71,60ec41ba55c00300382672d9,HDFC,Revenue-PG-split enabled,5eecc6d6449e4f7cfb1c2708,2020-09-25T00:00:00.000Z,NEFT CR-UTIB0001506-RAZORPAY SOFTWARE PR IVATE LIMITED-SLICK ORGANICS PVT LITD-AX ISCN0057735161,investments,,net_banking_transfer,21769.52
61b6fab3d8beac1599eb090b,50200023535069,376552.93,60ec41ba55c00300382672d9,HDFC,Revenue-Mktplace,5eecc6d6449e4f7cfb1c2708,2020-09-25T00:00:00.000Z,NEFT CR-DEUT0797BGL-MYNTRA DESIGNS PRIVA TE LIMITED-SLICK ORGANICS PRIVATE LIMITE D-092500163GN00016,shopping,,net_banking_transfer,1239.22
61b6fab4d8beac1599eb0910,50200023535069,326552.93,60ec41ba55c00300382672d9,HDFC,SAAS/tech expense,5eecc6d6449e4f7cfb1c2708,2020-09-25T00:00:00.000Z,POS 514834XXXXXX9486 AMAZON,shopping,,debit_card,-50000
61b6fab5d8beac1599eb0915,50200023535069,276552.93,60ec41ba55c00300382672d9,HDFC,SAAS/tech expense,5eecc6d6449e4f7cfb1c2708,2020-09-25T00:00:00.000Z,POS 514834XXXXXX9486 AMAZON,shopping,,debit_card,-50000
61b6fab6d8beac1599eb091b,50200023535069,277499.48,60ec41ba55c00300382672d9,HDFC,Transfer in/Revenue-other,5eecc6d6449e4f7cfb1c2708,2020-09-25T00:00:00.000Z,NEFT CR-ICIC0SF0002-ICICI BANK NODAL ACC -SLICK ORGANICS-22804835161DC,investments,,net_banking_transfer,946.55
61b6fab7d8beac1599eb091f,50200023535069,257499.48,60ec41ba55c00300382672d9,HDFC,direct expenses,5eecc6d6449e4f7cfb1c2708,2020-09-25T00:00:00.000Z,"SELF - CHQ PAID - KALKAJI, NEW",,,chq,-20000
61b6fab8d8beac1599eb0923,50200023535069,242499.48,60ec41ba55c00300382672d9,HDFC,direct expenses,5eecc6d6449e4f7cfb1c2708,2020-09-25T00:00:00.000Z,"NEFT DR-CITI0000027-RISHIEKA JAINI-NETBA NK, MUM-N269201254456460-15000",,,net_banking_transfer,-15000
61b6fab9d8beac1599eb0929,50200023535069,255025.12,60ec41ba55c00300382672d9,HDFC,Revenue-COD,5eecc6d6449e4f7cfb1c2708,2020-09-25T00:00:00.000Z,NEFT CR-KKBK0000958-BIGFOOT RETAIL SOLUT IONS PRIVATE LIMITED-SLICK ORGANICS PVT LTD-KKBK202691589344,,,net_banking_transfer,12525.64
61b6fabad8beac1599eb092c,50200023535069,257837.37,60ec41ba55c00300382672d9,HDFC,Revenue-Mktplace,5eecc6d6449e4f7cfb1c2708,2020-09-25T00:00:00.000Z,NEFT CR-DEUT0797BGL-FLIPKART INTERNET PV TLTD-SLICK ORGANICS PVT LTD-092500083GN0 0259,shopping,,net_banking_transfer,2812.25
61b6fabad8beac1599eb0936,50200023535069,258125.8,60ec41ba55c00300382672d9,HDFC,Revenue-Mktplace,5eecc6d6449e4f7cfb1c2708,2020-09-25T00:00:00.000Z,NEFT CR-ICIC0000105-MANASH LIFETYLE PVT LTD-SLICK ORGANICS PRIVATE LIMITED MP GG N-ICIB202690041308,,,net_banking_transfer,288.43
61b6fabbd8beac1599eb093b,50200023535069,258414.23,60ec41ba55c00300382672d9,HDFC,Revenue-Mktplace,5eecc6d6449e4f7cfb1c2708,2020-09-25T00:00:00.000Z,NEFT CR-ICIC0000105-MANASH LIFETYLE PVT LTD-SLICK ORGANICS PRIVATE LIMITED MP MU M-ICIB202690041309,,,net_banking_transfer,288.43
61b6fabcd8beac1599eb093e,50200023535069,264554.23,60ec41ba55c00300382672d9,HDFC,Revenue-Mktplace,5eecc6d6449e4f7cfb1c2708,2020-09-25T00:00:00.000Z,NEFT CR-SCBL0036001-DREAMPLUG TECHNOLOGI ES PRIVATE LIMI-SLICK ORGANICS PRIVATE L IMITEDSLICK-SIN31436Q0005793,,,net_banking_transfer,6140
61b6fabdd8beac1599eb0949,50200023535069,279363.48,60ec41ba55c00300382672d9,HDFC,Revenue-PG-split enabled,5eecc6d6449e4f7cfb1c2708,2020-09-25T00:00:00.000Z,NEFT CR-UTIB0001506-RAZORPAY SOFTWARE PR IVATE LIMITED-SLICK ORGANICS PVT LITD-AX ISCN0057782110,investments,,net_banking_transfer,14809.25
61b6fabed8beac1599eb094b,50200023535069,281603.06,60ec41ba55c00300382672d9,HDFC,Revenue-Mktplace,5eecc6d6449e4f7cfb1c2708,2020-09-25T00:00:00.000Z,NEFT CR-DEUT0784BBY-TATA UNISTORE LTD-NO DAL-SLICK ORGANICS PVT LTD-092501390GN00 257,investments,,net_banking_transfer,2239.58
61b6fabfd8beac1599eb0951,50200023535069,1603.06,60ec41ba55c00300382672d9,HDFC,direct expenses,5eecc6d6449e4f7cfb1c2708,2020-09-25T00:00:00.000Z,KQQHY74MA54K7P6TCY/PAYUMONEY,,,Other,-280000
61b6fac0d8beac1599eb0955,50200023535069,9454.5,60ec41ba55c00300382672d9,HDFC,Revenue-PG-non-split,5eecc6d6449e4f7cfb1c2708,2020-09-26T00:00:00.000Z,IMPS-027005182727-PAYTM-HDFC-XXXXXXXXXX0 007-,ewallet,,net_banking_transfer,7851.44
61b6fac1d8beac1599eb095a,50200023535069,15893.68,60ec41ba55c00300382672d9,HDFC,Revenue-PG-non-split,5eecc6d6449e4f7cfb1c2708,2020-09-27T00:00:00.000Z,UPI-PAYTM-PAYOUTS@PAYTM-PYTM0123456-0271,ewallet,,upi,6439.18
61b6fac2d8beac1599eb095e,50200023535069,22271.93,60ec41ba55c00300382672d9,HDFC,Revenue-PG-non-split,5eecc6d6449e4f7cfb1c2708,2020-09-28T00:00:00.000Z,IMPS-027205279709-PAYTM-HDFC-XXXXXXXXXX0 007-,ewallet,,net_banking_transfer,6378.25
61b6fac3d8beac1599eb0962,50200023535069,25659.1,60ec41ba55c00300382672d9,HDFC,Revenue-Mktplace,5eecc6d6449e4f7cfb1c2708,2020-09-28T00:00:00.000Z,NEFT CR-DEUT0797BGL-FLIPKART INTERNET P LTD-INT AC FO R INTERMEDIARY-SLICK ORGAN ICS PVT LTD-092800920GN00019,shopping,,net_banking_transfer,3387.17
61b6fac4d8beac1599eb0969,50200023535069,22020.5,60ec41ba55c00300382672d9,HDFC,direct expenses,5eecc6d6449e4f7cfb1c2708,2020-09-28T00:00:00.000Z,POS 514834XXXXXX9486 FRESHWORKS INC,,,debit_card,-3638.6
61b6fac5d8beac1599eb096e,50200023535069,107441.69,60ec41ba55c00300382672d9,HDFC,Revenue-PG-split enabled,5eecc6d6449e4f7cfb1c2708,2020-09-28T00:00:00.000Z,NEFT CR-UTIB0001506-RAZORPAY SOFTWARE PR IVATE LIMITED-SLICK ORGANICS PVT LITD-AX ISCN0057824504,investments,,net_banking_transfer,85421.19
61b6fac6d8beac1599eb0973,50200023535069,69441.69,60ec41ba55c00300382672d9,HDFC,direct expenses,5eecc6d6449e4f7cfb1c2708,2020-09-28T00:00:00.000Z,IMPS-027209145421-PAYTM-PYTM-XXXXXXXX383 9-38000,ewallet,,net_banking_transfer,-38000
61b6fac7d8beac1599eb097a,50200023535069,72445.56,60ec41ba55c00300382672d9,HDFC,Revenue-Mktplace,5eecc6d6449e4f7cfb1c2708,2020-09-28T00:00:00.000Z,NEFT CR-DEUT0797BGL-FLIPKART INTERNET PV TLTD-SLICK ORGANICS PVT LTD-092800949GN0 0135,shopping,,net_banking_transfer,3003.87
61b6fac8d8beac1599eb098f,50200023535069,72415.12,60ec41ba55c00300382672d9,HDFC,bank charges,5eecc6d6449e4f7cfb1c2708,2020-09-28T00:00:00.000Z,.DC INTL POS TXN MARKUP+ST 160920 180920 -CDT2025201211390,,,international_transaction_arbitrage,-30.44
61b6fac9d8beac1599eb0996,50200023535069,83737.12,60ec41ba55c00300382672d9,HDFC,Revenue-PG-split enabled,5eecc6d6449e4f7cfb1c2708,2020-09-28T00:00:00.000Z,NEFT CR-UTIB0001506-RAZORPAY SOFTWARE PR IVATE LIMITED-SLICK ORGANICS PVT LITD-AX ISCN0057889286,investments,,net_banking_transfer,11322
61b6facad8beac1599eb099a,50200023535069,84803.36,60ec41ba55c00300382672d9,HDFC,Revenue-Mktplace,5eecc6d6449e4f7cfb1c2708,2020-09-28T00:00:00.000Z,NEFT CR-ICIC0000105-MANASH LIFETYLE PVT LTD-SLICK ORGANICS PRIVATE LIMITED MP GG N-ICIB202720037121,,,net_banking_transfer,1066.24
61b6facbd8beac1599eb09a2,50200023535069,85487,60ec41ba55c00300382672d9,HDFC,Revenue-Mktplace,5eecc6d6449e4f7cfb1c2708,2020-09-28T00:00:00.000Z,NEFT CR-ICIC0000105-MANASH LIFETYLE PVT LTD-SLICK ORGANICS PRIVATE LIMITED MP MU M-ICIB202720037122,,,net_banking_transfer,683.64
61b6faccd8beac1599eb09a5,50200023535069,84379.64,60ec41ba55c00300382672d9,HDFC,direct expenses,5eecc6d6449e4f7cfb1c2708,2020-09-29T00:00:00.000Z,POS 514834XXXXXX9486 ZOOM.US,,,debit_card,-1107.36
61b6facdd8beac1599eb09aa,50200023535069,93371.99,60ec41ba55c00300382672d9,HDFC,Revenue-PG-non-split,5eecc6d6449e4f7cfb1c2708,2020-09-29T00:00:00.000Z,UPI-PAYTM-PAYOUTS@PAYTM-PYTM0123456-0273 85888936-ALL202009292168200,ewallet,,upi,8992.35
61b6faced8beac1599eb09b6,50200023535069,112391.63,60ec41ba55c00300382672d9,HDFC,Revenue-PG-split enabled,5eecc6d6449e4f7cfb1c2708,2020-09-29T00:00:00.000Z,NEFT CR-UTIB0001506-RAZORPAY SOFTWARE PR IVATE LIMITED-SLICK ORGANICS PVT LITD-AX ISCN0057911544,investments,,net_banking_transfer,19019.64
61b6facfd8beac1599eb09bc,50200023535069,155645.14,60ec41ba55c00300382672d9,HDFC,Revenue-Mktplace,5eecc6d6449e4f7cfb1c2708,2020-09-29T00:00:00.000Z,IMPS-027311156165-AMAZON SELLER SERVIC-H,shopping,,net_banking_transfer,43253.51
61b6fad0d8beac1599eb09c1,50200023535069,367883.09,60ec41ba55c00300382672d9,HDFC,Revenue-Mktplace,5eecc6d6449e4f7cfb1c2708,2020-09-29T00:00:00.000Z,NEFT CR-DEUT0797BGL-AMAZON PAY IND PVT L TD-INT AC INTM MKTPLACE-SLICK ORGANICS P VT LTD-092901984GN00341,shopping,,net_banking_transfer,212237.95
61b6fad1d8beac1599eb09c9,50200023535069,67883.09,60ec41ba55c00300382672d9,HDFC,direct expenses,5eecc6d6449e4f7cfb1c2708,2020-09-29T00:00:00.000Z,02711600008220-TPT-300000-VARUN SINGH,,,net_banking_transfer,-300000
61b6fad2d8beac1599eb09ec,50200023535069,68333.91,60ec41ba55c00300382672d9,HDFC,Revenue-Mktplace,5eecc6d6449e4f7cfb1c2708,2020-09-29T00:00:00.000Z,NEFT CR-ICIC0000105-MANASH LIFETYLE PVT LTD-SLICK ORGANICS PRIVATE LIMITED MP GG N-ICIB202730026375,,,net_banking_transfer,450.82
61b6fad3d8beac1599eb09f2,50200023535069,78749.13,60ec41ba55c00300382672d9,HDFC,Revenue-PG-split enabled,5eecc6d6449e4f7cfb1c2708,2020-09-29T00:00:00.000Z,NEFT CR-UTIB0001506-RAZORPAY SOFTWARE PR IVATE LIMITED-SLICK ORGANICS PVT LITD-AX ISCN0057972533,investments,,net_banking_transfer,10415.22
61b6fad4d8beac1599eb0a03,50200023535069,87188.88,60ec41ba55c00300382672d9,HDFC,Revenue-PG-non-split,5eecc6d6449e4f7cfb1c2708,2020-09-30T00:00:00.000Z,UPI-PAYTM-PAYOUTS@PAYTM-PYTM0123456-0274 01728152-ALL202009302168200,ewallet,,upi,8439.75
61b6fad5d8beac1599eb0a0c,50200023535069,104534.17,60ec41ba55c00300382672d9,HDFC,Revenue-PG-split enabled,5eecc6d6449e4f7cfb1c2708,2020-09-30T00:00:00.000Z,NEFT CR-UTIB0001506-RAZORPAY SOFTWARE PR IVATE LIMITED-SLICK ORGANICS PVT LITD-AX ISCN0057991540,investments,,net_banking_transfer,17345.29
61b6fad6d8beac1599eb0a1e,50200023535069,94534.17,60ec41ba55c00300382672d9,HDFC,SAAS/tech expense,5eecc6d6449e4f7cfb1c2708,2020-09-30T00:00:00.000Z,SHDF9276833791/BILLDKAMAZONSELLERSE,shopping,,Other,-10000
61b6fad6d8beac1599eb0a2a,50200023535069,95000.56,60ec41ba55c00300382672d9,HDFC,Revenue-Mktplace,5eecc6d6449e4f7cfb1c2708,2020-09-30T00:00:00.000Z,NEFT CR-ICIC0000105-MANASH LIFETYLE PVT LTD-SLICK ORGANICS PRIVATE LIMITED MP MU M-ICIB202740037253,,,net_banking_transfer,466.39
61b6fad7d8beac1599eb0a39,50200023535069,103810.47,60ec41ba55c00300382672d9,HDFC,Revenue-PG-split enabled,5eecc6d6449e4f7cfb1c2708,2020-09-30T00:00:00.000Z,NEFT CR-UTIB0001506-RAZORPAY SOFTWARE PR IVATE LIMITED-SLICK ORGANICS PVT LITD-AX ISCN0058067725,investments,,net_banking_transfer,8809.91
61b6fad8d8beac1599eb0a48,50200023535069,133973.02,60ec41ba55c00300382672d9,HDFC,Revenue-COD,5eecc6d6449e4f7cfb1c2708,2020-09-30T00:00:00.000Z,NEFT CR-KKBK0000958-BIGFOOT RETAIL SOLUT,,,net_banking_transfer,30162.55
61b6fad9d8beac1599eb0a4e,50200023535069,136310.64,60ec41ba55c00300382672d9,HDFC,Revenue-PG-non-split,5eecc6d6449e4f7cfb1c2708,2020-10-01T00:00:00.000Z,UPI-PAYTM-PAYOUTS@PAYTM-PYTM0123456-0275 18577440-ALL202010012168200,ewallet,,upi,2337.62
61b6fadad8beac1599eb0a55,50200023535069,142143.72,60ec41ba55c00300382672d9,HDFC,Revenue-PG-split enabled,5eecc6d6449e4f7cfb1c2708,2020-10-01T00:00:00.000Z,NEFT CR-UTIB0001506-RAZORPAY SOFTWARE PR IVATE LIMITED-SLICK ORGANICS PVT LITD-AX ISCN0058097128,investments,,net_banking_transfer,5833.08
61b6fadbd8beac1599eb0a67,50200023535069,143264.64,60ec41ba55c00300382672d9,HDFC,Transfer in/Revenue-other,5eecc6d6449e4f7cfb1c2708,2020-10-01T00:00:00.000Z,NEFT CR-ICIC0SF0002-TRELL EXPERIENCES PR -SLICK ORGANICS PVT LTD-22833435161DC,investments,,net_banking_transfer,1120.92
61b6fadcd8beac1599eb0a6c,50200023535069,141130.01,60ec41ba55c00300382672d9,HDFC,direct expenses,5eecc6d6449e4f7cfb1c2708,2020-10-01T00:00:00.000Z,POS 514834XXXXXX9486 SEOPTIMER,,,debit_card,-2134.63
61b6faddd8beac1599eb0a74,50200023535069,143835.07,60ec41ba55c00300382672d9,HDFC,Revenue-Mktplace,5eecc6d6449e4f7cfb1c2708,2020-10-01T00:00:00.000Z,NEFT CR-DEUT0797BGL-MYNTRA DESIGNS PRIVA TE LIMITED-SLICK ORGANICS PRIVATE LIMITE D-100103752GN00117,shopping,,net_banking_transfer,2705.06
61b6faded8beac1599eb0a7b,50200023535069,113835.07,60ec41ba55c00300382672d9,HDFC,direct expenses,5eecc6d6449e4f7cfb1c2708,2020-10-01T00:00:00.000Z,"SELF - CHQ PAID - KALKAJI, NEW",,,chq,-30000
61b6fadfd8beac1599eb0a81,50200023535069,113622.29,60ec41ba55c00300382672d9,HDFC,bank charges,5eecc6d6449e4f7cfb1c2708,2020-10-01T00:00:00.000Z,.DC INTL POS TXN MARKUP+ST 190920 220920 -CDT2027501367947,,,international_transaction_arbitrage,-212.78
61b6fae0d8beac1599eb0a87,50200023535069,113351.68,60ec41ba55c00300382672d9,HDFC,bank charges,5eecc6d6449e4f7cfb1c2708,2020-10-01T00:00:00.000Z,.DC INTL POS TXN MARKUP+ST 200920 220920 -CDT2027501367947,,,international_transaction_arbitrage,-270.61
61b6fae1d8beac1599eb0a8d,50200023535069,1113351.68,60ec41ba55c00300382672d9,HDFC,Internal Transfers,5eecc6d6449e4f7cfb1c2708,2020-10-01T00:00:00.000Z,IB FUNDS TRANSFER CR-50200035187206 -SL ICK ORGANICS PVT LTD,investments,,Other,1000000
61b6fae2d8beac1599eb0a97,50200023535069,913351.68,60ec41ba55c00300382672d9,HDFC,direct expenses,5eecc6d6449e4f7cfb1c2708,2020-10-01T00:00:00.000Z,IMPS-027514192841-PAYTM-PYTM-XXXXXXXX383 9-200000,ewallet,,net_banking_transfer,-200000
61b6fae3d8beac1599eb0a9e,50200023535069,543351.68,60ec41ba55c00300382672d9,HDFC,direct expenses,5eecc6d6449e4f7cfb1c2708,2020-10-01T00:00:00.000Z,"NEFT DR-YESB0000551-VISTTA COSMETICS-NET BANK, MUM-N275201261312225-370000",,,net_banking_transfer,-370000
61b6fae4d8beac1599eb0aa5,50200023535069,343351.68,60ec41ba55c00300382672d9,HDFC,direct expenses,5eecc6d6449e4f7cfb1c2708,2020-10-01T00:00:00.000Z,IMPS-027515102360-PAYTM-PYTM-XXXXXXXX383 9-200000,ewallet,,net_banking_transfer,-200000
61b6fae5d8beac1599eb0aaf,50200023535069,88351.68,60ec41ba55c00300382672d9,HDFC,SAAS/tech expense,5eecc6d6449e4f7cfb1c2708,2020-10-01T00:00:00.000Z,SHDF9281084327/BILLDKAMAZONSELLERSE,shopping,,Other,-255000
61b6fae6d8beac1599eb0ab7,50200023535069,18351.68,60ec41ba55c00300382672d9,HDFC,direct expenses,5eecc6d6449e4f7cfb1c2708,2020-10-01T00:00:00.000Z,IMPS-027515119734-PAYTM-PYTM-XXXXXXXX383 9-70000,ewallet,,net_banking_transfer,-70000
61b6fae7d8beac1599eb0ac1,50200023535069,19619.53,60ec41ba55c00300382672d9,HDFC,Revenue-Mktplace,5eecc6d6449e4f7cfb1c2708,2020-10-01T00:00:00.000Z,NEFT CR-DEUT0784BBY-TATA UNISTORE LTD-NO,,,net_banking_transfer,1267.85
61b6fae8d8beac1599eb0ac7,50200023535069,292755.53,60ec41ba55c00300382672d9,HDFC,Revenue-Mktplace,5eecc6d6449e4f7cfb1c2708,2020-10-01T00:00:00.000Z,NEFT CR-KKBK0000958-NATURALLY YOU AND ME -SLICK ORGANICS PVT LTD-KKBKH20275715270,investments,,net_banking_transfer,273136
61b6fae9d8beac1599eb0ad0,50200023535069,303600.58,60ec41ba55c00300382672d9,HDFC,Revenue-PG-split enabled,5eecc6d6449e4f7cfb1c2708,2020-10-01T00:00:00.000Z,NEFT CR-UTIB0001506-RAZORPAY SOFTWARE PR IVATE LIMITED-SLICK ORGANICS PVT LITD-AX ISCN0058181284,investments,,net_banking_transfer,10845.05
61b6faead8beac1599eb0ad5,50200023535069,307096.13,60ec41ba55c00300382672d9,HDFC,Revenue-PG-non-split,5eecc6d6449e4f7cfb1c2708,2020-10-02T00:00:00.000Z,IMPS-027605009877-PAYTM-HDFC-XXXXXXXXXX0 007-,ewallet,,net_banking_transfer,3495.55
61b6faebd8beac1599eb0ade,50200023535069,297930.18,60ec41ba55c00300382672d9,HDFC,direct expenses,5eecc6d6449e4f7cfb1c2708,2020-10-02T00:00:00.000Z,POS 514834XXXXXX9486 STK*SHUTTERSTOCK,,,debit_card,-9165.95
61b6faecd8beac1599eb0ae3,50200023535069,293211.36,60ec41ba55c00300382672d9,HDFC,direct expenses,5eecc6d6449e4f7cfb1c2708,2020-10-02T00:00:00.000Z,POS 514834XXXXXX4081 ONLINE PAYMENT,,,debit_card,-4718.82
61b6faedd8beac1599eb0af0,50200023535069,306318.48,60ec41ba55c00300382672d9,HDFC,Revenue-PG-non-split,5eecc6d6449e4f7cfb1c2708,2020-10-03T00:00:00.000Z,UPI-PAYTM-PAYOUTS@PAYTM-PYTM0123456-0277 52003228-ALL202010032168200,ewallet,,upi,13107.12
61b6faeed8beac1599eb0af5,50200023535069,106318.48,60ec41ba55c00300382672d9,HDFC,direct expenses,5eecc6d6449e4f7cfb1c2708,2020-10-03T00:00:00.000Z,"NEFT DR-SCBL0036025-DHRUV MADHOK-NETBANK , MUM-N277201262556352-200000",,,net_banking_transfer,-200000
61b6faefd8beac1599eb0afe,50200023535069,139615.32,60ec41ba55c00300382672d9,HDFC,Revenue-PG-split enabled,5eecc6d6449e4f7cfb1c2708,2020-10-03T00:00:00.000Z,NEFT CR-UTIB0001506-RAZORPAY SOFTWARE PR IVATE LIMITED-SLICK ORGANICS PVT LITD-AX ISCN0058208981,investments,,net_banking_transfer,33296.84
61b6faefd8beac1599eb0b06,50200023535069,1139615.32,60ec41ba55c00300382672d9,HDFC,Internal Transfers,5eecc6d6449e4f7cfb1c2708,2020-10-03T00:00:00.000Z,IB FUNDS TRANSFER CR-50200035187206 -SL ICK ORGANICS PVT LTD,investments,,Other,1000000
61b6faf0d8beac1599eb0b0a,50200023535069,939615.32,60ec41ba55c00300382672d9,HDFC,direct expenses,5eecc6d6449e4f7cfb1c2708,2020-10-03T00:00:00.000Z,KQQH64UEAN42HO63CA/PAYUMONEY,,,Other,-200000
61b6faf1d8beac1599eb0b10,50200023535069,739615.32,60ec41ba55c00300382672d9,HDFC,direct expenses,5eecc6d6449e4f7cfb1c2708,2020-10-03T00:00:00.000Z,02711930004579-TPT-200000-DHRUV BHASIN,,,net_banking_transfer,-200000
61b6faf2d8beac1599eb0b16,50200023535069,675466.32,60ec41ba55c00300382672d9,HDFC,direct expenses,5eecc6d6449e4f7cfb1c2708,2020-10-03T00:00:00.000Z,"NEFT DR-YESB0000109-JERONONE TECHNOLOGIE S-NETBANK, MUM-N277201263118673-64149",,,net_banking_transfer,-64149
61b6faf3d8beac1599eb0b1b,50200023535069,475164.32,60ec41ba55c00300382672d9,HDFC,direct expenses,5eecc6d6449e4f7cfb1c2708,2020-10-03T00:00:00.000Z,"NEFT DR-ORBC0101001-KRAUTER HEALTHCARE L TD-NETBANK, MUM-N277201263143664-200302",,,net_banking_transfer,-200302
61b6faf4d8beac1599eb0b24,50200023535069,170168.32,60ec41ba55c00300382672d9,HDFC,direct expenses,5eecc6d6449e4f7cfb1c2708,2020-10-03T00:00:00.000Z,02711600008220-TPT-304996-VARUN SINGH,,,net_banking_transfer,-304996
61b6faf6d8beac1599eb0b2c,50200023535069,175135.77,60ec41ba55c00300382672d9,HDFC,Revenue-Mktplace,5eecc6d6449e4f7cfb1c2708,2020-10-03T00:00:00.000Z,NEFT CR-DEUT0797BGL-FLIPKART INTERNET P LTD-INT AC FO R INTERMEDIARY-SLICK ORGAN ICS PVT LTD-100304299GN00140,shopping,,net_banking_transfer,4967.45
61b6faf8d8beac1599eb0b37,50200023535069,176296.06,60ec41ba55c00300382672d9,HDFC,Revenue-PG-split enabled,5eecc6d6449e4f7cfb1c2708,2020-10-03T00:00:00.000Z,NEFT CR-UTIB0001506-RAZORPAY SOFTWARE PR IVATE LIMITED-SLICK ORGANICS PVT LITD-AX ISCN0058241799,investments,,net_banking_transfer,1160.29
61b6fb23d8beac1599eb0bc8,50200023535069,181254.74,60ec41ba55c00300382672d9,HDFC,Revenue-PG-non-split,5eecc6d6449e4f7cfb1c2708,2020-10-04T00:00:00.000Z,UPI-PAYTM-PAYOUTS@PAYTM-PYTM0123456-0278,ewallet,,upi,4958.68
61b6fb24d8beac1599eb0bd1,50200023535069,189341.08,60ec41ba55c00300382672d9,HDFC,Revenue-PG-non-split,5eecc6d6449e4f7cfb1c2708,2020-10-05T00:00:00.000Z,IMPS-027905416872-PAYTM-HDFC-XXXXXXXXXX0 007-,ewallet,,net_banking_transfer,8086.34
61b6fb25d8beac1599eb0bd6,50200023535069,191350.81,60ec41ba55c00300382672d9,HDFC,Revenue-Mktplace,5eecc6d6449e4f7cfb1c2708,2020-10-05T00:00:00.000Z,NEFT CR-DEUT0797BGL-FLIPKART INTERNET P LTD-INT AC FO R INTERMEDIARY-SLICK ORGAN ICS PVT LTD-100505484GN00193,shopping,,net_banking_transfer,2009.73
61b6fb26d8beac1599eb0bd9,50200023535069,219989.58,60ec41ba55c00300382672d9,HDFC,Revenue-PG-split enabled,5eecc6d6449e4f7cfb1c2708,2020-10-05T00:00:00.000Z,NEFT CR-UTIB0001506-RAZORPAY SOFTWARE PR IVATE LIMITED-SLICK ORGANICS PVT LITD-AX ISCN0058259214,investments,,net_banking_transfer,28638.77
61b6fb27d8beac1599eb0bdd,50200023535069,220281.13,60ec41ba55c00300382672d9,HDFC,Revenue-Mktplace,5eecc6d6449e4f7cfb1c2708,2020-10-05T00:00:00.000Z,NEFT CR-DEUT0797BGL-MYNTRA DESIGNS PRIVA TE LIMITED-SLICK ORGANICS PRIVATE LIMITE D-100505548GN00111,shopping,,net_banking_transfer,291.55
61b6fb28d8beac1599eb0be1,50200023535069,221926.82,60ec41ba55c00300382672d9,HDFC,Transfer in/Revenue-other,5eecc6d6449e4f7cfb1c2708,2020-10-05T00:00:00.000Z,NEFT CR-ICIC0SF0002-ICICI BANK NODAL ACC -SLICK ORGANICS-22853017071DC,investments,,net_banking_transfer,1645.69
61b6fb29d8beac1599eb0be5,50200023535069,224906.67,60ec41ba55c00300382672d9,HDFC,Revenue-Mktplace,5eecc6d6449e4f7cfb1c2708,2020-10-05T00:00:00.000Z,NEFT CR-DEUT0797BGL-FLIPKART INTERNET PV TLTD-SLICK ORGANICS PVT LTD-100304261GN0 0286,shopping,,net_banking_transfer,2979.85
61b6fb2ad8beac1599eb0be9,50200023535069,59426.67,60ec41ba55c00300382672d9,HDFC,direct expenses,5eecc6d6449e4f7cfb1c2708,2020-10-05T00:00:00.000Z,05892560000649-TPT-165480-DECORPAC INDIA PRIVATE LIMITED,,,net_banking_transfer,-165480
61b6fb2bd8beac1599eb0bf0,50200023535069,60282.95,60ec41ba55c00300382672d9,HDFC,Revenue-Mktplace,5eecc6d6449e4f7cfb1c2708,2020-10-05T00:00:00.000Z,NEFT CR-DEUT0797BGL-FLIPKART INTERNET PV TLTD-SLICK ORGANICS PVT LTD-100505524GN0 0005,shopping,,net_banking_transfer,856.28
61b6fb2cd8beac1599eb0bf3,50200023535069,74436.17,60ec41ba55c00300382672d9,HDFC,Revenue-PG-split enabled,5eecc6d6449e4f7cfb1c2708,2020-10-05T00:00:00.000Z,NEFT CR-UTIB0001506-RAZORPAY SOFTWARE PR IVATE LIMITED-SLICK ORGANICS PVT LITD-AX ISCN0058316812,investments,,net_banking_transfer,14153.22
61b6fb2dd8beac1599eb0bfb,50200023535069,115033.97,60ec41ba55c00300382672d9,HDFC,Revenue-COD,5eecc6d6449e4f7cfb1c2708,2020-10-05T00:00:00.000Z,NEFT CR-KKBK0000958-BIGFOOT RETAIL SOLUT IONS PRIVATE LIMITED-SLICK ORGANICS PVT LTD-KKBK202793448562,,,net_banking_transfer,40597.8
61b6fb2ed8beac1599eb0c01,50200023535069,121418.24,60ec41ba55c00300382672d9,HDFC,Revenue-PG-non-split,5eecc6d6449e4f7cfb1c2708,2020-10-06T00:00:00.000Z,UPI-PAYTM-PAYOUTS@PAYTM-PYTM0123456-0280 02158518-ALL202010062168200,ewallet,,upi,6384.27
61b6fb2fd8beac1599eb0c06,50200023535069,141610.13,60ec41ba55c00300382672d9,HDFC,Revenue-PG-split enabled,5eecc6d6449e4f7cfb1c2708,2020-10-06T00:00:00.000Z,NEFT CR-UTIB0001506-RAZORPAY SOFTWARE PR,,,net_banking_transfer,20191.89
61b6fb30d8beac1599eb0c0a,50200023535069,192073.18,60ec41ba55c00300382672d9,HDFC,Revenue-Mktplace,5eecc6d6449e4f7cfb1c2708,2020-10-06T00:00:00.000Z,IMPS-028011326652-AMAZON SELLER SERVIC-H DFC-XXXXXXXX6004-11IBT2DC50RXFFRESLICK O RGANICS PVT LTD,shopping,,net_banking_transfer,50463.05
61b6fb31d8beac1599eb0c0d,50200023535069,410235.31,60ec41ba55c00300382672d9,HDFC,Revenue-Mktplace,5eecc6d6449e4f7cfb1c2708,2020-10-06T00:00:00.000Z,NEFT CR-DEUT0797BGL-AMAZON PAY IND PVT L TD-INT AC INTM MKTPLACE-SLICK ORGANICS P VT LTD-100606206GN00220,shopping,,net_banking_transfer,218162.13
61b6fb32d8beac1599eb0c11,50200023535069,411372.18,60ec41ba55c00300382672d9,HDFC,Revenue-Mktplace,5eecc6d6449e4f7cfb1c2708,2020-10-06T00:00:00.000Z,NEFT CR-KKBK0000958-SUPERMARKET GROCERY SUPPLIES PVT LTD-SLICK ORGANICS PVT LTD- KKBK202803666983,shopping,,net_banking_transfer,1136.87
61b6fb32d8beac1599eb0c18,50200023535069,414798.33,60ec41ba55c00300382672d9,HDFC,Revenue-Mktplace,5eecc6d6449e4f7cfb1c2708,2020-10-06T00:00:00.000Z,NEFT CR-KKBK0000958-SUPERMARKET GROCERY SUPPLIES PVT LTD-SLICK ORGANICS PVT LTD- KKBK202803667210,shopping,,net_banking_transfer,3426.15
61b6fb33d8beac1599eb0c1b,50200023535069,420155.6,60ec41ba55c00300382672d9,HDFC,Revenue-Mktplace,5eecc6d6449e4f7cfb1c2708,2020-10-06T00:00:00.000Z,NEFT CR-KKBK0000958-SUPERMARKET GROCERY SUPPLIES PVT LTD-SLICK ORGANICS PVT LTD- KKBK202803667332,shopping,,net_banking_transfer,5357.27
61b6fb34d8beac1599eb0c20,50200023535069,427541.86,60ec41ba55c00300382672d9,HDFC,Revenue-Mktplace,5eecc6d6449e4f7cfb1c2708,2020-10-06T00:00:00.000Z,NEFT CR-KKBK0000958-SUPERMARKET GROCERY SUPPLIES PVT LTD-SLICK ORGANICS PVT LTD- KKBK202803667331,shopping,,net_banking_transfer,7386.26
61b6fb35d8beac1599eb0c27,50200023535069,429441.81,60ec41ba55c00300382672d9,HDFC,Revenue-Mktplace,5eecc6d6449e4f7cfb1c2708,2020-10-06T00:00:00.000Z,NEFT CR-KKBK0000958-SUPERMARKET GROCERY SUPPLIES PVT LTD-SLICK ORGANICS PVT LTD- KKBK202803670152,shopping,,net_banking_transfer,1899.95
61b6fb36d8beac1599eb0c2c,50200023535069,436791.38,60ec41ba55c00300382672d9,HDFC,Revenue-Mktplace,5eecc6d6449e4f7cfb1c2708,2020-10-06T00:00:00.000Z,NEFT CR-KKBK0000958-SUPERMARKET GROCERY SUPPLIES PVT LTD-SLICK ORGANICS PVT LTD- KKBK202803670455,shopping,,net_banking_transfer,7349.57
61b6fb37d8beac1599eb0c33,50200023535069,440291.7,60ec41ba55c00300382672d9,HDFC,Revenue-Mktplace,5eecc6d6449e4f7cfb1c2708,2020-10-06T00:00:00.000Z,NEFT CR-KKBK0000958-SUPERMARKET GROCERY SUPPLIES PVT LTD-SLICK ORGANICS PVT LTD- KKBK202803673946,shopping,,net_banking_transfer,3500.32
61b6fb38d8beac1599eb0c37,50200023535069,449268.18,60ec41ba55c00300382672d9,HDFC,Revenue-PG-split enabled,5eecc6d6449e4f7cfb1c2708,2020-10-06T00:00:00.000Z,NEFT CR-UTIB0001506-RAZORPAY SOFTWARE PR IVATE LIMITED-SLICK ORGANICS PVT LITD-AX ISCN0058411102,investments,,net_banking_transfer,8976.48
61b6fb39d8beac1599eb0c5b,50200023535069,453987,60ec41ba55c00300382672d9,HDFC,Transfer in/Revenue-other,5eecc6d6449e4f7cfb1c2708,2020-10-06T00:00:00.000Z,POS 514834******4081 RVSL DT - 02/10/20,,,Other,4718.82
61b6fb3ad8beac1599eb0c5e,50200023535069,460051.5,60ec41ba55c00300382672d9,HDFC,Revenue-PG-non-split,5eecc6d6449e4f7cfb1c2708,2020-10-07T00:00:00.000Z,UPI-PAYTM-PAYOUTS@PAYTM-PYTM0123456-0281 19139608-ALL202010072168200,ewallet,,upi,6064.5
61b6fb3bd8beac1599eb0c62,50200023535069,560051.5,60ec41ba55c00300382672d9,HDFC,Internal Transfers,5eecc6d6449e4f7cfb1c2708,2020-10-07T00:00:00.000Z,IB FUNDS TRANSFER CR-50200050976833 -SL ICK ORGANICS PVT LTD,investments,,Other,100000
61b6fb3cd8beac1599eb0c67,50200023535069,1060051.5,60ec41ba55c00300382672d9,HDFC,Internal Transfers,5eecc6d6449e4f7cfb1c2708,2020-10-07T00:00:00.000Z,IB FUNDS TRANSFER CR-50200035187206 -SL ICK ORGANICS PVT LTD,investments,,Other,500000
61b6fb3dd8beac1599eb0c6b,50200023535069,986051.5,60ec41ba55c00300382672d9,HDFC,direct expenses,5eecc6d6449e4f7cfb1c2708,2020-10-07T00:00:00.000Z,"NEFT DR-CITI0000002-DHIRAJ-NETBANK, MUM- N281201266915985-74000",,,net_banking_transfer,-74000
61b6fb3ed8beac1599eb0c70,50200023535069,916051.5,60ec41ba55c00300382672d9,HDFC,direct expenses,5eecc6d6449e4f7cfb1c2708,2020-10-07T00:00:00.000Z,"NEFT DR-ICIC0000542-AVANTIKA SUKHIA-NETB ANK, MUM-N281201266916081-70000",,,net_banking_transfer,-70000
61b6fb3fd8beac1599eb0c76,50200023535069,901051.5,60ec41ba55c00300382672d9,HDFC,direct expenses,5eecc6d6449e4f7cfb1c2708,2020-10-07T00:00:00.000Z,"NEFT DR-SIBL0000555-JAIVEER KUMAR-NETBAN K, MUM-N281201266905328-15000",,,net_banking_transfer,-15000
61b6fb40d8beac1599eb0c7b,50200023535069,881051.5,60ec41ba55c00300382672d9,HDFC,direct expenses,5eecc6d6449e4f7cfb1c2708,2020-10-07T00:00:00.000Z,"NEFT DR-SBIN0001189-SANDEEP SINGH-NETBAN K, MUM-N281201266925357-20000",,,net_banking_transfer,-20000
61b6fb41d8beac1599eb0c86,50200023535069,871051.5,60ec41ba55c00300382672d9,HDFC,direct expenses,5eecc6d6449e4f7cfb1c2708,2020-10-07T00:00:00.000Z,"NEFT DR-PUNB0398000-MEENA SINGH-NETBANK, MUM-N281201266925480-10000",,,net_banking_transfer,-10000
61b6fb42d8beac1599eb0c8a,50200023535069,836051.5,60ec41ba55c00300382672d9,HDFC,direct expenses,5eecc6d6449e4f7cfb1c2708,2020-10-07T00:00:00.000Z,"NEFT DR-ICIC0003374-SIDDHARTH KANOJIA-NE TBANK, MUM-N281201266921120-35000",,,net_banking_transfer,-35000
61b6fb43d8beac1599eb0c8f,50200023535069,830051.5,60ec41ba55c00300382672d9,HDFC,direct expenses,5eecc6d6449e4f7cfb1c2708,2020-10-07T00:00:00.000Z,"NEFT DR-ALLA0210591-CHAMPA DEVI-NETBANK, MUM-N281201266921197-6000",,,net_banking_transfer,-6000
61b6fb44d8beac1599eb0c94,50200023535069,802426.5,60ec41ba55c00300382672d9,HDFC,direct expenses,5eecc6d6449e4f7cfb1c2708,2020-10-07T00:00:00.000Z,"NEFT DR-SYNB0005170-SNEHAL TAYDE-NETBANK , MUM-N281201266917682-27625",,,net_banking_transfer,-27625
61b6fb45d8beac1599eb0c9b,50200023535069,760726.5,60ec41ba55c00300382672d9,HDFC,direct expenses,5eecc6d6449e4f7cfb1c2708,2020-10-07T00:00:00.000Z,"NEFT DR-UTIB0000120-ADNAN ALI-NETBANK, M UM-N281201266922182-41700",,,net_banking_transfer,-41700
61b6fb46d8beac1599eb0c9f,50200023535069,668226.5,60ec41ba55c00300382672d9,HDFC,direct expenses,5eecc6d6449e4f7cfb1c2708,2020-10-07T00:00:00.000Z,"NEFT DR-BKDN0450123-ARTISTO DESIGNZ-NETB ANK, MUM-N281201266924310-92500",,,net_banking_transfer,-92500
61b6fb47d8beac1599eb0ca4,50200023535069,651726.5,60ec41ba55c00300382672d9,HDFC,direct expenses,5eecc6d6449e4f7cfb1c2708,2020-10-07T00:00:00.000Z,"NEFT DR-KKBK0000811-NASIR KHAN-NETBANK, MUM-N281201266931442-16500",,,net_banking_transfer,-16500
61b6fb47d8beac1599eb0ca9,50200023535069,581726.5,60ec41ba55c00300382672d9,HDFC,direct expenses,5eecc6d6449e4f7cfb1c2708,2020-10-07T00:00:00.000Z,50100301160692-TPT-70000-TARUN GARG,,,net_banking_transfer,-70000
61b6fb48d8beac1599eb0cad,50200023535069,549726.5,60ec41ba55c00300382672d9,HDFC,direct expenses,5eecc6d6449e4f7cfb1c2708,2020-10-07T00:00:00.000Z,00901610080520-TPT-32000-POOJA KAPIL SHR OTRIYA,,,net_banking_transfer,-32000
61b6fb49d8beac1599eb0cb4,50200023535069,449726.5,60ec41ba55c00300382672d9,HDFC,direct expenses,5eecc6d6449e4f7cfb1c2708,2020-10-07T00:00:00.000Z,02771610131904-TPT-100000-DIGANT BHATT,,,net_banking_transfer,-100000
61b6fb4ad8beac1599eb0cb9,50200023535069,383726.5,60ec41ba55c00300382672d9,HDFC,direct expenses,5eecc6d6449e4f7cfb1c2708,2020-10-07T00:00:00.000Z,50100330586095-TPT-66000-DIWAKAR UNIYAL,,,net_banking_transfer,-66000
61b6fb4bd8beac1599eb0cc2,50200023535069,353726.5,60ec41ba55c00300382672d9,HDFC,direct expenses,5eecc6d6449e4f7cfb1c2708,2020-10-07T00:00:00.000Z,"NEFT DR-SBIN0007976-SHLAGHA BORAH-NETBAN K, MUM-N281201266943692-30000",,,net_banking_transfer,-30000
61b6fb4cd8beac1599eb0cd2,50200023535069,367698.55,60ec41ba55c00300382672d9,HDFC,Revenue-PG-split enabled,5eecc6d6449e4f7cfb1c2708,2020-10-07T00:00:00.000Z,NEFT CR-UTIB0001506-RAZORPAY SOFTWARE PR IVATE LIMITED-SLICK ORGANICS PVT LITD-AX ISCN0058442215,investments,,net_banking_transfer,13972.05
61b6fb4dd8beac1599eb0ce6,50200023535069,368065.11,60ec41ba55c00300382672d9,HDFC,Revenue-Mktplace,5eecc6d6449e4f7cfb1c2708,2020-10-07T00:00:00.000Z,NEFT CR-DEUT0797BGL-FLIPKART INTERNET P LTD-INT AC FO R INTERMEDIARY-SLICK ORGAN ICS PVT LTD-100706867GN00210,shopping,,net_banking_transfer,366.56
61b6fb4ed8beac1599eb0cf8,50200023535069,368729.31,60ec41ba55c00300382672d9,HDFC,Revenue-Mktplace,5eecc6d6449e4f7cfb1c2708,2020-10-07T00:00:00.000Z,NEFT CR-DEUT0797BGL-MYNTRA DESIGNS PRIVA TE LIMITED-SLICK ORGANICS PRIVATE LIMITE D-100706938GN00085,shopping,,net_banking_transfer,664.2
61b6fb4fd8beac1599eb0d04,50200023535069,268729.31,60ec41ba55c00300382672d9,HDFC,SAAS/tech expense,5eecc6d6449e4f7cfb1c2708,2020-10-07T00:00:00.000Z,SHDF9301019363/BILLDKAMAZONSELLERSE,shopping,,Other,-100000
61b6fb50d8beac1599eb0d11,50200023535069,269278.5,60ec41ba55c00300382672d9,HDFC,Revenue-Mktplace,5eecc6d6449e4f7cfb1c2708,2020-10-07T00:00:00.000Z,NEFT CR-DEUT0797BGL-FLIPKART INTERNET PV TLTD-SLICK ORGANICS PVT LTD-100706836GN0 0001,shopping,,net_banking_transfer,549.19
61b6fb51d8beac1599eb0d18,50200023535069,274394.5,60ec41ba55c00300382672d9,HDFC,Revenue-Mktplace,5eecc6d6449e4f7cfb1c2708,2020-10-07T00:00:00.000Z,NEFT CR-SCBL0036001-DREAMPLUG TECHNOLOGI ES PRIVATE LIMI-SLICK ORGANICS PRIVATE L IMITEDSLICK-SIN31436Q0006285,,,net_banking_transfer,5116
61b6fb52d8beac1599eb0d26,50200023535069,269675.68,60ec41ba55c00300382672d9,HDFC,direct expenses,5eecc6d6449e4f7cfb1c2708,2020-10-07T00:00:00.000Z,POS 514834******4081 DT-02/10/20,,,debit_card,-4718.82
61b6fb53d8beac1599eb0d2e,50200023535069,275392.82,60ec41ba55c00300382672d9,HDFC,Revenue-PG-split enabled,5eecc6d6449e4f7cfb1c2708,2020-10-07T00:00:00.000Z,NEFT CR-UTIB0001506-RAZORPAY SOFTWARE PR IVATE LIMITED-SLICK ORGANICS PVT LITD-AX ISCN0058522112,investments,,net_banking_transfer,5717.14
61b6fb54d8beac1599eb0d33,50200023535069,336201.53,60ec41ba55c00300382672d9,HDFC,Revenue-COD,5eecc6d6449e4f7cfb1c2708,2020-10-07T00:00:00.000Z,NEFT CR-KKBK0000958-BIGFOOT RETAIL SOLUT IONS PRIVATE LIMITED-SLICK ORGANICS PVT LTD-KKBK202813988176,,,net_banking_transfer,60808.71
61b6fb55d8beac1599eb0d3c,50200023535069,337728.22,60ec41ba55c00300382672d9,HDFC,Revenue-PG-non-split,5eecc6d6449e4f7cfb1c2708,2020-10-08T00:00:00.000Z,UPI-PAYTM-PAYOUTS@PAYTM-PYTM0123456-0282 36388331-ALL202010082168200,ewallet,,upi,1526.69
61b6fb56d8beac1599eb0d49,50200023535069,309978.22,60ec41ba55c00300382672d9,HDFC,direct expenses,5eecc6d6449e4f7cfb1c2708,2020-10-08T00:00:00.000Z,"NEFT DR-UBIN0531855-MOHANISH KOTHARI-NET BANK, MUM-N282201268694424-27750",,,net_banking_transfer,-27750
61b6fb57d8beac1599eb0d53,50200023535069,318795.13,60ec41ba55c00300382672d9,HDFC,Revenue-PG-split enabled,5eecc6d6449e4f7cfb1c2708,2020-10-08T00:00:00.000Z,NEFT CR-UTIB0001506-RAZORPAY SOFTWARE PR,,,net_banking_transfer,8816.91
61b6fb58d8beac1599eb0d61,50200023535069,236505.13,60ec41ba55c00300382672d9,HDFC,direct expenses,5eecc6d6449e4f7cfb1c2708,2020-10-08T00:00:00.000Z,"NEFT DR-YESB0000551-VISTTA COSMETICS-NET BANK, MUM-N282201268915572-82290",,,net_banking_transfer,-82290
61b6fb59d8beac1599eb0d69,50200023535069,216505.13,60ec41ba55c00300382672d9,HDFC,direct expenses,5eecc6d6449e4f7cfb1c2708,2020-10-08T00:00:00.000Z,IMPS-028214147059-PAYTM-PYTM-XXXXXXXX383 9-20000,ewallet,,net_banking_transfer,-20000
61b6fb5ad8beac1599eb0d6f,50200023535069,233886.05,60ec41ba55c00300382672d9,HDFC,Revenue-PG-split enabled,5eecc6d6449e4f7cfb1c2708,2020-10-08T00:00:00.000Z,NEFT CR-UTIB0001506-RAZORPAY SOFTWARE PR IVATE LIMITED-SLICK ORGANICS PVT LITD-AX ISCN0058604034,investments,,net_banking_transfer,17380.92
61b6fb5bd8beac1599eb0d79,50200023535069,234174.48,60ec41ba55c00300382672d9,HDFC,Revenue-Mktplace,5eecc6d6449e4f7cfb1c2708,2020-10-08T00:00:00.000Z,NEFT CR-ICIC0000105-MANASH LIFETYLE PVT LTD-SLICKORGANICSPRIVATELIMITEDMPGGN-ICI B202820076999,,,net_banking_transfer,288.43
61b6fb5cd8beac1599eb0d81,50200023535069,236424.13,60ec41ba55c00300382672d9,HDFC,Revenue-Mktplace,5eecc6d6449e4f7cfb1c2708,2020-10-08T00:00:00.000Z,NEFT CR-ICIC0000105-MANASH LIFETYLE PVT LTD-SLICKORGANICSPRIVATELIMITEDMPMUM-ICI B202820077000,,,net_banking_transfer,2249.65
61b6fb5dd8beac1599eb0d8a,50200023535069,249051.69,60ec41ba55c00300382672d9,HDFC,Revenue-PG-non-split,5eecc6d6449e4f7cfb1c2708,2020-10-09T00:00:00.000Z,IMPS-028305690644-PAYTM-HDFC-XXXXXXXXXX0 007-,ewallet,,net_banking_transfer,12627.56
61b6fb5ed8beac1599eb0d98,50200023535069,254484.52,60ec41ba55c00300382672d9,HDFC,Revenue-Mktplace,5eecc6d6449e4f7cfb1c2708,2020-10-09T00:00:00.000Z,NEFT CR-DEUT0797BGL-FLIPKART INTERNET P LTD-INT AC FO R INTERMEDIARY-SLICK ORGAN ICS PVT LTD-100908619GN00250,shopping,,net_banking_transfer,5432.83
61b6fb5fd8beac1599eb0da4,50200023535069,270033.03,60ec41ba55c00300382672d9,HDFC,Revenue-PG-split enabled,5eecc6d6449e4f7cfb1c2708,2020-10-09T00:00:00.000Z,NEFT CR-UTIB0001506-RAZORPAY SOFTWARE PR IVATE LIMITED-SLICK ORGANICS PVT LITD-AX ISCN0058633798,investments,,net_banking_transfer,15548.51
61b6fb60d8beac1599eb0dab,50200023535069,271149.3,60ec41ba55c00300382672d9,HDFC,Revenue-Mktplace,5eecc6d6449e4f7cfb1c2708,2020-10-09T00:00:00.000Z,NEFT CR-DEUT0797BGL-MYNTRA DESIGNS PRIVA TE LIMITED-SLICK ORGANICS PRIVATE LIMITE D-100908686GN00114,shopping,,net_banking_transfer,1116.27
61b6fb61d8beac1599eb0db3,50200023535069,270922.3,60ec41ba55c00300382672d9,HDFC,direct expenses,5eecc6d6449e4f7cfb1c2708,2020-10-09T00:00:00.000Z,"NEFT DR-UTIB0000028-PREETI KAUR BHAMRA-N ETBANK, MUM-N283201270184493-227",,,net_banking_transfer,-227
61b6fb62d8beac1599eb0dbc,50200023535069,264728.3,60ec41ba55c00300382672d9,HDFC,direct expenses,5eecc6d6449e4f7cfb1c2708,2020-10-09T00:00:00.000Z,"NEFT DR-SBIN0008078-PANDIT PLASTICS-NETB ANK, MUM-N283201270184533-6194",,,net_banking_transfer,-6194
61b6fb63d8beac1599eb0dc5,50200023535069,236172.3,60ec41ba55c00300382672d9,HDFC,direct expenses,5eecc6d6449e4f7cfb1c2708,2020-10-09T00:00:00.000Z,50200043297657-TPT-28556-AIDC PRODUCTS I NDIA PRIVATE LIMITED,,,net_banking_transfer,-28556
61b6fb64d8beac1599eb0dcc,50200023535069,237408.25,60ec41ba55c00300382672d9,HDFC,Revenue-Mktplace,5eecc6d6449e4f7cfb1c2708,2020-10-09T00:00:00.000Z,NEFT CR-DEUT0784BBY-TATA UNISTORE LTD-NO,,,net_banking_transfer,1235.95
61b6fb65d8beac1599eb0dd1,50200023535069,237886.36,60ec41ba55c00300382672d9,HDFC,Transfer in/Revenue-other,5eecc6d6449e4f7cfb1c2708,2020-10-09T00:00:00.000Z,NEFT CR-YESB0000001-ILUMINAR MEDIA-SLICK ORGANICS-N283200443155988,,,net_banking_transfer,478.11
61b6fb66d8beac1599eb0dd5,50200023535069,126498.36,60ec41ba55c00300382672d9,HDFC,direct expenses,5eecc6d6449e4f7cfb1c2708,2020-10-09T00:00:00.000Z,IMPS-028314160288-VISTTA COSMETICS-IBKL- XXXXXXXXXXXX8280-111388,,,net_banking_transfer,-111388
61b6fb66d8beac1599eb0dda,50200023535069,79734.36,60ec41ba55c00300382672d9,HDFC,direct expenses,5eecc6d6449e4f7cfb1c2708,2020-10-09T00:00:00.000Z,"NEFT DR-ICIC0003430-HASHTAG ORANGE ADVER TISING PVT LTD-NETBANK, MUM-N28320127075 5080-46764",,,net_banking_transfer,-46764
61b6fb67d8beac1599eb0de1,50200023535069,67976.36,60ec41ba55c00300382672d9,HDFC,direct expenses,5eecc6d6449e4f7cfb1c2708,2020-10-09T00:00:00.000Z,"NEFT DR-BOFA0MM6205-FEDEX EXPRESS TRANSP ORTATION AND SUPPLY-NETBANK, MUM-N283201 270771029-11758",loans,lender_transaction,net_banking_transfer,-11758
61b6fb68d8beac1599eb0de6,50200023535069,87976.36,60ec41ba55c00300382672d9,HDFC,Internal Transfers,5eecc6d6449e4f7cfb1c2708,2020-10-09T00:00:00.000Z,IB FUNDS TRANSFER CR-50200050976833 -SL ICK ORGANICS PVT LTD,investments,,Other,20000
61b6fb69d8beac1599eb0dec,50200023535069,95095.49,60ec41ba55c00300382672d9,HDFC,Revenue-Mktplace,5eecc6d6449e4f7cfb1c2708,2020-10-09T00:00:00.000Z,NEFT CR-DEUT0797BGL-FLIPKART INTERNET PV TLTD-SLICK ORGANICS PVT LTD-100908590GN0 0203,shopping,,net_banking_transfer,7119.13
61b6fb6ad8beac1599eb0df3,50200023535069,95843.05,60ec41ba55c00300382672d9,HDFC,Revenue-Mktplace,5eecc6d6449e4f7cfb1c2708,2020-10-09T00:00:00.000Z,NEFT CR-DEUT0797BGL-MYNTRA DESIGNS PRIVA TE LIMITED-SLICK ORGANICS PRIVATE LIMITE D-100908727GN00118,shopping,,net_banking_transfer,747.56
61b6fb6bd8beac1599eb0df8,50200023535069,128165.74,60ec41ba55c00300382672d9,HDFC,Revenue-COD,5eecc6d6449e4f7cfb1c2708,2020-10-09T00:00:00.000Z,NEFT CR-KKBK0000958-BIGFOOT RETAIL SOLUT IONS PRIVATE LIMITED-SLICK ORGANICS PVT LTD-KKBK202834498669,,,net_banking_transfer,32322.69
61b6fb6cd8beac1599eb0dfb,50200023535069,138420.39,60ec41ba55c00300382672d9,HDFC,Revenue-PG-split enabled,5eecc6d6449e4f7cfb1c2708,2020-10-09T00:00:00.000Z,NEFT CR-UTIB0001506-RAZORPAY SOFTWARE PR IVATE LIMITED-SLICK ORGANICS PVT LITD-AX ISCN0058696223,investments,,net_banking_transfer,10254.65
61b6fb6dd8beac1599eb0dff,50200023535069,143083.07,60ec41ba55c00300382672d9,HDFC,Revenue-PG-non-split,5eecc6d6449e4f7cfb1c2708,2020-10-10T00:00:00.000Z,UPI-PAYTM-PAYOUTS@PAYTM-PYTM0123456-0284 70345999-ALL202010102168200,ewallet,,upi,4662.68
61b6fb6ed8beac1599eb0e07,50200023535069,93083.07,60ec41ba55c00300382672d9,HDFC,SAAS/tech expense,5eecc6d6449e4f7cfb1c2708,2020-10-10T00:00:00.000Z,POS 514834XXXXXX9486 AMAZON,shopping,,debit_card,-50000
61b6fb6fd8beac1599eb0e0b,50200023535069,98442.48,60ec41ba55c00300382672d9,HDFC,Revenue-PG-non-split,5eecc6d6449e4f7cfb1c2708,2020-10-11T00:00:00.000Z,IMPS-028505275811-PAYTM-HDFC-XXXXXXXXXX0 007-,ewallet,,net_banking_transfer,5359.41
61b6fb70d8beac1599eb0e10,50200023535069,116467.21,60ec41ba55c00300382672d9,HDFC,Revenue-PG-non-split,5eecc6d6449e4f7cfb1c2708,2020-10-12T00:00:00.000Z,IMPS-028605601934-PAYTM-HDFC-XXXXXXXXXX0,ewallet,,net_banking_transfer,18024.73
61b6fb71d8beac1599eb0e17,50200023535069,66467.21,60ec41ba55c00300382672d9,HDFC,SAAS/tech expense,5eecc6d6449e4f7cfb1c2708,2020-10-12T00:00:00.000Z,POS 514834XXXXXX9486 AMAZON,shopping,,debit_card,-50000
61b6fb72d8beac1599eb0e19,50200023535069,125175.72,60ec41ba55c00300382672d9,HDFC,Revenue-PG-split enabled,5eecc6d6449e4f7cfb1c2708,2020-10-12T00:00:00.000Z,NEFT CR-UTIB0001506-RAZORPAY SOFTWARE PR IVATE LIMITED-SLICK ORGANICS PVT LITD-AX ISCN0058737291,investments,,net_banking_transfer,58708.51
61b6fb73d8beac1599eb0e21,50200023535069,46982.72,60ec41ba55c00300382672d9,HDFC,direct expenses,5eecc6d6449e4f7cfb1c2708,2020-10-12T00:00:00.000Z,00921000075586-TPT-SEP-ROET BINDRA,,,net_banking_transfer,-78193
61b6fb74d8beac1599eb0e26,50200023535069,47356.06,60ec41ba55c00300382672d9,HDFC,Revenue-Mktplace,5eecc6d6449e4f7cfb1c2708,2020-10-12T00:00:00.000Z,NEFT CR-DEUT0797BGL-MYNTRA DESIGNS PRIVA TE LIMITED-SLICK ORGANICS PRIVATE LIMITE D-101209714GN00136,shopping,,net_banking_transfer,373.34
61b6fb75d8beac1599eb0e2c,50200023535069,49468.75,60ec41ba55c00300382672d9,HDFC,Revenue-Mktplace,5eecc6d6449e4f7cfb1c2708,2020-10-12T00:00:00.000Z,NEFT CR-DEUT0797BGL-FLIPKART INTERNET P LTD-INT AC FO R INTERMEDIARY-SLICK ORGAN ICS PVT LTD-101209815GN00060,shopping,,net_banking_transfer,2112.69
61b6fb76d8beac1599eb0e2f,50200023535069,50437.19,60ec41ba55c00300382672d9,HDFC,Revenue-Mktplace,5eecc6d6449e4f7cfb1c2708,2020-10-12T00:00:00.000Z,4060001190-TIMES INTERNET LIMITED NODAL,,,Other,968.44
61b6fb77d8beac1599eb0e33,50200023535069,430437.19,60ec41ba55c00300382672d9,HDFC,cash/cheque deposit/transfer in,5eecc6d6449e4f7cfb1c2708,2020-10-12T00:00:00.000Z,CHQ DEP MICR CLG NOIDA - MICR 1 CLG - NO : HORA ART CENTRE P L :ICICI BANKING COR PORATION LTD,,,chq,380000
61b6fb78d8beac1599eb0e37,50200023535069,431752.6,60ec41ba55c00300382672d9,HDFC,Revenue-Mktplace,5eecc6d6449e4f7cfb1c2708,2020-10-12T00:00:00.000Z,NEFT CR-DEUT0797BGL-FLIPKART INTERNET PV TLTD-SLICK ORGANICS PVT LTD-101209800GN0 0052,shopping,,net_banking_transfer,1315.41
61b6fb79d8beac1599eb0e3b,50200023535069,432403.4,60ec41ba55c00300382672d9,HDFC,Revenue-Mktplace,5eecc6d6449e4f7cfb1c2708,2020-10-12T00:00:00.000Z,NEFT CR-DEUT0797BGL-MYNTRA DESIGNS PRIVA TE LIMITED-SLICK ORGANICS PRIVATE LIMITE D-101209748GN00152,shopping,,net_banking_transfer,650.8
61b6fb7ad8beac1599eb0e41,50200023535069,441604.73,60ec41ba55c00300382672d9,HDFC,Revenue-PG-split enabled,5eecc6d6449e4f7cfb1c2708,2020-10-12T00:00:00.000Z,NEFT CR-UTIB0001506-RAZORPAY SOFTWARE PR IVATE LIMITED-SLICK ORGANICS PVT LITD-AX ISCN0058787952,investments,,net_banking_transfer,9201.33
61b6fb7bd8beac1599eb0e48,50200023535069,443979.66,60ec41ba55c00300382672d9,HDFC,Revenue-Mktplace,5eecc6d6449e4f7cfb1c2708,2020-10-12T00:00:00.000Z,NEFT CR-ICIC0000105-MANASH LIFETYLE PVT LTD-SLICKORGANICSPRIVATELIMITEDMPGGN-ICI B202860073100,,,net_banking_transfer,2374.93
61b6fb7cd8beac1599eb0e4d,50200023535069,451500.2,60ec41ba55c00300382672d9,HDFC,Revenue-PG-non-split,5eecc6d6449e4f7cfb1c2708,2020-10-13T00:00:00.000Z,IMPS-028705020685-PAYTM-HDFC-XXXXXXXXXX0 007-,ewallet,,net_banking_transfer,7520.54
61b6fb7dd8beac1599eb0e56,50200023535069,401500.2,60ec41ba55c00300382672d9,HDFC,SAAS/tech expense,5eecc6d6449e4f7cfb1c2708,2020-10-13T00:00:00.000Z,POS 514834XXXXXX9486 AMAZON,shopping,,debit_card,-50000
61b6fb7ed8beac1599eb0e5b,50200023535069,416414.54,60ec41ba55c00300382672d9,HDFC,Revenue-PG-split enabled,5eecc6d6449e4f7cfb1c2708,2020-10-13T00:00:00.000Z,NEFT CR-UTIB0001506-RAZORPAY SOFTWARE PR,,,net_banking_transfer,14914.34
61b6fb7fd8beac1599eb0e5f,50200023535069,457208.38,60ec41ba55c00300382672d9,HDFC,Revenue-Mktplace,5eecc6d6449e4f7cfb1c2708,2020-10-13T00:00:00.000Z,IMPS-028711007961-AMAZON SELLER SERVIC-H DFC-XXXXXXXX6004-C3EPBALFVMJVN19SSLICK O RGANICS PVT LTD,shopping,,net_banking_transfer,40793.84
61b6fb80d8beac1599eb0e6b,50200023535069,690927.02,60ec41ba55c00300382672d9,HDFC,Revenue-Mktplace,5eecc6d6449e4f7cfb1c2708,2020-10-13T00:00:00.000Z,NEFT CR-DEUT0797BGL-AMAZON PAY IND PVT L TD-INT AC INTM MKTPLACE-SLICK ORGANICS P VT LTD-101310731GN00305,shopping,,net_banking_transfer,233718.64
61b6fb81d8beac1599eb0e6e,50200023535069,654927.02,60ec41ba55c00300382672d9,HDFC,direct expenses,5eecc6d6449e4f7cfb1c2708,2020-10-13T00:00:00.000Z,"NEFT DR-ICIC0001944-TUNRAROUND CORPORATE ADVISORS PVT LTD-NETBANK, MUM-N28720127 4465035-36000",,,net_banking_transfer,-36000
61b6fb82d8beac1599eb0e72,50200023535069,504927.02,60ec41ba55c00300382672d9,HDFC,direct expenses,5eecc6d6449e4f7cfb1c2708,2020-10-13T00:00:00.000Z,"NEFT DR-ICIC0003430-HASHTAG ORANGE ADVER TISING PVT LTD-NETBANK, MUM-N28720127449 3889-150000",,,net_banking_transfer,-150000
61b6fb82d8beac1599eb0e78,50200023535069,483927.02,60ec41ba55c00300382672d9,HDFC,direct expenses,5eecc6d6449e4f7cfb1c2708,2020-10-13T00:00:00.000Z,50200001182150-TPT-21000-DEXTER CAPITAL ADVISORS PVT LTD,,,net_banking_transfer,-21000
61b6fb83d8beac1599eb0e7c,50200023535069,463927.02,60ec41ba55c00300382672d9,HDFC,direct expenses,5eecc6d6449e4f7cfb1c2708,2020-10-13T00:00:00.000Z,SARVAN KUMAR - CHQ PAID - DEVLI ROAD K,,,chq,-20000
61b6fb84d8beac1599eb0e81,50200023535069,469748.06,60ec41ba55c00300382672d9,HDFC,Revenue-PG-split enabled,5eecc6d6449e4f7cfb1c2708,2020-10-13T00:00:00.000Z,NEFT CR-UTIB0001506-RAZORPAY SOFTWARE PR IVATE LIMITED-SLICK ORGANICS PVT LITD-AX ISCN0058897169,investments,,net_banking_transfer,5821.04
61b6fb85d8beac1599eb0e88,50200023535069,470613.35,60ec41ba55c00300382672d9,HDFC,Revenue-Mktplace,5eecc6d6449e4f7cfb1c2708,2020-10-13T00:00:00.000Z,NEFT CR-ICIC0000105-MANASH LIFETYLE PVT LTD-SLICKORGANICSPRIVATELIMITEDMPGGN-ICI B202870061705,,,net_banking_transfer,865.29
61b6fb86d8beac1599eb0e8b,50200023535069,479523.51,60ec41ba55c00300382672d9,HDFC,Revenue-PG-non-split,5eecc6d6449e4f7cfb1c2708,2020-10-14T00:00:00.000Z,IMPS-028805620216-PAYTM-HDFC-XXXXXXXXXX0 007-,ewallet,,net_banking_transfer,8910.16
61b6fb87d8beac1599eb0e93,50200023535069,490560,60ec41ba55c00300382672d9,HDFC,Revenue-PG-split enabled,5eecc6d6449e4f7cfb1c2708,2020-10-14T00:00:00.000Z,NEFT CR-UTIB0001506-RAZORPAY SOFTWARE PR IVATE LIMITED-SLICK ORGANICS PVT LITD-AX ISCN0058937072,investments,,net_banking_transfer,11036.49
61b6fb88d8beac1599eb0e98,50200023535069,491884.52,60ec41ba55c00300382672d9,HDFC,Revenue-Mktplace,5eecc6d6449e4f7cfb1c2708,2020-10-14T00:00:00.000Z,NEFT CR-DEUT0797BGL-FLIPKART INTERNET P LTD-INT AC FO R INTERMEDIARY-SLICK ORGAN ICS PVT LTD-101411161GN00251,shopping,,net_banking_transfer,1324.52
61b6fb89d8beac1599eb0e9d,50200023535069,82915.52,60ec41ba55c00300382672d9,HDFC,direct expenses,5eecc6d6449e4f7cfb1c2708,2020-10-14T00:00:00.000Z,NEFT DR-UTIB0000723-VEDIC COMECEUTICALS,,,net_banking_transfer,-408969
61b6fb8ad8beac1599eb0ea1,50200023535069,44896.52,60ec41ba55c00300382672d9,HDFC,direct expenses,5eecc6d6449e4f7cfb1c2708,2020-10-14T00:00:00.000Z,"NEFT DR-YESB0000551-VISTTA COSMETICS-NET BANK, MUM-N288201275892959-38019",,,net_banking_transfer,-38019
61b6fb8bd8beac1599eb0ea5,50200023535069,54896.52,60ec41ba55c00300382672d9,HDFC,Internal Transfers,5eecc6d6449e4f7cfb1c2708,2020-10-14T00:00:00.000Z,IB FUNDS TRANSFER CR-50200050976833 -SL ICK ORGANICS PVT LTD,investments,,Other,10000
61b6fb8cd8beac1599eb0eaa,50200023535069,25896.52,60ec41ba55c00300382672d9,HDFC,direct expenses,5eecc6d6449e4f7cfb1c2708,2020-10-14T00:00:00.000Z,IMPS-028814101772-PAYTM-PYTM-XXXXXXXX383 9-29000,ewallet,,net_banking_transfer,-29000
61b6fb8dd8beac1599eb0eac,50200023535069,26069.16,60ec41ba55c00300382672d9,HDFC,Revenue-Mktplace,5eecc6d6449e4f7cfb1c2708,2020-10-14T00:00:00.000Z,NEFT CR-DEUT0797BGL-FLIPKART INTERNET PV TLTD-SLICK ORGANICS PVT LTD-101411234GN0 0295,shopping,,net_banking_transfer,172.64
61b6fb8ed8beac1599eb0eb4,50200023535069,29026.86,60ec41ba55c00300382672d9,HDFC,Revenue-Mktplace,5eecc6d6449e4f7cfb1c2708,2020-10-14T00:00:00.000Z,NEFT CR-DEUT0797BGL-MYNTRA DESIGNS PRIVA TE LIMITED-SLICK ORGANICS PRIVATE LIMITE D-101411271GN00145,shopping,,net_banking_transfer,2957.7
61b6fb8fd8beac1599eb0eba,50200023535069,72320.29,60ec41ba55c00300382672d9,HDFC,Revenue-COD,5eecc6d6449e4f7cfb1c2708,2020-10-14T00:00:00.000Z,NEFT CR-KKBK0000958-BIGFOOT RETAIL SOLUT IONS PRIVATE LIMITED-SLICK ORGANICS PVT LTD-KKBK202885285424,,,net_banking_transfer,43293.43
61b6fb90d8beac1599eb0ebd,50200023535069,111133.13,60ec41ba55c00300382672d9,HDFC,Revenue-PG-split enabled,5eecc6d6449e4f7cfb1c2708,2020-10-14T00:00:00.000Z,NEFT CR-UTIB0001506-RAZORPAY SOFTWARE PR IVATE LIMITED-SLICK ORGANICS PVT LITD-AX ISCN0058992850,investments,,net_banking_transfer,38812.84
61b6fb91d8beac1599eb0ec5,50200023535069,511133.13,60ec41ba55c00300382672d9,HDFC,Internal Transfers,5eecc6d6449e4f7cfb1c2708,2020-10-14T00:00:00.000Z,IB FUNDS TRANSFER CR-50200035187206 -SL ICK ORGANICS PVT LTD,investments,,Other,400000
61b6fb92d8beac1599eb0ec8,50200023535069,393133.13,60ec41ba55c00300382672d9,HDFC,SAAS/tech expense,5eecc6d6449e4f7cfb1c2708,2020-10-14T00:00:00.000Z,SHDF9330569158/BILLDKAMAZONSELLERSE,shopping,,Other,-118000
61b6fb93d8beac1599eb0ecf,50200023535069,413720.56,60ec41ba55c00300382672d9,HDFC,Revenue-PG-non-split,5eecc6d6449e4f7cfb1c2708,2020-10-15T00:00:00.000Z,IMPS-028905942501-PAYTM-HDFC-XXXXXXXXXX0 007-,ewallet,,net_banking_transfer,20587.43
61b6fb94d8beac1599eb0ed3,50200023535069,313720.56,60ec41ba55c00300382672d9,HDFC,direct expenses,5eecc6d6449e4f7cfb1c2708,2020-10-15T00:00:00.000Z,57500000443889-TPT-100000-WEBKLIPPER TEC HNOLOGIES PRIVATE LIMITED,,,net_banking_transfer,-100000
61b6fb95d8beac1599eb0ed7,50200023535069,259423.56,60ec41ba55c00300382672d9,HDFC,direct expenses,5eecc6d6449e4f7cfb1c2708,2020-10-15T00:00:00.000Z,"NEFT DR-YESB0000551-VISTTA COSMETICS-NET BANK, MUM-N289201276569886-54297",,,net_banking_transfer,-54297
61b6fb96d8beac1599eb0eda,50200023535069,295003.89,60ec41ba55c00300382672d9,HDFC,Revenue-PG-split enabled,5eecc6d6449e4f7cfb1c2708,2020-10-15T00:00:00.000Z,NEFT CR-UTIB0001506-RAZORPAY SOFTWARE PR,,,net_banking_transfer,35580.33
61b6fb97d8beac1599eb0edf,50200023535069,286003.89,60ec41ba55c00300382672d9,HDFC,direct expenses,5eecc6d6449e4f7cfb1c2708,2020-10-15T00:00:00.000Z,IMPS-028911179930-PAYTM-PYTM-XXXXXXXX383 9-9000,ewallet,,net_banking_transfer,-9000
61b6fb98d8beac1599eb0ee4,50200023535069,285203.89,60ec41ba55c00300382672d9,HDFC,direct expenses,5eecc6d6449e4f7cfb1c2708,2020-10-15T00:00:00.000Z,IMPS-028911175986-PAYTM-PYTM-XXXXXXXX383 9-800,ewallet,,net_banking_transfer,-800
61b6fb99d8beac1599eb0ee9,50200023535069,276943.89,60ec41ba55c00300382672d9,HDFC,agency/vendor expense,5eecc6d6449e4f7cfb1c2708,2020-10-15T00:00:00.000Z,50200025524947-TPT-8260-AFFOY MEDIA PRIV ATE LIMITED,,,net_banking_transfer,-8260
61b6fb99d8beac1599eb0ef0,50200023535069,276898.15,60ec41ba55c00300382672d9,HDFC,bank charges,5eecc6d6449e4f7cfb1c2708,2020-10-15T00:00:00.000Z,.DC INTL POS TXN MARKUP+ST 280920 300920 -CDT2027501367947,,,international_transaction_arbitrage,-45.74
61b6fb9ad8beac1599eb0ef4,50200023535069,299325.58,60ec41ba55c00300382672d9,HDFC,Revenue-PG-split enabled,5eecc6d6449e4f7cfb1c2708,2020-10-15T00:00:00.000Z,NEFT CR-UTIB0001506-RAZORPAY SOFTWARE PR IVATE LIMITED-SLICK ORGANICS PVT LITD-AX ISCN0059083432,investments,,net_banking_transfer,22427.43
61b6fb9bd8beac1599eb0efb,50200023535069,310354.97,60ec41ba55c00300382672d9,HDFC,Revenue-PG-non-split,5eecc6d6449e4f7cfb1c2708,2020-10-16T00:00:00.000Z,UPI-PAYTM-PAYOUTS@PAYTM-PYTM0123456-0290 73846412-ALL202010162168200,ewallet,,upi,11029.39
61b6fb9cd8beac1599eb0f00,50200023535069,255354.97,60ec41ba55c00300382672d9,HDFC,direct expenses,5eecc6d6449e4f7cfb1c2708,2020-10-16T00:00:00.000Z,IMPS-029008160205-PAYTM-PYTM-XXXXXXXX383 9-55000,ewallet,,net_banking_transfer,-55000
61b6fb9dd8beac1599eb0f05,50200023535069,281201.75,60ec41ba55c00300382672d9,HDFC,Revenue-PG-split enabled,5eecc6d6449e4f7cfb1c2708,2020-10-16T00:00:00.000Z,NEFT CR-UTIB0001506-RAZORPAY SOFTWARE PR IVATE LIMITED-SLICK ORGANICS PVT LITD-AX ISCN0059118962,investments,,net_banking_transfer,25846.78
61b6fb9ed8beac1599eb0f09,50200023535069,256421.75,60ec41ba55c00300382672d9,HDFC,direct expenses,5eecc6d6449e4f7cfb1c2708,2020-10-16T00:00:00.000Z,POS 514834XXXXXX9486 RAZ*KNOWLARITY,,,debit_card,-24780
61b6fb9fd8beac1599eb0f0d,50200023535069,257530.54,60ec41ba55c00300382672d9,HDFC,Revenue-Mktplace,5eecc6d6449e4f7cfb1c2708,2020-10-16T00:00:00.000Z,NEFT CR-DEUT0797BGL-MYNTRA DESIGNS PRIVA TE LIMITED-SLICK ORGANICS PRIVATE LIMITE D-101612921GN00090,shopping,,net_banking_transfer,1108.79
61b6fba0d8beac1599eb0f1d,50200023535069,259534.15,60ec41ba55c00300382672d9,HDFC,Revenue-Mktplace,5eecc6d6449e4f7cfb1c2708,2020-10-16T00:00:00.000Z,NEFT CR-DEUT0797BGL-FLIPKART INTERNET P LTD-INT AC FO R INTERMEDIARY-SLICK ORGAN ICS PVT LTD-101613008GN00156,shopping,,net_banking_transfer,2003.61
61b6fba1d8beac1599eb0f20,50200023535069,262539.14,60ec41ba55c00300382672d9,HDFC,Revenue-Mktplace,5eecc6d6449e4f7cfb1c2708,2020-10-16T00:00:00.000Z,NEFT CR-DEUT0797BGL-FLIPKART INTERNET PV TLTD-SLICK ORGANICS PVT LTD-101613170GN0 0151,shopping,,net_banking_transfer,3004.99
61b6fba2d8beac1599eb0f27,50200023535069,291921.53,60ec41ba55c00300382672d9,HDFC,Revenue-COD,5eecc6d6449e4f7cfb1c2708,2020-10-16T00:00:00.000Z,NEFT CR-KKBK0000958-BIGFOOT RETAIL SOLUT IONS PRIVATE LIMITED-SLICK ORGANICS PVT LTD-KKBK202905702333,,,net_banking_transfer,29382.39
61b6fba3d8beac1599eb0f2e,50200023535069,311794.94,60ec41ba55c00300382672d9,HDFC,Revenue-PG-split enabled,5eecc6d6449e4f7cfb1c2708,2020-10-16T00:00:00.000Z,NEFT CR-UTIB0001506-RAZORPAY SOFTWARE PR,,,net_banking_transfer,19873.41
61b6fba4d8beac1599eb0f30,50200023535069,314842.94,60ec41ba55c00300382672d9,HDFC,Revenue-Mktplace,5eecc6d6449e4f7cfb1c2708,2020-10-16T00:00:00.000Z,NEFT CR-SCBL0036001-DREAMPLUG TECHNOLOGI ES PRIVATE LIMI-SLICK ORGANICS PRIVATE L IMITEDSLICK-SIN31436Q0006640,,,net_banking_transfer,3048
61b6fba5d8beac1599eb0f38,50200023535069,314107.73,60ec41ba55c00300382672d9,HDFC,direct expenses,5eecc6d6449e4f7cfb1c2708,2020-10-16T00:00:00.000Z,POS 514834XXXXXX9486 MANYCHAT COM PRO,,,debit_card,-735.21
61b6fba6d8beac1599eb0f44,50200023535069,327980.75,60ec41ba55c00300382672d9,HDFC,Revenue-PG-non-split,5eecc6d6449e4f7cfb1c2708,2020-10-17T00:00:00.000Z,UPI-PAYTM-PAYOUTS@PAYTM-PYTM0123456-0291 92135796-ALL202010172168200,ewallet,,upi,13873.02
61b6fba7d8beac1599eb0f4c,50200023535069,353873.11,60ec41ba55c00300382672d9,HDFC,Revenue-PG-split enabled,5eecc6d6449e4f7cfb1c2708,2020-10-17T00:00:00.000Z,NEFT CR-UTIB0001506-RAZORPAY SOFTWARE PR IVATE LIMITED-SLICK ORGANICS PVT LITD-AX ISCN0059199553,investments,,net_banking_transfer,25892.36
61b6fba8d8beac1599eb0f50,50200023535069,98873.11,60ec41ba55c00300382672d9,HDFC,SAAS/tech expense,5eecc6d6449e4f7cfb1c2708,2020-10-17T00:00:00.000Z,VHDF9347879768/BILLDKAMAZONSELLERSE,shopping,,Other,-255000
61b6fbaad8beac1599eb0f56,50200023535069,120953.05,60ec41ba55c00300382672d9,HDFC,Revenue-PG-split enabled,5eecc6d6449e4f7cfb1c2708,2020-10-17T00:00:00.000Z,NEFT CR-UTIB0001506-RAZORPAY SOFTWARE PR IVATE LIMITED-SLICK ORGANICS PVT LITD-AX ISCN0059233264,investments,,net_banking_transfer,22079.94
61b6fbabd8beac1599eb0f5c,50200023535069,125589.54,60ec41ba55c00300382672d9,HDFC,Revenue-Mktplace,5eecc6d6449e4f7cfb1c2708,2020-10-17T00:00:00.000Z,NEFT CR-DEUT0784BBY-TATA UNISTORE LTD-NO DAL-SLICK ORGANICS PVT LTD-101725529GN00 221,investments,,net_banking_transfer,4636.49
61b6fbacd8beac1599eb0f62,50200023535069,138840.3,60ec41ba55c00300382672d9,HDFC,Revenue-PG-non-split,5eecc6d6449e4f7cfb1c2708,2020-10-18T00:00:00.000Z,UPI-PAYTM-PAYOUTS@PAYTM-PYTM0123456-0292 11192552-ALL202010182168200,ewallet,,upi,13250.76
61b6fbadd8beac1599eb0f6c,50200023535069,163111.23,60ec41ba55c00300382672d9,HDFC,Revenue-PG-non-split,5eecc6d6449e4f7cfb1c2708,2020-10-19T00:00:00.000Z,UPI-PAYTM-PAYOUTS@PAYTM-PYTM0123456-0293 27932054-ALL202010192168200,ewallet,,upi,24270.93
61b6fbaed8beac1599eb0f70,50200023535069,165291.2,60ec41ba55c00300382672d9,HDFC,Revenue-Mktplace,5eecc6d6449e4f7cfb1c2708,2020-10-19T00:00:00.000Z,NEFT CR-DEUT0797BGL-FLIPKART INTERNET PR IVATE LIMITED-SLICK ORGANICS PVT LTD-101 914261GN00020,shopping,,net_banking_transfer,2179.97
61b6fbafd8beac1599eb0f74,50200023535069,220428.78,60ec41ba55c00300382672d9,HDFC,Revenue-PG-split enabled,5eecc6d6449e4f7cfb1c2708,2020-10-19T00:00:00.000Z,NEFT CR-UTIB0001506-RAZORPAY SOFTWARE PR IVATE LIMITED-SLICK ORGANICS PVT LITD-AX ISCN0059255104,investments,,net_banking_transfer,55137.58
61b6fbb0d8beac1599eb0f7b,50200023535069,120428.78,60ec41ba55c00300382672d9,HDFC,direct expenses,5eecc6d6449e4f7cfb1c2708,2020-10-19T00:00:00.000Z,05892560000649-TPT-100000-DECORPAC INDIA PRIVATE LIMITED,,,net_banking_transfer,-100000
61b6fbb1d8beac1599eb0f7f,50200023535069,121735.12,60ec41ba55c00300382672d9,HDFC,Revenue-Mktplace,5eecc6d6449e4f7cfb1c2708,2020-10-19T00:00:00.000Z,NEFT CR-DEUT0797BGL-MYNTRA DESIGNS PRIVA,shopping,,net_banking_transfer,1306.34
61b6fbb2d8beac1599eb0f8f,50200023535069,21735.12,60ec41ba55c00300382672d9,HDFC,direct expenses,5eecc6d6449e4f7cfb1c2708,2020-10-19T00:00:00.000Z,IMPS-029315153494-PAYTM-PYTM-XXXXXXXX383 9-100000,ewallet,,net_banking_transfer,-100000
61b6fbb3d8beac1599eb0f92,50200023535069,21967.94,60ec41ba55c00300382672d9,HDFC,Revenue-Mktplace,5eecc6d6449e4f7cfb1c2708,2020-10-19T00:00:00.000Z,NEFT CR-ICIC0000105-MANASH LIFETYLE PVT LTD-SLICKORGANICSPRIVATELIMITEDMPGGN-ICI B202930039677,,,net_banking_transfer,232.82
61b6fbb3d8beac1599eb0f96,50200023535069,24084.13,60ec41ba55c00300382672d9,HDFC,Revenue-Mktplace,5eecc6d6449e4f7cfb1c2708,2020-10-19T00:00:00.000Z,NEFT CR-ICIC0000105-MANASH LIFETYLE PVT LTD-SLICKORGANICSPRIVATELIMITEDMPMUM-ICI B202930039678,,,net_banking_transfer,2116.19
61b6fbb4d8beac1599eb0f9b,50200023535069,24412.13,60ec41ba55c00300382672d9,HDFC,Transfer in/Revenue-other,5eecc6d6449e4f7cfb1c2708,2020-10-19T00:00:00.000Z,IMPS-029317858658-EARTH LOVE ECOMMERCE-H DFC-XXXXXXXX1048-PAYOUT,,,net_banking_transfer,328
61b6fbb5d8beac1599eb0f9e,50200023535069,39524.85,60ec41ba55c00300382672d9,HDFC,Revenue-PG-split enabled,5eecc6d6449e4f7cfb1c2708,2020-10-19T00:00:00.000Z,NEFT CR-UTIB0001506-RAZORPAY SOFTWARE PR IVATE LIMITED-SLICK ORGANICS PVT LITD-AX ISCN0059303458,investments,,net_banking_transfer,15112.72
61b6fbb6d8beac1599eb0fa4,50200023535069,46660.63,60ec41ba55c00300382672d9,HDFC,Revenue-PG-non-split,5eecc6d6449e4f7cfb1c2708,2020-10-20T00:00:00.000Z,UPI-PAYTM-PAYOUTS@PAYTM-PYTM0123456-0294 44637349-ALL202010202168200,ewallet,,upi,7135.78
61b6fbb7d8beac1599eb0fac,50200023535069,49814.47,60ec41ba55c00300382672d9,HDFC,Transfer in/Revenue-other,5eecc6d6449e4f7cfb1c2708,2020-10-20T00:00:00.000Z,NEFT CR-ICIC0SF0002-TRELL EXPERIENCES PR -SLICK ORGANICS PVT LTD-22934680441DC,investments,,net_banking_transfer,3153.84
61b6fbb8d8beac1599eb0fb0,50200023535069,54266.02,60ec41ba55c00300382672d9,HDFC,Transfer in/Revenue-other,5eecc6d6449e4f7cfb1c2708,2020-10-20T00:00:00.000Z,NEFT CR-ICIC0SF0002-TRELL EXPERIENCES PR -SLICK ORGANICS PVT LTD-22934680511DC,investments,,net_banking_transfer,4451.55
61b6fbb9d8beac1599eb0fbb,50200023535069,66754.21,60ec41ba55c00300382672d9,HDFC,Revenue-PG-split enabled,5eecc6d6449e4f7cfb1c2708,2020-10-20T00:00:00.000Z,NEFT CR-UTIB0001506-RAZORPAY SOFTWARE PR IVATE LIMITED-SLICK ORGANICS PVT LITD-AX ISCN0059330765,investments,,net_banking_transfer,12488.19
61b6fbbad8beac1599eb0fbf,50200023535069,61615.63,60ec41ba55c00300382672d9,HDFC,direct expenses,5eecc6d6449e4f7cfb1c2708,2020-10-20T00:00:00.000Z,POS 514834XXXXXX9486 FEEDBACKFIVE,,,debit_card,-5138.58
61b6fbbbd8beac1599eb0fc5,50200023535069,84615.63,60ec41ba55c00300382672d9,HDFC,Internal Transfers,5eecc6d6449e4f7cfb1c2708,2020-10-20T00:00:00.000Z,IB FUNDS TRANSFER CR-50200050976833 -SL ICK ORGANICS PVT LTD,investments,,Other,23000
61b6fbbcd8beac1599eb0fc9,50200023535069,99615.63,60ec41ba55c00300382672d9,HDFC,Internal Transfers,5eecc6d6449e4f7cfb1c2708,2020-10-20T00:00:00.000Z,IB FUNDS TRANSFER CR-50200050976833 -SL ICK ORGANICS PVT LTD,investments,,Other,15000
61b6fbbdd8beac1599eb0fcd,50200023535069,9615.63,60ec41ba55c00300382672d9,HDFC,direct expenses,5eecc6d6449e4f7cfb1c2708,2020-10-20T00:00:00.000Z,IMPS-029411164807-PAYTM-PYTM-XXXXXXXX383 9-90000,ewallet,,net_banking_transfer,-90000
61b6fbbed8beac1599eb0fd2,50200023535069,90010.4,60ec41ba55c00300382672d9,HDFC,Revenue-Mktplace,5eecc6d6449e4f7cfb1c2708,2020-10-20T00:00:00.000Z,IMPS-029411199624-AMAZON SELLER SERVIC-H,shopping,,net_banking_transfer,80394.77
61b6fbbfd8beac1599eb0fd4,50200023535069,82132.4,60ec41ba55c00300382672d9,HDFC,direct expenses,5eecc6d6449e4f7cfb1c2708,2020-10-20T00:00:00.000Z,"NEFT DR-BOFA0MM6205-FEDEX EXPRESS TRANSP ORTATION SUPPLY CHAI-NETBANK, MUM-N29420 1281104088-7878",loans,lender_transaction,net_banking_transfer,-7878
61b6fbc0d8beac1599eb0fdb,50200023535069,81753.85,60ec41ba55c00300382672d9,HDFC,bank charges,5eecc6d6449e4f7cfb1c2708,2020-10-20T00:00:00.000Z,.DC INTL POS TXN MARKUP+ST 021020 031020 -CDT2027501367947,,,international_transaction_arbitrage,-378.55
61b6fbc1d8beac1599eb0fe2,50200023535069,81665.7,60ec41ba55c00300382672d9,HDFC,bank charges,5eecc6d6449e4f7cfb1c2708,2020-10-20T00:00:00.000Z,.DC INTL POS TXN MARKUP+ST 011020 031020 -CDT2027501367947,,,international_transaction_arbitrage,-88.15
61b6fbc2d8beac1599eb0fe4,50200023535069,356620.37,60ec41ba55c00300382672d9,HDFC,Revenue-Mktplace,5eecc6d6449e4f7cfb1c2708,2020-10-20T00:00:00.000Z,NEFT CR-DEUT0797BGL-AMAZON PAY (INDIA) P RIVATE LIMITED-SLICK ORGANICS PVT LTD-10 2000140GN00353,shopping,,net_banking_transfer,274954.67
61b6fbc3d8beac1599eb0fee,50200023535069,328180.37,60ec41ba55c00300382672d9,HDFC,agency/vendor expense,5eecc6d6449e4f7cfb1c2708,2020-10-20T00:00:00.000Z,"NEFT DR-KKBK0000298-ADMITAD MEDIA PRIVAT E LIMITED-NETBANK, MUM-N294201281286232- APRIL",loans,lender_transaction,net_banking_transfer,-28440
61b6fbc4d8beac1599eb0ffa,50200023535069,238180.37,60ec41ba55c00300382672d9,HDFC,direct expenses,5eecc6d6449e4f7cfb1c2708,2020-10-20T00:00:00.000Z,IMPS-029413134981-PAYTM-PYTM-XXXXXXXX383 9-90000,ewallet,,net_banking_transfer,-90000
61b6fbc5d8beac1599eb100a,50200023535069,253420.15,60ec41ba55c00300382672d9,HDFC,Revenue-PG-split enabled,5eecc6d6449e4f7cfb1c2708,2020-10-20T00:00:00.000Z,NEFT CR-UTIB0001506-RAZORPAY SOFTWARE PR IVATE LIMITED-SLICK ORGANICS PVT LITD-AX ISCN0059379181,investments,,net_banking_transfer,15239.78
61b6fbc6d8beac1599eb101d,50200023535069,246884.95,60ec41ba55c00300382672d9,HDFC,direct expenses,5eecc6d6449e4f7cfb1c2708,2020-10-20T00:00:00.000Z,POS 514834XXXXXX9486 HOTJAR,,,debit_card,-6535.2
61b6fbc7d8beac1599eb1023,50200023535069,254757.15,60ec41ba55c00300382672d9,HDFC,Revenue-PG-non-split,5eecc6d6449e4f7cfb1c2708,2020-10-21T00:00:00.000Z,IMPS-029505378879-PAYTM-HDFC-XXXXXXXXXX0 007-,ewallet,,net_banking_transfer,7872.2
61b6fbc8d8beac1599eb1030,50200023535069,274821.19,60ec41ba55c00300382672d9,HDFC,Revenue-PG-split enabled,5eecc6d6449e4f7cfb1c2708,2020-10-21T00:00:00.000Z,NEFT CR-UTIB0001506-RAZORPAY SOFTWARE PR IVATE LIMITED-SLICK ORGANICS PVT LITD-AX ISCN0059407200,investments,,net_banking_transfer,20064.04
61b6fbc9d8beac1599eb103c,50200023535069,277489.28,60ec41ba55c00300382672d9,HDFC,Revenue-Mktplace,5eecc6d6449e4f7cfb1c2708,2020-10-21T00:00:00.000Z,NEFT CR-DEUT0797BGL-FLIPKART INTERNET PR IVATE LIMITED-SLICK ORGANICS PVT LTD-102 100108GN00196,shopping,,net_banking_transfer,2668.09
61b6fbcad8beac1599eb1042,50200023535069,278748.31,60ec41ba55c00300382672d9,HDFC,Revenue-Mktplace,5eecc6d6449e4f7cfb1c2708,2020-10-21T00:00:00.000Z,NEFT CR-DEUT0797BGL-MYNTRA DESIGNS PRIVA TE LIMITED-SLICK ORGANICS PRIVATE LIMITE D-102100184GN00128,shopping,,net_banking_transfer,1259.03
61b6fbcbd8beac1599eb104a,50200023535069,247748.31,60ec41ba55c00300382672d9,HDFC,direct expenses,5eecc6d6449e4f7cfb1c2708,2020-10-21T00:00:00.000Z,IMPS-029512152304-PAYTM-PYTM-XXXXXXXX383,ewallet,,net_banking_transfer,-31000
61b6fbccd8beac1599eb1059,50200023535069,47748.31,60ec41ba55c00300382672d9,HDFC,direct expenses,5eecc6d6449e4f7cfb1c2708,2020-10-21T00:00:00.000Z,50200001182150-TPT-200000-DEXTER CAPITAL ADVISORS PVT LTD,,,net_banking_transfer,-200000
61b6fbcdd8beac1599eb105f,50200023535069,11923.31,60ec41ba55c00300382672d9,HDFC,direct expenses,5eecc6d6449e4f7cfb1c2708,2020-10-21T00:00:00.000Z,"NEFT DR-ICIC0001944-TUNRAROUND CORPORATE ADVISORS PVT LTD-NETBANK, MUM-N29520128 2402362-35825",,,net_banking_transfer,-35825
61b6fbced8beac1599eb1069,50200023535069,14154.4,60ec41ba55c00300382672d9,HDFC,Revenue-Mktplace,5eecc6d6449e4f7cfb1c2708,2020-10-21T00:00:00.000Z,NEFT CR-ICIC0000105-MANASH LIFETYLE PVT LTD-SLICK ORGANICS PRIVATE LIMITED (MP) GGN-ICIB202950026216,,,net_banking_transfer,2231.09
61b6fbcfd8beac1599eb106e,50200023535069,15119.8,60ec41ba55c00300382672d9,HDFC,Revenue-Mktplace,5eecc6d6449e4f7cfb1c2708,2020-10-21T00:00:00.000Z,NEFT CR-ICIC0000105-MANASH LIFETYLE PVT LTD-SLICK ORGANICS PRIVATE LIMITED (MP) MUM-ICIB202950026217,,,net_banking_transfer,965.4
61b6fbcfd8beac1599eb1076,50200023535069,23758.87,60ec41ba55c00300382672d9,HDFC,Revenue-PG-split enabled,5eecc6d6449e4f7cfb1c2708,2020-10-21T00:00:00.000Z,NEFT CR-UTIB0001506-RAZORPAY SOFTWARE PR IVATE LIMITED-SLICK ORGANICS PVT LITD-AX ISCN0059457530,investments,,net_banking_transfer,8639.07
61b6fbd0d8beac1599eb107c,50200023535069,36226.42,60ec41ba55c00300382672d9,HDFC,Revenue-PG-non-split,5eecc6d6449e4f7cfb1c2708,2020-10-22T00:00:00.000Z,UPI-PAYTM-PAYOUTS@PAYTM-PYTM0123456-0296 78600201-ALL202010222168200,ewallet,,upi,12467.55
61b6fbd1d8beac1599eb1082,50200023535069,48092.42,60ec41ba55c00300382672d9,HDFC,Revenue-Mktplace,5eecc6d6449e4f7cfb1c2708,2020-10-22T00:00:00.000Z,NEFT CR-KKBK0000958-SUPERMARKET GROCERY SUPPLIES PVT LTD-SLICK ORGANICS PVT LTD- KKBK202966579949,shopping,,net_banking_transfer,11866
61b6fbd2d8beac1599eb1089,50200023535069,61108.52,60ec41ba55c00300382672d9,HDFC,Revenue-Mktplace,5eecc6d6449e4f7cfb1c2708,2020-10-22T00:00:00.000Z,NEFT CR-KKBK0000958-SUPERMARKET GROCERY SUPPLIES PVT LTD-SLICK ORGANICS PVT LTD- KKBK202966579914,shopping,,net_banking_transfer,13016.1
61b6fbd3d8beac1599eb108d,50200023535069,73611.52,60ec41ba55c00300382672d9,HDFC,Revenue-Mktplace,5eecc6d6449e4f7cfb1c2708,2020-10-22T00:00:00.000Z,NEFT CR-KKBK0000958-SUPERMARKET GROCERY SUPPLIES PVT LTD-SLICK ORGANICS PVT LTD- KKBK202966580400,shopping,,net_banking_transfer,12503
61b6fbd4d8beac1599eb10b4,50200023535069,78936.72,60ec41ba55c00300382672d9,HDFC,Revenue-Mktplace,5eecc6d6449e4f7cfb1c2708,2020-10-22T00:00:00.000Z,NEFT CR-KKBK0000958-SUPERMARKET GROCERY SUPPLIES PVT LTD-SLICK ORGANICS PVT LTD- KKBK202966580316,shopping,,net_banking_transfer,5325.2
61b6fbd5d8beac1599eb10bd,50200023535069,105360.82,60ec41ba55c00300382672d9,HDFC,Revenue-Mktplace,5eecc6d6449e4f7cfb1c2708,2020-10-22T00:00:00.000Z,NEFT CR-KKBK0000958-SUPERMARKET GROCERY,shopping,,net_banking_transfer,26424.1
61b6fbd6d8beac1599eb10c2,50200023535069,115331.22,60ec41ba55c00300382672d9,HDFC,Revenue-Mktplace,5eecc6d6449e4f7cfb1c2708,2020-10-22T00:00:00.000Z,NEFT CR-KKBK0000958-SUPERMARKET GROCERY SUPPLIES PVT LTD-SLICK ORGANICS PVT LTD- KKBK202966579875,shopping,,net_banking_transfer,9970.4
61b6fbd7d8beac1599eb10cc,50200023535069,130013.05,60ec41ba55c00300382672d9,HDFC,Revenue-PG-split enabled,5eecc6d6449e4f7cfb1c2708,2020-10-22T00:00:00.000Z,NEFT CR-UTIB0001506-RAZORPAY SOFTWARE PR IVATE LIMITED-SLICK ORGANICS PVT LITD-AX ISCN0059490271,investments,,net_banking_transfer,14681.83
61b6fbd8d8beac1599eb10d6,50200023535069,110013.05,60ec41ba55c00300382672d9,HDFC,direct expenses,5eecc6d6449e4f7cfb1c2708,2020-10-22T00:00:00.000Z,"NEFT DR-CITI0000027-RISHIEKA JAINI-NETBA NK, MUM-N296201283641730-ABC",,,net_banking_transfer,-20000
61b6fbd9d8beac1599eb10dd,50200023535069,110693.27,60ec41ba55c00300382672d9,HDFC,Revenue-Mktplace,5eecc6d6449e4f7cfb1c2708,2020-10-22T00:00:00.000Z,NEFT CR-ICIC0000105-MANASH LIFETYLE PVT LTD-SLICKORGANICSPRIVATELIMITED(MP)GGN-I CIB202960044552,,,net_banking_transfer,680.22
61b6fbdad8beac1599eb10e2,50200023535069,181846.62,60ec41ba55c00300382672d9,HDFC,Revenue-PG-split enabled,5eecc6d6449e4f7cfb1c2708,2020-10-22T00:00:00.000Z,NEFT CR-UTIB0001506-RAZORPAY SOFTWARE PR IVATE LIMITED-SLICK ORGANICS PVT LITD-AX ISCN0059537493,investments,,net_banking_transfer,71153.35
61b6fbdbd8beac1599eb10e6,50200023535069,181834.8,60ec41ba55c00300382672d9,HDFC,bank charges,5eecc6d6449e4f7cfb1c2708,2020-10-22T00:00:00.000Z,DEBIT CARD PUR ADJ DT 20/10/20,,,Other,-11.82
61b6fbdcd8beac1599eb10eb,50200023535069,219933.52,60ec41ba55c00300382672d9,HDFC,Revenue-PG-non-split,5eecc6d6449e4f7cfb1c2708,2020-10-23T00:00:00.000Z,IMPS-029705784456-PAYTM-HDFC-XXXXXXXXXX0 007-,ewallet,,net_banking_transfer,38098.72
61b6fbddd8beac1599eb10ed,50200023535069,419933.52,60ec41ba55c00300382672d9,HDFC,Internal Transfers,5eecc6d6449e4f7cfb1c2708,2020-10-23T00:00:00.000Z,IB FUNDS TRANSFER CR-50200035187206 -SL ICK ORGANICS PVT LTD,investments,,Other,200000
61b6fbded8beac1599eb10f4,50200023535069,119933.52,60ec41ba55c00300382672d9,HDFC,direct expenses,5eecc6d6449e4f7cfb1c2708,2020-10-23T00:00:00.000Z,02711600008220-TPT-300000-VARUN SINGH,,,net_banking_transfer,-300000
61b6fbdfd8beac1599eb10fb,50200023535069,94897.52,60ec41ba55c00300382672d9,HDFC,direct expenses,5eecc6d6449e4f7cfb1c2708,2020-10-23T00:00:00.000Z,02711600008220-TPT-25036-VARUN SINGH,,,net_banking_transfer,-25036
61b6fbe0d8beac1599eb10fe,50200023535069,294897.52,60ec41ba55c00300382672d9,HDFC,Internal Transfers,5eecc6d6449e4f7cfb1c2708,2020-10-23T00:00:00.000Z,IB FUNDS TRANSFER CR-50200035187206 -SL ICK ORGANICS PVT LTD,investments,,Other,200000
61b6fbe1d8beac1599eb1105,50200023535069,186468.52,60ec41ba55c00300382672d9,HDFC,direct expenses,5eecc6d6449e4f7cfb1c2708,2020-10-23T00:00:00.000Z,02771610131904-TPT-108429-DIGANT BHATT,,,net_banking_transfer,-108429
61b6fbe2d8beac1599eb110b,50200023535069,144468.52,60ec41ba55c00300382672d9,HDFC,direct expenses,5eecc6d6449e4f7cfb1c2708,2020-10-23T00:00:00.000Z,50200012495494-TPT-42000-BEAM AND WORDS LLP,,,net_banking_transfer,-42000
61b6fbe3d8beac1599eb1110,50200023535069,220609.28,60ec41ba55c00300382672d9,HDFC,Revenue-PG-split enabled,5eecc6d6449e4f7cfb1c2708,2020-10-23T00:00:00.000Z,NEFT CR-UTIB0001506-RAZORPAY SOFTWARE PR IVATE LIMITED-SLICK ORGANICS PVT LITD-AX ISCN0059566481,investments,,net_banking_transfer,76140.76
61b6fbe4d8beac1599eb1117,50200023535069,223294.24,60ec41ba55c00300382672d9,HDFC,Revenue-Mktplace,5eecc6d6449e4f7cfb1c2708,2020-10-23T00:00:00.000Z,NEFT CR-DEUT0797BGL-FLIPKART INTERNET PR,shopping,,net_banking_transfer,2684.96
61b6fbe5d8beac1599eb111f,50200023535069,226328.82,60ec41ba55c00300382672d9,HDFC,Revenue-Mktplace,5eecc6d6449e4f7cfb1c2708,2020-10-23T00:00:00.000Z,NEFT CR-DEUT0797BGL-MYNTRA DESIGNS PRIVA TE LIMITED-SLICK ORGANICS PRIVATE LIMITE D-102300185GN00140,shopping,,net_banking_transfer,3034.58
61b6fbe6d8beac1599eb1125,50200023535069,226806.93,60ec41ba55c00300382672d9,HDFC,Revenue-PG-split enabled,5eecc6d6449e4f7cfb1c2708,2020-10-23T00:00:00.000Z,NEFT CR-YESB0000001-RAZORPAY SOFTWARE P L NODAL ACCOUNT-SLICKORGANICS-N297200449 865079,investments,,net_banking_transfer,478.11
61b6fbe7d8beac1599eb112a,50200023535069,126005.93,60ec41ba55c00300382672d9,HDFC,direct expenses,5eecc6d6449e4f7cfb1c2708,2020-10-23T00:00:00.000Z,"NEFT DR-YESB0000551-VISTTA COSMETICS-NET BANK, MUM-N297201284630186-100801",,,net_banking_transfer,-100801
61b6fbe8d8beac1599eb112d,50200023535069,26005.93,60ec41ba55c00300382672d9,HDFC,direct expenses,5eecc6d6449e4f7cfb1c2708,2020-10-23T00:00:00.000Z,57500000443889-TPT-100000-WEBKLIPPER TEC HNOLOGIES PRIVATE LIMITED,,,net_banking_transfer,-100000
61b6fbe9d8beac1599eb113c,50200023535069,26406.36,60ec41ba55c00300382672d9,HDFC,Revenue-Mktplace,5eecc6d6449e4f7cfb1c2708,2020-10-23T00:00:00.000Z,NEFT CR-DEUT0797BGL-MYNTRA DESIGNS PRIVA TE LIMITED-SLICK ORGANICS PRIVATE LIMITE D-102300231GN00173,shopping,,net_banking_transfer,400.43
61b6fbead8beac1599eb1146,50200023535069,66421.28,60ec41ba55c00300382672d9,HDFC,Revenue-COD,5eecc6d6449e4f7cfb1c2708,2020-10-23T00:00:00.000Z,NEFT CR-KKBK0000958-BIGFOOT RETAIL SOLUT IONS PRIVATE LIMITED-SLICK ORGANICS PVT LTD-KKBK202976904595,,,net_banking_transfer,40014.92
61b6fbebd8beac1599eb114b,50200023535069,67653.48,60ec41ba55c00300382672d9,HDFC,Revenue-Mktplace,5eecc6d6449e4f7cfb1c2708,2020-10-23T00:00:00.000Z,NEFT CR-DEUT0784BBY-TATA UNISTORE LTD-NO DAL-SLICK ORGANICS PVT LTD-102301083GN00 279,investments,,net_banking_transfer,1232.2
61b6fbecd8beac1599eb1151,50200023535069,81767.57,60ec41ba55c00300382672d9,HDFC,Revenue-PG-split enabled,5eecc6d6449e4f7cfb1c2708,2020-10-23T00:00:00.000Z,NEFT CR-UTIB0001506-RAZORPAY SOFTWARE PR IVATE LIMITED-SLICK ORGANICS PVT LITD-AX ISCN0059629548,investments,,net_banking_transfer,14114.09
61b6fbedd8beac1599eb1159,50200023535069,92537.5,60ec41ba55c00300382672d9,HDFC,Revenue-PG-non-split,5eecc6d6449e4f7cfb1c2708,2020-10-24T00:00:00.000Z,UPI-PAYTM-PAYOUTS@PAYTM-PYTM0123456-0298 11559664-ALL202010242168200,ewallet,,upi,10769.93
61b6fbeed8beac1599eb115f,50200023535069,104057.27,60ec41ba55c00300382672d9,HDFC,Revenue-PG-non-split,5eecc6d6449e4f7cfb1c2708,2020-10-25T00:00:00.000Z,UPI-PAYTM-PAYOUTS@PAYTM-PYTM0123456-0299 28697132-ALL202010252168200,ewallet,,upi,11519.77
61b6fbefd8beac1599eb1164,50200023535069,116169.87,60ec41ba55c00300382672d9,HDFC,Revenue-PG-non-split,5eecc6d6449e4f7cfb1c2708,2020-10-26T00:00:00.000Z,UPI-PAYTM-PAYOUTS@PAYTM-PYTM0123456-0300 44518043-ALL202010262168200,ewallet,,upi,12112.6
61b6fbf0d8beac1599eb116f,50200023535069,112549.31,60ec41ba55c00300382672d9,HDFC,direct expenses,5eecc6d6449e4f7cfb1c2708,2020-10-26T00:00:00.000Z,POS 514834XXXXXX9486 WWW.FAQPRIME.COM,,,debit_card,-3620.56
61b6fbf1d8beac1599eb1174,50200023535069,108910.71,60ec41ba55c00300382672d9,HDFC,direct expenses,5eecc6d6449e4f7cfb1c2708,2020-10-26T00:00:00.000Z,POS 514834XXXXXX9486 FRESHWORKS INC,,,debit_card,-3638.6
61b6fbf2d8beac1599eb117b,50200023535069,183306.81,60ec41ba55c00300382672d9,HDFC,Revenue-PG-split enabled,5eecc6d6449e4f7cfb1c2708,2020-10-26T00:00:00.000Z,NEFT CR-UTIB0001506-RAZORPAY SOFTWARE PR,,,net_banking_transfer,74396.1
61b6fbf3d8beac1599eb1182,50200023535069,187941.44,60ec41ba55c00300382672d9,HDFC,Revenue-Mktplace,5eecc6d6449e4f7cfb1c2708,2020-10-26T00:00:00.000Z,NEFT CR-DEUT0797BGL-MYNTRA DESIGNS PRIVA TE LIMITED-SLICK ORGANICS PRIVATE LIMITE D-102600161GN00118,shopping,,net_banking_transfer,4634.63
61b6fbf3d8beac1599eb118c,50200023535069,191752.91,60ec41ba55c00300382672d9,HDFC,Revenue-Mktplace,5eecc6d6449e4f7cfb1c2708,2020-10-26T00:00:00.000Z,NEFT CR-DEUT0797BGL-FLIPKART INTERNET PR IVATE LIMITED-SLICK ORGANICS PVT LTD-102 600095GN00219,shopping,,net_banking_transfer,3811.47
61b6fbf4d8beac1599eb118f,50200023535069,219602.91,60ec41ba55c00300382672d9,HDFC,Transfer in/Revenue-other,5eecc6d6449e4f7cfb1c2708,2020-10-26T00:00:00.000Z,50200050241205 -TPT-VANITY WAGON-NAPSA PRIVATE LIMITED,,,net_banking_transfer,27850
61b6fbf5d8beac1599eb119c,50200023535069,219720.35,60ec41ba55c00300382672d9,HDFC,Revenue-Mktplace,5eecc6d6449e4f7cfb1c2708,2020-10-26T00:00:00.000Z,NEFT CR-DEUT0797BGL-MYNTRA DESIGNS PRIVA TE LIMITED-SLICK ORGANICS PRIVATE LIMITE D-102600202GN00218,shopping,,net_banking_transfer,117.44
61b6fbf6d8beac1599eb11a0,50200023535069,243646.98,60ec41ba55c00300382672d9,HDFC,Revenue-PG-split enabled,5eecc6d6449e4f7cfb1c2708,2020-10-26T00:00:00.000Z,NEFT CR-UTIB0001506-RAZORPAY SOFTWARE PR IVATE LIMITED-SLICK ORGANICS PVT LITD-AX ISCN0059695082,investments,,net_banking_transfer,23926.63
61b6fbf7d8beac1599eb11a7,50200023535069,248824.96,60ec41ba55c00300382672d9,HDFC,Revenue-Mktplace,5eecc6d6449e4f7cfb1c2708,2020-10-26T00:00:00.000Z,NEFT CR-ICIC0000105-MANASH LIFETYLE PVT LTD-SLICKORGANICSPRIVATELIMITEDMPMUM-ICI B203000064753,,,net_banking_transfer,5177.98
61b6fbf8d8beac1599eb11ae,50200023535069,251969.09,60ec41ba55c00300382672d9,HDFC,Revenue-Mktplace,5eecc6d6449e4f7cfb1c2708,2020-10-26T00:00:00.000Z,NEFT CR-ICIC0000105-MANASH LIFETYLE PVT LTD-SLICKORGANICSPRIVATELIMITEDMPGGN-ICI B203000064752,,,net_banking_transfer,3144.13
61b6fbf9d8beac1599eb11b3,50200023535069,267518.52,60ec41ba55c00300382672d9,HDFC,Revenue-PG-non-split,5eecc6d6449e4f7cfb1c2708,2020-10-27T00:00:00.000Z,IMPS-030105687286-PAYTM-HDFC-XXXXXXXXXX0 007-,ewallet,,net_banking_transfer,15549.43
61b6fbfad8beac1599eb11b8,50200023535069,303773.97,60ec41ba55c00300382672d9,HDFC,Revenue-PG-split enabled,5eecc6d6449e4f7cfb1c2708,2020-10-27T00:00:00.000Z,NEFT CR-UTIB0001506-RAZORPAY SOFTWARE PR IVATE LIMITED-SLICK ORGANICS PVT LITD-AX ISCN0059719794,investments,,net_banking_transfer,36255.45
61b6fbfbd8beac1599eb11bb,50200023535069,296551.97,60ec41ba55c00300382672d9,HDFC,direct expenses,5eecc6d6449e4f7cfb1c2708,2020-10-27T00:00:00.000Z,13742000001308-TPT-7222-AES LABORATORIES PVT LTD,,,net_banking_transfer,-7222
61b6fbfcd8beac1599eb11c0,50200023535069,364443.43,60ec41ba55c00300382672d9,HDFC,Revenue-Mktplace,5eecc6d6449e4f7cfb1c2708,2020-10-27T00:00:00.000Z,IMPS-030111085154-AMAZON SELLER SERVIC-H DFC-XXXXXXXX6004-53NL2DYB7R24FDCNSLICK O RGANICS PVT LTD,shopping,,net_banking_transfer,67891.46
61b6fbfdd8beac1599eb11c9,50200023535069,624885.65,60ec41ba55c00300382672d9,HDFC,Revenue-Mktplace,5eecc6d6449e4f7cfb1c2708,2020-10-27T00:00:00.000Z,NEFT CR-DEUT0797BGL-AMAZON PAY (INDIA) P,shopping,,net_banking_transfer,260442.22
61b6fbfed8beac1599eb11cb,50200023535069,722100.54,60ec41ba55c00300382672d9,HDFC,Revenue-PG-split enabled,5eecc6d6449e4f7cfb1c2708,2020-10-27T00:00:00.000Z,NEFT CR-UTIB0001506-RAZORPAY SOFTWARE PR IVATE LIMITED-SLICK ORGANICS PVT LITD-AX ISCN0059775963,investments,,net_banking_transfer,97214.89
61b6fbffd8beac1599eb11d2,50200023535069,522100.54,60ec41ba55c00300382672d9,HDFC,direct expenses,5eecc6d6449e4f7cfb1c2708,2020-10-27T00:00:00.000Z,50200001182150-TPT-ABC-DEXTER CAPITAL AD VISORS PVT LTD,,,net_banking_transfer,-200000
61b6fc00d8beac1599eb11d8,50200023535069,372100.54,60ec41ba55c00300382672d9,HDFC,direct expenses,5eecc6d6449e4f7cfb1c2708,2020-10-27T00:00:00.000Z,05892560000649-TPT-ABC-DECORPAC INDIA PR IVATE LIMITED,,,net_banking_transfer,-150000
61b6fc01d8beac1599eb11dc,50200023535069,414991.2,60ec41ba55c00300382672d9,HDFC,Revenue-PG-non-split,5eecc6d6449e4f7cfb1c2708,2020-10-28T00:00:00.000Z,IMPS-030205850452-PAYTM-HDFC-XXXXXXXXXX0 007-,ewallet,,net_banking_transfer,42890.66
61b6fc02d8beac1599eb11e0,50200023535069,342991.2,60ec41ba55c00300382672d9,HDFC,direct expenses,5eecc6d6449e4f7cfb1c2708,2020-10-28T00:00:00.000Z,"NEFT DR-PYTM0123456-PAYTM-NETBANK, MUM-N 302201287971257-72000",ewallet,,net_banking_transfer,-72000
61b6fc03d8beac1599eb11e6,50200023535069,345138.23,60ec41ba55c00300382672d9,HDFC,Revenue-Mktplace,5eecc6d6449e4f7cfb1c2708,2020-10-28T00:00:00.000Z,NEFT CR-DEUT0797BGL-FLIPKART INTERNET PR IVATE LIMITED-SLICK ORGANICS PVT LTD-102 800109GN00095,shopping,,net_banking_transfer,2147.03
61b6fc04d8beac1599eb11ea,50200023535069,398574.99,60ec41ba55c00300382672d9,HDFC,Revenue-PG-split enabled,5eecc6d6449e4f7cfb1c2708,2020-10-28T00:00:00.000Z,NEFT CR-UTIB0001506-RAZORPAY SOFTWARE PR IVATE LIMITED-SLICK ORGANICS PVT LITD-AX ISCN0059801832,investments,,net_banking_transfer,53436.76
61b6fc05d8beac1599eb11f0,50200023535069,392719.99,60ec41ba55c00300382672d9,HDFC,direct expenses,5eecc6d6449e4f7cfb1c2708,2020-10-28T00:00:00.000Z,"NEFT DR-CITI0000032-TRADETRACKER INDIA L LP-NETBANK, MUM-N302201288012238-5855",,,net_banking_transfer,-5855
61b6fc06d8beac1599eb11f7,50200023535069,358219.99,60ec41ba55c00300382672d9,HDFC,direct expenses,5eecc6d6449e4f7cfb1c2708,2020-10-28T00:00:00.000Z,"NEFT DR-PYTM0123456-PAYTM-NETBANK, MUM-N 302201288275400-34500",ewallet,,net_banking_transfer,-34500
61b6fc07d8beac1599eb1203,50200023535069,308219.99,60ec41ba55c00300382672d9,HDFC,SAAS/tech expense,5eecc6d6449e4f7cfb1c2708,2020-10-28T00:00:00.000Z,VHDF9399234152/BILLDKAMAZONSELLERSE,shopping,,Other,-50000
61b6fc08d8beac1599eb1206,50200023535069,310711.47,60ec41ba55c00300382672d9,HDFC,Revenue-Mktplace,5eecc6d6449e4f7cfb1c2708,2020-10-28T00:00:00.000Z,NEFT CR-ICIC0000105-MANASH LIFETYLE PVT LTD-SLICKORGANICSPRIVATELIMITEDMPMUM-ICI B203020018425,,,net_banking_transfer,2491.48
61b6fc09d8beac1599eb120d,50200023535069,311457.66,60ec41ba55c00300382672d9,HDFC,Revenue-Mktplace,5eecc6d6449e4f7cfb1c2708,2020-10-28T00:00:00.000Z,NEFT CR-ICIC0000105-MANASH LIFETYLE PVT LTD-SLICKORGANICSPRIVATELIMITEDMPGGN-ICI B203020018424,,,net_banking_transfer,746.19
61b6fc0ad8beac1599eb1211,50200023535069,211457.66,60ec41ba55c00300382672d9,HDFC,direct expenses,5eecc6d6449e4f7cfb1c2708,2020-10-28T00:00:00.000Z,57500000443889-TPT-100000-WEBKLIPPER TEC,,,net_banking_transfer,-100000
61b6fc0bd8beac1599eb1216,50200023535069,211522.1,60ec41ba55c00300382672d9,HDFC,Revenue-Mktplace,5eecc6d6449e4f7cfb1c2708,2020-10-28T00:00:00.000Z,NEFT CR-DEUT0797BGL-FLIPKART INTERNET PR IVATE LIMITED-SLICK ORGANICS PVT LTD-102 800077GN00112,shopping,,net_banking_transfer,64.44
61b6fc0cd8beac1599eb121b,50200023535069,211491.73,60ec41ba55c00300382672d9,HDFC,bank charges,5eecc6d6449e4f7cfb1c2708,2020-10-28T00:00:00.000Z,.DC INTL POS TXN MARKUP+ST 161020 191020 -CDT2027501367947,,,international_transaction_arbitrage,-30.37
61b6fc0dd8beac1599eb121f,50200023535069,243796.22,60ec41ba55c00300382672d9,HDFC,Revenue-COD,5eecc6d6449e4f7cfb1c2708,2020-10-28T00:00:00.000Z,NEFT CR-KKBK0000958-BIGFOOT RETAIL SOLUT IONS PRIVATE LIMITED-SLICK ORGANICS PVT LTD-KKBK203027655262,,,net_banking_transfer,32304.49
61b6fc0ed8beac1599eb1223,50200023535069,262062.5,60ec41ba55c00300382672d9,HDFC,Revenue-PG-split enabled,5eecc6d6449e4f7cfb1c2708,2020-10-28T00:00:00.000Z,NEFT CR-UTIB0001506-RAZORPAY SOFTWARE PR IVATE LIMITED-SLICK ORGANICS PVT LITD-AX ISCN0059848556,investments,,net_banking_transfer,18266.28
61b6fc0fd8beac1599eb1229,50200023535069,260949.16,60ec41ba55c00300382672d9,HDFC,direct expenses,5eecc6d6449e4f7cfb1c2708,2020-10-29T00:00:00.000Z,POS 514834XXXXXX9486 ZOOM.US,,,debit_card,-1113.34
61b6fc10d8beac1599eb122c,50200023535069,269106,60ec41ba55c00300382672d9,HDFC,Revenue-PG-non-split,5eecc6d6449e4f7cfb1c2708,2020-10-29T00:00:00.000Z,IMPS-030305020642-PAYTM-HDFC-XXXXXXXXXX0 007-,ewallet,,net_banking_transfer,8156.84
61b6fc11d8beac1599eb1231,50200023535069,287111.76,60ec41ba55c00300382672d9,HDFC,Revenue-PG-split enabled,5eecc6d6449e4f7cfb1c2708,2020-10-29T00:00:00.000Z,NEFT CR-UTIB0001506-RAZORPAY SOFTWARE PR IVATE LIMITED-SLICK ORGANICS PVT LITD-AX ISCN0059878370,investments,,net_banking_transfer,18005.76
61b6fc12d8beac1599eb1238,50200023535069,197831.76,60ec41ba55c00300382672d9,HDFC,direct expenses,5eecc6d6449e4f7cfb1c2708,2020-10-29T00:00:00.000Z,"NEFT DR-YESB0000551-VISTTA COSMETICS-NET BANK, MUM-N303201289128060-89280",,,net_banking_transfer,-89280
61b6fc13d8beac1599eb123b,50200023535069,119638.76,60ec41ba55c00300382672d9,HDFC,Rental expense,5eecc6d6449e4f7cfb1c2708,2020-10-29T00:00:00.000Z,00921000075586-TPT-OCT RENT-ROET BINDRA,,,net_banking_transfer,-78193
61b6fc13d8beac1599eb1242,50200023535069,120025.04,60ec41ba55c00300382672d9,HDFC,Revenue-Mktplace,5eecc6d6449e4f7cfb1c2708,2020-10-29T00:00:00.000Z,NEFT CR-DEUT0784BBY-TATA UNISTORE LTD-NO DAL-SLICK ORGANICS PVT LTD-102900391GN00 225,investments,,net_banking_transfer,386.28
61b6fc14d8beac1599eb1247,50200023535069,100025.04,60ec41ba55c00300382672d9,HDFC,direct expenses,5eecc6d6449e4f7cfb1c2708,2020-10-29T00:00:00.000Z,CHQ PAID TO RAJKUMAR GUPTA - CHQ PAID - DEVLI ROAD K,,,chq,-20000
61b6fc15d8beac1599eb124c,50200023535069,116333.22,60ec41ba55c00300382672d9,HDFC,Revenue-PG-split enabled,5eecc6d6449e4f7cfb1c2708,2020-10-29T00:00:00.000Z,NEFT CR-UTIB0001506-RAZORPAY SOFTWARE PR IVATE LIMITED-SLICK ORGANICS PVT LITD-AX ISCN0059943823,investments,,net_banking_transfer,16308.18
61b6fc16d8beac1599eb1250,50200023535069,128700.31,60ec41ba55c00300382672d9,HDFC,Revenue-PG-non-split,5eecc6d6449e4f7cfb1c2708,2020-10-30T00:00:00.000Z,UPI-PAYTM-PAYOUTS@PAYTM-PYTM0123456-0304 12224261-ALL202010302168200,ewallet,,upi,12367.09
61b6fc17d8beac1599eb1255,50200023535069,28700.31,60ec41ba55c00300382672d9,HDFC,SAAS/tech expense,5eecc6d6449e4f7cfb1c2708,2020-10-30T00:00:00.000Z,VHDF9405901016/BILLDKAMAZONSELLERSE,shopping,,Other,-100000
61b6fc18d8beac1599eb1260,50200023535069,24541.31,60ec41ba55c00300382672d9,HDFC,SAAS/tech expense,5eecc6d6449e4f7cfb1c2708,2020-10-30T00:00:00.000Z,POS 514834XXXXXX9486 AMAZON,shopping,,debit_card,-4159
61b6fc19d8beac1599eb1262,50200023535069,25001.89,60ec41ba55c00300382672d9,HDFC,Revenue-PG-split enabled,5eecc6d6449e4f7cfb1c2708,2020-10-31T00:00:00.000Z,NEFT CR-YESB0000001-RAZORPAY SOFTWARE P L NODAL ACCOUNT-SLICKORGANICS-N305200453 234402,investments,,net_banking_transfer,460.58
61b6fc1ad8beac1599eb1268,50200023535069,43672.24,60ec41ba55c00300382672d9,HDFC,Revenue-PG-non-split,5eecc6d6449e4f7cfb1c2708,2020-10-31T00:00:00.000Z,UPI-PAYTM-PAYOUTS@PAYTM-PYTM0123456-0305 29834247-ALL202010312168200,ewallet,,upi,18670.35
61b6fc1bd8beac1599eb1270,50200023535069,134805.62,60ec41ba55c00300382672d9,HDFC,Revenue-PG-split enabled,5eecc6d6449e4f7cfb1c2708,2020-10-31T00:00:00.000Z,NEFT CR-UTIB0001506-RAZORPAY SOFTWARE PR IVATE LIMITED-SLICK ORGANICS PVT LITD-AX ISCN0059975595,investments,,net_banking_transfer,91133.38
61b6fc1cd8beac1599eb1272,50200023535069,134593.39,60ec41ba55c00300382672d9,HDFC,bank charges,5eecc6d6449e4f7cfb1c2708,2020-10-31T00:00:00.000Z,.DC INTL POS TXN MARKUP+ST 191020 221020 -CDT2027501367947,,,international_transaction_arbitrage,-212.23
61b6fc1dd8beac1599eb1279,50200023535069,134323,60ec41ba55c00300382672d9,HDFC,bank charges,5eecc6d6449e4f7cfb1c2708,2020-10-31T00:00:00.000Z,.DC INTL POS TXN MARKUP+ST 201020 221020 -CDT2027501367947,,,international_transaction_arbitrage,-270.39
61b6fc1ed8beac1599eb1280,50200023535069,145808.63,60ec41ba55c00300382672d9,HDFC,Revenue-PG-split enabled,5eecc6d6449e4f7cfb1c2708,2020-10-31T00:00:00.000Z,NEFT CR-UTIB0001506-RAZORPAY SOFTWARE PR,,,net_banking_transfer,11485.63
61b6fc1fd8beac1599eb1285,50200023535069,152952.64,60ec41ba55c00300382672d9,HDFC,Revenue-PG-non-split,5eecc6d6449e4f7cfb1c2708,2020-11-01T00:00:00.000Z,IMPS-030605394062-PAYTM-HDFC-XXXXXXXXXX0 007-,ewallet,,net_banking_transfer,7144.01
61b6fc20d8beac1599eb1289,50200023535069,1152952.64,60ec41ba55c00300382672d9,HDFC,Internal Transfers,5eecc6d6449e4f7cfb1c2708,2020-11-01T00:00:00.000Z,IB FUNDS TRANSFER CR-50200035187206 -SL ICK ORGANICS PVT LTD,investments,,Other,1000000
61b6fc21d8beac1599eb128f,50200023535069,955651.64,60ec41ba55c00300382672d9,HDFC,direct expenses,5eecc6d6449e4f7cfb1c2708,2020-11-01T00:00:00.000Z,"NEFT DR-YESB0000551-VISTTA COSMETICS-NET BANK, MUM-N306201292473221-197301",,,net_banking_transfer,-197301
61b6fc22d8beac1599eb1295,50200023535069,855651.64,60ec41ba55c00300382672d9,HDFC,direct expenses,5eecc6d6449e4f7cfb1c2708,2020-11-01T00:00:00.000Z,"NEFT DR-YESB0000551-VISTTA COSMETICS-NET BANK, MUM-N306201292453767-100000",,,net_banking_transfer,-100000
61b6fc23d8beac1599eb1298,50200023535069,667314.64,60ec41ba55c00300382672d9,HDFC,direct expenses,5eecc6d6449e4f7cfb1c2708,2020-11-01T00:00:00.000Z,"NEFT DR-UTIB0000723-VEDIC COMECEUTICALS PVT LTD-NETBANK, MUM-N306201292473774-18 8337",,,net_banking_transfer,-188337
61b6fc24d8beac1599eb12c9,50200023535069,567314.64,60ec41ba55c00300382672d9,HDFC,direct expenses,5eecc6d6449e4f7cfb1c2708,2020-11-01T00:00:00.000Z,"NEFT DR-UTIB0000723-VEDIC COMECEUTICALS PVT LTD-NETBANK, MUM-N306201292468151-10 0000",,,net_banking_transfer,-100000
61b6fc25d8beac1599eb12d2,50200023535069,447314.64,60ec41ba55c00300382672d9,HDFC,direct expenses,5eecc6d6449e4f7cfb1c2708,2020-11-01T00:00:00.000Z,"NEFT DR-ANDB0002029-HITESH ARORA-NETBANK , MUM-N306201292474652-120000",,,net_banking_transfer,-120000
61b6fc26d8beac1599eb12d6,50200023535069,406439.64,60ec41ba55c00300382672d9,HDFC,direct expenses,5eecc6d6449e4f7cfb1c2708,2020-11-01T00:00:00.000Z,50200012495494-TPT-40875-BEAM AND WORDS LLP,,,net_banking_transfer,-40875
61b6fc27d8beac1599eb12fc,50200023535069,256439.64,60ec41ba55c00300382672d9,HDFC,direct expenses,5eecc6d6449e4f7cfb1c2708,2020-11-01T00:00:00.000Z,05892560000649-TPT-150000-DECORPAC INDIA PRIVATE LIMITED,,,net_banking_transfer,-150000
61b6fc28d8beac1599eb12ff,50200023535069,156439.64,60ec41ba55c00300382672d9,HDFC,direct expenses,5eecc6d6449e4f7cfb1c2708,2020-11-01T00:00:00.000Z,"NEFT DR-INDB0000148-ACQUISORY INDIA CONS ULTING PVT LTD-NETBANK, MUM-N30620129246 9893-100000",,,net_banking_transfer,-100000
61b6fc29d8beac1599eb1311,50200023535069,73741.64,60ec41ba55c00300382672d9,HDFC,agency/vendor expense,5eecc6d6449e4f7cfb1c2708,2020-11-01T00:00:00.000Z,"NEFT DR-KKBK0000298-ADMITAD MEDIA PRIVAT E LIMITED-NETBANK, MUM-N306201292480637- 82698",loans,lender_transaction,net_banking_transfer,-82698
61b6fc2ad8beac1599eb1316,50200023535069,63536.64,60ec41ba55c00300382672d9,HDFC,direct expenses,5eecc6d6449e4f7cfb1c2708,2020-11-01T00:00:00.000Z,50200021241300-TPT-10205-AFFLE INDIA LIM ITED,,,net_banking_transfer,-10205
61b6fc2bd8beac1599eb131a,50200023535069,13536.64,60ec41ba55c00300382672d9,HDFC,direct expenses,5eecc6d6449e4f7cfb1c2708,2020-11-01T00:00:00.000Z,NEFT DR-ICIC0000007-DLF UTILITIES LTD-NE,,,net_banking_transfer,-50000
61b6fc2cd8beac1599eb132a,50200023535069,11370.62,60ec41ba55c00300382672d9,HDFC,direct expenses,5eecc6d6449e4f7cfb1c2708,2020-11-01T00:00:00.000Z,POS 514834XXXXXX9486 SEOPTIMER,,,debit_card,-2166.02
61b6fc2dd8beac1599eb132f,50200023535069,28751.35,60ec41ba55c00300382672d9,HDFC,Revenue-PG-non-split,5eecc6d6449e4f7cfb1c2708,2020-11-02T00:00:00.000Z,UPI-PAYTM-PAYOUTS@PAYTM-PYTM0123456-0307 67379156-ALL202011022168200,ewallet,,upi,17380.73
61b6fc2ed8beac1599eb1333,50200023535069,1028751.35,60ec41ba55c00300382672d9,HDFC,Internal Transfers,5eecc6d6449e4f7cfb1c2708,2020-11-02T00:00:00.000Z,IB FUNDS TRANSFER CR-50200035187206 -SL ICK ORGANICS PVT LTD,investments,,Other,1000000
61b6fc2fd8beac1599eb13a7,50200023535069,428751.35,60ec41ba55c00300382672d9,HDFC,direct expenses,5eecc6d6449e4f7cfb1c2708,2020-11-02T00:00:00.000Z,02711600008220-TPT-600000-VARUN SINGH,,,net_banking_transfer,-600000
61b6fc30d8beac1599eb13b1,50200023535069,436353.33,60ec41ba55c00300382672d9,HDFC,Revenue-Mktplace,5eecc6d6449e4f7cfb1c2708,2020-11-02T00:00:00.000Z,NEFT CR-DEUT0797BGL-FLIPKART INTERNET PR IVATE LIMITED-SLICK ORGANICS PVT LTD-110 200117GN00149,shopping,,net_banking_transfer,7601.98
61b6fc31d8beac1599eb13bb,50200023535069,489237.13,60ec41ba55c00300382672d9,HDFC,Revenue-PG-split enabled,5eecc6d6449e4f7cfb1c2708,2020-11-02T00:00:00.000Z,NEFT CR-UTIB0001506-RAZORPAY SOFTWARE PR IVATE LIMITED-SLICK ORGANICS PVT LITD-AX ISCN0060082569,investments,,net_banking_transfer,52883.8
61b6fc32d8beac1599eb13cc,50200023535069,491706.99,60ec41ba55c00300382672d9,HDFC,Revenue-Mktplace,5eecc6d6449e4f7cfb1c2708,2020-11-02T00:00:00.000Z,NEFT CR-DEUT0797BGL-MYNTRA DESIGNS PRIVA TE LIMITED-SLICK ORGANICS PRIVATE LIMITE D-110200153GN00194,shopping,,net_banking_transfer,2469.86
61b6fc33d8beac1599eb13d4,50200023535069,191706.99,60ec41ba55c00300382672d9,HDFC,direct expenses,5eecc6d6449e4f7cfb1c2708,2020-11-02T00:00:00.000Z,"NEFT DR-ICIC0003430-HASHTAG ORANGE ADVER TISING PVT LTD-NETBANK, MUM-N30720129359 9396-300000",,,net_banking_transfer,-300000
61b6fc34d8beac1599eb13da,50200023535069,91706.99,60ec41ba55c00300382672d9,HDFC,direct expenses,5eecc6d6449e4f7cfb1c2708,2020-11-02T00:00:00.000Z,"NEFT DR-SCBL0036025-DHRUV MADHOK-NETBANK , MUM-N307201293607075-100000",,,net_banking_transfer,-100000
61b6fc35d8beac1599eb13de,50200023535069,4237.99,60ec41ba55c00300382672d9,HDFC,direct expenses,5eecc6d6449e4f7cfb1c2708,2020-11-02T00:00:00.000Z,"NEFT DR-UTIB0000723-VEDIC COMECEUTICALS PVT LTD-NETBANK, MUM-N307201293583495-87 469",,,net_banking_transfer,-87469
61b6fc36d8beac1599eb13eb,50200023535069,204237.99,60ec41ba55c00300382672d9,HDFC,Internal Transfers,5eecc6d6449e4f7cfb1c2708,2020-11-02T00:00:00.000Z,IB FUNDS TRANSFER CR-50200035187206 -SL ICK ORGANICS PVT LTD,investments,,Other,200000
61b6fc37d8beac1599eb13f0,50200023535069,304237.99,60ec41ba55c00300382672d9,HDFC,Internal Transfers,5eecc6d6449e4f7cfb1c2708,2020-11-02T00:00:00.000Z,IB FUNDS TRANSFER CR-50200035187206 -SL ICK ORGANICS PVT LTD,investments,,Other,100000
61b6fc38d8beac1599eb13f3,50200023535069,49237.99,60ec41ba55c00300382672d9,HDFC,SAAS/tech expense,5eecc6d6449e4f7cfb1c2708,2020-11-02T00:00:00.000Z,VHDF9417789164/BILLDKAMAZONSELLERSE,shopping,,Other,-255000
61b6fc39d8beac1599eb13ff,50200023535069,18610.99,60ec41ba55c00300382672d9,HDFC,direct expenses,5eecc6d6449e4f7cfb1c2708,2020-11-02T00:00:00.000Z,"NEFT DR-IOBA0001834-VINDHYA SINGH-NETBAN K, MUM-N307201293688564-30627",,,net_banking_transfer,-30627
61b6fc3ad8beac1599eb1407,50200023535069,9274.71,60ec41ba55c00300382672d9,HDFC,direct expenses,5eecc6d6449e4f7cfb1c2708,2020-11-02T00:00:00.000Z,POS 514834XXXXXX9486 STK*SHUTTERSTOCK,,,debit_card,-9336.28
61b6fc3ad8beac1599eb140b,50200023535069,11702.59,60ec41ba55c00300382672d9,HDFC,Revenue-Mktplace,5eecc6d6449e4f7cfb1c2708,2020-11-02T00:00:00.000Z,NEFT CR-DEUT0797BGL-MYNTRA DESIGNS PRIVA,shopping,,net_banking_transfer,2427.88
61b6fc3bd8beac1599eb1414,50200023535069,14889.18,60ec41ba55c00300382672d9,HDFC,Revenue-Mktplace,5eecc6d6449e4f7cfb1c2708,2020-11-02T00:00:00.000Z,NEFT CR-DEUT0797BGL-FLIPKART INTERNET PR IVATE LIMITED-SLICK ORGANICS PVT LTD-110 200164GN00089,shopping,,net_banking_transfer,3186.59
61b6fc3cd8beac1599eb1425,50200023535069,10170.36,60ec41ba55c00300382672d9,HDFC,direct expenses,5eecc6d6449e4f7cfb1c2708,2020-11-02T00:00:00.000Z,POS 514834XXXXXX4081 ONLINE PAYMENT,,,debit_card,-4718.82
61b6fc3dd8beac1599eb1438,50200023535069,25129.59,60ec41ba55c00300382672d9,HDFC,Revenue-PG-split enabled,5eecc6d6449e4f7cfb1c2708,2020-11-02T00:00:00.000Z,NEFT CR-UTIB0001506-RAZORPAY SOFTWARE PR IVATE LIMITED-SLICK ORGANICS PVT LITD-AX ISCN0060153579,investments,,net_banking_transfer,14959.23
61b6fc3ed8beac1599eb1447,50200023535069,51820.74,60ec41ba55c00300382672d9,HDFC,Revenue-COD,5eecc6d6449e4f7cfb1c2708,2020-11-02T00:00:00.000Z,NEFT CR-KKBK0000958-BIGFOOT RETAIL SOLUT IONS PRIVATE LIMITED-SLICK ORGANICS PVT LTD-KKBK203078558495,,,net_banking_transfer,26691.15
61b6fc3fd8beac1599eb144e,50200023535069,66373.97,60ec41ba55c00300382672d9,HDFC,Revenue-PG-non-split,5eecc6d6449e4f7cfb1c2708,2020-11-03T00:00:00.000Z,UPI-PAYTM-PAYOUTS@PAYTM-PYTM0123456-0308 87557096-ALL202011032168200,ewallet,,upi,14553.23
61b6fc40d8beac1599eb145e,50200023535069,90540.23,60ec41ba55c00300382672d9,HDFC,Revenue-PG-split enabled,5eecc6d6449e4f7cfb1c2708,2020-11-03T00:00:00.000Z,NEFT CR-UTIB0001506-RAZORPAY SOFTWARE PR IVATE LIMITED-SLICK ORGANICS PVT LITD-AX ISCN0060185124,investments,,net_banking_transfer,24166.26
61b6fc41d8beac1599eb1468,50200023535069,540.23,60ec41ba55c00300382672d9,HDFC,direct expenses,5eecc6d6449e4f7cfb1c2708,2020-11-03T00:00:00.000Z,50200031284040-TPT-90000-BURGEON LAW LLP,,,net_banking_transfer,-90000
61b6fc42d8beac1599eb1470,50200023535069,353791.93,60ec41ba55c00300382672d9,HDFC,Revenue-Mktplace,5eecc6d6449e4f7cfb1c2708,2020-11-03T00:00:00.000Z,NEFT CR-DEUT0797BGL-AMAZON PAY (INDIA) P RIVATE LIMITED-SLICK ORGANICS PVT LTD-11 0300136GN00176,shopping,,net_banking_transfer,353251.7
61b6fc43d8beac1599eb147c,50200023535069,604022.59,60ec41ba55c00300382672d9,HDFC,Revenue-Mktplace,5eecc6d6449e4f7cfb1c2708,2020-11-03T00:00:00.000Z,NEFT CR-HSBC0560002-AMAZON SELLER SERVIC ES PRIVATE LIMI-SLICK ORGANICS PVT L-HSB CN20308885537,shopping,,net_banking_transfer,250230.66
61b6fc44d8beac1599eb149f,50200023535069,603873.07,60ec41ba55c00300382672d9,HDFC,bank charges,5eecc6d6449e4f7cfb1c2708,2020-11-03T00:00:00.000Z,.DC INTL POS TXN MARKUP+ST 251020 271020 -CDT2030701838784,,,international_transaction_arbitrage,-149.52
61b6fc45d8beac1599eb14b0,50200023535069,631780.12,60ec41ba55c00300382672d9,HDFC,Revenue-PG-split enabled,5eecc6d6449e4f7cfb1c2708,2020-11-03T00:00:00.000Z,NEFT CR-UTIB0001506-RAZORPAY SOFTWARE PR IVATE LIMITED-SLICK ORGANICS PVT LITD-AX ISCN0060277557,investments,,net_banking_transfer,27907.05
61b6fc46d8beac1599eb14b7,50200023535069,651772,60ec41ba55c00300382672d9,HDFC,Revenue-PG-non-split,5eecc6d6449e4f7cfb1c2708,2020-11-04T00:00:00.000Z,IMPS-030905164693-PAYTM-HDFC-XXXXXXXXXX0 007-,ewallet,,net_banking_transfer,19991.88
61b6fc47d8beac1599eb14be,50200023535069,660851.38,60ec41ba55c00300382672d9,HDFC,Revenue-Mktplace,5eecc6d6449e4f7cfb1c2708,2020-11-04T00:00:00.000Z,NEFT CR-DEUT0797BGL-FLIPKART INTERNET PR,shopping,,net_banking_transfer,9079.38
61b6fc48d8beac1599eb14c4,50200023535069,692937.72,60ec41ba55c00300382672d9,HDFC,Revenue-PG-split enabled,5eecc6d6449e4f7cfb1c2708,2020-11-04T00:00:00.000Z,NEFT CR-UTIB0001506-RAZORPAY SOFTWARE PR IVATE LIMITED-SLICK ORGANICS PVT LITD-AX ISCN0060304253,investments,,net_banking_transfer,32086.34
61b6fc49d8beac1599eb14cb,50200023535069,892937.72,60ec41ba55c00300382672d9,HDFC,Internal Transfers,5eecc6d6449e4f7cfb1c2708,2020-11-04T00:00:00.000Z,IB FUNDS TRANSFER CR-50200035187206 -SL ICK ORGANICS PVT LTD,investments,,Other,200000
61b6fc4ad8beac1599eb14d2,50200023535069,692937.72,60ec41ba55c00300382672d9,HDFC,direct expenses,5eecc6d6449e4f7cfb1c2708,2020-11-04T00:00:00.000Z,"NEFT DR-PYTM0123456-PAYTM-NETBANK, MUM-N 309201296082362-200000",ewallet,,net_banking_transfer,-200000
61b6fc4bd8beac1599eb14d6,50200023535069,492937.72,60ec41ba55c00300382672d9,HDFC,direct expenses,5eecc6d6449e4f7cfb1c2708,2020-11-04T00:00:00.000Z,"NEFT DR-PYTM0123456-PAYTM-NETBANK, MUM-N 309201296082547-200000",ewallet,,net_banking_transfer,-200000
61b6fc4cd8beac1599eb14dc,50200023535069,292937.72,60ec41ba55c00300382672d9,HDFC,direct expenses,5eecc6d6449e4f7cfb1c2708,2020-11-04T00:00:00.000Z,IMPS-030909155468-PAYTM-PYTM-XXXXXXXX383 9-200000,ewallet,,net_banking_transfer,-200000
61b6fc4dd8beac1599eb14e4,50200023535069,92937.72,60ec41ba55c00300382672d9,HDFC,direct expenses,5eecc6d6449e4f7cfb1c2708,2020-11-04T00:00:00.000Z,IMPS-030909160118-PAYTM-PYTM-XXXXXXXX383 9-200000,ewallet,,net_banking_transfer,-200000
61b6fc4ed8beac1599eb14ec,50200023535069,93189.12,60ec41ba55c00300382672d9,HDFC,Revenue-Mktplace,5eecc6d6449e4f7cfb1c2708,2020-11-04T00:00:00.000Z,NEFT CR-DEUT0797BGL-MYNTRA DESIGNS PRIVA TE LIMITED-SLICK ORGANICS PRIVATE LIMITE D-110400179GN00189,shopping,,net_banking_transfer,251.4
61b6fc4fd8beac1599eb14f8,50200023535069,172189.12,60ec41ba55c00300382672d9,HDFC,Transfer in/Revenue-other,5eecc6d6449e4f7cfb1c2708,2020-11-04T00:00:00.000Z,IMPS-030910570561-ARATA-HDFC-XXXXXXXXXX0 001-,,,net_banking_transfer,79000
61b6fc50d8beac1599eb14fd,50200023535069,22189.12,60ec41ba55c00300382672d9,HDFC,direct expenses,5eecc6d6449e4f7cfb1c2708,2020-11-04T00:00:00.000Z,05892560000649-TPT-150000-DECORPAC INDIA PRIVATE LIMITED,,,net_banking_transfer,-150000
61b6fc51d8beac1599eb1506,50200023535069,43689.12,60ec41ba55c00300382672d9,HDFC,Internal Transfers,5eecc6d6449e4f7cfb1c2708,2020-11-04T00:00:00.000Z,IB FUNDS TRANSFER CR-50200050976833 -SL ICK ORGANICS PVT LTD,investments,,Other,21500
61b6fc52d8beac1599eb150d,50200023535069,33689.12,60ec41ba55c00300382672d9,HDFC,Marketing Expense,5eecc6d6449e4f7cfb1c2708,2020-11-04T00:00:00.000Z,POS 514834XXXXXX9486 GOOGLE ADWORDS,,,debit_card,-10000
61b6fc53d8beac1599eb1511,50200023535069,34894.22,60ec41ba55c00300382672d9,HDFC,Revenue-Mktplace,5eecc6d6449e4f7cfb1c2708,2020-11-04T00:00:00.000Z,NEFT CR-DEUT0797BGL-MYNTRA DESIGNS PRIVA TE LIMITED-SLICK ORGANICS PRIVATE LIMITE D-110400220GN00215,shopping,,net_banking_transfer,1205.1
61b6fc54d8beac1599eb1515,50200023535069,35931.22,60ec41ba55c00300382672d9,HDFC,Revenue-Mktplace,5eecc6d6449e4f7cfb1c2708,2020-11-04T00:00:00.000Z,POS REF 514834******9486-11/04 AMAZON,shopping,,refund,1037
61b6fc55d8beac1599eb1524,50200023535069,39632.69,60ec41ba55c00300382672d9,HDFC,Revenue-Mktplace,5eecc6d6449e4f7cfb1c2708,2020-11-04T00:00:00.000Z,NEFT CR-DEUT0797BGL-FLIPKART INTERNET PR,shopping,,net_banking_transfer,3701.47
61b6fc56d8beac1599eb1527,50200023535069,113671.83,60ec41ba55c00300382672d9,HDFC,Revenue-COD,5eecc6d6449e4f7cfb1c2708,2020-11-04T00:00:00.000Z,NEFT CR-KKBK0000958-BIGFOOT RETAIL SOLUT IONS PRIVATE LIMITED-SLICK ORGANICS PVT LTD-KKBK203099024144,,,net_banking_transfer,74039.14
61b6fc57d8beac1599eb152b,50200023535069,131211.73,60ec41ba55c00300382672d9,HDFC,Revenue-PG-split enabled,5eecc6d6449e4f7cfb1c2708,2020-11-04T00:00:00.000Z,NEFT CR-UTIB0001506-RAZORPAY SOFTWARE PR IVATE LIMITED-SLICK ORGANICS PVT LITD-AX ISCN0060349830,investments,,net_banking_transfer,17539.9
61b6fc58d8beac1599eb1533,50200023535069,139748.7,60ec41ba55c00300382672d9,HDFC,Revenue-PG-non-split,5eecc6d6449e4f7cfb1c2708,2020-11-05T00:00:00.000Z,IMPS-031005415922-PAYTM-HDFC-XXXXXXXXXX0 007-,ewallet,,net_banking_transfer,8536.97
61b6fc58d8beac1599eb1537,50200023535069,161418.68,60ec41ba55c00300382672d9,HDFC,Revenue-PG-split enabled,5eecc6d6449e4f7cfb1c2708,2020-11-05T00:00:00.000Z,NEFT CR-UTIB0001506-RAZORPAY SOFTWARE PR IVATE LIMITED-SLICK ORGANICS PVT LITD-AX ISCN0060383551,investments,,net_banking_transfer,21669.98
61b6fc59d8beac1599eb1540,50200023535069,1161418.68,60ec41ba55c00300382672d9,HDFC,Internal Transfers,5eecc6d6449e4f7cfb1c2708,2020-11-05T00:00:00.000Z,IB FUNDS TRANSFER CR-50200035187206 -SL ICK ORGANICS PVT LTD,investments,,Other,1000000
61b6fc5ad8beac1599eb1547,50200023535069,961418.68,60ec41ba55c00300382672d9,HDFC,direct expenses,5eecc6d6449e4f7cfb1c2708,2020-11-05T00:00:00.000Z,IMPS-031011156501-PAYTM-PYTM-XXXXXXXX383 9-200000,ewallet,,net_banking_transfer,-200000
61b6fc5bd8beac1599eb154d,50200023535069,761418.68,60ec41ba55c00300382672d9,HDFC,direct expenses,5eecc6d6449e4f7cfb1c2708,2020-11-05T00:00:00.000Z,IMPS-031011158098-PAYTM-PYTM-XXXXXXXX383 9-200000,ewallet,,net_banking_transfer,-200000
61b6fc5cd8beac1599eb1551,50200023535069,533884.68,60ec41ba55c00300382672d9,HDFC,direct expenses,5eecc6d6449e4f7cfb1c2708,2020-11-05T00:00:00.000Z,"NEFT DR-ORBC0101001-KRAUTER HEALTHCARE L TD-NETBANK, MUM-N310201297558218-PO 007",,,net_banking_transfer,-227534
61b6fc5dd8beac1599eb1555,50200023535069,417300.68,60ec41ba55c00300382672d9,HDFC,direct expenses,5eecc6d6449e4f7cfb1c2708,2020-11-05T00:00:00.000Z,"NEFT DR-ORBC0101001-KRAUTER HEALTHCARE L TD-NETBANK, MUM-N310201297561653-PO 008",,,net_banking_transfer,-116584
61b6fc5ed8beac1599eb155d,50200023535069,317300.68,60ec41ba55c00300382672d9,HDFC,direct expenses,5eecc6d6449e4f7cfb1c2708,2020-11-05T00:00:00.000Z,57500000443889-TPT-100000-WEBKLIPPER TEC HNOLOGIES PRIVATE LIMITED,,,net_banking_transfer,-100000
61b6fc5fd8beac1599eb155f,50200023535069,117300.68,60ec41ba55c00300382672d9,HDFC,direct expenses,5eecc6d6449e4f7cfb1c2708,2020-11-05T00:00:00.000Z,IMPS-031012165937-PAYTM-PYTM-XXXXXXXX383 9-200000,ewallet,,net_banking_transfer,-200000
61b6fc60d8beac1599eb1564,50200023535069,116338.68,60ec41ba55c00300382672d9,HDFC,direct expenses,5eecc6d6449e4f7cfb1c2708,2020-11-05T00:00:00.000Z,"NEFT DR-SBIN0070155-ASHITHA THOMAS-NETBA NK, MUM-N310201297615649-962",,,net_banking_transfer,-962
61b6fc61d8beac1599eb156b,50200023535069,140386.3,60ec41ba55c00300382672d9,HDFC,Revenue-PG-split enabled,5eecc6d6449e4f7cfb1c2708,2020-11-05T00:00:00.000Z,NEFT CR-UTIB0001506-RAZORPAY SOFTWARE PR IVATE LIMITED-SLICK ORGANICS PVT LITD-AX ISCN0060451301,investments,,net_banking_transfer,24047.62
61b6fc62d8beac1599eb156f,50200023535069,152018.79,60ec41ba55c00300382672d9,HDFC,Revenue-PG-non-split,5eecc6d6449e4f7cfb1c2708,2020-11-06T00:00:00.000Z,UPI-PAYTM-PAYOUTS@PAYTM-PYTM0123456-0311,ewallet,,upi,11632.49
61b6fc63d8beac1599eb1578,50200023535069,2018.79,60ec41ba55c00300382672d9,HDFC,direct expenses,5eecc6d6449e4f7cfb1c2708,2020-11-06T00:00:00.000Z,IMPS-031108173700-PAYTM-PYTM-XXXXXXXX383 9-150000,ewallet,,net_banking_transfer,-150000
61b6fc64d8beac1599eb157d,50200023535069,1002018.79,60ec41ba55c00300382672d9,HDFC,Internal Transfers,5eecc6d6449e4f7cfb1c2708,2020-11-06T00:00:00.000Z,IB FUNDS TRANSFER CR-50200035187206 -SL ICK ORGANICS PVT LTD,investments,,Other,1000000
61b6fc65d8beac1599eb1582,50200023535069,902018.79,60ec41ba55c00300382672d9,HDFC,direct expenses,5eecc6d6449e4f7cfb1c2708,2020-11-06T00:00:00.000Z,IMPS-031108175619-PAYTM-PYTM-XXXXXXXX383 9-100000,ewallet,,net_banking_transfer,-100000
61b6fc66d8beac1599eb1587,50200023535069,911048.58,60ec41ba55c00300382672d9,HDFC,Revenue-Mktplace,5eecc6d6449e4f7cfb1c2708,2020-11-06T00:00:00.000Z,NEFT CR-DEUT0797BGL-FLIPKART INTERNET PR IVATE LIMITED-SLICK ORGANICS PVT LTD-110 600120GN00239,shopping,,net_banking_transfer,9029.79
61b6fc67d8beac1599eb158c,50200023535069,896048.58,60ec41ba55c00300382672d9,HDFC,direct expenses,5eecc6d6449e4f7cfb1c2708,2020-11-06T00:00:00.000Z,IMPS-031109182456-PAYTM-PYTM-XXXXXXXX383 9-15000,ewallet,,net_banking_transfer,-15000
61b6fc68d8beac1599eb1591,50200023535069,941059.28,60ec41ba55c00300382672d9,HDFC,Revenue-PG-split enabled,5eecc6d6449e4f7cfb1c2708,2020-11-06T00:00:00.000Z,NEFT CR-UTIB0001506-RAZORPAY SOFTWARE PR IVATE LIMITED-SLICK ORGANICS PVT LITD-AX ISCN0060503189,investments,,net_banking_transfer,45010.7
61b6fc69d8beac1599eb1595,50200023535069,942761.16,60ec41ba55c00300382672d9,HDFC,Revenue-Mktplace,5eecc6d6449e4f7cfb1c2708,2020-11-06T00:00:00.000Z,NEFT CR-DEUT0797BGL-MYNTRA DESIGNS PRIVA TE LIMITED-SLICK ORGANICS PRIVATE LIMITE D-110600204GN00226,shopping,,net_banking_transfer,1701.88
61b6fc6ad8beac1599eb1598,50200023535069,642761.16,60ec41ba55c00300382672d9,HDFC,direct expenses,5eecc6d6449e4f7cfb1c2708,2020-11-06T00:00:00.000Z,50200001182150-TPT-300000-DEXTER CAPITAL ADVISORS PVT LTD,,,net_banking_transfer,-300000
61b6fc6bd8beac1599eb159d,50200023535069,492761.16,60ec41ba55c00300382672d9,HDFC,direct expenses,5eecc6d6449e4f7cfb1c2708,2020-11-06T00:00:00.000Z,05892560000649-TPT-150000-DECORPAC INDIA PRIVATE LIMITED,,,net_banking_transfer,-150000
61b6fc6cd8beac1599eb15a6,50200023535069,397386.16,60ec41ba55c00300382672d9,HDFC,direct expenses,5eecc6d6449e4f7cfb1c2708,2020-11-06T00:00:00.000Z,50200031284040-TPT-95375-BURGEON LAW LLP,,,net_banking_transfer,-95375
61b6fc6dd8beac1599eb15ae,50200023535069,398043.81,60ec41ba55c00300382672d9,HDFC,Revenue-Mktplace,5eecc6d6449e4f7cfb1c2708,2020-11-06T00:00:00.000Z,NEFT CR-DEUT0797BGL-MYNTRA DESIGNS PRIVA TE LIMITED-SLICK ORGANICS PRIVATE LIMITE D-110600244GN00215,shopping,,net_banking_transfer,657.65
61b6fc6ed8beac1599eb15b4,50200023535069,403390.35,60ec41ba55c00300382672d9,HDFC,Revenue-Mktplace,5eecc6d6449e4f7cfb1c2708,2020-11-06T00:00:00.000Z,NEFT CR-DEUT0797BGL-FLIPKART INTERNET PR IVATE LIMITED-SLICK ORGANICS PVT LTD-110 600081GN00081,shopping,,net_banking_transfer,5346.54
61b6fc6fd8beac1599eb15b9,50200023535069,429234.1,60ec41ba55c00300382672d9,HDFC,Revenue-COD,5eecc6d6449e4f7cfb1c2708,2020-11-06T00:00:00.000Z,NEFT CR-KKBK0000958-BIGFOOT RETAIL SOLUT IONS PRIVATE LIMITED-SLICK ORGANICS PVT LTD-KKBK203119585194,,,net_banking_transfer,25843.75
61b6fc70d8beac1599eb15be,50200023535069,466336.49,60ec41ba55c00300382672d9,HDFC,Revenue-PG-split enabled,5eecc6d6449e4f7cfb1c2708,2020-11-06T00:00:00.000Z,NEFT CR-UTIB0001506-RAZORPAY SOFTWARE PR,,,net_banking_transfer,37102.39
61b6fc71d8beac1599eb15c2,50200023535069,468359.04,60ec41ba55c00300382672d9,HDFC,Revenue-Mktplace,5eecc6d6449e4f7cfb1c2708,2020-11-06T00:00:00.000Z,NEFT CR-DEUT0784BBY-TATA UNISTORE LTD-NO DAL-SLICK ORGANICS PVT LTD-110601485GN00 316,investments,,net_banking_transfer,2022.55
61b6fc72d8beac1599eb15c7,50200023535069,469241.04,60ec41ba55c00300382672d9,HDFC,Revenue-Mktplace,5eecc6d6449e4f7cfb1c2708,2020-11-06T00:00:00.000Z,IMPS-031119419601-MSDREAMPLUGTECHNOLOG-H DFC-XXXXXXX9394-52,,,net_banking_transfer,882
61b6fc73d8beac1599eb15cc,50200023535069,486605.34,60ec41ba55c00300382672d9,HDFC,Revenue-PG-non-split,5eecc6d6449e4f7cfb1c2708,2020-11-07T00:00:00.000Z,UPI-PAYTM-PAYOUTS@PAYTM-PYTM0123456-0312 72313669-ALL202011072168200,ewallet,,upi,17364.3
61b6fc74d8beac1599eb15d0,50200023535069,514644.83,60ec41ba55c00300382672d9,HDFC,Revenue-PG-split enabled,5eecc6d6449e4f7cfb1c2708,2020-11-07T00:00:00.000Z,NEFT CR-UTIB0001506-RAZORPAY SOFTWARE PR IVATE LIMITED-SLICK ORGANICS PVT LITD-AX ISCN0060585973,investments,,net_banking_transfer,28039.49
61b6fc74d8beac1599eb15d4,50200023535069,517307.88,60ec41ba55c00300382672d9,HDFC,Revenue-Mktplace,5eecc6d6449e4f7cfb1c2708,2020-11-07T00:00:00.000Z,NEFT CR-KKBK0000958-SUPERMARKET GROCERY SUPPLIES PVT LTD-SLICK ORGANICS PVT LTD- KKBK203129748628,shopping,,net_banking_transfer,2663.05
61b6fc75d8beac1599eb15dc,50200023535069,523848.78,60ec41ba55c00300382672d9,HDFC,Revenue-Mktplace,5eecc6d6449e4f7cfb1c2708,2020-11-07T00:00:00.000Z,NEFT CR-KKBK0000958-SUPERMARKET GROCERY SUPPLIES PVT LTD-SLICK ORGANICS PVT LTD- KKBK203129748623,shopping,,net_banking_transfer,6540.9
61b6fc76d8beac1599eb15df,50200023535069,524985.63,60ec41ba55c00300382672d9,HDFC,Revenue-Mktplace,5eecc6d6449e4f7cfb1c2708,2020-11-07T00:00:00.000Z,NEFT CR-KKBK0000958-SUPERMARKET GROCERY SUPPLIES PVT LTD-SLICK ORGANICS PVT LTD- KKBK203129748711,shopping,,net_banking_transfer,1136.85
61b6fc77d8beac1599eb15e7,50200023535069,526122.48,60ec41ba55c00300382672d9,HDFC,Revenue-Mktplace,5eecc6d6449e4f7cfb1c2708,2020-11-07T00:00:00.000Z,NEFT CR-KKBK0000958-SUPERMARKET GROCERY SUPPLIES PVT LTD-SLICK ORGANICS PVT LTD- KKBK203129748784,shopping,,net_banking_transfer,1136.85
61b6fc78d8beac1599eb15ec,50200023535069,533204.33,60ec41ba55c00300382672d9,HDFC,Revenue-Mktplace,5eecc6d6449e4f7cfb1c2708,2020-11-07T00:00:00.000Z,NEFT CR-KKBK0000958-SUPERMARKET GROCERY SUPPLIES PVT LTD-SLICK ORGANICS PVT LTD- KKBK203129750337,shopping,,net_banking_transfer,7081.85
61b6fc79d8beac1599eb15f1,50200023535069,535851.81,60ec41ba55c00300382672d9,HDFC,Revenue-Mktplace,5eecc6d6449e4f7cfb1c2708,2020-11-07T00:00:00.000Z,NEFT CR-KKBK0000958-SUPERMARKET GROCERY SUPPLIES PVT LTD-SLICK ORGANICS PVT LTD- KKBK203129750360,shopping,,net_banking_transfer,2647.48
61b6fc7ad8beac1599eb1600,50200023535069,546553.16,60ec41ba55c00300382672d9,HDFC,Revenue-Mktplace,5eecc6d6449e4f7cfb1c2708,2020-11-07T00:00:00.000Z,NEFT CR-KKBK0000958-SUPERMARKET GROCERY,shopping,,net_banking_transfer,10701.35
61b6fc7bd8beac1599eb1604,50200023535069,546507.17,60ec41ba55c00300382672d9,HDFC,bank charges,5eecc6d6449e4f7cfb1c2708,2020-11-07T00:00:00.000Z,.DC INTL POS TXN MARKUP+ST 281020 311020 -CDT2030701838784,,,international_transaction_arbitrage,-45.99
61b6fc7cd8beac1599eb1609,50200023535069,563580.98,60ec41ba55c00300382672d9,HDFC,Revenue-PG-split enabled,5eecc6d6449e4f7cfb1c2708,2020-11-07T00:00:00.000Z,NEFT CR-UTIB0001506-RAZORPAY SOFTWARE PR IVATE LIMITED-SLICK ORGANICS PVT LITD-AX ISCN0060621777,investments,,net_banking_transfer,17073.81
61b6fc7dd8beac1599eb160c,50200023535069,576362.56,60ec41ba55c00300382672d9,HDFC,Revenue-PG-non-split,5eecc6d6449e4f7cfb1c2708,2020-11-08T00:00:00.000Z,IMPS-031305094819-PAYTM-HDFC-XXXXXXXXXX0 007-,ewallet,,net_banking_transfer,12781.58
61b6fc7ed8beac1599eb1611,50200023535069,502362.56,60ec41ba55c00300382672d9,HDFC,direct expenses,5eecc6d6449e4f7cfb1c2708,2020-11-08T00:00:00.000Z,"NEFT DR-CITI0000002-DHIRAJ-NETBANK, MUM- N313201301820754-74000",,,net_banking_transfer,-74000
61b6fc7fd8beac1599eb1618,50200023535069,432362.56,60ec41ba55c00300382672d9,HDFC,direct expenses,5eecc6d6449e4f7cfb1c2708,2020-11-08T00:00:00.000Z,"NEFT DR-ICIC0000542-AVANTIKA SUKHIA-NETB ANK, MUM-N313201301807931-70000",,,net_banking_transfer,-70000
61b6fc80d8beac1599eb1622,50200023535069,417362.56,60ec41ba55c00300382672d9,HDFC,direct expenses,5eecc6d6449e4f7cfb1c2708,2020-11-08T00:00:00.000Z,"NEFT DR-SIBL0000555-JAIVEER KUMAR-NETBAN K, MUM-N313201301816079-15000",,,net_banking_transfer,-15000
61b6fc81d8beac1599eb162a,50200023535069,407362.56,60ec41ba55c00300382672d9,HDFC,direct expenses,5eecc6d6449e4f7cfb1c2708,2020-11-08T00:00:00.000Z,"NEFT DR-PUNB0398000-MEENA SINGH-NETBANK, MUM-N313201301820951-10000",,,net_banking_transfer,-10000
61b6fc82d8beac1599eb162e,50200023535069,372362.56,60ec41ba55c00300382672d9,HDFC,direct expenses,5eecc6d6449e4f7cfb1c2708,2020-11-08T00:00:00.000Z,"NEFT DR-ICIC0003374-SIDDHARTH KANOJIA-NE TBANK, MUM-N313201301821009-35000",,,net_banking_transfer,-35000
61b6fc83d8beac1599eb1634,50200023535069,366362.56,60ec41ba55c00300382672d9,HDFC,direct expenses,5eecc6d6449e4f7cfb1c2708,2020-11-08T00:00:00.000Z,"NEFT DR-ALLA0210591-CHAMPA DEVI-NETBANK, MUM-N313201301816224-6000",,,net_banking_transfer,-6000
61b6fc84d8beac1599eb163a,50200023535069,338737.56,60ec41ba55c00300382672d9,HDFC,direct expenses,5eecc6d6449e4f7cfb1c2708,2020-11-08T00:00:00.000Z,"NEFT DR-SYNB0005170-SNEHAL TAYDE-NETBANK , MUM-N313201301816306-27625",,,net_banking_transfer,-27625
61b6fc85d8beac1599eb163f,50200023535069,297037.56,60ec41ba55c00300382672d9,HDFC,direct expenses,5eecc6d6449e4f7cfb1c2708,2020-11-08T00:00:00.000Z,"NEFT DR-UTIB0000120-ADNAN ALI-NETBANK, M UM-N313201301808126-41700",,,net_banking_transfer,-41700
61b6fc86d8beac1599eb1646,50200023535069,204537.56,60ec41ba55c00300382672d9,HDFC,direct expenses,5eecc6d6449e4f7cfb1c2708,2020-11-08T00:00:00.000Z,"NEFT DR-BKDN0450123-ARTISTO DESIGNZ-NETB ANK, MUM-N313201301821447-92500",,,net_banking_transfer,-92500
61b6fc87d8beac1599eb1649,50200023535069,188037.56,60ec41ba55c00300382672d9,HDFC,direct expenses,5eecc6d6449e4f7cfb1c2708,2020-11-08T00:00:00.000Z,"NEFT DR-KKBK0000811-NASIR KHAN-NETBANK, MUM-N313201301813953-16500",,,net_banking_transfer,-16500
61b6fc88d8beac1599eb164e,50200023535069,99537.56,60ec41ba55c00300382672d9,HDFC,direct expenses,5eecc6d6449e4f7cfb1c2708,2020-11-08T00:00:00.000Z,50100301160692-TPT-88500-TARUN GARG,,,net_banking_transfer,-88500
61b6fc89d8beac1599eb1654,50200023535069,67537.56,60ec41ba55c00300382672d9,HDFC,direct expenses,5eecc6d6449e4f7cfb1c2708,2020-11-08T00:00:00.000Z,00901610080520-TPT-32000-POOJA KAPIL SHR OTRIYA,,,net_banking_transfer,-32000
61b6fc8ad8beac1599eb1659,50200023535069,367537.56,60ec41ba55c00300382672d9,HDFC,Internal Transfers,5eecc6d6449e4f7cfb1c2708,2020-11-08T00:00:00.000Z,IB FUNDS TRANSFER CR-50200035187206 -SL,,,Other,300000
61b6fc8bd8beac1599eb165f,50200023535069,267537.56,60ec41ba55c00300382672d9,HDFC,direct expenses,5eecc6d6449e4f7cfb1c2708,2020-11-08T00:00:00.000Z,02771610131904-TPT-100000-DIGANT BHATT,,,net_banking_transfer,-100000
61b6fc8cd8beac1599eb1664,50200023535069,201537.56,60ec41ba55c00300382672d9,HDFC,direct expenses,5eecc6d6449e4f7cfb1c2708,2020-11-08T00:00:00.000Z,50100330586095-TPT-66000-DIWAKAR UNIYAL,,,net_banking_transfer,-66000
61b6fc8dd8beac1599eb1669,50200023535069,171537.56,60ec41ba55c00300382672d9,HDFC,direct expenses,5eecc6d6449e4f7cfb1c2708,2020-11-08T00:00:00.000Z,"NEFT DR-SBIN0007976-SHLAGHA BORAH-NETBAN K, MUM-N313201301817512-30000",,,net_banking_transfer,-30000
61b6fc8ed8beac1599eb166e,50200023535069,189592.09,60ec41ba55c00300382672d9,HDFC,Revenue-PG-non-split,5eecc6d6449e4f7cfb1c2708,2020-11-09T00:00:00.000Z,UPI-PAYTM-PAYOUTS@PAYTM-PYTM0123456-0314 18761007-ALL202011092168200,ewallet,,upi,18054.53
61b6fc8fd8beac1599eb1673,50200023535069,169592.09,60ec41ba55c00300382672d9,HDFC,direct expenses,5eecc6d6449e4f7cfb1c2708,2020-11-09T00:00:00.000Z,"NEFT DR-SBIN0001189-SANDEEP SINGH-NETBAN K, MUM-N314201302119705-20000",,,net_banking_transfer,-20000
61b6fc90d8beac1599eb1677,50200023535069,174443.51,60ec41ba55c00300382672d9,HDFC,Revenue-Mktplace,5eecc6d6449e4f7cfb1c2708,2020-11-09T00:00:00.000Z,NEFT CR-DEUT0797BGL-FLIPKART INTERNET PR IVATE LIMITED-SLICK ORGANICS PVT LTD-110 900117GN00117,shopping,,net_banking_transfer,4851.42
61b6fc91d8beac1599eb167c,50200023535069,163209.51,60ec41ba55c00300382672d9,HDFC,Salary/Emp/consultant Expense,5eecc6d6449e4f7cfb1c2708,2020-11-09T00:00:00.000Z,"NEFT DR-UTIB0000404-ELIZABETH THOMAS ALE X-NETBANK, MUM-N314201302094515-11234",,,net_banking_transfer,-11234
61b6fc92d8beac1599eb1681,50200023535069,159421.51,60ec41ba55c00300382672d9,HDFC,direct expenses,5eecc6d6449e4f7cfb1c2708,2020-11-09T00:00:00.000Z,50100097355028-TPT-3788-PALLAVI JUNEJA,,,net_banking_transfer,-3788
61b6fc93d8beac1599eb1685,50200023535069,232463.58,60ec41ba55c00300382672d9,HDFC,Revenue-PG-split enabled,5eecc6d6449e4f7cfb1c2708,2020-11-09T00:00:00.000Z,NEFT CR-UTIB0001506-RAZORPAY SOFTWARE PR IVATE LIMITED-SLICK ORGANICS PVT LITD-AX ISCN0060644883,investments,,net_banking_transfer,73042.07
61b6fc93d8beac1599eb168d,50200023535069,132463.58,60ec41ba55c00300382672d9,HDFC,SAAS/tech expense,5eecc6d6449e4f7cfb1c2708,2020-11-09T00:00:00.000Z,VHDF9444103122/BILLDKAMAZONSELLERSE,shopping,,Other,-100000
61b6fc94d8beac1599eb1690,50200023535069,136054.39,60ec41ba55c00300382672d9,HDFC,Revenue-Mktplace,5eecc6d6449e4f7cfb1c2708,2020-11-09T00:00:00.000Z,NEFT CR-DEUT0797BGL-MYNTRA DESIGNS PRIVA TE LIMITED-SLICK ORGANICS PRIVATE LIMITE D-110900497GN00249,shopping,,net_banking_transfer,3590.81
61b6fc95d8beac1599eb1698,50200023535069,136342.7,60ec41ba55c00300382672d9,HDFC,Revenue-Mktplace,5eecc6d6449e4f7cfb1c2708,2020-11-09T00:00:00.000Z,NEFT CR-DEUT0797BGL-MYNTRA DESIGNS PRIVA TE LIMITED-SLICK ORGANICS PRIVATE LIMITE D-110900502GN00205,shopping,,net_banking_transfer,288.31
61b6fc96d8beac1599eb169f,50200023535069,140259.61,60ec41ba55c00300382672d9,HDFC,Revenue-Mktplace,5eecc6d6449e4f7cfb1c2708,2020-11-09T00:00:00.000Z,NEFT CR-DEUT0797BGL-FLIPKART INTERNET PR IVATE LIMITED-SLICK ORGANICS PVT LTD-110 900152GN00209,shopping,,net_banking_transfer,3916.91
61b6fc97d8beac1599eb16a3,50200023535069,158785.51,60ec41ba55c00300382672d9,HDFC,Revenue-PG-split enabled,5eecc6d6449e4f7cfb1c2708,2020-11-09T00:00:00.000Z,NEFT CR-UTIB0001506-RAZORPAY SOFTWARE PR IVATE LIMITED-SLICK ORGANICS PVT LITD-AX ISCN0060748934,investments,,net_banking_transfer,18525.9
61b6fc98d8beac1599eb16a8,50200023535069,173865.37,60ec41ba55c00300382672d9,HDFC,Revenue-PG-non-split,5eecc6d6449e4f7cfb1c2708,2020-11-10T00:00:00.000Z,UPI-PAYTM-PAYOUTS@PAYTM-PYTM0123456-0315,ewallet,,upi,15079.86
61b6fc99d8beac1599eb16ac,50200023535069,178638.37,60ec41ba55c00300382672d9,HDFC,Transfer in/Revenue-other,5eecc6d6449e4f7cfb1c2708,2020-11-10T00:00:00.000Z,NEFT CR-YESB0000001-LEMILL PRIVATE LIMI- SLICK ORGANICS PVT LTD-N315200459768599,,,net_banking_transfer,4773
61b6fc9ad8beac1599eb16b4,50200023535069,233588.26,60ec41ba55c00300382672d9,HDFC,Revenue-PG-split enabled,5eecc6d6449e4f7cfb1c2708,2020-11-10T00:00:00.000Z,NEFT CR-UTIB0001506-RAZORPAY SOFTWARE PR IVATE LIMITED-SLICK ORGANICS PVT LITD-AX ISCN0060780298,investments,,net_banking_transfer,54949.89
61b6fc9bd8beac1599eb16b6,50200023535069,233202.67,60ec41ba55c00300382672d9,HDFC,bank charges,5eecc6d6449e4f7cfb1c2708,2020-11-10T00:00:00.000Z,.DC INTL POS TXN MARKUP+ST 021120 031120 -CDT2030701838784,,,international_transaction_arbitrage,-385.59
61b6fc9cd8beac1599eb16bb,50200023535069,233113.22,60ec41ba55c00300382672d9,HDFC,bank charges,5eecc6d6449e4f7cfb1c2708,2020-11-10T00:00:00.000Z,.DC INTL POS TXN MARKUP+ST 011120 031120 -CDT2030701838784,,,international_transaction_arbitrage,-89.45
61b6fc9dd8beac1599eb16c3,50200023535069,248767.31,60ec41ba55c00300382672d9,HDFC,Revenue-Mktplace,5eecc6d6449e4f7cfb1c2708,2020-11-10T00:00:00.000Z,IMPS-031511124280-AMAZON SELLER SERVIC-H DFC-XXXXXXXX6004-2ON347Y6USJZVZRBSLICK O RGANICS PVT LTD,shopping,,net_banking_transfer,15654.09
61b6fc9ed8beac1599eb16c6,50200023535069,597857.88,60ec41ba55c00300382672d9,HDFC,Revenue-Mktplace,5eecc6d6449e4f7cfb1c2708,2020-11-10T00:00:00.000Z,NEFT CR-DEUT0797BGL-AMAZON PAY (INDIA) P RIVATE LIMITED-SLICK ORGANICS PVT LTD-11 1000143GN00108,shopping,,net_banking_transfer,349090.57
61b6fc9fd8beac1599eb16ce,50200023535069,297857.88,60ec41ba55c00300382672d9,HDFC,direct expenses,5eecc6d6449e4f7cfb1c2708,2020-11-10T00:00:00.000Z,"NEFT DR-ICIC0003430-HASHTAG ORANGE ADVER TISING PVT LTD-NETBANK, MUM-N31520130433 9614-300000",,,net_banking_transfer,-300000
61b6fca0d8beac1599eb16d2,50200023535069,47857.88,60ec41ba55c00300382672d9,HDFC,direct expenses,5eecc6d6449e4f7cfb1c2708,2020-11-10T00:00:00.000Z,"NEFT DR-YESB0000551-VISTTA COSMETICS-NET BANK, MUM-N315201304372151-250000",,,net_banking_transfer,-250000
61b6fca1d8beac1599eb16d7,50200023535069,79050.35,60ec41ba55c00300382672d9,HDFC,Revenue-PG-split enabled,5eecc6d6449e4f7cfb1c2708,2020-11-10T00:00:00.000Z,NEFT CR-UTIB0001506-RAZORPAY SOFTWARE PR IVATE LIMITED-SLICK ORGANICS PVT LITD-AX ISCN0060831111,investments,,net_banking_transfer,31192.47
61b6fca2d8beac1599eb16db,50200023535069,91513.02,60ec41ba55c00300382672d9,HDFC,Revenue-PG-non-split,5eecc6d6449e4f7cfb1c2708,2020-11-11T00:00:00.000Z,UPI-PAYTM-PAYOUTS@PAYTM-PYTM0123456-0316 62965637-ALL202011112168200,ewallet,,upi,12462.67
61b6fca3d8beac1599eb16e0,50200023535069,108513.02,60ec41ba55c00300382672d9,HDFC,Internal Transfers,5eecc6d6449e4f7cfb1c2708,2020-11-11T00:00:00.000Z,IB FUNDS TRANSFER CR-50200050976833 -SL ICK ORGANICS PVT LTD,investments,,Other,17000
61b6fca4d8beac1599eb16e5,50200023535069,153792.69,60ec41ba55c00300382672d9,HDFC,Revenue-PG-split enabled,5eecc6d6449e4f7cfb1c2708,2020-11-11T00:00:00.000Z,NEFT CR-UTIB0001506-RAZORPAY SOFTWARE PR IVATE LIMITED-SLICK ORGANICS PVT LITD-AX ISCN0060858606,investments,,net_banking_transfer,45279.67
61b6fca5d8beac1599eb16e9,50200023535069,154825.92,60ec41ba55c00300382672d9,HDFC,Revenue-Mktplace,5eecc6d6449e4f7cfb1c2708,2020-11-11T00:00:00.000Z,NEFT CR-DEUT0797BGL-FLIPKART INTERNET PR,shopping,,net_banking_transfer,1033.23
61b6fca6d8beac1599eb16ed,50200023535069,155639.51,60ec41ba55c00300382672d9,HDFC,Revenue-Mktplace,5eecc6d6449e4f7cfb1c2708,2020-11-11T00:00:00.000Z,NEFT CR-DEUT0797BGL-MYNTRA DESIGNS PRIVA TE LIMITED-SLICK ORGANICS PRIVATE LIMITE D-111100154GN00292,shopping,,net_banking_transfer,813.59
61b6fca7d8beac1599eb16f7,50200023535069,191365.51,60ec41ba55c00300382672d9,HDFC,Transfer in/Revenue-other,5eecc6d6449e4f7cfb1c2708,2020-11-11T00:00:00.000Z,IMPS-031612930746-VANITY WAGON-HDFC-XXXX XXXXXXX0887-VANITY WAGON,,,net_banking_transfer,35726
61b6fca8d8beac1599eb16fd,50200023535069,91365.51,60ec41ba55c00300382672d9,HDFC,SAAS/tech expense,5eecc6d6449e4f7cfb1c2708,2020-11-11T00:00:00.000Z,POS 514834XXXXXX9486 AMAZON,shopping,,debit_card,-100000
61b6fca9d8beac1599eb1707,50200023535069,92918.21,60ec41ba55c00300382672d9,HDFC,Revenue-Mktplace,5eecc6d6449e4f7cfb1c2708,2020-11-11T00:00:00.000Z,NEFT CR-DEUT0797BGL-FLIPKART INTERNET PR IVATE LIMITED-SLICK ORGANICS PVT LTD-111 100077GN00024,shopping,,net_banking_transfer,1552.7
61b6fcaad8beac1599eb170b,50200023535069,94049.39,60ec41ba55c00300382672d9,HDFC,Revenue-Mktplace,5eecc6d6449e4f7cfb1c2708,2020-11-11T00:00:00.000Z,NEFT CR-DEUT0797BGL-MYNTRA DESIGNS PRIVA TE LIMITED-SLICK ORGANICS PRIVATE LIMITE D-111100220GN00209,shopping,,net_banking_transfer,1131.18
61b6fcabd8beac1599eb1710,50200023535069,110763.68,60ec41ba55c00300382672d9,HDFC,Revenue-COD,5eecc6d6449e4f7cfb1c2708,2020-11-11T00:00:00.000Z,NEFT CR-KKBK0000958-BIGFOOT RETAIL SOLUT IONS PRIVATE LIMITED-SLICK ORGANICS PVT LTD-KKBK203161758398,,,net_banking_transfer,16714.29
61b6fcacd8beac1599eb1714,50200023535069,129779.02,60ec41ba55c00300382672d9,HDFC,Revenue-PG-split enabled,5eecc6d6449e4f7cfb1c2708,2020-11-11T00:00:00.000Z,NEFT CR-UTIB0001506-RAZORPAY SOFTWARE PR IVATE LIMITED-SLICK ORGANICS PVT LITD-AX ISCN0060915793,investments,,net_banking_transfer,19015.34
61b6fcadd8beac1599eb1719,50200023535069,141321.36,60ec41ba55c00300382672d9,HDFC,Revenue-PG-non-split,5eecc6d6449e4f7cfb1c2708,2020-11-12T00:00:00.000Z,UPI-PAYTM-PAYOUTS@PAYTM-PYTM0123456-0317 85231457-ALL202011122168200,ewallet,,upi,11542.34
61b6fcaed8beac1599eb171d,50200023535069,1941321.36,60ec41ba55c00300382672d9,HDFC,Internal Transfers,5eecc6d6449e4f7cfb1c2708,2020-11-12T00:00:00.000Z,IB FUNDS TRANSFER CR-50200035187206 -SL ICK ORGANICS PVT LTD,investments,,Other,1800000
61b6fcafd8beac1599eb1721,50200023535069,1850886.36,60ec41ba55c00300382672d9,HDFC,direct expenses,5eecc6d6449e4f7cfb1c2708,2020-11-12T00:00:00.000Z,"NEFT DR-UTIB0000723-VEDIC COMECEUTICALS PVT LTD-NETBANK, MUM-N317201307203038-90 435",,,net_banking_transfer,-90435
61b6fcb0d8beac1599eb1725,50200023535069,1678600.36,60ec41ba55c00300382672d9,HDFC,direct expenses,5eecc6d6449e4f7cfb1c2708,2020-11-12T00:00:00.000Z,"NEFT DR-UTIB0000723-VEDIC COMECEUTICALS PVT LTD-NETBANK, MUM-N317201307218011-RA W MATERIAL",,,net_banking_transfer,-172286
61b6fcb1d8beac1599eb172a,50200023535069,1565430.36,60ec41ba55c00300382672d9,HDFC,direct expenses,5eecc6d6449e4f7cfb1c2708,2020-11-12T00:00:00.000Z,NEFT DR-ORBC0101001-KRAUTER HEALTHCARE L,,,net_banking_transfer,-113170
61b6fcb2d8beac1599eb1732,50200023535069,1537680.36,60ec41ba55c00300382672d9,HDFC,direct expenses,5eecc6d6449e4f7cfb1c2708,2020-11-12T00:00:00.000Z,"NEFT DR-UBIN0531855-MOHANISH KOTHARI-NET BANK, MUM-N317201307262608-27750",,,net_banking_transfer,-27750
61b6fcb3d8beac1599eb1736,50200023535069,1561126.4,60ec41ba55c00300382672d9,HDFC,Revenue-PG-split enabled,5eecc6d6449e4f7cfb1c2708,2020-11-12T00:00:00.000Z,NEFT CR-UTIB0001506-RAZORPAY SOFTWARE PR IVATE LIMITED-SLICK ORGANICS PVT LITD-AX ISCN0060976408,investments,,net_banking_transfer,23446.04
61b6fcb4d8beac1599eb1746,50200023535069,1561604.51,60ec41ba55c00300382672d9,HDFC,Revenue-PG-split enabled,5eecc6d6449e4f7cfb1c2708,2020-11-12T00:00:00.000Z,NEFT CR-YESB0000001-RAZORPAY SOFTWARE P L NODAL ACCOUNT-SLICKORGANICS-N317200461 441304,investments,,net_banking_transfer,478.11
61b6fcb5d8beac1599eb1755,50200023535069,1561594.51,60ec41ba55c00300382672d9,HDFC,N-ACH payments,5eecc6d6449e4f7cfb1c2708,2020-11-12T00:00:00.000Z,ACH D- TEST DIP-MYUQZVSYH7X1,loans,lender_transaction,auto_debit_payment,-10
61b6fcb6d8beac1599eb1769,50200023535069,1541594.51,60ec41ba55c00300382672d9,HDFC,direct expenses,5eecc6d6449e4f7cfb1c2708,2020-11-12T00:00:00.000Z,SARVAN KUMAR - CHQ PAID - DEVLI ROAD K,,,chq,-20000
61b6fcb7d8beac1599eb1775,50200023535069,1556208.29,60ec41ba55c00300382672d9,HDFC,Revenue-PG-split enabled,5eecc6d6449e4f7cfb1c2708,2020-11-12T00:00:00.000Z,NEFT CR-UTIB0001506-RAZORPAY SOFTWARE PR IVATE LIMITED-SLICK ORGANICS PVT LITD-AX ISCN0061045245,investments,,net_banking_transfer,14613.78
61b6fcb8d8beac1599eb177b,50200023535069,1552556.63,60ec41ba55c00300382672d9,HDFC,direct expenses,5eecc6d6449e4f7cfb1c2708,2020-11-12T00:00:00.000Z,POS 514834XXXXXX9486 WWW.FAQPRIME.COM,,,debit_card,-3651.66
61b6fcb9d8beac1599eb1787,50200023535069,145711.97,60ec41ba55c00300382672d9,HDFC,direct expenses,5eecc6d6449e4f7cfb1c2708,2020-11-12T00:00:00.000Z,ADVANCE PAYMENT OF IMPORT BILL,bills,,Other,-1406844.66
61b6fcbad8beac1599eb1792,50200023535069,150758.91,60ec41ba55c00300382672d9,HDFC,Revenue-PG-non-split,5eecc6d6449e4f7cfb1c2708,2020-11-13T00:00:00.000Z,UPI-PAYTM-PAYOUTS@PAYTM-PYTM0123456-0318 06421456-ALL202011132168200,ewallet,,upi,5046.94
61b6fcbbd8beac1599eb1799,50200023535069,136421.91,60ec41ba55c00300382672d9,HDFC,direct expenses,5eecc6d6449e4f7cfb1c2708,2020-11-13T00:00:00.000Z,"NEFT DR-SBIN0008078-PANDIT PLASTICS-NETB ANK, MUM-N318201308964289-14337",,,net_banking_transfer,-14337
61b6fcbbd8beac1599eb17a5,50200023535069,86421.91,60ec41ba55c00300382672d9,HDFC,direct expenses,5eecc6d6449e4f7cfb1c2708,2020-11-13T00:00:00.000Z,IMPS-031808196336-PAYTM-PYTM-XXXXXXXX383 9-50000,ewallet,,net_banking_transfer,-50000
61b6fcbcd8beac1599eb17ae,50200023535069,121089.91,60ec41ba55c00300382672d9,HDFC,Internal Transfers,5eecc6d6449e4f7cfb1c2708,2020-11-13T00:00:00.000Z,IB FUNDS TRANSFER CR-50200035187206 -SL ICK ORGANICS PVT LTD,investments,,Other,34668
61b6fcbdd8beac1599eb17bd,50200023535069,321089.91,60ec41ba55c00300382672d9,HDFC,Internal Transfers,5eecc6d6449e4f7cfb1c2708,2020-11-13T00:00:00.000Z,IB FUNDS TRANSFER CR-50200035187206 -SL ICK ORGANICS PVT LTD,investments,,Other,200000
61b6fcbed8beac1599eb17c4,50200023535069,145789.91,60ec41ba55c00300382672d9,HDFC,direct expenses,5eecc6d6449e4f7cfb1c2708,2020-11-13T00:00:00.000Z,"NEFT DR-KKBK0000208-SYSCOM PACKAGING COM PANY-NETBANK, MUM-N318201308990010-17530 0",,,net_banking_transfer,-175300
61b6fcbfd8beac1599eb17cd,50200023535069,45789.91,60ec41ba55c00300382672d9,HDFC,direct expenses,5eecc6d6449e4f7cfb1c2708,2020-11-13T00:00:00.000Z,57500000443889-TPT-100000-WEBKLIPPER TEC HNOLOGIES PRIVATE LIMITED,,,net_banking_transfer,-100000
61b6fcc0d8beac1599eb17d4,50200023535069,49221.24,60ec41ba55c00300382672d9,HDFC,Revenue-Mktplace,5eecc6d6449e4f7cfb1c2708,2020-11-13T00:00:00.000Z,NEFT CR-DEUT0797BGL-FLIPKART INTERNET PR,shopping,,net_banking_transfer,3431.33
61b6fcc1d8beac1599eb17db,50200023535069,149221.24,60ec41ba55c00300382672d9,HDFC,Internal Transfers,5eecc6d6449e4f7cfb1c2708,2020-11-13T00:00:00.000Z,IB FUNDS TRANSFER CR-50200035187206 -SL ICK ORGANICS PVT LTD,investments,,Other,100000
61b6fcc2d8beac1599eb17ef,50200023535069,78221.24,60ec41ba55c00300382672d9,HDFC,direct expenses,5eecc6d6449e4f7cfb1c2708,2020-11-13T00:00:00.000Z,IMPS-031809111941-PAYTM-PYTM-XXXXXXXX383 9-71000,ewallet,,net_banking_transfer,-71000
61b6fcc3d8beac1599eb17f4,50200023535069,91506.1,60ec41ba55c00300382672d9,HDFC,Revenue-PG-split enabled,5eecc6d6449e4f7cfb1c2708,2020-11-13T00:00:00.000Z,NEFT CR-UTIB0001506-RAZORPAY SOFTWARE PR IVATE LIMITED-SLICK ORGANICS PVT LITD-AX ISCN0061078628,investments,,net_banking_transfer,13284.86
61b6fcc4d8beac1599eb181b,50200023535069,93093.43,60ec41ba55c00300382672d9,HDFC,Revenue-Mktplace,5eecc6d6449e4f7cfb1c2708,2020-11-13T00:00:00.000Z,NEFT CR-DEUT0797BGL-MYNTRA DESIGNS PRIVA TE LIMITED-SLICK ORGANICS PRIVATE LIMITE D-111300178GN00221,shopping,,net_banking_transfer,1587.33
61b6fcc5d8beac1599eb1828,50200023535069,91093.43,60ec41ba55c00300382672d9,HDFC,direct expenses,5eecc6d6449e4f7cfb1c2708,2020-11-13T00:00:00.000Z,IMPS-031809132321-PAYTM-PYTM-XXXXXXXX383 9-2000,ewallet,,net_banking_transfer,-2000
61b6fcc6d8beac1599eb182f,50200023535069,76093.43,60ec41ba55c00300382672d9,HDFC,direct expenses,5eecc6d6449e4f7cfb1c2708,2020-11-13T00:00:00.000Z,IMPS-031809137027-PAYTM-PYTM-XXXXXXXX383 9-15000,ewallet,,net_banking_transfer,-15000
61b6fcc7d8beac1599eb183b,50200023535069,126093.43,60ec41ba55c00300382672d9,HDFC,Internal Transfers,5eecc6d6449e4f7cfb1c2708,2020-11-13T00:00:00.000Z,IB FUNDS TRANSFER CR-50200050976833 -SL ICK ORGANICS PVT LTD,investments,,Other,50000
61b6fcc8d8beac1599eb1848,50200023535069,26093.43,60ec41ba55c00300382672d9,HDFC,SAAS/tech expense,5eecc6d6449e4f7cfb1c2708,2020-11-13T00:00:00.000Z,VHDF9459426006/BILLDKAMAZONSELLERSE,shopping,,Other,-100000
61b6fcc9d8beac1599eb1853,50200023535069,26936.22,60ec41ba55c00300382672d9,HDFC,Revenue-Mktplace,5eecc6d6449e4f7cfb1c2708,2020-11-13T00:00:00.000Z,NEFT CR-DEUT0784BBY-TATA UNISTORE LTD-NO DAL-SLICK ORGANICS PVT LTD-111300548GN00 282,investments,,net_banking_transfer,842.79
61b6fccad8beac1599eb185c,50200023535069,48857.15,60ec41ba55c00300382672d9,HDFC,Revenue-COD,5eecc6d6449e4f7cfb1c2708,2020-11-13T00:00:00.000Z,NEFT CR-KKBK0000958-BIGFOOT RETAIL SOLUT IONS PRIVATE LIMITED-SLICK ORGANICS PVT LTD-KKBK203182351235,,,net_banking_transfer,21920.93
61b6fccbd8beac1599eb18a6,50200023535069,50275.04,60ec41ba55c00300382672d9,HDFC,Transfer in/Revenue-other,5eecc6d6449e4f7cfb1c2708,2020-11-13T00:00:00.000Z,4060001863-13 11 2020-HDFAZCUR1,,,Other,1417.89
61b6fcccd8beac1599eb18ad,50200023535069,56383.88,60ec41ba55c00300382672d9,HDFC,Revenue-Mktplace,5eecc6d6449e4f7cfb1c2708,2020-11-13T00:00:00.000Z,NEFT CR-DEUT0797BGL-FLIPKART INTERNET PR IVATE LIMITED-SLICK ORGANICS PVT LTD-111 300078GN00114,shopping,,net_banking_transfer,6108.84
61b6fccdd8beac1599eb18b8,50200023535069,57226.25,60ec41ba55c00300382672d9,HDFC,Revenue-Mktplace,5eecc6d6449e4f7cfb1c2708,2020-11-13T00:00:00.000Z,NEFT CR-DEUT0797BGL-MYNTRA DESIGNS PRIVA TE LIMITED-SLICK ORGANICS PRIVATE LIMITE D-111300226GN00276,shopping,,net_banking_transfer,842.37
61b6fcced8beac1599eb18be,50200023535069,112676.75,60ec41ba55c00300382672d9,HDFC,Revenue-PG-split enabled,5eecc6d6449e4f7cfb1c2708,2020-11-13T00:00:00.000Z,NEFT CR-UTIB0001506-RAZORPAY SOFTWARE PR,,,net_banking_transfer,55450.5
61b6fccfd8beac1599eb18cb,50200023535069,137447.32,60ec41ba55c00300382672d9,HDFC,Revenue-PG-non-split,5eecc6d6449e4f7cfb1c2708,2020-11-14T00:00:00.000Z,IMPS-031905984625-PAYTM-HDFC-XXXXXXXXXX0 007-,ewallet,,net_banking_transfer,24770.57
61b6fcd0d8beac1599eb18d0,50200023535069,148518.73,60ec41ba55c00300382672d9,HDFC,Revenue-PG-non-split,5eecc6d6449e4f7cfb1c2708,2020-11-15T00:00:00.000Z,UPI-PAYTM-PAYOUTS@PAYTM-PYTM0123456-0320 47070576-ALL202011152168200,ewallet,,upi,11071.41
61b6fcd1d8beac1599eb18e2,50200023535069,48518.73,60ec41ba55c00300382672d9,HDFC,SAAS/tech expense,5eecc6d6449e4f7cfb1c2708,2020-11-15T00:00:00.000Z,POS 514834XXXXXX9486 AMAZON,shopping,,debit_card,-100000
61b6fcd2d8beac1599eb18e8,50200023535069,55365.29,60ec41ba55c00300382672d9,HDFC,Revenue-PG-non-split,5eecc6d6449e4f7cfb1c2708,2020-11-16T00:00:00.000Z,UPI-PAYTM-PAYOUTS@PAYTM-PYTM0123456-0321 63882792-ALL202011162168200,ewallet,,upi,6846.56
61b6fcd3d8beac1599eb18ec,50200023535069,60987.86,60ec41ba55c00300382672d9,HDFC,Revenue-Mktplace,5eecc6d6449e4f7cfb1c2708,2020-11-16T00:00:00.000Z,NEFT CR-DEUT0797BGL-FLIPKART INTERNET PR IVATE LIMITED-SLICK ORGANICS PVT LTD-111 600102GN00008,shopping,,net_banking_transfer,5622.57
61b6fcd4d8beac1599eb18f1,50200023535069,30987.86,60ec41ba55c00300382672d9,HDFC,direct expenses,5eecc6d6449e4f7cfb1c2708,2020-11-16T00:00:00.000Z,IMPS-032113104713-PAYTM-PYTM-XXXXXXXX383 9-30000,ewallet,,net_banking_transfer,-30000
61b6fcd5d8beac1599eb18f6,50200023535069,33568.57,60ec41ba55c00300382672d9,HDFC,Revenue-Mktplace,5eecc6d6449e4f7cfb1c2708,2020-11-16T00:00:00.000Z,NEFT CR-DEUT0797BGL-FLIPKART INTERNET PR IVATE LIMITED-SLICK ORGANICS PVT LTD-111 600159GN00240,shopping,,net_banking_transfer,2580.71
61b6fcd6d8beac1599eb18fe,50200023535069,32821.23,60ec41ba55c00300382672d9,HDFC,direct expenses,5eecc6d6449e4f7cfb1c2708,2020-11-16T00:00:00.000Z,POS 514834XXXXXX9486 MANYCHAT COM PRO,,,debit_card,-747.34
61b6fcd7d8beac1599eb1901,50200023535069,43822.25,60ec41ba55c00300382672d9,HDFC,Revenue-PG-non-split,5eecc6d6449e4f7cfb1c2708,2020-11-17T00:00:00.000Z,UPI-PAYTM-PAYOUTS@PAYTM-PYTM0123456-0322 82894545-ALL202011172168200,ewallet,,upi,11001.02
61b6fcd8d8beac1599eb1904,50200023535069,45316.16,60ec41ba55c00300382672d9,HDFC,Revenue-Mktplace,5eecc6d6449e4f7cfb1c2708,2020-11-17T00:00:00.000Z,NEFT CR-DEUT0797BGL-MYNTRA DESIGNS PRIVA TE LIMITED-SLICK ORGANICS PRIVATE LIMITE D-111700068GN00300,shopping,,net_banking_transfer,1493.91
61b6fcd9d8beac1599eb1909,50200023535069,153771.35,60ec41ba55c00300382672d9,HDFC,Revenue-PG-split enabled,5eecc6d6449e4f7cfb1c2708,2020-11-17T00:00:00.000Z,NEFT CR-UTIB0001506-RAZORPAY SOFTWARE PR IVATE LIMITED-SLICK ORGANICS PVT LITD-AX ISCN0061214434,investments,,net_banking_transfer,108455.19
61b6fcdad8beac1599eb1911,50200023535069,266394.57,60ec41ba55c00300382672d9,HDFC,Revenue-Mktplace,5eecc6d6449e4f7cfb1c2708,2020-11-17T00:00:00.000Z,IMPS-032211362006-AMAZON SELLER SERVIC-H DFC-XXXXXXXX6004-1WWSU9ILVCTSFLT4SLICK O RGANICS PVT LTD,shopping,,net_banking_transfer,112623.22
61b6fcdbd8beac1599eb1917,50200023535069,673539.95,60ec41ba55c00300382672d9,HDFC,Revenue-Mktplace,5eecc6d6449e4f7cfb1c2708,2020-11-17T00:00:00.000Z,NEFT CR-DEUT0797BGL-AMAZON PAY (INDIA) P,shopping,,net_banking_transfer,407145.38
61b6fcdcd8beac1599eb191e,50200023535069,674983.78,60ec41ba55c00300382672d9,HDFC,Revenue-Mktplace,5eecc6d6449e4f7cfb1c2708,2020-11-17T00:00:00.000Z,NEFT CR-DEUT0797BGL-MYNTRA DESIGNS PRIVA TE LIMITED-SLICK ORGANICS PRIVATE LIMITE D-111700075GN00277,shopping,,net_banking_transfer,1443.83
61b6fcddd8beac1599eb1922,50200023535069,696628.34,60ec41ba55c00300382672d9,HDFC,Revenue-PG-split enabled,5eecc6d6449e4f7cfb1c2708,2020-11-17T00:00:00.000Z,NEFT CR-UTIB0001506-RAZORPAY SOFTWARE PR IVATE LIMITED-SLICK ORGANICS PVT LITD-AX ISCN0061261984,investments,,net_banking_transfer,21644.56
61b6fcded8beac1599eb1928,50200023535069,646628.34,60ec41ba55c00300382672d9,HDFC,SAAS/tech expense,5eecc6d6449e4f7cfb1c2708,2020-11-17T00:00:00.000Z,POS 514834XXXXXX9486 AMAZON,shopping,,debit_card,-50000
61b6fcdfd8beac1599eb192c,50200023535069,652225.82,60ec41ba55c00300382672d9,HDFC,Revenue-PG-non-split,5eecc6d6449e4f7cfb1c2708,2020-11-18T00:00:00.000Z,UPI-PAYTM-PAYOUTS@PAYTM-PYTM0123456-0323 01952701-ALL202011182168200,ewallet,,upi,5597.48
61b6fce0d8beac1599eb1931,50200023535069,653792.65,60ec41ba55c00300382672d9,HDFC,Revenue-Mktplace,5eecc6d6449e4f7cfb1c2708,2020-11-18T00:00:00.000Z,NEFT CR-DEUT0797BGL-FLIPKART INTERNET PR IVATE LIMITED-SLICK ORGANICS PVT LTD-111 800122GN00186,shopping,,net_banking_transfer,1566.83
61b6fce1d8beac1599eb1936,50200023535069,667384.95,60ec41ba55c00300382672d9,HDFC,Revenue-PG-split enabled,5eecc6d6449e4f7cfb1c2708,2020-11-18T00:00:00.000Z,NEFT CR-UTIB0001506-RAZORPAY SOFTWARE PR IVATE LIMITED-SLICK ORGANICS PVT LITD-AX ISCN0061311566,investments,,net_banking_transfer,13592.3
61b6fce1d8beac1599eb1938,50200023535069,663894.95,60ec41ba55c00300382672d9,HDFC,SAAS/tech expense,5eecc6d6449e4f7cfb1c2708,2020-11-18T00:00:00.000Z,POS 514834XXXXXX9486 AMAZON,shopping,,debit_card,-3490
61b6fce2d8beac1599eb193e,50200023535069,663744.14,60ec41ba55c00300382672d9,HDFC,bank charges,5eecc6d6449e4f7cfb1c2708,2020-11-18T00:00:00.000Z,.DC INTL POS TXN MARKUP+ST 121120 161120 -CDT2030701838784,,,international_transaction_arbitrage,-150.81
61b6fce3d8beac1599eb1947,50200023535069,681098.14,60ec41ba55c00300382672d9,HDFC,Transfer in/Revenue-other,5eecc6d6449e4f7cfb1c2708,2020-11-18T00:00:00.000Z,IMPS-032313645941-VANITY WAGON-HDFC-XXXX XXXXXXX0887-VANITY WAGON,,,net_banking_transfer,17354
61b6fce4d8beac1599eb194b,50200023535069,781098.14,60ec41ba55c00300382672d9,HDFC,Transfer in/Revenue-other,5eecc6d6449e4f7cfb1c2708,2020-11-18T00:00:00.000Z,REF-BILLDKAMAZO-VHDF9459426006-13/11/20,,,refund,100000
61b6fce5d8beac1599eb1955,50200023535069,785344.94,60ec41ba55c00300382672d9,HDFC,Revenue-Mktplace,5eecc6d6449e4f7cfb1c2708,2020-11-18T00:00:00.000Z,NEFT CR-DEUT0797BGL-FLIPKART INTERNET PR IVATE LIMITED-SLICK ORGANICS PVT LTD-111 800082GN00151,shopping,,net_banking_transfer,4246.8
61b6fce6d8beac1599eb195a,50200023535069,866832.32,60ec41ba55c00300382672d9,HDFC,Revenue-COD,5eecc6d6449e4f7cfb1c2708,2020-11-18T00:00:00.000Z,NEFT CR-KKBK0000958-BIGFOOT RETAIL SOLUT IONS PRIVATE LIMITED-SLICK ORGANICS PVT LTD-KKBK203233058971,,,net_banking_transfer,81487.38
61b6fce7d8beac1599eb1960,50200023535069,879922.17,60ec41ba55c00300382672d9,HDFC,Revenue-PG-split enabled,5eecc6d6449e4f7cfb1c2708,2020-11-18T00:00:00.000Z,NEFT CR-UTIB0001506-RAZORPAY SOFTWARE PR IVATE LIMITED-SLICK ORGANICS PVT LITD-AX ISCN0061374234,investments,,net_banking_transfer,13089.85
61b6fce8d8beac1599eb1965,50200023535069,892475.6,60ec41ba55c00300382672d9,HDFC,Revenue-PG-non-split,5eecc6d6449e4f7cfb1c2708,2020-11-19T00:00:00.000Z,IMPS-032405003562-PAYTM-HDFC-XXXXXXXXXX0,ewallet,,net_banking_transfer,12553.43
61b6fce9d8beac1599eb1969,50200023535069,828475.6,60ec41ba55c00300382672d9,HDFC,direct expenses,5eecc6d6449e4f7cfb1c2708,2020-11-19T00:00:00.000Z,"NEFT DR-UTIB0000723-VEDIC COMECEUTICALS PVT LTD-NETBANK, MUM-N324201313617245-AD VANCE",,,net_banking_transfer,-64000
61b6fcead8beac1599eb196e,50200023535069,842354.12,60ec41ba55c00300382672d9,HDFC,Revenue-PG-split enabled,5eecc6d6449e4f7cfb1c2708,2020-11-19T00:00:00.000Z,NEFT CR-UTIB0001506-RAZORPAY SOFTWARE PR IVATE LIMITED-SLICK ORGANICS PVT LITD-AX ISCN0061436062,investments,,net_banking_transfer,13878.52
61b6fcebd8beac1599eb1970,50200023535069,843885.58,60ec41ba55c00300382672d9,HDFC,Revenue-PG-non-split,5eecc6d6449e4f7cfb1c2708,2020-11-19T00:00:00.000Z,NEFT CR-ICIC0000031-PAYTM E COMMERCE PVT LTD-SLICK ORGANICS PVT LTD-CMS169238388 6,investments,,net_banking_transfer,1531.46
61b6fcecd8beac1599eb1975,50200023535069,845086.5,60ec41ba55c00300382672d9,HDFC,Revenue-PG-split enabled,5eecc6d6449e4f7cfb1c2708,2020-11-19T00:00:00.000Z,NEFT CR-YESB0000001-RAZORPAY SOFTWARE P L NODAL ACCOUNT-SLICKORGANICS-N324200464 283357,investments,,net_banking_transfer,1200.92
61b6fcedd8beac1599eb197d,50200023535069,795086.5,60ec41ba55c00300382672d9,HDFC,SAAS/tech expense,5eecc6d6449e4f7cfb1c2708,2020-11-19T00:00:00.000Z,POS 514834XXXXXX9486 AMAZON,shopping,,debit_card,-50000
61b6fceed8beac1599eb1980,50200023535069,809613.78,60ec41ba55c00300382672d9,HDFC,Revenue-PG-split enabled,5eecc6d6449e4f7cfb1c2708,2020-11-19T00:00:00.000Z,NEFT CR-UTIB0001506-RAZORPAY SOFTWARE PR IVATE LIMITED-SLICK ORGANICS PVT LITD-AX ISCN0061486593,investments,,net_banking_transfer,14527.28
61b6fcefd8beac1599eb1989,50200023535069,812661.78,60ec41ba55c00300382672d9,HDFC,Revenue-Mktplace,5eecc6d6449e4f7cfb1c2708,2020-11-19T00:00:00.000Z,NEFT CR-SCBL0036001-DREAMPLUG TECHNOLOGI ES PRIVATE LIMI-SLICK ORGANICS PRIVATE L IMITEDSLICK-SIN31436Q0008178,,,net_banking_transfer,3048
61b6fcf0d8beac1599eb198d,50200023535069,823593.95,60ec41ba55c00300382672d9,HDFC,Revenue-PG-non-split,5eecc6d6449e4f7cfb1c2708,2020-11-20T00:00:00.000Z,IMPS-032505132469-PAYTM-HDFC-XXXXXXXXXX0 007-,ewallet,,net_banking_transfer,10932.17
61b6fcf1d8beac1599eb1992,50200023535069,773593.95,60ec41ba55c00300382672d9,HDFC,direct expenses,5eecc6d6449e4f7cfb1c2708,2020-11-20T00:00:00.000Z,IMPS-032508125699-PAYTM-PYTM-XXXXXXXX383 9-50000,ewallet,,net_banking_transfer,-50000
61b6fcf2d8beac1599eb1997,50200023535069,765593.95,60ec41ba55c00300382672d9,HDFC,direct expenses,5eecc6d6449e4f7cfb1c2708,2020-11-20T00:00:00.000Z,IMPS-032509140181-PAYTM-PYTM-XXXXXXXX383 9-8000,ewallet,,net_banking_transfer,-8000
61b6fcf3d8beac1599eb199c,50200023535069,767232.24,60ec41ba55c00300382672d9,HDFC,Revenue-Mktplace,5eecc6d6449e4f7cfb1c2708,2020-11-20T00:00:00.000Z,NEFT CR-DEUT0797BGL-FLIPKART INTERNET PR IVATE LIMITED-SLICK ORGANICS PVT LTD-112 000119GN00037,shopping,,net_banking_transfer,1638.29
61b6fcf4d8beac1599eb19a0,50200023535069,784221.13,60ec41ba55c00300382672d9,HDFC,Revenue-PG-split enabled,5eecc6d6449e4f7cfb1c2708,2020-11-20T00:00:00.000Z,NEFT CR-UTIB0001506-RAZORPAY SOFTWARE PR IVATE LIMITED-SLICK ORGANICS PVT LITD-AX ISCN0061535111,investments,,net_banking_transfer,16988.89
61b6fcf5d8beac1599eb19a4,50200023535069,779027.28,60ec41ba55c00300382672d9,HDFC,direct expenses,5eecc6d6449e4f7cfb1c2708,2020-11-20T00:00:00.000Z,POS 514834XXXXXX9486 FEEDBACKFIVE,,,debit_card,-5193.85
61b6fcf6d8beac1599eb19a7,50200023535069,782300.83,60ec41ba55c00300382672d9,HDFC,Revenue-Mktplace,5eecc6d6449e4f7cfb1c2708,2020-11-20T00:00:00.000Z,NEFT CR-DEUT0797BGL-MYNTRA DESIGNS PRIVA TE LIMITED-SLICK ORGANICS PRIVATE LIMITE D-112000334GN00231,shopping,,net_banking_transfer,3273.55
61b6fcf7d8beac1599eb19ac,50200023535069,782269.97,60ec41ba55c00300382672d9,HDFC,bank charges,5eecc6d6449e4f7cfb1c2708,2020-11-20T00:00:00.000Z,.DC INTL POS TXN MARKUP+ST 161120 181120 -CDT2030701838784,,,international_transaction_arbitrage,-30.86
61b6fcf8d8beac1599eb19b3,50200023535069,784016.79,60ec41ba55c00300382672d9,HDFC,Revenue-Mktplace,5eecc6d6449e4f7cfb1c2708,2020-11-20T00:00:00.000Z,NEFT CR-DEUT0797BGL-MYNTRA DESIGNS PRIVA TE LIMITED-SLICK ORGANICS PRIVATE LIMITE D-112000338GN00219,shopping,,net_banking_transfer,1746.82
61b6fcf9d8beac1599eb19b9,50200023535069,791895.6,60ec41ba55c00300382672d9,HDFC,Revenue-Mktplace,5eecc6d6449e4f7cfb1c2708,2020-11-20T00:00:00.000Z,NEFT CR-DEUT0797BGL-FLIPKART INTERNET PR IVATE LIMITED-SLICK ORGANICS PVT LTD-112 000137GN00115,shopping,,net_banking_transfer,7878.81
61b6fcfad8beac1599eb19c0,50200023535069,827726.65,60ec41ba55c00300382672d9,HDFC,Revenue-COD,5eecc6d6449e4f7cfb1c2708,2020-11-20T00:00:00.000Z,NEFT CR-KKBK0000958-BIGFOOT RETAIL SOLUT IONS PRIVATE LIMITED-SLICK ORGANICS PVT LTD-KKBK203253359898,,,net_banking_transfer,35831.05
61b6fcfbd8beac1599eb19c4,50200023535069,828955.52,60ec41ba55c00300382672d9,HDFC,Revenue-Mktplace,5eecc6d6449e4f7cfb1c2708,2020-11-20T00:00:00.000Z,NEFT CR-DEUT0784BBY-TATA UNISTORE LTD-NO DAL-SLICK ORGANICS PVT LTD-112001011GN00 297,investments,,net_banking_transfer,1228.87
61b6fcfcd8beac1599eb19d0,50200023535069,829415.38,60ec41ba55c00300382672d9,HDFC,Revenue-PG-non-split,5eecc6d6449e4f7cfb1c2708,2020-11-20T00:00:00.000Z,NEFT CR-ICIC0000031-PAYTM E COMMERCE PVT LTD-SLICK ORGANICS PVT LTD-CMS169477004 2,investments,,net_banking_transfer,459.86
61b6fcfdd8beac1599eb19d5,50200023535069,847688.33,60ec41ba55c00300382672d9,HDFC,Revenue-PG-split enabled,5eecc6d6449e4f7cfb1c2708,2020-11-20T00:00:00.000Z,NEFT CR-UTIB0001506-RAZORPAY SOFTWARE PR IVATE LIMITED-SLICK ORGANICS PVT LITD-AX ISCN0061597188,investments,,net_banking_transfer,18272.95
61b6fcfed8beac1599eb19d9,50200023535069,841082.84,60ec41ba55c00300382672d9,HDFC,direct expenses,5eecc6d6449e4f7cfb1c2708,2020-11-20T00:00:00.000Z,POS 514834XXXXXX9486 HOTJAR,,,debit_card,-6605.49
61b6fcffd8beac1599eb19de,50200023535069,846927.42,60ec41ba55c00300382672d9,HDFC,Revenue-PG-non-split,5eecc6d6449e4f7cfb1c2708,2020-11-21T00:00:00.000Z,UPI-PAYTM-PAYOUTS@PAYTM-PYTM0123456-0326 63329780-ALL202011212168200,ewallet,,upi,5844.58
61b6fd00d8beac1599eb19e0,50200023535069,446927.42,60ec41ba55c00300382672d9,HDFC,direct expenses,5eecc6d6449e4f7cfb1c2708,2020-11-21T00:00:00.000Z,02711600008220-TPT-ABC-VARUN SINGH,,,net_banking_transfer,-400000
61b6fd01d8beac1599eb19e5,50200023535069,453201.86,60ec41ba55c00300382672d9,HDFC,Revenue-PG-split enabled,5eecc6d6449e4f7cfb1c2708,2020-11-21T00:00:00.000Z,NEFT CR-UTIB0001506-RAZORPAY SOFTWARE PR IVATE LIMITED-SLICK ORGANICS PVT LITD-AX ISCN0061649967,investments,,net_banking_transfer,6274.44
61b6fd01d8beac1599eb19ec,50200023535069,461244.01,60ec41ba55c00300382672d9,HDFC,Revenue-PG-split enabled,5eecc6d6449e4f7cfb1c2708,2020-11-21T00:00:00.000Z,NEFT CR-UTIB0001506-RAZORPAY SOFTWARE PR,,,net_banking_transfer,8042.15
61b6fd02d8beac1599eb19f0,50200023535069,411244.01,60ec41ba55c00300382672d9,HDFC,direct expenses,5eecc6d6449e4f7cfb1c2708,2020-11-21T00:00:00.000Z,"NEFT DR-YESB0000551-VISTTA COSMETICS-NET BANK, MUM-N326201316295566-ABC",,,net_banking_transfer,-50000
61b6fd03d8beac1599eb19fa,50200023535069,418302.89,60ec41ba55c00300382672d9,HDFC,Revenue-PG-non-split,5eecc6d6449e4f7cfb1c2708,2020-11-22T00:00:00.000Z,UPI-PAYTM-PAYOUTS@PAYTM-PYTM0123456-0327 84620810-ALL202011222168200,ewallet,,upi,7058.88
61b6fd04d8beac1599eb19fe,50200023535069,368302.89,60ec41ba55c00300382672d9,HDFC,SAAS/tech expense,5eecc6d6449e4f7cfb1c2708,2020-11-22T00:00:00.000Z,POS 514834XXXXXX9486 AMAZON,shopping,,debit_card,-50000
61b6fd05d8beac1599eb1a03,50200023535069,366149.89,60ec41ba55c00300382672d9,HDFC,SAAS/tech expense,5eecc6d6449e4f7cfb1c2708,2020-11-22T00:00:00.000Z,POS 514834XXXXXX9486 AMAZON,shopping,,debit_card,-2153
61b6fd06d8beac1599eb1a0a,50200023535069,370167.93,60ec41ba55c00300382672d9,HDFC,Revenue-PG-non-split,5eecc6d6449e4f7cfb1c2708,2020-11-23T00:00:00.000Z,IMPS-032805319071-PAYTM-HDFC-XXXXXXXXXX0 007-,ewallet,,net_banking_transfer,4018.04
61b6fd07d8beac1599eb1a0e,50200023535069,358167.93,60ec41ba55c00300382672d9,HDFC,direct expenses,5eecc6d6449e4f7cfb1c2708,2020-11-23T00:00:00.000Z,IMPS-032809108038-PAYTM-PYTM-XXXXXXXX383 9-12000,ewallet,,net_banking_transfer,-12000
61b6fd08d8beac1599eb1a13,50200023535069,399432.15,60ec41ba55c00300382672d9,HDFC,Revenue-PG-split enabled,5eecc6d6449e4f7cfb1c2708,2020-11-23T00:00:00.000Z,NEFT CR-UTIB0001506-RAZORPAY SOFTWARE PR IVATE LIMITED-SLICK ORGANICS PVT LITD-AX ISCN0061834462,investments,,net_banking_transfer,41264.22
61b6fd09d8beac1599eb1a16,50200023535069,401583.85,60ec41ba55c00300382672d9,HDFC,Revenue-Mktplace,5eecc6d6449e4f7cfb1c2708,2020-11-23T00:00:00.000Z,NEFT CR-DEUT0797BGL-FLIPKART INTERNET PR IVATE LIMITED-SLICK ORGANICS PVT LTD-112 300104GN00106,shopping,,net_banking_transfer,2151.7
61b6fd0ad8beac1599eb1a1a,50200023535069,402587.98,60ec41ba55c00300382672d9,HDFC,Revenue-Mktplace,5eecc6d6449e4f7cfb1c2708,2020-11-23T00:00:00.000Z,NEFT CR-DEUT0797BGL-MYNTRA DESIGNS PRIVA TE LIMITED-SLICK ORGANICS PRIVATE LIMITE D-112300201GN00256,shopping,,net_banking_transfer,1004.13
61b6fd0bd8beac1599eb1a2b,50200023535069,403681.46,60ec41ba55c00300382672d9,HDFC,Revenue-Mktplace,5eecc6d6449e4f7cfb1c2708,2020-11-23T00:00:00.000Z,NEFT CR-DEUT0797BGL-MYNTRA DESIGNS PRIVA TE LIMITED-SLICK ORGANICS PRIVATE LIMITE D-112300183GN00078,shopping,,net_banking_transfer,1093.48
61b6fd0cd8beac1599eb1a2f,50200023535069,405616.41,60ec41ba55c00300382672d9,HDFC,Revenue-Mktplace,5eecc6d6449e4f7cfb1c2708,2020-11-23T00:00:00.000Z,NEFT CR-DEUT0797BGL-FLIPKART INTERNET PR IVATE LIMITED-SLICK ORGANICS PVT LTD-112 300150GN00062,shopping,,net_banking_transfer,1934.95
61b6fd0dd8beac1599eb1a39,50200023535069,413390.6,60ec41ba55c00300382672d9,HDFC,Revenue-PG-split enabled,5eecc6d6449e4f7cfb1c2708,2020-11-23T00:00:00.000Z,NEFT CR-UTIB0001506-RAZORPAY SOFTWARE PR IVATE LIMITED-SLICK ORGANICS PVT LITD-AX ISCN0061886132,investments,,net_banking_transfer,7774.19
61b6fd0ed8beac1599eb1a3f,50200023535069,413393.82,60ec41ba55c00300382672d9,HDFC,Adjustments/Reversal,5eecc6d6449e4f7cfb1c2708,2020-11-23T00:00:00.000Z,DEBIT CARD PUR ADJ DT 20/11/20,,,Other,3.22
61b6fd0fd8beac1599eb1a43,50200023535069,413893.46,60ec41ba55c00300382672d9,HDFC,Revenue-PG-non-split,5eecc6d6449e4f7cfb1c2708,2020-11-23T00:00:00.000Z,NEFT CR-ICIC0000031-PAYTM E COMMERCE PVT,ewallet,,net_banking_transfer,499.64
61b6fd10d8beac1599eb1a48,50200023535069,414288.55,60ec41ba55c00300382672d9,HDFC,Revenue-Mktplace,5eecc6d6449e4f7cfb1c2708,2020-11-23T00:00:00.000Z,NEFT CR-ICIC0000105-MANASH LIFETYLE PVT LTD-SLICKORGANICSPRIVATELIMITED(MP)MUM-I CIB203280028869,,,net_banking_transfer,395.09
61b6fd11d8beac1599eb1a53,50200023535069,423793.15,60ec41ba55c00300382672d9,HDFC,Revenue-PG-non-split,5eecc6d6449e4f7cfb1c2708,2020-11-24T00:00:00.000Z,UPI-PAYTM-PAYOUTS@PAYTM-PYTM0123456-0329 23670527-ALL202011242168200,ewallet,,upi,9504.6
61b6fd12d8beac1599eb1a5c,50200023535069,202967.15,60ec41ba55c00300382672d9,HDFC,direct expenses,5eecc6d6449e4f7cfb1c2708,2020-11-24T00:00:00.000Z,"NEFT DR-ORBC0100707-UFLEX LIMITED-NETBAN K, MUM-N329201317670721-220826",loans,lender_transaction,net_banking_transfer,-220826
61b6fd13d8beac1599eb1a5f,50200023535069,216338.17,60ec41ba55c00300382672d9,HDFC,Revenue-PG-split enabled,5eecc6d6449e4f7cfb1c2708,2020-11-24T00:00:00.000Z,NEFT CR-UTIB0001506-RAZORPAY SOFTWARE PR IVATE LIMITED-SLICK ORGANICS PVT LITD-AX ISCN0061947048,investments,,net_banking_transfer,13371.02
61b6fd14d8beac1599eb1a63,50200023535069,208193.17,60ec41ba55c00300382672d9,HDFC,direct expenses,5eecc6d6449e4f7cfb1c2708,2020-11-24T00:00:00.000Z,"NEFT DR-BOFA0MM6205-FEDEX EXPRESS TRANSP ORTATION SUPPLY CHAI-NETBANK, MUM-N32920 1317704441-8145",loans,lender_transaction,net_banking_transfer,-8145
61b6fd15d8beac1599eb1a67,50200023535069,158201.17,60ec41ba55c00300382672d9,HDFC,agency/vendor expense,5eecc6d6449e4f7cfb1c2708,2020-11-24T00:00:00.000Z,"NEFT DR-KKBK0000298-ADMITAD MEDIA PRIVAT E LIMITED-NETBANK, MUM-N329201317713873- 49992",loans,lender_transaction,net_banking_transfer,-49992
61b6fd16d8beac1599eb1a70,50200023535069,283236.53,60ec41ba55c00300382672d9,HDFC,Revenue-Mktplace,5eecc6d6449e4f7cfb1c2708,2020-11-24T00:00:00.000Z,IMPS-032911276091-AMAZON SELLER SERVIC-H DFC-XXXXXXXX6004-5DPZLWXKNS7X3VX7SLICK O RGANICS PVT LTD,shopping,,net_banking_transfer,125035.36
61b6fd17d8beac1599eb1a78,50200023535069,649963.86,60ec41ba55c00300382672d9,HDFC,Revenue-Mktplace,5eecc6d6449e4f7cfb1c2708,2020-11-24T00:00:00.000Z,NEFT CR-DEUT0797BGL-AMAZON PAY (INDIA) P RIVATE LIMITED-SLICK ORGANICS PVT LTD-11 2400350GN00067,shopping,,net_banking_transfer,366727.33
61b6fd18d8beac1599eb1a80,50200023535069,599963.86,60ec41ba55c00300382672d9,HDFC,SAAS/tech expense,5eecc6d6449e4f7cfb1c2708,2020-11-24T00:00:00.000Z,VHDF9490958719/BILLDKAMAZONSELLERSE,shopping,,Other,-50000
61b6fd19d8beac1599eb1a84,50200023535069,563963.86,60ec41ba55c00300382672d9,HDFC,direct expenses,5eecc6d6449e4f7cfb1c2708,2020-11-24T00:00:00.000Z,"NEFT DR-ORBC0100707-UFLEX LIMITED-NETBAN K, MUM-N329201317947393-ADVANCE",loans,lender_transaction,net_banking_transfer,-36000
61b6fd1ad8beac1599eb1a8a,50200023535069,552714.86,60ec41ba55c00300382672d9,HDFC,direct expenses,5eecc6d6449e4f7cfb1c2708,2020-11-24T00:00:00.000Z,POS 514834XXXXXX9486 TATA CLIQ,,,debit_card,-11249
61b6fd1bd8beac1599eb1a8e,50200023535069,557215.46,60ec41ba55c00300382672d9,HDFC,Revenue-Mktplace,5eecc6d6449e4f7cfb1c2708,2020-11-24T00:00:00.000Z,NEFT CR-KKBK0000958-SUPERMARKET GROCERY SUPPLIES PVT LTD-SLICK ORGANICS PVT LTD- KKBK203293923719,shopping,,net_banking_transfer,4500.6
61b6fd1cd8beac1599eb1a93,50200023535069,560252.26,60ec41ba55c00300382672d9,HDFC,Revenue-Mktplace,5eecc6d6449e4f7cfb1c2708,2020-11-24T00:00:00.000Z,NEFT CR-KKBK0000958-SUPERMARKET GROCERY,shopping,,net_banking_transfer,3036.8
61b6fd1dd8beac1599eb1a98,50200023535069,562136.61,60ec41ba55c00300382672d9,HDFC,Revenue-Mktplace,5eecc6d6449e4f7cfb1c2708,2020-11-24T00:00:00.000Z,NEFT CR-KKBK0000958-SUPERMARKET GROCERY SUPPLIES PVT LTD-SLICK ORGANICS PVT LTD- KKBK203293923778,shopping,,net_banking_transfer,1884.35
61b6fd1ed8beac1599eb1a9b,50200023535069,572698.18,60ec41ba55c00300382672d9,HDFC,Revenue-Mktplace,5eecc6d6449e4f7cfb1c2708,2020-11-24T00:00:00.000Z,NEFT CR-KKBK0000958-SUPERMARKET GROCERY SUPPLIES PVT LTD-SLICK ORGANICS PVT LTD- KKBK203293923750,shopping,,net_banking_transfer,10561.57
61b6fd1fd8beac1599eb1a9f,50200023535069,576742.75,60ec41ba55c00300382672d9,HDFC,Revenue-Mktplace,5eecc6d6449e4f7cfb1c2708,2020-11-24T00:00:00.000Z,NEFT CR-KKBK0000958-SUPERMARKET GROCERY SUPPLIES PVT LTD-SLICK ORGANICS PVT LTD- KKBK203293923771,shopping,,net_banking_transfer,4044.57
61b6fd20d8beac1599eb1aa9,50200023535069,579405.8,60ec41ba55c00300382672d9,HDFC,Revenue-Mktplace,5eecc6d6449e4f7cfb1c2708,2020-11-24T00:00:00.000Z,NEFT CR-KKBK0000958-SUPERMARKET GROCERY SUPPLIES PVT LTD-SLICK ORGANICS PVT LTD- KKBK203293923865,shopping,,net_banking_transfer,2663.05
61b6fd21d8beac1599eb1aac,50200023535069,592883.51,60ec41ba55c00300382672d9,HDFC,Revenue-PG-split enabled,5eecc6d6449e4f7cfb1c2708,2020-11-24T00:00:00.000Z,NEFT CR-UTIB0001506-RAZORPAY SOFTWARE PR IVATE LIMITED-SLICK ORGANICS PVT LITD-AX ISCN0061998704,investments,,net_banking_transfer,13477.71
61b6fd22d8beac1599eb1ab8,50200023535069,601399.69,60ec41ba55c00300382672d9,HDFC,Revenue-PG-non-split,5eecc6d6449e4f7cfb1c2708,2020-11-25T00:00:00.000Z,UPI-PAYTM-PAYOUTS@PAYTM-PYTM0123456-0330 42726837-ALL202011252168200,ewallet,,upi,8516.18
61b6fd23d8beac1599eb1abc,50200023535069,602411.03,60ec41ba55c00300382672d9,HDFC,Revenue-Mktplace,5eecc6d6449e4f7cfb1c2708,2020-11-25T00:00:00.000Z,NEFT CR-DEUT0797BGL-FLIPKART INTERNET PR IVATE LIMITED-SLICK ORGANICS PVT LTD-112 500113GN00165,shopping,,net_banking_transfer,1011.34
61b6fd23d8beac1599eb1ac0,50200023535069,610177.29,60ec41ba55c00300382672d9,HDFC,Revenue-PG-split enabled,5eecc6d6449e4f7cfb1c2708,2020-11-25T00:00:00.000Z,NEFT CR-UTIB0001506-RAZORPAY SOFTWARE PR IVATE LIMITED-SLICK ORGANICS PVT LITD-AX ISCN0062054100,investments,,net_banking_transfer,7766.26
61b6fd24d8beac1599eb1ac6,50200023535069,570330.9,60ec41ba55c00300382672d9,HDFC,direct expenses,5eecc6d6449e4f7cfb1c2708,2020-11-25T00:00:00.000Z,ADVANCE PAYMENT OF IMPORT BILL,bills,,Other,-39846.39
61b6fd25d8beac1599eb1aca,50200023535069,270330.9,60ec41ba55c00300382672d9,HDFC,direct expenses,5eecc6d6449e4f7cfb1c2708,2020-11-25T00:00:00.000Z,"NEFT DR-ICIC0003430-HASHTAG ORANGE ADVER TISING PVT LTD-NETBANK, MUM-N33020131902 2043-300000",,,net_banking_transfer,-300000
61b6fd26d8beac1599eb1ad7,50200023535069,178330.9,60ec41ba55c00300382672d9,HDFC,direct expenses,5eecc6d6449e4f7cfb1c2708,2020-11-25T00:00:00.000Z,"NEFT DR-YESB0000551-VISTTA COSMETICS-NET BANK, MUM-N330201319027383-92000",,,net_banking_transfer,-92000
61b6fd27d8beac1599eb1ad9,50200023535069,78330.9,60ec41ba55c00300382672d9,HDFC,direct expenses,5eecc6d6449e4f7cfb1c2708,2020-11-25T00:00:00.000Z,57500000443889-TPT-100000-WEBKLIPPER TEC,,,net_banking_transfer,-100000
61b6fd28d8beac1599eb1add,50200023535069,53956.9,60ec41ba55c00300382672d9,HDFC,agency/vendor expense,5eecc6d6449e4f7cfb1c2708,2020-11-25T00:00:00.000Z,"NEFT DR-KKBK0000298-ADMITAD MEDIA PRIVAT E LIMITED-NETBANK, MUM-N330201319014855- 24374",loans,lender_transaction,net_banking_transfer,-24374
61b6fd29d8beac1599eb1ae5,50200023535069,55121.71,60ec41ba55c00300382672d9,HDFC,Revenue-Mktplace,5eecc6d6449e4f7cfb1c2708,2020-11-25T00:00:00.000Z,NEFT CR-DEUT0797BGL-MYNTRA DESIGNS PRIVA TE LIMITED-SLICK ORGANICS PRIVATE LIMITE D-112500220GN00264,shopping,,net_banking_transfer,1164.81
61b6fd2ad8beac1599eb1ae7,50200023535069,85886.86,60ec41ba55c00300382672d9,HDFC,Revenue-COD,5eecc6d6449e4f7cfb1c2708,2020-11-25T00:00:00.000Z,NEFT CR-KKBK0000958-BIGFOOT RETAIL SOLUT IONS PRIVATE LIMITED-SLICK ORGANICS PVT LTD-KKBK203304076116,,,net_banking_transfer,30765.15
61b6fd2bd8beac1599eb1af3,50200023535069,86581.21,60ec41ba55c00300382672d9,HDFC,Revenue-Mktplace,5eecc6d6449e4f7cfb1c2708,2020-11-25T00:00:00.000Z,NEFT CR-DEUT0797BGL-FLIPKART INTERNET PR IVATE LIMITED-SLICK ORGANICS PVT LTD-112 500081GN00202,shopping,,net_banking_transfer,694.35
61b6fd2cd8beac1599eb1b02,50200023535069,93163.35,60ec41ba55c00300382672d9,HDFC,Revenue-PG-split enabled,5eecc6d6449e4f7cfb1c2708,2020-11-25T00:00:00.000Z,NEFT CR-UTIB0001506-RAZORPAY SOFTWARE PR IVATE LIMITED-SLICK ORGANICS PVT LITD-AX ISCN0062110284,investments,,net_banking_transfer,6582.14
61b6fd2dd8beac1599eb1b14,50200023535069,100195.29,60ec41ba55c00300382672d9,HDFC,Revenue-PG-non-split,5eecc6d6449e4f7cfb1c2708,2020-11-26T00:00:00.000Z,UPI-PAYTM-PAYOUTS@PAYTM-PYTM0123456-0331 62180844-ALL202011262168200,ewallet,,upi,7031.94
61b6fd2ed8beac1599eb1b21,50200023535069,102092.16,60ec41ba55c00300382672d9,HDFC,Revenue-Mktplace,5eecc6d6449e4f7cfb1c2708,2020-11-26T00:00:00.000Z,NEFT CR-DEUT0797BGL-MYNTRA DESIGNS PRIVA TE LIMITED-SLICK ORGANICS PRIVATE LIMITE D-112600053GN00224,shopping,,net_banking_transfer,1896.87
61b6fd2fd8beac1599eb1b2f,50200023535069,121377.3,60ec41ba55c00300382672d9,HDFC,Revenue-PG-split enabled,5eecc6d6449e4f7cfb1c2708,2020-11-26T00:00:00.000Z,NEFT CR-UTIB0001506-RAZORPAY SOFTWARE PR IVATE LIMITED-SLICK ORGANICS PVT LITD-AX ISCN0062156436,investments,,net_banking_transfer,19285.14
61b6fd30d8beac1599eb1b3d,50200023535069,117738.7,60ec41ba55c00300382672d9,HDFC,direct expenses,5eecc6d6449e4f7cfb1c2708,2020-11-26T00:00:00.000Z,POS 514834XXXXXX9486 FRESHWORKS INC,,,debit_card,-3638.6
61b6fd31d8beac1599eb1b43,50200023535069,117524.2,60ec41ba55c00300382672d9,HDFC,bank charges,5eecc6d6449e4f7cfb1c2708,2020-11-26T00:00:00.000Z,.DC INTL POS TXN MARKUP+ST 191120 231120 -CDT2030701838784,,,international_transaction_arbitrage,-214.5
61b6fd32d8beac1599eb1b4b,50200023535069,117251.52,60ec41ba55c00300382672d9,HDFC,bank charges,5eecc6d6449e4f7cfb1c2708,2020-11-26T00:00:00.000Z,.DC INTL POS TXN MARKUP+ST 201120 231120 -CDT2030701838784,,,international_transaction_arbitrage,-272.68
61b6fd33d8beac1599eb1b5a,50200023535069,67251.52,60ec41ba55c00300382672d9,HDFC,SAAS/tech expense,5eecc6d6449e4f7cfb1c2708,2020-11-26T00:00:00.000Z,VHDF9496402596/BILLDKAMAZONSELLERSE,shopping,,Other,-50000
61b6fd34d8beac1599eb1b60,50200023535069,67841.52,60ec41ba55c00300382672d9,HDFC,Revenue-Mktplace,5eecc6d6449e4f7cfb1c2708,2020-11-26T00:00:00.000Z,POS REF 514834******9486-11/26 AMAZON,shopping,,refund,590
61b6fd35d8beac1599eb1b69,50200023535069,76288.85,60ec41ba55c00300382672d9,HDFC,Revenue-PG-split enabled,5eecc6d6449e4f7cfb1c2708,2020-11-26T00:00:00.000Z,NEFT CR-UTIB0001506-RAZORPAY SOFTWARE PR,,,net_banking_transfer,8447.33
61b6fd36d8beac1599eb1b70,50200023535069,82327.57,60ec41ba55c00300382672d9,HDFC,Revenue-PG-non-split,5eecc6d6449e4f7cfb1c2708,2020-11-27T00:00:00.000Z,UPI-PAYTM-PAYOUTS@PAYTM-PYTM0123456-0332 79927379-ALL202011272168200,ewallet,,upi,6038.72
61b6fd37d8beac1599eb1b77,50200023535069,84359.57,60ec41ba55c00300382672d9,HDFC,Revenue-Mktplace,5eecc6d6449e4f7cfb1c2708,2020-11-27T00:00:00.000Z,NEFT CR-SCBL0036001-DREAMPLUG TECHNOLOGI ES PRIVATE LIMI-SLICK ORGANICS PRIVATE L IMITEDSLICK-SIN31436Q0008634,,,net_banking_transfer,2032
61b6fd38d8beac1599eb1b7d,50200023535069,91023.15,60ec41ba55c00300382672d9,HDFC,Revenue-PG-split enabled,5eecc6d6449e4f7cfb1c2708,2020-11-27T00:00:00.000Z,NEFT CR-UTIB0001506-RAZORPAY SOFTWARE PR IVATE LIMITED-SLICK ORGANICS PVT LITD-AX ISCN0062253047,investments,,net_banking_transfer,6663.58
61b6fd39d8beac1599eb1b84,50200023535069,101081.43,60ec41ba55c00300382672d9,HDFC,Revenue-Mktplace,5eecc6d6449e4f7cfb1c2708,2020-11-27T00:00:00.000Z,NEFT CR-DEUT0797BGL-FLIPKART INTERNET PR IVATE LIMITED-SLICK ORGANICS PVT LTD-112 700111GN00081,shopping,,net_banking_transfer,10058.28
61b6fd3ad8beac1599eb1b8a,50200023535069,102097.22,60ec41ba55c00300382672d9,HDFC,Revenue-PG-non-split,5eecc6d6449e4f7cfb1c2708,2020-11-27T00:00:00.000Z,NEFT CR-ICIC0000031-PAYTM E COMMERCE PVT LTD-SLICK ORGANICS PVT LTD-CMS170241372 2,investments,,net_banking_transfer,1015.79
61b6fd3bd8beac1599eb1b92,50200023535069,103745.69,60ec41ba55c00300382672d9,HDFC,Revenue-Mktplace,5eecc6d6449e4f7cfb1c2708,2020-11-27T00:00:00.000Z,NEFT CR-DEUT0784BBY-TATA UNISTORE LTD-NO DAL-SLICK ORGANICS PVT LTD-112700596GN00 291,investments,,net_banking_transfer,1648.47
61b6fd3cd8beac1599eb1b96,50200023535069,78745.69,60ec41ba55c00300382672d9,HDFC,direct expenses,5eecc6d6449e4f7cfb1c2708,2020-11-27T00:00:00.000Z,50100301160692-TPT-25000-TARUN GARG,,,net_banking_transfer,-25000
61b6fd3dd8beac1599eb1b9e,50200023535069,88472.25,60ec41ba55c00300382672d9,HDFC,Revenue-Mktplace,5eecc6d6449e4f7cfb1c2708,2020-11-27T00:00:00.000Z,NEFT CR-DEUT0797BGL-FLIPKART INTERNET PR IVATE LIMITED-SLICK ORGANICS PVT LTD-112 700128GN00046,shopping,,net_banking_transfer,9726.56
61b6fd3ed8beac1599eb1ba8,50200023535069,114843.88,60ec41ba55c00300382672d9,HDFC,Revenue-COD,5eecc6d6449e4f7cfb1c2708,2020-11-27T00:00:00.000Z,NEFT CR-KKBK0000958-BIGFOOT RETAIL SOLUT IONS PRIVATE LIMITED-SLICK ORGANICS PVT LTD-KKBK203324465657,,,net_banking_transfer,26371.63
61b6fd3fd8beac1599eb1bac,50200023535069,118652.88,60ec41ba55c00300382672d9,HDFC,Revenue-Mktplace,5eecc6d6449e4f7cfb1c2708,2020-11-27T00:00:00.000Z,NEFT CR-KKBK0000958-SURFBOATS SOLUTIONS PVT LTD-SLICK ORGANICS PRIVATE LIMITED-K KBK203324483891,investments,,net_banking_transfer,3809
61b6fd40d8beac1599eb1bb9,50200023535069,120859.88,60ec41ba55c00300382672d9,HDFC,Revenue-Mktplace,5eecc6d6449e4f7cfb1c2708,2020-11-27T00:00:00.000Z,NEFT CR-KKBK0000958-SURFBOATS SOLUTIONS PVT LTD-SLICK ORGANICS PRIVATE LIMITED-K KBK203324488868,investments,,net_banking_transfer,2207
61b6fd41d8beac1599eb1bc6,50200023535069,124072.88,60ec41ba55c00300382672d9,HDFC,Revenue-Mktplace,5eecc6d6449e4f7cfb1c2708,2020-11-27T00:00:00.000Z,NEFT CR-KKBK0000958-SURFBOATS SOLUTIONS,,,net_banking_transfer,3213
61b6fd42d8beac1599eb1bcc,50200023535069,124619.88,60ec41ba55c00300382672d9,HDFC,Revenue-Mktplace,5eecc6d6449e4f7cfb1c2708,2020-11-27T00:00:00.000Z,NEFT CR-KKBK0000958-SURFBOATS SOLUTIONS PVT LTD-SLICK ORGANICS PRIVATE LIMITED-K KBK203324488835,investments,,net_banking_transfer,547
61b6fd43d8beac1599eb1bd2,50200023535069,273958.88,60ec41ba55c00300382672d9,HDFC,Revenue-Mktplace,5eecc6d6449e4f7cfb1c2708,2020-11-27T00:00:00.000Z,NYKAA E RETAIL-SLICK ORGANICS PVT L,investments,,Other,149339
61b6fd43d8beac1599eb1bd6,50200023535069,276294.88,60ec41ba55c00300382672d9,HDFC,Revenue-Mktplace,5eecc6d6449e4f7cfb1c2708,2020-11-27T00:00:00.000Z,NEFT CR-KKBK0000958-SURFBOATS SOLUTIONS PVT LTD-SLICK ORGANICS PRIVATE LIMITED-K KBK203324491106,investments,,net_banking_transfer,2336
61b6fd44d8beac1599eb1be2,50200023535069,481729.28,60ec41ba55c00300382672d9,HDFC,Revenue-PG-split enabled,5eecc6d6449e4f7cfb1c2708,2020-11-27T00:00:00.000Z,RTGS CR-UTIB0001506-RAZORPAY SOFTWARE PR IVATE LIMITED --SLICK ORGANICS PVT LITD- UTIBR52020112700349726,,,net_banking_transfer,205434.4
61b6fd45d8beac1599eb1be4,50200023535069,81729.28,60ec41ba55c00300382672d9,HDFC,OD/CC Repayment,5eecc6d6449e4f7cfb1c2708,2020-11-27T00:00:00.000Z,02711600008220-TPT-CREDIT CARD-VARUN SIN GH,bills,credit_card_bill,bill_payment,-400000
61b6fd46d8beac1599eb1be8,50200023535069,166319.92,60ec41ba55c00300382672d9,HDFC,Revenue-PG-non-split,5eecc6d6449e4f7cfb1c2708,2020-11-28T00:00:00.000Z,IMPS-033305083068-PAYTM-HDFC-XXXXXXXXXX0 007-,ewallet,,net_banking_transfer,84590.64
61b6fd47d8beac1599eb1bf1,50200023535069,166318.92,60ec41ba55c00300382672d9,HDFC,Marketing Expense,5eecc6d6449e4f7cfb1c2708,2020-11-28T00:00:00.000Z,POS 514834XXXXXX9486 GOOGLE ADWORDS,,,debit_card,-1
61b6fd48d8beac1599eb1bf4,50200023535069,116318.92,60ec41ba55c00300382672d9,HDFC,Marketing Expense,5eecc6d6449e4f7cfb1c2708,2020-11-28T00:00:00.000Z,POS 514834XXXXXX9486 GOOGLE ADWORDS,,,debit_card,-50000
61b6fd49d8beac1599eb1bfc,50200023535069,66318.92,60ec41ba55c00300382672d9,HDFC,SAAS/tech expense,5eecc6d6449e4f7cfb1c2708,2020-11-28T00:00:00.000Z,POS 514834XXXXXX9486 AMAZON,shopping,,debit_card,-50000
61b6fd4ad8beac1599eb1c04,50200023535069,65207.84,60ec41ba55c00300382672d9,HDFC,direct expenses,5eecc6d6449e4f7cfb1c2708,2020-11-29T00:00:00.000Z,POS 514834XXXXXX9486 ZOOM US 888-799-,,,debit_card,-1111.08
61b6fd4bd8beac1599eb1c08,50200023535069,70258.55,60ec41ba55c00300382672d9,HDFC,Revenue-PG-non-split,5eecc6d6449e4f7cfb1c2708,2020-11-29T00:00:00.000Z,IMPS-033405315774-PAYTM-HDFC-XXXXXXXXXX0 007-,ewallet,,net_banking_transfer,5050.71
61b6fd4cd8beac1599eb1c0d,50200023535069,75451.05,60ec41ba55c00300382672d9,HDFC,Revenue-PG-non-split,5eecc6d6449e4f7cfb1c2708,2020-11-30T00:00:00.000Z,UPI-PAYTM-PAYOUTS@PAYTM-PYTM0123456-0335 38355533-ALL202011302168200,ewallet,,upi,5192.5
61b6fd4dd8beac1599eb1c12,50200023535069,25451.05,60ec41ba55c00300382672d9,HDFC,SAAS/tech expense,5eecc6d6449e4f7cfb1c2708,2020-11-30T00:00:00.000Z,VHDF9513719014/BILLDKAMAZONSELLERSE,shopping,,Other,-50000
61b6fd4ed8beac1599eb1c19,50200023535069,63016.05,60ec41ba55c00300382672d9,HDFC,Transfer in/Revenue-other,5eecc6d6449e4f7cfb1c2708,2020-11-30T00:00:00.000Z,IMPS-033511725837-VANITY WAGON-HDFC-XXXX XXXXXXX0887-VANITY WAGON,,,net_banking_transfer,37565
61b6fd4fd8beac1599eb1c1d,50200023535069,38016.05,60ec41ba55c00300382672d9,HDFC,SAAS/tech expense,5eecc6d6449e4f7cfb1c2708,2020-11-30T00:00:00.000Z,VHDF9514346064/BILLDKAMAZONSELLERSE,shopping,,Other,-25000
61b6fd50d8beac1599eb1c21,50200023535069,13016.05,60ec41ba55c00300382672d9,HDFC,SAAS/tech expense,5eecc6d6449e4f7cfb1c2708,2020-11-30T00:00:00.000Z,VHDF9514435248/BILLDKAMAZONSELLERSE,shopping,,Other,-25000
61b6fd51d8beac1599eb1c24,50200023535069,-4683.95,60ec41ba55c00300382672d9,HDFC,direct expenses,5eecc6d6449e4f7cfb1c2708,2020-11-30T00:00:00.000Z,POS 514834XXXXXX9486 PAYU-WWW.TOWNSCR,,,debit_card,-17700
61b6fd52d8beac1599eb1c2b,50200023535069,-4572.21,60ec41ba55c00300382672d9,HDFC,Transfer in/Revenue-other,5eecc6d6449e4f7cfb1c2708,2020-11-30T00:00:00.000Z,INT. ON SWCR ON-50300247022509,,,Other,111.74
61b6fd53d8beac1599eb1c31,50200023535069,111.79,60ec41ba55c00300382672d9,HDFC,Loan-in,5eecc6d6449e4f7cfb1c2708,2020-11-30T00:00:00.000Z,SWEEP-IN CREDIT - 50300247022509,,,self_transfer,4684
61b6fd54d8beac1599eb1c42,50200023535069,2588.85,60ec41ba55c00300382672d9,HDFC,Revenue-PG-non-split,5eecc6d6449e4f7cfb1c2708,2020-12-01T00:00:00.000Z,IMPS-033605939948-PAYTM-HDFC-XXXXXXXXXX0 007-,ewallet,,net_banking_transfer,2477.06
61b6fd55d8beac1599eb1c48,50200023535069,3508.57,60ec41ba55c00300382672d9,HDFC,Revenue-PG-non-split,5eecc6d6449e4f7cfb1c2708,2020-12-01T00:00:00.000Z,NEFT CR-ICIC0000031-PAYTM E COMMERCE PVT LTD-SLICK ORGANICS PVT LTD-CMS170673062 0,investments,,net_banking_transfer,919.72
61b6fd56d8beac1599eb1c4c,50200023535069,144231.77,60ec41ba55c00300382672d9,HDFC,Revenue-PG-split enabled,5eecc6d6449e4f7cfb1c2708,2020-12-01T00:00:00.000Z,NEFT CR-UTIB0001506-RAZORPAY SOFTWARE PR IVATE LIMITED-SLICK ORGANICS PVT LITD-AX ISCN0062416839,investments,,net_banking_transfer,140723.2
61b6fd57d8beac1599eb1c52,50200023535069,146547.32,60ec41ba55c00300382672d9,HDFC,Revenue-Mktplace,5eecc6d6449e4f7cfb1c2708,2020-12-01T00:00:00.000Z,NEFT CR-DEUT0797BGL-MYNTRA DESIGNS PRIVA TE LIMITED-SLICK ORGANICS PRIVATE LIMITE D-120100109GN00004,shopping,,net_banking_transfer,2315.55
61b6fd58d8beac1599eb1c56,50200023535069,2849075.32,60ec41ba55c00300382672d9,HDFC,Internal Transfers,5eecc6d6449e4f7cfb1c2708,2020-12-01T00:00:00.000Z,IB FUNDS TRANSFER CR-50200035187206 -SL ICK ORGANICS PVT LTD,investments,,Other,2702528
61b6fd59d8beac1599eb1c5c,50200023535069,2871075.32,60ec41ba55c00300382672d9,HDFC,Internal Transfers,5eecc6d6449e4f7cfb1c2708,2020-12-01T00:00:00.000Z,IB FUNDS TRANSFER CR-50200050976833 -SL ICK ORGANICS PVT LTD,investments,,Other,22000
61b6fd5ad8beac1599eb1c63,50200023535069,2571075.32,60ec41ba55c00300382672d9,HDFC,direct expenses,5eecc6d6449e4f7cfb1c2708,2020-12-01T00:00:00.000Z,"NEFT DR-SCBL0036025-DHRUV MADHOK-NETBANK , MUM-N336201324519197-300000",,,net_banking_transfer,-300000
61b6fd5bd8beac1599eb1c69,50200023535069,2071075.32,60ec41ba55c00300382672d9,HDFC,direct expenses,5eecc6d6449e4f7cfb1c2708,2020-12-01T00:00:00.000Z,05892560000649-TPT-500000-DECORPAC INDIA PRIVATE LIMITED,,,net_banking_transfer,-500000
61b6fd5cd8beac1599eb1c73,50200023535069,1845051.32,60ec41ba55c00300382672d9,HDFC,direct expenses,5eecc6d6449e4f7cfb1c2708,2020-12-01T00:00:00.000Z,"NEFT DR-INDB0000148-ACQUISORY INDIA CONS ULTING PVT LTD-NETBANK, MUM-N33620132452 7454-226024",,,net_banking_transfer,-226024
61b6fd5cd8beac1599eb1c75,50200023535069,1590051.32,60ec41ba55c00300382672d9,HDFC,SAAS/tech expense,5eecc6d6449e4f7cfb1c2708,2020-12-01T00:00:00.000Z,VHDF9516963440/BILLDKAMAZONSELLERSE,shopping,,Other,-255000
61b6fd5dd8beac1599eb1c80,50200023535069,1661939.58,60ec41ba55c00300382672d9,HDFC,Revenue-Mktplace,5eecc6d6449e4f7cfb1c2708,2020-12-01T00:00:00.000Z,IMPS-033611218953-AMAZON SELLER SERVIC-H DFC-XXXXXXXX6004-7HYX52KA2FQ3BK7CSLICK O RGANICS PVT LTD,shopping,,net_banking_transfer,71888.26
61b6fd5ed8beac1599eb1c87,50200023535069,1659792.43,60ec41ba55c00300382672d9,HDFC,direct expenses,5eecc6d6449e4f7cfb1c2708,2020-12-01T00:00:00.000Z,POS 514834XXXXXX9486 SEOPTIMER,,,debit_card,-2147.15
61b6fd5fd8beac1599eb1c8c,50200023535069,1366473.09,60ec41ba55c00300382672d9,HDFC,direct expenses,5eecc6d6449e4f7cfb1c2708,2020-12-01T00:00:00.000Z,POS 514834XXXXXX9486 THE COPY CLUB,,,debit_card,-293319.34
61b6fd60d8beac1599eb1c94,50200023535069,1666185.63,60ec41ba55c00300382672d9,HDFC,Revenue-Mktplace,5eecc6d6449e4f7cfb1c2708,2020-12-01T00:00:00.000Z,NEFT CR-DEUT0797BGL-AMAZON PAY (INDIA) P,shopping,,net_banking_transfer,299712.54
61b6fd61d8beac1599eb1c99,50200023535069,1583753.63,60ec41ba55c00300382672d9,HDFC,direct expenses,5eecc6d6449e4f7cfb1c2708,2020-12-01T00:00:00.000Z,"NEFT DR-KKBK0000173-MATRIX PRINTING SOLU TIONS PRIVATE LIMITE-NETBANK, MUM-N33620 1324719402-82432",,,net_banking_transfer,-82432
61b6fd62d8beac1599eb1c9f,50200023535069,1459027.63,60ec41ba55c00300382672d9,HDFC,direct expenses,5eecc6d6449e4f7cfb1c2708,2020-12-01T00:00:00.000Z,"NEFT DR-ORBC0101001-KRAUTER HEALTHCARE L TD-NETBANK, MUM-N336201324740727-124726",,,net_banking_transfer,-124726
61b6fd63d8beac1599eb1ca1,50200023535069,959027.63,60ec41ba55c00300382672d9,HDFC,direct expenses,5eecc6d6449e4f7cfb1c2708,2020-12-01T00:00:00.000Z,"NEFT DR-YESB0000551-VISTTA COSMETICS-NET BANK, MUM-N336201324766899-500000",,,net_banking_transfer,-500000
61b6fd64d8beac1599eb1ca5,50200023535069,909027.63,60ec41ba55c00300382672d9,HDFC,direct expenses,5eecc6d6449e4f7cfb1c2708,2020-12-01T00:00:00.000Z,"NEFT DR-YESB0000551-VISTTA COSMETICS-NET BANK, MUM-N336201324776770-50000",,,net_banking_transfer,-50000
61b6fd65d8beac1599eb1cac,50200023535069,809027.63,60ec41ba55c00300382672d9,HDFC,direct expenses,5eecc6d6449e4f7cfb1c2708,2020-12-01T00:00:00.000Z,"NEFT DR-YESB0000551-VISTTA COSMETICS-NET BANK, MUM-N336201324789084-100000",,,net_banking_transfer,-100000
61b6fd66d8beac1599eb1caf,50200023535069,809716.37,60ec41ba55c00300382672d9,HDFC,Revenue-Mktplace,5eecc6d6449e4f7cfb1c2708,2020-12-01T00:00:00.000Z,NEFT CR-DEUT0797BGL-MYNTRA DESIGNS PRIVA TE LIMITED-SLICK ORGANICS PRIVATE LIMITE D-120100108GN00296,shopping,,net_banking_transfer,688.74
61b6fd67d8beac1599eb1cb7,50200023535069,820284.96,60ec41ba55c00300382672d9,HDFC,Revenue-PG-split enabled,5eecc6d6449e4f7cfb1c2708,2020-12-01T00:00:00.000Z,NEFT CR-UTIB0001506-RAZORPAY SOFTWARE PR IVATE LIMITED-SLICK ORGANICS PVT LITD-AX ISCN0062491584,investments,,net_banking_transfer,10568.59
61b6fd68d8beac1599eb1cbc,50200023535069,823873.95,60ec41ba55c00300382672d9,HDFC,Revenue-PG-non-split,5eecc6d6449e4f7cfb1c2708,2020-12-02T00:00:00.000Z,IMPS-033706713664-PAYTM-HDFC-XXXXXXXXXX0 007-,ewallet,,net_banking_transfer,3588.99
61b6fd69d8beac1599eb1cc2,50200023535069,418873.95,60ec41ba55c00300382672d9,HDFC,direct expenses,5eecc6d6449e4f7cfb1c2708,2020-12-02T00:00:00.000Z,50200001182150-TPT-405000-DEXTER CAPITAL ADVISORS PVT LTD,,,net_banking_transfer,-405000
61b6fd6ad8beac1599eb1cc6,50200023535069,340678.95,60ec41ba55c00300382672d9,HDFC,direct expenses,5eecc6d6449e4f7cfb1c2708,2020-12-02T00:00:00.000Z,00921000075586-TPT-78195-ROET BINDRA,,,net_banking_transfer,-78195
61b6fd6bd8beac1599eb1ccc,50200023535069,329051.95,60ec41ba55c00300382672d9,HDFC,direct expenses,5eecc6d6449e4f7cfb1c2708,2020-12-02T00:00:00.000Z,"NEFT DR-CITI0000002-OMG NETWORK INDIA PR IVATE LIMITED-NETBANK, MUM-N337201325961 728-11627",,,net_banking_transfer,-11627
61b6fd6cd8beac1599eb1cd1,50200023535069,300604.95,60ec41ba55c00300382672d9,HDFC,agency/vendor expense,5eecc6d6449e4f7cfb1c2708,2020-12-02T00:00:00.000Z,"NEFT DR-IDFB0021001-CLIKCONIK DIGITAL ME DIA PRIVATE LIMITED-NETBANK, MUM-N337201 325949771-28447",,,net_banking_transfer,-28447
61b6fd6dd8beac1599eb1cd6,50200023535069,184604.95,60ec41ba55c00300382672d9,HDFC,direct expenses,5eecc6d6449e4f7cfb1c2708,2020-12-02T00:00:00.000Z,"NEFT DR-YESB0000551-VISTTA COSMETICS-NET BANK, MUM-N337201325967052-116000",,,net_banking_transfer,-116000
61b6fd6ed8beac1599eb1cd9,50200023535069,190618.26,60ec41ba55c00300382672d9,HDFC,Revenue-PG-split enabled,5eecc6d6449e4f7cfb1c2708,2020-12-02T00:00:00.000Z,NEFT CR-UTIB0001506-RAZORPAY SOFTWARE PR,,,net_banking_transfer,6013.31
61b6fd6fd8beac1599eb1cdd,50200023535069,191716.45,60ec41ba55c00300382672d9,HDFC,Revenue-Mktplace,5eecc6d6449e4f7cfb1c2708,2020-12-02T00:00:00.000Z,NEFT CR-DEUT0797BGL-FLIPKART INTERNET PR IVATE LIMITED-SLICK ORGANICS PVT LTD-120 200112GN00016,shopping,,net_banking_transfer,1098.19
61b6fd70d8beac1599eb1ce4,50200023535069,192097.92,60ec41ba55c00300382672d9,HDFC,Revenue-Mktplace,5eecc6d6449e4f7cfb1c2708,2020-12-02T00:00:00.000Z,NEFT CR-DEUT0797BGL-MYNTRA DESIGNS PRIVA TE LIMITED-SLICK ORGANICS PRIVATE LIMITE D-120200176GN00141,shopping,,net_banking_transfer,381.47
61b6fd71d8beac1599eb1ce6,50200023535069,172097.92,60ec41ba55c00300382672d9,HDFC,direct expenses,5eecc6d6449e4f7cfb1c2708,2020-12-02T00:00:00.000Z,"SELF - CHQ PAID - KALKAJI, NEW",,,chq,-20000
61b6fd72d8beac1599eb1cf0,50200023535069,136047.92,60ec41ba55c00300382672d9,HDFC,direct expenses,5eecc6d6449e4f7cfb1c2708,2020-12-02T00:00:00.000Z,"NEFT DR-ICIC0000037-PURPLE PANDA FASHION S PVT LTD-NETBANK, MUM-N337201326421015- 36050",shopping,,net_banking_transfer,-36050
61b6fd73d8beac1599eb1cf4,50200023535069,186047.92,60ec41ba55c00300382672d9,HDFC,Transfer in/Revenue-other,5eecc6d6449e4f7cfb1c2708,2020-12-02T00:00:00.000Z,REF-BILLDKAMAZO-VHDF9513719014-30/11/20,,,refund,50000
61b6fd74d8beac1599eb1cf9,50200023535069,116047.92,60ec41ba55c00300382672d9,HDFC,direct expenses,5eecc6d6449e4f7cfb1c2708,2020-12-02T00:00:00.000Z,IMPS-033714144908-PAYTM-PYTM-XXXXXXXX383 9-70000,ewallet,,net_banking_transfer,-70000
61b6fd75d8beac1599eb1d1f,50200023535069,117238.05,60ec41ba55c00300382672d9,HDFC,Revenue-Mktplace,5eecc6d6449e4f7cfb1c2708,2020-12-02T00:00:00.000Z,NEFT CR-DEUT0797BGL-FLIPKART INTERNET PR IVATE LIMITED-SLICK ORGANICS PVT LTD-120 200074GN00190,shopping,,net_banking_transfer,1190.13
61b6fd75d8beac1599eb1d23,50200023535069,112519.23,60ec41ba55c00300382672d9,HDFC,direct expenses,5eecc6d6449e4f7cfb1c2708,2020-12-02T00:00:00.000Z,POS 514834XXXXXX4081 ONLINE PAYMENT,,,debit_card,-4718.82
61b6fd76d8beac1599eb1d29,50200023535069,125070.17,60ec41ba55c00300382672d9,HDFC,Revenue-PG-split enabled,5eecc6d6449e4f7cfb1c2708,2020-12-02T00:00:00.000Z,NEFT CR-UTIB0001506-RAZORPAY SOFTWARE PR IVATE LIMITED-SLICK ORGANICS PVT LITD-AX ISCN0062598473,investments,,net_banking_transfer,12550.94
61b6fd77d8beac1599eb1d2c,50200023535069,137363.16,60ec41ba55c00300382672d9,HDFC,Revenue-PG-non-split,5eecc6d6449e4f7cfb1c2708,2020-12-03T00:00:00.000Z,UPI-PAYTM-PAYOUTS@PAYTM-PYTM0123456-0338 97898866-ALL202012032168200,ewallet,,upi,12292.99
61b6fd78d8beac1599eb1d31,50200023535069,-761.84,60ec41ba55c00300382672d9,HDFC,direct expenses,5eecc6d6449e4f7cfb1c2708,2020-12-03T00:00:00.000Z,"NEFT DR-ORBC0100201-MASCOT SPIN CONTROL INDIA PRIVATE LIMITE-NETBANK, MUM-N33820 1327275782-138125",,,net_banking_transfer,-138125
61b6fd79d8beac1599eb1d39,50200023535069,499238.16,60ec41ba55c00300382672d9,HDFC,Internal Transfers,5eecc6d6449e4f7cfb1c2708,2020-12-03T00:00:00.000Z,IB FUNDS TRANSFER CR-50200035187206 -SL ICK ORGANICS PVT LTD,investments,,Other,500000
61b6fd7ad8beac1599eb1d3b,50200023535069,299238.16,60ec41ba55c00300382672d9,HDFC,direct expenses,5eecc6d6449e4f7cfb1c2708,2020-12-03T00:00:00.000Z,02711600008220-TPT-200000-VARUN SINGH,,,net_banking_transfer,-200000
61b6fd7bd8beac1599eb1d43,50200023535069,-761.84,60ec41ba55c00300382672d9,HDFC,direct expenses,5eecc6d6449e4f7cfb1c2708,2020-12-03T00:00:00.000Z,NEFT DR-ICIC0003430-HASHTAG ORANGE ADVER,,,net_banking_transfer,-300000
61b6fd7cd8beac1599eb1d48,50200023535069,13855.97,60ec41ba55c00300382672d9,HDFC,Revenue-PG-split enabled,5eecc6d6449e4f7cfb1c2708,2020-12-03T00:00:00.000Z,NEFT CR-UTIB0001506-RAZORPAY SOFTWARE PR IVATE LIMITED-SLICK ORGANICS PVT LITD-AX ISCN0062632927,investments,,net_banking_transfer,14617.81
61b6fd7dd8beac1599eb1d4d,50200023535069,12169.97,60ec41ba55c00300382672d9,HDFC,direct expenses,5eecc6d6449e4f7cfb1c2708,2020-12-03T00:00:00.000Z,POS 514834XXXXXX9486 PAYU-HTTPS://STO,,,debit_card,-1686
61b6fd7ed8beac1599eb1d53,50200023535069,12905.17,60ec41ba55c00300382672d9,HDFC,Revenue-Mktplace,5eecc6d6449e4f7cfb1c2708,2020-12-03T00:00:00.000Z,NEFT CR-ICIC0000105-MANASH LIFETYLE PVT LTD-SLICK ORGANICS PRIVATE LIMITED MP MUM-ICIB203380052149,,,net_banking_transfer,735.2
61b6fd7fd8beac1599eb1d5a,50200023535069,25962.22,60ec41ba55c00300382672d9,HDFC,Revenue-PG-split enabled,5eecc6d6449e4f7cfb1c2708,2020-12-03T00:00:00.000Z,NEFT CR-UTIB0001506-RAZORPAY SOFTWARE PR IVATE LIMITED-SLICK ORGANICS PVT LITD-AX ISCN0062685609,investments,,net_banking_transfer,13057.05
61b6fd80d8beac1599eb1d60,50200023535069,33650.39,60ec41ba55c00300382672d9,HDFC,Revenue-PG-non-split,5eecc6d6449e4f7cfb1c2708,2020-12-04T00:00:00.000Z,UPI-PAYTM-PAYOUTS@PAYTM-PYTM0123456-0339 17394843-ALL202012042168200,ewallet,,upi,7688.17
61b6fd81d8beac1599eb1d62,50200023535069,40103.02,60ec41ba55c00300382672d9,HDFC,Revenue-Mktplace,5eecc6d6449e4f7cfb1c2708,2020-12-04T00:00:00.000Z,NEFT CR-DEUT0797BGL-FLIPKART INTERNET PR IVATE LIMITED-SLICK ORGANICS PVT LTD-120 400083GN00286,shopping,,net_banking_transfer,6452.63
61b6fd82d8beac1599eb1d66,50200023535069,-59896.98,60ec41ba55c00300382672d9,HDFC,direct expenses,5eecc6d6449e4f7cfb1c2708,2020-12-04T00:00:00.000Z,"NEFT DR-ICIC0003430-HASHTAG ORANGE ADVER TISING PVT LTD-NETBANK, MUM-N33920132861 5865-100000",,,net_banking_transfer,-100000
61b6fd83d8beac1599eb1d6c,50200023535069,-53798.38,60ec41ba55c00300382672d9,HDFC,Revenue-Mktplace,5eecc6d6449e4f7cfb1c2708,2020-12-04T00:00:00.000Z,NEFT CR-DEUT0797BGL-FLIPKART INTERNET PR IVATE LIMITED-SLICK ORGANICS PVT LTD-120 400115GN00202,shopping,,net_banking_transfer,6098.6
61b6fd84d8beac1599eb1d70,50200023535069,-39713.29,60ec41ba55c00300382672d9,HDFC,Revenue-PG-split enabled,5eecc6d6449e4f7cfb1c2708,2020-12-04T00:00:00.000Z,NEFT CR-UTIB0001506-RAZORPAY SOFTWARE PR IVATE LIMITED-SLICK ORGANICS PVT LITD-AX ISCN0062732550,investments,,net_banking_transfer,14085.09
61b6fd85d8beac1599eb1d76,50200023535069,-39331.82,60ec41ba55c00300382672d9,HDFC,Revenue-Mktplace,5eecc6d6449e4f7cfb1c2708,2020-12-04T00:00:00.000Z,NEFT CR-DEUT0797BGL-MYNTRA DESIGNS PRIVA TE LIMITED-SLICK ORGANICS PRIVATE LIMITE D-120400378GN00263,shopping,,net_banking_transfer,381.47
61b6fd86d8beac1599eb1d7e,50200023535069,-38342.53,60ec41ba55c00300382672d9,HDFC,Transfer in/Revenue-other,5eecc6d6449e4f7cfb1c2708,2020-12-04T00:00:00.000Z,ZOOBOP ME WORK-ARATA,,,Other,989.29
61b6fd87d8beac1599eb1d84,50200023535069,-47585.14,60ec41ba55c00300382672d9,HDFC,direct expenses,5eecc6d6449e4f7cfb1c2708,2020-12-04T00:00:00.000Z,POS 514834XXXXXX9486 STK*SHUTTERSTOCK,,,debit_card,-9242.61
61b6fd88d8beac1599eb1d87,50200023535069,-45773.46,60ec41ba55c00300382672d9,HDFC,Revenue-Mktplace,5eecc6d6449e4f7cfb1c2708,2020-12-04T00:00:00.000Z,NEFT CR-DEUT0784BBY-TATA UNISTORE LTD-NO,,,net_banking_transfer,1811.68
61b6fd89d8beac1599eb1d8e,50200023535069,-35474.16,60ec41ba55c00300382672d9,HDFC,Revenue-PG-split enabled,5eecc6d6449e4f7cfb1c2708,2020-12-04T00:00:00.000Z,NEFT CR-UTIB0001506-RAZORPAY SOFTWARE PR IVATE LIMITED-SLICK ORGANICS PVT LITD-AX ISCN0062792500,investments,,net_banking_transfer,10299.3
61b6fd8ad8beac1599eb1d96,50200023535069,-34458.16,60ec41ba55c00300382672d9,HDFC,Revenue-Mktplace,5eecc6d6449e4f7cfb1c2708,2020-12-04T00:00:00.000Z,NEFT CR-SCBL0036001-DREAMPLUG TECHNOLOGI ES PRIVATE LIMI-SLICK ORGANICS PRIVATE L IMITEDSLICK-SIN31436Q0008943,,,net_banking_transfer,1016
61b6fd8bd8beac1599eb1d9c,50200023535069,-33617.65,60ec41ba55c00300382672d9,HDFC,Transfer in/Revenue-other,5eecc6d6449e4f7cfb1c2708,2020-12-05T00:00:00.000Z,INT. ON SWCR ON-50300247022509,,,Other,840.51
61b6fd8cd8beac1599eb1d9e,50200023535069,841.35,60ec41ba55c00300382672d9,HDFC,Loan-in,5eecc6d6449e4f7cfb1c2708,2020-12-05T00:00:00.000Z,SWEEP-IN CREDIT - 50300247022509,,,self_transfer,34459
61b6fd8dd8beac1599eb1da3,50200023535069,8954.11,60ec41ba55c00300382672d9,HDFC,Revenue-PG-non-split,5eecc6d6449e4f7cfb1c2708,2020-12-05T00:00:00.000Z,UPI-PAYTM-PAYOUTS@PAYTM-PYTM0123456-0340 37168442-ALL202012052168200,ewallet,,upi,8112.76
61b6fd8ed8beac1599eb1daa,50200023535069,19737.12,60ec41ba55c00300382672d9,HDFC,Revenue-PG-split enabled,5eecc6d6449e4f7cfb1c2708,2020-12-05T00:00:00.000Z,NEFT CR-UTIB0001506-RAZORPAY SOFTWARE PR IVATE LIMITED-SLICK ORGANICS PVT LITD-AX ISCN0062810074,investments,,net_banking_transfer,10783.01
61b6fd8fd8beac1599eb1dac,50200023535069,317831.12,60ec41ba55c00300382672d9,HDFC,Internal Transfers,5eecc6d6449e4f7cfb1c2708,2020-12-05T00:00:00.000Z,IB FUNDS TRANSFER CR-50200035187206 -SL ICK ORGANICS PVT LTD,investments,,Other,298094
61b6fd90d8beac1599eb1db5,50200023535069,62831.12,60ec41ba55c00300382672d9,HDFC,SAAS/tech expense,5eecc6d6449e4f7cfb1c2708,2020-12-05T00:00:00.000Z,POS 514834XXXXXX9486 AMAZON,shopping,,debit_card,-255000
61b6fd91d8beac1599eb1db9,50200023535069,70488.88,60ec41ba55c00300382672d9,HDFC,Revenue-PG-split enabled,5eecc6d6449e4f7cfb1c2708,2020-12-05T00:00:00.000Z,NEFT CR-UTIB0001506-RAZORPAY SOFTWARE PR IVATE LIMITED-SLICK ORGANICS PVT LITD-AX ISCN0062852057,investments,,net_banking_transfer,7657.76
61b6fd92d8beac1599eb1dbf,50200023535069,20488.88,60ec41ba55c00300382672d9,HDFC,Marketing Expense,5eecc6d6449e4f7cfb1c2708,2020-12-05T00:00:00.000Z,POS 514834XXXXXX9486 GOOGLE ADWORDS,,,debit_card,-50000
61b6fd93d8beac1599eb1dc6,50200023535069,25577.78,60ec41ba55c00300382672d9,HDFC,Revenue-PG-non-split,5eecc6d6449e4f7cfb1c2708,2020-12-06T00:00:00.000Z,UPI-PAYTM-PAYOUTS@PAYTM-PYTM0123456-0341 57008244-ALL202012062168200,ewallet,,upi,5088.9
61b6fd94d8beac1599eb1dcb,50200023535069,36084.08,60ec41ba55c00300382672d9,HDFC,Revenue-PG-non-split,5eecc6d6449e4f7cfb1c2708,2020-12-07T00:00:00.000Z,UPI-PAYTM-PAYOUTS@PAYTM-PYTM0123456-0342 75709625-ALL202012072168200,ewallet,,upi,10506.3
61b6fd95d8beac1599eb1dd2,50200023535069,1036084.08,60ec41ba55c00300382672d9,HDFC,Internal Transfers,5eecc6d6449e4f7cfb1c2708,2020-12-07T00:00:00.000Z,IB FUNDS TRANSFER CR-50200035187206 -SL ICK ORGANICS PVT LTD,investments,,Other,1000000
61b6fd95d8beac1599eb1dd4,50200023535069,962084.08,60ec41ba55c00300382672d9,HDFC,direct expenses,5eecc6d6449e4f7cfb1c2708,2020-12-07T00:00:00.000Z,"NEFT DR-CITI0000002-DHIRAJ-NETBANK, MUM- N342201331472742-74000",,,net_banking_transfer,-74000
61b6fd96d8beac1599eb1dd8,50200023535069,892084.08,60ec41ba55c00300382672d9,HDFC,direct expenses,5eecc6d6449e4f7cfb1c2708,2020-12-07T00:00:00.000Z,"NEFT DR-ICIC0000542-AVANTIKA SUKHIA-NETB ANK, MUM-N342201331478054-70000",,,net_banking_transfer,-70000
61b6fd97d8beac1599eb1de2,50200023535069,877084.08,60ec41ba55c00300382672d9,HDFC,direct expenses,5eecc6d6449e4f7cfb1c2708,2020-12-07T00:00:00.000Z,NEFT DR-SIBL0000555-JAIVEER KUMAR-NETBAN,,,net_banking_transfer,-15000
61b6fd98d8beac1599eb1de4,50200023535069,867084.08,60ec41ba55c00300382672d9,HDFC,direct expenses,5eecc6d6449e4f7cfb1c2708,2020-12-07T00:00:00.000Z,"NEFT DR-PUNB0398000-MEENA SINGH-NETBANK, MUM-N342201331482704-10000",,,net_banking_transfer,-10000
61b6fd99d8beac1599eb1dee,50200023535069,832084.08,60ec41ba55c00300382672d9,HDFC,direct expenses,5eecc6d6449e4f7cfb1c2708,2020-12-07T00:00:00.000Z,"NEFT DR-ICIC0003374-SIDDHARTH KANOJIA-NE TBANK, MUM-N342201331478746-35000",,,net_banking_transfer,-35000
61b6fd9ad8beac1599eb1df3,50200023535069,826084.08,60ec41ba55c00300382672d9,HDFC,direct expenses,5eecc6d6449e4f7cfb1c2708,2020-12-07T00:00:00.000Z,"NEFT DR-ALLA0210591-CHAMPA DEVI-NETBANK, MUM-N342201331478878-6000",,,net_banking_transfer,-6000
61b6fd9bd8beac1599eb1df8,50200023535069,784384.08,60ec41ba55c00300382672d9,HDFC,direct expenses,5eecc6d6449e4f7cfb1c2708,2020-12-07T00:00:00.000Z,"NEFT DR-UTIB0000120-ADNAN ALI-NETBANK, M UM-N342201331486681-41700",,,net_banking_transfer,-41700
61b6fd9cd8beac1599eb1e06,50200023535069,691884.08,60ec41ba55c00300382672d9,HDFC,direct expenses,5eecc6d6449e4f7cfb1c2708,2020-12-07T00:00:00.000Z,"NEFT DR-BKDN0450123-ARTISTO DESIGNZ-NETB ANK, MUM-N342201331474110-92500",,,net_banking_transfer,-92500
61b6fd9dd8beac1599eb1e0f,50200023535069,609044.08,60ec41ba55c00300382672d9,HDFC,direct expenses,5eecc6d6449e4f7cfb1c2708,2020-12-07T00:00:00.000Z,50100301160692-TPT-82840-TARUN GARG,,,net_banking_transfer,-82840
61b6fd9ed8beac1599eb1e15,50200023535069,577044.08,60ec41ba55c00300382672d9,HDFC,direct expenses,5eecc6d6449e4f7cfb1c2708,2020-12-07T00:00:00.000Z,00901610080520-TPT-32000-POOJA KAPIL SHR OTRIYA,,,net_banking_transfer,-32000
61b6fd9fd8beac1599eb1e18,50200023535069,477044.08,60ec41ba55c00300382672d9,HDFC,direct expenses,5eecc6d6449e4f7cfb1c2708,2020-12-07T00:00:00.000Z,02771610131904-TPT-100000-DIGANT BHATT,,,net_banking_transfer,-100000
61b6fda0d8beac1599eb1e1c,50200023535069,411044.08,60ec41ba55c00300382672d9,HDFC,direct expenses,5eecc6d6449e4f7cfb1c2708,2020-12-07T00:00:00.000Z,50100330586095-TPT-66000-DIWAKAR UNIYAL,,,net_banking_transfer,-66000
61b6fda1d8beac1599eb1e23,50200023535069,381044.08,60ec41ba55c00300382672d9,HDFC,direct expenses,5eecc6d6449e4f7cfb1c2708,2020-12-07T00:00:00.000Z,"NEFT DR-SBIN0007976-SHLAGHA BORAH-NETBAN K, MUM-N342201331491694-30000",,,net_banking_transfer,-30000
61b6fda2d8beac1599eb1e2b,50200023535069,331044.08,60ec41ba55c00300382672d9,HDFC,direct expenses,5eecc6d6449e4f7cfb1c2708,2020-12-07T00:00:00.000Z,IMPS-034209199828-PAYTM-PYTM-XXXXXXXX383 9-50000,ewallet,,net_banking_transfer,-50000
61b6fda3d8beac1599eb1e37,50200023535069,371760.59,60ec41ba55c00300382672d9,HDFC,Revenue-PG-split enabled,5eecc6d6449e4f7cfb1c2708,2020-12-07T00:00:00.000Z,NEFT CR-UTIB0001506-RAZORPAY SOFTWARE PR IVATE LIMITED-SLICK ORGANICS PVT LITD-AX ISCN0062876183,investments,,net_banking_transfer,40716.51
61b6fda4d8beac1599eb1e47,50200023535069,376144.08,60ec41ba55c00300382672d9,HDFC,Revenue-Mktplace,5eecc6d6449e4f7cfb1c2708,2020-12-07T00:00:00.000Z,NEFT CR-DEUT0797BGL-FLIPKART INTERNET PR IVATE LIMITED-SLICK ORGANICS PVT LTD-120 700101GN00017,shopping,,net_banking_transfer,4383.49
61b6fda5d8beac1599eb1e59,50200023535069,378391.37,60ec41ba55c00300382672d9,HDFC,Revenue-Mktplace,5eecc6d6449e4f7cfb1c2708,2020-12-07T00:00:00.000Z,NEFT CR-DEUT0797BGL-MYNTRA DESIGNS PRIVA TE LIMITED-SLICK ORGANICS PRIVATE LIMITE D-120700143GN00258,shopping,,net_banking_transfer,2247.29
61b6fda6d8beac1599eb1e67,50200023535069,379485,60ec41ba55c00300382672d9,HDFC,Revenue-Mktplace,5eecc6d6449e4f7cfb1c2708,2020-12-07T00:00:00.000Z,NEFT CR-DEUT0797BGL-MYNTRA DESIGNS PRIVA,shopping,,net_banking_transfer,1093.63
61b6fda7d8beac1599eb1e71,50200023535069,386285.22,60ec41ba55c00300382672d9,HDFC,Revenue-Mktplace,5eecc6d6449e4f7cfb1c2708,2020-12-07T00:00:00.000Z,NEFT CR-DEUT0797BGL-FLIPKART INTERNET PR IVATE LIMITED-SLICK ORGANICS PVT LTD-120 700151GN00291,shopping,,net_banking_transfer,6800.22
61b6fda8d8beac1599eb1e83,50200023535069,397565.38,60ec41ba55c00300382672d9,HDFC,Revenue-PG-split enabled,5eecc6d6449e4f7cfb1c2708,2020-12-07T00:00:00.000Z,NEFT CR-UTIB0001506-RAZORPAY SOFTWARE PR IVATE LIMITED-SLICK ORGANICS PVT LITD-AX ISCN0062931423,investments,,net_banking_transfer,11280.16
61b6fda9d8beac1599eb1e90,50200023535069,397564.38,60ec41ba55c00300382672d9,HDFC,Marketing Expense,5eecc6d6449e4f7cfb1c2708,2020-12-07T00:00:00.000Z,POS 514834XXXXXX9486 GOOGLE ADWORDS,,,debit_card,-1
61b6fdaad8beac1599eb1e97,50200023535069,387564.38,60ec41ba55c00300382672d9,HDFC,Marketing Expense,5eecc6d6449e4f7cfb1c2708,2020-12-07T00:00:00.000Z,POS 514834XXXXXX9486 GOOGLE ADWORDS,,,debit_card,-10000
61b6fdabd8beac1599eb1e9f,50200023535069,403734.94,60ec41ba55c00300382672d9,HDFC,Revenue-PG-non-split,5eecc6d6449e4f7cfb1c2708,2020-12-08T00:00:00.000Z,IMPS-034305207840-PAYTM-HDFC-XXXXXXXXXX0 007-,ewallet,,net_banking_transfer,16170.56
61b6fdacd8beac1599eb1ea9,50200023535069,416734.16,60ec41ba55c00300382672d9,HDFC,Revenue-PG-split enabled,5eecc6d6449e4f7cfb1c2708,2020-12-08T00:00:00.000Z,NEFT CR-UTIB0001506-RAZORPAY SOFTWARE PR IVATE LIMITED-SLICK ORGANICS PVT LITD-AX ISCN0062968236,investments,,net_banking_transfer,12999.22
61b6fdadd8beac1599eb1eb2,50200023535069,498534.85,60ec41ba55c00300382672d9,HDFC,Revenue-Mktplace,5eecc6d6449e4f7cfb1c2708,2020-12-08T00:00:00.000Z,IMPS-034311240140-AMAZON SELLER SERVIC-H DFC-XXXXXXXX6004-1B6UOHPBXY3U4CO8SLICK O RGANICS PVT LTD,shopping,,net_banking_transfer,81800.69
61b6fdaed8beac1599eb1ec2,50200023535069,794418.18,60ec41ba55c00300382672d9,HDFC,Revenue-Mktplace,5eecc6d6449e4f7cfb1c2708,2020-12-08T00:00:00.000Z,NEFT CR-DEUT0797BGL-AMAZON PAY (INDIA) P RIVATE LIMITED-SLICK ORGANICS PVT LTD-12 0800133GN00202,shopping,,net_banking_transfer,295883.33
61b6fdafd8beac1599eb1ec8,50200023535069,795424.76,60ec41ba55c00300382672d9,HDFC,Transfer in/Revenue-other,5eecc6d6449e4f7cfb1c2708,2020-12-08T00:00:00.000Z,ZOOBOP ME WORK-VENDOR ARATA,,,Other,1006.58
61b6fdb0d8beac1599eb1ecf,50200023535069,815274.16,60ec41ba55c00300382672d9,HDFC,Revenue-PG-split enabled,5eecc6d6449e4f7cfb1c2708,2020-12-08T00:00:00.000Z,NEFT CR-UTIB0001506-RAZORPAY SOFTWARE PR IVATE LIMITED-SLICK ORGANICS PVT LITD-AX ISCN0063019837,investments,,net_banking_transfer,19849.4
61b6fdb1d8beac1599eb1ed9,50200023535069,819494.56,60ec41ba55c00300382672d9,HDFC,Revenue-Mktplace,5eecc6d6449e4f7cfb1c2708,2020-12-08T00:00:00.000Z,NEFT CR-KKBK0000958-SUPERMARKET GROCERY SUPPLIES PVT LTD-SLICK ORGANICS PVT LTD- KKBK203436752712,shopping,,net_banking_transfer,4220.4
61b6fdb2d8beac1599eb1ee1,50200023535069,828161.46,60ec41ba55c00300382672d9,HDFC,Revenue-Mktplace,5eecc6d6449e4f7cfb1c2708,2020-12-08T00:00:00.000Z,NEFT CR-KKBK0000958-SUPERMARKET GROCERY SUPPLIES PVT LTD-SLICK ORGANICS PVT LTD- KKBK203436752921,shopping,,net_banking_transfer,8666.9
61b6fdb3d8beac1599eb1ee9,50200023535069,828940.16,60ec41ba55c00300382672d9,HDFC,Revenue-Mktplace,5eecc6d6449e4f7cfb1c2708,2020-12-08T00:00:00.000Z,NEFT CR-KKBK0000958-SUPERMARKET GROCERY,shopping,,net_banking_transfer,778.7
61b6fdb4d8beac1599eb1eed,50200023535069,829687.68,60ec41ba55c00300382672d9,HDFC,Revenue-Mktplace,5eecc6d6449e4f7cfb1c2708,2020-12-08T00:00:00.000Z,NEFT CR-KKBK0000958-SUPERMARKET GROCERY SUPPLIES PVT LTD-SLICK ORGANICS PVT LTD- KKBK203436754306,shopping,,net_banking_transfer,747.52
61b6fdb5d8beac1599eb1ef4,50200023535069,831271.4,60ec41ba55c00300382672d9,HDFC,Revenue-Mktplace,5eecc6d6449e4f7cfb1c2708,2020-12-08T00:00:00.000Z,NEFT CR-KKBK0000958-SUPERMARKET GROCERY SUPPLIES PVT LTD-SLICK ORGANICS PVT LTD- KKBK203436754505,shopping,,net_banking_transfer,1583.72
61b6fdb6d8beac1599eb1eff,50200023535069,831272.4,60ec41ba55c00300382672d9,HDFC,Transfer in/Revenue-other,5eecc6d6449e4f7cfb1c2708,2020-12-08T00:00:00.000Z,CRV POS 514834******9486 GOOGLE ADWORDS,,,refund,1
61b6fdb7d8beac1599eb1f04,50200023535069,833561.7,60ec41ba55c00300382672d9,HDFC,Revenue-Mktplace,5eecc6d6449e4f7cfb1c2708,2020-12-08T00:00:00.000Z,NEFT CR-KKBK0000958-SUPERMARKET GROCERY SUPPLIES PVT LTD-SLICK ORGANICS PVT LTD- KKBK203436758010,shopping,,net_banking_transfer,2289.3
61b6fdb7d8beac1599eb1f0e,50200023535069,856754.21,60ec41ba55c00300382672d9,HDFC,Revenue-PG-non-split,5eecc6d6449e4f7cfb1c2708,2020-12-09T00:00:00.000Z,UPI-PAYTM-PAYOUTS@PAYTM-PYTM0123456-0344 13358562-ALL202012092168200,ewallet,,upi,23192.51
61b6fdb8d8beac1599eb1f17,50200023535069,840254.21,60ec41ba55c00300382672d9,HDFC,direct expenses,5eecc6d6449e4f7cfb1c2708,2020-12-09T00:00:00.000Z,"NEFT DR-KKBK0000811-NASIR KHAN-NETBANK, MUM-N344201334717050-16500",,,net_banking_transfer,-16500
61b6fdb9d8beac1599eb1f1d,50200023535069,820254.21,60ec41ba55c00300382672d9,HDFC,direct expenses,5eecc6d6449e4f7cfb1c2708,2020-12-09T00:00:00.000Z,"NEFT DR-SBIN0001189-SANDEEP SINGH-NETBAN K, MUM-N344201334693150-20000",,,net_banking_transfer,-20000
61b6fdbad8beac1599eb1f28,50200023535069,720254.21,60ec41ba55c00300382672d9,HDFC,direct expenses,5eecc6d6449e4f7cfb1c2708,2020-12-09T00:00:00.000Z,57500000443889-TPT-100000-WEBKLIPPER TEC HNOLOGIES PRIVATE LIMITED,,,net_banking_transfer,-100000
61b6fdbbd8beac1599eb1f33,50200023535069,692504.21,60ec41ba55c00300382672d9,HDFC,direct expenses,5eecc6d6449e4f7cfb1c2708,2020-12-09T00:00:00.000Z,"NEFT DR-UBIN0531855-MOHANISH KOTHARI-NET BANK, MUM-N344201334717914-27750",,,net_banking_transfer,-27750
61b6fdbcd8beac1599eb1f3a,50200023535069,658634.21,60ec41ba55c00300382672d9,HDFC,Salary/Emp/consultant Expense,5eecc6d6449e4f7cfb1c2708,2020-12-09T00:00:00.000Z,"NEFT DR-UTIB0003142-ARIA DESAI UG ELIZAB ETH THOMAS ALEX-NETBANK, MUM-N3442013346 93521-33870",,,net_banking_transfer,-33870
61b6fdbdd8beac1599eb1f44,50200023535069,658193.21,60ec41ba55c00300382672d9,HDFC,direct expenses,5eecc6d6449e4f7cfb1c2708,2020-12-09T00:00:00.000Z,"NEFT DR-SBIN0070155-ASHITHA THOMAS-NETBA NK, MUM-N344201334718001-441",,,net_banking_transfer,-441
61b6fdbfd8beac1599eb1f49,50200023535069,661308.18,60ec41ba55c00300382672d9,HDFC,Revenue-Mktplace,5eecc6d6449e4f7cfb1c2708,2020-12-09T00:00:00.000Z,NEFT CR-DEUT0797BGL-FLIPKART INTERNET PR IVATE LIMITED-SLICK ORGANICS PVT LTD-120 900090GN00190,shopping,,net_banking_transfer,3114.97
61b6fdc0d8beac1599eb1f56,50200023535069,676617.35,60ec41ba55c00300382672d9,HDFC,Revenue-PG-split enabled,5eecc6d6449e4f7cfb1c2708,2020-12-09T00:00:00.000Z,NEFT CR-UTIB0001506-RAZORPAY SOFTWARE PR IVATE LIMITED-SLICK ORGANICS PVT LITD-AX ISCN0063051409,investments,,net_banking_transfer,15309.17
61b6fdc0d8beac1599eb1f59,50200023535069,676571.46,60ec41ba55c00300382672d9,HDFC,bank charges,5eecc6d6449e4f7cfb1c2708,2020-12-09T00:00:00.000Z,.DC INTL POS TXN MARKUP+ST 281120 011220,,,international_transaction_arbitrage,-45.89
61b6fdc1d8beac1599eb1f61,50200023535069,576571.46,60ec41ba55c00300382672d9,HDFC,SAAS/tech expense,5eecc6d6449e4f7cfb1c2708,2020-12-09T00:00:00.000Z,VHDF9541766991/BILLDKAMAZONSELLERSE,shopping,,Other,-100000
61b6fdc2d8beac1599eb1f68,50200023535069,376571.46,60ec41ba55c00300382672d9,HDFC,direct expenses,5eecc6d6449e4f7cfb1c2708,2020-12-09T00:00:00.000Z,"NEFT DR-YESB0000551-VISTTA COSMETICS-NET BANK, MUM-N344201335006716-200000",,,net_banking_transfer,-200000
61b6fdc3d8beac1599eb1f6c,50200023535069,176571.46,60ec41ba55c00300382672d9,HDFC,direct expenses,5eecc6d6449e4f7cfb1c2708,2020-12-09T00:00:00.000Z,"NEFT DR-ICIC0003430-HASHTAG ORANGE ADVER TISING PVT LTD-NETBANK, MUM-N34420133501 6938-200000",,,net_banking_transfer,-200000
61b6fdc4d8beac1599eb1f73,50200023535069,176715.46,60ec41ba55c00300382672d9,HDFC,Revenue-Mktplace,5eecc6d6449e4f7cfb1c2708,2020-12-09T00:00:00.000Z,NEFT CR-DEUT0797BGL-MYNTRA DESIGNS PRIVA TE LIMITED-SLICK ORGANICS PRIVATE LIMITE D-120900336GN00008,shopping,,net_banking_transfer,144
61b6fdc5d8beac1599eb1f79,50200023535069,164601.36,60ec41ba55c00300382672d9,HDFC,bank charges,5eecc6d6449e4f7cfb1c2708,2020-12-09T00:00:00.000Z,.DC INTL POS TXN MARKUP+ST 011220 021220 -CDT2034302237966,,,international_transaction_arbitrage,-12114.1
61b6fdc6d8beac1599eb1f81,50200023535069,164512.69,60ec41ba55c00300382672d9,HDFC,bank charges,5eecc6d6449e4f7cfb1c2708,2020-12-09T00:00:00.000Z,.DC INTL POS TXN MARKUP+ST 011220 021220 -CDT2034302237966,,,international_transaction_arbitrage,-88.67
61b6fdc7d8beac1599eb1f83,50200023535069,165057.64,60ec41ba55c00300382672d9,HDFC,Revenue-Mktplace,5eecc6d6449e4f7cfb1c2708,2020-12-09T00:00:00.000Z,NEFT CR-DEUT0797BGL-FLIPKART INTERNET PR IVATE LIMITED-SLICK ORGANICS PVT LTD-120 900067GN00260,shopping,,net_banking_transfer,544.95
61b6fdc8d8beac1599eb1f87,50200023535069,274600.64,60ec41ba55c00300382672d9,HDFC,Revenue-COD,5eecc6d6449e4f7cfb1c2708,2020-12-09T00:00:00.000Z,NEFT CR-KKBK0000958-BIGFOOT RETAIL SOLUT IONS PRIVATE LIMITED-SLICK ORGANICS PVT LTD-KKBK203446918253,,,net_banking_transfer,109543
61b6fdc9d8beac1599eb1f8e,50200023535069,280801.62,60ec41ba55c00300382672d9,HDFC,Revenue-PG-split enabled,5eecc6d6449e4f7cfb1c2708,2020-12-09T00:00:00.000Z,NEFT CR-UTIB0001506-RAZORPAY SOFTWARE PR IVATE LIMITED-SLICK ORGANICS PVT LITD-AX ISCN0063100000,investments,,net_banking_transfer,6200.98
61b6fdcad8beac1599eb1f91,50200023535069,293382.32,60ec41ba55c00300382672d9,HDFC,Revenue-PG-non-split,5eecc6d6449e4f7cfb1c2708,2020-12-10T00:00:00.000Z,UPI-PAYTM-PAYOUTS@PAYTM-PYTM0123456-0345 32982282-ALL202012102168200,ewallet,,upi,12580.7
61b6fdcbd8beac1599eb1f99,50200023535069,309382.25,60ec41ba55c00300382672d9,HDFC,Revenue-PG-split enabled,5eecc6d6449e4f7cfb1c2708,2020-12-10T00:00:00.000Z,NEFT CR-UTIB0001506-RAZORPAY SOFTWARE PR IVATE LIMITED-SLICK ORGANICS PVT LITD-AX ISCN0063138650,investments,,net_banking_transfer,15999.93
61b6fdccd8beac1599eb1f9f,50200023535069,309777.34,60ec41ba55c00300382672d9,HDFC,Revenue-Mktplace,5eecc6d6449e4f7cfb1c2708,2020-12-10T00:00:00.000Z,NEFT CR-ICIC0000105-MANASH LIFETYLE PVT LTD-SLICK ORGANICS PRIVATE LIMITED MP MU M-ICIB203450137767,,,net_banking_transfer,395.09
61b6fdcdd8beac1599eb1fa3,50200023535069,318404.99,60ec41ba55c00300382672d9,HDFC,Revenue-PG-split enabled,5eecc6d6449e4f7cfb1c2708,2020-12-10T00:00:00.000Z,NEFT CR-UTIB0001506-RAZORPAY SOFTWARE PR,,,net_banking_transfer,8627.65
61b6fdced8beac1599eb1fa6,50200023535069,331119.75,60ec41ba55c00300382672d9,HDFC,Revenue-PG-non-split,5eecc6d6449e4f7cfb1c2708,2020-12-11T00:00:00.000Z,UPI-PAYTM-PAYOUTS@PAYTM-PYTM0123456-0346 52154199-ALL202012112168200,ewallet,,upi,12714.76
61b6fdcfd8beac1599eb1faf,50200023535069,337116.74,60ec41ba55c00300382672d9,HDFC,Revenue-Mktplace,5eecc6d6449e4f7cfb1c2708,2020-12-11T00:00:00.000Z,NEFT CR-DEUT0797BGL-FLIPKART INTERNET PR IVATE LIMITED-SLICK ORGANICS PVT LTD-121 100115GN00111,shopping,,net_banking_transfer,5996.99
61b6fdd0d8beac1599eb1fb5,50200023535069,353310.22,60ec41ba55c00300382672d9,HDFC,Revenue-PG-split enabled,5eecc6d6449e4f7cfb1c2708,2020-12-11T00:00:00.000Z,NEFT CR-UTIB0001506-RAZORPAY SOFTWARE PR IVATE LIMITED-SLICK ORGANICS PVT LITD-AX ISCN0063261434,investments,,net_banking_transfer,16193.48
61b6fdd1d8beac1599eb1fb9,50200023535069,153310.22,60ec41ba55c00300382672d9,HDFC,Internal Transfers,5eecc6d6449e4f7cfb1c2708,2020-12-11T00:00:00.000Z,IB FUNDS TRANSFER DR-50200035187206 -SL ICK ORGANICS PVT LTD,investments,,net_banking_transfer,-200000
61b6fdd2d8beac1599eb1fbd,50200023535069,153710.65,60ec41ba55c00300382672d9,HDFC,Revenue-Mktplace,5eecc6d6449e4f7cfb1c2708,2020-12-11T00:00:00.000Z,NEFT CR-DEUT0797BGL-MYNTRA DESIGNS PRIVA TE LIMITED-SLICK ORGANICS PRIVATE LIMITE D-121100175GN00198,shopping,,net_banking_transfer,400.43
61b6fdd3d8beac1599eb1fc0,50200023535069,133710.65,60ec41ba55c00300382672d9,HDFC,direct expenses,5eecc6d6449e4f7cfb1c2708,2020-12-11T00:00:00.000Z,"SELF - CHQ PAID - KALKAJI, NEW",,,chq,-20000
61b6fdd4d8beac1599eb1fc9,50200023535069,134294.77,60ec41ba55c00300382672d9,HDFC,Revenue-Mktplace,5eecc6d6449e4f7cfb1c2708,2020-12-11T00:00:00.000Z,NEFT CR-DEUT0784BBY-TATA UNISTORE LTD-NO DAL-SLICK ORGANICS PVT LTD-121100356GN00 271,investments,,net_banking_transfer,584.12
61b6fdd5d8beac1599eb1fd0,50200023535069,84294.77,60ec41ba55c00300382672d9,HDFC,Marketing Expense,5eecc6d6449e4f7cfb1c2708,2020-12-11T00:00:00.000Z,POS 514834XXXXXX9486 GOOGLE ADWORDS,,,debit_card,-50000
61b6fdd6d8beac1599eb2007,50200023535069,92351.33,60ec41ba55c00300382672d9,HDFC,Revenue-Mktplace,5eecc6d6449e4f7cfb1c2708,2020-12-11T00:00:00.000Z,NEFT CR-DEUT0797BGL-FLIPKART INTERNET PR IVATE LIMITED-SLICK ORGANICS PVT LTD-121 100081GN00059,shopping,,net_banking_transfer,8056.56
61b6fdd7d8beac1599eb200d,50200023535069,92829.17,60ec41ba55c00300382672d9,HDFC,Transfer in/Revenue-other,5eecc6d6449e4f7cfb1c2708,2020-12-11T00:00:00.000Z,4060002274-11 12 2020-HDFAZCUR1,,,Other,477.84
61b6fdd8d8beac1599eb2011,50200023535069,123838.07,60ec41ba55c00300382672d9,HDFC,Revenue-COD,5eecc6d6449e4f7cfb1c2708,2020-12-11T00:00:00.000Z,NEFT CR-KKBK0000958-BIGFOOT RETAIL SOLUT IONS PRIVATE LIMITED-SLICK ORGANICS PVT LTD-KKBK203467394859,,,net_banking_transfer,31008.9
61b6fdd9d8beac1599eb2018,50200023535069,139299.64,60ec41ba55c00300382672d9,HDFC,Revenue-PG-split enabled,5eecc6d6449e4f7cfb1c2708,2020-12-11T00:00:00.000Z,NEFT CR-UTIB0001506-RAZORPAY SOFTWARE PR IVATE LIMITED-SLICK ORGANICS PVT LITD-AX ISCN0063320608,investments,,net_banking_transfer,15461.57
61b6fddad8beac1599eb201d,50200023535069,162309.64,60ec41ba55c00300382672d9,HDFC,Transfer in/Revenue-other,5eecc6d6449e4f7cfb1c2708,2020-12-11T00:00:00.000Z,FT - CR - 00322000016711 - FORWEST ESTAT,,,Other,23010
61b6fddbd8beac1599eb2023,50200023535069,171159.64,60ec41ba55c00300382672d9,HDFC,Transfer in/Revenue-other,5eecc6d6449e4f7cfb1c2708,2020-12-11T00:00:00.000Z,FT - CR - 50200004711897 - MADHUKAR MULT I SPEC HOSP AND RES CENTRE,,,Other,8850
61b6fddcd8beac1599eb2025,50200023535069,171637.75,60ec41ba55c00300382672d9,HDFC,Revenue-PG-split enabled,5eecc6d6449e4f7cfb1c2708,2020-12-11T00:00:00.000Z,NEFT CR-YESB0000001-RAZORPAY SOFTWARE P L NODAL ACCOUNT-SLICKORGANICS-N346200477 411763,investments,,net_banking_transfer,478.11
61b6fdddd8beac1599eb2029,50200023535069,172097.61,60ec41ba55c00300382672d9,HDFC,Revenue-PG-non-split,5eecc6d6449e4f7cfb1c2708,2020-12-11T00:00:00.000Z,NEFT CR-ICIC0000031-PAYTM E COMMERCE PVT LTD-SLICK ORGANICS PVT LTD-CMS172328352 4,investments,,net_banking_transfer,459.86
61b6fdded8beac1599eb2031,50200023535069,192438.21,60ec41ba55c00300382672d9,HDFC,Revenue-PG-non-split,5eecc6d6449e4f7cfb1c2708,2020-12-12T00:00:00.000Z,UPI-PAYTM-PAYOUTS@PAYTM-PYTM0123456-0347 71305473-ALL202012122168200,ewallet,,upi,20340.6
61b6fddfd8beac1599eb2033,50200023535069,188820.69,60ec41ba55c00300382672d9,HDFC,direct expenses,5eecc6d6449e4f7cfb1c2708,2020-12-12T00:00:00.000Z,POS 514834XXXXXX9486 WWW.FAQPRIME.COM,,,debit_card,-3617.52
61b6fde0d8beac1599eb203c,50200023535069,213523.4,60ec41ba55c00300382672d9,HDFC,Revenue-PG-non-split,5eecc6d6449e4f7cfb1c2708,2020-12-13T00:00:00.000Z,UPI-PAYTM-PAYOUTS@PAYTM-PYTM0123456-0348 90549139-ALL202012132168200,ewallet,,upi,24702.71
61b6fde1d8beac1599eb2040,50200023535069,1213523.4,60ec41ba55c00300382672d9,HDFC,Internal Transfers,5eecc6d6449e4f7cfb1c2708,2020-12-13T00:00:00.000Z,IB FUNDS TRANSFER CR-50200035187206 -SL ICK ORGANICS PVT LTD,investments,,Other,1000000
61b6fde2d8beac1599eb2046,50200023535069,813523.4,60ec41ba55c00300382672d9,HDFC,direct expenses,5eecc6d6449e4f7cfb1c2708,2020-12-13T00:00:00.000Z,02711600008220-TPT-400000-VARUN SINGH,,,net_banking_transfer,-400000
61b6fde3d8beac1599eb204b,50200023535069,613523.4,60ec41ba55c00300382672d9,HDFC,direct expenses,5eecc6d6449e4f7cfb1c2708,2020-12-13T00:00:00.000Z,IMPS-034812174101-PAYTM-PYTM-XXXXXXXX383 9-200000,ewallet,,net_banking_transfer,-200000
61b6fde3d8beac1599eb2052,50200023535069,413523.4,60ec41ba55c00300382672d9,HDFC,direct expenses,5eecc6d6449e4f7cfb1c2708,2020-12-13T00:00:00.000Z,IMPS-034812171898-PAYTM-PYTM-XXXXXXXX383 9-200000,ewallet,,net_banking_transfer,-200000
61b6fde4d8beac1599eb2061,50200023535069,363523.4,60ec41ba55c00300382672d9,HDFC,SAAS/tech expense,5eecc6d6449e4f7cfb1c2708,2020-12-13T00:00:00.000Z,VHDF9554440598/BILLDKAMAZONSELLERSE,shopping,,Other,-50000
61b6fde5d8beac1599eb2065,50200023535069,313523.4,60ec41ba55c00300382672d9,HDFC,SAAS/tech expense,5eecc6d6449e4f7cfb1c2708,2020-12-13T00:00:00.000Z,VHDF9554941158/BILLDKAMAZONSELLERSE,shopping,,Other,-50000
61b6fde6d8beac1599eb2069,50200023535069,331728.03,60ec41ba55c00300382672d9,HDFC,Revenue-PG-non-split,5eecc6d6449e4f7cfb1c2708,2020-12-14T00:00:00.000Z,UPI-PAYTM-PAYOUTS@PAYTM-PYTM0123456-0349 08952097-ALL202012142168200,ewallet,,upi,18204.63
61b6fde7d8beac1599eb2071,50200023535069,334635.5,60ec41ba55c00300382672d9,HDFC,Revenue-Mktplace,5eecc6d6449e4f7cfb1c2708,2020-12-14T00:00:00.000Z,NEFT CR-DEUT0797BGL-FLIPKART INTERNET PR IVATE LIMITED-SLICK ORGANICS PVT LTD-121 400095GN00119,shopping,,net_banking_transfer,2907.47
61b6fde8d8beac1599eb2073,50200023535069,428040,60ec41ba55c00300382672d9,HDFC,Revenue-PG-split enabled,5eecc6d6449e4f7cfb1c2708,2020-12-14T00:00:00.000Z,NEFT CR-UTIB0001506-RAZORPAY SOFTWARE PR IVATE LIMITED-SLICK ORGANICS PVT LITD-AX ISCN0063370030,investments,,net_banking_transfer,93404.5
61b6fde9d8beac1599eb207b,50200023535069,328040,60ec41ba55c00300382672d9,HDFC,direct expenses,5eecc6d6449e4f7cfb1c2708,2020-12-14T00:00:00.000Z,NEFT DR-ICIC0003430-HASHTAG ORANGE ADVER,,,net_banking_transfer,-100000
61b6fdead8beac1599eb2086,50200023535069,300415,60ec41ba55c00300382672d9,HDFC,direct expenses,5eecc6d6449e4f7cfb1c2708,2020-12-14T00:00:00.000Z,"NEFT DR-SYNB0005170-SNEHAL TAYDE-NETBANK , MUM-N349201339570162-27625",,,net_banking_transfer,-27625
61b6fdebd8beac1599eb208c,50200023535069,305889.68,60ec41ba55c00300382672d9,HDFC,Revenue-Mktplace,5eecc6d6449e4f7cfb1c2708,2020-12-14T00:00:00.000Z,4060002249-TIMES INTERNET LIMITED NODAL,,,Other,5474.68
61b6fdecd8beac1599eb2092,50200023535069,311364.36,60ec41ba55c00300382672d9,HDFC,Revenue-Mktplace,5eecc6d6449e4f7cfb1c2708,2020-12-14T00:00:00.000Z,4060002326-TIMES INTERNET LIMITED NODAL,,,Other,5474.68
61b6fdedd8beac1599eb2099,50200023535069,312565.65,60ec41ba55c00300382672d9,HDFC,Revenue-Mktplace,5eecc6d6449e4f7cfb1c2708,2020-12-14T00:00:00.000Z,NEFT CR-DEUT0797BGL-MYNTRA DESIGNS PRIVA TE LIMITED-SLICK ORGANICS PRIVATE LIMITE D-121400165GN00255,shopping,,net_banking_transfer,1201.29
61b6fdeed8beac1599eb209f,50200023535069,312183.94,60ec41ba55c00300382672d9,HDFC,bank charges,5eecc6d6449e4f7cfb1c2708,2020-12-14T00:00:00.000Z,.DC INTL POS TXN MARKUP+ST 041220 051220 -CDT2034302237966,,,international_transaction_arbitrage,-381.71
61b6fdefd8beac1599eb20a3,50200023535069,313250.49,60ec41ba55c00300382672d9,HDFC,Revenue-Mktplace,5eecc6d6449e4f7cfb1c2708,2020-12-14T00:00:00.000Z,NEFT CR-DEUT0797BGL-MYNTRA DESIGNS PRIVA TE LIMITED-SLICK ORGANICS PRIVATE LIMITE D-121400207GN00271,shopping,,net_banking_transfer,1066.55
61b6fdf0d8beac1599eb20aa,50200023535069,314502.84,60ec41ba55c00300382672d9,HDFC,Revenue-Mktplace,5eecc6d6449e4f7cfb1c2708,2020-12-14T00:00:00.000Z,NEFT CR-DEUT0797BGL-FLIPKART INTERNET PR IVATE LIMITED-SLICK ORGANICS PVT LTD-121 400128GN00283,shopping,,net_banking_transfer,1252.35
61b6fdf1d8beac1599eb20af,50200023535069,315358.99,60ec41ba55c00300382672d9,HDFC,Revenue-Mktplace,5eecc6d6449e4f7cfb1c2708,2020-12-14T00:00:00.000Z,NEFT CR-ICIC0000105-MANASH LIFETYLE PVT LTD-SLICK ORGANICS PRIVATE LIMITED MP MUM-ICIB203490058948,,,net_banking_transfer,856.15
61b6fdf2d8beac1599eb20b5,50200023535069,335918.76,60ec41ba55c00300382672d9,HDFC,Revenue-PG-split enabled,5eecc6d6449e4f7cfb1c2708,2020-12-14T00:00:00.000Z,NEFT CR-UTIB0001506-RAZORPAY SOFTWARE PR IVATE LIMITED-SLICK ORGANICS PVT LITD-AX ISCN0063458911,investments,,net_banking_transfer,20559.77
61b6fdf3d8beac1599eb20ba,50200023535069,361604.69,60ec41ba55c00300382672d9,HDFC,Revenue-COD,5eecc6d6449e4f7cfb1c2708,2020-12-14T00:00:00.000Z,NEFT CR-KKBK0000958-BIGFOOT RETAIL SOLUT IONS PRIVATE LIMITED-SLICK ORGANICS PVT LTD-KKBK203497768266,,,net_banking_transfer,25685.93
61b6fdf4d8beac1599eb20c0,50200023535069,311604.69,60ec41ba55c00300382672d9,HDFC,SAAS/tech expense,5eecc6d6449e4f7cfb1c2708,2020-12-14T00:00:00.000Z,VHDF9558263118/BILLDKAMAZONSELLERSE,shopping,,Other,-50000
61b6fdf5d8beac1599eb20c6,50200023535069,323732.61,60ec41ba55c00300382672d9,HDFC,Revenue-PG-non-split,5eecc6d6449e4f7cfb1c2708,2020-12-15T00:00:00.000Z,UPI-PAYTM-PAYOUTS@PAYTM-PYTM0123456-0350 27867068-ALL202012152168200,ewallet,,upi,12127.92
61b6fdf6d8beac1599eb20c9,50200023535069,338407.13,60ec41ba55c00300382672d9,HDFC,Revenue-PG-split enabled,5eecc6d6449e4f7cfb1c2708,2020-12-15T00:00:00.000Z,NEFT CR-UTIB0001506-RAZORPAY SOFTWARE PR IVATE LIMITED-SLICK ORGANICS PVT LITD-AX ISCN0063494908,investments,,net_banking_transfer,14674.52
61b6fdf7d8beac1599eb20d0,50200023535069,288407.13,60ec41ba55c00300382672d9,HDFC,SAAS/tech expense,5eecc6d6449e4f7cfb1c2708,2020-12-15T00:00:00.000Z,POS 514834XXXXXX9486 AMAZON,shopping,,debit_card,-50000
61b6fdf8d8beac1599eb20d6,50200023535069,288967.01,60ec41ba55c00300382672d9,HDFC,Transfer in/Revenue-other,5eecc6d6449e4f7cfb1c2708,2020-12-15T00:00:00.000Z,NEFT CR-YESB0000001-ILLUMINAR MEDIA-SLIC K ORGANICS PVT LTD-N350200478589912,,,net_banking_transfer,559.88
61b6fdf9d8beac1599eb20dd,50200023535069,289427.59,60ec41ba55c00300382672d9,HDFC,Transfer in/Revenue-other,5eecc6d6449e4f7cfb1c2708,2020-12-15T00:00:00.000Z,NEFT CR-YESB0000001-ILUMINAR MEDIA-SLICK ORGANICS PVT. LTD-N350200478590362,,,net_banking_transfer,460.58
61b6fdfad8beac1599eb20e4,50200023535069,385550.92,60ec41ba55c00300382672d9,HDFC,Revenue-Mktplace,5eecc6d6449e4f7cfb1c2708,2020-12-15T00:00:00.000Z,IMPS-035011306017-AMAZON SELLER SERVIC-H DFC-XXXXXXXX6004-UXZ5LS0ZPY2NOFCGSLICK O RGANICS PVT LTD,shopping,,net_banking_transfer,96123.33
61b6fdfbd8beac1599eb20e8,50200023535069,285550.92,60ec41ba55c00300382672d9,HDFC,SAAS/tech expense,5eecc6d6449e4f7cfb1c2708,2020-12-15T00:00:00.000Z,VHDF9560435419/BILLDKAMAZONSELLERSE,shopping,,Other,-100000
61b6fdfcd8beac1599eb20f0,50200023535069,627995.28,60ec41ba55c00300382672d9,HDFC,Revenue-Mktplace,5eecc6d6449e4f7cfb1c2708,2020-12-15T00:00:00.000Z,NEFT CR-DEUT0797BGL-AMAZON PAY (INDIA) P RIVATE LIMITED-SLICK ORGANICS PVT LTD-12 1500119GN00560,shopping,,net_banking_transfer,342444.36
61b6fdfdd8beac1599eb20f3,50200023535069,1127995.28,60ec41ba55c00300382672d9,HDFC,Internal Transfers,5eecc6d6449e4f7cfb1c2708,2020-12-15T00:00:00.000Z,IB FUNDS TRANSFER CR-50200035187206 -SL ICK ORGANICS PVT LTD,investments,,Other,500000
61b6fdfed8beac1599eb20fd,50200023535069,1129577.84,60ec41ba55c00300382672d9,HDFC,Revenue-Mktplace,5eecc6d6449e4f7cfb1c2708,2020-12-15T00:00:00.000Z,NEFT CR-ICIC0000105-MANASH LIFETYLE PVT LTD-SLICK ORGANICS PRIVATE LIMITED MP MUM-ICIB203500041728,,,net_banking_transfer,1582.56
61b6fdffd8beac1599eb2103,50200023535069,1130253.67,60ec41ba55c00300382672d9,HDFC,Revenue-Mktplace,5eecc6d6449e4f7cfb1c2708,2020-12-15T00:00:00.000Z,NEFT CR-ICIC0000105-MANASH LIFETYLE PVT LTD-SLICK ORGANICS PRIVATE LIMITED MP GGN-ICIB203500041727,,,net_banking_transfer,675.83
61b6fe00d8beac1599eb2108,50200023535069,280253.67,60ec41ba55c00300382672d9,HDFC,direct expenses,5eecc6d6449e4f7cfb1c2708,2020-12-15T00:00:00.000Z,"NEFT DR-ICIC0003430-HASHTAG ORANGE ADVER TISING PVT LTD-NETBANK, MUM-N35020134217 9789-850000",,,net_banking_transfer,-850000
61b6fe01d8beac1599eb210d,50200023535069,292006.18,60ec41ba55c00300382672d9,HDFC,Revenue-PG-split enabled,5eecc6d6449e4f7cfb1c2708,2020-12-15T00:00:00.000Z,NEFT CR-UTIB0001506-RAZORPAY SOFTWARE PR IVATE LIMITED-SLICK ORGANICS PVT LITD-AX ISCN0063602249,investments,,net_banking_transfer,11752.51
61b6fe02d8beac1599eb2116,50200023535069,310236.08,60ec41ba55c00300382672d9,HDFC,Revenue-PG-non-split,5eecc6d6449e4f7cfb1c2708,2020-12-16T00:00:00.000Z,IMPS-035105953224-PAYTM-HDFC-XXXXXXXXXX0 007-,ewallet,,net_banking_transfer,18229.9
61b6fe03d8beac1599eb211e,50200023535069,312072.66,60ec41ba55c00300382672d9,HDFC,Revenue-Mktplace,5eecc6d6449e4f7cfb1c2708,2020-12-16T00:00:00.000Z,NEFT CR-DEUT0797BGL-FLIPKART INTERNET PR IVATE LIMITED-SLICK ORGANICS PVT LTD-121 600104GN00160,shopping,,net_banking_transfer,1836.58
61b6fe04d8beac1599eb2120,50200023535069,177072.66,60ec41ba55c00300382672d9,HDFC,direct expenses,5eecc6d6449e4f7cfb1c2708,2020-12-16T00:00:00.000Z,NEFT DR-YESB0000551-VISTTA COSMETICS-NET,,,net_banking_transfer,-135000
61b6fe04d8beac1599eb2124,50200023535069,189977.74,60ec41ba55c00300382672d9,HDFC,Revenue-PG-split enabled,5eecc6d6449e4f7cfb1c2708,2020-12-16T00:00:00.000Z,NEFT CR-UTIB0001506-RAZORPAY SOFTWARE PR IVATE LIMITED-SLICK ORGANICS PVT LITD-AX ISCN0063631739,investments,,net_banking_transfer,12905.08
61b6fe05d8beac1599eb212d,50200023535069,239977.74,60ec41ba55c00300382672d9,HDFC,Transfer in/Revenue-other,5eecc6d6449e4f7cfb1c2708,2020-12-16T00:00:00.000Z,REF-BILLDKAMAZO-VHDF9558263118-14/12/20,,,refund,50000
61b6fe06d8beac1599eb212f,50200023535069,246400.89,60ec41ba55c00300382672d9,HDFC,Revenue-Mktplace,5eecc6d6449e4f7cfb1c2708,2020-12-16T00:00:00.000Z,NEFT CR-DEUT0797BGL-FLIPKART INTERNET PR IVATE LIMITED-SLICK ORGANICS PVT LTD-121 600061GN00084,shopping,,net_banking_transfer,6423.15
61b6fe07d8beac1599eb2137,50200023535069,247212.29,60ec41ba55c00300382672d9,HDFC,Revenue-Mktplace,5eecc6d6449e4f7cfb1c2708,2020-12-16T00:00:00.000Z,NEFT CR-DEUT0797BGL-MYNTRA DESIGNS PRIVA TE LIMITED-SLICK ORGANICS PRIVATE LIMITE D-121600329GN00003,shopping,,net_banking_transfer,811.4
61b6fe08d8beac1599eb213b,50200023535069,265715.77,60ec41ba55c00300382672d9,HDFC,Revenue-PG-split enabled,5eecc6d6449e4f7cfb1c2708,2020-12-16T00:00:00.000Z,NEFT CR-UTIB0001506-RAZORPAY SOFTWARE PR IVATE LIMITED-SLICK ORGANICS PVT LITD-AX ISCN0063694158,investments,,net_banking_transfer,18503.48
61b6fe09d8beac1599eb2141,50200023535069,266731.77,60ec41ba55c00300382672d9,HDFC,Revenue-Mktplace,5eecc6d6449e4f7cfb1c2708,2020-12-16T00:00:00.000Z,NEFT CR-SCBL0036001-DREAMPLUG TECHNOLOGI ES PRIVATE LIMI-SLICK ORGANICS PRIVATE L IMITEDSLICK-SIN31436Q0009302,,,net_banking_transfer,1016
61b6fe0ad8beac1599eb2146,50200023535069,267142.54,60ec41ba55c00300382672d9,HDFC,Revenue-PG-non-split,5eecc6d6449e4f7cfb1c2708,2020-12-16T00:00:00.000Z,NEFT CR-ICIC0000031-PAYTM E COMMERCE PVT LTD-SLICK ORGANICS PVT LTD-CMS172912717 7,investments,,net_banking_transfer,410.77
61b6fe0bd8beac1599eb214c,50200023535069,266406.79,60ec41ba55c00300382672d9,HDFC,direct expenses,5eecc6d6449e4f7cfb1c2708,2020-12-16T00:00:00.000Z,POS 514834XXXXXX9486 MANYCHAT COM PRO,,,debit_card,-735.75
61b6fe0cd8beac1599eb2155,50200023535069,288993.92,60ec41ba55c00300382672d9,HDFC,Revenue-PG-non-split,5eecc6d6449e4f7cfb1c2708,2020-12-17T00:00:00.000Z,IMPS-035206437682-PAYTM-HDFC-XXXXXXXXXX0 007-,ewallet,,net_banking_transfer,22587.13
61b6fe0dd8beac1599eb2158,50200023535069,188993.92,60ec41ba55c00300382672d9,HDFC,SAAS/tech expense,5eecc6d6449e4f7cfb1c2708,2020-12-17T00:00:00.000Z,VHDF9566342676/BILLDKAMAZONSELLERSE,shopping,,Other,-100000
61b6fe0ed8beac1599eb215c,50200023535069,215969.94,60ec41ba55c00300382672d9,HDFC,Revenue-PG-split enabled,5eecc6d6449e4f7cfb1c2708,2020-12-17T00:00:00.000Z,NEFT CR-UTIB0001506-RAZORPAY SOFTWARE PR IVATE LIMITED-SLICK ORGANICS PVT LITD-AX ISCN0063739859,investments,,net_banking_transfer,26976.02
61b6fe0fd8beac1599eb2163,50200023535069,165969.94,60ec41ba55c00300382672d9,HDFC,Marketing Expense,5eecc6d6449e4f7cfb1c2708,2020-12-17T00:00:00.000Z,POS 514834XXXXXX9486 GOOGLE ADWORDS,,,debit_card,-50000
61b6fe10d8beac1599eb2168,50200023535069,160070.94,60ec41ba55c00300382672d9,HDFC,direct expenses,5eecc6d6449e4f7cfb1c2708,2020-12-17T00:00:00.000Z,POS 514834XXXXXX9486 LBB,,,debit_card,-5899
61b6fe11d8beac1599eb2170,50200023535069,159921.55,60ec41ba55c00300382672d9,HDFC,bank charges,5eecc6d6449e4f7cfb1c2708,2020-12-17T00:00:00.000Z,.DC INTL POS TXN MARKUP+ST 121220 151220 -CDT2034302237966,,,international_transaction_arbitrage,-149.39
61b6fe12d8beac1599eb2176,50200023535069,179918.75,60ec41ba55c00300382672d9,HDFC,Revenue-PG-split enabled,5eecc6d6449e4f7cfb1c2708,2020-12-17T00:00:00.000Z,NEFT CR-UTIB0001506-RAZORPAY SOFTWARE PR,,,net_banking_transfer,19997.2
61b6fe13d8beac1599eb217b,50200023535069,179919.75,60ec41ba55c00300382672d9,HDFC,Transfer in/Revenue-other,5eecc6d6449e4f7cfb1c2708,2020-12-17T00:00:00.000Z,CRV POS 514834******9486 GOOGLE ADWORDS,,,refund,1
61b6fe14d8beac1599eb217f,50200023535069,211690.79,60ec41ba55c00300382672d9,HDFC,Revenue-PG-non-split,5eecc6d6449e4f7cfb1c2708,2020-12-18T00:00:00.000Z,UPI-PAYTM-PAYOUTS@PAYTM-PYTM0123456-0353 85776013-ALL202012182168200,ewallet,,upi,31771.04
61b6fe15d8beac1599eb2185,50200023535069,11690.79,60ec41ba55c00300382672d9,HDFC,direct expenses,5eecc6d6449e4f7cfb1c2708,2020-12-18T00:00:00.000Z,02711600008220-TPT-200000-VARUN SINGH,,,net_banking_transfer,-200000
61b6fe16d8beac1599eb218a,50200023535069,16999.62,60ec41ba55c00300382672d9,HDFC,Revenue-Mktplace,5eecc6d6449e4f7cfb1c2708,2020-12-18T00:00:00.000Z,NEFT CR-DEUT0797BGL-FLIPKART INTERNET PR IVATE LIMITED-SLICK ORGANICS PVT LTD-121 800112GN00008,shopping,,net_banking_transfer,5308.83
61b6fe17d8beac1599eb2191,50200023535069,42267.77,60ec41ba55c00300382672d9,HDFC,Revenue-PG-split enabled,5eecc6d6449e4f7cfb1c2708,2020-12-18T00:00:00.000Z,NEFT CR-UTIB0001506-RAZORPAY SOFTWARE PR IVATE LIMITED-SLICK ORGANICS PVT LITD-AX ISCN0063852648,investments,,net_banking_transfer,25268.15
61b6fe18d8beac1599eb2193,50200023535069,43342.29,60ec41ba55c00300382672d9,HDFC,Revenue-Mktplace,5eecc6d6449e4f7cfb1c2708,2020-12-18T00:00:00.000Z,NEFT CR-DEUT0797BGL-MYNTRA DESIGNS PRIVA TE LIMITED-SLICK ORGANICS PRIVATE LIMITE D-121800187GN00263,shopping,,net_banking_transfer,1074.52
61b6fe19d8beac1599eb2197,50200023535069,44311.38,60ec41ba55c00300382672d9,HDFC,Transfer in/Revenue-other,5eecc6d6449e4f7cfb1c2708,2020-12-18T00:00:00.000Z,NEFT CR-ICIC0SF0002-ICICI BANK NODAL ACC -SLICK ORGANICS-23263996901DC,investments,,net_banking_transfer,969.09
61b6fe1ad8beac1599eb219f,50200023535069,50666.71,60ec41ba55c00300382672d9,HDFC,Revenue-Mktplace,5eecc6d6449e4f7cfb1c2708,2020-12-18T00:00:00.000Z,NEFT CR-DEUT0797BGL-FLIPKART INTERNET PR IVATE LIMITED-SLICK ORGANICS PVT LTD-121 800081GN00246,shopping,,net_banking_transfer,6355.33
61b6fe1bd8beac1599eb21a1,50200023535069,50858.99,60ec41ba55c00300382672d9,HDFC,Revenue-Mktplace,5eecc6d6449e4f7cfb1c2708,2020-12-18T00:00:00.000Z,NEFT CR-DEUT0797BGL-MYNTRA DESIGNS PRIVA TE LIMITED-SLICK ORGANICS PRIVATE LIMITE D-121800228GN00242,shopping,,net_banking_transfer,192.28
61b6fe1cd8beac1599eb21b3,50200023535069,153424.82,60ec41ba55c00300382672d9,HDFC,Revenue-PG-split enabled,5eecc6d6449e4f7cfb1c2708,2020-12-18T00:00:00.000Z,NEFT CR-UTIB0001506-RAZORPAY SOFTWARE PR IVATE LIMITED-SLICK ORGANICS PVT LITD-AX ISCN0063928106,investments,,net_banking_transfer,102565.83
61b6fe1dd8beac1599eb21c2,50200023535069,154282.22,60ec41ba55c00300382672d9,HDFC,Revenue-Mktplace,5eecc6d6449e4f7cfb1c2708,2020-12-18T00:00:00.000Z,NEFT CR-DEUT0784BBY-TATA UNISTORE LTD-NO DAL-SLICK ORGANICS PVT LTD-121801325GN00 287,investments,,net_banking_transfer,857.4
61b6fe1ed8beac1599eb21d5,50200023535069,315310.54,60ec41ba55c00300382672d9,HDFC,Transfer in/Revenue-other,5eecc6d6449e4f7cfb1c2708,2020-12-19T00:00:00.000Z,IMPS-035405675237-NA-HDFC-XXXXXXXXXX0007 -ALL20201219216820000330830668628,,,net_banking_transfer,161028.32
61b6fe1fd8beac1599eb21e1,50200023535069,417871.88,60ec41ba55c00300382672d9,HDFC,Revenue-PG-split enabled,5eecc6d6449e4f7cfb1c2708,2020-12-19T00:00:00.000Z,NEFT CR-UTIB0001506-RAZORPAY SOFTWARE PR,,,net_banking_transfer,102561.34
61b6fe20d8beac1599eb21eb,50200023535069,317871.88,60ec41ba55c00300382672d9,HDFC,SAAS/tech expense,5eecc6d6449e4f7cfb1c2708,2020-12-19T00:00:00.000Z,VHDF9573616692/BILLDKAMAZONSELLERSE,shopping,,Other,-100000
61b6fe21d8beac1599eb21f9,50200023535069,319669.72,60ec41ba55c00300382672d9,HDFC,Transfer in/Revenue-other,5eecc6d6449e4f7cfb1c2708,2020-12-19T00:00:00.000Z,ZOOBOP ME WORK-ARATA,,,Other,1797.84
61b6fe22d8beac1599eb21ff,50200023535069,330986.91,60ec41ba55c00300382672d9,HDFC,Revenue-PG-split enabled,5eecc6d6449e4f7cfb1c2708,2020-12-19T00:00:00.000Z,NEFT CR-UTIB0001506-RAZORPAY SOFTWARE PR IVATE LIMITED-SLICK ORGANICS PVT LITD-AX ISCN0064043015,investments,,net_banking_transfer,11317.19
61b6fe23d8beac1599eb2205,50200023535069,343903.61,60ec41ba55c00300382672d9,HDFC,Revenue-PG-non-split,5eecc6d6449e4f7cfb1c2708,2020-12-20T00:00:00.000Z,UPI-PAYTM-PAYOUTS@PAYTM-PYTM0123456-0355 26654064-ALL202012202168200,ewallet,,upi,12916.7
61b6fe24d8beac1599eb2216,50200023535069,338753.29,60ec41ba55c00300382672d9,HDFC,direct expenses,5eecc6d6449e4f7cfb1c2708,2020-12-20T00:00:00.000Z,POS 514834XXXXXX9486 FEEDBACKFIVE,,,debit_card,-5150.32
61b6fe25d8beac1599eb2219,50200023535069,226404.29,60ec41ba55c00300382672d9,HDFC,direct expenses,5eecc6d6449e4f7cfb1c2708,2020-12-20T00:00:00.000Z,"NEFT DR-ORBC0101001-KRAUTER HEALTHCARE L TD-NETBANK, MUM-N355201346786190-112349",,,net_banking_transfer,-112349
61b6fe25d8beac1599eb2223,50200023535069,219854.16,60ec41ba55c00300382672d9,HDFC,direct expenses,5eecc6d6449e4f7cfb1c2708,2020-12-20T00:00:00.000Z,POS 514834XXXXXX9486 HOTJAR,,,debit_card,-6550.13
61b6fe26d8beac1599eb222a,50200023535069,250887.01,60ec41ba55c00300382672d9,HDFC,Revenue-PG-non-split,5eecc6d6449e4f7cfb1c2708,2020-12-21T00:00:00.000Z,UPI-PAYTM-PAYOUTS@PAYTM-PYTM0123456-0356 45658134-ALL202012212168200,ewallet,,upi,31032.85
61b6fe27d8beac1599eb2234,50200023535069,251081.01,60ec41ba55c00300382672d9,HDFC,Revenue-Mktplace,5eecc6d6449e4f7cfb1c2708,2020-12-21T00:00:00.000Z,NEFT CR-KKBK0000958-SURFBOATS SOLUTIONS PVT LTD-SLICK ORGANICS PRIVATE LIMITED-K KBK203568841164,investments,,net_banking_transfer,194
61b6fe28d8beac1599eb223a,50200023535069,252564.35,60ec41ba55c00300382672d9,HDFC,Revenue-Mktplace,5eecc6d6449e4f7cfb1c2708,2020-12-21T00:00:00.000Z,NEFT CR-DEUT0797BGL-FLIPKART INTERNET PR IVATE LIMITED-SLICK ORGANICS PVT LTD-122 100091GN00109,shopping,,net_banking_transfer,1483.34
61b6fe29d8beac1599eb2241,50200023535069,286594.43,60ec41ba55c00300382672d9,HDFC,Revenue-PG-split enabled,5eecc6d6449e4f7cfb1c2708,2020-12-21T00:00:00.000Z,NEFT CR-UTIB0001506-RAZORPAY SOFTWARE PR IVATE LIMITED-SLICK ORGANICS PVT LITD-AX ISCN0064075102,investments,,net_banking_transfer,34030.08
61b6fe2bd8beac1599eb224c,50200023535069,286564.04,60ec41ba55c00300382672d9,HDFC,bank charges,5eecc6d6449e4f7cfb1c2708,2020-12-21T00:00:00.000Z,.DC INTL POS TXN MARKUP+ST 161220 181220 -CDT2034302237966,,,international_transaction_arbitrage,-30.39
61b6fe2cd8beac1599eb2250,50200023535069,287882.96,60ec41ba55c00300382672d9,HDFC,Revenue-Mktplace,5eecc6d6449e4f7cfb1c2708,2020-12-21T00:00:00.000Z,NEFT CR-DEUT0797BGL-MYNTRA DESIGNS PRIVA TE LIMITED-SLICK ORGANICS PRIVATE LIMITE D-122100201GN00288,shopping,,net_banking_transfer,1318.92
61b6fe2dd8beac1599eb2260,50200023535069,289448.18,60ec41ba55c00300382672d9,HDFC,Revenue-Mktplace,5eecc6d6449e4f7cfb1c2708,2020-12-21T00:00:00.000Z,NEFT CR-DEUT0797BGL-FLIPKART INTERNET PR IVATE LIMITED-SLICK ORGANICS PVT LTD-122 100140GN00277,shopping,,net_banking_transfer,1565.22
61b6fe2ed8beac1599eb226d,50200023535069,289926.29,60ec41ba55c00300382672d9,HDFC,Transfer in/Revenue-other,5eecc6d6449e4f7cfb1c2708,2020-12-21T00:00:00.000Z,NEFT CR-YESB0000001-ILUMINAR MEDIA-SLICK,,,net_banking_transfer,478.11
61b6fe2fd8beac1599eb2271,50200023535069,296378.63,60ec41ba55c00300382672d9,HDFC,Revenue-PG-split enabled,5eecc6d6449e4f7cfb1c2708,2020-12-21T00:00:00.000Z,NEFT CR-UTIB0001506-RAZORPAY SOFTWARE PR IVATE LIMITED-SLICK ORGANICS PVT LITD-AX ISCN0064137183,investments,,net_banking_transfer,6452.34
61b6fe30d8beac1599eb227d,50200023535069,196378.63,60ec41ba55c00300382672d9,HDFC,direct expenses,5eecc6d6449e4f7cfb1c2708,2020-12-22T00:00:00.000Z,"NEFT DR-PYTM0123456-PAYTM-NETBANK, MUM-N 357201348280993-100000",ewallet,,net_banking_transfer,-100000
61b6fe31d8beac1599eb2282,50200023535069,218902.14,60ec41ba55c00300382672d9,HDFC,Revenue-PG-split enabled,5eecc6d6449e4f7cfb1c2708,2020-12-22T00:00:00.000Z,NEFT CR-UTIB0001506-RAZORPAY SOFTWARE PR IVATE LIMITED-SLICK ORGANICS PVT LITD-AX ISCN0064169594,investments,,net_banking_transfer,22523.51
61b6fe32d8beac1599eb228d,50200023535069,118902.14,60ec41ba55c00300382672d9,HDFC,SAAS/tech expense,5eecc6d6449e4f7cfb1c2708,2020-12-22T00:00:00.000Z,VHDF9582893535/BILLDKAMAZONSELLERSE,shopping,,Other,-100000
61b6fe33d8beac1599eb2294,50200023535069,196302.59,60ec41ba55c00300382672d9,HDFC,Revenue-Mktplace,5eecc6d6449e4f7cfb1c2708,2020-12-22T00:00:00.000Z,IMPS-035711347045-AMAZON SELLER SERVIC-H DFC-XXXXXXXX6004-2EW400QQ1EWA8PCHSLICK O RGANICS PVT LTD,shopping,,net_banking_transfer,77400.45
61b6fe34d8beac1599eb22a3,50200023535069,550874.87,60ec41ba55c00300382672d9,HDFC,Revenue-Mktplace,5eecc6d6449e4f7cfb1c2708,2020-12-22T00:00:00.000Z,NEFT CR-DEUT0797BGL-AMAZON PAY (INDIA) P RIVATE LIMITED-SLICK ORGANICS PVT LTD-12 2200125GN00558,shopping,,net_banking_transfer,354572.28
61b6fe35d8beac1599eb22af,50200023535069,548198.87,60ec41ba55c00300382672d9,HDFC,SAAS/tech expense,5eecc6d6449e4f7cfb1c2708,2020-12-22T00:00:00.000Z,POS 514834XXXXXX9486 AMAZON,shopping,,debit_card,-2676
61b6fe36d8beac1599eb22b3,50200023535069,556593.04,60ec41ba55c00300382672d9,HDFC,Revenue-PG-split enabled,5eecc6d6449e4f7cfb1c2708,2020-12-22T00:00:00.000Z,NEFT CR-UTIB0001506-RAZORPAY SOFTWARE PR IVATE LIMITED-SLICK ORGANICS PVT LITD-AX ISCN0064274496,investments,,net_banking_transfer,8394.17
61b6fe37d8beac1599eb22b8,50200023535069,580245.82,60ec41ba55c00300382672d9,HDFC,Revenue-PG-non-split,5eecc6d6449e4f7cfb1c2708,2020-12-22T00:00:00.000Z,NEFT CR-CITI0000002-ONE97 COMMUNICATIONS LIMITED-SLICK ORGANICS PVT LTD-CITIN201 85032973,investments,,net_banking_transfer,23652.78
61b6fe38d8beac1599eb22c2,50200023535069,581142.29,60ec41ba55c00300382672d9,HDFC,Revenue-Mktplace,5eecc6d6449e4f7cfb1c2708,2020-12-22T00:00:00.000Z,NEFT CR-ICIC0000105-MANASH LIFETYLE PVT LTD-SLICKORGANICSPRIVATELIMITEDMPMUM-ICI B203570105838,,,net_banking_transfer,896.47
61b6fe39d8beac1599eb22c4,50200023535069,600813.9,60ec41ba55c00300382672d9,HDFC,Revenue-PG-non-split,5eecc6d6449e4f7cfb1c2708,2020-12-23T00:00:00.000Z,UPI-PAYTM-PAYOUTS@PAYTM-PYTM0123456-0358 84259348-ALL202012232168200,ewallet,,upi,19671.61
61b6fe3ad8beac1599eb22d1,50200023535069,623259.13,60ec41ba55c00300382672d9,HDFC,Revenue-PG-split enabled,5eecc6d6449e4f7cfb1c2708,2020-12-23T00:00:00.000Z,NEFT CR-UTIB0001506-RAZORPAY SOFTWARE PR IVATE LIMITED-SLICK ORGANICS PVT LITD-AX ISCN0064315315,investments,,net_banking_transfer,22445.23
61b6fe3bd8beac1599eb22d6,50200023535069,629567.98,60ec41ba55c00300382672d9,HDFC,Revenue-Mktplace,5eecc6d6449e4f7cfb1c2708,2020-12-23T00:00:00.000Z,NEFT CR-DEUT0797BGL-FLIPKART INTERNET PR,shopping,,net_banking_transfer,6308.85
61b6fe3cd8beac1599eb22dc,50200023535069,630059.21,60ec41ba55c00300382672d9,HDFC,Revenue-Mktplace,5eecc6d6449e4f7cfb1c2708,2020-12-23T00:00:00.000Z,NEFT CR-DEUT0797BGL-MYNTRA DESIGNS PRIVA TE LIMITED-SLICK ORGANICS PRIVATE LIMITE D-122300181GN00234,shopping,,net_banking_transfer,491.23
61b6fe3dd8beac1599eb22e1,50200023535069,580059.21,60ec41ba55c00300382672d9,HDFC,Marketing Expense,5eecc6d6449e4f7cfb1c2708,2020-12-23T00:00:00.000Z,POS 514834XXXXXX9486 GOOGLE ADWORDS,,,debit_card,-50000
61b6fe3dd8beac1599eb22e6,50200023535069,580682.63,60ec41ba55c00300382672d9,HDFC,Revenue-Mktplace,5eecc6d6449e4f7cfb1c2708,2020-12-23T00:00:00.000Z,NEFT CR-DEUT0797BGL-MYNTRA DESIGNS PRIVA TE LIMITED-SLICK ORGANICS PRIVATE LIMITE D-122300243GN00019,shopping,,net_banking_transfer,623.42
61b6fe3ed8beac1599eb22ef,50200023535069,585697.74,60ec41ba55c00300382672d9,HDFC,Revenue-PG-split enabled,5eecc6d6449e4f7cfb1c2708,2020-12-23T00:00:00.000Z,NEFT CR-UTIB0001506-RAZORPAY SOFTWARE PR IVATE LIMITED-SLICK ORGANICS PVT LITD-AX ISCN0064386702,investments,,net_banking_transfer,5015.11
61b6fe3fd8beac1599eb22f3,50200023535069,602028.88,60ec41ba55c00300382672d9,HDFC,Revenue-PG-non-split,5eecc6d6449e4f7cfb1c2708,2020-12-24T00:00:00.000Z,UPI-PAYTM-PAYOUTS@PAYTM-PYTM0123456-0359 03626135-ALL202012242168200,ewallet,,upi,16331.14
61b6fe40d8beac1599eb22f7,50200023535069,613199.85,60ec41ba55c00300382672d9,HDFC,Revenue-PG-split enabled,5eecc6d6449e4f7cfb1c2708,2020-12-24T00:00:00.000Z,NEFT CR-UTIB0001506-RAZORPAY SOFTWARE PR IVATE LIMITED-SLICK ORGANICS PVT LITD-AX ISCN0064451829,investments,,net_banking_transfer,11170.97
61b6fe41d8beac1599eb22ff,50200023535069,613511.76,60ec41ba55c00300382672d9,HDFC,Revenue-Mktplace,5eecc6d6449e4f7cfb1c2708,2020-12-24T00:00:00.000Z,NEFT CR-DEUT0797BGL-MYNTRA DESIGNS PRIVA TE LIMITED-SLICK ORGANICS PRIVATE LIMITE D-122400518GN00155,shopping,,net_banking_transfer,311.91
61b6fe42d8beac1599eb2302,50200023535069,593511.76,60ec41ba55c00300382672d9,HDFC,direct expenses,5eecc6d6449e4f7cfb1c2708,2020-12-24T00:00:00.000Z,"SARVAN KUMAR - CHQ PAID - GKII, NEW DE",,,chq,-20000
61b6fe43d8beac1599eb230a,50200023535069,593299.06,60ec41ba55c00300382672d9,HDFC,bank charges,5eecc6d6449e4f7cfb1c2708,2020-12-24T00:00:00.000Z,.DC INTL POS TXN MARKUP+ST 191220 221220 -CDT2034302237966,,,international_transaction_arbitrage,-212.7
61b6fe44d8beac1599eb230e,50200023535069,593028.55,60ec41ba55c00300382672d9,HDFC,bank charges,5eecc6d6449e4f7cfb1c2708,2020-12-24T00:00:00.000Z,.DC INTL POS TXN MARKUP+ST 201220 221220 -CDT2034302237966,,,international_transaction_arbitrage,-270.51
61b6fe45d8beac1599eb2313,50200023535069,493028.55,60ec41ba55c00300382672d9,HDFC,SAAS/tech expense,5eecc6d6449e4f7cfb1c2708,2020-12-24T00:00:00.000Z,VHDF9589876933/BILLDKAMAZONSELLERSE,shopping,,Other,-100000
61b6fe46d8beac1599eb2317,50200023535069,495770.37,60ec41ba55c00300382672d9,HDFC,Revenue-PG-split enabled,5eecc6d6449e4f7cfb1c2708,2020-12-24T00:00:00.000Z,NEFT CR-YESB0000001-RAZORPAY SOFTWARE P L NODAL ACCOUNT-SLICKORGANICS-N359200482 311011,investments,,net_banking_transfer,2741.82
61b6fe47d8beac1599eb231d,50200023535069,496205.78,60ec41ba55c00300382672d9,HDFC,Revenue-Mktplace,5eecc6d6449e4f7cfb1c2708,2020-12-24T00:00:00.000Z,NEFT CR-ICIC0000105-MANASH LIFETYLE PVT,,,net_banking_transfer,435.41
61b6fe48d8beac1599eb2324,50200023535069,498448.32,60ec41ba55c00300382672d9,HDFC,Revenue-Mktplace,5eecc6d6449e4f7cfb1c2708,2020-12-24T00:00:00.000Z,NEFT CR-KKBK0000958-SUPERMARKET GROCERY SUPPLIES PVT LTD-SLICK ORGANICS PVT LTD- KKBK203599631564,shopping,,net_banking_transfer,2242.54
61b6fe49d8beac1599eb2328,50200023535069,502995.67,60ec41ba55c00300382672d9,HDFC,Revenue-Mktplace,5eecc6d6449e4f7cfb1c2708,2020-12-24T00:00:00.000Z,NEFT CR-KKBK0000958-SUPERMARKET GROCERY SUPPLIES PVT LTD-SLICK ORGANICS PVT LTD- KKBK203599631639,shopping,,net_banking_transfer,4547.35
61b6fe4ad8beac1599eb232b,50200023535069,504896.15,60ec41ba55c00300382672d9,HDFC,Revenue-Mktplace,5eecc6d6449e4f7cfb1c2708,2020-12-24T00:00:00.000Z,NEFT CR-KKBK0000958-SUPERMARKET GROCERY SUPPLIES PVT LTD-SLICK ORGANICS PVT LTD- KKBK203599631611,shopping,,net_banking_transfer,1900.48
61b6fe4bd8beac1599eb232e,50200023535069,511380.14,60ec41ba55c00300382672d9,HDFC,Revenue-Mktplace,5eecc6d6449e4f7cfb1c2708,2020-12-24T00:00:00.000Z,NEFT CR-KKBK0000958-SUPERMARKET GROCERY SUPPLIES PVT LTD-SLICK ORGANICS PVT LTD- KKBK203599631654,shopping,,net_banking_transfer,6483.99
61b6fe4cd8beac1599eb2338,50200023535069,512127.64,60ec41ba55c00300382672d9,HDFC,Revenue-Mktplace,5eecc6d6449e4f7cfb1c2708,2020-12-24T00:00:00.000Z,NEFT CR-KKBK0000958-SUPERMARKET GROCERY SUPPLIES PVT LTD-SLICK ORGANICS PVT LTD- KKBK203599631773,shopping,,net_banking_transfer,747.5
61b6fe4dd8beac1599eb233e,50200023535069,616612.18,60ec41ba55c00300382672d9,HDFC,Revenue-PG-split enabled,5eecc6d6449e4f7cfb1c2708,2020-12-24T00:00:00.000Z,NEFT CR-UTIB0001506-RAZORPAY SOFTWARE PR IVATE LIMITED-SLICK ORGANICS PVT LITD-AX ISCN0064524799,investments,,net_banking_transfer,104484.54
61b6fe4ed8beac1599eb2346,50200023535069,713466.08,60ec41ba55c00300382672d9,HDFC,Transfer in/Revenue-other,5eecc6d6449e4f7cfb1c2708,2020-12-25T00:00:00.000Z,IMPS-036006903199-NA-HDFC-XXXXXXXXXX0007 -ALL20201225216820000330830668628,,,net_banking_transfer,96853.9
61b6fe4fd8beac1599eb234b,50200023535069,613466.08,60ec41ba55c00300382672d9,HDFC,direct expenses,5eecc6d6449e4f7cfb1c2708,2020-12-25T00:00:00.000Z,57500000443889-TPT-ABC-WEBKLIPPER TECHNO LOGIES PRIVATE LIMITED,,,net_banking_transfer,-100000
61b6fe50d8beac1599eb2350,50200023535069,643037.45,60ec41ba55c00300382672d9,HDFC,Revenue-PG-non-split,5eecc6d6449e4f7cfb1c2708,2020-12-26T00:00:00.000Z,UPI-PAYTM-PAYOUTS@PAYTM-PYTM0123456-0361 42524384-ALL202012262168200,ewallet,,upi,29571.37
61b6fe51d8beac1599eb2354,50200023535069,543037.45,60ec41ba55c00300382672d9,HDFC,Internal Transfers,5eecc6d6449e4f7cfb1c2708,2020-12-26T00:00:00.000Z,IB FUNDS TRANSFER DR-50200035187206 -SL ICK ORGANICS PVT LTD,investments,,net_banking_transfer,-100000
61b6fe52d8beac1599eb2359,50200023535069,539398.85,60ec41ba55c00300382672d9,HDFC,direct expenses,5eecc6d6449e4f7cfb1c2708,2020-12-26T00:00:00.000Z,POS 514834XXXXXX9486 FRESHWORKS INC,,,debit_card,-3638.6
61b6fe53d8beac1599eb2360,50200023535069,489398.85,60ec41ba55c00300382672d9,HDFC,SAAS/tech expense,5eecc6d6449e4f7cfb1c2708,2020-12-26T00:00:00.000Z,VHDF9596246752/BILLDKAMAZONSELLERSE,shopping,,Other,-50000
61b6fe54d8beac1599eb2363,50200023535069,505295.16,60ec41ba55c00300382672d9,HDFC,Revenue-PG-non-split,5eecc6d6449e4f7cfb1c2708,2020-12-27T00:00:00.000Z,UPI-PAYTM-PAYOUTS@PAYTM-PYTM0123456-0362 61288840-ALL202012272168200,ewallet,,upi,15896.31
61b6fe55d8beac1599eb2367,50200023535069,455295.16,60ec41ba55c00300382672d9,HDFC,Marketing Expense,5eecc6d6449e4f7cfb1c2708,2020-12-27T00:00:00.000Z,POS 514834XXXXXX9486 GOOGLE ADWORDS,,,debit_card,-50000
61b6fe56d8beac1599eb2370,50200023535069,463103.95,60ec41ba55c00300382672d9,HDFC,Revenue-PG-non-split,5eecc6d6449e4f7cfb1c2708,2020-12-28T00:00:00.000Z,UPI-PAYTM-PAYOUTS@PAYTM-PYTM0123456-0363,ewallet,,upi,7808.79
61b6fe57d8beac1599eb2372,50200023535069,594407.14,60ec41ba55c00300382672d9,HDFC,Revenue-PG-split enabled,5eecc6d6449e4f7cfb1c2708,2020-12-28T00:00:00.000Z,NEFT CR-UTIB0001506-RAZORPAY SOFTWARE PR IVATE LIMITED-SLICK ORGANICS PVT LITD-AX ISCN0064598319,investments,,net_banking_transfer,131303.19
61b6fe57d8beac1599eb237a,50200023535069,596094.46,60ec41ba55c00300382672d9,HDFC,Revenue-Mktplace,5eecc6d6449e4f7cfb1c2708,2020-12-28T00:00:00.000Z,NEFT CR-DEUT0797BGL-FLIPKART INTERNET PR IVATE LIMITED-SLICK ORGANICS PVT LTD-122 800098GN00099,shopping,,net_banking_transfer,1687.32
61b6fe58d8beac1599eb237f,50200023535069,517902.46,60ec41ba55c00300382672d9,HDFC,direct expenses,5eecc6d6449e4f7cfb1c2708,2020-12-28T00:00:00.000Z,00921000075586-TPT-78192-ROET BINDRA,,,net_banking_transfer,-78192
61b6fe59d8beac1599eb2384,50200023535069,467902.46,60ec41ba55c00300382672d9,HDFC,SAAS/tech expense,5eecc6d6449e4f7cfb1c2708,2020-12-28T00:00:00.000Z,POS 514834XXXXXX9486 AMAZON,shopping,,debit_card,-50000
61b6fe5ad8beac1599eb2388,50200023535069,477406.97,60ec41ba55c00300382672d9,HDFC,Revenue-PG-split enabled,5eecc6d6449e4f7cfb1c2708,2020-12-28T00:00:00.000Z,NEFT CR-UTIB0001506-RAZORPAY SOFTWARE PR IVATE LIMITED-SLICK ORGANICS PVT LITD-AX ISCN0064736833,investments,,net_banking_transfer,9504.51
61b6fe5bd8beac1599eb238e,50200023535069,478432.47,60ec41ba55c00300382672d9,HDFC,Revenue-Mktplace,5eecc6d6449e4f7cfb1c2708,2020-12-28T00:00:00.000Z,NEFT CR-ICIC0000105-MANASH LIFETYLE PVT LTD-SLICKORGANICSPRIVATELIMITEDMPMUM-ICI B203630041363,,,net_banking_transfer,1025.5
61b6fe5cd8beac1599eb2395,50200023535069,487945.55,60ec41ba55c00300382672d9,HDFC,Revenue-COD,5eecc6d6449e4f7cfb1c2708,2020-12-28T00:00:00.000Z,NEFT CR-KKBK0000958-BIGFOOT RETAIL SOLUT IONS PRIVATE LIMITED-SLICK ORGANICS PVT LTD-KKBK203631173770,,,net_banking_transfer,9513.08
61b6fe5dd8beac1599eb2398,50200023535069,508705.31,60ec41ba55c00300382672d9,HDFC,Revenue-PG-non-split,5eecc6d6449e4f7cfb1c2708,2020-12-29T00:00:00.000Z,UPI-PAYTM-PAYOUTS@PAYTM-PYTM0123456-0364 00072954-ALL202012292168200,ewallet,,upi,20759.76
61b6fe5ed8beac1599eb239d,50200023535069,507602.38,60ec41ba55c00300382672d9,HDFC,direct expenses,5eecc6d6449e4f7cfb1c2708,2020-12-29T00:00:00.000Z,POS 514834XXXXXX9486 ZOOM US 888-799-,,,debit_card,-1102.93
61b6fe5fd8beac1599eb23a4,50200023535069,534154.61,60ec41ba55c00300382672d9,HDFC,Revenue-PG-split enabled,5eecc6d6449e4f7cfb1c2708,2020-12-29T00:00:00.000Z,NEFT CR-UTIB0001506-RAZORPAY SOFTWARE PR IVATE LIMITED-SLICK ORGANICS PVT LITD-AX ISCN0064780763,investments,,net_banking_transfer,26552.23
61b6fe60d8beac1599eb23a7,50200023535069,484154.61,60ec41ba55c00300382672d9,HDFC,SAAS/tech expense,5eecc6d6449e4f7cfb1c2708,2020-12-29T00:00:00.000Z,VHDF9604995427/BILLDKAMAZONSELLERSE,shopping,,Other,-50000
61b6fe61d8beac1599eb23ab,50200023535069,464154.61,60ec41ba55c00300382672d9,HDFC,direct expenses,5eecc6d6449e4f7cfb1c2708,2020-12-29T00:00:00.000Z,IMPS-036412158551-PAYTM-PYTM-XXXXXXXX383 9-20000,ewallet,,net_banking_transfer,-20000
61b6fe62d8beac1599eb23b3,50200023535069,841147.45,60ec41ba55c00300382672d9,HDFC,Revenue-Mktplace,5eecc6d6449e4f7cfb1c2708,2020-12-29T00:00:00.000Z,NEFT CR-DEUT0797BGL-AMAZON PAY (INDIA) P RIVATE LIMITED-SLICK ORGANICS PVT LTD-12 2900237GN00179,shopping,,net_banking_transfer,376992.84
61b6fe63d8beac1599eb23b8,50200023535069,853226.45,60ec41ba55c00300382672d9,HDFC,Transfer in/Revenue-other,5eecc6d6449e4f7cfb1c2708,2020-12-29T00:00:00.000Z,IMPS-036415901041-MR SIDDHARTH KOTHA-H,,,net_banking_transfer,12079
61b6fe64d8beac1599eb23bd,50200023535069,862408.51,60ec41ba55c00300382672d9,HDFC,Revenue-PG-split enabled,5eecc6d6449e4f7cfb1c2708,2020-12-29T00:00:00.000Z,NEFT CR-UTIB0001506-RAZORPAY SOFTWARE PR IVATE LIMITED-SLICK ORGANICS PVT LITD-AX ISCN0064884007,investments,,net_banking_transfer,9182.06
61b6fe65d8beac1599eb23c2,50200023535069,884479.97,60ec41ba55c00300382672d9,HDFC,Revenue-PG-non-split,5eecc6d6449e4f7cfb1c2708,2020-12-30T00:00:00.000Z,UPI-PAYTM-PAYOUTS@PAYTM-PYTM0123456-0365 18986306-ALL202012302168200,ewallet,,upi,22071.46
61b6fe66d8beac1599eb23c8,50200023535069,927350.55,60ec41ba55c00300382672d9,HDFC,Revenue-PG-split enabled,5eecc6d6449e4f7cfb1c2708,2020-12-30T00:00:00.000Z,NEFT CR-UTIB0001506-RAZORPAY SOFTWARE PR IVATE LIMITED-SLICK ORGANICS PVT LITD-AX ISCN0064918804,investments,,net_banking_transfer,42870.58
61b6fe67d8beac1599eb23ce,50200023535069,928273.29,60ec41ba55c00300382672d9,HDFC,Revenue-Mktplace,5eecc6d6449e4f7cfb1c2708,2020-12-30T00:00:00.000Z,NEFT CR-DEUT0797BGL-FLIPKART INTERNET PR IVATE LIMITED-SLICK ORGANICS PVT LTD-123 000111GN00255,shopping,,net_banking_transfer,922.74
61b6fe68d8beac1599eb23d1,50200023535069,928694.05,60ec41ba55c00300382672d9,HDFC,Revenue-Mktplace,5eecc6d6449e4f7cfb1c2708,2020-12-30T00:00:00.000Z,NEFT CR-ICIC0000105-MANASH LIFETYLE PVT LTD-SLICKORGANICSPRIVATELIMITEDMPMUM-ICI B203650015923,,,net_banking_transfer,420.76
61b6fe69d8beac1599eb23d5,50200023535069,939973.99,60ec41ba55c00300382672d9,HDFC,Revenue-COD,5eecc6d6449e4f7cfb1c2708,2020-12-30T00:00:00.000Z,NEFT CR-KKBK0000958-BIGFOOT RETAIL SOLUT IONS PRIVATE LIMITED-SLICK ORGANICS PVT LTD-KKBK203651622256,,,net_banking_transfer,11279.94
61b6fe6ad8beac1599eb23dd,50200023535069,889973.99,60ec41ba55c00300382672d9,HDFC,SAAS/tech expense,5eecc6d6449e4f7cfb1c2708,2020-12-30T00:00:00.000Z,POS 514834XXXXXX9486 AMAZON,shopping,,debit_card,-50000
61b6fe6bd8beac1599eb23df,50200023535069,1027325.44,60ec41ba55c00300382672d9,HDFC,Revenue-PG-split enabled,5eecc6d6449e4f7cfb1c2708,2020-12-30T00:00:00.000Z,NEFT CR-UTIB0001506-RAZORPAY SOFTWARE PR IVATE LIMITED-SLICK ORGANICS PVT LITD-AX ISCN0064983775,investments,,net_banking_transfer,137351.45
61b6fe6cd8beac1599eb23e9,50200023535069,977325.44,60ec41ba55c00300382672d9,HDFC,SAAS/tech expense,5eecc6d6449e4f7cfb1c2708,2020-12-30T00:00:00.000Z,POS 514834XXXXXX9486 AMAZON,shopping,,debit_card,-50000
61b6fe6dd8beac1599eb23ec,50200023535069,1167428.33,60ec41ba55c00300382672d9,HDFC,Revenue-PG-split enabled,5eecc6d6449e4f7cfb1c2708,2020-12-31T00:00:00.000Z,NEFT CR-UTIB0001506-RAZORPAY SOFTWARE PR IVATE LIMITED-SLICK ORGANICS PVT LITD-AX ISCN0065033964,investments,,net_banking_transfer,190102.89
61b6fe6ed8beac1599eb23f2,50200023535069,1117428.33,60ec41ba55c00300382672d9,HDFC,SAAS/tech expense,5eecc6d6449e4f7cfb1c2708,2020-12-31T00:00:00.000Z,VHDF9611542363/BILLDKAMAZONSELLERSE,shopping,,Other,-50000
61b6fe6fd8beac1599eb23f8,50200023535069,1323463.82,60ec41ba55c00300382672d9,HDFC,Revenue-PG-non-split,5eecc6d6449e4f7cfb1c2708,2020-12-31T00:00:00.000Z,RTGS CR-PYTM0000001-ONE97 COMMUNICATIONS LIMITED-SLICK ORGANICS PVT LTD-PYTMR220 20123100006348,ewallet,,net_banking_transfer,206035.49
61b6fe70d8beac1599eb23fd,50200023535069,1341482.05,60ec41ba55c00300382672d9,HDFC,Revenue-PG-split enabled,5eecc6d6449e4f7cfb1c2708,2020-12-31T00:00:00.000Z,NEFT CR-UTIB0001506-RAZORPAY SOFTWARE PR,,,net_banking_transfer,18018.23
61b6fe71d8beac1599eb240b,50200023535069,1367232.56,60ec41ba55c00300382672d9,HDFC,Revenue-PG-non-split,5eecc6d6449e4f7cfb1c2708,2021-01-01T00:00:00.000Z,UPI-PAYTM-PAYOUTS@PAYTM-PYTM0123456-1001 61534205-ALL202101012168200,ewallet,,upi,25750.51
61b6fe72d8beac1599eb240d,50200023535069,1372232.5,60ec41ba55c00300382672d9,HDFC,Revenue-Mktplace,5eecc6d6449e4f7cfb1c2708,2021-01-01T00:00:00.000Z,NEFT CR-DEUT0797BGL-FLIPKART INTERNET PR IVATE LIMITED-SLICK ORGANICS PVT LTD-010 100111GN00186,shopping,,net_banking_transfer,4999.94
61b6fe73d8beac1599eb2412,50200023535069,1385595.9,60ec41ba55c00300382672d9,HDFC,Revenue-PG-split enabled,5eecc6d6449e4f7cfb1c2708,2021-01-01T00:00:00.000Z,NEFT CR-UTIB0001506-RAZORPAY SOFTWARE PR IVATE LIMITED-SLICK ORGANICS PVT LITD-AX ISCN0065167555,investments,,net_banking_transfer,13363.4
61b6fe74d8beac1599eb241a,50200023535069,1391339.83,60ec41ba55c00300382672d9,HDFC,Revenue-Mktplace,5eecc6d6449e4f7cfb1c2708,2021-01-01T00:00:00.000Z,NEFT CR-DEUT0797BGL-MYNTRA DESIGNS PRIVA TE LIMITED-SLICK ORGANICS PRIVATE LIMITE D-010100212GN00030,shopping,,net_banking_transfer,5743.93
61b6fe74d8beac1599eb241c,50200023535069,1191339.83,60ec41ba55c00300382672d9,HDFC,direct expenses,5eecc6d6449e4f7cfb1c2708,2021-01-01T00:00:00.000Z,"NEFT DR-YESB0000551-VISTTA COSMETICS-NET BANK, MUM-N001211358433003-200000",,,net_banking_transfer,-200000
61b6fe75d8beac1599eb242d,50200023535069,1091339.83,60ec41ba55c00300382672d9,HDFC,direct expenses,5eecc6d6449e4f7cfb1c2708,2021-01-01T00:00:00.000Z,"NEFT DR-UTIB0000166-KRAUTER HEALTHCARE LIMITED-NETBANK, MUM-N001211358451133-10 0000",,,net_banking_transfer,-100000
61b6fe76d8beac1599eb2435,50200023535069,821339.83,60ec41ba55c00300382672d9,HDFC,direct expenses,5eecc6d6449e4f7cfb1c2708,2021-01-01T00:00:00.000Z,02711600008220-TPT-270000-VARUN SINGH,,,net_banking_transfer,-270000
61b6fe77d8beac1599eb2439,50200023535069,571339.83,60ec41ba55c00300382672d9,HDFC,direct expenses,5eecc6d6449e4f7cfb1c2708,2021-01-01T00:00:00.000Z,05892560000649-TPT-250000-DECORPAC INDIA PRIVATE LIMITED,,,net_banking_transfer,-250000
61b6fe78d8beac1599eb243f,50200023535069,483794.83,60ec41ba55c00300382672d9,HDFC,agency/vendor expense,5eecc6d6449e4f7cfb1c2708,2021-01-01T00:00:00.000Z,"NEFT DR-KKBK0000298-ADMITAD MEDIA PRIVAT E LIMITED-NETBANK, MUM-N001211358453704- 87545",loans,lender_transaction,net_banking_transfer,-87545
61b6fe79d8beac1599eb2445,50200023535069,463794.83,60ec41ba55c00300382672d9,HDFC,direct expenses,5eecc6d6449e4f7cfb1c2708,2021-01-01T00:00:00.000Z,"NEFT DR-PYTM0123456-PAYTM-NETBANK, MUM-N 001211358475618-20000",ewallet,,net_banking_transfer,-20000
61b6fe7ad8beac1599eb244e,50200023535069,463749.29,60ec41ba55c00300382672d9,HDFC,bank charges,5eecc6d6449e4f7cfb1c2708,2021-01-01T00:00:00.000Z,.DC INTL POS TXN MARKUP+ST 281220 301220 -CDT2100102447680,,,international_transaction_arbitrage,-45.54
61b6fe7bd8beac1599eb2451,50200023535069,467843.61,60ec41ba55c00300382672d9,HDFC,Revenue-Mktplace,5eecc6d6449e4f7cfb1c2708,2021-01-01T00:00:00.000Z,NEFT CR-DEUT0797BGL-MYNTRA DESIGNS PRIVA TE LIMITED-SLICK ORGANICS PRIVATE LIMITE D-010100231GN00133,shopping,,net_banking_transfer,4094.32
61b6fe7cd8beac1599eb245d,50200023535069,465723.74,60ec41ba55c00300382672d9,HDFC,direct expenses,5eecc6d6449e4f7cfb1c2708,2021-01-01T00:00:00.000Z,POS 514834XXXXXX9486 SEOPTIMER,,,debit_card,-2119.87
61b6fe7dd8beac1599eb2462,50200023535069,415723.74,60ec41ba55c00300382672d9,HDFC,SAAS/tech expense,5eecc6d6449e4f7cfb1c2708,2021-01-01T00:00:00.000Z,VHDF9615353644/BILLDKAMAZONSELLERSE,shopping,,Other,-50000
61b6fe7ed8beac1599eb2467,50200023535069,430565.01,60ec41ba55c00300382672d9,HDFC,Revenue-PG-split enabled,5eecc6d6449e4f7cfb1c2708,2021-01-01T00:00:00.000Z,NEFT CR-UTIB0001506-RAZORPAY SOFTWARE PR IVATE LIMITED-SLICK ORGANICS PVT LITD-AX ISCN0065255534,investments,,net_banking_transfer,14841.27
61b6fe7fd8beac1599eb246c,50200023535069,450608.11,60ec41ba55c00300382672d9,HDFC,Revenue-PG-non-split,5eecc6d6449e4f7cfb1c2708,2021-01-02T00:00:00.000Z,UPI-PAYTM-PAYOUTS@PAYTM-PYTM0123456-1002 81156128-ALL202101022168200,ewallet,,upi,20043.1
61b6fe80d8beac1599eb2475,50200023535069,458213.71,60ec41ba55c00300382672d9,HDFC,Revenue-PG-split enabled,5eecc6d6449e4f7cfb1c2708,2021-01-02T00:00:00.000Z,NEFT CR-UTIB0001506-RAZORPAY SOFTWARE PR IVATE LIMITED-SLICK ORGANICS PVT LITD-AX ISCN0065296774,investments,,net_banking_transfer,7605.6
61b6fe81d8beac1599eb2479,50200023535069,408213.71,60ec41ba55c00300382672d9,HDFC,SAAS/tech expense,5eecc6d6449e4f7cfb1c2708,2021-01-02T00:00:00.000Z,VHDF9617977327/BILLDKAMAZONSELLERSE,shopping,,Other,-50000
61b6fe82d8beac1599eb2480,50200023535069,1908286.89,60ec41ba55c00300382672d9,HDFC,Investments-New,5eecc6d6449e4f7cfb1c2708,2021-01-02T00:00:00.000Z,50100216436008-TPT-DIRECTOR SOPL-DHRUV M ADHOK,,,net_banking_transfer,1500073.18
61b6fe83d8beac1599eb2486,50200023535069,1921540.36,60ec41ba55c00300382672d9,HDFC,Revenue-PG-split enabled,5eecc6d6449e4f7cfb1c2708,2021-01-02T00:00:00.000Z,NEFT CR-UTIB0001506-RAZORPAY SOFTWARE PR IVATE LIMITED-SLICK ORGANICS PVT LITD-AX ISCN0065347108,investments,,net_banking_transfer,13253.47
61b6fe84d8beac1599eb248e,50200023535069,1936272.8,60ec41ba55c00300382672d9,HDFC,Revenue-PG-non-split,5eecc6d6449e4f7cfb1c2708,2021-01-03T00:00:00.000Z,UPI-PAYTM-PAYOUTS@PAYTM-PYTM0123456-1003 01146749-ALL202101032168200,ewallet,,upi,14732.44
61b6fe85d8beac1599eb2494,50200023535069,1931553.98,60ec41ba55c00300382672d9,HDFC,direct expenses,5eecc6d6449e4f7cfb1c2708,2021-01-03T00:00:00.000Z,POS 514834XXXXXX4081 ONLINE PAYMENT,,,debit_card,-4718.82
61b6fe86d8beac1599eb2496,50200023535069,1959353.33,60ec41ba55c00300382672d9,HDFC,Revenue-PG-non-split,5eecc6d6449e4f7cfb1c2708,2021-01-04T00:00:00.000Z,UPI-PAYTM-PAYOUTS@PAYTM-PYTM0123456-1004 20738214-ALL202101042168200,ewallet,,upi,27799.35
61b6fe87d8beac1599eb249b,50200023535069,2011130.69,60ec41ba55c00300382672d9,HDFC,Revenue-PG-split enabled,5eecc6d6449e4f7cfb1c2708,2021-01-04T00:00:00.000Z,NEFT CR-UTIB0001506-RAZORPAY SOFTWARE PR IVATE LIMITED-SLICK ORGANICS PVT LITD-AX ISCN0065384822,investments,,net_banking_transfer,51777.36
61b6fe88d8beac1599eb24a5,50200023535069,2012843.6,60ec41ba55c00300382672d9,HDFC,Revenue-Mktplace,5eecc6d6449e4f7cfb1c2708,2021-01-04T00:00:00.000Z,NEFT CR-DEUT0797BGL-MYNTRA DESIGNS PRIVA TE LIMITED-SLICK ORGANICS PRIVATE LIMITE D-010400048GN00272,shopping,,net_banking_transfer,1712.91
61b6fe89d8beac1599eb24a9,50200023535069,2015123.94,60ec41ba55c00300382672d9,HDFC,Revenue-Mktplace,5eecc6d6449e4f7cfb1c2708,2021-01-04T00:00:00.000Z,NEFT CR-DEUT0797BGL-MYNTRA DESIGNS PRIVA TE LIMITED-SLICK ORGANICS PRIVATE LIMITE D-010400057GN00050,shopping,,net_banking_transfer,2280.34
61b6fe8ad8beac1599eb24b2,50200023535069,515050.94,60ec41ba55c00300382672d9,HDFC,direct expenses,5eecc6d6449e4f7cfb1c2708,2021-01-04T00:00:00.000Z,"NEFT DR-SCBL0036025-DHRUV MADHOK-NETBANK , MUM-N004211361123833-1500073",,,net_banking_transfer,-1500073
61b6fe8bd8beac1599eb24b5,50200023535069,515951.9,60ec41ba55c00300382672d9,HDFC,Revenue-Mktplace,5eecc6d6449e4f7cfb1c2708,2021-01-04T00:00:00.000Z,NEFT CR-DEUT0797BGL-FLIPKART INTERNET PR,shopping,,net_banking_transfer,900.96
61b6fe8cd8beac1599eb24b9,50200023535069,506814.52,60ec41ba55c00300382672d9,HDFC,direct expenses,5eecc6d6449e4f7cfb1c2708,2021-01-04T00:00:00.000Z,POS 514834XXXXXX9486 STK*SHUTTERSTOCK,,,debit_card,-9137.38
61b6fe8dd8beac1599eb24bf,50200023535069,456814.52,60ec41ba55c00300382672d9,HDFC,Marketing Expense,5eecc6d6449e4f7cfb1c2708,2021-01-04T00:00:00.000Z,POS 514834XXXXXX9486 GOOGLE ADWORDS,,,debit_card,-50000
61b6fe8ed8beac1599eb24c4,50200023535069,476534.42,60ec41ba55c00300382672d9,HDFC,Revenue-PG-split enabled,5eecc6d6449e4f7cfb1c2708,2021-01-04T00:00:00.000Z,NEFT CR-UTIB0001506-RAZORPAY SOFTWARE PR IVATE LIMITED-SLICK ORGANICS PVT LITD-AX ISCN0065456126,investments,,net_banking_transfer,19719.9
61b6fe8fd8beac1599eb24cb,50200023535069,554546.86,60ec41ba55c00300382672d9,HDFC,Revenue-COD,5eecc6d6449e4f7cfb1c2708,2021-01-04T00:00:00.000Z,NEFT CR-KKBK0000958-BIGFOOT RETAIL SOLUT IONS PRIVATE LIMITED-SLICK ORGANICS PVT LTD-KKBK210042762216,,,net_banking_transfer,78012.44
61b6fe8fd8beac1599eb24ce,50200023535069,555006.72,60ec41ba55c00300382672d9,HDFC,Revenue-PG-non-split,5eecc6d6449e4f7cfb1c2708,2021-01-04T00:00:00.000Z,NEFT CR-ICIC0000031-PAYTM E COMMERCE PVT LTD-SLICK ORGANICS PVT LTD-CMS175330765 7,investments,,net_banking_transfer,459.86
61b6fe90d8beac1599eb24d2,50200023535069,505006.72,60ec41ba55c00300382672d9,HDFC,SAAS/tech expense,5eecc6d6449e4f7cfb1c2708,2021-01-04T00:00:00.000Z,VHDF9626559164/BILLDKAMAZONSELLERSE,shopping,,Other,-50000
61b6fe91d8beac1599eb24db,50200023535069,526453.79,60ec41ba55c00300382672d9,HDFC,Revenue-PG-non-split,5eecc6d6449e4f7cfb1c2708,2021-01-05T00:00:00.000Z,UPI-PAYTM-PAYOUTS@PAYTM-PYTM0123456-1005 40806535-ALL202101052168200,ewallet,,upi,21447.07
61b6fe92d8beac1599eb24dd,50200023535069,542823.69,60ec41ba55c00300382672d9,HDFC,Revenue-PG-split enabled,5eecc6d6449e4f7cfb1c2708,2021-01-05T00:00:00.000Z,NEFT CR-UTIB0001506-RAZORPAY SOFTWARE PR IVATE LIMITED-SLICK ORGANICS PVT LITD-AX ISCN0065497947,investments,,net_banking_transfer,16369.9
61b6fe93d8beac1599eb24e5,50200023535069,442823.69,60ec41ba55c00300382672d9,HDFC,direct expenses,5eecc6d6449e4f7cfb1c2708,2021-01-05T00:00:00.000Z,02711600008220-TPT-100000-VARUN SINGH,,,net_banking_transfer,-100000
61b6fe94d8beac1599eb24f6,50200023535069,425100.69,60ec41ba55c00300382672d9,HDFC,direct expenses,5eecc6d6449e4f7cfb1c2708,2021-01-05T00:00:00.000Z,"NEFT DR-CITI0000032-TRADETRACKER INDIA L LP-NETBANK, MUM-N005211362546464-17723",,,net_banking_transfer,-17723
61b6fe95d8beac1599eb2508,50200023535069,416220.69,60ec41ba55c00300382672d9,HDFC,agency/vendor expense,5eecc6d6449e4f7cfb1c2708,2021-01-05T00:00:00.000Z,"NEFT DR-IDFB0021001-CLIKCONIK DIGITAL ME DIA PRIVATE LIMITED-NETBANK, MUM-N005211 362547254-8880",,,net_banking_transfer,-8880
61b6fe96d8beac1599eb2514,50200023535069,366220.69,60ec41ba55c00300382672d9,HDFC,direct expenses,5eecc6d6449e4f7cfb1c2708,2021-01-05T00:00:00.000Z,"NEFT DR-PYTM0123456-PAYTM-NETBANK, MUM-N 005211362549617-50000",ewallet,,net_banking_transfer,-50000
61b6fe97d8beac1599eb2525,50200023535069,439819.68,60ec41ba55c00300382672d9,HDFC,Revenue-Mktplace,5eecc6d6449e4f7cfb1c2708,2021-01-05T00:00:00.000Z,IMPS-100511106221-AMAZON SELLER SERVIC-H DFC-XXXXXXXX6004-5G6ZYGKFPOS4W98JSLICK O RGANICS PVT LTD,shopping,,net_banking_transfer,73598.99
61b6fe98d8beac1599eb252f,50200023535069,429819.68,60ec41ba55c00300382672d9,HDFC,direct expenses,5eecc6d6449e4f7cfb1c2708,2021-01-05T00:00:00.000Z,CHQ PAID TO SARVAN KUMAR - CHQ PAID - DE,,,chq,-10000
61b6fe99d8beac1599eb2539,50200023535069,402579.68,60ec41ba55c00300382672d9,HDFC,direct expenses,5eecc6d6449e4f7cfb1c2708,2021-01-05T00:00:00.000Z,"NEFT DR-CITI0000002-OMG NETWORK INDIA PR IVATE LIMITED-NETBANK, MUM-N005211362571 766-27240",,,net_banking_transfer,-27240
61b6fe9ad8beac1599eb253f,50200023535069,312579.68,60ec41ba55c00300382672d9,HDFC,direct expenses,5eecc6d6449e4f7cfb1c2708,2021-01-05T00:00:00.000Z,"NEFT DR-YESB0000551-VISTTA COSMETICS-NET BANK, MUM-N005211362569167-90000",,,net_banking_transfer,-90000
61b6fe9bd8beac1599eb254c,50200023535069,696745.84,60ec41ba55c00300382672d9,HDFC,Revenue-Mktplace,5eecc6d6449e4f7cfb1c2708,2021-01-05T00:00:00.000Z,NEFT CR-DEUT0797BGL-AMAZON PAY (INDIA) P RIVATE LIMITED-SLICK ORGANICS PVT LTD-01 0500116GN00197,shopping,,net_banking_transfer,384166.16
61b6fe9cd8beac1599eb2555,50200023535069,718437.14,60ec41ba55c00300382672d9,HDFC,Revenue-PG-split enabled,5eecc6d6449e4f7cfb1c2708,2021-01-05T00:00:00.000Z,NEFT CR-UTIB0001506-RAZORPAY SOFTWARE PR IVATE LIMITED-SLICK ORGANICS PVT LITD-AX ISCN0065576910,investments,,net_banking_transfer,21691.3
61b6fe9dd8beac1599eb255b,50200023535069,718898.2,60ec41ba55c00300382672d9,HDFC,Revenue-Mktplace,5eecc6d6449e4f7cfb1c2708,2021-01-05T00:00:00.000Z,NEFT CR-ICIC0000105-MANASH LIFETYLE PVT LTD-SLICK ORGANICS PRIVATE LIMITED MP MUM-ICIB210050057698,,,net_banking_transfer,461.06
61b6fe9ed8beac1599eb2564,50200023535069,732293.51,60ec41ba55c00300382672d9,HDFC,Revenue-PG-non-split,5eecc6d6449e4f7cfb1c2708,2021-01-06T00:00:00.000Z,UPI-PAYTM-PAYOUTS@PAYTM-PYTM0123456-1006 61159518-ALL202101062168200,ewallet,,upi,13395.31
61b6fe9fd8beac1599eb2569,50200023535069,682293.51,60ec41ba55c00300382672d9,HDFC,SAAS/tech expense,5eecc6d6449e4f7cfb1c2708,2021-01-06T00:00:00.000Z,VHDF9631281525/BILLDKAMAZONSELLERSE,shopping,,Other,-50000
61b6fea0d8beac1599eb2570,50200023535069,697008.09,60ec41ba55c00300382672d9,HDFC,Revenue-PG-split enabled,5eecc6d6449e4f7cfb1c2708,2021-01-06T00:00:00.000Z,NEFT CR-UTIB0001506-RAZORPAY SOFTWARE PR IVATE LIMITED-SLICK ORGANICS PVT LITD-AX ISCN0065629188,investments,,net_banking_transfer,14714.58
61b6fea1d8beac1599eb2578,50200023535069,699593.22,60ec41ba55c00300382672d9,HDFC,Revenue-Mktplace,5eecc6d6449e4f7cfb1c2708,2021-01-06T00:00:00.000Z,NEFT CR-DEUT0797BGL-FLIPKART INTERNET PR IVATE LIMITED-SLICK ORGANICS PVT LTD-010 600113GN00265,shopping,,net_banking_transfer,2585.13
61b6fea2d8beac1599eb257f,50200023535069,701507.39,60ec41ba55c00300382672d9,HDFC,Revenue-Mktplace,5eecc6d6449e4f7cfb1c2708,2021-01-06T00:00:00.000Z,NEFT CR-DEUT0797BGL-MYNTRA DESIGNS PRIVA TE LIMITED-SLICK ORGANICS PRIVATE LIMITE D-010600226GN00004,shopping,,net_banking_transfer,1914.17
61b6fea3d8beac1599eb2588,50200023535069,701780.42,60ec41ba55c00300382672d9,HDFC,Revenue-Mktplace,5eecc6d6449e4f7cfb1c2708,2021-01-06T00:00:00.000Z,NEFT CR-DEUT0797BGL-MYNTRA DESIGNS PRIVA TE LIMITED-SLICK ORGANICS PRIVATE LIMITE D-010600184GN00276,shopping,,net_banking_transfer,273.03
61b6fea4d8beac1599eb258d,50200023535069,740421.66,60ec41ba55c00300382672d9,HDFC,Revenue-COD,5eecc6d6449e4f7cfb1c2708,2021-01-06T00:00:00.000Z,NEFT CR-KKBK0000958-BIGFOOT RETAIL SOLUT,,,net_banking_transfer,38641.24
61b6fea5d8beac1599eb2593,50200023535069,762985.16,60ec41ba55c00300382672d9,HDFC,Revenue-PG-split enabled,5eecc6d6449e4f7cfb1c2708,2021-01-06T00:00:00.000Z,NEFT CR-UTIB0001506-RAZORPAY SOFTWARE PR IVATE LIMITED-SLICK ORGANICS PVT LITD-AX ISCN0065684244,investments,,net_banking_transfer,22563.5
61b6fea6d8beac1599eb259f,50200023535069,763510.72,60ec41ba55c00300382672d9,HDFC,Revenue-Mktplace,5eecc6d6449e4f7cfb1c2708,2021-01-06T00:00:00.000Z,NEFT CR-ICIC0000105-MANASH LIFETYLE PVT LTD-SLICKORGANICSPRIVATELIMITEDMPGGN-ICI B210060106339,,,net_banking_transfer,525.56
61b6fea7d8beac1599eb25a3,50200023535069,763883.83,60ec41ba55c00300382672d9,HDFC,Revenue-Mktplace,5eecc6d6449e4f7cfb1c2708,2021-01-06T00:00:00.000Z,NEFT CR-ICIC0000105-MANASH LIFETYLE PVT LTD-SLICKORGANICSPRIVATELIMITEDMPMUM-ICI B210060106340,,,net_banking_transfer,373.11
61b6fea8d8beac1599eb25af,50200023535069,791463.66,60ec41ba55c00300382672d9,HDFC,Revenue-PG-non-split,5eecc6d6449e4f7cfb1c2708,2021-01-07T00:00:00.000Z,UPI-PAYTM-PAYOUTS@PAYTM-PYTM0123456-1007 81599636-ALL202101072168200,ewallet,,upi,27579.83
61b6fea8d8beac1599eb25b6,50200023535069,720623.66,60ec41ba55c00300382672d9,HDFC,Internal Transfers,5eecc6d6449e4f7cfb1c2708,2021-01-07T00:00:00.000Z,IB FUNDS TRANSFER DR-50200035187206 -SL ICK ORGANICS PVT LTD,investments,,net_banking_transfer,-70840
61b6fea9d8beac1599eb25ba,50200023535069,628123.66,60ec41ba55c00300382672d9,HDFC,direct expenses,5eecc6d6449e4f7cfb1c2708,2021-01-07T00:00:00.000Z,"NEFT DR-CITI0000002-DHIRAJ-NETBANK, MUM- N007211365210081-92500",,,net_banking_transfer,-92500
61b6feaad8beac1599eb25be,50200023535069,558123.66,60ec41ba55c00300382672d9,HDFC,direct expenses,5eecc6d6449e4f7cfb1c2708,2021-01-07T00:00:00.000Z,"NEFT DR-ICIC0000542-AVANTIKA SUKHIA-NETB ANK, MUM-N007211365210163-70000",,,net_banking_transfer,-70000
61b6feabd8beac1599eb25c4,50200023535069,537123.66,60ec41ba55c00300382672d9,HDFC,direct expenses,5eecc6d6449e4f7cfb1c2708,2021-01-07T00:00:00.000Z,"NEFT DR-SIBL0000555-JAIVEER KUMAR-NETBAN K, MUM-N007211365210273-21000",,,net_banking_transfer,-21000
61b6feacd8beac1599eb25ca,50200023535069,522123.66,60ec41ba55c00300382672d9,HDFC,direct expenses,5eecc6d6449e4f7cfb1c2708,2021-01-07T00:00:00.000Z,"NEFT DR-PUNB0398000-MEENA SINGH-NETBANK, MUM-N007211365272045-15000",,,net_banking_transfer,-15000
61b6feadd8beac1599eb25ce,50200023535069,487123.66,60ec41ba55c00300382672d9,HDFC,direct expenses,5eecc6d6449e4f7cfb1c2708,2021-01-07T00:00:00.000Z,"NEFT DR-ICIC0003374-SIDDHARTH KANOJIA-NE TBANK, MUM-N007211365300402-35000",,,net_banking_transfer,-35000
61b6feaed8beac1599eb25d1,50200023535069,477123.66,60ec41ba55c00300382672d9,HDFC,direct expenses,5eecc6d6449e4f7cfb1c2708,2021-01-07T00:00:00.000Z,"NEFT DR-ALLA0210591-CHAMPA DEVI-NETBANK, MUM-N007211365272214-10000",,,net_banking_transfer,-10000
61b6feafd8beac1599eb25d8,50200023535069,427123.66,60ec41ba55c00300382672d9,HDFC,direct expenses,5eecc6d6449e4f7cfb1c2708,2021-01-07T00:00:00.000Z,"NEFT DR-UTIB0000120-ADNAN ALI-NETBANK, M UM-N007211365272322-50000",,,net_banking_transfer,-50000
61b6feb0d8beac1599eb25de,50200023535069,391123.66,60ec41ba55c00300382672d9,HDFC,direct expenses,5eecc6d6449e4f7cfb1c2708,2021-01-07T00:00:00.000Z,00901610080520-TPT-36000-POOJA KAPIL SHR OTRIYA,,,net_banking_transfer,-36000
61b6feb1d8beac1599eb25e2,50200023535069,291123.66,60ec41ba55c00300382672d9,HDFC,direct expenses,5eecc6d6449e4f7cfb1c2708,2021-01-07T00:00:00.000Z,02771610131904-TPT-100000-DIGANT BHATT,,,net_banking_transfer,-100000
61b6feb2d8beac1599eb25ec,50200023535069,201123.66,60ec41ba55c00300382672d9,HDFC,direct expenses,5eecc6d6449e4f7cfb1c2708,2021-01-07T00:00:00.000Z,50100301160692-TPT-90000-TARUN GARG,,,net_banking_transfer,-90000
61b6feb3d8beac1599eb25ef,50200023535069,135123.66,60ec41ba55c00300382672d9,HDFC,direct expenses,5eecc6d6449e4f7cfb1c2708,2021-01-07T00:00:00.000Z,50100330586095-TPT-66000-DIWAKAR UNIYAL,,,net_banking_transfer,-66000
61b6feb4d8beac1599eb25f3,50200023535069,85123.66,60ec41ba55c00300382672d9,HDFC,direct expenses,5eecc6d6449e4f7cfb1c2708,2021-01-07T00:00:00.000Z,"NEFT DR-PYTM0123456-PAYTM-NETBANK, MUM-N 007211365273001-50000",ewallet,,net_banking_transfer,-50000
61b6feb5d8beac1599eb25fa,50200023535069,57498.66,60ec41ba55c00300382672d9,HDFC,direct expenses,5eecc6d6449e4f7cfb1c2708,2021-01-07T00:00:00.000Z,"NEFT DR-SYNB0005170-SNEHAL TAYDE-NETBANK , MUM-N007211365274343-27625",,,net_banking_transfer,-27625
61b6feb6d8beac1599eb2601,50200023535069,79905.01,60ec41ba55c00300382672d9,HDFC,Revenue-PG-split enabled,5eecc6d6449e4f7cfb1c2708,2021-01-07T00:00:00.000Z,NEFT CR-UTIB0001506-RAZORPAY SOFTWARE PR IVATE LIMITED-SLICK ORGANICS PVT LITD-AX ISCN0065739823,investments,,net_banking_transfer,22406.35
61b6feb7d8beac1599eb2608,50200023535069,40905.01,60ec41ba55c00300382672d9,HDFC,direct expenses,5eecc6d6449e4f7cfb1c2708,2021-01-07T00:00:00.000Z,"NEFT DR-PYTM0123456-PAYTM-NETBANK, MUM-N 007211365403229-39000",ewallet,,net_banking_transfer,-39000
61b6feb8d8beac1599eb260a,50200023535069,19415.01,60ec41ba55c00300382672d9,HDFC,direct expenses,5eecc6d6449e4f7cfb1c2708,2021-01-07T00:00:00.000Z,50100301160692-TPT-21490-TARUN GARG,,,net_banking_transfer,-21490
61b6feb9d8beac1599eb260e,50200023535069,-10584.99,60ec41ba55c00300382672d9,HDFC,direct expenses,5eecc6d6449e4f7cfb1c2708,2021-01-07T00:00:00.000Z,"MC ISSUED - KALKAJI, NEW - 027112174401 - - RCL FEEDER PTE LTD",,,Other,-30000
61b6febad8beac1599eb2618,50200023535069,-10058.7,60ec41ba55c00300382672d9,HDFC,Revenue-Mktplace,5eecc6d6449e4f7cfb1c2708,2021-01-07T00:00:00.000Z,NEFT CR-ICIC0000105-MANASH LIFETYLE PVT LTD-SLICKORGANICSPRIVATELIMITEDMPMUM-ICI B210070050387,,,net_banking_transfer,526.29
61b6febbd8beac1599eb2624,50200023535069,-8697.92,60ec41ba55c00300382672d9,HDFC,Transfer in/Revenue-other,5eecc6d6449e4f7cfb1c2708,2021-01-07T00:00:00.000Z,ZOOBOP ME WORK-ARATA,,,Other,1360.78
61b6febcd8beac1599eb262c,50200023535069,6606.71,60ec41ba55c00300382672d9,HDFC,Revenue-PG-split enabled,5eecc6d6449e4f7cfb1c2708,2021-01-07T00:00:00.000Z,NEFT CR-UTIB0001506-RAZORPAY SOFTWARE PR IVATE LIMITED-SLICK ORGANICS PVT LITD-AX ISCN0065833265,investments,,net_banking_transfer,15304.63
61b6febdd8beac1599eb2634,50200023535069,34734.32,60ec41ba55c00300382672d9,HDFC,Revenue-PG-non-split,5eecc6d6449e4f7cfb1c2708,2021-01-08T00:00:00.000Z,UPI-PAYTM-PAYOUTS@PAYTM-PYTM0123456-1008 02386790-ALL202101082168200,ewallet,,upi,28127.61
61b6febed8beac1599eb2638,50200023535069,50503.36,60ec41ba55c00300382672d9,HDFC,Revenue-PG-split enabled,5eecc6d6449e4f7cfb1c2708,2021-01-08T00:00:00.000Z,NEFT CR-UTIB0001506-RAZORPAY SOFTWARE PR IVATE LIMITED-SLICK ORGANICS PVT LITD-AX ISCN0065868737,investments,,net_banking_transfer,15769.04
61b6febfd8beac1599eb2648,50200023535069,52757.92,60ec41ba55c00300382672d9,HDFC,Revenue-Mktplace,5eecc6d6449e4f7cfb1c2708,2021-01-08T00:00:00.000Z,NEFT CR-DEUT0797BGL-MYNTRA DESIGNS PRIVA TE LIMITED-SLICK ORGANICS PRIVATE LIMITE D-010800056GN00104,shopping,,net_banking_transfer,2254.56
61b6fec0d8beac1599eb2654,50200023535069,61799.15,60ec41ba55c00300382672d9,HDFC,Revenue-Mktplace,5eecc6d6449e4f7cfb1c2708,2021-01-08T00:00:00.000Z,NEFT CR-DEUT0797BGL-FLIPKART INTERNET PR IVATE LIMITED-SLICK ORGANICS PVT LTD-010 800181GN00266,shopping,,net_banking_transfer,9041.23
61b6fec1d8beac1599eb265f,50200023535069,36799.15,60ec41ba55c00300382672d9,HDFC,direct expenses,5eecc6d6449e4f7cfb1c2708,2021-01-08T00:00:00.000Z,"NEFT DR-PYTM0123456-PAYTM-NETBANK, MUM-N",ewallet,,net_banking_transfer,-25000
61b6fec2d8beac1599eb26a0,50200023535069,86799.15,60ec41ba55c00300382672d9,HDFC,Internal Transfers,5eecc6d6449e4f7cfb1c2708,2021-01-08T00:00:00.000Z,IB FUNDS TRANSFER CR-50200050976833 -SL ICK ORGANICS PVT LTD,investments,,Other,50000
61b6fec3d8beac1599eb26a4,50200023535069,87225.18,60ec41ba55c00300382672d9,HDFC,Revenue-Mktplace,5eecc6d6449e4f7cfb1c2708,2021-01-08T00:00:00.000Z,NEFT CR-DEUT0784BBY-TATA UNISTORE LTD-NO DAL-SLICK ORGANICS PVT LTD-010800595GN00 260,investments,,net_banking_transfer,426.03
61b6fec3d8beac1599eb26af,50200023535069,88211.08,60ec41ba55c00300382672d9,HDFC,Transfer in/Revenue-other,5eecc6d6449e4f7cfb1c2708,2021-01-08T00:00:00.000Z,NEFT CR-YESB0000001-ILUMINAR MEDIA-SLICK ORGANICS PVT. LTD-N008210492099852,,,net_banking_transfer,985.9
61b6fec5d8beac1599eb26cc,50200023535069,38211.08,60ec41ba55c00300382672d9,HDFC,SAAS/tech expense,5eecc6d6449e4f7cfb1c2708,2021-01-08T00:00:00.000Z,VHDF9638782359/BILLDKAMAZONSELLERSE,shopping,,Other,-50000
61b6fec6d8beac1599eb26db,50200023535069,38348.16,60ec41ba55c00300382672d9,HDFC,Revenue-Mktplace,5eecc6d6449e4f7cfb1c2708,2021-01-08T00:00:00.000Z,NEFT CR-ICIC0000105-MANASH LIFETYLE PVT LTD-SLICKORGANICSPRIVATELIMITEDMPGGN-ICI B210080086921,,,net_banking_transfer,137.08
61b6fec6d8beac1599eb26df,50200023535069,145664.77,60ec41ba55c00300382672d9,HDFC,Revenue-COD,5eecc6d6449e4f7cfb1c2708,2021-01-08T00:00:00.000Z,NEFT CR-KKBK0000958-BIGFOOT RETAIL SOLUT IONS PRIVATE LIMITED-SLICK ORGANICS PVT LTD-KKBK210083838683,,,net_banking_transfer,107316.61
61b6fec7d8beac1599eb26e8,50200023535069,157239.59,60ec41ba55c00300382672d9,HDFC,Revenue-PG-split enabled,5eecc6d6449e4f7cfb1c2708,2021-01-08T00:00:00.000Z,NEFT CR-UTIB0001506-RAZORPAY SOFTWARE PR IVATE LIMITED-SLICK ORGANICS PVT LITD-AX ISCN0065962880,investments,,net_banking_transfer,11574.82
61b6fec8d8beac1599eb26ee,50200023535069,179034.81,60ec41ba55c00300382672d9,HDFC,Transfer in/Revenue-other,5eecc6d6449e4f7cfb1c2708,2021-01-09T00:00:00.000Z,IMPS-100905192678-NA-HDFC-XXXXXXXXXX0007 -ALL20210109216820000330830668628,,,net_banking_transfer,21795.22
61b6fec9d8beac1599eb26f4,50200023535069,129034.81,60ec41ba55c00300382672d9,HDFC,SAAS/tech expense,5eecc6d6449e4f7cfb1c2708,2021-01-09T00:00:00.000Z,VHDF9642967260/BILLDKAMAZONSELLERSE,shopping,,Other,-50000
61b6fecad8beac1599eb26fe,50200023535069,148207.74,60ec41ba55c00300382672d9,HDFC,Revenue-PG-non-split,5eecc6d6449e4f7cfb1c2708,2021-01-10T00:00:00.000Z,UPI-PAYTM-PAYOUTS@PAYTM-PYTM0123456-1010 45079018-ALL202101102168200,ewallet,,upi,19172.93
61b6fecbd8beac1599eb2707,50200023535069,165387.39,60ec41ba55c00300382672d9,HDFC,Revenue-PG-non-split,5eecc6d6449e4f7cfb1c2708,2021-01-11T00:00:00.000Z,UPI-PAYTM-PAYOUTS@PAYTM-PYTM0123456-1011 65529954-ALL202101112168200,ewallet,,upi,17179.65
61b6feccd8beac1599eb270b,50200023535069,263327.39,60ec41ba55c00300382672d9,HDFC,Transfer in/Revenue-other,5eecc6d6449e4f7cfb1c2708,2021-01-11T00:00:00.000Z,NEFT CR-SCBL0036001-AMEYA GROUP-SLICK OR GANICS PVT LTD-IT36702101111557,investments,,net_banking_transfer,97940
61b6fecdd8beac1599eb2711,50200023535069,63327.39,60ec41ba55c00300382672d9,HDFC,direct expenses,5eecc6d6449e4f7cfb1c2708,2021-01-11T00:00:00.000Z,"NEFT DR-PYTM0123456-PAYTM-NETBANK, MUM-N 011211369223419-200000",ewallet,,net_banking_transfer,-200000
61b6feced8beac1599eb2716,50200023535069,127222.84,60ec41ba55c00300382672d9,HDFC,Revenue-PG-split enabled,5eecc6d6449e4f7cfb1c2708,2021-01-11T00:00:00.000Z,NEFT CR-UTIB0001506-RAZORPAY SOFTWARE PR IVATE LIMITED-SLICK ORGANICS PVT LITD-AX ISCN0066026293,investments,,net_banking_transfer,63895.45
61b6fecfd8beac1599eb271c,50200023535069,1127222.84,60ec41ba55c00300382672d9,HDFC,Internal Transfers,5eecc6d6449e4f7cfb1c2708,2021-01-11T00:00:00.000Z,IB FUNDS TRANSFER CR-50200035187206 -SL,,,Other,1000000
61b6fed0d8beac1599eb2725,50200023535069,927222.84,60ec41ba55c00300382672d9,HDFC,direct expenses,5eecc6d6449e4f7cfb1c2708,2021-01-11T00:00:00.000Z,IMPS-101111129113-PAYTM-PYTM-XXXXXXXX383 9-200000,ewallet,,net_banking_transfer,-200000
61b6fed1d8beac1599eb2729,50200023535069,727222.84,60ec41ba55c00300382672d9,HDFC,direct expenses,5eecc6d6449e4f7cfb1c2708,2021-01-11T00:00:00.000Z,IMPS-101111117595-PAYTM-PYTM-XXXXXXXX383 9-200000,ewallet,,net_banking_transfer,-200000
61b6fed2d8beac1599eb272d,50200023535069,527222.84,60ec41ba55c00300382672d9,HDFC,direct expenses,5eecc6d6449e4f7cfb1c2708,2021-01-11T00:00:00.000Z,IMPS-101111130016-PAYTM-PYTM-XXXXXXXX383 9-200000,ewallet,,net_banking_transfer,-200000
61b6fed3d8beac1599eb2738,50200023535069,377222.84,60ec41ba55c00300382672d9,HDFC,direct expenses,5eecc6d6449e4f7cfb1c2708,2021-01-11T00:00:00.000Z,IMPS-101111130354-PAYTM-PYTM-XXXXXXXX383 9-150000,ewallet,,net_banking_transfer,-150000
61b6fed4d8beac1599eb273f,50200023535069,277222.84,60ec41ba55c00300382672d9,HDFC,direct expenses,5eecc6d6449e4f7cfb1c2708,2021-01-11T00:00:00.000Z,"NEFT DR-YESB0000551-VISTTA COSMETICS-NET BANK, MUM-N011211369462334-100000",,,net_banking_transfer,-100000
61b6fed5d8beac1599eb2745,50200023535069,278717.84,60ec41ba55c00300382672d9,HDFC,Revenue-Mktplace,5eecc6d6449e4f7cfb1c2708,2021-01-11T00:00:00.000Z,NEFT CR-KKBK0000958-SUPERMARKET GROCERY SUPPLIES PVT LTD-SLICK ORGANICS PVT LTD- KKBK210114094604,shopping,,net_banking_transfer,1495
61b6fed6d8beac1599eb2747,50200023535069,288448.43,60ec41ba55c00300382672d9,HDFC,Revenue-Mktplace,5eecc6d6449e4f7cfb1c2708,2021-01-11T00:00:00.000Z,NEFT CR-KKBK0000958-SUPERMARKET GROCERY SUPPLIES PVT LTD-SLICK ORGANICS PVT LTD- KKBK210114094679,shopping,,net_banking_transfer,9730.59
61b6fed7d8beac1599eb274c,50200023535069,297231.91,60ec41ba55c00300382672d9,HDFC,Revenue-Mktplace,5eecc6d6449e4f7cfb1c2708,2021-01-11T00:00:00.000Z,NEFT CR-KKBK0000958-SUPERMARKET GROCERY SUPPLIES PVT LTD-SLICK ORGANICS PVT LTD- KKBK210114096503,shopping,,net_banking_transfer,8783.48
61b6fed8d8beac1599eb2754,50200023535069,298758.11,60ec41ba55c00300382672d9,HDFC,Revenue-Mktplace,5eecc6d6449e4f7cfb1c2708,2021-01-11T00:00:00.000Z,NEFT CR-KKBK0000958-SUPERMARKET GROCERY SUPPLIES PVT LTD-SLICK ORGANICS PVT LTD- KKBK210114097267,shopping,,net_banking_transfer,1526.2
61b6fed9d8beac1599eb2758,50200023535069,303733.17,60ec41ba55c00300382672d9,HDFC,Revenue-Mktplace,5eecc6d6449e4f7cfb1c2708,2021-01-11T00:00:00.000Z,NEFT CR-DEUT0797BGL-FLIPKART INTERNET PR IVATE LIMITED-SLICK ORGANICS PVT LTD-011 100146GN00048,shopping,,net_banking_transfer,4975.06
61b6fedad8beac1599eb2762,50200023535069,305262.12,60ec41ba55c00300382672d9,HDFC,Revenue-Mktplace,5eecc6d6449e4f7cfb1c2708,2021-01-11T00:00:00.000Z,NEFT CR-DEUT0797BGL-MYNTRA DESIGNS PRIVA TE LIMITED-SLICK ORGANICS PRIVATE LIMITE D-011100201GN00090,shopping,,net_banking_transfer,1528.95
61b6fedbd8beac1599eb2767,50200023535069,307689.67,60ec41ba55c00300382672d9,HDFC,Revenue-Mktplace,5eecc6d6449e4f7cfb1c2708,2021-01-11T00:00:00.000Z,NEFT CR-DEUT0797BGL-FLIPKART INTERNET PR,shopping,,net_banking_transfer,2427.55
61b6fedcd8beac1599eb276b,50200023535069,275314.67,60ec41ba55c00300382672d9,HDFC,direct expenses,5eecc6d6449e4f7cfb1c2708,2021-01-11T00:00:00.000Z,"NEFT DR-UBIN0531855-MOHANISH KOTHARI-NET BANK, MUM-N011211369631809-32375",,,net_banking_transfer,-32375
61b6feddd8beac1599eb2770,50200023535069,199906.67,60ec41ba55c00300382672d9,HDFC,direct expenses,5eecc6d6449e4f7cfb1c2708,2021-01-11T00:00:00.000Z,"NEFT DR-YESB0000551-VISTTA COSMETICS-NET BANK, MUM-N011211369627567-75408",,,net_banking_transfer,-75408
61b6feded8beac1599eb2777,50200023535069,159906.67,60ec41ba55c00300382672d9,HDFC,direct expenses,5eecc6d6449e4f7cfb1c2708,2021-01-11T00:00:00.000Z,"NEFT DR-PYTM0123456-PAYTM-NETBANK, MUM-N 011211369883867-40000",ewallet,,net_banking_transfer,-40000
61b6fedfd8beac1599eb277c,50200023535069,213931.61,60ec41ba55c00300382672d9,HDFC,Revenue-COD,5eecc6d6449e4f7cfb1c2708,2021-01-11T00:00:00.000Z,NEFT CR-KKBK0000958-BIGFOOT RETAIL SOLUT IONS PRIVATE LIMITED-SLICK ORGANICS PVT LTD-KKBK210114227378,,,net_banking_transfer,54024.94
61b6fedfd8beac1599eb2781,50200023535069,214490.91,60ec41ba55c00300382672d9,HDFC,Revenue-Mktplace,5eecc6d6449e4f7cfb1c2708,2021-01-11T00:00:00.000Z,NEFT CR-ICIC0000105-MANASH LIFETYLE PVT LTD-SLICKORGANICSPRIVATELIMITEDMPMUM-ICI B210110052920,,,net_banking_transfer,559.3
61b6fee0d8beac1599eb2786,50200023535069,214765.07,60ec41ba55c00300382672d9,HDFC,Revenue-Mktplace,5eecc6d6449e4f7cfb1c2708,2021-01-11T00:00:00.000Z,NEFT CR-ICIC0000105-MANASH LIFETYLE PVT LTD-SLICKORGANICSPRIVATELIMITEDMPGGN-ICI B210110052919,,,net_banking_transfer,274.16
61b6fee1d8beac1599eb278f,50200023535069,225299.54,60ec41ba55c00300382672d9,HDFC,Revenue-PG-split enabled,5eecc6d6449e4f7cfb1c2708,2021-01-11T00:00:00.000Z,NEFT CR-UTIB0001506-RAZORPAY SOFTWARE PR IVATE LIMITED-SLICK ORGANICS PVT LITD-AX ISCN0066107155,investments,,net_banking_transfer,10534.47
61b6fee2d8beac1599eb2792,50200023535069,233970.96,60ec41ba55c00300382672d9,HDFC,Revenue-PG-non-split,5eecc6d6449e4f7cfb1c2708,2021-01-12T00:00:00.000Z,UPI-PAYTM-PAYOUTS@PAYTM-PYTM0123456-1012 86226535-ALL202101122168200,ewallet,,upi,8671.42
61b6fee3d8beac1599eb2798,50200023535069,234204.4,60ec41ba55c00300382672d9,HDFC,Revenue-PG-non-split,5eecc6d6449e4f7cfb1c2708,2021-01-12T00:00:00.000Z,NEFT CR-ICIC0000031-PAYTM E COMMERCE PVT LTD-SLICK ORGANICS PVT LTD-CMS176445356 6,investments,,net_banking_transfer,233.44
61b6fee4d8beac1599eb279f,50200023535069,246825.69,60ec41ba55c00300382672d9,HDFC,Revenue-PG-split enabled,5eecc6d6449e4f7cfb1c2708,2021-01-12T00:00:00.000Z,NEFT CR-UTIB0001506-RAZORPAY SOFTWARE PR IVATE LIMITED-SLICK ORGANICS PVT LITD-AX ISCN0066138539,investments,,net_banking_transfer,12621.29
61b6fee5d8beac1599eb27a5,50200023535069,246738.13,60ec41ba55c00300382672d9,HDFC,bank charges,5eecc6d6449e4f7cfb1c2708,2021-01-12T00:00:00.000Z,.DC INTL POS TXN MARKUP+ST 010121 020121 -CDT2100102447680,,,international_transaction_arbitrage,-87.56
61b6fee6d8beac1599eb27a9,50200023535069,310790.97,60ec41ba55c00300382672d9,HDFC,Revenue-Mktplace,5eecc6d6449e4f7cfb1c2708,2021-01-12T00:00:00.000Z,IMPS-101211042195-AMAZON SELLER SERVIC-H DFC-XXXXXXXX6004-6C9YZF2URE657EKYSLICK O RGANICS PVT LTD,shopping,,net_banking_transfer,64052.84
61b6fee7d8beac1599eb27af,50200023535069,649067.94,60ec41ba55c00300382672d9,HDFC,Revenue-Mktplace,5eecc6d6449e4f7cfb1c2708,2021-01-12T00:00:00.000Z,NEFT CR-DEUT0797BGL-AMAZON PAY (INDIA) P,shopping,,net_banking_transfer,338276.97
61b6fee8d8beac1599eb27b7,50200023535069,648690.57,60ec41ba55c00300382672d9,HDFC,bank charges,5eecc6d6449e4f7cfb1c2708,2021-01-12T00:00:00.000Z,.DC INTL POS TXN MARKUP+ST 040121 050121 -CDT2100102447680,,,international_transaction_arbitrage,-377.37
61b6fee9d8beac1599eb27bc,50200023535069,656033.1,60ec41ba55c00300382672d9,HDFC,Revenue-PG-split enabled,5eecc6d6449e4f7cfb1c2708,2021-01-12T00:00:00.000Z,NEFT CR-UTIB0001506-RAZORPAY SOFTWARE PR IVATE LIMITED-SLICK ORGANICS PVT LITD-AX ISCN0066215661,investments,,net_banking_transfer,7342.53
61b6feead8beac1599eb27c0,50200023535069,652426.37,60ec41ba55c00300382672d9,HDFC,direct expenses,5eecc6d6449e4f7cfb1c2708,2021-01-12T00:00:00.000Z,POS 514834XXXXXX9486 WWW.FAQPRIME.COM,,,debit_card,-3606.73
61b6feebd8beac1599eb27c4,50200023535069,662160.15,60ec41ba55c00300382672d9,HDFC,Revenue-PG-non-split,5eecc6d6449e4f7cfb1c2708,2021-01-13T00:00:00.000Z,UPI-PAYTM-PAYOUTS@PAYTM-PYTM0123456-1013 08066507-ALL202101132168200,ewallet,,upi,9733.78
61b6feecd8beac1599eb27cc,50200023535069,679499.18,60ec41ba55c00300382672d9,HDFC,Revenue-PG-split enabled,5eecc6d6449e4f7cfb1c2708,2021-01-13T00:00:00.000Z,NEFT CR-UTIB0001506-RAZORPAY SOFTWARE PR IVATE LIMITED-SLICK ORGANICS PVT LITD-AX ISCN0066259334,investments,,net_banking_transfer,17339.03
61b6feedd8beac1599eb27d1,50200023535069,680302.63,60ec41ba55c00300382672d9,HDFC,Revenue-Mktplace,5eecc6d6449e4f7cfb1c2708,2021-01-13T00:00:00.000Z,NEFT CR-DEUT0797BGL-FLIPKART INTERNET PR IVATE LIMITED-SLICK ORGANICS PVT LTD-011 300109GN00031,shopping,,net_banking_transfer,803.45
61b6feeed8beac1599eb27db,50200023535069,681633.27,60ec41ba55c00300382672d9,HDFC,Revenue-Mktplace,5eecc6d6449e4f7cfb1c2708,2021-01-13T00:00:00.000Z,NEFT CR-DEUT0797BGL-MYNTRA DESIGNS PRIVA TE LIMITED-SLICK ORGANICS PRIVATE LIMITE D-011300228GN00111,shopping,,net_banking_transfer,1330.64
61b6feefd8beac1599eb27de,50200023535069,685231.24,60ec41ba55c00300382672d9,HDFC,Revenue-Mktplace,5eecc6d6449e4f7cfb1c2708,2021-01-13T00:00:00.000Z,NEFT CR-DEUT0797BGL-FLIPKART INTERNET PR IVATE LIMITED-SLICK ORGANICS PVT LTD-011 300068GN00049,shopping,,net_banking_transfer,3597.97
61b6fef0d8beac1599eb27e4,50200023535069,715929.48,60ec41ba55c00300382672d9,HDFC,Revenue-COD,5eecc6d6449e4f7cfb1c2708,2021-01-13T00:00:00.000Z,NEFT CR-KKBK0000958-BIGFOOT RETAIL SOLUT IONS PRIVATE LIMITED-SLICK ORGANICS PVT LTD-KKBK210134745188,,,net_banking_transfer,30698.24
61b6fef1d8beac1599eb27ec,50200023535069,729745.19,60ec41ba55c00300382672d9,HDFC,Revenue-PG-split enabled,5eecc6d6449e4f7cfb1c2708,2021-01-13T00:00:00.000Z,NEFT CR-UTIB0001506-RAZORPAY SOFTWARE PR IVATE LIMITED-SLICK ORGANICS PVT LITD-AX ISCN0066359826,investments,,net_banking_transfer,13815.71
61b6fef2d8beac1599eb27f2,50200023535069,679745.19,60ec41ba55c00300382672d9,HDFC,Marketing Expense,5eecc6d6449e4f7cfb1c2708,2021-01-13T00:00:00.000Z,POS 514834XXXXXX9486 TML*GOOGLE ADWOR,,,debit_card,-50000
61b6fef3d8beac1599eb27fa,50200023535069,701684.44,60ec41ba55c00300382672d9,HDFC,Revenue-PG-non-split,5eecc6d6449e4f7cfb1c2708,2021-01-14T00:00:00.000Z,UPI-PAYTM-PAYOUTS@PAYTM-PYTM0123456-1014 29660616-ALL202101142168200,ewallet,,upi,21939.25
61b6fef4d8beac1599eb27fe,50200023535069,711806.08,60ec41ba55c00300382672d9,HDFC,Revenue-PG-split enabled,5eecc6d6449e4f7cfb1c2708,2021-01-14T00:00:00.000Z,NEFT CR-UTIB0001506-RAZORPAY SOFTWARE PR,,,net_banking_transfer,10121.64
61b6fef5d8beac1599eb2803,50200023535069,712284.19,60ec41ba55c00300382672d9,HDFC,Revenue-PG-split enabled,5eecc6d6449e4f7cfb1c2708,2021-01-14T00:00:00.000Z,NEFT CR-YESB0000001-RAZORPAY SOFTWARE P L NODAL ACCOUNT-SLICKORGANICS-N014210495 246742,investments,,net_banking_transfer,478.11
61b6fef6d8beac1599eb280c,50200023535069,277284.19,60ec41ba55c00300382672d9,HDFC,direct expenses,5eecc6d6449e4f7cfb1c2708,2021-01-14T00:00:00.000Z,FD BOOKED - 50300489334405 : SLICK ORGAN ICS PVT LTD,investments,,investment,-435000
61b6fef7d8beac1599eb280f,50200023535069,284066.96,60ec41ba55c00300382672d9,HDFC,Revenue-PG-split enabled,5eecc6d6449e4f7cfb1c2708,2021-01-14T00:00:00.000Z,NEFT CR-UTIB0001506-RAZORPAY SOFTWARE PR IVATE LIMITED-SLICK ORGANICS PVT LITD-AX ISCN0066466983,investments,,net_banking_transfer,6782.77
61b6fef7d8beac1599eb2816,50200023535069,285166.45,60ec41ba55c00300382672d9,HDFC,Transfer in/Revenue-other,5eecc6d6449e4f7cfb1c2708,2021-01-14T00:00:00.000Z,NEFT CR-YESB0000001-ILLUMINAR MEDIA-SLIC K ORGANICS PVT LTD-N014210495380873,,,net_banking_transfer,1099.49
61b6fef8d8beac1599eb281d,50200023535069,301427.58,60ec41ba55c00300382672d9,HDFC,Revenue-PG-non-split,5eecc6d6449e4f7cfb1c2708,2021-01-15T00:00:00.000Z,UPI-PAYTM-PAYOUTS@PAYTM-PYTM0123456-1015 49392202-ALL202101152168200,ewallet,,upi,16261.13
61b6fef9d8beac1599eb2822,50200023535069,251427.58,60ec41ba55c00300382672d9,HDFC,SAAS/tech expense,5eecc6d6449e4f7cfb1c2708,2021-01-15T00:00:00.000Z,VHDF9658281078/BILLDKAMAZONSELLERSE,shopping,,Other,-50000
61b6fefad8beac1599eb2826,50200023535069,253323.81,60ec41ba55c00300382672d9,HDFC,Revenue-Mktplace,5eecc6d6449e4f7cfb1c2708,2021-01-15T00:00:00.000Z,NEFT CR-DEUT0797BGL-FLIPKART INTERNET PR IVATE LIMITED-SLICK ORGANICS PVT LTD-011 500106GN00072,shopping,,net_banking_transfer,1896.23
61b6fefbd8beac1599eb282d,50200023535069,268220.23,60ec41ba55c00300382672d9,HDFC,Revenue-PG-split enabled,5eecc6d6449e4f7cfb1c2708,2021-01-15T00:00:00.000Z,NEFT CR-UTIB0001506-RAZORPAY SOFTWARE PR IVATE LIMITED-SLICK ORGANICS PVT LITD-AX ISCN0066501364,investments,,net_banking_transfer,14896.42
61b6fefcd8beac1599eb2833,50200023535069,269338.12,60ec41ba55c00300382672d9,HDFC,Revenue-Mktplace,5eecc6d6449e4f7cfb1c2708,2021-01-15T00:00:00.000Z,NEFT CR-DEUT0797BGL-MYNTRA DESIGNS PRIVA TE LIMITED-SLICK ORGANICS PRIVATE LIMITE D-011500232GN00085,shopping,,net_banking_transfer,1117.89
61b6fefdd8beac1599eb2837,50200023535069,109338.12,60ec41ba55c00300382672d9,HDFC,direct expenses,5eecc6d6449e4f7cfb1c2708,2021-01-15T00:00:00.000Z,"NEFT DR-YESB0000551-VISTTA COSMETICS-NET BANK, MUM-N015211374811024-160000",,,net_banking_transfer,-160000
61b6fefed8beac1599eb283a,50200023535069,110526.08,60ec41ba55c00300382672d9,HDFC,Revenue-Mktplace,5eecc6d6449e4f7cfb1c2708,2021-01-15T00:00:00.000Z,NEFT CR-DEUT0784BBY-TATA UNISTORE LIMITE D-SLICK ORGANICS PVT LTD-011500097GN0016 1,investments,,net_banking_transfer,1187.96
61b6feffd8beac1599eb283f,50200023535069,112403.36,60ec41ba55c00300382672d9,HDFC,Revenue-Mktplace,5eecc6d6449e4f7cfb1c2708,2021-01-15T00:00:00.000Z,NEFT CR-DEUT0784BBY-TATA UNISTORE LTD-NO,,,net_banking_transfer,1877.28
61b6ff00d8beac1599eb2849,50200023535069,112621.06,60ec41ba55c00300382672d9,HDFC,Revenue-Mktplace,5eecc6d6449e4f7cfb1c2708,2021-01-15T00:00:00.000Z,NEFT CR-ICIC0000105-MANASH LIFETYLE PVT LTD-SLICKORGANICSPRIVATELIMITEDMPMUM-ICI B210150024129,,,net_banking_transfer,217.7
61b6ff01d8beac1599eb2850,50200023535069,113024.95,60ec41ba55c00300382672d9,HDFC,Revenue-Mktplace,5eecc6d6449e4f7cfb1c2708,2021-01-15T00:00:00.000Z,NEFT CR-ICIC0000105-MANASH LIFETYLE PVT LTD-SLICKORGANICSPRIVATELIMITEDMPGGN-ICI B210150024128,,,net_banking_transfer,403.89
61b6ff02d8beac1599eb2858,50200023535069,204194.38,60ec41ba55c00300382672d9,HDFC,Revenue-COD,5eecc6d6449e4f7cfb1c2708,2021-01-15T00:00:00.000Z,NEFT CR-KKBK0000958-BIGFOOT RETAIL SOLUT IONS PRIVATE LIMITED-SLICK ORGANICS PVT LTD-KKBK210155075227,,,net_banking_transfer,91169.43
61b6ff03d8beac1599eb285c,50200023535069,217508.67,60ec41ba55c00300382672d9,HDFC,Revenue-PG-split enabled,5eecc6d6449e4f7cfb1c2708,2021-01-15T00:00:00.000Z,NEFT CR-UTIB0001506-RAZORPAY SOFTWARE PR IVATE LIMITED-SLICK ORGANICS PVT LITD-AX ISCN0066579918,investments,,net_banking_transfer,13314.29
61b6ff04d8beac1599eb2860,50200023535069,233509.29,60ec41ba55c00300382672d9,HDFC,Revenue-PG-non-split,5eecc6d6449e4f7cfb1c2708,2021-01-16T00:00:00.000Z,UPI-PAYTM-PAYOUTS@PAYTM-PYTM0123456-1016 68869973-ALL202101162168200,ewallet,,upi,16000.62
61b6ff05d8beac1599eb2868,50200023535069,234602.29,60ec41ba55c00300382672d9,HDFC,Revenue-Mktplace,5eecc6d6449e4f7cfb1c2708,2021-01-16T00:00:00.000Z,NEFT CR-KKBK0000958-SURFBOATS SOLUTIONS PVT LTD-SLICK ORGANICS PRIVATE LIMITED-K KBK210165135471,investments,,net_banking_transfer,1093
61b6ff06d8beac1599eb287d,50200023535069,245482.85,60ec41ba55c00300382672d9,HDFC,Revenue-PG-split enabled,5eecc6d6449e4f7cfb1c2708,2021-01-16T00:00:00.000Z,NEFT CR-UTIB0001506-RAZORPAY SOFTWARE PR IVATE LIMITED-SLICK ORGANICS PVT LITD-AX ISCN0066596824,investments,,net_banking_transfer,10880.56
61b6ff07d8beac1599eb28ea,50200023535069,265949.55,60ec41ba55c00300382672d9,HDFC,Revenue-PG-split enabled,5eecc6d6449e4f7cfb1c2708,2021-01-16T00:00:00.000Z,NEFT CR-UTIB0001506-RAZORPAY SOFTWARE PR IVATE LIMITED-SLICK ORGANICS PVT LITD-AX ISCN0066644803,investments,,net_banking_transfer,20466.7
61b6ff08d8beac1599eb28ed,50200023535069,165949.55,60ec41ba55c00300382672d9,HDFC,SAAS/tech expense,5eecc6d6449e4f7cfb1c2708,2021-01-16T00:00:00.000Z,VHDF9662722570/BILLDKAMAZONSELLERSE,shopping,,Other,-100000
61b6ff09d8beac1599eb28f2,50200023535069,165217.37,60ec41ba55c00300382672d9,HDFC,direct expenses,5eecc6d6449e4f7cfb1c2708,2021-01-16T00:00:00.000Z,POS 514834XXXXXX9486 MANYCHAT COM PRO,,,debit_card,-732.18
61b6ff0ad8beac1599eb28fa,50200023535069,172925.36,60ec41ba55c00300382672d9,HDFC,Revenue-PG-non-split,5eecc6d6449e4f7cfb1c2708,2021-01-17T00:00:00.000Z,UPI-PAYTM-PAYOUTS@PAYTM-PYTM0123456-1017 89259233-ALL202101172168200,ewallet,,upi,7707.99
61b6ff0bd8beac1599eb28fc,50200023535069,183290.7,60ec41ba55c00300382672d9,HDFC,Revenue-PG-non-split,5eecc6d6449e4f7cfb1c2708,2021-01-18T00:00:00.000Z,UPI-PAYTM-PAYOUTS@PAYTM-PYTM0123456-1018 08922224-ALL202101182168200,ewallet,,upi,10365.34
61b6ff0cd8beac1599eb2914,50200023535069,185078.9,60ec41ba55c00300382672d9,HDFC,Revenue-Mktplace,5eecc6d6449e4f7cfb1c2708,2021-01-18T00:00:00.000Z,NEFT CR-DEUT0797BGL-FLIPKART INTERNET PR,shopping,,net_banking_transfer,1788.2
61b6ff0dd8beac1599eb2925,50200023535069,221629.45,60ec41ba55c00300382672d9,HDFC,Revenue-PG-split enabled,5eecc6d6449e4f7cfb1c2708,2021-01-18T00:00:00.000Z,NEFT CR-UTIB0001506-RAZORPAY SOFTWARE PR IVATE LIMITED-SLICK ORGANICS PVT LITD-AX ISCN0066678096,investments,,net_banking_transfer,36550.55
61b6ff0ed8beac1599eb2938,50200023535069,121629.45,60ec41ba55c00300382672d9,HDFC,direct expenses,5eecc6d6449e4f7cfb1c2708,2021-01-18T00:00:00.000Z,57500000443889-TPT-100000-WEBKLIPPER TEC HNOLOGIES PRIVATE LIMITED,,,net_banking_transfer,-100000
61b6ff0fd8beac1599eb2940,50200023535069,122110.26,60ec41ba55c00300382672d9,HDFC,Revenue-Mktplace,5eecc6d6449e4f7cfb1c2708,2021-01-18T00:00:00.000Z,NEFT CR-DEUT0797BGL-MYNTRA DESIGNS PRIVA TE LIMITED-SLICK ORGANICS PRIVATE LIMITE D-011800202GN00055,shopping,,net_banking_transfer,480.81
61b6ff10d8beac1599eb294a,50200023535069,122917.33,60ec41ba55c00300382672d9,HDFC,Revenue-Mktplace,5eecc6d6449e4f7cfb1c2708,2021-01-18T00:00:00.000Z,NEFT CR-ICIC0000105-MANASH LIFETYLE PVT LTD-SLICKORGANICSPRIVATELIMITED(MP)GGN-I CIB210180022816,,,net_banking_transfer,807.07
61b6ff11d8beac1599eb295c,50200023535069,102917.33,60ec41ba55c00300382672d9,HDFC,direct expenses,5eecc6d6449e4f7cfb1c2708,2021-01-18T00:00:00.000Z,CHQ PAID TO SARVAN KUMAR - CHQ PAID - DE VLI ROAD K,,,chq,-20000
61b6ff12d8beac1599eb2966,50200023535069,103525.35,60ec41ba55c00300382672d9,HDFC,Revenue-Mktplace,5eecc6d6449e4f7cfb1c2708,2021-01-18T00:00:00.000Z,NEFT CR-DEUT0797BGL-MYNTRA DESIGNS PRIVA TE LIMITED-SLICK ORGANICS PRIVATE LIMITE D-011800162GN00007,shopping,,net_banking_transfer,608.02
61b6ff13d8beac1599eb2971,50200023535069,105418.92,60ec41ba55c00300382672d9,HDFC,Revenue-Mktplace,5eecc6d6449e4f7cfb1c2708,2021-01-18T00:00:00.000Z,NEFT CR-DEUT0797BGL-FLIPKART INTERNET PR IVATE LIMITED-SLICK ORGANICS PVT LTD-011 800129GN00250,shopping,,net_banking_transfer,1893.57
61b6ff14d8beac1599eb297d,50200023535069,110664.15,60ec41ba55c00300382672d9,HDFC,Revenue-PG-split enabled,5eecc6d6449e4f7cfb1c2708,2021-01-18T00:00:00.000Z,NEFT CR-UTIB0001506-RAZORPAY SOFTWARE PR IVATE LIMITED-SLICK ORGANICS PVT LITD-AX ISCN0066737713,investments,,net_banking_transfer,5245.23
61b6ff16d8beac1599eb2993,50200023535069,124155.22,60ec41ba55c00300382672d9,HDFC,Revenue-PG-non-split,5eecc6d6449e4f7cfb1c2708,2021-01-19T00:00:00.000Z,UPI-PAYTM-PAYOUTS@PAYTM-PYTM0123456-1019 29071925-ALL202101192168200,ewallet,,upi,13491.07
61b6ff17d8beac1599eb299a,50200023535069,155389.42,60ec41ba55c00300382672d9,HDFC,Revenue-PG-split enabled,5eecc6d6449e4f7cfb1c2708,2021-01-19T00:00:00.000Z,NEFT CR-UTIB0001506-RAZORPAY SOFTWARE PR IVATE LIMITED-SLICK ORGANICS PVT LITD-AX ISCN0066778093,investments,,net_banking_transfer,31234.2
61b6ff18d8beac1599eb299f,50200023535069,590389.42,60ec41ba55c00300382672d9,HDFC,Internal Transfers,5eecc6d6449e4f7cfb1c2708,2021-01-19T00:00:00.000Z,IB FUNDS TRANSFER CR-50200035187206 -SL ICK ORGANICS PVT LTD,investments,,Other,435000
61b6ff19d8beac1599eb29a8,50200023535069,335389.42,60ec41ba55c00300382672d9,HDFC,SAAS/tech expense,5eecc6d6449e4f7cfb1c2708,2021-01-19T00:00:00.000Z,VHDF9669193234/BILLDKAMAZONSELLERSE,shopping,,Other,-255000
61b6ff1ad8beac1599eb29af,50200023535069,285389.42,60ec41ba55c00300382672d9,HDFC,direct expenses,5eecc6d6449e4f7cfb1c2708,2021-01-19T00:00:00.000Z,"NEFT DR-PYTM0123456-PAYTM-NETBANK, MUM-N",ewallet,,net_banking_transfer,-50000
61b6ff1bd8beac1599eb29b7,50200023535069,356655.82,60ec41ba55c00300382672d9,HDFC,Revenue-Mktplace,5eecc6d6449e4f7cfb1c2708,2021-01-19T00:00:00.000Z,IMPS-101911356872-AMAZON SELLER SERVIC-H DFC-XXXXXXXX6004-4P1M6R88TYZVZVQ8SLICK O RGANICS PVT LTD,shopping,,net_banking_transfer,71266.4
61b6ff1cd8beac1599eb29bc,50200023535069,681328.05,60ec41ba55c00300382672d9,HDFC,Revenue-Mktplace,5eecc6d6449e4f7cfb1c2708,2021-01-19T00:00:00.000Z,NEFT CR-DEUT0797BGL-AMAZON PAY (INDIA) P RIVATE LIMITED-SLICK ORGANICS PVT LTD-01 1900114GN00624,shopping,,net_banking_transfer,324672.23
61b6ff1dd8beac1599eb29c3,50200023535069,677198.05,60ec41ba55c00300382672d9,HDFC,direct expenses,5eecc6d6449e4f7cfb1c2708,2021-01-19T00:00:00.000Z,COMM ON GUARANTEE ISSUED,,,Other,-4130
61b6ff1ed8beac1599eb29ce,50200023535069,677618.81,60ec41ba55c00300382672d9,HDFC,Revenue-Mktplace,5eecc6d6449e4f7cfb1c2708,2021-01-19T00:00:00.000Z,NEFT CR-ICIC0000105-MANASH LIFETYLE PVT LTD-SLICKORGANICSPRIVATELIMITEDMPGGN-ICI B210190029512,,,net_banking_transfer,420.76
61b6ff1fd8beac1599eb29d2,50200023535069,677681.11,60ec41ba55c00300382672d9,HDFC,Revenue-Mktplace,5eecc6d6449e4f7cfb1c2708,2021-01-19T00:00:00.000Z,NEFT CR-ICIC0000105-MANASH LIFETYLE PVT LTD-SLICKORGANICSPRIVATELIMITEDMPMUM-ICI B210190029513,,,net_banking_transfer,62.3
61b6ff20d8beac1599eb29db,50200023535069,788262.07,60ec41ba55c00300382672d9,HDFC,Revenue-PG-split enabled,5eecc6d6449e4f7cfb1c2708,2021-01-19T00:00:00.000Z,NEFT CR-UTIB0001506-RAZORPAY SOFTWARE PR IVATE LIMITED-SLICK ORGANICS PVT LITD-AX ISCN0066841835,investments,,net_banking_transfer,110580.96
61b6ff21d8beac1599eb29e5,50200023535069,876165.65,60ec41ba55c00300382672d9,HDFC,Transfer in/Revenue-other,5eecc6d6449e4f7cfb1c2708,2021-01-20T00:00:00.000Z,IMPS-102005653518-NA-HDFC-XXXXXXXXXX0007 -ALL20210120216820000330830668628,,,net_banking_transfer,87903.58
61b6ff22d8beac1599eb29ec,50200023535069,985727.73,60ec41ba55c00300382672d9,HDFC,Revenue-PG-split enabled,5eecc6d6449e4f7cfb1c2708,2021-01-20T00:00:00.000Z,NEFT CR-UTIB0001506-RAZORPAY SOFTWARE PR IVATE LIMITED-SLICK ORGANICS PVT LITD-AX ISCN0066885120,investments,,net_banking_transfer,109562.08
61b6ff23d8beac1599eb29f4,50200023535069,980597.29,60ec41ba55c00300382672d9,HDFC,direct expenses,5eecc6d6449e4f7cfb1c2708,2021-01-20T00:00:00.000Z,POS 514834XXXXXX9486 FEEDBACKFIVE,,,debit_card,-5130.44
61b6ff24d8beac1599eb29ff,50200023535069,820597.29,60ec41ba55c00300382672d9,HDFC,direct expenses,5eecc6d6449e4f7cfb1c2708,2021-01-20T00:00:00.000Z,"NEFT DR-YESB0000551-VISTTA COSMETICS-NET BANK, MUM-N020211379040046-160000",,,net_banking_transfer,-160000
61b6ff25d8beac1599eb2a07,50200023535069,820760.96,60ec41ba55c00300382672d9,HDFC,Revenue-Mktplace,5eecc6d6449e4f7cfb1c2708,2021-01-20T00:00:00.000Z,NEFT CR-DEUT0797BGL-MYNTRA DESIGNS PRIVA TE LIMITED-SLICK ORGANICS PRIVATE LIMITE D-012000378GN00105,shopping,,net_banking_transfer,163.67
61b6ff26d8beac1599eb2a11,50200023535069,821424.69,60ec41ba55c00300382672d9,HDFC,Revenue-Mktplace,5eecc6d6449e4f7cfb1c2708,2021-01-20T00:00:00.000Z,NEFT CR-DEUT0797BGL-MYNTRA DESIGNS PRIVA TE LIMITED-SLICK ORGANICS PRIVATE LIMITE D-012000371GN00111,shopping,,net_banking_transfer,663.73
61b6ff26d8beac1599eb2a17,50200023535069,818926.83,60ec41ba55c00300382672d9,HDFC,direct expenses,5eecc6d6449e4f7cfb1c2708,2021-01-20T00:00:00.000Z,POS 514834XXXXXX9486 AMZNMKTPLACE AMA,,,debit_card,-2497.86
61b6ff27d8beac1599eb2a1d,50200023535069,821567.12,60ec41ba55c00300382672d9,HDFC,Revenue-COD,5eecc6d6449e4f7cfb1c2708,2021-01-20T00:00:00.000Z,NEFT CR-KKBK0000958-BIGFOOT RETAIL SOLUT,,,net_banking_transfer,2640.29
61b6ff28d8beac1599eb2a21,50200023535069,771567.12,60ec41ba55c00300382672d9,HDFC,Marketing Expense,5eecc6d6449e4f7cfb1c2708,2021-01-20T00:00:00.000Z,POS 514834XXXXXX9486 TML*GOOGLE ADWOR,,,debit_card,-50000
61b6ff29d8beac1599eb2a26,50200023535069,792965.67,60ec41ba55c00300382672d9,HDFC,Revenue-PG-split enabled,5eecc6d6449e4f7cfb1c2708,2021-01-20T00:00:00.000Z,NEFT CR-UTIB0001506-RAZORPAY SOFTWARE PR IVATE LIMITED-SLICK ORGANICS PVT LITD-AX ISCN0066947948,investments,,net_banking_transfer,21398.55
61b6ff2ad8beac1599eb2a30,50200023535069,786440.81,60ec41ba55c00300382672d9,HDFC,direct expenses,5eecc6d6449e4f7cfb1c2708,2021-01-20T00:00:00.000Z,POS 514834XXXXXX9486 HOTJAR,,,debit_card,-6524.86
61b6ff2bd8beac1599eb2a34,50200023535069,792749.21,60ec41ba55c00300382672d9,HDFC,Revenue-PG-non-split,5eecc6d6449e4f7cfb1c2708,2021-01-21T00:00:00.000Z,UPI-PAYTM-PAYOUTS@PAYTM-PYTM0123456-1021 70337329-ALL202101212168200,ewallet,,upi,6308.4
61b6ff2cd8beac1599eb2a37,50200023535069,817842.23,60ec41ba55c00300382672d9,HDFC,Revenue-PG-split enabled,5eecc6d6449e4f7cfb1c2708,2021-01-21T00:00:00.000Z,NEFT CR-UTIB0001506-RAZORPAY SOFTWARE PR IVATE LIMITED-SLICK ORGANICS PVT LITD-AX ISCN0066991163,investments,,net_banking_transfer,25093.02
61b6ff2dd8beac1599eb2a3e,50200023535069,819238.8,60ec41ba55c00300382672d9,HDFC,Revenue-PG-non-split,5eecc6d6449e4f7cfb1c2708,2021-01-21T00:00:00.000Z,NEFT CR-SCBL0036001-STRIPE INDIA PRIVATE LIMITED-SLICK ORGANICS PRIVATE LIMITED- SSG17413Q0170648,investments,,net_banking_transfer,1396.57
61b6ff2ed8beac1599eb2a46,50200023535069,782222.8,60ec41ba55c00300382672d9,HDFC,direct expenses,5eecc6d6449e4f7cfb1c2708,2021-01-21T00:00:00.000Z,"NEFT DR-KKBK0000173-MATRIX PRINTING SOLU TIONS PRIVATE LIMITE-NETBANK, MUM-N02121 1380377210-37016",,,net_banking_transfer,-37016
61b6ff2fd8beac1599eb2a4b,50200023535069,607222.8,60ec41ba55c00300382672d9,HDFC,direct expenses,5eecc6d6449e4f7cfb1c2708,2021-01-21T00:00:00.000Z,IMPS-102114158096-PAYTM-PYTM-XXXXXXXX383 9-175000,ewallet,,net_banking_transfer,-175000
61b6ff30d8beac1599eb2a51,50200023535069,624878.38,60ec41ba55c00300382672d9,HDFC,Revenue-PG-split enabled,5eecc6d6449e4f7cfb1c2708,2021-01-21T00:00:00.000Z,NEFT CR-UTIB0001506-RAZORPAY SOFTWARE PR IVATE LIMITED-SLICK ORGANICS PVT LITD-AX ISCN0067055212,investments,,net_banking_transfer,17655.58
61b6ff31d8beac1599eb2a55,50200023535069,624924.6,60ec41ba55c00300382672d9,HDFC,Revenue-Mktplace,5eecc6d6449e4f7cfb1c2708,2021-01-21T00:00:00.000Z,NEFT CR-ICIC0000105-MANASH LIFETYLE PVT LTD-SLICK ORGANICS PRIVATE LIMITED MP MU M-ICIB210210048777,,,net_banking_transfer,46.22
61b6ff32d8beac1599eb2a5e,50200023535069,624775.64,60ec41ba55c00300382672d9,HDFC,bank charges,5eecc6d6449e4f7cfb1c2708,2021-01-21T00:00:00.000Z,.DC INTL POS TXN MARKUP+ST 120121 140121 -CDT2100102447680,,,international_transaction_arbitrage,-148.96
61b6ff33d8beac1599eb2a61,50200023535069,640467.43,60ec41ba55c00300382672d9,HDFC,Revenue-PG-non-split,5eecc6d6449e4f7cfb1c2708,2021-01-22T00:00:00.000Z,UPI-PAYTM-PAYOUTS@PAYTM-PYTM0123456-1022 91031071-ALL202101222168200,ewallet,,upi,15691.79
61b6ff34d8beac1599eb2a6b,50200023535069,140467.43,60ec41ba55c00300382672d9,HDFC,direct expenses,5eecc6d6449e4f7cfb1c2708,2021-01-22T00:00:00.000Z,02711600008220-TPT-500000-VARUN SINGH,,,net_banking_transfer,-500000
61b6ff35d8beac1599eb2a6f,50200023535069,153317.07,60ec41ba55c00300382672d9,HDFC,Revenue-Mktplace,5eecc6d6449e4f7cfb1c2708,2021-01-22T00:00:00.000Z,NEFT CR-DEUT0797BGL-FLIPKART INTERNET PR,shopping,,net_banking_transfer,12849.64
61b6ff36d8beac1599eb2a74,50200023535069,168581.29,60ec41ba55c00300382672d9,HDFC,Revenue-PG-split enabled,5eecc6d6449e4f7cfb1c2708,2021-01-22T00:00:00.000Z,NEFT CR-UTIB0001506-RAZORPAY SOFTWARE PR IVATE LIMITED-SLICK ORGANICS PVT LITD-AX ISCN0067084135,investments,,net_banking_transfer,15264.22
61b6ff37d8beac1599eb2a7a,50200023535069,168682.13,60ec41ba55c00300382672d9,HDFC,Revenue-Mktplace,5eecc6d6449e4f7cfb1c2708,2021-01-22T00:00:00.000Z,NEFT CR-DEUT0797BGL-MYNTRA DESIGNS PRIVA TE LIMITED-SLICK ORGANICS PRIVATE LIMITE D-012200343GN00057,shopping,,net_banking_transfer,100.84
61b6ff38d8beac1599eb2a80,50200023535069,170303.54,60ec41ba55c00300382672d9,HDFC,Revenue-PG-split enabled,5eecc6d6449e4f7cfb1c2708,2021-01-22T00:00:00.000Z,NEFT CR-YESB0000001-RAZORPAY SOFTWARE P L NODAL ACCOUNT-SLICKORGANICS-N022210499 091599,investments,,net_banking_transfer,1621.41
61b6ff39d8beac1599eb2a86,50200023535069,170468.21,60ec41ba55c00300382672d9,HDFC,Revenue-Mktplace,5eecc6d6449e4f7cfb1c2708,2021-01-22T00:00:00.000Z,NEFT CR-ICIC0000105-MANASH LIFETYLE PVT LTD-SLICKORGANICSPRIVATELIMITEDMPGGN-ICI B210220030769,,,net_banking_transfer,164.67
61b6ff3ad8beac1599eb2a8a,50200023535069,171194.52,60ec41ba55c00300382672d9,HDFC,Revenue-Mktplace,5eecc6d6449e4f7cfb1c2708,2021-01-22T00:00:00.000Z,NEFT CR-ICIC0000105-MANASH LIFETYLE PVT LTD-SLICKORGANICSPRIVATELIMITEDMPMUM-ICI B210220030770,,,net_banking_transfer,726.31
61b6ff3bd8beac1599eb2a8f,50200023535069,172068.44,60ec41ba55c00300382672d9,HDFC,Revenue-Mktplace,5eecc6d6449e4f7cfb1c2708,2021-01-22T00:00:00.000Z,NEFT CR-DEUT0797BGL-MYNTRA DESIGNS PRIVA TE LIMITED-SLICK ORGANICS PRIVATE LIMITE D-012200338GN00052,shopping,,net_banking_transfer,873.92
61b6ff3cd8beac1599eb2a98,50200023535069,176488.36,60ec41ba55c00300382672d9,HDFC,Revenue-Mktplace,5eecc6d6449e4f7cfb1c2708,2021-01-22T00:00:00.000Z,NEFT CR-DEUT0797BGL-FLIPKART INTERNET PR IVATE LIMITED-SLICK ORGANICS PVT LTD-012 200135GN00103,shopping,,net_banking_transfer,4419.92
61b6ff3cd8beac1599eb2a9c,50200023535069,197772.5,60ec41ba55c00300382672d9,HDFC,Revenue-COD,5eecc6d6449e4f7cfb1c2708,2021-01-22T00:00:00.000Z,NEFT CR-KKBK0000958-BIGFOOT RETAIL SOLUT IONS PRIVATE LIMITED-SLICK ORGANICS PVT LTD-KKBK210226297652,,,net_banking_transfer,21284.14
61b6ff3dd8beac1599eb2aa3,50200023535069,198629.9,60ec41ba55c00300382672d9,HDFC,Revenue-Mktplace,5eecc6d6449e4f7cfb1c2708,2021-01-22T00:00:00.000Z,NEFT CR-DEUT0784BBY-TATA UNISTORE LIMITE D-SLICK ORGANICS PVT LTD-012201017GN0018 2,investments,,net_banking_transfer,857.4
61b6ff3ed8beac1599eb2aac,50200023535069,209979.54,60ec41ba55c00300382672d9,HDFC,Revenue-PG-split enabled,5eecc6d6449e4f7cfb1c2708,2021-01-22T00:00:00.000Z,NEFT CR-UTIB0001506-RAZORPAY SOFTWARE PR,,,net_banking_transfer,11349.64
61b6ff3fd8beac1599eb2ab2,50200023535069,210457.65,60ec41ba55c00300382672d9,HDFC,Transfer in/Revenue-other,5eecc6d6449e4f7cfb1c2708,2021-01-22T00:00:00.000Z,NEFT CR-YESB0000001-ILUMINAR MEDIA-SLICK ORGANICS PVT. LTD-N022210499195240,,,net_banking_transfer,478.11
61b6ff40d8beac1599eb2ab6,50200023535069,210488,60ec41ba55c00300382672d9,HDFC,Adjustments/Reversal,5eecc6d6449e4f7cfb1c2708,2021-01-22T00:00:00.000Z,DEBIT CARD PUR ADJ DT 20/01/21,,,Other,30.35
61b6ff41d8beac1599eb2b06,50200023535069,228685.73,60ec41ba55c00300382672d9,HDFC,Revenue-PG-non-split,5eecc6d6449e4f7cfb1c2708,2021-01-23T00:00:00.000Z,UPI-PAYTM-PAYOUTS@PAYTM-PYTM0123456-1023 12213937-ALL202101232168200,ewallet,,upi,18197.73
61b6ff42d8beac1599eb2b34,50200023535069,128685.73,60ec41ba55c00300382672d9,HDFC,SAAS/tech expense,5eecc6d6449e4f7cfb1c2708,2021-01-23T00:00:00.000Z,VHDF9681661396/BILLDKAMAZONSELLERSE,shopping,,Other,-100000
61b6ff43d8beac1599eb2b38,50200023535069,140574.98,60ec41ba55c00300382672d9,HDFC,Revenue-PG-non-split,5eecc6d6449e4f7cfb1c2708,2021-01-24T00:00:00.000Z,UPI-PAYTM-PAYOUTS@PAYTM-PYTM0123456-1024 34192935-ALL202101242168200,ewallet,,upi,11889.25
61b6ff44d8beac1599eb2b3d,50200023535069,15574.98,60ec41ba55c00300382672d9,HDFC,direct expenses,5eecc6d6449e4f7cfb1c2708,2021-01-24T00:00:00.000Z,02711600008220-TPT-125000-VARUN SINGH,,,net_banking_transfer,-125000
61b6ff45d8beac1599eb2b43,50200023535069,26454.33,60ec41ba55c00300382672d9,HDFC,Revenue-PG-non-split,5eecc6d6449e4f7cfb1c2708,2021-01-25T00:00:00.000Z,UPI-PAYTM-PAYOUTS@PAYTM-PYTM0123456-1025 56718588-ALL202101252168200,ewallet,,upi,10879.35
61b6ff46d8beac1599eb2b4b,50200023535069,29296.93,60ec41ba55c00300382672d9,HDFC,Revenue-Mktplace,5eecc6d6449e4f7cfb1c2708,2021-01-25T00:00:00.000Z,NEFT CR-DEUT0797BGL-FLIPKART INTERNET PR IVATE LIMITED-SLICK ORGANICS PVT LTD-012 500094GN00167,shopping,,net_banking_transfer,2842.6
61b6ff47d8beac1599eb2b50,50200023535069,102663.42,60ec41ba55c00300382672d9,HDFC,Revenue-PG-split enabled,5eecc6d6449e4f7cfb1c2708,2021-01-25T00:00:00.000Z,NEFT CR-UTIB0001506-RAZORPAY SOFTWARE PR IVATE LIMITED-SLICK ORGANICS PVT LITD-AX ISCN0067200754,investments,,net_banking_transfer,73366.49
61b6ff48d8beac1599eb2b5a,50200023535069,103213.5,60ec41ba55c00300382672d9,HDFC,Transfer in/Revenue-other,5eecc6d6449e4f7cfb1c2708,2021-01-25T00:00:00.000Z,ZOOBOP ME WORK-ARATA,,,Other,550.08
61b6ff49d8beac1599eb2b5e,50200023535069,104107.39,60ec41ba55c00300382672d9,HDFC,Revenue-Mktplace,5eecc6d6449e4f7cfb1c2708,2021-01-25T00:00:00.000Z,NEFT CR-DEUT0797BGL-MYNTRA DESIGNS PRIVA TE LIMITED-SLICK ORGANICS PRIVATE LIMITE D-012500327GN00234,shopping,,net_banking_transfer,893.89
61b6ff4ad8beac1599eb2b62,50200023535069,45725.39,60ec41ba55c00300382672d9,HDFC,Salary/Emp/consultant Expense,5eecc6d6449e4f7cfb1c2708,2021-01-25T00:00:00.000Z,"NEFT DR-UTIB0003142-ARIA DESAI UG ELIZAB ETH THOMAS ALEX-NETBANK, MUM-N0252113832 58295-58382",,,net_banking_transfer,-58382
61b6ff4bd8beac1599eb2b67,50200023535069,45989.31,60ec41ba55c00300382672d9,HDFC,Revenue-Mktplace,5eecc6d6449e4f7cfb1c2708,2021-01-25T00:00:00.000Z,NEFT CR-ICIC0000105-MANASH LIFETYLE PVT LTD-SLICKORGANICSPRIVATELIMITEDMPMUM-ICI B210250015464,,,net_banking_transfer,263.92
61b6ff4cd8beac1599eb2b6d,50200023535069,46700.17,60ec41ba55c00300382672d9,HDFC,Revenue-Mktplace,5eecc6d6449e4f7cfb1c2708,2021-01-25T00:00:00.000Z,NEFT CR-ICIC0000105-MANASH LIFETYLE PVT LTD-SLICKORGANICSPRIVATELIMITEDMPGGN-ICI B210250015463,,,net_banking_transfer,710.86
61b6ff4dd8beac1599eb2b71,50200023535069,379625.17,60ec41ba55c00300382672d9,HDFC,Transfer in/Revenue-other,5eecc6d6449e4f7cfb1c2708,2021-01-25T00:00:00.000Z,00640330000510-SLICK ORGANICS PVT,investments,,Other,332925
61b6ff4ed8beac1599eb2b75,50200023535069,381576.23,60ec41ba55c00300382672d9,HDFC,Revenue-Mktplace,5eecc6d6449e4f7cfb1c2708,2021-01-25T00:00:00.000Z,NEFT CR-DEUT0797BGL-FLIPKART INTERNET PR,shopping,,net_banking_transfer,1951.06
61b6ff4fd8beac1599eb2b84,50200023535069,382218.79,60ec41ba55c00300382672d9,HDFC,Revenue-Mktplace,5eecc6d6449e4f7cfb1c2708,2021-01-25T00:00:00.000Z,NEFT CR-DEUT0797BGL-MYNTRA DESIGNS PRIVA TE LIMITED-SLICK ORGANICS PRIVATE LIMITE D-012500330GN00241,shopping,,net_banking_transfer,642.56
61b6ff50d8beac1599eb2b8d,50200023535069,382188.54,60ec41ba55c00300382672d9,HDFC,bank charges,5eecc6d6449e4f7cfb1c2708,2021-01-25T00:00:00.000Z,.DC INTL POS TXN MARKUP+ST 160121 200121 -CDT2100102447680,,,international_transaction_arbitrage,-30.25
61b6ff51d8beac1599eb2b8f,50200023535069,382170.84,60ec41ba55c00300382672d9,HDFC,direct expenses,5eecc6d6449e4f7cfb1c2708,2021-01-25T00:00:00.000Z,.IMPS P2P 102114158096#21/01/2021 210121 -CDT2102402866204,,,net_banking_transfer,-17.7
61b6ff52d8beac1599eb2b97,50200023535069,392286.68,60ec41ba55c00300382672d9,HDFC,Revenue-PG-split enabled,5eecc6d6449e4f7cfb1c2708,2021-01-25T00:00:00.000Z,NEFT CR-UTIB0001506-RAZORPAY SOFTWARE PR IVATE LIMITED-SLICK ORGANICS PVT LITD-AX ISCN0067276231,investments,,net_banking_transfer,10115.84
61b6ff53d8beac1599eb2b9c,50200023535069,392074.79,60ec41ba55c00300382672d9,HDFC,bank charges,5eecc6d6449e4f7cfb1c2708,2021-01-25T00:00:00.000Z,.DC INTL POS TXN MARKUP+ST 190121 220121 -CDT2100102447680,,,international_transaction_arbitrage,-211.89
61b6ff54d8beac1599eb2bbf,50200023535069,391806.56,60ec41ba55c00300382672d9,HDFC,bank charges,5eecc6d6449e4f7cfb1c2708,2021-01-25T00:00:00.000Z,.DC INTL POS TXN MARKUP+ST 200121 220121 -CDT2100102447680,,,international_transaction_arbitrage,-268.23
61b6ff55d8beac1599eb2bcb,50200023535069,391703.39,60ec41ba55c00300382672d9,HDFC,bank charges,5eecc6d6449e4f7cfb1c2708,2021-01-25T00:00:00.000Z,.DC INTL POS TXN MARKUP+ST 200121 220121 -CDT2100102447680,,,international_transaction_arbitrage,-103.17
61b6ff56d8beac1599eb2bf4,50200023535069,406616.62,60ec41ba55c00300382672d9,HDFC,Revenue-COD,5eecc6d6449e4f7cfb1c2708,2021-01-25T00:00:00.000Z,NEFT CR-KKBK0000958-BIGFOOT RETAIL SOLUT IONS PRIVATE LIMITED-SLICK ORGANICS PVT LTD-KKBK210256766030,,,net_banking_transfer,14913.23
61b6ff57d8beac1599eb2bfb,50200023535069,356616.62,60ec41ba55c00300382672d9,HDFC,SAAS/tech expense,5eecc6d6449e4f7cfb1c2708,2021-01-25T00:00:00.000Z,POS 514834XXXXXX9486 AMAZON,shopping,,debit_card,-50000
61b6ff58d8beac1599eb2bfe,50200023535069,369733.66,60ec41ba55c00300382672d9,HDFC,Revenue-PG-non-split,5eecc6d6449e4f7cfb1c2708,2021-01-26T00:00:00.000Z,UPI-PAYTM-PAYOUTS@PAYTM-PYTM0123456-1026 77765378-ALL202101262168200,ewallet,,upi,13117.04
61b6ff59d8beac1599eb2c04,50200023535069,371040.66,60ec41ba55c00300382672d9,HDFC,Transfer in/Revenue-other,5eecc6d6449e4f7cfb1c2708,2021-01-26T00:00:00.000Z,IMPS-102611646956-EARTH LOVE ECOMMERCE-H DFC-XXXXXXXX1048-PAYOUT,,,net_banking_transfer,1307
61b6ff5ad8beac1599eb2c0d,50200023535069,453607.47,60ec41ba55c00300382672d9,HDFC,Revenue-Mktplace,5eecc6d6449e4f7cfb1c2708,2021-01-26T00:00:00.000Z,IMPS-102611023432-AMAZON SELLER SERVIC-H DFC-XXXXXXXX6004-60CR4ON7KFM4E276SLICK O RGANICS PVT LTD,shopping,,net_banking_transfer,82566.81
61b6ff5bd8beac1599eb2c12,50200023535069,777216.59,60ec41ba55c00300382672d9,HDFC,Revenue-Mktplace,5eecc6d6449e4f7cfb1c2708,2021-01-26T00:00:00.000Z,NEFT CR-DEUT0797BGL-AMAZON PAY (INDIA) P,shopping,,net_banking_transfer,323609.12
61b6ff5cd8beac1599eb2c17,50200023535069,727216.59,60ec41ba55c00300382672d9,HDFC,SAAS/tech expense,5eecc6d6449e4f7cfb1c2708,2021-01-26T00:00:00.000Z,VHDF9691553234/BILLDKAMAZONSELLERSE,shopping,,Other,-50000
61b6ff5dd8beac1599eb2c1f,50200023535069,744416.31,60ec41ba55c00300382672d9,HDFC,Revenue-PG-non-split,5eecc6d6449e4f7cfb1c2708,2021-01-27T00:00:00.000Z,UPI-PAYTM-PAYOUTS@PAYTM-PYTM0123456-1027 96827977-ALL202101272168200,ewallet,,upi,17199.72
61b6ff5ed8beac1599eb2c24,50200023535069,744659.19,60ec41ba55c00300382672d9,HDFC,Revenue-PG-non-split,5eecc6d6449e4f7cfb1c2708,2021-01-27T00:00:00.000Z,NEFT CR-ICIC0000031-PAYTM E COMMERCE PVT LTD-SLICK ORGANICS PVT LTD-CMS178352969 8,investments,,net_banking_transfer,242.88
61b6ff5ed8beac1599eb2c27,50200023535069,796119.82,60ec41ba55c00300382672d9,HDFC,Revenue-PG-split enabled,5eecc6d6449e4f7cfb1c2708,2021-01-27T00:00:00.000Z,NEFT CR-UTIB0001506-RAZORPAY SOFTWARE PR IVATE LIMITED-SLICK ORGANICS PVT LITD-AX ISCN0067312239,investments,,net_banking_transfer,51460.63
61b6ff5fd8beac1599eb2c2d,50200023535069,844162.82,60ec41ba55c00300382672d9,HDFC,Investments-New,5eecc6d6449e4f7cfb1c2708,2021-01-27T00:00:00.000Z,50200019889031-TPT-INV NO 100-1908 E-VEN TURES PRIVATE LIMITED,,,net_banking_transfer,48043
61b6ff60d8beac1599eb2c33,50200023535069,845703.88,60ec41ba55c00300382672d9,HDFC,Revenue-Mktplace,5eecc6d6449e4f7cfb1c2708,2021-01-27T00:00:00.000Z,NEFT CR-DEUT0797BGL-FLIPKART INTERNET PR IVATE LIMITED-SLICK ORGANICS PVT LTD-012 700595GN00065,shopping,,net_banking_transfer,1541.06
61b6ff61d8beac1599eb2c36,50200023535069,846920.25,60ec41ba55c00300382672d9,HDFC,Revenue-Mktplace,5eecc6d6449e4f7cfb1c2708,2021-01-27T00:00:00.000Z,NEFT CR-DEUT0797BGL-FLIPKART INTERNET PR IVATE LIMITED-SLICK ORGANICS PVT LTD-012 700652GN00131,shopping,,net_banking_transfer,1216.37
61b6ff62d8beac1599eb2c3a,50200023535069,863153.64,60ec41ba55c00300382672d9,HDFC,Revenue-PG-split enabled,5eecc6d6449e4f7cfb1c2708,2021-01-27T00:00:00.000Z,NEFT CR-UTIB0001506-RAZORPAY SOFTWARE PR IVATE LIMITED-SLICK ORGANICS PVT LITD-AX ISCN0067393134,investments,,net_banking_transfer,16233.39
61b6ff63d8beac1599eb2c40,50200023535069,868551.52,60ec41ba55c00300382672d9,HDFC,Revenue-COD,5eecc6d6449e4f7cfb1c2708,2021-01-27T00:00:00.000Z,NEFT CR-KKBK0000958-BIGFOOT RETAIL SOLUT IONS PRIVATE LIMITED-SLICK ORGANICS PVT LTD-KKBK210277056672,,,net_banking_transfer,5397.88
61b6ff64d8beac1599eb2c46,50200023535069,869011.38,60ec41ba55c00300382672d9,HDFC,Revenue-PG-non-split,5eecc6d6449e4f7cfb1c2708,2021-01-27T00:00:00.000Z,NEFT CR-ICIC0000031-PAYTM E COMMERCE PVT LTD-SLICK ORGANICS PVT LTD-CMS178617175 1,investments,,net_banking_transfer,459.86
61b6ff65d8beac1599eb2c59,50200023535069,882950.06,60ec41ba55c00300382672d9,HDFC,Revenue-PG-non-split,5eecc6d6449e4f7cfb1c2708,2021-01-28T00:00:00.000Z,UPI-PAYTM-PAYOUTS@PAYTM-PYTM0123456-1028 17045380-ALL202101282168200,ewallet,,upi,13938.68
61b6ff66d8beac1599eb2c63,50200023535069,897901.52,60ec41ba55c00300382672d9,HDFC,Revenue-PG-split enabled,5eecc6d6449e4f7cfb1c2708,2021-01-28T00:00:00.000Z,NEFT CR-UTIB0001506-RAZORPAY SOFTWARE PR IVATE LIMITED-SLICK ORGANICS PVT LITD-AX ISCN0067430257,investments,,net_banking_transfer,14951.46
61b6ff67d8beac1599eb2c68,50200023535069,887901.52,60ec41ba55c00300382672d9,HDFC,direct expenses,5eecc6d6449e4f7cfb1c2708,2021-01-28T00:00:00.000Z,SARVAN KUMAR - CHQ PAID - DEVLI ROAD K,,,chq,-10000
61b6ff68d8beac1599eb2c6c,50200023535069,837901.52,60ec41ba55c00300382672d9,HDFC,SAAS/tech expense,5eecc6d6449e4f7cfb1c2708,2021-01-28T00:00:00.000Z,VHDF9696037244/BILLDKAMAZONSELLERSE,shopping,,Other,-50000
61b6ff69d8beac1599eb2c71,50200023535069,834262.92,60ec41ba55c00300382672d9,HDFC,direct expenses,5eecc6d6449e4f7cfb1c2708,2021-01-28T00:00:00.000Z,POS 514834XXXXXX9486 FRESHWORKS INC,,,debit_card,-3638.6
61b6ff6ad8beac1599eb2c79,50200023535069,816392.92,60ec41ba55c00300382672d9,HDFC,Tax,5eecc6d6449e4f7cfb1c2708,2021-01-28T00:00:00.000Z,051030828012116460- CBDT TAX,,,Other,-17870
61b6ff6bd8beac1599eb2c7d,50200023535069,777109.92,60ec41ba55c00300382672d9,HDFC,Tax,5eecc6d6449e4f7cfb1c2708,2021-01-28T00:00:00.000Z,051030828012118164- CBDT TAX,,,Other,-39283
61b6ff6cd8beac1599eb2c80,50200023535069,703234.92,60ec41ba55c00300382672d9,HDFC,agency/vendor expense,5eecc6d6449e4f7cfb1c2708,2021-01-28T00:00:00.000Z,50200003053313-TPT-73875-CLOVE LEGAL,,,net_banking_transfer,-73875
61b6ff6dd8beac1599eb2c89,50200023535069,678234.92,60ec41ba55c00300382672d9,HDFC,Marketing Expense,5eecc6d6449e4f7cfb1c2708,2021-01-28T00:00:00.000Z,POS 514834XXXXXX9486 TML*GOOGLE ADWOR,,,debit_card,-25000
61b6ff6ed8beac1599eb2c91,50200023535069,692520.19,60ec41ba55c00300382672d9,HDFC,Revenue-PG-split enabled,5eecc6d6449e4f7cfb1c2708,2021-01-28T00:00:00.000Z,NEFT CR-UTIB0001506-RAZORPAY SOFTWARE PR IVATE LIMITED-SLICK ORGANICS PVT LITD-AX ISCN0067513536,investments,,net_banking_transfer,14285.27
61b6ff6fd8beac1599eb2c95,50200023535069,702898.65,60ec41ba55c00300382672d9,HDFC,Revenue-PG-non-split,5eecc6d6449e4f7cfb1c2708,2021-01-29T00:00:00.000Z,UPI-PAYTM-PAYOUTS@PAYTM-PYTM0123456-1029 37611712-ALL202101292168200,ewallet,,upi,10378.46
61b6ff70d8beac1599eb2c9c,50200023535069,701804.57,60ec41ba55c00300382672d9,HDFC,direct expenses,5eecc6d6449e4f7cfb1c2708,2021-01-29T00:00:00.000Z,POS 514834XXXXXX9486 ZOOM US 888-799-,,,debit_card,-1094.08
61b6ff71d8beac1599eb2ca5,50200023535069,712860.83,60ec41ba55c00300382672d9,HDFC,Revenue-PG-split enabled,5eecc6d6449e4f7cfb1c2708,2021-01-29T00:00:00.000Z,NEFT CR-UTIB0001506-RAZORPAY SOFTWARE PR IVATE LIMITED-SLICK ORGANICS PVT LITD-AX ISCN0067549718,investments,,net_banking_transfer,11056.26
61b6ff72d8beac1599eb2cab,50200023535069,719969.77,60ec41ba55c00300382672d9,HDFC,Revenue-Mktplace,5eecc6d6449e4f7cfb1c2708,2021-01-29T00:00:00.000Z,NEFT CR-DEUT0797BGL-FLIPKART INTERNET PR IVATE LIMITED-SLICK ORGANICS PVT LTD-012 900119GN00245,shopping,,net_banking_transfer,7108.94
61b6ff73d8beac1599eb2cb0,50200023535069,720443.16,60ec41ba55c00300382672d9,HDFC,Revenue-Mktplace,5eecc6d6449e4f7cfb1c2708,2021-01-29T00:00:00.000Z,NEFT CR-DEUT0784BBY-TATA UNISTORE LTD-NO DAL-SLICK ORGANICS PVT LTD-012900990GN00 377,investments,,net_banking_transfer,473.39
61b6ff74d8beac1599eb2cb5,50200023535069,721358.24,60ec41ba55c00300382672d9,HDFC,Transfer in/Revenue-other,5eecc6d6449e4f7cfb1c2708,2021-01-29T00:00:00.000Z,NEFT CR-YESB0000001-ILLUMINAR MEDIA-SLIC K ORGANICS PVT LTD-N029210502909959,,,net_banking_transfer,915.08
61b6ff75d8beac1599eb2cba,50200023535069,621358.24,60ec41ba55c00300382672d9,HDFC,SAAS/tech expense,5eecc6d6449e4f7cfb1c2708,2021-01-29T00:00:00.000Z,VHDF9700268064/BILLDKAMAZONSELLERSE,shopping,,Other,-100000
61b6ff76d8beac1599eb2cbd,50200023535069,622105.74,60ec41ba55c00300382672d9,HDFC,Revenue-Mktplace,5eecc6d6449e4f7cfb1c2708,2021-01-29T00:00:00.000Z,NEFT CR-KKBK0000958-SUPERMARKET GROCERY SUPPLIES PVT LTD-SLICK ORGANICS PVT LTD- KKBK210297468371,shopping,,net_banking_transfer,747.5
61b6ff77d8beac1599eb2cc2,50200023535069,629129.54,60ec41ba55c00300382672d9,HDFC,Revenue-Mktplace,5eecc6d6449e4f7cfb1c2708,2021-01-29T00:00:00.000Z,NEFT CR-KKBK0000958-SUPERMARKET GROCERY SUPPLIES PVT LTD-SLICK ORGANICS PVT LTD- KKBK210297468359,shopping,,net_banking_transfer,7023.8
61b6ff78d8beac1599eb2ccc,50200023535069,632400.3,60ec41ba55c00300382672d9,HDFC,Revenue-Mktplace,5eecc6d6449e4f7cfb1c2708,2021-01-29T00:00:00.000Z,NEFT CR-KKBK0000958-SUPERMARKET GROCERY,shopping,,net_banking_transfer,3270.76
61b6ff79d8beac1599eb2ccf,50200023535069,632542.73,60ec41ba55c00300382672d9,HDFC,Revenue-Mktplace,5eecc6d6449e4f7cfb1c2708,2021-01-29T00:00:00.000Z,NEFT CR-ICIC0000105-MANASH LIFETYLE PVT LTD-SLICKORGANICSPRIVATELIMITEDMPGGN-ICI B210290025373,,,net_banking_transfer,142.43
61b6ff7ad8beac1599eb2cd7,50200023535069,634339.73,60ec41ba55c00300382672d9,HDFC,Revenue-Mktplace,5eecc6d6449e4f7cfb1c2708,2021-01-29T00:00:00.000Z,NEFT CR-ICIC0000105-MANASH LIFETYLE PVT LTD-SLICKORGANICSPRIVATELIMITEDMPMUM-ICI B210290025374,,,net_banking_transfer,1797
61b6ff7bd8beac1599eb2cdd,50200023535069,635023.64,60ec41ba55c00300382672d9,HDFC,Revenue-Mktplace,5eecc6d6449e4f7cfb1c2708,2021-01-29T00:00:00.000Z,NEFT CR-DEUT0797BGL-FLIPKART INTERNET PR IVATE LIMITED-SLICK ORGANICS PVT LTD-012 900089GN00015,shopping,,net_banking_transfer,683.91
61b6ff7cd8beac1599eb2ce3,50200023535069,651133.32,60ec41ba55c00300382672d9,HDFC,Revenue-COD,5eecc6d6449e4f7cfb1c2708,2021-01-29T00:00:00.000Z,NEFT CR-KKBK0000958-BIGFOOT RETAIL SOLUT IONS PRIVATE LIMITED-SLICK ORGANICS PVT LTD-KKBK210297508425,,,net_banking_transfer,16109.68
61b6ff7dd8beac1599eb2ce6,50200023535069,670713.76,60ec41ba55c00300382672d9,HDFC,Revenue-PG-split enabled,5eecc6d6449e4f7cfb1c2708,2021-01-29T00:00:00.000Z,NEFT CR-UTIB0001506-RAZORPAY SOFTWARE PR IVATE LIMITED-SLICK ORGANICS PVT LITD-AX ISCN0067654580,investments,,net_banking_transfer,19580.44
61b6ff7dd8beac1599eb2ceb,50200023535069,716969.76,60ec41ba55c00300382672d9,HDFC,Transfer in/Revenue-other,5eecc6d6449e4f7cfb1c2708,2021-01-29T00:00:00.000Z,00640330000510-SLICK ORGANICS PVT,investments,,Other,46256
61b6ff7ed8beac1599eb2cf2,50200023535069,717841.01,60ec41ba55c00300382672d9,HDFC,Revenue-Mktplace,5eecc6d6449e4f7cfb1c2708,2021-01-29T00:00:00.000Z,NEFT CR-ICIC0000104-GOQII TECHNOLOGIES P VT LTD-SLICK ORGANICS PRIVATE LIMITED-CM S1790204946,,,net_banking_transfer,871.25
61b6ff7fd8beac1599eb2cf5,50200023535069,736662.59,60ec41ba55c00300382672d9,HDFC,Revenue-PG-non-split,5eecc6d6449e4f7cfb1c2708,2021-01-30T00:00:00.000Z,UPI-PAYTM-PAYOUTS@PAYTM-PYTM0123456-1030 58579311-ALL202101302168200,ewallet,,upi,18821.58
61b6ff80d8beac1599eb2cf9,50200023535069,753808.39,60ec41ba55c00300382672d9,HDFC,Revenue-PG-split enabled,5eecc6d6449e4f7cfb1c2708,2021-01-30T00:00:00.000Z,NEFT CR-UTIB0001506-RAZORPAY SOFTWARE PR IVATE LIMITED-SLICK ORGANICS PVT LITD-AX ISCN0067671866,investments,,net_banking_transfer,17145.8
61b6ff82d8beac1599eb2d01,50200023535069,775357.76,60ec41ba55c00300382672d9,HDFC,Revenue-PG-split enabled,5eecc6d6449e4f7cfb1c2708,2021-01-30T00:00:00.000Z,NEFT CR-UTIB0001506-RAZORPAY SOFTWARE PR IVATE LIMITED-SLICK ORGANICS PVT LITD-AX ISCN0067753435,investments,,net_banking_transfer,21549.37
61b6ff83d8beac1599eb2d0b,50200023535069,789515.31,60ec41ba55c00300382672d9,HDFC,Revenue-PG-non-split,5eecc6d6449e4f7cfb1c2708,2021-01-31T00:00:00.000Z,UPI-PAYTM-PAYOUTS@PAYTM-PYTM0123456-1031,ewallet,,upi,14157.55
61b6ff84d8beac1599eb2d17,50200023535069,797055.05,60ec41ba55c00300382672d9,HDFC,Revenue-PG-non-split,5eecc6d6449e4f7cfb1c2708,2021-02-01T00:00:00.000Z,UPI-PAYTM-PAYOUTS@PAYTM-PYTM0123456-1032 01275837-ALL202102012168200,ewallet,,upi,7539.74
61b6ff85d8beac1599eb2d2a,50200023535069,802400.36,60ec41ba55c00300382672d9,HDFC,Revenue-Mktplace,5eecc6d6449e4f7cfb1c2708,2021-02-01T00:00:00.000Z,NEFT CR-DEUT0797BGL-MYNTRA DESIGNS PRIVA TE LIMITED-SLICK ORGANICS PRIVATE LIMITE D-020100042GN00194,shopping,,net_banking_transfer,5345.31
61b6ff86d8beac1599eb2d37,50200023535069,835255.18,60ec41ba55c00300382672d9,HDFC,Revenue-PG-split enabled,5eecc6d6449e4f7cfb1c2708,2021-02-01T00:00:00.000Z,NEFT CR-UTIB0001506-RAZORPAY SOFTWARE PR IVATE LIMITED-SLICK ORGANICS PVT LITD-AX ISCN0067802193,investments,,net_banking_transfer,32854.82
61b6ff87d8beac1599eb2d48,50200023535069,847820.67,60ec41ba55c00300382672d9,HDFC,Revenue-PG-non-split,5eecc6d6449e4f7cfb1c2708,2021-02-01T00:00:00.000Z,NEFT CR-SCBL0036001-STRIPE INDIA PRIVATE LIMITED-SLICK ORGANICS PRIVATE LIMITED- SSG17413Q0176581,investments,,net_banking_transfer,12565.49
61b6ff88d8beac1599eb2d5a,50200023535069,647820.67,60ec41ba55c00300382672d9,HDFC,direct expenses,5eecc6d6449e4f7cfb1c2708,2021-02-01T00:00:00.000Z,"NEFT DR-INDB0000148-ACQUISORY INDIA CONS ULTING PVT LTD-NETBANK, MUM-N03221139060 2040-200000",,,net_banking_transfer,-200000
61b6ff89d8beac1599eb2d6f,50200023535069,547820.67,60ec41ba55c00300382672d9,HDFC,direct expenses,5eecc6d6449e4f7cfb1c2708,2021-02-01T00:00:00.000Z,57500000443889-TPT-100000-WEBKLIPPER TEC HNOLOGIES PRIVATE LIMITED,,,net_banking_transfer,-100000
61b6ff8ad8beac1599eb2d76,50200023535069,545705.09,60ec41ba55c00300382672d9,HDFC,direct expenses,5eecc6d6449e4f7cfb1c2708,2021-02-01T00:00:00.000Z,POS 514834XXXXXX9486 SEOPTIMER,,,debit_card,-2115.58
61b6ff8bd8beac1599eb2d7e,50200023535069,290705.09,60ec41ba55c00300382672d9,HDFC,SAAS/tech expense,5eecc6d6449e4f7cfb1c2708,2021-02-01T00:00:00.000Z,VHDF9709429347/BILLDKAMAZONSELLERSE,shopping,,Other,-255000
61b6ff8cd8beac1599eb2d86,50200023535069,291420.07,60ec41ba55c00300382672d9,HDFC,Revenue-Mktplace,5eecc6d6449e4f7cfb1c2708,2021-02-01T00:00:00.000Z,NEFT CR-DEUT0797BGL-MYNTRA DESIGNS PRIVA TE LIMITED-SLICK ORGANICS PRIVATE LIMITE D-020100066GN00039,shopping,,net_banking_transfer,714.98
61b6ff8dd8beac1599eb2d92,50200023535069,297945.23,60ec41ba55c00300382672d9,HDFC,Revenue-PG-split enabled,5eecc6d6449e4f7cfb1c2708,2021-02-01T00:00:00.000Z,NEFT CR-UTIB0001506-RAZORPAY SOFTWARE PR IVATE LIMITED-SLICK ORGANICS PVT LITD-AX ISCN0067899451,investments,,net_banking_transfer,6525.16
61b6ff8dd8beac1599eb2d9e,50200023535069,299900.84,60ec41ba55c00300382672d9,HDFC,Revenue-Mktplace,5eecc6d6449e4f7cfb1c2708,2021-02-01T00:00:00.000Z,NEFT CR-DEUT0797BGL-FLIPKART INTERNET PR IVATE LIMITED-SLICK ORGANICS PVT LTD-020 100290GN00010,shopping,,net_banking_transfer,1955.61
61b6ff8ed8beac1599eb2da8,50200023535069,301879.81,60ec41ba55c00300382672d9,HDFC,Revenue-Mktplace,5eecc6d6449e4f7cfb1c2708,2021-02-01T00:00:00.000Z,NEFT CR-DEUT0797BGL-FLIPKART INTERNET PR,shopping,,net_banking_transfer,1978.97
61b6ff8fd8beac1599eb2db2,50200023535069,337293.02,60ec41ba55c00300382672d9,HDFC,Revenue-COD,5eecc6d6449e4f7cfb1c2708,2021-02-01T00:00:00.000Z,NEFT CR-KKBK0000958-BIGFOOT RETAIL SOLUT IONS PRIVATE LIMITED-SLICK ORGANICS PVT LTD-KKBK210328182919,,,net_banking_transfer,35413.21
61b6ff90d8beac1599eb2db9,50200023535069,350520.68,60ec41ba55c00300382672d9,HDFC,Revenue-PG-non-split,5eecc6d6449e4f7cfb1c2708,2021-02-02T00:00:00.000Z,UPI-PAYTM-PAYOUTS@PAYTM-PYTM0123456-1033 23507420-ALL202102022168200,ewallet,,upi,13227.66
61b6ff91d8beac1599eb2dc0,50200023535069,377993.2,60ec41ba55c00300382672d9,HDFC,Revenue-PG-split enabled,5eecc6d6449e4f7cfb1c2708,2021-02-02T00:00:00.000Z,NEFT CR-UTIB0001506-RAZORPAY SOFTWARE PR IVATE LIMITED-SLICK ORGANICS PVT LITD-AX ISCN0067941687,investments,,net_banking_transfer,27472.52
61b6ff92d8beac1599eb2dc9,50200023535069,327993.2,60ec41ba55c00300382672d9,HDFC,Marketing Expense,5eecc6d6449e4f7cfb1c2708,2021-02-02T00:00:00.000Z,POS 514834XXXXXX9486 TML*GOOGLE ADWOR,,,debit_card,-50000
61b6ff93d8beac1599eb2dce,50200023535069,484699.13,60ec41ba55c00300382672d9,HDFC,Revenue-Mktplace,5eecc6d6449e4f7cfb1c2708,2021-02-02T00:00:00.000Z,IMPS-103311145770-AMAZON SELLER SERVIC-H DFC-XXXXXXXX6004-JND1RJQ0JNXQF3TCSLICK O RGANICS PVT LTD,shopping,,net_banking_transfer,156705.93
61b6ff94d8beac1599eb2dd2,50200023535069,824100.94,60ec41ba55c00300382672d9,HDFC,Revenue-Mktplace,5eecc6d6449e4f7cfb1c2708,2021-02-02T00:00:00.000Z,NEFT CR-DEUT0797BGL-AMAZON PAY (INDIA) P RIVATE LIMITED-SLICK ORGANICS PVT LTD-02 0200111GN00376,shopping,,net_banking_transfer,339401.81
61b6ff95d8beac1599eb2dde,50200023535069,836113.62,60ec41ba55c00300382672d9,HDFC,Revenue-PG-split enabled,5eecc6d6449e4f7cfb1c2708,2021-02-02T00:00:00.000Z,NEFT CR-UTIB0001506-RAZORPAY SOFTWARE PR IVATE LIMITED-SLICK ORGANICS PVT LITD-AX ISCN0068033277,investments,,net_banking_transfer,12012.68
61b6ff96d8beac1599eb2de8,50200023535069,831394.8,60ec41ba55c00300382672d9,HDFC,direct expenses,5eecc6d6449e4f7cfb1c2708,2021-02-02T00:00:00.000Z,POS 514834XXXXXX4081 ONLINE PAYMENT,,,debit_card,-4718.82
61b6ff97d8beac1599eb2df9,50200023535069,851438.31,60ec41ba55c00300382672d9,HDFC,Revenue-PG-non-split,5eecc6d6449e4f7cfb1c2708,2021-02-03T00:00:00.000Z,UPI-PAYTM-PAYOUTS@PAYTM-PYTM0123456-1034 45731052-ALL202102032168200,ewallet,,upi,20043.51
61b6ff98d8beac1599eb2e05,50200023535069,854679.71,60ec41ba55c00300382672d9,HDFC,Revenue-Mktplace,5eecc6d6449e4f7cfb1c2708,2021-02-03T00:00:00.000Z,NEFT CR-DEUT0797BGL-FLIPKART INTERNET PR IVATE LIMITED-SLICK ORGANICS PVT LTD-020 300108GN00079,shopping,,net_banking_transfer,3241.4
61b6ff99d8beac1599eb2e0a,50200023535069,864921.52,60ec41ba55c00300382672d9,HDFC,Revenue-PG-split enabled,5eecc6d6449e4f7cfb1c2708,2021-02-03T00:00:00.000Z,NEFT CR-UTIB0001506-RAZORPAY SOFTWARE PR IVATE LIMITED-SLICK ORGANICS PVT LITD-AX ISCN0068062272,investments,,net_banking_transfer,10241.81
61b6ff9ad8beac1599eb2e0f,50200023535069,866301.29,60ec41ba55c00300382672d9,HDFC,Revenue-Mktplace,5eecc6d6449e4f7cfb1c2708,2021-02-03T00:00:00.000Z,NEFT CR-DEUT0797BGL-MYNTRA DESIGNS PRIVA TE LIMITED-SLICK ORGANICS PRIVATE LIMITE D-020300242GN00279,shopping,,net_banking_transfer,1379.77
61b6ff9bd8beac1599eb2e15,50200023535069,716301.29,60ec41ba55c00300382672d9,HDFC,direct expenses,5eecc6d6449e4f7cfb1c2708,2021-02-03T00:00:00.000Z,NEFT DR-YESB0000551-VISTTA COSMETICS-NET,,,net_banking_transfer,-150000
61b6ff9cd8beac1599eb2e1f,50200023535069,516301.29,60ec41ba55c00300382672d9,HDFC,direct expenses,5eecc6d6449e4f7cfb1c2708,2021-02-03T00:00:00.000Z,"NEFT DR-SCBL0036025-DHRUV MADHOK-NETBANK , MUM-N034211393229397-200000",,,net_banking_transfer,-200000
61b6ff9dd8beac1599eb2e2a,50200023535069,316301.29,60ec41ba55c00300382672d9,HDFC,direct expenses,5eecc6d6449e4f7cfb1c2708,2021-02-03T00:00:00.000Z,02711930004579-TPT-200000-DHRUV BHASIN,,,net_banking_transfer,-200000
61b6ff9ed8beac1599eb2e2e,50200023535069,116301.29,60ec41ba55c00300382672d9,HDFC,direct expenses,5eecc6d6449e4f7cfb1c2708,2021-02-03T00:00:00.000Z,05892560000649-TPT-200000-DECORPAC INDIA PRIVATE LIMITED,,,net_banking_transfer,-200000
61b6ff9fd8beac1599eb2e33,50200023535069,116908.42,60ec41ba55c00300382672d9,HDFC,Revenue-Mktplace,5eecc6d6449e4f7cfb1c2708,2021-02-03T00:00:00.000Z,NEFT CR-DEUT0797BGL-MYNTRA DESIGNS PRIVA TE LIMITED-SLICK ORGANICS PRIVATE LIMITE D-020300260GN00243,shopping,,net_banking_transfer,607.13
61b6ffa0d8beac1599eb2e3a,50200023535069,128934.36,60ec41ba55c00300382672d9,HDFC,Revenue-PG-split enabled,5eecc6d6449e4f7cfb1c2708,2021-02-03T00:00:00.000Z,NEFT CR-UTIB0001506-RAZORPAY SOFTWARE PR IVATE LIMITED-SLICK ORGANICS PVT LITD-AX ISCN0068139247,investments,,net_banking_transfer,12025.94
61b6ffa1d8beac1599eb2e3e,50200023535069,146124.14,60ec41ba55c00300382672d9,HDFC,Revenue-PG-non-split,5eecc6d6449e4f7cfb1c2708,2021-02-04T00:00:00.000Z,UPI-PAYTM-PAYOUTS@PAYTM-PYTM0123456-1035 68726682-ALL202102042168200,ewallet,,upi,17189.78
61b6ffa2d8beac1599eb2e48,50200023535069,129624.14,60ec41ba55c00300382672d9,HDFC,direct expenses,5eecc6d6449e4f7cfb1c2708,2021-02-04T00:00:00.000Z,"NEFT DR-IBKL0000165-SHIV ENTERPRISES-NET BANK, MUM-N035211394468440-16500",,,net_banking_transfer,-16500
61b6ffa3d8beac1599eb2e4f,50200023535069,129623.14,60ec41ba55c00300382672d9,HDFC,Marketing Expense,5eecc6d6449e4f7cfb1c2708,2021-02-04T00:00:00.000Z,POS 514834XXXXXX9486 TML*GOOGLE ADWOR,,,debit_card,-1
61b6ffa4d8beac1599eb2e52,50200023535069,109623.14,60ec41ba55c00300382672d9,HDFC,Marketing Expense,5eecc6d6449e4f7cfb1c2708,2021-02-04T00:00:00.000Z,POS 514834XXXXXX9486 TML*GOOGLE ADWOR,,,debit_card,-20000
61b6ffa5d8beac1599eb2e58,50200023535069,125256.26,60ec41ba55c00300382672d9,HDFC,Revenue-PG-split enabled,5eecc6d6449e4f7cfb1c2708,2021-02-04T00:00:00.000Z,NEFT CR-UTIB0001506-RAZORPAY SOFTWARE PR IVATE LIMITED-SLICK ORGANICS PVT LITD-AX ISCN0068184472,investments,,net_banking_transfer,15633.12
61b6ffa6d8beac1599eb2e5f,50200023535069,124582.26,60ec41ba55c00300382672d9,HDFC,direct expenses,5eecc6d6449e4f7cfb1c2708,2021-02-04T00:00:00.000Z,"NEFT DR-PUNB0307800-PRAKASH JHA-NETBANK, MUM-N035211394835337-674",,,net_banking_transfer,-674
61b6ffa7d8beac1599eb2e65,50200023535069,115472.85,60ec41ba55c00300382672d9,HDFC,direct expenses,5eecc6d6449e4f7cfb1c2708,2021-02-04T00:00:00.000Z,POS 514834XXXXXX9486 STK*SHUTTERSTOCK,,,debit_card,-9109.41
61b6ffa8d8beac1599eb2e68,50200023535069,115926.45,60ec41ba55c00300382672d9,HDFC,Transfer in/Revenue-other,5eecc6d6449e4f7cfb1c2708,2021-02-04T00:00:00.000Z,ZOOBOP ME WORK-ARATA,,,Other,453.6
61b6ffa9d8beac1599eb2e6d,50200023535069,144285.73,60ec41ba55c00300382672d9,HDFC,Revenue-COD,5eecc6d6449e4f7cfb1c2708,2021-02-04T00:00:00.000Z,NEFT CR-KKBK0000958-BIGFOOT RETAIL SOLUT IONS PRIVATE LIMITED-SLICK ORGANICS PVT LTD-KKBK210358793462,,,net_banking_transfer,28359.28
61b6ffaad8beac1599eb2e74,50200023535069,154497.05,60ec41ba55c00300382672d9,HDFC,Revenue-PG-split enabled,5eecc6d6449e4f7cfb1c2708,2021-02-04T00:00:00.000Z,NEFT CR-UTIB0001506-RAZORPAY SOFTWARE PR IVATE LIMITED-SLICK ORGANICS PVT LITD-AX ISCN0068266371,investments,,net_banking_transfer,10211.32
61b6ffabd8beac1599eb2e77,50200023535069,156107.7,60ec41ba55c00300382672d9,HDFC,Revenue-Mktplace,5eecc6d6449e4f7cfb1c2708,2021-02-04T00:00:00.000Z,NEFT CR-ICIC0000105-MANASH LIFETYLE PVT,,,net_banking_transfer,1610.65
61b6ffacd8beac1599eb2e7c,50200023535069,162546.89,60ec41ba55c00300382672d9,HDFC,Revenue-PG-non-split,5eecc6d6449e4f7cfb1c2708,2021-02-05T00:00:00.000Z,UPI-PAYTM-PAYOUTS@PAYTM-PYTM0123456-1036 92025839-ALL202102052168200,ewallet,,upi,6439.19
61b6ffadd8beac1599eb2e83,50200023535069,173294.56,60ec41ba55c00300382672d9,HDFC,Revenue-PG-split enabled,5eecc6d6449e4f7cfb1c2708,2021-02-05T00:00:00.000Z,NEFT CR-UTIB0001506-RAZORPAY SOFTWARE PR IVATE LIMITED-SLICK ORGANICS PVT LITD-AX ISCN0068306077,investments,,net_banking_transfer,10747.67
61b6ffaed8beac1599eb2e87,50200023535069,173637.18,60ec41ba55c00300382672d9,HDFC,Revenue-Mktplace,5eecc6d6449e4f7cfb1c2708,2021-02-05T00:00:00.000Z,NEFT CR-DEUT0797BGL-MYNTRA DESIGNS PRIVA TE LIMITED-SLICK ORGANICS PRIVATE LIMITE D-020500125GN00287,shopping,,net_banking_transfer,342.62
61b6ffafd8beac1599eb2e8b,50200023535069,157137.18,60ec41ba55c00300382672d9,HDFC,direct expenses,5eecc6d6449e4f7cfb1c2708,2021-02-05T00:00:00.000Z,"NEFT DR-KKBK0000811-NASIR KHAN-NETBANK, MUM-N036211396100498-FNF",,,net_banking_transfer,-16500
61b6ffafd8beac1599eb2e90,50200023535069,157136.18,60ec41ba55c00300382672d9,HDFC,Marketing Expense,5eecc6d6449e4f7cfb1c2708,2021-02-05T00:00:00.000Z,POS 514834XXXXXX9486 GOOGLE *TEMPORAR,,,debit_card,-1
61b6ffb0d8beac1599eb2e98,50200023535069,157137.18,60ec41ba55c00300382672d9,HDFC,Transfer in/Revenue-other,5eecc6d6449e4f7cfb1c2708,2021-02-05T00:00:00.000Z,POS 514834XXXXXX9486 GOOGLE *TEMPORAR,,,debit_card,1
61b6ffb1d8beac1599eb2e9b,50200023535069,155837.18,60ec41ba55c00300382672d9,HDFC,Marketing Expense,5eecc6d6449e4f7cfb1c2708,2021-02-05T00:00:00.000Z,POS 514834XXXXXX9486 GOOGLE *GOOGLE S,,,debit_card,-1300
61b6ffb2d8beac1599eb2e9e,50200023535069,156209.29,60ec41ba55c00300382672d9,HDFC,Revenue-Mktplace,5eecc6d6449e4f7cfb1c2708,2021-02-05T00:00:00.000Z,NEFT CR-DEUT0797BGL-MYNTRA DESIGNS PRIVA TE LIMITED-SLICK ORGANICS PRIVATE LIMITE D-020500126GN00236,shopping,,net_banking_transfer,372.11
61b6ffb3d8beac1599eb2ea3,50200023535069,159531.33,60ec41ba55c00300382672d9,HDFC,Revenue-Mktplace,5eecc6d6449e4f7cfb1c2708,2021-02-05T00:00:00.000Z,NEFT CR-DEUT0797BGL-FLIPKART INTERNET PR IVATE LIMITED-SLICK ORGANICS PVT LTD-020 500630GN00187,shopping,,net_banking_transfer,3322.04
61b6ffb4d8beac1599eb2eac,50200023535069,205438.79,60ec41ba55c00300382672d9,HDFC,Revenue-COD,5eecc6d6449e4f7cfb1c2708,2021-02-05T00:00:00.000Z,NEFT CR-KKBK0000958-BIGFOOT RETAIL SOLUT IONS PRIVATE LIMITED-SLICK ORGANICS PVT LTD-KKBK210369163607,,,net_banking_transfer,45907.46
61b6ffb5d8beac1599eb2eb2,50200023535069,206098.93,60ec41ba55c00300382672d9,HDFC,Revenue-Mktplace,5eecc6d6449e4f7cfb1c2708,2021-02-05T00:00:00.000Z,NEFT CR-ICIC0000105-MANASH LIFETYLE PVT LTD-SLICK ORGANICS PRIVATE LIMITED MP GGN-ICIB210360053345,,,net_banking_transfer,660.14
61b6ffb6d8beac1599eb2eb9,50200023535069,233079.82,60ec41ba55c00300382672d9,HDFC,Revenue-PG-split enabled,5eecc6d6449e4f7cfb1c2708,2021-02-05T00:00:00.000Z,NEFT CR-UTIB0001506-RAZORPAY SOFTWARE PR IVATE LIMITED-SLICK ORGANICS PVT LITD-AX ISCN0068402020,investments,,net_banking_transfer,26980.89
61b6ffb7d8beac1599eb2ebc,50200023535069,1233079.82,60ec41ba55c00300382672d9,HDFC,Transfer in/Revenue-other,5eecc6d6449e4f7cfb1c2708,2021-02-05T00:00:00.000Z,NEFT CR-ICIC0SF0002-GLANCE GETVANTAGE ES,,,net_banking_transfer,1000000
61b6ffb8d8beac1599eb2ebf,50200023535069,1103613.82,60ec41ba55c00300382672d9,HDFC,direct expenses,5eecc6d6449e4f7cfb1c2708,2021-02-05T00:00:00.000Z,"NEFT DR-ORBC0101001-KRAUTER HEALTHCARE L TD-NETBANK, MUM-N036211397268569-129466",,,net_banking_transfer,-129466
61b6ffb9d8beac1599eb2ecd,50200023535069,1099525.12,60ec41ba55c00300382672d9,HDFC,direct expenses,5eecc6d6449e4f7cfb1c2708,2021-02-05T00:00:00.000Z,POS 514834XXXXXX4081 ONLINE PAYMENT,,,debit_card,-4088.7
61b6ffbad8beac1599eb2ef4,50200023535069,1119881.68,60ec41ba55c00300382672d9,HDFC,Revenue-PG-non-split,5eecc6d6449e4f7cfb1c2708,2021-02-06T00:00:00.000Z,UPI-PAYTM-PAYOUTS@PAYTM-PYTM0123456-1037 15868847-ALL202102062168200,ewallet,,upi,20356.56
61b6ffbbd8beac1599eb2ef9,50200023535069,1139800.83,60ec41ba55c00300382672d9,HDFC,Revenue-PG-split enabled,5eecc6d6449e4f7cfb1c2708,2021-02-06T00:00:00.000Z,NEFT CR-UTIB0001506-RAZORPAY SOFTWARE PR IVATE LIMITED-SLICK ORGANICS PVT LITD-AX ISCN0068418997,investments,,net_banking_transfer,19919.15
61b6ffbcd8beac1599eb2efc,50200023535069,1142622.13,60ec41ba55c00300382672d9,HDFC,Transfer in/Revenue-other,5eecc6d6449e4f7cfb1c2708,2021-02-06T00:00:00.000Z,NEFT CR-YESB0000001-ILLUMINAR MEDIA-SLIC K ORGANICS PVT LTD-N037210509638996,,,net_banking_transfer,2821.3
61b6ffbdd8beac1599eb2f01,50200023535069,1143082.71,60ec41ba55c00300382672d9,HDFC,Transfer in/Revenue-other,5eecc6d6449e4f7cfb1c2708,2021-02-06T00:00:00.000Z,NEFT CR-YESB0000001-ILUMINAR MEDIA-SLICK ORGANICS PVT. LTD-N037210509642771,,,net_banking_transfer,460.58
61b6ffbed8beac1599eb2f08,50200023535069,1143037.52,60ec41ba55c00300382672d9,HDFC,bank charges,5eecc6d6449e4f7cfb1c2708,2021-02-06T00:00:00.000Z,.DC INTL POS TXN MARKUP+ST 280121 300121 -CDT2103302935063,,,international_transaction_arbitrage,-45.19
61b6ffbfd8beac1599eb2f0b,50200023535069,1162502.06,60ec41ba55c00300382672d9,HDFC,Revenue-PG-split enabled,5eecc6d6449e4f7cfb1c2708,2021-02-06T00:00:00.000Z,NEFT CR-UTIB0001506-RAZORPAY SOFTWARE PR IVATE LIMITED-SLICK ORGANICS PVT LITD-AX ISCN0068476920,investments,,net_banking_transfer,19464.54
61b6ffc0d8beac1599eb2f11,50200023535069,1184514.49,60ec41ba55c00300382672d9,HDFC,Revenue-PG-non-split,5eecc6d6449e4f7cfb1c2708,2021-02-07T00:00:00.000Z,UPI-PAYTM-PAYOUTS@PAYTM-PYTM0123456-1038 41298881-ALL202102072168200,ewallet,,upi,22012.43
61b6ffc1d8beac1599eb2f32,50200023535069,1208124.56,60ec41ba55c00300382672d9,HDFC,Revenue-PG-non-split,5eecc6d6449e4f7cfb1c2708,2021-02-08T00:00:00.000Z,UPI-PAYTM-PAYOUTS@PAYTM-PYTM0123456-1039 66931918-ALL202102082168200,ewallet,,upi,23610.07
61b6ffc2d8beac1599eb2f38,50200023535069,1113724.56,60ec41ba55c00300382672d9,HDFC,direct expenses,5eecc6d6449e4f7cfb1c2708,2021-02-08T00:00:00.000Z,CHQ PAID-MICR CTS-MU-GLANCE GET VANTAGE,,,chq,-94400
61b6ffc3d8beac1599eb2f3b,50200023535069,1021224.56,60ec41ba55c00300382672d9,HDFC,direct expenses,5eecc6d6449e4f7cfb1c2708,2021-02-08T00:00:00.000Z,"NEFT DR-CITI0000002-DHIRAJ-NETBANK, MUM- N039211399007145-92500",,,net_banking_transfer,-92500
61b6ffc4d8beac1599eb2f41,50200023535069,951224.56,60ec41ba55c00300382672d9,HDFC,direct expenses,5eecc6d6449e4f7cfb1c2708,2021-02-08T00:00:00.000Z,"NEFT DR-ICIC0000542-AVANTIKA SUKHIA-NETB ANK, MUM-N039211399007174-70000",,,net_banking_transfer,-70000
61b6ffc5d8beac1599eb2f47,50200023535069,930224.56,60ec41ba55c00300382672d9,HDFC,direct expenses,5eecc6d6449e4f7cfb1c2708,2021-02-08T00:00:00.000Z,"NEFT DR-SIBL0000555-JAIVEER KUMAR-NETBAN K, MUM-N039211399002396-21000",,,net_banking_transfer,-21000
61b6ffc5d8beac1599eb2f4c,50200023535069,915224.56,60ec41ba55c00300382672d9,HDFC,direct expenses,5eecc6d6449e4f7cfb1c2708,2021-02-08T00:00:00.000Z,"NEFT DR-PUNB0398000-MEENA SINGH-NETBANK, MUM-N039211399002433-15000",,,net_banking_transfer,-15000
61b6ffc6d8beac1599eb2f4f,50200023535069,880224.56,60ec41ba55c00300382672d9,HDFC,direct expenses,5eecc6d6449e4f7cfb1c2708,2021-02-08T00:00:00.000Z,NEFT DR-ICIC0003374-SIDDHARTH KANOJIA-NE,,,net_banking_transfer,-35000
61b6ffc7d8beac1599eb2f55,50200023535069,870224.56,60ec41ba55c00300382672d9,HDFC,direct expenses,5eecc6d6449e4f7cfb1c2708,2021-02-08T00:00:00.000Z,"NEFT DR-ALLA0210591-CHAMPA DEVI-NETBANK, MUM-N039211399010742-10000",,,net_banking_transfer,-10000
61b6ffc8d8beac1599eb2f5b,50200023535069,820224.56,60ec41ba55c00300382672d9,HDFC,direct expenses,5eecc6d6449e4f7cfb1c2708,2021-02-08T00:00:00.000Z,"NEFT DR-UTIB0000120-ADNAN ALI-NETBANK, M UM-N039211398998339-50000",,,net_banking_transfer,-50000
61b6ffc9d8beac1599eb2f5f,50200023535069,792599.56,60ec41ba55c00300382672d9,HDFC,direct expenses,5eecc6d6449e4f7cfb1c2708,2021-02-08T00:00:00.000Z,"NEFT DR-SYNB0005170-SNEHAL TAYDE-NETBANK , MUM-N039211399007426-27625",,,net_banking_transfer,-27625
61b6ffcad8beac1599eb2f65,50200023535069,756599.56,60ec41ba55c00300382672d9,HDFC,direct expenses,5eecc6d6449e4f7cfb1c2708,2021-02-08T00:00:00.000Z,00901610080520-TPT-36000-POOJA KAPIL SHR OTRIYA,,,net_banking_transfer,-36000
61b6ffcbd8beac1599eb2f69,50200023535069,656599.56,60ec41ba55c00300382672d9,HDFC,direct expenses,5eecc6d6449e4f7cfb1c2708,2021-02-08T00:00:00.000Z,02771610131904-TPT-100000-DIGANT BHATT,,,net_banking_transfer,-100000
61b6ffccd8beac1599eb2f6d,50200023535069,590599.56,60ec41ba55c00300382672d9,HDFC,direct expenses,5eecc6d6449e4f7cfb1c2708,2021-02-08T00:00:00.000Z,50100330586095-TPT-66000-DIWAKAR UNIYAL,,,net_banking_transfer,-66000
61b6ffcdd8beac1599eb2f73,50200023535069,540599.56,60ec41ba55c00300382672d9,HDFC,direct expenses,5eecc6d6449e4f7cfb1c2708,2021-02-08T00:00:00.000Z,IMPS-103908186436-PAYTM-PYTM-XXXXXXXX383 9-50000,ewallet,,net_banking_transfer,-50000
61b6ffced8beac1599eb2f78,50200023535069,390599.56,60ec41ba55c00300382672d9,HDFC,direct expenses,5eecc6d6449e4f7cfb1c2708,2021-02-08T00:00:00.000Z,"NEFT DR-YESB0000551-VISTTA COSMETICS-NET BANK, MUM-N039211399011070-150000",,,net_banking_transfer,-150000
61b6ffcfd8beac1599eb2f7c,50200023535069,446975.01,60ec41ba55c00300382672d9,HDFC,Revenue-PG-split enabled,5eecc6d6449e4f7cfb1c2708,2021-02-08T00:00:00.000Z,NEFT CR-UTIB0001506-RAZORPAY SOFTWARE PR IVATE LIMITED-SLICK ORGANICS PVT LITD-AX ISCN0068510168,investments,,net_banking_transfer,56375.45
61b6ffd0d8beac1599eb2f80,50200023535069,447463.92,60ec41ba55c00300382672d9,HDFC,Revenue-Mktplace,5eecc6d6449e4f7cfb1c2708,2021-02-08T00:00:00.000Z,NEFT CR-DEUT0797BGL-MYNTRA DESIGNS PRIVA TE LIMITED-SLICK ORGANICS PRIVATE LIMITE D-020800060GN00032,shopping,,net_banking_transfer,488.91
61b6ffd1d8beac1599eb2f84,50200023535069,377463.92,60ec41ba55c00300382672d9,HDFC,direct expenses,5eecc6d6449e4f7cfb1c2708,2021-02-08T00:00:00.000Z,"NEFT DR-PYTM0123456-PAYTM-NETBANK, MUM-N 039211399159202-70000",ewallet,,net_banking_transfer,-70000
61b6ffd2d8beac1599eb2f8c,50200023535069,359525.92,60ec41ba55c00300382672d9,HDFC,direct expenses,5eecc6d6449e4f7cfb1c2708,2021-02-08T00:00:00.000Z,50100301160692-TPT-17938-TARUN GARG,,,net_banking_transfer,-17938
61b6ffd3d8beac1599eb2f90,50200023535069,361952.13,60ec41ba55c00300382672d9,HDFC,Revenue-Mktplace,5eecc6d6449e4f7cfb1c2708,2021-02-08T00:00:00.000Z,NEFT CR-DEUT0797BGL-FLIPKART INTERNET PR IVATE LIMITED-SLICK ORGANICS PVT LTD-020 800235GN00265,shopping,,net_banking_transfer,2426.21
61b6ffd4d8beac1599eb2f95,50200023535069,365290.76,60ec41ba55c00300382672d9,HDFC,Transfer in/Revenue-other,5eecc6d6449e4f7cfb1c2708,2021-02-08T00:00:00.000Z,ZOOBOP ME WORK-ARATA,,,Other,3338.63
61b6ffd5d8beac1599eb2f9a,50200023535069,545290.76,60ec41ba55c00300382672d9,HDFC,Transfer in/Revenue-other,5eecc6d6449e4f7cfb1c2708,2021-02-08T00:00:00.000Z,02711600008220-TPT-180000-VARUN SINGH,,,net_banking_transfer,180000
61b6ffd6d8beac1599eb2f9e,50200023535069,548542.43,60ec41ba55c00300382672d9,HDFC,Revenue-Mktplace,5eecc6d6449e4f7cfb1c2708,2021-02-08T00:00:00.000Z,NEFT CR-DEUT0797BGL-FLIPKART INTERNET PR IVATE LIMITED-SLICK ORGANICS PVT LTD-020 800160GN00164,shopping,,net_banking_transfer,3251.67
61b6ffd7d8beac1599eb2fa1,50200023535069,509752.43,60ec41ba55c00300382672d9,HDFC,SAAS/tech expense,5eecc6d6449e4f7cfb1c2708,2021-02-08T00:00:00.000Z,POS 514834XXXXXX9486 AMAZON,shopping,,debit_card,-38790
61b6ffd8d8beac1599eb2fa7,50200023535069,536643.67,60ec41ba55c00300382672d9,HDFC,Revenue-COD,5eecc6d6449e4f7cfb1c2708,2021-02-08T00:00:00.000Z,NEFT CR-KKBK0000958-BIGFOOT RETAIL SOLUT IONS PRIVATE LIMITED-SLICK ORGANICS PVT LTD-KKBK210399786161,,,net_banking_transfer,26891.24
61b6ffd9d8beac1599eb2fad,50200023535069,545334.72,60ec41ba55c00300382672d9,HDFC,Revenue-PG-split enabled,5eecc6d6449e4f7cfb1c2708,2021-02-08T00:00:00.000Z,NEFT CR-UTIB0001506-RAZORPAY SOFTWARE PR IVATE LIMITED-SLICK ORGANICS PVT LITD-AX ISCN0068645408,investments,,net_banking_transfer,8691.05
61b6ffdad8beac1599eb2fb1,50200023535069,565723.27,60ec41ba55c00300382672d9,HDFC,Revenue-PG-non-split,5eecc6d6449e4f7cfb1c2708,2021-02-09T00:00:00.000Z,UPI-PAYTM-PAYOUTS@PAYTM-PYTM0123456-1040 90338021-ALL202102092168200,ewallet,,upi,20388.55
61b6ffdbd8beac1599eb2fb5,50200023535069,598169.42,60ec41ba55c00300382672d9,HDFC,Revenue-PG-split enabled,5eecc6d6449e4f7cfb1c2708,2021-02-09T00:00:00.000Z,NEFT CR-UTIB0001506-RAZORPAY SOFTWARE PR IVATE LIMITED-SLICK ORGANICS PVT LITD-AX ISCN0068684598,investments,,net_banking_transfer,32446.15
61b6ffdcd8beac1599eb2fbd,50200023535069,580416.42,60ec41ba55c00300382672d9,HDFC,direct expenses,5eecc6d6449e4f7cfb1c2708,2021-02-09T00:00:00.000Z,"NEFT DR-PUNB0307800-PRAKASH JHA-NETBANK, MUM-N040211400857265-17753",,,net_banking_transfer,-17753
61b6ffddd8beac1599eb2fc0,50200023535069,487916.42,60ec41ba55c00300382672d9,HDFC,direct expenses,5eecc6d6449e4f7cfb1c2708,2021-02-09T00:00:00.000Z,"NEFT DR-BKDN0450123-ARTISTO DESIGNZ-NETB ANK, MUM-N040211400867895-92500",,,net_banking_transfer,-92500
61b6ffddd8beac1599eb2fc5,50200023535069,479445.42,60ec41ba55c00300382672d9,HDFC,agency/vendor expense,5eecc6d6449e4f7cfb1c2708,2021-02-09T00:00:00.000Z,"NEFT DR-IDFB0021001-CLIKCONIK DIGITAL ME DIA PRIVATE LIMITED-NETBANK, MUM-N040211 400868616-8471",,,net_banking_transfer,-8471
61b6ffded8beac1599eb2fcd,50200023535069,467494.42,60ec41ba55c00300382672d9,HDFC,direct expenses,5eecc6d6449e4f7cfb1c2708,2021-02-09T00:00:00.000Z,"NEFT DR-CITI0000002-OMG NETWORK INDIA PR IVATE LIMITED-NETBANK, MUM-N040211400876 608-11951",,,net_banking_transfer,-11951
61b6ffdfd8beac1599eb2fdc,50200023535069,557894.79,60ec41ba55c00300382672d9,HDFC,Revenue-Mktplace,5eecc6d6449e4f7cfb1c2708,2021-02-09T00:00:00.000Z,IMPS-104011190266-AMAZON SELLER SERVIC-H DFC-XXXXXXXX6004-8ROHAX3GVWVQ1UHBSLICK O RGANICS PVT LTD,shopping,,net_banking_transfer,90400.37
61b6ffe0d8beac1599eb2fe0,50200023535069,960928.03,60ec41ba55c00300382672d9,HDFC,Revenue-Mktplace,5eecc6d6449e4f7cfb1c2708,2021-02-09T00:00:00.000Z,NEFT CR-DEUT0797BGL-AMAZON PAY (INDIA) P RIVATE LIMITED-SLICK ORGANICS PVT LTD-02 0900138GN00098,shopping,,net_banking_transfer,403033.24
61b6ffe1d8beac1599eb2fe5,50200023535069,962248.31,60ec41ba55c00300382672d9,HDFC,Revenue-Mktplace,5eecc6d6449e4f7cfb1c2708,2021-02-09T00:00:00.000Z,NEFT CR-ICIC0000105-MANASH LIFETYLE PVT LTD-SLICKORGANICSPRIVATELIMITEDMPGGN-ICI B210400081557,,,net_banking_transfer,1320.28
61b6ffe2d8beac1599eb2fee,50200023535069,962660.71,60ec41ba55c00300382672d9,HDFC,Revenue-Mktplace,5eecc6d6449e4f7cfb1c2708,2021-02-09T00:00:00.000Z,NEFT CR-ICIC0000105-MANASH LIFETYLE PVT,,,net_banking_transfer,412.4
61b6ffe3d8beac1599eb2ff1,50200023535069,979345.65,60ec41ba55c00300382672d9,HDFC,Revenue-PG-split enabled,5eecc6d6449e4f7cfb1c2708,2021-02-09T00:00:00.000Z,NEFT CR-UTIB0001506-RAZORPAY SOFTWARE PR IVATE LIMITED-SLICK ORGANICS PVT LITD-AX ISCN0068764107,investments,,net_banking_transfer,16684.94
61b6ffe4d8beac1599eb2ff5,50200023535069,983434.35,60ec41ba55c00300382672d9,HDFC,Transfer in/Revenue-other,5eecc6d6449e4f7cfb1c2708,2021-02-09T00:00:00.000Z,POS 514834******4081 RVSL DT - 05/02/21,,,Other,4088.7
61b6ffe5d8beac1599eb3002,50200023535069,1006740.28,60ec41ba55c00300382672d9,HDFC,Revenue-PG-non-split,5eecc6d6449e4f7cfb1c2708,2021-02-10T00:00:00.000Z,UPI-PAYTM-PAYOUTS@PAYTM-PYTM0123456-1041 13731833-ALL202102102168200,ewallet,,upi,23305.93
61b6ffe6d8beac1599eb3008,50200023535069,1007036.91,60ec41ba55c00300382672d9,HDFC,Revenue-Mktplace,5eecc6d6449e4f7cfb1c2708,2021-02-10T00:00:00.000Z,NEFT CR-DEUT0797BGL-MYNTRA DESIGNS PRIVA TE LIMITED-SLICK ORGANICS PRIVATE LIMITE D-021000182GN00244,shopping,,net_banking_transfer,296.63
61b6ffe7d8beac1599eb3012,50200023535069,1018179.72,60ec41ba55c00300382672d9,HDFC,Revenue-PG-split enabled,5eecc6d6449e4f7cfb1c2708,2021-02-10T00:00:00.000Z,NEFT CR-UTIB0001506-RAZORPAY SOFTWARE PR IVATE LIMITED-SLICK ORGANICS PVT LITD-AX ISCN0068803153,investments,,net_banking_transfer,11142.81
61b6ffe8d8beac1599eb301a,50200023535069,948179.72,60ec41ba55c00300382672d9,HDFC,Internal Transfers,5eecc6d6449e4f7cfb1c2708,2021-02-10T00:00:00.000Z,IB FUNDS TRANSFER DR-50200035187206 -SL ICK ORGANICS PVT LTD,investments,,net_banking_transfer,-70000
61b6ffe9d8beac1599eb3044,50200023535069,933179.72,60ec41ba55c00300382672d9,HDFC,direct expenses,5eecc6d6449e4f7cfb1c2708,2021-02-10T00:00:00.000Z,"NEFT DR-YESB0000551-VISTTA COSMETICS-NET BANK, MUM-N041211402331671-15000",,,net_banking_transfer,-15000
61b6ffead8beac1599eb3048,50200023535069,733179.72,60ec41ba55c00300382672d9,HDFC,direct expenses,5eecc6d6449e4f7cfb1c2708,2021-02-10T00:00:00.000Z,"NEFT DR-PYTM0123456-PAYTM-NETBANK, MUM-N 041211402526941-200000",ewallet,,net_banking_transfer,-200000
61b6ffebd8beac1599eb3050,50200023535069,734315.85,60ec41ba55c00300382672d9,HDFC,Revenue-Mktplace,5eecc6d6449e4f7cfb1c2708,2021-02-10T00:00:00.000Z,NEFT CR-DEUT0797BGL-FLIPKART INTERNET PR IVATE LIMITED-SLICK ORGANICS PVT LTD-021 000447GN00188,shopping,,net_banking_transfer,1136.13
61b6ffecd8beac1599eb3056,50200023535069,735435.45,60ec41ba55c00300382672d9,HDFC,Revenue-Mktplace,5eecc6d6449e4f7cfb1c2708,2021-02-10T00:00:00.000Z,NEFT CR-ICIC0000105-MANASH LIFETYLE PVT LTD-SLICK ORGANICS PRIVATE LIMITED MP MUM-ICIB210410179988,,,net_banking_transfer,1119.6
61b6ffedd8beac1599eb305b,50200023535069,735572.92,60ec41ba55c00300382672d9,HDFC,Revenue-Mktplace,5eecc6d6449e4f7cfb1c2708,2021-02-10T00:00:00.000Z,NEFT CR-ICIC0000105-MANASH LIFETYLE PVT LTD-SLICK ORGANICS PRIVATE LIMITED MP GGN-ICIB210410179987,,,net_banking_transfer,137.47
61b6ffeed8beac1599eb307d,50200023535069,731484.22,60ec41ba55c00300382672d9,HDFC,direct expenses,5eecc6d6449e4f7cfb1c2708,2021-02-10T00:00:00.000Z,POS 514834******4081 DT-05/02/21,,,debit_card,-4088.7
61b6ffefd8beac1599eb3082,50200023535069,738643.87,60ec41ba55c00300382672d9,HDFC,Revenue-PG-split enabled,5eecc6d6449e4f7cfb1c2708,2021-02-10T00:00:00.000Z,NEFT CR-UTIB0001506-RAZORPAY SOFTWARE PR,,,net_banking_transfer,7159.65
61b6fff0d8beac1599eb308c,50200023535069,688643.87,60ec41ba55c00300382672d9,HDFC,Marketing Expense,5eecc6d6449e4f7cfb1c2708,2021-02-10T00:00:00.000Z,POS 514834XXXXXX9486 GOOGLE ADWORDS,,,debit_card,-50000
61b6fff1d8beac1599eb3090,50200023535069,705549.11,60ec41ba55c00300382672d9,HDFC,Revenue-COD,5eecc6d6449e4f7cfb1c2708,2021-02-10T00:00:00.000Z,NEFT CR-KKBK0000958-BIGFOOT RETAIL SOLUT IONS PRIVATE LIMITED-SLICK ORGANICS PVT LTD-KKBK210411316628,,,net_banking_transfer,16905.24
61b6fff2d8beac1599eb3095,50200023535069,730713.88,60ec41ba55c00300382672d9,HDFC,Revenue-PG-non-split,5eecc6d6449e4f7cfb1c2708,2021-02-11T00:00:00.000Z,UPI-PAYTM-PAYOUTS@PAYTM-PYTM0123456-1042 37570637-ALL202102112168200,ewallet,,upi,25164.77
61b6fff3d8beac1599eb309c,50200023535069,780713.88,60ec41ba55c00300382672d9,HDFC,Transfer in/Revenue-other,5eecc6d6449e4f7cfb1c2708,2021-02-11T00:00:00.000Z,02711600008220-TPT-50000-VARUN SINGH,,,net_banking_transfer,50000
61b6fff4d8beac1599eb30a0,50200023535069,796339.13,60ec41ba55c00300382672d9,HDFC,Revenue-PG-split enabled,5eecc6d6449e4f7cfb1c2708,2021-02-11T00:00:00.000Z,NEFT CR-UTIB0001506-RAZORPAY SOFTWARE PR IVATE LIMITED-SLICK ORGANICS PVT LITD-AX ISCN0068919525,investments,,net_banking_transfer,15625.25
61b6fff5d8beac1599eb30a3,50200023535069,775759.13,60ec41ba55c00300382672d9,HDFC,direct expenses,5eecc6d6449e4f7cfb1c2708,2021-02-11T00:00:00.000Z,"NEFT DR-ICIC0000542-AVANTIKA SUKHIA-NETB ANK, MUM-N042211404317755-20580",,,net_banking_transfer,-20580
61b6fff6d8beac1599eb30a8,50200023535069,776156.09,60ec41ba55c00300382672d9,HDFC,Revenue-Mktplace,5eecc6d6449e4f7cfb1c2708,2021-02-11T00:00:00.000Z,NEFT CR-ICIC0000105-MANASH LIFETYLE PVT LTD-SLICKORGANICSPRIVATELIMITEDMPGGN-ICI B210420060770,,,net_banking_transfer,396.96
61b6fff6d8beac1599eb30bc,50200023535069,788145.28,60ec41ba55c00300382672d9,HDFC,Revenue-PG-split enabled,5eecc6d6449e4f7cfb1c2708,2021-02-11T00:00:00.000Z,NEFT CR-UTIB0001506-RAZORPAY SOFTWARE PR IVATE LIMITED-SLICK ORGANICS PVT LITD-AX ISCN0069004226,investments,,net_banking_transfer,11989.19
61b6fff7d8beac1599eb30c1,50200023535069,807771.83,60ec41ba55c00300382672d9,HDFC,Revenue-PG-non-split,5eecc6d6449e4f7cfb1c2708,2021-02-12T00:00:00.000Z,UPI-PAYTM-PAYOUTS@PAYTM-PYTM0123456-1043 61312744-ALL202102122168200,ewallet,,upi,19626.55
61b6fff8d8beac1599eb30c4,50200023535069,808890.99,60ec41ba55c00300382672d9,HDFC,Revenue-Mktplace,5eecc6d6449e4f7cfb1c2708,2021-02-12T00:00:00.000Z,NEFT CR-DEUT0797BGL-MYNTRA DESIGNS PRIVA TE LIMITED-SLICK ORGANICS PRIVATE LIMITE D-021200108GN00185,shopping,,net_banking_transfer,1119.16
61b6fff9d8beac1599eb30c9,50200023535069,823968.3,60ec41ba55c00300382672d9,HDFC,Revenue-PG-split enabled,5eecc6d6449e4f7cfb1c2708,2021-02-12T00:00:00.000Z,NEFT CR-UTIB0001506-RAZORPAY SOFTWARE PR IVATE LIMITED-SLICK ORGANICS PVT LITD-AX ISCN0069044632,investments,,net_banking_transfer,15077.31
61b6fffad8beac1599eb30d0,50200023535069,830176.24,60ec41ba55c00300382672d9,HDFC,Revenue-Mktplace,5eecc6d6449e4f7cfb1c2708,2021-02-12T00:00:00.000Z,NEFT CR-DEUT0797BGL-FLIPKART INTERNET PR IVATE LIMITED-SLICK ORGANICS PVT LTD-021 200176GN00104,shopping,,net_banking_transfer,6207.94
61b6fffbd8beac1599eb30d6,50200023535069,823676.24,60ec41ba55c00300382672d9,HDFC,direct expenses,5eecc6d6449e4f7cfb1c2708,2021-02-12T00:00:00.000Z,POS 514834XXXXXX9486 PAYPAL *ARATAGLO,,,debit_card,-6500
61b6fffcd8beac1599eb30ed,50200023535069,823588.87,60ec41ba55c00300382672d9,HDFC,bank charges,5eecc6d6449e4f7cfb1c2708,2021-02-12T00:00:00.000Z,.DC INTL POS TXN MARKUP+ST 010221 020221,,,international_transaction_arbitrage,-87.37
61b6fffdd8beac1599eb3101,50200023535069,828214.27,60ec41ba55c00300382672d9,HDFC,Revenue-Mktplace,5eecc6d6449e4f7cfb1c2708,2021-02-12T00:00:00.000Z,NEFT CR-KKBK0000958-SUPERMARKET GROCERY SUPPLIES PVT LTD-SLICK ORGANICS PVT LTD- KKBK210431646048,shopping,,net_banking_transfer,4625.4
61b6fffed8beac1599eb310c,50200023535069,828429.3,60ec41ba55c00300382672d9,HDFC,Revenue-PG-split enabled,5eecc6d6449e4f7cfb1c2708,2021-02-12T00:00:00.000Z,NEFT CR-UTIB0001506-RAZORPAY SOFTWARE PR IVATE LIMITED-SLICK ORGANICS-AXISCN00690 69014,investments,,net_banking_transfer,215.03
61b6ffffd8beac1599eb3117,50200023535069,828840.24,60ec41ba55c00300382672d9,HDFC,Revenue-Mktplace,5eecc6d6449e4f7cfb1c2708,2021-02-12T00:00:00.000Z,NEFT CR-ICIC0000105-MANASH LIFETYLE PVT LTD-SLICKORGANICSPRIVATELIMITEDMPGGN-ICI B210430020881,,,net_banking_transfer,410.94
61b70000d8beac1599eb311f,50200023535069,829208.96,60ec41ba55c00300382672d9,HDFC,Transfer in/Revenue-other,5eecc6d6449e4f7cfb1c2708,2021-02-12T00:00:00.000Z,NEFT CR-YESB0000001-ILUMINAR MEDIA-SLICK ORGANICS PVT. LTD-N043210514229790,,,net_banking_transfer,368.72
61b70001d8beac1599eb312e,50200023535069,830457.96,60ec41ba55c00300382672d9,HDFC,Revenue-Mktplace,5eecc6d6449e4f7cfb1c2708,2021-02-12T00:00:00.000Z,NEFT CR-DEUT0797BGL-MYNTRA DESIGNS PRIVA TE LIMITED-SLICK ORGANICS PRIVATE LIMITE D-021200132GN00026,shopping,,net_banking_transfer,1249
61b70002d8beac1599eb3135,50200023535069,874339.98,60ec41ba55c00300382672d9,HDFC,Revenue-COD,5eecc6d6449e4f7cfb1c2708,2021-02-12T00:00:00.000Z,NEFT CR-KKBK0000958-BIGFOOT RETAIL SOLUT IONS PRIVATE LIMITED-SLICK ORGANICS PVT LTD-KKBK210431714008,,,net_banking_transfer,43882.02
61b70003d8beac1599eb313b,50200023535069,920731.71,60ec41ba55c00300382672d9,HDFC,Revenue-PG-split enabled,5eecc6d6449e4f7cfb1c2708,2021-02-12T00:00:00.000Z,NEFT CR-UTIB0001506-RAZORPAY SOFTWARE PR IVATE LIMITED-SLICK ORGANICS PVT LITD-AX ISCN0069132296,investments,,net_banking_transfer,46391.73
61b70004d8beac1599eb314c,50200023535069,917168.67,60ec41ba55c00300382672d9,HDFC,direct expenses,5eecc6d6449e4f7cfb1c2708,2021-02-12T00:00:00.000Z,POS 514834XXXXXX9486 WWW.FAQPRIME.COM,,,debit_card,-3563.04
61b70005d8beac1599eb3151,50200023535069,917642.06,60ec41ba55c00300382672d9,HDFC,Revenue-Mktplace,5eecc6d6449e4f7cfb1c2708,2021-02-12T00:00:00.000Z,NEFT CR-DEUT0784BBY-TATA UNISTORE LTD-NO DAL-SLICK ORGANICS PVT LTD-021201916GN00 401,investments,,net_banking_transfer,473.39
61b70006d8beac1599eb315a,50200023535069,973363.32,60ec41ba55c00300382672d9,HDFC,Transfer in/Revenue-other,5eecc6d6449e4f7cfb1c2708,2021-02-13T00:00:00.000Z,IMPS-104405783496-NA-HDFC-XXXXXXXXXX0007 -ALL20210213216820000330830668628,,,net_banking_transfer,55721.26
61b70007d8beac1599eb3163,50200023535069,978856.98,60ec41ba55c00300382672d9,HDFC,Revenue-PG-non-split,5eecc6d6449e4f7cfb1c2708,2021-02-14T00:00:00.000Z,UPI-PAYTM-PAYOUTS@PAYTM-PYTM0123456-1045 08340532-ALL202102142168200,ewallet,,upi,5493.66
61b70008d8beac1599eb3169,50200023535069,996399.54,60ec41ba55c00300382672d9,HDFC,Revenue-PG-non-split,5eecc6d6449e4f7cfb1c2708,2021-02-15T00:00:00.000Z,UPI-PAYTM-PAYOUTS@PAYTM-PYTM0123456-1046 31268785-ALL202102152168200,ewallet,,upi,17542.56
61b70009d8beac1599eb316e,50200023535069,1102568.46,60ec41ba55c00300382672d9,HDFC,Revenue-PG-split enabled,5eecc6d6449e4f7cfb1c2708,2021-02-15T00:00:00.000Z,NEFT CR-UTIB0001506-RAZORPAY SOFTWARE PR,,,net_banking_transfer,106168.92
61b7000ad8beac1599eb3176,50200023535069,1091859.46,60ec41ba55c00300382672d9,HDFC,Tax,5eecc6d6449e4f7cfb1c2708,2021-02-15T00:00:00.000Z,051030815022111547- CBDT TAX,,,Other,-10709
61b7000bd8beac1599eb317f,50200023535069,1086552.46,60ec41ba55c00300382672d9,HDFC,Tax,5eecc6d6449e4f7cfb1c2708,2021-02-15T00:00:00.000Z,051030815022111699- CBDT TAX,,,Other,-5307
61b7000cd8beac1599eb3186,50200023535069,1081245.46,60ec41ba55c00300382672d9,HDFC,Tax,5eecc6d6449e4f7cfb1c2708,2021-02-15T00:00:00.000Z,051030815022111850- CBDT TAX,,,Other,-5307
61b7000cd8beac1599eb318c,50200023535069,1065324.46,60ec41ba55c00300382672d9,HDFC,Tax,5eecc6d6449e4f7cfb1c2708,2021-02-15T00:00:00.000Z,051030815022112044- CBDT TAX,,,Other,-15921
61b7000dd8beac1599eb3196,50200023535069,1059624.46,60ec41ba55c00300382672d9,HDFC,Tax,5eecc6d6449e4f7cfb1c2708,2021-02-15T00:00:00.000Z,051030815022112204- CBDT TAX,,,Other,-5700
61b7000ed8beac1599eb319f,50200023535069,1049624.46,60ec41ba55c00300382672d9,HDFC,direct expenses,5eecc6d6449e4f7cfb1c2708,2021-02-15T00:00:00.000Z,POS 514834XXXXXX9486 PAYPAL *ARATAGLO,,,debit_card,-10000
61b7000fd8beac1599eb31a4,50200023535069,1050021.4,60ec41ba55c00300382672d9,HDFC,Revenue-Mktplace,5eecc6d6449e4f7cfb1c2708,2021-02-15T00:00:00.000Z,NEFT CR-DEUT0797BGL-MYNTRA DESIGNS PRIVA TE LIMITED-SLICK ORGANICS PRIVATE LIMITE D-021500395GN00082,shopping,,net_banking_transfer,396.94
61b70010d8beac1599eb31ab,50200023535069,1015766.4,60ec41ba55c00300382672d9,HDFC,direct expenses,5eecc6d6449e4f7cfb1c2708,2021-02-15T00:00:00.000Z,50200016295776-TPT-34255-V KESHRI AND AS SOCIATES,,,net_banking_transfer,-34255
61b70011d8beac1599eb31af,50200023535069,1018364.11,60ec41ba55c00300382672d9,HDFC,Revenue-Mktplace,5eecc6d6449e4f7cfb1c2708,2021-02-15T00:00:00.000Z,NEFT CR-DEUT0797BGL-FLIPKART INTERNET PR IVATE LIMITED-SLICK ORGANICS PVT LTD-021 500513GN00034,shopping,,net_banking_transfer,2597.71
61b70012d8beac1599eb31b3,50200023535069,1017987.9,60ec41ba55c00300382672d9,HDFC,bank charges,5eecc6d6449e4f7cfb1c2708,2021-02-15T00:00:00.000Z,.DC INTL POS TXN MARKUP+ST 040221 050221 -CDT2103302935063,,,international_transaction_arbitrage,-376.21
61b70013d8beac1599eb31b8,50200023535069,1017982,60ec41ba55c00300382672d9,HDFC,direct expenses,5eecc6d6449e4f7cfb1c2708,2021-02-15T00:00:00.000Z,.IMPS P2P 103908186436#08/02/2021 080221 -CDT2104503101708,,,net_banking_transfer,-5.9
61b70014d8beac1599eb31be,50200023535069,1018294.86,60ec41ba55c00300382672d9,HDFC,Revenue-Mktplace,5eecc6d6449e4f7cfb1c2708,2021-02-15T00:00:00.000Z,NEFT CR-DEUT0797BGL-MYNTRA DESIGNS PRIVA TE LIMITED-SLICK ORGANICS PRIVATE LIMITE D-021500396GN00067,shopping,,net_banking_transfer,312.86
61b70015d8beac1599eb31c3,50200023535069,1020386.95,60ec41ba55c00300382672d9,HDFC,Revenue-Mktplace,5eecc6d6449e4f7cfb1c2708,2021-02-15T00:00:00.000Z,NEFT CR-DEUT0797BGL-FLIPKART INTERNET PR IVATE LIMITED-SLICK ORGANICS PVT LTD-021 500657GN00054,shopping,,net_banking_transfer,2092.09
61b70016d8beac1599eb31c7,50200023535069,1062488.4,60ec41ba55c00300382672d9,HDFC,Revenue-COD,5eecc6d6449e4f7cfb1c2708,2021-02-15T00:00:00.000Z,NEFT CR-KKBK0000958-BIGFOOT RETAIL SOLUT IONS PRIVATE LIMITED-SLICK ORGANICS PVT LTD-KKBK210462165595,,,net_banking_transfer,42101.45
61b70017d8beac1599eb31ca,50200023535069,1076067.05,60ec41ba55c00300382672d9,HDFC,Revenue-PG-split enabled,5eecc6d6449e4f7cfb1c2708,2021-02-15T00:00:00.000Z,NEFT CR-UTIB0001506-RAZORPAY SOFTWARE PR,,,net_banking_transfer,13578.65
61b70018d8beac1599eb31d2,50200023535069,1076068.05,60ec41ba55c00300382672d9,HDFC,Transfer in/Revenue-other,5eecc6d6449e4f7cfb1c2708,2021-02-15T00:00:00.000Z,POS REF 514834******9486-02/14 GOOGLE146,,,refund,1
61b70019d8beac1599eb31d7,50200023535069,1098018.78,60ec41ba55c00300382672d9,HDFC,Revenue-PG-non-split,5eecc6d6449e4f7cfb1c2708,2021-02-16T00:00:00.000Z,UPI-PAYTM-PAYOUTS@PAYTM-PYTM0123456-1047 54163401-ALL202102162168200,ewallet,,upi,21950.73
61b7001ad8beac1599eb31dd,50200023535069,1099032.78,60ec41ba55c00300382672d9,HDFC,Revenue-Mktplace,5eecc6d6449e4f7cfb1c2708,2021-02-16T00:00:00.000Z,NEFT CR-KKBK0000958-SURFBOATS SOLUTIONS PVT LTD-SLICK ORGANICS PRIVATE LIMITED-K KBK210472256571,investments,,net_banking_transfer,1014
61b7001bd8beac1599eb31e3,50200023535069,1112842.15,60ec41ba55c00300382672d9,HDFC,Revenue-PG-split enabled,5eecc6d6449e4f7cfb1c2708,2021-02-16T00:00:00.000Z,NEFT CR-UTIB0001506-RAZORPAY SOFTWARE PR IVATE LIMITED-SLICK ORGANICS PVT LITD-AX ISCN0069355438,investments,,net_banking_transfer,13809.37
61b7001cd8beac1599eb31e7,50200023535069,1218991.86,60ec41ba55c00300382672d9,HDFC,Revenue-Mktplace,5eecc6d6449e4f7cfb1c2708,2021-02-16T00:00:00.000Z,IMPS-104711105797-AMAZON SELLER SERVIC-H DFC-XXXXXXXX6004-6BJTP7HN0W8OH3E0SLICK O RGANICS PVT LTD,shopping,,net_banking_transfer,106149.71
61b7001dd8beac1599eb31eb,50200023535069,1597768.09,60ec41ba55c00300382672d9,HDFC,Revenue-Mktplace,5eecc6d6449e4f7cfb1c2708,2021-02-16T00:00:00.000Z,NEFT CR-DEUT0797BGL-AMAZON PAY (INDIA) P RIVATE LIMITED-SLICK ORGANICS PVT LTD-02 1600146GN00013,shopping,,net_banking_transfer,378776.23
61b7001ed8beac1599eb31f1,50200023535069,1575582.09,60ec41ba55c00300382672d9,HDFC,direct expenses,5eecc6d6449e4f7cfb1c2708,2021-02-16T00:00:00.000Z,"NEFT DR-CITI0000002-OMG NETWORK INDIA PR IVATE LIMITED-NETBANK, MUM-N047211408868 637-22186",,,net_banking_transfer,-22186
61b7001fd8beac1599eb31f8,50200023535069,1565061.09,60ec41ba55c00300382672d9,HDFC,direct expenses,5eecc6d6449e4f7cfb1c2708,2021-02-16T00:00:00.000Z,"NEFT DR-CITI0000032-TRADETRACKER INDIA L LP-NETBANK, MUM-N047211408880469-10521",,,net_banking_transfer,-10521
61b70020d8beac1599eb31fd,50200023535069,1420500.09,60ec41ba55c00300382672d9,HDFC,agency/vendor expense,5eecc6d6449e4f7cfb1c2708,2021-02-16T00:00:00.000Z,"NEFT DR-KKBK0000298-ADMITAD MEDIA PRIVAT E LIMITED-NETBANK, MUM-N047211408881645- 144561",loans,lender_transaction,net_banking_transfer,-144561
61b70021d8beac1599eb3200,50200023535069,1187996.09,60ec41ba55c00300382672d9,HDFC,direct expenses,5eecc6d6449e4f7cfb1c2708,2021-02-16T00:00:00.000Z,"NEFT DR-ORBC0100707-UFLEX LIMITED-NETBAN K, MUM-N047211408880251-232504",loans,lender_transaction,net_banking_transfer,-232504
61b70022d8beac1599eb3208,50200023535069,1170896.09,60ec41ba55c00300382672d9,HDFC,Tax,5eecc6d6449e4f7cfb1c2708,2021-02-16T00:00:00.000Z,051030816022112489- CBDT TAX,,,Other,-17100
61b70023d8beac1599eb320b,50200023535069,1154975.09,60ec41ba55c00300382672d9,HDFC,Tax,5eecc6d6449e4f7cfb1c2708,2021-02-16T00:00:00.000Z,051030816022112553- CBDT TAX,,,Other,-15921
61b70024d8beac1599eb3211,50200023535069,1054975.09,60ec41ba55c00300382672d9,HDFC,direct expenses,5eecc6d6449e4f7cfb1c2708,2021-02-16T00:00:00.000Z,57500000443889-TPT-100000-WEBKLIPPER TEC HNOLOGIES PRIVATE LIMITED,,,net_banking_transfer,-100000
61b70024d8beac1599eb3217,50200023535069,1106975.09,60ec41ba55c00300382672d9,HDFC,Internal Transfers,5eecc6d6449e4f7cfb1c2708,2021-02-16T00:00:00.000Z,IB FUNDS TRANSFER CR-50200050976833 -SL ICK ORGANICS PVT LTD,investments,,Other,52000
61b70025d8beac1599eb321b,50200023535069,1107121.38,60ec41ba55c00300382672d9,HDFC,Revenue-Mktplace,5eecc6d6449e4f7cfb1c2708,2021-02-16T00:00:00.000Z,NEFT CR-ICIC0000105-MANASH LIFETYLE PVT,,,net_banking_transfer,146.29
61b70026d8beac1599eb321f,50200023535069,1125264.89,60ec41ba55c00300382672d9,HDFC,Revenue-PG-split enabled,5eecc6d6449e4f7cfb1c2708,2021-02-16T00:00:00.000Z,NEFT CR-UTIB0001506-RAZORPAY SOFTWARE PR IVATE LIMITED-SLICK ORGANICS PVT LITD-AX ISCN0069448385,investments,,net_banking_transfer,18143.51
61b70027d8beac1599eb322f,50200023535069,1124537.79,60ec41ba55c00300382672d9,HDFC,direct expenses,5eecc6d6449e4f7cfb1c2708,2021-02-16T00:00:00.000Z,POS 514834XXXXXX9486 MANYCHAT COM PRO,,,debit_card,-727.1
61b70028d8beac1599eb3235,50200023535069,1143546.59,60ec41ba55c00300382672d9,HDFC,Revenue-PG-non-split,5eecc6d6449e4f7cfb1c2708,2021-02-17T00:00:00.000Z,UPI-PAYTM-PAYOUTS@PAYTM-PYTM0123456-1048 76273987-ALL202102172168200,ewallet,,upi,19008.8
61b70029d8beac1599eb323a,50200023535069,1164890.06,60ec41ba55c00300382672d9,HDFC,Revenue-PG-split enabled,5eecc6d6449e4f7cfb1c2708,2021-02-17T00:00:00.000Z,NEFT CR-UTIB0001506-RAZORPAY SOFTWARE PR IVATE LIMITED-SLICK ORGANICS PVT LITD-AX ISCN0069483539,investments,,net_banking_transfer,21343.47
61b7002ad8beac1599eb3249,50200023535069,1166293.36,60ec41ba55c00300382672d9,HDFC,Revenue-Mktplace,5eecc6d6449e4f7cfb1c2708,2021-02-17T00:00:00.000Z,NEFT CR-DEUT0797BGL-MYNTRA DESIGNS PRIVA TE LIMITED-SLICK ORGANICS PRIVATE LIMITE D-021700172GN00077,shopping,,net_banking_transfer,1403.3
61b7002bd8beac1599eb324d,50200023535069,1104735.36,60ec41ba55c00300382672d9,HDFC,direct expenses,5eecc6d6449e4f7cfb1c2708,2021-02-17T00:00:00.000Z,"NEFT DR-YESB0000162-VINAY REDDY-NETBANK, MUM-N048211409939130-61558",,,net_banking_transfer,-61558
61b7002cd8beac1599eb3256,50200023535069,904735.36,60ec41ba55c00300382672d9,HDFC,direct expenses,5eecc6d6449e4f7cfb1c2708,2021-02-17T00:00:00.000Z,"NEFT DR-KKBK0000180-VEDIC COSMECEUTICALS PVT LTD-NETBANK, MUM-N048211409947366-2 00000",,,net_banking_transfer,-200000
61b7002dd8beac1599eb3262,50200023535069,904810.53,60ec41ba55c00300382672d9,HDFC,Revenue-Mktplace,5eecc6d6449e4f7cfb1c2708,2021-02-17T00:00:00.000Z,NEFT CR-DEUT0797BGL-FLIPKART INTERNET PR IVATE LIMITED-SLICK ORGANICS PVT LTD-021 700202GN00222,shopping,,net_banking_transfer,75.17
61b7002ed8beac1599eb326b,50200023535069,804810.53,60ec41ba55c00300382672d9,HDFC,direct expenses,5eecc6d6449e4f7cfb1c2708,2021-02-17T00:00:00.000Z,IMPS-104811147725-PAYTM-PYTM-XXXXXXXX383 9-100000,ewallet,,net_banking_transfer,-100000
61b7002fd8beac1599eb326f,50200023535069,704810.53,60ec41ba55c00300382672d9,HDFC,direct expenses,5eecc6d6449e4f7cfb1c2708,2021-02-17T00:00:00.000Z,05892560000649-TPT-100000-DECORPAC INDIA PRIVATE LIMITED,,,net_banking_transfer,-100000
61b70030d8beac1599eb3279,50200023535069,713281.45,60ec41ba55c00300382672d9,HDFC,Revenue-PG-non-split,5eecc6d6449e4f7cfb1c2708,2021-02-17T00:00:00.000Z,NEFT CR-SCBL0036001-STRIPE INDIA PRIVATE -SLICK ORGANICS PRIVATE LIMITED-SSG17413 Q0190105,investments,,net_banking_transfer,8470.92
61b70031d8beac1599eb327e,50200023535069,713349.09,60ec41ba55c00300382672d9,HDFC,Revenue-Mktplace,5eecc6d6449e4f7cfb1c2708,2021-02-17T00:00:00.000Z,NEFT CR-ICIC0000105-MANASH LIFETYLE PVT,,,net_banking_transfer,67.64
61b70032d8beac1599eb3284,50200023535069,713622.12,60ec41ba55c00300382672d9,HDFC,Revenue-Mktplace,5eecc6d6449e4f7cfb1c2708,2021-02-17T00:00:00.000Z,NEFT CR-DEUT0797BGL-MYNTRA DESIGNS PRIVA TE LIMITED-SLICK ORGANICS PRIVATE LIMITE D-021700170GN00145,shopping,,net_banking_transfer,273.03
61b70033d8beac1599eb328b,50200023535069,711078.53,60ec41ba55c00300382672d9,HDFC,direct expenses,5eecc6d6449e4f7cfb1c2708,2021-02-17T00:00:00.000Z,POS 514834XXXXXX9486 AMZNMKTPLACE,,,debit_card,-2543.59
61b70034d8beac1599eb3291,50200023535069,725900.16,60ec41ba55c00300382672d9,HDFC,Revenue-COD,5eecc6d6449e4f7cfb1c2708,2021-02-17T00:00:00.000Z,NEFT CR-KKBK0000958-BIGFOOT RETAIL SOLUT IONS PRIVATE LIMITED-SLICK ORGANICS PVT LTD-KKBK210482629156,,,net_banking_transfer,14821.63
61b70035d8beac1599eb3295,50200023535069,739006.96,60ec41ba55c00300382672d9,HDFC,Revenue-PG-split enabled,5eecc6d6449e4f7cfb1c2708,2021-02-17T00:00:00.000Z,NEFT CR-UTIB0001506-RAZORPAY SOFTWARE PR IVATE LIMITED-SLICK ORGANICS PVT LITD-AX ISCN0069556836,investments,,net_banking_transfer,13106.8
61b70036d8beac1599eb329d,50200023535069,752580.16,60ec41ba55c00300382672d9,HDFC,Revenue-PG-non-split,5eecc6d6449e4f7cfb1c2708,2021-02-18T00:00:00.000Z,UPI-PAYTM-PAYOUTS@PAYTM-PYTM0123456-1049 00019372-ALL202102182168200,ewallet,,upi,13573.2
61b70037d8beac1599eb329f,50200023535069,770904.97,60ec41ba55c00300382672d9,HDFC,Revenue-PG-split enabled,5eecc6d6449e4f7cfb1c2708,2021-02-18T00:00:00.000Z,NEFT CR-UTIB0001506-RAZORPAY SOFTWARE PR IVATE LIMITED-SLICK ORGANICS PVT LITD-AX ISCN0069625284,investments,,net_banking_transfer,18324.81
61b70038d8beac1599eb32a4,50200023535069,720904.97,60ec41ba55c00300382672d9,HDFC,Marketing Expense,5eecc6d6449e4f7cfb1c2708,2021-02-18T00:00:00.000Z,POS 514834XXXXXX9486 GOOGLE ADWORDS,,,debit_card,-50000
61b70039d8beac1599eb32ab,50200023535069,721987.8,60ec41ba55c00300382672d9,HDFC,Revenue-Mktplace,5eecc6d6449e4f7cfb1c2708,2021-02-18T00:00:00.000Z,NEFT CR-ICIC0000105-MANASH LIFETYLE PVT LTD-SLICKORGANICSPRIVATELIMITEDMPMUM-ICI B210490062239,,,net_banking_transfer,1082.83
61b7003ad8beac1599eb32b1,50200023535069,731924.68,60ec41ba55c00300382672d9,HDFC,Revenue-PG-split enabled,5eecc6d6449e4f7cfb1c2708,2021-02-18T00:00:00.000Z,NEFT CR-UTIB0001506-RAZORPAY SOFTWARE PR IVATE LIMITED-SLICK ORGANICS PVT LITD-AX ISCN0069719546,investments,,net_banking_transfer,9936.88
61b7003bd8beac1599eb32b4,50200023535069,3231924.68,60ec41ba55c00300382672d9,HDFC,Transfer in/Revenue-other,5eecc6d6449e4f7cfb1c2708,2021-02-18T00:00:00.000Z,NEFT CR-ICIC0SF0002-GLANCE GETVANTAGE ES CROW ACCOUNT 1-SLICK ORGANICS PRIVATE LI MITED-48137525,,,net_banking_transfer,2500000
61b7003cd8beac1599eb32b9,50200023535069,3243937.7,60ec41ba55c00300382672d9,HDFC,Revenue-PG-non-split,5eecc6d6449e4f7cfb1c2708,2021-02-19T00:00:00.000Z,UPI-PAYTM-PAYOUTS@PAYTM-PYTM0123456-1050 22448354-ALL202102192168200,ewallet,,upi,12013.02
61b7003dd8beac1599eb32bf,50200023535069,3252434.86,60ec41ba55c00300382672d9,HDFC,Revenue-Mktplace,5eecc6d6449e4f7cfb1c2708,2021-02-19T00:00:00.000Z,NEFT CR-DEUT0797BGL-FLIPKART INTERNET PR IVATE LIMITED-SLICK ORGANICS PVT LTD-021 900151GN00272,shopping,,net_banking_transfer,8497.16
61b7003ed8beac1599eb32c5,50200023535069,3253624.05,60ec41ba55c00300382672d9,HDFC,Revenue-Mktplace,5eecc6d6449e4f7cfb1c2708,2021-02-19T00:00:00.000Z,NEFT CR-DEUT0797BGL-MYNTRA DESIGNS PRIVA,shopping,,net_banking_transfer,1189.19
61b7003fd8beac1599eb32c8,50200023535069,3262430.08,60ec41ba55c00300382672d9,HDFC,Revenue-Mktplace,5eecc6d6449e4f7cfb1c2708,2021-02-19T00:00:00.000Z,NEFT CR-DEUT0797BGL-FLIPKART INTERNET PR IVATE LIMITED-SLICK ORGANICS PVT LTD-021 900185GN00073,shopping,,net_banking_transfer,8806.03
61b70040d8beac1599eb32ce,50200023535069,3109625.08,60ec41ba55c00300382672d9,HDFC,direct expenses,5eecc6d6449e4f7cfb1c2708,2021-02-19T00:00:00.000Z,"NEFT DR-KKBK0000180-VEDIC COSMECEUTICALS PVT LTD-NETBANK, MUM-N050211411962691-1 52805",,,net_banking_transfer,-152805
61b70040d8beac1599eb32d3,50200023535069,3089625.08,60ec41ba55c00300382672d9,HDFC,direct expenses,5eecc6d6449e4f7cfb1c2708,2021-02-19T00:00:00.000Z,SARVAN KUMAR 809489779410 - CHQ PAID - D EVLI ROAD K,,,chq,-20000
61b70041d8beac1599eb32d7,50200023535069,3089977.21,60ec41ba55c00300382672d9,HDFC,Revenue-Mktplace,5eecc6d6449e4f7cfb1c2708,2021-02-19T00:00:00.000Z,NEFT CR-ICIC0000105-MANASH LIFETYLE PVT LTD-SLICK ORGANICS PRIVATE LIMITED MP MUM-ICIB210500141473,,,net_banking_transfer,352.13
61b70042d8beac1599eb32de,50200023535069,3091339.83,60ec41ba55c00300382672d9,HDFC,Revenue-Mktplace,5eecc6d6449e4f7cfb1c2708,2021-02-19T00:00:00.000Z,NEFT CR-DEUT0797BGL-MYNTRA DESIGNS PRIVA TE LIMITED-SLICK ORGANICS PRIVATE LIMITE D-021900216GN00250,shopping,,net_banking_transfer,1362.62
61b70043d8beac1599eb32e2,50200023535069,3149265.41,60ec41ba55c00300382672d9,HDFC,Revenue-COD,5eecc6d6449e4f7cfb1c2708,2021-02-19T00:00:00.000Z,NEFT CR-KKBK0000958-BIGFOOT RETAIL SOLUT IONS PRIVATE LIMITED-SLICK ORGANICS PVT LTD-KKBK210503043800,,,net_banking_transfer,57925.58
61b70044d8beac1599eb32e8,50200023535069,3150651.38,60ec41ba55c00300382672d9,HDFC,Transfer in/Revenue-other,5eecc6d6449e4f7cfb1c2708,2021-02-19T00:00:00.000Z,NEFT CR-YESB0000001-ILUMINAR MEDIA-SLICK ORGANICS PVT. LTD-N050210518783375,,,net_banking_transfer,1385.97
61b70045d8beac1599eb32ed,50200023535069,3177366.19,60ec41ba55c00300382672d9,HDFC,Revenue-PG-non-split,5eecc6d6449e4f7cfb1c2708,2021-02-20T00:00:00.000Z,UPI-PAYTM-PAYOUTS@PAYTM-PYTM0123456-1051 45425523-ALL202102202168200,ewallet,,upi,26714.81
61b70046d8beac1599eb32f3,50200023535069,3237411.07,60ec41ba55c00300382672d9,HDFC,Revenue-PG-split enabled,5eecc6d6449e4f7cfb1c2708,2021-02-20T00:00:00.000Z,NEFT CR-UTIB0001506-RAZORPAY SOFTWARE PR IVATE LIMITED-SLICK ORGANICS PVT LITD-AX ISCN0069798496,investments,,net_banking_transfer,60044.88
61b70047d8beac1599eb32f5,50200023535069,3232328.84,60ec41ba55c00300382672d9,HDFC,direct expenses,5eecc6d6449e4f7cfb1c2708,2021-02-20T00:00:00.000Z,POS 514834XXXXXX9486 FEEDBACKFIVE,,,debit_card,-5082.23
61b70048d8beac1599eb32fc,50200023535069,3232181.69,60ec41ba55c00300382672d9,HDFC,bank charges,5eecc6d6449e4f7cfb1c2708,2021-02-20T00:00:00.000Z,.DC INTL POS TXN MARKUP+ST 120221 140221 -CDT2103302935063,,,international_transaction_arbitrage,-147.15
61b70049d8beac1599eb3300,50200023535069,3232175.79,60ec41ba55c00300382672d9,HDFC,direct expenses,5eecc6d6449e4f7cfb1c2708,2021-02-20T00:00:00.000Z,.IMPS P2P 104811147725#17/02/2021 170221 -CDT2104503101708,,,net_banking_transfer,-5.9
61b7004ad8beac1599eb3307,50200023535069,3225712.25,60ec41ba55c00300382672d9,HDFC,direct expenses,5eecc6d6449e4f7cfb1c2708,2021-02-20T00:00:00.000Z,POS 514834XXXXXX9486 HOTJAR,,,debit_card,-6463.54
61b7004bd8beac1599eb330b,50200023535069,3234054.22,60ec41ba55c00300382672d9,HDFC,Revenue-PG-split enabled,5eecc6d6449e4f7cfb1c2708,2021-02-20T00:00:00.000Z,NEFT CR-UTIB0001506-RAZORPAY SOFTWARE PR,,,net_banking_transfer,8341.97
61b7004cd8beac1599eb330f,50200023535069,3246437.14,60ec41ba55c00300382672d9,HDFC,Revenue-PG-non-split,5eecc6d6449e4f7cfb1c2708,2021-02-21T00:00:00.000Z,UPI-PAYTM-PAYOUTS@PAYTM-PYTM0123456-1052 69125724-ALL202102212168200,ewallet,,upi,12382.92
61b7004dd8beac1599eb3316,50200023535069,3266149.71,60ec41ba55c00300382672d9,HDFC,Revenue-PG-non-split,5eecc6d6449e4f7cfb1c2708,2021-02-22T00:00:00.000Z,UPI-PAYTM-PAYOUTS@PAYTM-PYTM0123456-1053 91781608-ALL202102222168200,ewallet,,upi,19712.57
61b7004ed8beac1599eb331b,50200023535069,3309840.14,60ec41ba55c00300382672d9,HDFC,Revenue-PG-split enabled,5eecc6d6449e4f7cfb1c2708,2021-02-22T00:00:00.000Z,NEFT CR-UTIB0001506-RAZORPAY SOFTWARE PR IVATE LIMITED-SLICK ORGANICS PVT LITD-AX ISCN0069910162,investments,,net_banking_transfer,43690.43
61b7004fd8beac1599eb331f,50200023535069,3309810.11,60ec41ba55c00300382672d9,HDFC,bank charges,5eecc6d6449e4f7cfb1c2708,2021-02-22T00:00:00.000Z,.DC INTL POS TXN MARKUP+ST 160221 180221 -CDT2103302935063,,,international_transaction_arbitrage,-30.03
61b70050d8beac1599eb3323,50200023535069,3309705.06,60ec41ba55c00300382672d9,HDFC,bank charges,5eecc6d6449e4f7cfb1c2708,2021-02-22T00:00:00.000Z,.DC INTL POS TXN MARKUP+ST 170221 190221 -CDT2103302935063,,,international_transaction_arbitrage,-105.05
61b70051d8beac1599eb3329,50200023535069,3310973,60ec41ba55c00300382672d9,HDFC,Revenue-Mktplace,5eecc6d6449e4f7cfb1c2708,2021-02-22T00:00:00.000Z,NEFT CR-DEUT0797BGL-FLIPKART INTERNET PR IVATE LIMITED-SLICK ORGANICS PVT LTD-022 200537GN00246,shopping,,net_banking_transfer,1267.94
61b70052d8beac1599eb3332,50200023535069,3311843.87,60ec41ba55c00300382672d9,HDFC,Revenue-Mktplace,5eecc6d6449e4f7cfb1c2708,2021-02-22T00:00:00.000Z,NEFT CR-DEUT0797BGL-MYNTRA DESIGNS PRIVA TE LIMITED-SLICK ORGANICS PRIVATE LIMITE D-022200571GN00248,shopping,,net_banking_transfer,870.87
61b70053d8beac1599eb3336,50200023535069,3312569.98,60ec41ba55c00300382672d9,HDFC,Revenue-Mktplace,5eecc6d6449e4f7cfb1c2708,2021-02-22T00:00:00.000Z,NEFT CR-DEUT0797BGL-MYNTRA DESIGNS PRIVA TE LIMITED-SLICK ORGANICS PRIVATE LIMITE D-022200579GN00076,shopping,,net_banking_transfer,726.11
61b70054d8beac1599eb333e,50200023535069,3315514.06,60ec41ba55c00300382672d9,HDFC,Transfer in/Revenue-other,5eecc6d6449e4f7cfb1c2708,2021-02-22T00:00:00.000Z,ZOOBOP ME WORK-ARATA,,,Other,2944.08
61b70055d8beac1599eb3341,50200023535069,3313076.06,60ec41ba55c00300382672d9,HDFC,SAAS/tech expense,5eecc6d6449e4f7cfb1c2708,2021-02-22T00:00:00.000Z,POS 514834XXXXXX9486 AMAZON,shopping,,debit_card,-2438
61b70056d8beac1599eb3346,50200023535069,3350483.2,60ec41ba55c00300382672d9,HDFC,Revenue-COD,5eecc6d6449e4f7cfb1c2708,2021-02-22T00:00:00.000Z,NEFT CR-KKBK0000958-BIGFOOT RETAIL SOLUT IONS PRIVATE LIMITED-SLICK ORGANICS PVT LTD-KKBK210533513075,,,net_banking_transfer,37407.14
61b70057d8beac1599eb334e,50200023535069,350483.2,60ec41ba55c00300382672d9,HDFC,direct expenses,5eecc6d6449e4f7cfb1c2708,2021-02-22T00:00:00.000Z,FD BOOKED - 50300498262188 : SLICK ORGAN ICS PVT LTD,investments,,investment,-3000000
61b70058d8beac1599eb3357,50200023535069,370726.34,60ec41ba55c00300382672d9,HDFC,Revenue-PG-split enabled,5eecc6d6449e4f7cfb1c2708,2021-02-22T00:00:00.000Z,NEFT CR-UTIB0001506-RAZORPAY SOFTWARE PR,,,net_banking_transfer,20243.14
61b70058d8beac1599eb335d,50200023535069,395310.38,60ec41ba55c00300382672d9,HDFC,Revenue-PG-non-split,5eecc6d6449e4f7cfb1c2708,2021-02-23T00:00:00.000Z,UPI-PAYTM-PAYOUTS@PAYTM-PYTM0123456-1054 14862160-ALL202102232168200,ewallet,,upi,24584.04
61b70059d8beac1599eb3362,50200023535069,395721.15,60ec41ba55c00300382672d9,HDFC,Revenue-PG-non-split,5eecc6d6449e4f7cfb1c2708,2021-02-23T00:00:00.000Z,NEFT CR-ICIC0000031-PAYTM E COMMERCE PVT LTD-SLICK ORGANICS PVT LTD-CMS182608388 7,investments,,net_banking_transfer,410.77
61b7005ad8beac1599eb336d,50200023535069,408433.26,60ec41ba55c00300382672d9,HDFC,Revenue-PG-split enabled,5eecc6d6449e4f7cfb1c2708,2021-02-23T00:00:00.000Z,NEFT CR-UTIB0001506-RAZORPAY SOFTWARE PR IVATE LIMITED-SLICK ORGANICS PVT LITD-AX ISCN0070045664,investments,,net_banking_transfer,12712.11
61b7005bd8beac1599eb336f,50200023535069,408728.99,60ec41ba55c00300382672d9,HDFC,Revenue-Mktplace,5eecc6d6449e4f7cfb1c2708,2021-02-23T00:00:00.000Z,NEFT CR-DEUT0797BGL-MYNTRA DESIGNS PRIVA TE LIMITED-SLICK ORGANICS PRIVATE LIMITE D-022300260GN00189,shopping,,net_banking_transfer,295.73
61b7005cd8beac1599eb3375,50200023535069,516842.32,60ec41ba55c00300382672d9,HDFC,Revenue-Mktplace,5eecc6d6449e4f7cfb1c2708,2021-02-23T00:00:00.000Z,IMPS-105411315136-AMAZON SELLER SERVIC-H DFC-XXXXXXXX6004-1973DJ8X66KJPCLOSLICK O RGANICS PVT LTD,shopping,,net_banking_transfer,108113.33
61b7005dd8beac1599eb3379,50200023535069,948758.85,60ec41ba55c00300382672d9,HDFC,Revenue-Mktplace,5eecc6d6449e4f7cfb1c2708,2021-02-23T00:00:00.000Z,NEFT CR-DEUT0797BGL-AMAZON PAY (INDIA) P RIVATE LIMITED-SLICK ORGANICS PVT LTD-02 2300307GN00489,shopping,,net_banking_transfer,431916.53
61b7005ed8beac1599eb3385,50200023535069,948548.95,60ec41ba55c00300382672d9,HDFC,bank charges,5eecc6d6449e4f7cfb1c2708,2021-02-23T00:00:00.000Z,.DC INTL POS TXN MARKUP+ST 190221 210221 -CDT2103302935063,,,international_transaction_arbitrage,-209.9
61b7005fd8beac1599eb3389,50200023535069,823548.95,60ec41ba55c00300382672d9,HDFC,direct expenses,5eecc6d6449e4f7cfb1c2708,2021-02-23T00:00:00.000Z,"NEFT DR-PYTM0123456-PAYTM-NETBANK, MUM-N 054211415373228-125000",ewallet,,net_banking_transfer,-125000
61b70060d8beac1599eb338f,50200023535069,825849.19,60ec41ba55c00300382672d9,HDFC,Revenue-Mktplace,5eecc6d6449e4f7cfb1c2708,2021-02-23T00:00:00.000Z,NEFT CR-ICIC0000105-MANASH LIFETYLE PVT LTD-SLICKORGANICSPRIVATELIMITEDMPMUM-ICI B210540052250,,,net_banking_transfer,2300.24
61b70061d8beac1599eb3394,50200023535069,827273.86,60ec41ba55c00300382672d9,HDFC,Revenue-Mktplace,5eecc6d6449e4f7cfb1c2708,2021-02-23T00:00:00.000Z,NEFT CR-ICIC0000105-MANASH LIFETYLE PVT LTD-SLICKORGANICSPRIVATELIMITEDMPGGN-ICI B210540052249,,,net_banking_transfer,1424.67
61b70062d8beac1599eb3399,50200023535069,846116.58,60ec41ba55c00300382672d9,HDFC,Revenue-PG-split enabled,5eecc6d6449e4f7cfb1c2708,2021-02-23T00:00:00.000Z,NEFT CR-UTIB0001506-RAZORPAY SOFTWARE PR IVATE LIMITED-SLICK ORGANICS PVT LITD-AX ISCN0070114603,investments,,net_banking_transfer,18842.72
61b70063d8beac1599eb33a0,50200023535069,848983.46,60ec41ba55c00300382672d9,HDFC,Transfer in/Revenue-other,5eecc6d6449e4f7cfb1c2708,2021-02-23T00:00:00.000Z,4060004286-23 02 2021-HDFAZCUR1,,,Other,2866.88
61b70064d8beac1599eb33a5,50200023535069,866314.73,60ec41ba55c00300382672d9,HDFC,Revenue-PG-non-split,5eecc6d6449e4f7cfb1c2708,2021-02-24T00:00:00.000Z,UPI-PAYTM-PAYOUTS@PAYTM-PYTM0123456-1055,ewallet,,upi,17331.27
61b70065d8beac1599eb33aa,50200023535069,867625.33,60ec41ba55c00300382672d9,HDFC,Revenue-Mktplace,5eecc6d6449e4f7cfb1c2708,2021-02-24T00:00:00.000Z,NEFT CR-DEUT0797BGL-FLIPKART INTERNET PR IVATE LIMITED-SLICK ORGANICS PVT LTD-022 400094GN00228,shopping,,net_banking_transfer,1310.6
61b70066d8beac1599eb33b0,50200023535069,787625.33,60ec41ba55c00300382672d9,HDFC,direct expenses,5eecc6d6449e4f7cfb1c2708,2021-02-24T00:00:00.000Z,"NEFT DR-PYTM0123456-PAYTM-NETBANK, MUM-N 055211416246933-80000",ewallet,,net_banking_transfer,-80000
61b70067d8beac1599eb33ba,50200023535069,801568.63,60ec41ba55c00300382672d9,HDFC,Revenue-PG-split enabled,5eecc6d6449e4f7cfb1c2708,2021-02-24T00:00:00.000Z,NEFT CR-UTIB0001506-RAZORPAY SOFTWARE PR IVATE LIMITED-SLICK ORGANICS PVT LITD-AX ISCN0070144047,investments,,net_banking_transfer,13943.3
61b70068d8beac1599eb33c5,50200023535069,712204.63,60ec41ba55c00300382672d9,HDFC,direct expenses,5eecc6d6449e4f7cfb1c2708,2021-02-24T00:00:00.000Z,00921000075586-TPT-89364-ROET BINDRA,,,net_banking_transfer,-89364
61b70069d8beac1599eb33cd,50200023535069,731888.39,60ec41ba55c00300382672d9,HDFC,Revenue-COD,5eecc6d6449e4f7cfb1c2708,2021-02-24T00:00:00.000Z,NEFT CR-KKBK0000958-BIGFOOT RETAIL SOLUT IONS PRIVATE LIMITED-SLICK ORGANICS PVT LTD-KKBK210553983406,,,net_banking_transfer,19683.76
61b7006ad8beac1599eb33d2,50200023535069,839202.28,60ec41ba55c00300382672d9,HDFC,Revenue-PG-split enabled,5eecc6d6449e4f7cfb1c2708,2021-02-24T00:00:00.000Z,NEFT CR-UTIB0001506-RAZORPAY SOFTWARE PR IVATE LIMITED-SLICK ORGANICS PVT LITD-AX ISCN0070237244,investments,,net_banking_transfer,107313.89
61b7006bd8beac1599eb33d9,50200023535069,840532.11,60ec41ba55c00300382672d9,HDFC,Revenue-Mktplace,5eecc6d6449e4f7cfb1c2708,2021-02-24T00:00:00.000Z,NEFT CR-ICIC0000105-MANASH LIFETYLE PVT LTD-SLICKORGANICSPRIVATELIMITEDMPGGN-ICI B210550142441,,,net_banking_transfer,1329.83
61b7006cd8beac1599eb33df,50200023535069,840884.24,60ec41ba55c00300382672d9,HDFC,Revenue-Mktplace,5eecc6d6449e4f7cfb1c2708,2021-02-24T00:00:00.000Z,NEFT CR-ICIC0000105-MANASH LIFETYLE PVT LTD-SLICKORGANICSPRIVATELIMITEDMPMUM-ICI B210550142442,,,net_banking_transfer,352.13
61b7006dd8beac1599eb33e4,50200023535069,841285.02,60ec41ba55c00300382672d9,HDFC,Revenue-Mktplace,5eecc6d6449e4f7cfb1c2708,2021-02-24T00:00:00.000Z,NEFT CR-ICIC0000104-GOQII TECHNOLOGIES P VT LTD-SLICK ORGANICS PRIVATE LIMITED-CM S1828901551,,,net_banking_transfer,400.78
61b7006ed8beac1599eb33eb,50200023535069,919330.36,60ec41ba55c00300382672d9,HDFC,Transfer in/Revenue-other,5eecc6d6449e4f7cfb1c2708,2021-02-25T00:00:00.000Z,IMPS-105605417292-NA-HDFC-XXXXXXXXXX0007 -ALL20210225216820000330830668628,,,net_banking_transfer,78045.34
61b7006fd8beac1599eb33f2,50200023535069,987438.67,60ec41ba55c00300382672d9,HDFC,Revenue-PG-split enabled,5eecc6d6449e4f7cfb1c2708,2021-02-25T00:00:00.000Z,NEFT CR-UTIB0001506-RAZORPAY SOFTWARE PR IVATE LIMITED-SLICK ORGANICS PVT LITD-AX ISCN0070313199,investments,,net_banking_transfer,68108.31
61b7006fd8beac1599eb33fd,50200023535069,989029.32,60ec41ba55c00300382672d9,HDFC,Revenue-Mktplace,5eecc6d6449e4f7cfb1c2708,2021-02-25T00:00:00.000Z,4060004262-TIMES INTERNET LIMITED NODAL,,,Other,1590.65
61b70070d8beac1599eb3407,50200023535069,1070307.32,60ec41ba55c00300382672d9,HDFC,Transfer in/Revenue-other,5eecc6d6449e4f7cfb1c2708,2021-02-25T00:00:00.000Z,FT - CR - 00322000016711 - FORWEST ESTAT,,,Other,81278
61b70071d8beac1599eb340c,50200023535069,1078562.16,60ec41ba55c00300382672d9,HDFC,Revenue-PG-non-split,5eecc6d6449e4f7cfb1c2708,2021-02-25T00:00:00.000Z,NEFT CR-SCBL0036001-STRIPE INDIA PRIVATE -SLICK ORGANICS PRIVATE LIMITED-SSG17413 Q0195826,investments,,net_banking_transfer,8254.84
61b70072d8beac1599eb3414,50200023535069,1083616.62,60ec41ba55c00300382672d9,HDFC,Revenue-PG-split enabled,5eecc6d6449e4f7cfb1c2708,2021-02-25T00:00:00.000Z,NEFT CR-UTIB0001506-RAZORPAY SOFTWARE PR IVATE LIMITED-SLICK ORGANICS PVT LITD-AX ISCN0070407225,investments,,net_banking_transfer,5054.46
61b70073d8beac1599eb341b,50200023535069,1083762.91,60ec41ba55c00300382672d9,HDFC,Revenue-Mktplace,5eecc6d6449e4f7cfb1c2708,2021-02-25T00:00:00.000Z,NEFT CR-ICIC0000105-MANASH LIFETYLE PVT LTD-SLICKORGANICSPRIVATELIMITEDMPMUM-ICI B210560068836,,,net_banking_transfer,146.29
61b70074d8beac1599eb342c,50200023535069,1084389.26,60ec41ba55c00300382672d9,HDFC,Revenue-Mktplace,5eecc6d6449e4f7cfb1c2708,2021-02-25T00:00:00.000Z,NEFT CR-ICIC0000105-MANASH LIFETYLE PVT LTD-SLICKORGANICSPRIVATELIMITEDMPGGN-ICI B210560068835,,,net_banking_transfer,626.35
61b70075d8beac1599eb343f,50200023535069,1034389.26,60ec41ba55c00300382672d9,HDFC,direct expenses,5eecc6d6449e4f7cfb1c2708,2021-02-25T00:00:00.000Z,IMPS-105620101440-PAYTM-PYTM-XXXXXXXX383 9-50000,ewallet,,net_banking_transfer,-50000
61b70076d8beac1599eb3454,50200023535069,934389.26,60ec41ba55c00300382672d9,HDFC,direct expenses,5eecc6d6449e4f7cfb1c2708,2021-02-25T00:00:00.000Z,IMPS-105621109177-PAYTM-PYTM-XXXXXXXX383 9-100000,ewallet,,net_banking_transfer,-100000
61b70077d8beac1599eb3465,50200023535069,948204.1,60ec41ba55c00300382672d9,HDFC,Revenue-PG-non-split,5eecc6d6449e4f7cfb1c2708,2021-02-26T00:00:00.000Z,UPI-PAYTM-PAYOUTS@PAYTM-PYTM0123456-1057 83404376-ALL202102262168200,ewallet,,upi,13814.84
61b70078d8beac1599eb3472,50200023535069,968617.88,60ec41ba55c00300382672d9,HDFC,Revenue-PG-split enabled,5eecc6d6449e4f7cfb1c2708,2021-02-26T00:00:00.000Z,NEFT CR-UTIB0001506-RAZORPAY SOFTWARE PR IVATE LIMITED-SLICK ORGANICS PVT LITD-AX ISCN0070438793,investments,,net_banking_transfer,20413.78
61b70079d8beac1599eb3479,50200023535069,974246.25,60ec41ba55c00300382672d9,HDFC,Revenue-Mktplace,5eecc6d6449e4f7cfb1c2708,2021-02-26T00:00:00.000Z,NEFT CR-DEUT0797BGL-FLIPKART INTERNET PR IVATE LIMITED-SLICK ORGANICS PVT LTD-022 600172GN00216,shopping,,net_banking_transfer,5628.37
61b7007ad8beac1599eb3483,50200023535069,978104.67,60ec41ba55c00300382672d9,HDFC,Revenue-Mktplace,5eecc6d6449e4f7cfb1c2708,2021-02-26T00:00:00.000Z,NEFT CR-KKBK0000958-SUPERMARKET GROCERY SUPPLIES PVT LTD-SLICK ORGANICS PVT LTD- KKBK210574475348,shopping,,net_banking_transfer,3858.42
61b7007bd8beac1599eb3489,50200023535069,1037543.77,60ec41ba55c00300382672d9,HDFC,Revenue-COD,5eecc6d6449e4f7cfb1c2708,2021-02-26T00:00:00.000Z,NEFT CR-KKBK0000958-BIGFOOT RETAIL SOLUT IONS PRIVATE LIMITED-SLICK ORGANICS PVT LTD-KKBK210574609074,,,net_banking_transfer,59439.1
61b7007cd8beac1599eb349d,50200023535069,1038017.16,60ec41ba55c00300382672d9,HDFC,Revenue-Mktplace,5eecc6d6449e4f7cfb1c2708,2021-02-26T00:00:00.000Z,NEFT CR-DEUT0784BBY-TATA UNISTORE LTD-NO,,,net_banking_transfer,473.39
61b7007dd8beac1599eb34a4,50200023535069,1064958.17,60ec41ba55c00300382672d9,HDFC,Revenue-PG-split enabled,5eecc6d6449e4f7cfb1c2708,2021-02-26T00:00:00.000Z,NEFT CR-UTIB0001506-RAZORPAY SOFTWARE PR IVATE LIMITED-SLICK ORGANICS PVT LITD-AX ISCN0070525722,investments,,net_banking_transfer,26941.01
61b7007ed8beac1599eb34aa,50200023535069,1091564.17,60ec41ba55c00300382672d9,HDFC,Revenue-Mktplace,5eecc6d6449e4f7cfb1c2708,2021-02-26T00:00:00.000Z,NEFT CR-SCBL0036001-M/S DREAMPLUG TECHNO -SLICK ORGANICS PRIVATE LIMITEDSLICK-SIN 31436Q0012241,investments,,net_banking_transfer,26606
61b7007fd8beac1599eb34b3,50200023535069,1092498.13,60ec41ba55c00300382672d9,HDFC,Revenue-PG-non-split,5eecc6d6449e4f7cfb1c2708,2021-02-26T00:00:00.000Z,NEFT CR-ICIC0000031-PAYTM E COMMERCE PVT LTD-SLICK ORGANICS PVT LTD-CMS183348657 1,investments,,net_banking_transfer,933.96
61b70080d8beac1599eb34bb,50200023535069,1102546.12,60ec41ba55c00300382672d9,HDFC,Revenue-PG-non-split,5eecc6d6449e4f7cfb1c2708,2021-02-27T00:00:00.000Z,UPI-PAYTM-PAYOUTS@PAYTM-PYTM0123456-1058 07389282-ALL202102272168200,ewallet,,upi,10047.99
61b70081d8beac1599eb34c5,50200023535069,1098907.52,60ec41ba55c00300382672d9,HDFC,direct expenses,5eecc6d6449e4f7cfb1c2708,2021-02-27T00:00:00.000Z,POS 514834XXXXXX9486 FRESHWORKS INC,,,debit_card,-3638.6
61b70082d8beac1599eb34cd,50200023535069,1098640.58,60ec41ba55c00300382672d9,HDFC,bank charges,5eecc6d6449e4f7cfb1c2708,2021-02-27T00:00:00.000Z,.DC INTL POS TXN MARKUP+ST 200221 230221 -CDT2103302935063,,,international_transaction_arbitrage,-266.94
61b70083d8beac1599eb34d4,50200023535069,1115614.94,60ec41ba55c00300382672d9,HDFC,Revenue-PG-non-split,5eecc6d6449e4f7cfb1c2708,2021-02-28T00:00:00.000Z,UPI-PAYTM-PAYOUTS@PAYTM-PYTM0123456-1059,ewallet,,upi,16974.36
61b70084d8beac1599eb34da,50200023535069,1137057.88,60ec41ba55c00300382672d9,HDFC,Revenue-PG-non-split,5eecc6d6449e4f7cfb1c2708,2021-03-01T00:00:00.000Z,UPI-PAYTM-PAYOUTS@PAYTM-PYTM0123456-1060 58914168-ALL202103012168200,ewallet,,upi,21442.94
61b70085d8beac1599eb34e2,50200023535069,711919.88,60ec41ba55c00300382672d9,HDFC,direct expenses,5eecc6d6449e4f7cfb1c2708,2021-03-01T00:00:00.000Z,"NEFT DR-SCBL0036020-FREIGHT SYSTEMS INDI A PRIVATE LIMITED-NETBANK, MUM-N06021142 1418216-425138",,,net_banking_transfer,-425138
61b70086d8beac1599eb34ea,50200023535069,710809.79,60ec41ba55c00300382672d9,HDFC,direct expenses,5eecc6d6449e4f7cfb1c2708,2021-03-01T00:00:00.000Z,POS 514834XXXXXX9486 ZOOM US 888-799-,,,debit_card,-1110.09
61b70087d8beac1599eb34f4,50200023535069,798862.7,60ec41ba55c00300382672d9,HDFC,Revenue-PG-split enabled,5eecc6d6449e4f7cfb1c2708,2021-03-01T00:00:00.000Z,NEFT CR-UTIB0001506-RAZORPAY SOFTWARE PR IVATE LIMITED-SLICK ORGANICS PVT LITD-AX ISCN0070589218,investments,,net_banking_transfer,88052.91
61b70087d8beac1599eb34fa,50200023535069,801817.83,60ec41ba55c00300382672d9,HDFC,Revenue-Mktplace,5eecc6d6449e4f7cfb1c2708,2021-03-01T00:00:00.000Z,NEFT CR-DEUT0797BGL-FLIPKART INTERNET PR IVATE LIMITED-SLICK ORGANICS PVT LTD-030 100138GN00292,shopping,,net_banking_transfer,2955.13
61b70088d8beac1599eb3507,50200023535069,799670.23,60ec41ba55c00300382672d9,HDFC,direct expenses,5eecc6d6449e4f7cfb1c2708,2021-03-01T00:00:00.000Z,POS 514834XXXXXX9486 SEOPTIMER,,,debit_card,-2147.6
61b70089d8beac1599eb350c,50200023535069,806065.59,60ec41ba55c00300382672d9,HDFC,Revenue-Mktplace,5eecc6d6449e4f7cfb1c2708,2021-03-01T00:00:00.000Z,NEFT CR-DEUT0797BGL-MYNTRA DESIGNS PRIVA TE LIMITED-SLICK ORGANICS PRIVATE LIMITE D-030100274GN00199,shopping,,net_banking_transfer,6395.36
61b7008ad8beac1599eb3511,50200023535069,807799.72,60ec41ba55c00300382672d9,HDFC,Revenue-Mktplace,5eecc6d6449e4f7cfb1c2708,2021-03-01T00:00:00.000Z,NEFT CR-DEUT0797BGL-FLIPKART INTERNET PR IVATE LIMITED-SLICK ORGANICS PVT LTD-030 100296GN00254,shopping,,net_banking_transfer,1734.13
61b7008bd8beac1599eb3517,50200023535069,784499.72,60ec41ba55c00300382672d9,HDFC,direct expenses,5eecc6d6449e4f7cfb1c2708,2021-03-01T00:00:00.000Z,"NEFT DR-SCBL0036020-FREIGHT SYSTEMS INDI A PRIVATE LIMITED-NETBANK, MUM-N06021142 2024988-23300",,,net_banking_transfer,-23300
61b7008cd8beac1599eb351e,50200023535069,785908.06,60ec41ba55c00300382672d9,HDFC,Revenue-Mktplace,5eecc6d6449e4f7cfb1c2708,2021-03-01T00:00:00.000Z,NEFT CR-DEUT0797BGL-MYNTRA DESIGNS PRIVA TE LIMITED-SLICK ORGANICS PRIVATE LIMITE D-030100273GN00097,shopping,,net_banking_transfer,1408.34
61b7008dd8beac1599eb3520,50200023535069,854158.83,60ec41ba55c00300382672d9,HDFC,Revenue-COD,5eecc6d6449e4f7cfb1c2708,2021-03-01T00:00:00.000Z,NEFT CR-KKBK0000958-BIGFOOT RETAIL SOLUT IONS PRIVATE LIMITED-SLICK ORGANICS PVT LTD-KKBK210605178188,,,net_banking_transfer,68250.77
61b7008ed8beac1599eb3527,50200023535069,869575.81,60ec41ba55c00300382672d9,HDFC,Revenue-PG-split enabled,5eecc6d6449e4f7cfb1c2708,2021-03-01T00:00:00.000Z,NEFT CR-UTIB0001506-RAZORPAY SOFTWARE PR,,,net_banking_transfer,15416.98
61b7008fd8beac1599eb352a,50200023535069,893073.71,60ec41ba55c00300382672d9,HDFC,Revenue-PG-non-split,5eecc6d6449e4f7cfb1c2708,2021-03-02T00:00:00.000Z,UPI-PAYTM-PAYOUTS@PAYTM-PYTM0123456-1061 85195392-ALL202103022168200,ewallet,,upi,23497.9
61b70090d8beac1599eb3532,50200023535069,909593.21,60ec41ba55c00300382672d9,HDFC,Revenue-PG-split enabled,5eecc6d6449e4f7cfb1c2708,2021-03-02T00:00:00.000Z,NEFT CR-UTIB0001506-RAZORPAY SOFTWARE PR IVATE LIMITED-SLICK ORGANICS PVT LITD-AX ISCN0070806458,investments,,net_banking_transfer,16519.5
61b70091d8beac1599eb3537,50200023535069,1034900.63,60ec41ba55c00300382672d9,HDFC,Revenue-Mktplace,5eecc6d6449e4f7cfb1c2708,2021-03-02T00:00:00.000Z,IMPS-106111225505-AMAZON SELLER SERVIC-H DFC-XXXXXXXX6004-B57C2Z4FE8F575EPSLICK O RGANICS PVT LTD,shopping,,net_banking_transfer,125307.42
61b70092d8beac1599eb353d,50200023535069,356359.03,60ec41ba55c00300382672d9,HDFC,direct expenses,5eecc6d6449e4f7cfb1c2708,2021-03-02T00:00:00.000Z,ADVANCE PAYMENT OF IMPORT BILL,bills,,Other,-678541.6
61b70093d8beac1599eb3545,50200023535069,198182.03,60ec41ba55c00300382672d9,HDFC,direct expenses,5eecc6d6449e4f7cfb1c2708,2021-03-02T00:00:00.000Z,"NEFT DR-YESB0000551-VISTTA COSMETICS-NET BANK, MUM-N061211423621754-158177",,,net_banking_transfer,-158177
61b70094d8beac1599eb354a,50200023535069,182337.03,60ec41ba55c00300382672d9,HDFC,direct expenses,5eecc6d6449e4f7cfb1c2708,2021-03-02T00:00:00.000Z,"NEFT DR-SBIN0008078-PANDIT PLASTICS-NETB ANK, MUM-N061211423624313-15845",,,net_banking_transfer,-15845
61b70095d8beac1599eb354f,50200023535069,105113.03,60ec41ba55c00300382672d9,HDFC,direct expenses,5eecc6d6449e4f7cfb1c2708,2021-03-02T00:00:00.000Z,"NEFT DR-KKBK0000173-MATRIX PRINTING SOLU TIONS PRIVATE LIMITE-NETBANK, MUM-N06121 1423628814-77224",,,net_banking_transfer,-77224
61b70096d8beac1599eb3557,50200023535069,462401.9,60ec41ba55c00300382672d9,HDFC,Revenue-Mktplace,5eecc6d6449e4f7cfb1c2708,2021-03-02T00:00:00.000Z,NEFT CR-DEUT0797BGL-AMAZON PAY (INDIA) P RIVATE LIMITED-SLICK ORGANICS PVT LTD-03 0200088GN00404,shopping,,net_banking_transfer,357288.87
61b70097d8beac1599eb355e,50200023535069,462381.9,60ec41ba55c00300382672d9,HDFC,N-ACH payments,5eecc6d6449e4f7cfb1c2708,2021-03-02T00:00:00.000Z,ACH D- CTRAZORPAY-GETVANTAGEGHLZ1SPTOP6N,loans,lender_transaction,auto_debit_payment,-20
61b70098d8beac1599eb3561,50200023535069,462361.9,60ec41ba55c00300382672d9,HDFC,N-ACH payments,5eecc6d6449e4f7cfb1c2708,2021-03-02T00:00:00.000Z,ACH D- CTRAZORPAY-GETVANTAGEGHLZXJSJ5FLO,loans,lender_transaction,auto_debit_payment,-20
61b70099d8beac1599eb3567,50200023535069,480374.61,60ec41ba55c00300382672d9,HDFC,Revenue-PG-split enabled,5eecc6d6449e4f7cfb1c2708,2021-03-02T00:00:00.000Z,NEFT CR-UTIB0001506-RAZORPAY SOFTWARE PR IVATE LIMITED-SLICK ORGANICS PVT LITD-AX ISCN0070907540,investments,,net_banking_transfer,18012.71
61b7009ad8beac1599eb3570,50200023535069,470935.79,60ec41ba55c00300382672d9,HDFC,direct expenses,5eecc6d6449e4f7cfb1c2708,2021-03-02T00:00:00.000Z,POS 514834XXXXXX4081 ONLINE PAYMENT,,,debit_card,-9438.82
61b7009bd8beac1599eb3575,50200023535069,370935.79,60ec41ba55c00300382672d9,HDFC,direct expenses,5eecc6d6449e4f7cfb1c2708,2021-03-02T00:00:00.000Z,"NEFT DR-YESB0000162-VINAY REDDY-NETBANK, MUM-N061211424660135-ADVANCE",,,net_banking_transfer,-100000
61b7009cd8beac1599eb3579,50200023535069,386590.2,60ec41ba55c00300382672d9,HDFC,Revenue-PG-non-split,5eecc6d6449e4f7cfb1c2708,2021-03-03T00:00:00.000Z,UPI-PAYTM-PAYOUTS@PAYTM-PYTM0123456-1062 10282607-ALL202103032168200,ewallet,,upi,15654.41
61b7009cd8beac1599eb357f,50200023535069,389612.15,60ec41ba55c00300382672d9,HDFC,Revenue-Mktplace,5eecc6d6449e4f7cfb1c2708,2021-03-03T00:00:00.000Z,NEFT CR-DEUT0797BGL-FLIPKART INTERNET PR,shopping,,net_banking_transfer,3021.95
61b7009dd8beac1599eb3584,50200023535069,392189.15,60ec41ba55c00300382672d9,HDFC,Revenue-Mktplace,5eecc6d6449e4f7cfb1c2708,2021-03-03T00:00:00.000Z,NEFT CR-DEUT0797BGL-FLIPKART INTERNET PR IVATE LIMITED-SLICK ORGANICS PVT LTD-030 300116GN00033,shopping,,net_banking_transfer,2577
61b7009ed8beac1599eb3589,50200023535069,393233.82,60ec41ba55c00300382672d9,HDFC,Revenue-Mktplace,5eecc6d6449e4f7cfb1c2708,2021-03-03T00:00:00.000Z,NEFT CR-DEUT0797BGL-MYNTRA DESIGNS PRIVA TE LIMITED-SLICK ORGANICS PRIVATE LIMITE D-030300171GN00215,shopping,,net_banking_transfer,1044.67
61b7009fd8beac1599eb358f,50200023535069,407064.56,60ec41ba55c00300382672d9,HDFC,Revenue-PG-split enabled,5eecc6d6449e4f7cfb1c2708,2021-03-03T00:00:00.000Z,NEFT CR-UTIB0001506-RAZORPAY SOFTWARE PR IVATE LIMITED-SLICK ORGANICS PVT LITD-AX ISCN0070951965,investments,,net_banking_transfer,13830.74
61b700a0d8beac1599eb3595,50200023535069,207064.56,60ec41ba55c00300382672d9,HDFC,direct expenses,5eecc6d6449e4f7cfb1c2708,2021-03-03T00:00:00.000Z,57500000443889-TPT-200000-WEBKLIPPER TEC HNOLOGIES PRIVATE LIMITED,,,net_banking_transfer,-200000
61b700a1d8beac1599eb3598,50200023535069,207542.96,60ec41ba55c00300382672d9,HDFC,Revenue-PG-non-split,5eecc6d6449e4f7cfb1c2708,2021-03-03T00:00:00.000Z,NEFT CR-ICIC0000031-PAYTM E COMMERCE PVT LTD-SLICK ORGANICS PVT LTD-CMS183975018 0,investments,,net_banking_transfer,478.4
61b700a2d8beac1599eb359d,50200023535069,124255.96,60ec41ba55c00300382672d9,HDFC,Salary/Emp/consultant Expense,5eecc6d6449e4f7cfb1c2708,2021-03-03T00:00:00.000Z,"NEFT DR-UTIB0003142-ARIA DESAI UG ELIZAB ETH THOMAS ALEX-NETBANK, MUM-N0622114251 56198-83287",,,net_banking_transfer,-83287
61b700a3d8beac1599eb35a2,50200023535069,114255.96,60ec41ba55c00300382672d9,HDFC,direct expenses,5eecc6d6449e4f7cfb1c2708,2021-03-03T00:00:00.000Z,"NEFT DR-ICIC0001963-HARSHADA WAGHMARE-NE TBANK, MUM-N062211425161557-10000",,,net_banking_transfer,-10000
61b700a4d8beac1599eb35ad,50200023535069,114250.06,60ec41ba55c00300382672d9,HDFC,direct expenses,5eecc6d6449e4f7cfb1c2708,2021-03-03T00:00:00.000Z,.IMPS P2P 105621109177#25/02/2021 260221 -CDT2106203308404,,,net_banking_transfer,-5.9
61b700a5d8beac1599eb35b4,50200023535069,114244.16,60ec41ba55c00300382672d9,HDFC,direct expenses,5eecc6d6449e4f7cfb1c2708,2021-03-03T00:00:00.000Z,.IMPS P2P 105620101440#25/02/2021 260221 -CDT2106203308404,,,net_banking_transfer,-5.9
61b700a6d8beac1599eb35b9,50200023535069,115988.39,60ec41ba55c00300382672d9,HDFC,Revenue-Mktplace,5eecc6d6449e4f7cfb1c2708,2021-03-03T00:00:00.000Z,NEFT CR-DEUT0797BGL-MYNTRA DESIGNS PRIVA TE LIMITED-SLICK ORGANICS PRIVATE LIMITE D-030300241GN00050,shopping,,net_banking_transfer,1744.23
61b700a7d8beac1599eb35c1,50200023535069,125873.98,60ec41ba55c00300382672d9,HDFC,Revenue-COD,5eecc6d6449e4f7cfb1c2708,2021-03-03T00:00:00.000Z,NEFT CR-KKBK0000958-BIGFOOT RETAIL SOLUT IONS PRIVATE LIMITED-SLICK ORGANICS PVT LTD-KKBK210625821250,,,net_banking_transfer,9885.59
61b700a8d8beac1599eb35c5,50200023535069,137965.62,60ec41ba55c00300382672d9,HDFC,Revenue-PG-split enabled,5eecc6d6449e4f7cfb1c2708,2021-03-03T00:00:00.000Z,NEFT CR-UTIB0001506-RAZORPAY SOFTWARE PR,,,net_banking_transfer,12091.64
61b700a9d8beac1599eb35d0,50200023535069,138185.43,60ec41ba55c00300382672d9,HDFC,Revenue-Mktplace,5eecc6d6449e4f7cfb1c2708,2021-03-03T00:00:00.000Z,NEFT CR-ICIC0000105-MANASH LIFETYLE PVT LTD-SLICKORGANICSPRIVATELIMITEDMPGGN-ICI B210620060800,,,net_banking_transfer,219.81
61b700aad8beac1599eb35d7,50200023535069,141282.53,60ec41ba55c00300382672d9,HDFC,Revenue-Mktplace,5eecc6d6449e4f7cfb1c2708,2021-03-03T00:00:00.000Z,NEFT CR-ICIC0000105-MANASH LIFETYLE PVT LTD-SLICKORGANICSPRIVATELIMITEDMPMUM-ICI B210620060801,,,net_banking_transfer,3097.1
61b700abd8beac1599eb35da,50200023535069,140102.53,60ec41ba55c00300382672d9,HDFC,direct expenses,5eecc6d6449e4f7cfb1c2708,2021-03-03T00:00:00.000Z,COMM ON GUARANTEE AMENDMENT,,,Other,-1180
61b700acd8beac1599eb35df,50200023535069,154800.16,60ec41ba55c00300382672d9,HDFC,Revenue-PG-non-split,5eecc6d6449e4f7cfb1c2708,2021-03-04T00:00:00.000Z,UPI-PAYTM-PAYOUTS@PAYTM-PYTM0123456-1063 35517412-ALL202103042168200,ewallet,,upi,14697.63
61b700add8beac1599eb35ea,50200023535069,175453.84,60ec41ba55c00300382672d9,HDFC,Revenue-PG-split enabled,5eecc6d6449e4f7cfb1c2708,2021-03-04T00:00:00.000Z,NEFT CR-UTIB0001506-RAZORPAY SOFTWARE PR IVATE LIMITED-SLICK ORGANICS PVT LITD-AX ISCN0071080504,investments,,net_banking_transfer,20653.68
61b700aed8beac1599eb35f8,50200023535069,125453.84,60ec41ba55c00300382672d9,HDFC,Marketing Expense,5eecc6d6449e4f7cfb1c2708,2021-03-04T00:00:00.000Z,POS 514834XXXXXX9486 GOOGLE ADWORDS,,,debit_card,-50000
61b700afd8beac1599eb35fd,50200023535069,37053.84,60ec41ba55c00300382672d9,HDFC,direct expenses,5eecc6d6449e4f7cfb1c2708,2021-03-04T00:00:00.000Z,"NEFT DR-SCBL0036031-PR PUNDIT PUBLIC REL ATIONS PRIVATE LIMIT-NETBANK, MUM-N06321 1426705830-88400",investments,,net_banking_transfer,-88400
61b700b0d8beac1599eb3602,50200023535069,26286.8,60ec41ba55c00300382672d9,HDFC,direct expenses,5eecc6d6449e4f7cfb1c2708,2021-03-04T00:00:00.000Z,POS 514834XXXXXX9486 STK*SHUTTERSTOCK,,,debit_card,-10767.04
61b700b1d8beac1599eb3608,50200023535069,27263.56,60ec41ba55c00300382672d9,HDFC,Revenue-PG-non-split,5eecc6d6449e4f7cfb1c2708,2021-03-04T00:00:00.000Z,NEFT CR-IDFB0010204-SEZZLE PAYMENTS PRIV ATE LIMITED-SLICK ORGANICS PRIVATE LIMIT ED-IDFBH21063551087,investments,,net_banking_transfer,976.76
61b700b2d8beac1599eb360d,50200023535069,39539.26,60ec41ba55c00300382672d9,HDFC,Revenue-PG-split enabled,5eecc6d6449e4f7cfb1c2708,2021-03-04T00:00:00.000Z,NEFT CR-UTIB0001506-RAZORPAY SOFTWARE PR IVATE LIMITED-SLICK ORGANICS PVT LITD-AX ISCN0071297798,investments,,net_banking_transfer,12275.7
61b700b3d8beac1599eb3612,50200023535069,40309.66,60ec41ba55c00300382672d9,HDFC,Revenue-Mktplace,5eecc6d6449e4f7cfb1c2708,2021-03-04T00:00:00.000Z,NEFT CR-ICIC0000105-MANASH LIFETYLE PVT LTD-SLICKORGANICSPRIVATELIMITEDMPGGN-ICI B210630049175,,,net_banking_transfer,770.4
61b700b4d8beac1599eb3617,50200023535069,40859.53,60ec41ba55c00300382672d9,HDFC,Revenue-Mktplace,5eecc6d6449e4f7cfb1c2708,2021-03-04T00:00:00.000Z,NEFT CR-ICIC0000105-MANASH LIFETYLE PVT LTD-SLICKORGANICSPRIVATELIMITEDMPMUM-ICI B210630049176,,,net_banking_transfer,549.87
61b700b5d8beac1599eb361e,50200023535069,53705.53,60ec41ba55c00300382672d9,HDFC,Revenue-Mktplace,5eecc6d6449e4f7cfb1c2708,2021-03-04T00:00:00.000Z,NEFT CR-SCBL0036001-M/S DREAMPLUG TECHNO,,,net_banking_transfer,12846
61b700b6d8beac1599eb3622,50200023535069,86008.77,60ec41ba55c00300382672d9,HDFC,Revenue-PG-non-split,5eecc6d6449e4f7cfb1c2708,2021-03-05T00:00:00.000Z,UPI-PAYTM-PAYOUTS@PAYTM-PYTM0123456-1064 60610891-ALL202103052168200,ewallet,,upi,32303.24
61b700b7d8beac1599eb3627,50200023535069,89500.17,60ec41ba55c00300382672d9,HDFC,Revenue-Mktplace,5eecc6d6449e4f7cfb1c2708,2021-03-05T00:00:00.000Z,NEFT CR-DEUT0797BGL-FLIPKART INTERNET PR IVATE LIMITED-SLICK ORGANICS PVT LTD-030 500099GN00282,shopping,,net_banking_transfer,3491.4
61b700b8d8beac1599eb362b,50200023535069,95368.11,60ec41ba55c00300382672d9,HDFC,Revenue-Mktplace,5eecc6d6449e4f7cfb1c2708,2021-03-05T00:00:00.000Z,NEFT CR-DEUT0797BGL-FLIPKART INTERNET PR IVATE LIMITED-SLICK ORGANICS PVT LTD-030 500126GN00027,shopping,,net_banking_transfer,5867.94
61b700b9d8beac1599eb363c,50200023535069,96874.26,60ec41ba55c00300382672d9,HDFC,Revenue-Mktplace,5eecc6d6449e4f7cfb1c2708,2021-03-05T00:00:00.000Z,NEFT CR-DEUT0797BGL-MYNTRA DESIGNS PRIVA TE LIMITED-SLICK ORGANICS PRIVATE LIMITE D-030500193GN00213,shopping,,net_banking_transfer,1506.15
61b700bad8beac1599eb3645,50200023535069,113318.28,60ec41ba55c00300382672d9,HDFC,Revenue-PG-split enabled,5eecc6d6449e4f7cfb1c2708,2021-03-05T00:00:00.000Z,NEFT CR-UTIB0001506-RAZORPAY SOFTWARE PR IVATE LIMITED-SLICK ORGANICS PVT LITD-AX ISCN0071394375,investments,,net_banking_transfer,16444.02
61b700bbd8beac1599eb364c,50200023535069,-86681.72,60ec41ba55c00300382672d9,HDFC,direct expenses,5eecc6d6449e4f7cfb1c2708,2021-03-05T00:00:00.000Z,"NEFT DR-SCBL0036025-DHRUV MADHOK-NETBANK , MUM-N064211428143923-200000",,,net_banking_transfer,-200000
61b700bbd8beac1599eb3650,50200023535069,-286681.72,60ec41ba55c00300382672d9,HDFC,direct expenses,5eecc6d6449e4f7cfb1c2708,2021-03-05T00:00:00.000Z,02711930004579-TPT-200000-DHRUV BHASIN,,,net_banking_transfer,-200000
61b700bcd8beac1599eb3655,50200023535069,-285033.64,60ec41ba55c00300382672d9,HDFC,Transfer in/Revenue-other,5eecc6d6449e4f7cfb1c2708,2021-03-05T00:00:00.000Z,ZOOBOP ME WORK-ARATA,,,Other,1648.08
61b700bdd8beac1599eb365a,50200023535069,-284799.55,60ec41ba55c00300382672d9,HDFC,Revenue-Mktplace,5eecc6d6449e4f7cfb1c2708,2021-03-05T00:00:00.000Z,NEFT CR-DEUT0797BGL-MYNTRA DESIGNS PRIVA TE LIMITED-SLICK ORGANICS PRIVATE LIMITE D-030500260GN00074,shopping,,net_banking_transfer,234.09
61b700bed8beac1599eb3661,50200023535069,-272123.04,60ec41ba55c00300382672d9,HDFC,Revenue-PG-split enabled,5eecc6d6449e4f7cfb1c2708,2021-03-05T00:00:00.000Z,NEFT CR-UTIB0001506-RAZORPAY SOFTWARE PR IVATE LIMITED-SLICK ORGANICS PVT LITD-AX ISCN0071510184,investments,,net_banking_transfer,12676.51
61b700bfd8beac1599eb366b,50200023535069,-193480.21,60ec41ba55c00300382672d9,HDFC,Revenue-COD,5eecc6d6449e4f7cfb1c2708,2021-03-05T00:00:00.000Z,NEFT CR-KKBK0000958-BIGFOOT RETAIL SOLUT IONS PRIVATE LIMITED-SLICK ORGANICS PVT LTD-KKBK210646432909,,,net_banking_transfer,78642.83
61b700c0d8beac1599eb366e,50200023535069,-193483.14,60ec41ba55c00300382672d9,HDFC,direct expenses,5eecc6d6449e4f7cfb1c2708,2021-03-06T00:00:00.000Z,TDS RECOVERED ON-50300498262188,,,Other,-2.93
61b700c1d8beac1599eb3673,50200023535069,-193444.14,60ec41ba55c00300382672d9,HDFC,Transfer in/Revenue-other,5eecc6d6449e4f7cfb1c2708,2021-03-06T00:00:00.000Z,INT. ON SWCR ON-50300498262188,,,Other,39
61b700c2d8beac1599eb367a,50200023535069,-106762.14,60ec41ba55c00300382672d9,HDFC,Loan-in,5eecc6d6449e4f7cfb1c2708,2021-03-06T00:00:00.000Z,SWEEP-IN CREDIT - 50300498262188,,,self_transfer,86682
61b700c3d8beac1599eb3682,50200023535069,-106765.74,60ec41ba55c00300382672d9,HDFC,direct expenses,5eecc6d6449e4f7cfb1c2708,2021-03-06T00:00:00.000Z,TDS RECOVERED ON-50300498262188,,,Other,-3.6
61b700c4d8beac1599eb3689,50200023535069,-106717.74,60ec41ba55c00300382672d9,HDFC,Transfer in/Revenue-other,5eecc6d6449e4f7cfb1c2708,2021-03-06T00:00:00.000Z,INT. ON SWCR ON-50300498262188,,,Other,48
61b700c5d8beac1599eb3690,50200023535069,45.26,60ec41ba55c00300382672d9,HDFC,Loan-in,5eecc6d6449e4f7cfb1c2708,2021-03-06T00:00:00.000Z,SWEEP-IN CREDIT - 50300498262188,,,self_transfer,106763
61b700c6d8beac1599eb3694,50200023535069,20303.84,60ec41ba55c00300382672d9,HDFC,Revenue-PG-non-split,5eecc6d6449e4f7cfb1c2708,2021-03-06T00:00:00.000Z,UPI-PAYTM-PAYOUTS@PAYTM-PYTM0123456-1065 86338984-ALL202103062168200,ewallet,,upi,20258.58
61b700c7d8beac1599eb369a,50200023535069,31390.98,60ec41ba55c00300382672d9,HDFC,Revenue-PG-split enabled,5eecc6d6449e4f7cfb1c2708,2021-03-06T00:00:00.000Z,NEFT CR-UTIB0001506-RAZORPAY SOFTWARE PR IVATE LIMITED-SLICK ORGANICS PVT LITD-AX ISCN0071545773,investments,,net_banking_transfer,11087.14
61b700c8d8beac1599eb36a6,50200023535069,39627.98,60ec41ba55c00300382672d9,HDFC,Revenue-PG-split enabled,5eecc6d6449e4f7cfb1c2708,2021-03-06T00:00:00.000Z,NEFT CR-UTIB0001506-RAZORPAY SOFTWARE PR IVATE LIMITED-SLICK ORGANICS PVT LITD-AX ISCN0071613475,investments,,net_banking_transfer,8237
61b700c9d8beac1599eb36aa,50200023535069,59155.66,60ec41ba55c00300382672d9,HDFC,Revenue-PG-non-split,5eecc6d6449e4f7cfb1c2708,2021-03-07T00:00:00.000Z,UPI-PAYTM-PAYOUTS@PAYTM-PYTM0123456-1066 12726645-ALL202103072168200,ewallet,,upi,19527.68
61b700cad8beac1599eb36ac,50200023535069,76223.08,60ec41ba55c00300382672d9,HDFC,Revenue-PG-non-split,5eecc6d6449e4f7cfb1c2708,2021-03-08T00:00:00.000Z,UPI-PAYTM-PAYOUTS@PAYTM-PYTM0123456-1067 38359375-ALL202103082168200,ewallet,,upi,17067.42
61b700cbd8beac1599eb36b5,50200023535069,-16276.92,60ec41ba55c00300382672d9,HDFC,direct expenses,5eecc6d6449e4f7cfb1c2708,2021-03-08T00:00:00.000Z,"NEFT DR-CITI0000002-DHIRAJ-NETBANK, MUM- N067211431284533-92500",,,net_banking_transfer,-92500
61b700ccd8beac1599eb36c8,50200023535069,-106856.92,60ec41ba55c00300382672d9,HDFC,direct expenses,5eecc6d6449e4f7cfb1c2708,2021-03-08T00:00:00.000Z,"NEFT DR-ICIC0000542-AVANTIKA SUKHIA-NETB ANK, MUM-N067211431279745-90580",,,net_banking_transfer,-90580
61b700cdd8beac1599eb36cb,50200023535069,-127856.92,60ec41ba55c00300382672d9,HDFC,direct expenses,5eecc6d6449e4f7cfb1c2708,2021-03-08T00:00:00.000Z,"NEFT DR-SIBL0000555-JAIVEER KUMAR-NETBAN K, MUM-N067211431279789-21000",,,net_banking_transfer,-21000
61b700ced8beac1599eb36d3,50200023535069,-142856.92,60ec41ba55c00300382672d9,HDFC,direct expenses,5eecc6d6449e4f7cfb1c2708,2021-03-08T00:00:00.000Z,"NEFT DR-PUNB0398000-MEENA SINGH-NETBANK, MUM-N067211431280017-15000",,,net_banking_transfer,-15000
61b700cfd8beac1599eb36d9,50200023535069,-177856.92,60ec41ba55c00300382672d9,HDFC,direct expenses,5eecc6d6449e4f7cfb1c2708,2021-03-08T00:00:00.000Z,"NEFT DR-ICIC0003374-SIDDHARTH KANOJIA-NE TBANK, MUM-N067211431291427-35000",,,net_banking_transfer,-35000
61b700d0d8beac1599eb36df,50200023535069,-187856.92,60ec41ba55c00300382672d9,HDFC,direct expenses,5eecc6d6449e4f7cfb1c2708,2021-03-08T00:00:00.000Z,"NEFT DR-ALLA0210591-CHAMPA DEVI-NETBANK, MUM-N067211431291448-10000",,,net_banking_transfer,-10000
61b700d1d8beac1599eb36e6,50200023535069,-237856.92,60ec41ba55c00300382672d9,HDFC,direct expenses,5eecc6d6449e4f7cfb1c2708,2021-03-08T00:00:00.000Z,"NEFT DR-UTIB0000120-ADNAN ALI-NETBANK, M UM-N067211431289324-50000",,,net_banking_transfer,-50000
61b700d3d8beac1599eb36f0,50200023535069,-342831.92,60ec41ba55c00300382672d9,HDFC,direct expenses,5eecc6d6449e4f7cfb1c2708,2021-03-08T00:00:00.000Z,"NEFT DR-SYNB0005170-SNEHAL TAYDE-NETBANK , MUM-N067211431291572-104975",,,net_banking_transfer,-104975
61b700d4d8beac1599eb36f3,50200023535069,-378831.92,60ec41ba55c00300382672d9,HDFC,direct expenses,5eecc6d6449e4f7cfb1c2708,2021-03-08T00:00:00.000Z,00901610080520-TPT-36000-POOJA KAPIL SHR,,,net_banking_transfer,-36000
61b700d5d8beac1599eb36f7,50200023535069,-478831.92,60ec41ba55c00300382672d9,HDFC,direct expenses,5eecc6d6449e4f7cfb1c2708,2021-03-08T00:00:00.000Z,02771610131904-TPT-100000-DIGANT BHATT,,,net_banking_transfer,-100000
61b700d5d8beac1599eb36fd,50200023535069,-564537.92,60ec41ba55c00300382672d9,HDFC,direct expenses,5eecc6d6449e4f7cfb1c2708,2021-03-08T00:00:00.000Z,50100330586095-TPT-85706-DIWAKAR UNIYAL,,,net_banking_transfer,-85706
61b700d6d8beac1599eb3704,50200023535069,-634537.92,60ec41ba55c00300382672d9,HDFC,direct expenses,5eecc6d6449e4f7cfb1c2708,2021-03-08T00:00:00.000Z,50100301160692-TPT-70000-TARUN GARG,,,net_banking_transfer,-70000
61b700d7d8beac1599eb370a,50200023535069,-673564.92,60ec41ba55c00300382672d9,HDFC,Salary/Emp/consultant Expense,5eecc6d6449e4f7cfb1c2708,2021-03-08T00:00:00.000Z,"NEFT DR-UTIB0003142-ARIA DESAI UG ELIZAB ETH THOMAS ALEX-NETBANK, MUM-N0672114312 97561-39027",,,net_banking_transfer,-39027
61b700d8d8beac1599eb3710,50200023535069,-689564.92,60ec41ba55c00300382672d9,HDFC,direct expenses,5eecc6d6449e4f7cfb1c2708,2021-03-08T00:00:00.000Z,"NEFT DR-PUNB0482100-RAM BHAVAN YADAV-NET BANK, MUM-N067211431302474-16000",,,net_banking_transfer,-16000
61b700d9d8beac1599eb3715,50200023535069,-710222.92,60ec41ba55c00300382672d9,HDFC,direct expenses,5eecc6d6449e4f7cfb1c2708,2021-03-08T00:00:00.000Z,"NEFT DR-PUNB0307800-PRAKASH JHA-NETBANK, MUM-N067211431307010-20658",,,net_banking_transfer,-20658
61b700dad8beac1599eb3719,50200023535069,-706645.52,60ec41ba55c00300382672d9,HDFC,Revenue-Mktplace,5eecc6d6449e4f7cfb1c2708,2021-03-08T00:00:00.000Z,NEFT CR-DEUT0797BGL-FLIPKART INTERNET PR IVATE LIMITED-SLICK ORGANICS PVT LTD-030 800097GN00261,shopping,,net_banking_transfer,3577.4
61b700dbd8beac1599eb371e,50200023535069,-701879.78,60ec41ba55c00300382672d9,HDFC,Revenue-Mktplace,5eecc6d6449e4f7cfb1c2708,2021-03-08T00:00:00.000Z,NEFT CR-DEUT0797BGL-FLIPKART INTERNET PR IVATE LIMITED-SLICK ORGANICS PVT LTD-030 800123GN00026,shopping,,net_banking_transfer,4765.74
61b700dcd8beac1599eb3724,50200023535069,-700829.35,60ec41ba55c00300382672d9,HDFC,Revenue-Mktplace,5eecc6d6449e4f7cfb1c2708,2021-03-08T00:00:00.000Z,NEFT CR-DEUT0797BGL-MYNTRA DESIGNS PRIVA TE LIMITED-SLICK ORGANICS PRIVATE LIMITE D-030800151GN00200,shopping,,net_banking_transfer,1050.43
61b700ddd8beac1599eb3727,50200023535069,-644617.6,60ec41ba55c00300382672d9,HDFC,Revenue-PG-split enabled,5eecc6d6449e4f7cfb1c2708,2021-03-08T00:00:00.000Z,NEFT CR-UTIB0001506-RAZORPAY SOFTWARE PR IVATE LIMITED-SLICK ORGANICS PVT LITD-AX ISCN0071646414,investments,,net_banking_transfer,56211.75
61b700ded8beac1599eb372a,50200023535069,-644210.2,60ec41ba55c00300382672d9,HDFC,Revenue-Mktplace,5eecc6d6449e4f7cfb1c2708,2021-03-08T00:00:00.000Z,NEFT CR-DEUT0797BGL-MYNTRA DESIGNS PRIVA TE LIMITED-SLICK ORGANICS PRIVATE LIMITE D-030800222GN00094,shopping,,net_banking_transfer,407.4
61b700dfd8beac1599eb372e,50200023535069,-642313.78,60ec41ba55c00300382672d9,HDFC,Revenue-PG-non-split,5eecc6d6449e4f7cfb1c2708,2021-03-08T00:00:00.000Z,NEFT CR-IDFB0010204-SEZZLE PAYMENTS PRIV ATE LIMITED-SLICK ORGANICS PRIVATE LIMIT ED-IDFBH21067767250,investments,,net_banking_transfer,1896.42
61b700e0d8beac1599eb3737,50200023535069,-639338.53,60ec41ba55c00300382672d9,HDFC,Revenue-PG-non-split,5eecc6d6449e4f7cfb1c2708,2021-03-08T00:00:00.000Z,NEFT CR-IDFB0010204-SEZZLE PAYMENTS PRIV ATE LIMITED-SLICK ORGANICS PRIVATE LIMIT ED-IDFBH21067767796,investments,,net_banking_transfer,2975.25
61b700e1d8beac1599eb373c,50200023535069,-640938.53,60ec41ba55c00300382672d9,HDFC,direct expenses,5eecc6d6449e4f7cfb1c2708,2021-03-08T00:00:00.000Z,"NEFT DR-UTIB0000120-ADNAN ALI-NETBANK, M",,,net_banking_transfer,-1600
61b700e2d8beac1599eb3743,50200023535069,-638552.31,60ec41ba55c00300382672d9,HDFC,Revenue-Mktplace,5eecc6d6449e4f7cfb1c2708,2021-03-08T00:00:00.000Z,NEFT CR-ICIC0000105-MANASH LIFETYLE PVT LTD-SLICKORGANICSPRIVATELIMITEDMPMUM-ICI B210670037130,,,net_banking_transfer,2386.22
61b700e3d8beac1599eb3751,50200023535069,-635065.64,60ec41ba55c00300382672d9,HDFC,Revenue-Mktplace,5eecc6d6449e4f7cfb1c2708,2021-03-08T00:00:00.000Z,NEFT CR-ICIC0000105-MANASH LIFETYLE PVT LTD-SLICKORGANICSPRIVATELIMITEDMPGGN-ICI B210670037129,,,net_banking_transfer,3486.67
61b700e4d8beac1599eb3758,50200023535069,-495036.33,60ec41ba55c00300382672d9,HDFC,Revenue-PG-split enabled,5eecc6d6449e4f7cfb1c2708,2021-03-08T00:00:00.000Z,NEFT CR-UTIB0001506-RAZORPAY SOFTWARE PR IVATE LIMITED-SLICK ORGANICS PVT LITD-AX ISCN0071738769,investments,,net_banking_transfer,140029.31
61b700e5d8beac1599eb375c,50200023535069,-384532.17,60ec41ba55c00300382672d9,HDFC,Revenue-COD,5eecc6d6449e4f7cfb1c2708,2021-03-08T00:00:00.000Z,NEFT CR-KKBK0000958-BIGFOOT RETAIL SOLUT IONS PRIVATE LIMITED-SLICK ORGANICS PVT LTD-KKBK210677277714,,,net_banking_transfer,110504.16
61b700e6d8beac1599eb3761,50200023535069,-384532.84,60ec41ba55c00300382672d9,HDFC,direct expenses,5eecc6d6449e4f7cfb1c2708,2021-03-09T00:00:00.000Z,TDS RECOVERED ON-50300498262188,,,Other,-0.67
61b700e7d8beac1599eb3768,50200023535069,-384523.84,60ec41ba55c00300382672d9,HDFC,Transfer in/Revenue-other,5eecc6d6449e4f7cfb1c2708,2021-03-09T00:00:00.000Z,INT. ON SWCR ON-50300498262188,,,Other,9
61b700e8d8beac1599eb376b,50200023535069,-368246.84,60ec41ba55c00300382672d9,HDFC,Loan-in,5eecc6d6449e4f7cfb1c2708,2021-03-09T00:00:00.000Z,SWEEP-IN CREDIT - 50300498262188,,,self_transfer,16277
61b700e9d8beac1599eb376f,50200023535069,-368250.74,60ec41ba55c00300382672d9,HDFC,direct expenses,5eecc6d6449e4f7cfb1c2708,2021-03-09T00:00:00.000Z,TDS RECOVERED ON-50300498262188,,,Other,-3.9
61b700ead8beac1599eb3778,50200023535069,-368198.74,60ec41ba55c00300382672d9,HDFC,Transfer in/Revenue-other,5eecc6d6449e4f7cfb1c2708,2021-03-09T00:00:00.000Z,INT. ON SWCR ON-50300498262188,,,Other,52
61b700ebd8beac1599eb377d,50200023535069,-277618.74,60ec41ba55c00300382672d9,HDFC,Loan-in,5eecc6d6449e4f7cfb1c2708,2021-03-09T00:00:00.000Z,SWEEP-IN CREDIT - 50300498262188,,,self_transfer,90580
61b700ecd8beac1599eb378d,50200023535069,-277619.64,60ec41ba55c00300382672d9,HDFC,direct expenses,5eecc6d6449e4f7cfb1c2708,2021-03-09T00:00:00.000Z,TDS RECOVERED ON-50300498262188,,,Other,-0.9
61b700edd8beac1599eb379e,50200023535069,-277607.64,60ec41ba55c00300382672d9,HDFC,Transfer in/Revenue-other,5eecc6d6449e4f7cfb1c2708,2021-03-09T00:00:00.000Z,INT. ON SWCR ON-50300498262188,,,Other,12
61b700eed8beac1599eb37aa,50200023535069,-256607.64,60ec41ba55c00300382672d9,HDFC,Loan-in,5eecc6d6449e4f7cfb1c2708,2021-03-09T00:00:00.000Z,SWEEP-IN CREDIT - 50300498262188,,,self_transfer,21000
61b700eed8beac1599eb37b6,50200023535069,-256608.32,60ec41ba55c00300382672d9,HDFC,direct expenses,5eecc6d6449e4f7cfb1c2708,2021-03-09T00:00:00.000Z,TDS RECOVERED ON-50300498262188,,,Other,-0.68
61b700efd8beac1599eb37c7,50200023535069,-256599.32,60ec41ba55c00300382672d9,HDFC,Transfer in/Revenue-other,5eecc6d6449e4f7cfb1c2708,2021-03-09T00:00:00.000Z,INT. ON SWCR ON-50300498262188,,,Other,9
61b700f0d8beac1599eb37d3,50200023535069,-241599.32,60ec41ba55c00300382672d9,HDFC,Loan-in,5eecc6d6449e4f7cfb1c2708,2021-03-09T00:00:00.000Z,SWEEP-IN CREDIT - 50300498262188,,,self_transfer,15000
61b700f1d8beac1599eb37e2,50200023535069,-241600.82,60ec41ba55c00300382672d9,HDFC,direct expenses,5eecc6d6449e4f7cfb1c2708,2021-03-09T00:00:00.000Z,TDS RECOVERED ON-50300498262188,,,Other,-1.5
61b700f2d8beac1599eb37e9,50200023535069,-241580.82,60ec41ba55c00300382672d9,HDFC,Transfer in/Revenue-other,5eecc6d6449e4f7cfb1c2708,2021-03-09T00:00:00.000Z,INT. ON SWCR ON-50300498262188,,,Other,20
61b700f3d8beac1599eb37f8,50200023535069,-206580.82,60ec41ba55c00300382672d9,HDFC,Loan-in,5eecc6d6449e4f7cfb1c2708,2021-03-09T00:00:00.000Z,SWEEP-IN CREDIT - 50300498262188,,,self_transfer,35000
61b700f4d8beac1599eb3800,50200023535069,-206581.27,60ec41ba55c00300382672d9,HDFC,direct expenses,5eecc6d6449e4f7cfb1c2708,2021-03-09T00:00:00.000Z,TDS RECOVERED ON-50300498262188,,,Other,-0.45
61b700f5d8beac1599eb3807,50200023535069,-206575.27,60ec41ba55c00300382672d9,HDFC,Transfer in/Revenue-other,5eecc6d6449e4f7cfb1c2708,2021-03-09T00:00:00.000Z,INT. ON SWCR ON-50300498262188,,,Other,6
61b700f6d8beac1599eb3812,50200023535069,-196575.27,60ec41ba55c00300382672d9,HDFC,Loan-in,5eecc6d6449e4f7cfb1c2708,2021-03-09T00:00:00.000Z,SWEEP-IN CREDIT - 50300498262188,,,self_transfer,10000
61b700f7d8beac1599eb3819,50200023535069,-196577.44,60ec41ba55c00300382672d9,HDFC,direct expenses,5eecc6d6449e4f7cfb1c2708,2021-03-09T00:00:00.000Z,TDS RECOVERED ON-50300498262188,,,Other,-2.17
61b700f8d8beac1599eb3823,50200023535069,-196548.44,60ec41ba55c00300382672d9,HDFC,Transfer in/Revenue-other,5eecc6d6449e4f7cfb1c2708,2021-03-09T00:00:00.000Z,INT. ON SWCR ON-50300498262188,,,Other,29
61b700f9d8beac1599eb382a,50200023535069,-146548.44,60ec41ba55c00300382672d9,HDFC,Loan-in,5eecc6d6449e4f7cfb1c2708,2021-03-09T00:00:00.000Z,SWEEP-IN CREDIT - 50300498262188,,,self_transfer,50000
61b700fad8beac1599eb3831,50200023535069,-146552.94,60ec41ba55c00300382672d9,HDFC,direct expenses,5eecc6d6449e4f7cfb1c2708,2021-03-09T00:00:00.000Z,TDS RECOVERED ON-50300498262188,,,Other,-4.5
61b700fbd8beac1599eb3839,50200023535069,-146492.94,60ec41ba55c00300382672d9,HDFC,Transfer in/Revenue-other,5eecc6d6449e4f7cfb1c2708,2021-03-09T00:00:00.000Z,INT. ON SWCR ON-50300498262188,,,Other,60
61b700fcd8beac1599eb383d,50200023535069,-41517.94,60ec41ba55c00300382672d9,HDFC,Loan-in,5eecc6d6449e4f7cfb1c2708,2021-03-09T00:00:00.000Z,SWEEP-IN CREDIT - 50300498262188,,,self_transfer,104975
61b700fdd8beac1599eb3841,50200023535069,-41519.52,60ec41ba55c00300382672d9,HDFC,direct expenses,5eecc6d6449e4f7cfb1c2708,2021-03-09T00:00:00.000Z,TDS RECOVERED ON-50300498262188,,,Other,-1.58
61b700fed8beac1599eb384e,50200023535069,-41498.52,60ec41ba55c00300382672d9,HDFC,Transfer in/Revenue-other,5eecc6d6449e4f7cfb1c2708,2021-03-09T00:00:00.000Z,INT. ON SWCR ON-50300498262188,,,Other,21
61b700ffd8beac1599eb3853,50200023535069,-5498.52,60ec41ba55c00300382672d9,HDFC,Loan-in,5eecc6d6449e4f7cfb1c2708,2021-03-09T00:00:00.000Z,SWEEP-IN CREDIT - 50300498262188,,,self_transfer,36000
61b70100d8beac1599eb385e,50200023535069,-5498.74,60ec41ba55c00300382672d9,HDFC,direct expenses,5eecc6d6449e4f7cfb1c2708,2021-03-09T00:00:00.000Z,TDS RECOVERED ON-50300498262188,,,Other,-0.22
61b70101d8beac1599eb3867,50200023535069,-5495.74,60ec41ba55c00300382672d9,HDFC,Transfer in/Revenue-other,5eecc6d6449e4f7cfb1c2708,2021-03-09T00:00:00.000Z,INT. ON SWCR ON-50300498262188,,,Other,3
61b70102d8beac1599eb3876,50200023535069,3.26,60ec41ba55c00300382672d9,HDFC,Loan-in,5eecc6d6449e4f7cfb1c2708,2021-03-09T00:00:00.000Z,SWEEP-IN CREDIT - 50300498262188,,,self_transfer,5499
61b70103d8beac1599eb387d,50200023535069,137042.59,60ec41ba55c00300382672d9,HDFC,Transfer in/Revenue-other,5eecc6d6449e4f7cfb1c2708,2021-03-09T00:00:00.000Z,IMPS-106805294891-NA-HDFC-XXXXXXXXXX0007 -ALL20210309216820000330830668628,,,net_banking_transfer,137039.33
61b70104d8beac1599eb3881,50200023535069,37042.59,60ec41ba55c00300382672d9,HDFC,direct expenses,5eecc6d6449e4f7cfb1c2708,2021-03-09T00:00:00.000Z,"NEFT DR-YESB0000162-VINAY REDDY-NETBANK, MUM-N068211432925910-100000",,,net_banking_transfer,-100000
61b70105d8beac1599eb3889,50200023535069,-1457.41,60ec41ba55c00300382672d9,HDFC,direct expenses,5eecc6d6449e4f7cfb1c2708,2021-03-09T00:00:00.000Z,50100293329616-TPT-38500-SADIYA BANO,,,net_banking_transfer,-38500
61b70106d8beac1599eb388b,50200023535069,-36457.41,60ec41ba55c00300382672d9,HDFC,direct expenses,5eecc6d6449e4f7cfb1c2708,2021-03-09T00:00:00.000Z,50100064106714-TPT-35000-AKSHARANSH BHAT T,,,net_banking_transfer,-35000
61b70107d8beac1599eb388e,50200023535069,-51457.41,60ec41ba55c00300382672d9,HDFC,direct expenses,5eecc6d6449e4f7cfb1c2708,2021-03-09T00:00:00.000Z,"NEFT DR-BARB0DBKHAN-ARUNT RANSPORT-NETBA NK, MUM-N068211432927494-15000",travel,,net_banking_transfer,-15000
61b70108d8beac1599eb389c,50200023535069,81833.84,60ec41ba55c00300382672d9,HDFC,Revenue-PG-split enabled,5eecc6d6449e4f7cfb1c2708,2021-03-09T00:00:00.000Z,NEFT CR-UTIB0001506-RAZORPAY SOFTWARE PR IVATE LIMITED-SLICK ORGANICS PVT LITD-AX ISCN0071835007,investments,,net_banking_transfer,133291.25
61b70109d8beac1599eb38a4,50200023535069,61833.84,60ec41ba55c00300382672d9,HDFC,direct expenses,5eecc6d6449e4f7cfb1c2708,2021-03-09T00:00:00.000Z,SARVAN KUMAR - CHQ PAID - DEVLI ROAD K,,,chq,-20000
61b7010ad8beac1599eb38a9,50200023535069,168035.6,60ec41ba55c00300382672d9,HDFC,Revenue-Mktplace,5eecc6d6449e4f7cfb1c2708,2021-03-09T00:00:00.000Z,IMPS-106811175316-AMAZON SELLER SERVIC-H DFC-XXXXXXXX6004-5EUU3ELLOXLDDXMZSLICK O RGANICS PVT LTD,shopping,,net_banking_transfer,106201.76
61b7010ad8beac1599eb38b4,50200023535069,536626.17,60ec41ba55c00300382672d9,HDFC,Revenue-Mktplace,5eecc6d6449e4f7cfb1c2708,2021-03-09T00:00:00.000Z,NEFT CR-DEUT0797BGL-AMAZON PAY (INDIA) P RIVATE LIMITED-SLICK ORGANICS PVT LTD-03 0900108GN00221,shopping,,net_banking_transfer,368590.57
61b7010cd8beac1599eb38b9,50200023535069,444126.17,60ec41ba55c00300382672d9,HDFC,direct expenses,5eecc6d6449e4f7cfb1c2708,2021-03-09T00:00:00.000Z,NEFT DR-BARB0VJMATU-ARTISTO DESIGNZ-NETB,,,net_banking_transfer,-92500
61b7010dd8beac1599eb38c0,50200023535069,452162.49,60ec41ba55c00300382672d9,HDFC,Revenue-PG-non-split,5eecc6d6449e4f7cfb1c2708,2021-03-09T00:00:00.000Z,NEFT CR-SCBL0036001-STRIPE INDIA PRIVATE -SLICK ORGANICS PRIVATE LIMITED-SSG17413 Q0203947,investments,,net_banking_transfer,8036.32
61b7010ed8beac1599eb38e4,50200023535069,453119.16,60ec41ba55c00300382672d9,HDFC,Transfer in/Revenue-other,5eecc6d6449e4f7cfb1c2708,2021-03-09T00:00:00.000Z,4060004495-09 03 2021-HDFAZCUR1,,,Other,956.67
61b7010fd8beac1599eb38f1,50200023535069,285043.16,60ec41ba55c00300382672d9,HDFC,direct expenses,5eecc6d6449e4f7cfb1c2708,2021-03-09T00:00:00.000Z,"NEFT DR-YESB0000551-VISTTA COSMETICS-NET BANK, MUM-N068211433613323-168076",,,net_banking_transfer,-168076
61b70110d8beac1599eb38f5,50200023535069,150043.16,60ec41ba55c00300382672d9,HDFC,direct expenses,5eecc6d6449e4f7cfb1c2708,2021-03-09T00:00:00.000Z,02711600008220-TPT-135000-VARUN SINGH,,,net_banking_transfer,-135000
61b70111d8beac1599eb38f8,50200023535069,137543.16,60ec41ba55c00300382672d9,HDFC,agency/vendor expense,5eecc6d6449e4f7cfb1c2708,2021-03-09T00:00:00.000Z,50200055013567-TPT-12500-NEO MEDIAWORKS,,,net_banking_transfer,-12500
61b70112d8beac1599eb38ff,50200023535069,122543.16,60ec41ba55c00300382672d9,HDFC,direct expenses,5eecc6d6449e4f7cfb1c2708,2021-03-09T00:00:00.000Z,"NEFT DR-ICIC0000046-RANA TRANSPORT COMPA NY-NETBANK, MUM-N068211433653369-15000",travel,,net_banking_transfer,-15000
61b70113d8beac1599eb3903,50200023535069,123262.85,60ec41ba55c00300382672d9,HDFC,Revenue-Mktplace,5eecc6d6449e4f7cfb1c2708,2021-03-09T00:00:00.000Z,NEFT CR-ICIC0000105-MANASH LIFETYLE PVT LTD-SLICKORGANICSPRIVATELIMITEDMPGGN-ICI B210680038903,,,net_banking_transfer,719.69
61b70114d8beac1599eb390a,50200023535069,131036.25,60ec41ba55c00300382672d9,HDFC,Revenue-PG-split enabled,5eecc6d6449e4f7cfb1c2708,2021-03-09T00:00:00.000Z,NEFT CR-UTIB0001506-RAZORPAY SOFTWARE PR IVATE LIMITED-SLICK ORGANICS PVT LITD-AX ISCN0071928292,investments,,net_banking_transfer,7773.4
61b70115d8beac1599eb3912,50200023535069,153671.74,60ec41ba55c00300382672d9,HDFC,Revenue-PG-non-split,5eecc6d6449e4f7cfb1c2708,2021-03-10T00:00:00.000Z,UPI-PAYTM-PAYOUTS@PAYTM-PYTM0123456-1069 91517376-ALL202103102168200,ewallet,,upi,22635.49
61b70116d8beac1599eb3918,50200023535069,155127.38,60ec41ba55c00300382672d9,HDFC,Revenue-Mktplace,5eecc6d6449e4f7cfb1c2708,2021-03-10T00:00:00.000Z,NEFT CR-DEUT0797BGL-FLIPKART INTERNET PR IVATE LIMITED-SLICK ORGANICS PVT LTD-031 000051GN00253,shopping,,net_banking_transfer,1455.64
61b70117d8beac1599eb391f,50200023535069,157600.17,60ec41ba55c00300382672d9,HDFC,Revenue-Mktplace,5eecc6d6449e4f7cfb1c2708,2021-03-10T00:00:00.000Z,NEFT CR-DEUT0797BGL-FLIPKART INTERNET PR IVATE LIMITED-SLICK ORGANICS PVT LTD-031 000085GN00166,shopping,,net_banking_transfer,2472.79
61b70118d8beac1599eb3927,50200023535069,158782.93,60ec41ba55c00300382672d9,HDFC,Revenue-Mktplace,5eecc6d6449e4f7cfb1c2708,2021-03-10T00:00:00.000Z,NEFT CR-DEUT0797BGL-MYNTRA DESIGNS PRIVA TE LIMITED-SLICK ORGANICS PRIVATE LIMITE D-031000151GN00094,shopping,,net_banking_transfer,1182.76
61b70119d8beac1599eb392e,50200023535069,160370.98,60ec41ba55c00300382672d9,HDFC,Revenue-Mktplace,5eecc6d6449e4f7cfb1c2708,2021-03-10T00:00:00.000Z,NEFT CR-DEUT0797BGL-MYNTRA DESIGNS PRIVA TE LIMITED-SLICK ORGANICS PRIVATE LIMITE D-031000152GN00107,shopping,,net_banking_transfer,1588.05
61b70119d8beac1599eb3931,50200023535069,178839.02,60ec41ba55c00300382672d9,HDFC,Revenue-PG-split enabled,5eecc6d6449e4f7cfb1c2708,2021-03-10T00:00:00.000Z,NEFT CR-UTIB0001506-RAZORPAY SOFTWARE PR,,,net_banking_transfer,18468.04
61b7011ad8beac1599eb3934,50200023535069,172612.16,60ec41ba55c00300382672d9,HDFC,direct expenses,5eecc6d6449e4f7cfb1c2708,2021-03-10T00:00:00.000Z,POS 514834XXXXXX9486 LTCARTRIDGE,,,debit_card,-6226.86
61b7011bd8beac1599eb393a,50200023535069,174098.58,60ec41ba55c00300382672d9,HDFC,Revenue-Mktplace,5eecc6d6449e4f7cfb1c2708,2021-03-10T00:00:00.000Z,NEFT CR-ICIC0000105-MANASH LIFETYLE PVT LTD-SLICKORGANICSPRIVATELIMITED(MP)MUM-I CIB210690040319,,,net_banking_transfer,1486.42
61b7011cd8beac1599eb3942,50200023535069,174272.08,60ec41ba55c00300382672d9,HDFC,Revenue-Mktplace,5eecc6d6449e4f7cfb1c2708,2021-03-10T00:00:00.000Z,NEFT CR-ICIC0000105-MANASH LIFETYLE PVT LTD-SLICKORGANICSPRIVATELIMITED(MP)GGN-I CIB210690040316,,,net_banking_transfer,173.5
61b7011dd8beac1599eb3949,50200023535069,190733.72,60ec41ba55c00300382672d9,HDFC,Revenue-PG-split enabled,5eecc6d6449e4f7cfb1c2708,2021-03-10T00:00:00.000Z,NEFT CR-UTIB0001506-RAZORPAY SOFTWARE PR IVATE LIMITED-SLICK ORGANICS PVT LITD-AX ISCN0072100223,investments,,net_banking_transfer,16461.64
61b7011ed8beac1599eb3952,50200023535069,196627.73,60ec41ba55c00300382672d9,HDFC,Revenue-PG-non-split,5eecc6d6449e4f7cfb1c2708,2021-03-10T00:00:00.000Z,NEFT CR-IDFB0010204-SEZZLE PAYMENTS PRIV ATE LIMITED-SLICK ORGANICS PRIVATE LIMIT ED-IDFBH21069952066,investments,,net_banking_transfer,5894.01
61b7011fd8beac1599eb3958,50200023535069,213651.88,60ec41ba55c00300382672d9,HDFC,Transfer in/Revenue-other,5eecc6d6449e4f7cfb1c2708,2021-03-11T00:00:00.000Z,IMPS-107005627787-NA-HDFC-XXXXXXXXXX0007 -ALL20210311216820000330830668628,,,net_banking_transfer,17024.15
61b70120d8beac1599eb395d,50200023535069,211701.88,60ec41ba55c00300382672d9,HDFC,direct expenses,5eecc6d6449e4f7cfb1c2708,2021-03-11T00:00:00.000Z,00071610019925-TPT-1950-KHUSHBOO SINGHVI,,,net_banking_transfer,-1950
61b70121d8beac1599eb3965,50200023535069,211920.21,60ec41ba55c00300382672d9,HDFC,Revenue-Mktplace,5eecc6d6449e4f7cfb1c2708,2021-03-11T00:00:00.000Z,NEFT CR-ICIC0000105-MANASH LIFETYLE PVT LTD-SLICK ORGANICS PRIVATE LIMITED MP MUM-ICIB210700011976,,,net_banking_transfer,218.33
61b70122d8beac1599eb396c,50200023535069,213355.72,60ec41ba55c00300382672d9,HDFC,Revenue-Mktplace,5eecc6d6449e4f7cfb1c2708,2021-03-11T00:00:00.000Z,4060004462-TIMES INTERNET LIMITED NODAL,,,Other,1435.51
61b70123d8beac1599eb3970,50200023535069,229976.15,60ec41ba55c00300382672d9,HDFC,Transfer in/Revenue-other,5eecc6d6449e4f7cfb1c2708,2021-03-12T00:00:00.000Z,IMPS-107105782742-NA-HDFC-XXXXXXXXXX0007 -ALL20210312216820000330830668628,,,net_banking_transfer,16620.43
61b70124d8beac1599eb3974,50200023535069,179976.15,60ec41ba55c00300382672d9,HDFC,Marketing Expense,5eecc6d6449e4f7cfb1c2708,2021-03-12T00:00:00.000Z,POS 514834XXXXXX9486 GOOGLE ADWORDS,,,debit_card,-50000
61b70125d8beac1599eb3977,50200023535069,97101.15,60ec41ba55c00300382672d9,HDFC,direct expenses,5eecc6d6449e4f7cfb1c2708,2021-03-12T00:00:00.000Z,"NEFT DR-KKBK0000173-ONE STOP ADVERTISING -NETBANK, MUM-N071211437019979-82875",,,net_banking_transfer,-82875
61b70126d8beac1599eb3983,50200023535069,103729.66,60ec41ba55c00300382672d9,HDFC,Revenue-Mktplace,5eecc6d6449e4f7cfb1c2708,2021-03-12T00:00:00.000Z,NEFT CR-DEUT0797BGL-FLIPKART INTERNET PR IVATE LIMITED-SLICK ORGANICS PVT LTD-031 200110GN00023,shopping,,net_banking_transfer,6628.51
61b70127d8beac1599eb3987,50200023535069,104830.13,60ec41ba55c00300382672d9,HDFC,Revenue-Mktplace,5eecc6d6449e4f7cfb1c2708,2021-03-12T00:00:00.000Z,NEFT CR-DEUT0797BGL-MYNTRA DESIGNS PRIVA,shopping,,net_banking_transfer,1100.47
61b70128d8beac1599eb398d,50200023535069,116454.55,60ec41ba55c00300382672d9,HDFC,Revenue-PG-split enabled,5eecc6d6449e4f7cfb1c2708,2021-03-12T00:00:00.000Z,NEFT CR-UTIB0001506-RAZORPAY SOFTWARE PR IVATE LIMITED-SLICK ORGANICS PVT LITD-AX ISCN0072223756,investments,,net_banking_transfer,11624.42
61b70129d8beac1599eb3995,50200023535069,116510.26,60ec41ba55c00300382672d9,HDFC,Revenue-Mktplace,5eecc6d6449e4f7cfb1c2708,2021-03-12T00:00:00.000Z,NEFT CR-DEUT0797BGL-MYNTRA DESIGNS PRIVA TE LIMITED-SLICK ORGANICS PRIVATE LIMITE D-031200234GN00090,shopping,,net_banking_transfer,55.71
61b7012ad8beac1599eb399b,50200023535069,99935.26,60ec41ba55c00300382672d9,HDFC,agency/vendor expense,5eecc6d6449e4f7cfb1c2708,2021-03-12T00:00:00.000Z,50200019195361-TPT-16575-ILUMINAR MEDIA PVT LTD,,,net_banking_transfer,-16575
61b7012bd8beac1599eb39a0,50200023535069,100637.2,60ec41ba55c00300382672d9,HDFC,Revenue-PG-split enabled,5eecc6d6449e4f7cfb1c2708,2021-03-12T00:00:00.000Z,NEFT CR-UTIB0001506-RAZORPAY SOFTWARE PR IVATE LIMITED-SLICK ORGANICS-AXISCN00722 62602,investments,,net_banking_transfer,701.94
61b7012cd8beac1599eb39a7,50200023535069,101115.31,60ec41ba55c00300382672d9,HDFC,Revenue-PG-split enabled,5eecc6d6449e4f7cfb1c2708,2021-03-12T00:00:00.000Z,NEFT CR-UTIB0001506-RAZORPAY SOFTWARE PR IVATE LIMITED-SLICK ORGANICS-AXISCN00722 62531,investments,,net_banking_transfer,478.11
61b7012dd8beac1599eb39af,50200023535069,109656.16,60ec41ba55c00300382672d9,HDFC,Revenue-Mktplace,5eecc6d6449e4f7cfb1c2708,2021-03-12T00:00:00.000Z,NEFT CR-DEUT0797BGL-FLIPKART INTERNET PR IVATE LIMITED-SLICK ORGANICS PVT LTD-031 200075GN00052,shopping,,net_banking_transfer,8540.85
61b7012ed8beac1599eb39b2,50200023535069,110584.45,60ec41ba55c00300382672d9,HDFC,Revenue-PG-split enabled,5eecc6d6449e4f7cfb1c2708,2021-03-12T00:00:00.000Z,NEFT CR-UTIB0001506-RAZORPAY SOFTWARE PR IVATE LIMITED-SLICK ORGANICS-AXISCN00722 88188,investments,,net_banking_transfer,928.29
61b7012fd8beac1599eb39b6,50200023535069,111066.17,60ec41ba55c00300382672d9,HDFC,Transfer in/Revenue-other,5eecc6d6449e4f7cfb1c2708,2021-03-12T00:00:00.000Z,NEFT CR-YESB0000001-ILLUMINAR MEDIA-SLIC K ORGANICS PVT LTD-N071210536379013,,,net_banking_transfer,481.72
61b70130d8beac1599eb39bd,50200023535069,171374.47,60ec41ba55c00300382672d9,HDFC,Revenue-COD,5eecc6d6449e4f7cfb1c2708,2021-03-12T00:00:00.000Z,NEFT CR-KKBK0000958-BIGFOOT RETAIL SOLUT IONS PRIVATE LIMITED-SLICK ORGANICS PVT LTD-KKBK210718397561,,,net_banking_transfer,60308.3
61b70131d8beac1599eb39c2,50200023535069,167806.78,60ec41ba55c00300382672d9,HDFC,direct expenses,5eecc6d6449e4f7cfb1c2708,2021-03-12T00:00:00.000Z,POS 514834XXXXXX9486 WWW.FAQPRIME.COM,,,debit_card,-3567.69
61b70132d8beac1599eb39ca,50200023535069,181614.44,60ec41ba55c00300382672d9,HDFC,Revenue-PG-split enabled,5eecc6d6449e4f7cfb1c2708,2021-03-12T00:00:00.000Z,NEFT CR-UTIB0001506-RAZORPAY SOFTWARE PR IVATE LIMITED-SLICK ORGANICS PVT LITD-AX ISCN0072358884,investments,,net_banking_transfer,13807.66
61b70133d8beac1599eb39d2,50200023535069,96298.44,60ec41ba55c00300382672d9,HDFC,direct expenses,5eecc6d6449e4f7cfb1c2708,2021-03-12T00:00:00.000Z,"NEFT DR-INDB0000333-NOASTRIX PRIVATE LIM ITED-NETBANK, MUM-N071211438334380-85316",,,net_banking_transfer,-85316
61b70134d8beac1599eb39d6,50200023535069,718.44,60ec41ba55c00300382672d9,HDFC,direct expenses,5eecc6d6449e4f7cfb1c2708,2021-03-12T00:00:00.000Z,NEFT DR-ICIC0006615-INSTASPACES REALTECH,,,net_banking_transfer,-95580
61b70135d8beac1599eb39db,50200023535069,23577.23,60ec41ba55c00300382672d9,HDFC,Transfer in/Revenue-other,5eecc6d6449e4f7cfb1c2708,2021-03-13T00:00:00.000Z,IMPS-107205880560-NA-HDFC-XXXXXXXXXX0007 -ALL20210313216820000330830668628,,,net_banking_transfer,22858.79
61b70136d8beac1599eb39e2,50200023535069,6577.23,60ec41ba55c00300382672d9,HDFC,direct expenses,5eecc6d6449e4f7cfb1c2708,2021-03-13T00:00:00.000Z,"NEFT DR-ICIC0000046-RANA TRANSPORT COMPA NY-NETBANK, MUM-N072211438736757-FNF",travel,,net_banking_transfer,-17000
61b70136d8beac1599eb39ea,50200023535069,21416.12,60ec41ba55c00300382672d9,HDFC,Transfer in/Revenue-other,5eecc6d6449e4f7cfb1c2708,2021-03-14T00:00:00.000Z,IMPS-107305955369-NA-HDFC-XXXXXXXXXX0007 -ALL20210314216820000330830668628,,,net_banking_transfer,14838.89
61b70137d8beac1599eb39ec,50200023535069,45919.27,60ec41ba55c00300382672d9,HDFC,Transfer in/Revenue-other,5eecc6d6449e4f7cfb1c2708,2021-03-15T00:00:00.000Z,IMPS-107405983116-NA-HDFC-XXXXXXXXXX0007 -ALL20210315216820000330830668628,,,net_banking_transfer,24503.15
61b70138d8beac1599eb39f0,50200023535069,49793.1,60ec41ba55c00300382672d9,HDFC,Revenue-Mktplace,5eecc6d6449e4f7cfb1c2708,2021-03-15T00:00:00.000Z,NEFT CR-DEUT0797BGL-FLIPKART INTERNET PR IVATE LIMITED-SLICK ORGANICS PVT LTD-031 500102GN00055,shopping,,net_banking_transfer,3873.83
61b70139d8beac1599eb39f5,50200023535069,48140.1,60ec41ba55c00300382672d9,HDFC,direct expenses,5eecc6d6449e4f7cfb1c2708,2021-03-15T00:00:00.000Z,"NEFT DR-SBIN0012924-DAMAYANTI AMBALAL JA IN-NETBANK, MUM-N074211439274196-1653",,,net_banking_transfer,-1653
61b7013ad8beac1599eb39fd,50200023535069,38140.1,60ec41ba55c00300382672d9,HDFC,direct expenses,5eecc6d6449e4f7cfb1c2708,2021-03-15T00:00:00.000Z,"NEFT DR-PUNB0476900-SANDHYA SHUKLA-NETBA NK, MUM-N074211439282620-10000",,,net_banking_transfer,-10000
61b7013bd8beac1599eb3a02,50200023535069,38525.73,60ec41ba55c00300382672d9,HDFC,Revenue-Mktplace,5eecc6d6449e4f7cfb1c2708,2021-03-15T00:00:00.000Z,NEFT CR-DEUT0797BGL-MYNTRA DESIGNS PRIVA TE LIMITED-SLICK ORGANICS PRIVATE LIMITE D-031500162GN00191,shopping,,net_banking_transfer,385.63
61b7013cd8beac1599eb3a0b,50200023535069,38581.44,60ec41ba55c00300382672d9,HDFC,Revenue-Mktplace,5eecc6d6449e4f7cfb1c2708,2021-03-15T00:00:00.000Z,NEFT CR-DEUT0797BGL-MYNTRA DESIGNS PRIVA TE LIMITED-SLICK ORGANICS PRIVATE LIMITE D-031500225GN00123,shopping,,net_banking_transfer,55.71
61b7013dd8beac1599eb3a11,50200023535069,40221.63,60ec41ba55c00300382672d9,HDFC,Revenue-PG-split enabled,5eecc6d6449e4f7cfb1c2708,2021-03-15T00:00:00.000Z,NEFT CR-UTIB0001506-RAZORPAY SOFTWARE PR IVATE LIMITED-SLICK ORGANICS PVT LITD-AX ISCN0072417144,investments,,net_banking_transfer,1640.19
61b7013ed8beac1599eb3a16,50200023535069,25221.63,60ec41ba55c00300382672d9,HDFC,direct expenses,5eecc6d6449e4f7cfb1c2708,2021-03-15T00:00:00.000Z,"NEFT DR-BARB0DBKHAN-ARUNT RANSPORT-NETBA NK, MUM-N074211439660221-15000",travel,,net_banking_transfer,-15000
61b7013fd8beac1599eb3a1c,50200023535069,27495.84,60ec41ba55c00300382672d9,HDFC,Revenue-PG-non-split,5eecc6d6449e4f7cfb1c2708,2021-03-15T00:00:00.000Z,NEFT CR-IDFB0010204-SEZZLE PAYMENTS PRIV ATE LIMITED-SLICK ORGANICS PRIVATE LIMIT ED-IDFBH21074147998,investments,,net_banking_transfer,2274.21
61b70140d8beac1599eb3a24,50200023535069,24950.09,60ec41ba55c00300382672d9,HDFC,direct expenses,5eecc6d6449e4f7cfb1c2708,2021-03-15T00:00:00.000Z,POS 514834XXXXXX9486 AIP*GODADDY INDI,,,debit_card,-2545.75
61b70141d8beac1599eb3a28,50200023535069,48187.22,60ec41ba55c00300382672d9,HDFC,Revenue-PG-split enabled,5eecc6d6449e4f7cfb1c2708,2021-03-15T00:00:00.000Z,NEFT CR-UTIB0001506-RAZORPAY SOFTWARE PR IVATE LIMITED-SLICK ORGANICS PVT LITD-AX ISCN0072535441,investments,,net_banking_transfer,23237.13
61b70142d8beac1599eb3a2b,50200023535069,142682.72,60ec41ba55c00300382672d9,HDFC,Revenue-COD,5eecc6d6449e4f7cfb1c2708,2021-03-15T00:00:00.000Z,NEFT CR-KKBK0000958-BIGFOOT RETAIL SOLUT IONS PRIVATE LIMITED-SLICK ORGANICS PVT LTD-KKBK210748867472,,,net_banking_transfer,94495.5
61b70143d8beac1599eb3a31,50200023535069,153793.96,60ec41ba55c00300382672d9,HDFC,Transfer in/Revenue-other,5eecc6d6449e4f7cfb1c2708,2021-03-16T00:00:00.000Z,IMPS-107505202090-NA-HDFC-XXXXXXXXXX0007 -ALL20210316216820000330830668628,,,net_banking_transfer,11111.24
61b70144d8beac1599eb3a43,50200023535069,153843.12,60ec41ba55c00300382672d9,HDFC,Revenue-PG-split enabled,5eecc6d6449e4f7cfb1c2708,2021-03-16T00:00:00.000Z,NEFT CR-UTIB0001506-RAZORPAY SOFTWARE PR IVATE LIMITED-SLICK ORGANICS PVT LITD-AX ISCN0072673363,investments,,net_banking_transfer,49.16
61b70145d8beac1599eb3a47,50200023535069,133843.12,60ec41ba55c00300382672d9,HDFC,direct expenses,5eecc6d6449e4f7cfb1c2708,2021-03-16T00:00:00.000Z,"NEFT DR-YESB0000162-VINAY REDDY-NETBANK, MUM-N075211440777362-20000",,,net_banking_transfer,-20000
61b70146d8beac1599eb3a54,50200023535069,262920.83,60ec41ba55c00300382672d9,HDFC,Revenue-Mktplace,5eecc6d6449e4f7cfb1c2708,2021-03-16T00:00:00.000Z,IMPS-107511066681-AMAZON SELLER SERVIC-H DFC-XXXXXXXX6004-3LSOGYONAS5N392CSLICK O RGANICS PVT LTD,shopping,,net_banking_transfer,129077.71
61b70147d8beac1599eb3a59,50200023535069,736909.34,60ec41ba55c00300382672d9,HDFC,Revenue-Mktplace,5eecc6d6449e4f7cfb1c2708,2021-03-16T00:00:00.000Z,NEFT CR-DEUT0797BGL-AMAZON PAY (INDIA) P RIVATE LIMITED-SLICK ORGANICS PVT LTD-03 1600123GN00449,shopping,,net_banking_transfer,473988.51
61b70148d8beac1599eb3a5e,50200023535069,751840.39,60ec41ba55c00300382672d9,HDFC,Revenue-PG-split enabled,5eecc6d6449e4f7cfb1c2708,2021-03-16T00:00:00.000Z,NEFT CR-UTIB0001506-RAZORPAY SOFTWARE PR IVATE LIMITED-SLICK ORGANICS PVT LITD-AX ISCN0072782822,investments,,net_banking_transfer,14931.05
61b70149d8beac1599eb3a63,50200023535069,751113.1,60ec41ba55c00300382672d9,HDFC,direct expenses,5eecc6d6449e4f7cfb1c2708,2021-03-16T00:00:00.000Z,POS 514834XXXXXX9486 MANYCHAT COM PRO,,,debit_card,-727.29
61b7014ad8beac1599eb3a76,50200023535069,768119.64,60ec41ba55c00300382672d9,HDFC,Transfer in/Revenue-other,5eecc6d6449e4f7cfb1c2708,2021-03-17T00:00:00.000Z,IMPS-107605292854-NA-HDFC-XXXXXXXXXX0007 -ALL20210317216820000330830668628,,,net_banking_transfer,17006.54
61b7014bd8beac1599eb3a7b,50200023535069,769507.97,60ec41ba55c00300382672d9,HDFC,Revenue-Mktplace,5eecc6d6449e4f7cfb1c2708,2021-03-17T00:00:00.000Z,NEFT CR-DEUT0797BGL-FLIPKART INTERNET PR IVATE LIMITED-SLICK ORGANICS PVT LTD-031 700065GN00130,shopping,,net_banking_transfer,1388.33
61b7014cd8beac1599eb3a7e,50200023535069,774314.17,60ec41ba55c00300382672d9,HDFC,Revenue-Mktplace,5eecc6d6449e4f7cfb1c2708,2021-03-17T00:00:00.000Z,NEFT CR-DEUT0797BGL-FLIPKART INTERNET PR IVATE LIMITED-SLICK ORGANICS PVT LTD-031 700100GN00267,shopping,,net_banking_transfer,4806.2
61b7014dd8beac1599eb3a88,50200023535069,774416.36,60ec41ba55c00300382672d9,HDFC,Revenue-PG-split enabled,5eecc6d6449e4f7cfb1c2708,2021-03-17T00:00:00.000Z,NEFT CR-UTIB0001506-RAZORPAY SOFTWARE PR,,,net_banking_transfer,102.19
61b7014ed8beac1599eb3a95,50200023535069,776355.66,60ec41ba55c00300382672d9,HDFC,Revenue-Mktplace,5eecc6d6449e4f7cfb1c2708,2021-03-17T00:00:00.000Z,NEFT CR-DEUT0797BGL-MYNTRA DESIGNS PRIVA TE LIMITED-SLICK ORGANICS PRIVATE LIMITE D-031700205GN00230,shopping,,net_banking_transfer,1939.3
61b7014fd8beac1599eb3a97,50200023535069,776266.95,60ec41ba55c00300382672d9,HDFC,bank charges,5eecc6d6449e4f7cfb1c2708,2021-03-17T00:00:00.000Z,.DC INTL POS TXN MARKUP+ST 010321 020321 -CDT2107003388014,,,international_transaction_arbitrage,-88.71
61b70150d8beac1599eb3aa5,50200023535069,776221.1,60ec41ba55c00300382672d9,HDFC,bank charges,5eecc6d6449e4f7cfb1c2708,2021-03-17T00:00:00.000Z,.DC INTL POS TXN MARKUP+ST 280221 030321 -CDT2107003388014,,,international_transaction_arbitrage,-45.85
61b70151d8beac1599eb3aad,50200023535069,764221.1,60ec41ba55c00300382672d9,HDFC,direct expenses,5eecc6d6449e4f7cfb1c2708,2021-03-17T00:00:00.000Z,"NEFT DR-MAHB0000472-NAINSI KESHARI-NETBA NK, MUM-N076211442306856-12000",,,net_banking_transfer,-12000
61b70152d8beac1599eb3ab4,50200023535069,564221.1,60ec41ba55c00300382672d9,HDFC,direct expenses,5eecc6d6449e4f7cfb1c2708,2021-03-17T00:00:00.000Z,"NEFT DR-ICIC0006235-GLANCE GETVANTAGE ES CROW ACCOUNT 2-NETBANK, MUM-N07621144232 0942-200000",,,net_banking_transfer,-200000
61b70153d8beac1599eb3aba,50200023535069,563776.41,60ec41ba55c00300382672d9,HDFC,bank charges,5eecc6d6449e4f7cfb1c2708,2021-03-17T00:00:00.000Z,.DC INTL POS TXN MARKUP+ST 040321 050321 -CDT2107003388014,,,international_transaction_arbitrage,-444.69
61b70154d8beac1599eb3abf,50200023535069,567075.41,60ec41ba55c00300382672d9,HDFC,Revenue-Mktplace,5eecc6d6449e4f7cfb1c2708,2021-03-17T00:00:00.000Z,NEFT CR-KKBK0000958-SURFBOATS SOLUTIONS PVT LTD-SLICK ORGANICS PRIVATE LIMITED-K KBK210769375059,investments,,net_banking_transfer,3299
61b70155d8beac1599eb3ac9,50200023535069,577319.41,60ec41ba55c00300382672d9,HDFC,Revenue-PG-non-split,5eecc6d6449e4f7cfb1c2708,2021-03-17T00:00:00.000Z,NEFT CR-IDFB0010204-SEZZLE PAYMENTS PRIV ATE LIMITED-SLICK ORGANICS PRIVATE LIMIT ED-IDFBH21076271241,investments,,net_banking_transfer,10244
61b70156d8beac1599eb3acf,50200023535069,575968.68,60ec41ba55c00300382672d9,HDFC,direct expenses,5eecc6d6449e4f7cfb1c2708,2021-03-17T00:00:00.000Z,POS 514834XXXXXX9486 AMZNMKTPLACE,,,debit_card,-1350.73
61b70157d8beac1599eb3ad2,50200023535069,576024.39,60ec41ba55c00300382672d9,HDFC,Revenue-Mktplace,5eecc6d6449e4f7cfb1c2708,2021-03-17T00:00:00.000Z,NEFT CR-DEUT0797BGL-MYNTRA DESIGNS PRIVA TE LIMITED-SLICK ORGANICS PRIVATE LIMITE D-031700227GN00157,shopping,,net_banking_transfer,55.71
61b70158d8beac1599eb3adb,50200023535069,576463.17,60ec41ba55c00300382672d9,HDFC,Revenue-Mktplace,5eecc6d6449e4f7cfb1c2708,2021-03-17T00:00:00.000Z,NEFT CR-KKBK0000958-SUPERMARKET GROCERY SUPPLIES PVT LTD-SLICK ORGANICS PVT LTD- KKBK210769418387,shopping,,net_banking_transfer,438.78
61b70159d8beac1599eb3ae3,50200023535069,581562.83,60ec41ba55c00300382672d9,HDFC,Revenue-Mktplace,5eecc6d6449e4f7cfb1c2708,2021-03-17T00:00:00.000Z,NEFT CR-KKBK0000958-SUPERMARKET GROCERY,shopping,,net_banking_transfer,5099.66
61b7015ad8beac1599eb3aea,50200023535069,594340.17,60ec41ba55c00300382672d9,HDFC,Revenue-PG-split enabled,5eecc6d6449e4f7cfb1c2708,2021-03-17T00:00:00.000Z,NEFT CR-UTIB0001506-RAZORPAY SOFTWARE PR IVATE LIMITED-SLICK ORGANICS PVT LITD-AX ISCN0072960833,investments,,net_banking_transfer,12777.34
61b7015bd8beac1599eb3af2,50200023535069,612692.17,60ec41ba55c00300382672d9,HDFC,Revenue-Mktplace,5eecc6d6449e4f7cfb1c2708,2021-03-17T00:00:00.000Z,NEFT CR-RATN0000999-DREAMPLUG TECHNOLOGI ES PRIVATE LIMI-SLICK ORGANICS PRIVATE L IMITED-000165846799,,,net_banking_transfer,18352
61b7015cd8beac1599eb3afa,50200023535069,635488.19,60ec41ba55c00300382672d9,HDFC,Transfer in/Revenue-other,5eecc6d6449e4f7cfb1c2708,2021-03-18T00:00:00.000Z,IMPS-107705461375-NA-HDFC-XXXXXXXXXX0007 -ALL20210318216820000330830668628,,,net_banking_transfer,22796.02
61b7015cd8beac1599eb3aff,50200023535069,635526.67,60ec41ba55c00300382672d9,HDFC,Revenue-PG-split enabled,5eecc6d6449e4f7cfb1c2708,2021-03-18T00:00:00.000Z,NEFT CR-UTIB0001506-RAZORPAY SOFTWARE PR IVATE LIMITED-SLICK ORGANICS PVT LITD-AX ISCN0073009230,investments,,net_banking_transfer,38.48
61b7015dd8beac1599eb3b05,50200023535069,381917.67,60ec41ba55c00300382672d9,HDFC,direct expenses,5eecc6d6449e4f7cfb1c2708,2021-03-18T00:00:00.000Z,"NEFT DR-ICIC0006235-GLANCE GETVANTAGE ES CROW ACCOUNT 2-NETBANK, MUM-N07721144335 0432-253609",,,net_banking_transfer,-253609
61b7015ed8beac1599eb3b0e,50200023535069,389482.56,60ec41ba55c00300382672d9,HDFC,Revenue-PG-non-split,5eecc6d6449e4f7cfb1c2708,2021-03-18T00:00:00.000Z,NEFT CR-SCBL0036001-STRIPE INDIA PRIVATE -SLICK ORGANICS PRIVATE LIMITED-SSG17413 Q0211984,investments,,net_banking_transfer,7564.89
61b7015fd8beac1599eb3b11,50200023535069,387532.56,60ec41ba55c00300382672d9,HDFC,direct expenses,5eecc6d6449e4f7cfb1c2708,2021-03-18T00:00:00.000Z,00071610019925-TPT-1950-KHUSHBOO SINGHVI,,,net_banking_transfer,-1950
61b70160d8beac1599eb3b15,50200023535069,362221.56,60ec41ba55c00300382672d9,HDFC,direct expenses,5eecc6d6449e4f7cfb1c2708,2021-03-18T00:00:00.000Z,50200043297657-TPT-25311-AIDC PRODUCTS I NDIA PRIVATE LIMITED,,,net_banking_transfer,-25311
61b70161d8beac1599eb3b1a,50200023535069,352221.56,60ec41ba55c00300382672d9,HDFC,direct expenses,5eecc6d6449e4f7cfb1c2708,2021-03-18T00:00:00.000Z,01201000228777-TPT-10000-S K JENIA HASSE EN,,,net_banking_transfer,-10000
61b70162d8beac1599eb3b25,50200023535069,345221.56,60ec41ba55c00300382672d9,HDFC,direct expenses,5eecc6d6449e4f7cfb1c2708,2021-03-18T00:00:00.000Z,"NEFT DR-SBIN0032160-KARISHMA NAVLANI-NET BANK, MUM-N077211443643644-7000",,,net_banking_transfer,-7000
61b70163d8beac1599eb3b2d,50200023535069,346603.59,60ec41ba55c00300382672d9,HDFC,Revenue-Mktplace,5eecc6d6449e4f7cfb1c2708,2021-03-18T00:00:00.000Z,NEFT CR-ICIC0000105-MANASH LIFETYLE PVT LTD-SLICKORGANICSPRIVATELIMITEDMPGGN-ICI B210770018937,,,net_banking_transfer,1382.03
61b70164d8beac1599eb3b3f,50200023535069,347258.58,60ec41ba55c00300382672d9,HDFC,Revenue-Mktplace,5eecc6d6449e4f7cfb1c2708,2021-03-18T00:00:00.000Z,NEFT CR-ICIC0000105-MANASH LIFETYLE PVT LTD-SLICKORGANICSPRIVATELIMITEDMPMUM-ICI B210770019797,,,net_banking_transfer,654.99
61b70165d8beac1599eb3b4f,50200023535069,358656.98,60ec41ba55c00300382672d9,HDFC,Revenue-PG-split enabled,5eecc6d6449e4f7cfb1c2708,2021-03-18T00:00:00.000Z,NEFT CR-UTIB0001506-RAZORPAY SOFTWARE PR,,,net_banking_transfer,11398.4
61b70166d8beac1599eb3b63,50200023535069,370316.6,60ec41ba55c00300382672d9,HDFC,Transfer in/Revenue-other,5eecc6d6449e4f7cfb1c2708,2021-03-19T00:00:00.000Z,IMPS-107805678124-NA-HDFC-XXXXXXXXXX0007 -ALL20210319216820000330830668628,,,net_banking_transfer,11659.62
61b70167d8beac1599eb3b70,50200023535069,370789.62,60ec41ba55c00300382672d9,HDFC,Transfer in/Revenue-other,5eecc6d6449e4f7cfb1c2708,2021-03-19T00:00:00.000Z,NEFT CR-YESB0000001-ILLUMINAR MEDIA-SLIC K ORGANICS PVT LTD-N078210541276759,,,net_banking_transfer,473.02
61b70168d8beac1599eb3b7d,50200023535069,371267.73,60ec41ba55c00300382672d9,HDFC,Transfer in/Revenue-other,5eecc6d6449e4f7cfb1c2708,2021-03-19T00:00:00.000Z,NEFT CR-YESB0000001-ILUMINAR MEDIA-SLICK ORGANICS PVT. LTD-N078210541277722,,,net_banking_transfer,478.11
61b70169d8beac1599eb3b88,50200023535069,371301.24,60ec41ba55c00300382672d9,HDFC,Revenue-Mktplace,5eecc6d6449e4f7cfb1c2708,2021-03-19T00:00:00.000Z,NEFT CR-DEUT0797BGL-FLIPKART INTERNET PR IVATE LIMITED-SLICK ORGANICS PVT LTD-031 900081GN00107,shopping,,net_banking_transfer,33.51
61b7016ad8beac1599eb3b8f,50200023535069,379984.88,60ec41ba55c00300382672d9,HDFC,Revenue-Mktplace,5eecc6d6449e4f7cfb1c2708,2021-03-19T00:00:00.000Z,NEFT CR-DEUT0797BGL-FLIPKART INTERNET PR IVATE LIMITED-SLICK ORGANICS PVT LTD-031 900123GN00167,shopping,,net_banking_transfer,8683.64
61b7016bd8beac1599eb3b9c,50200023535069,319984.88,60ec41ba55c00300382672d9,HDFC,direct expenses,5eecc6d6449e4f7cfb1c2708,2021-03-19T00:00:00.000Z,"NEFT DR-ANDB0002029-HITESH ARORA-NETBANK , MUM-N078211444432722-60000",,,net_banking_transfer,-60000
61b7016cd8beac1599eb3ba4,50200023535069,321645.73,60ec41ba55c00300382672d9,HDFC,Revenue-Mktplace,5eecc6d6449e4f7cfb1c2708,2021-03-19T00:00:00.000Z,NEFT CR-DEUT0797BGL-MYNTRA DESIGNS PRIVA TE LIMITED-SLICK ORGANICS PRIVATE LIMITE D-031900198GN00254,shopping,,net_banking_transfer,1660.85
61b7016dd8beac1599eb3bab,50200023535069,323116.35,60ec41ba55c00300382672d9,HDFC,Revenue-PG-split enabled,5eecc6d6449e4f7cfb1c2708,2021-03-19T00:00:00.000Z,NEFT CR-UTIB0001506-RAZORPAY SOFTWARE PR IVATE LIMITED-SLICK ORGANICS PVT LITD-AX ISCN0073174022,investments,,net_banking_transfer,1470.62
61b7016ed8beac1599eb3bb2,50200023535069,290440.35,60ec41ba55c00300382672d9,HDFC,Tax,5eecc6d6449e4f7cfb1c2708,2021-03-19T00:00:00.000Z,051030819032110906- CBDT TAX,,,Other,-32676
61b7016fd8beac1599eb3bbe,50200023535069,213692.35,60ec41ba55c00300382672d9,HDFC,Tax,5eecc6d6449e4f7cfb1c2708,2021-03-19T00:00:00.000Z,051030819032111847- CBDT TAX,,,Other,-76748
61b70170d8beac1599eb3bc9,50200023535069,110351.35,60ec41ba55c00300382672d9,HDFC,Tax,5eecc6d6449e4f7cfb1c2708,2021-03-19T00:00:00.000Z,051030819032111894- CBDT TAX,,,Other,-103341
61b70171d8beac1599eb3bd1,50200023535069,110204,60ec41ba55c00300382672d9,HDFC,bank charges,5eecc6d6449e4f7cfb1c2708,2021-03-19T00:00:00.000Z,.DC INTL POS TXN MARKUP+ST 120321 140321 -CDT2107003388014,,,international_transaction_arbitrage,-147.35
61b70172d8beac1599eb3bf6,50200023535069,111139.63,60ec41ba55c00300382672d9,HDFC,Revenue-Mktplace,5eecc6d6449e4f7cfb1c2708,2021-03-19T00:00:00.000Z,NEFT CR-DEUT0797BGL-MYNTRA DESIGNS PRIVA TE LIMITED-SLICK ORGANICS PRIVATE LIMITE D-031900230GN00161,shopping,,net_banking_transfer,935.63
61b70173d8beac1599eb3c01,50200023535069,111226.36,60ec41ba55c00300382672d9,HDFC,Revenue-Mktplace,5eecc6d6449e4f7cfb1c2708,2021-03-19T00:00:00.000Z,NEFT CR-ICIC0000105-MANASH LIFETYLE PVT,,,net_banking_transfer,86.73
61b70174d8beac1599eb3c07,50200023535069,112255.53,60ec41ba55c00300382672d9,HDFC,Revenue-Mktplace,5eecc6d6449e4f7cfb1c2708,2021-03-19T00:00:00.000Z,NEFT CR-ICIC0000105-MANASH LIFETYLE PVT LTD-SLICKORGANICSPRIVATELIMITEDMPMUM-ICI B210780040386,,,net_banking_transfer,1029.17
61b70174d8beac1599eb3c0e,50200023535069,156421.23,60ec41ba55c00300382672d9,HDFC,Revenue-COD,5eecc6d6449e4f7cfb1c2708,2021-03-19T00:00:00.000Z,NEFT CR-KKBK0000958-BIGFOOT RETAIL SOLUT IONS PRIVATE LIMITED-SLICK ORGANICS PVT LTD-KKBK210789932881,,,net_banking_transfer,44165.7
61b70175d8beac1599eb3c15,50200023535069,157378.9,60ec41ba55c00300382672d9,HDFC,Revenue-Mktplace,5eecc6d6449e4f7cfb1c2708,2021-03-19T00:00:00.000Z,NEFT CR-ICIC0000104-GOQII TECHNOLOGIES P VT LTD-SLICK ORGANICS PRIVATE LIMITED-CM S1867080772,,,net_banking_transfer,957.67
61b70176d8beac1599eb3c1e,50200023535069,166796.85,60ec41ba55c00300382672d9,HDFC,Revenue-PG-split enabled,5eecc6d6449e4f7cfb1c2708,2021-03-19T00:00:00.000Z,NEFT CR-UTIB0001506-RAZORPAY SOFTWARE PR IVATE LIMITED-SLICK ORGANICS PVT LITD-AX ISCN0073256858,investments,,net_banking_transfer,9417.95
61b70177d8beac1599eb3c25,50200023535069,901796.85,60ec41ba55c00300382672d9,HDFC,Transfer in/Revenue-other,5eecc6d6449e4f7cfb1c2708,2021-03-19T00:00:00.000Z,NEFT CR-ICIC0006235-GLANCE GETVANTAGE ES CROW ACCOUNT 1-SLICK ORGANICS PVT LTD-CM S1866782534,,,net_banking_transfer,735000
61b70178d8beac1599eb3c2f,50200023535069,919924.87,60ec41ba55c00300382672d9,HDFC,Transfer in/Revenue-other,5eecc6d6449e4f7cfb1c2708,2021-03-20T00:00:00.000Z,IMPS-107905783213-NA-HDFC-XXXXXXXXXX0007 -ALL20210320216820000330830668628,,,net_banking_transfer,18128.02
61b70179d8beac1599eb3c3a,50200023535069,591968.87,60ec41ba55c00300382672d9,HDFC,Tax,5eecc6d6449e4f7cfb1c2708,2021-03-20T00:00:00.000Z,051030820032110322- CBDT TAX,,,Other,-327956
61b7017ad8beac1599eb3c44,50200023535069,593480.69,60ec41ba55c00300382672d9,HDFC,Revenue-PG-split enabled,5eecc6d6449e4f7cfb1c2708,2021-03-20T00:00:00.000Z,NEFT CR-UTIB0001506-RAZORPAY SOFTWARE PR IVATE LIMITED-SLICK ORGANICS PVT LITD-AX ISCN0073287580,investments,,net_banking_transfer,1511.82
61b7017bd8beac1599eb3c49,50200023535069,588410.85,60ec41ba55c00300382672d9,HDFC,direct expenses,5eecc6d6449e4f7cfb1c2708,2021-03-20T00:00:00.000Z,POS 514834XXXXXX9486 FEEDBACKFIVE,,,debit_card,-5069.84
61b7017cd8beac1599eb3c4d,50200023535069,587322.45,60ec41ba55c00300382672d9,HDFC,Refund,5eecc6d6449e4f7cfb1c2708,2021-03-20T00:00:00.000Z,"NEFT DR-UCBA0000850-SHALINI MESSEY-NETBA NK, MUM-N079211445985641-REFUND",,,net_banking_transfer,-1088.4
61b7017dd8beac1599eb3c52,50200023535069,577322.45,60ec41ba55c00300382672d9,HDFC,direct expenses,5eecc6d6449e4f7cfb1c2708,2021-03-20T00:00:00.000Z,50100201107051-TPT-10000-SHEETAL KLER,,,net_banking_transfer,-10000
61b7017ed8beac1599eb3c56,50200023535069,570322.45,60ec41ba55c00300382672d9,HDFC,direct expenses,5eecc6d6449e4f7cfb1c2708,2021-03-20T00:00:00.000Z,"NEFT DR-BARB0VJNAZA-HEENA P TALREJA-NETB ANK, MUM-N079211445984498-7000",,,net_banking_transfer,-7000
61b7017fd8beac1599eb3c5c,50200023535069,585725.32,60ec41ba55c00300382672d9,HDFC,Revenue-PG-split enabled,5eecc6d6449e4f7cfb1c2708,2021-03-20T00:00:00.000Z,NEFT CR-UTIB0001506-RAZORPAY SOFTWARE PR IVATE LIMITED-SLICK ORGANICS PVT LITD-AX ISCN0073347309,investments,,net_banking_transfer,15402.87
61b70180d8beac1599eb3c68,50200023535069,579277.54,60ec41ba55c00300382672d9,HDFC,direct expenses,5eecc6d6449e4f7cfb1c2708,2021-03-20T00:00:00.000Z,POS 514834XXXXXX9486 HOTJAR,,,debit_card,-6447.78
61b70181d8beac1599eb3c6d,50200023535069,597895.47,60ec41ba55c00300382672d9,HDFC,Transfer in/Revenue-other,5eecc6d6449e4f7cfb1c2708,2021-03-21T00:00:00.000Z,IMPS-108005827632-NA-HDFC-XXXXXXXXXX0007,,,net_banking_transfer,18617.93
61b70182d8beac1599eb3c7f,50200023535069,493819.47,60ec41ba55c00300382672d9,HDFC,direct expenses,5eecc6d6449e4f7cfb1c2708,2021-03-21T00:00:00.000Z,"NEFT DR-YESB0000551-VISTTA COSMETICS-NET BANK, MUM-N080211446555750-104076",,,net_banking_transfer,-104076
61b70183d8beac1599eb3c89,50200023535069,516312.85,60ec41ba55c00300382672d9,HDFC,Transfer in/Revenue-other,5eecc6d6449e4f7cfb1c2708,2021-03-22T00:00:00.000Z,IMPS-108105797655-NA-HDFC-XXXXXXXXXX0007 -ALL20210322216820000330830668628,,,net_banking_transfer,22493.38
61b70184d8beac1599eb3c8e,50200023535069,530526.88,60ec41ba55c00300382672d9,HDFC,Revenue-PG-split enabled,5eecc6d6449e4f7cfb1c2708,2021-03-22T00:00:00.000Z,NEFT CR-UTIB0001506-RAZORPAY SOFTWARE PR IVATE LIMITED-SLICK ORGANICS PVT LITD-AX ISCN0073373387,investments,,net_banking_transfer,14214.03
61b70185d8beac1599eb3c95,50200023535069,532463.64,60ec41ba55c00300382672d9,HDFC,Revenue-Mktplace,5eecc6d6449e4f7cfb1c2708,2021-03-22T00:00:00.000Z,NEFT CR-DEUT0797BGL-MYNTRA DESIGNS PRIVA TE LIMITED-SLICK ORGANICS PRIVATE LIMITE D-032200098GN00214,shopping,,net_banking_transfer,1936.76
61b70186d8beac1599eb3c9a,50200023535069,535555.28,60ec41ba55c00300382672d9,HDFC,Revenue-Mktplace,5eecc6d6449e4f7cfb1c2708,2021-03-22T00:00:00.000Z,NEFT CR-DEUT0797BGL-MYNTRA DESIGNS PRIVA TE LIMITED-SLICK ORGANICS PRIVATE LIMITE D-032200097GN00223,shopping,,net_banking_transfer,3091.64
61b70187d8beac1599eb3ca6,50200023535069,559171.13,60ec41ba55c00300382672d9,HDFC,Revenue-Mktplace,5eecc6d6449e4f7cfb1c2708,2021-03-22T00:00:00.000Z,NEFT CR-DEUT0797BGL-FLIPKART INTERNET PR IVATE LIMITED-SLICK ORGANICS PVT LTD-032 200110GN00259,shopping,,net_banking_transfer,23615.85
61b70188d8beac1599eb3caa,50200023535069,509171.13,60ec41ba55c00300382672d9,HDFC,direct expenses,5eecc6d6449e4f7cfb1c2708,2021-03-22T00:00:00.000Z,"NEFT DR-ICIC0000007-DLF UTILITIES LTD-NE TBANK, MUM-N081211446816299-50000",,,net_banking_transfer,-50000
61b70189d8beac1599eb3cae,50200023535069,510989.37,60ec41ba55c00300382672d9,HDFC,Revenue-Mktplace,5eecc6d6449e4f7cfb1c2708,2021-03-22T00:00:00.000Z,NEFT CR-DEUT0797BGL-FLIPKART INTERNET PR IVATE LIMITED-SLICK ORGANICS PVT LTD-032 200140GN00076,shopping,,net_banking_transfer,1818.24
61b7018ad8beac1599eb3cb2,50200023535069,459135.37,60ec41ba55c00300382672d9,HDFC,direct expenses,5eecc6d6449e4f7cfb1c2708,2021-03-22T00:00:00.000Z,"NEFT DR-ICIC0000007-DLF UTILITIES LTD-NE TBANK, MUM-N081211446825046-51854",,,net_banking_transfer,-51854
61b7018bd8beac1599eb3cba,50200023535069,409135.37,60ec41ba55c00300382672d9,HDFC,Marketing Expense,5eecc6d6449e4f7cfb1c2708,2021-03-22T00:00:00.000Z,POS 514834XXXXXX9486 GOOGLE ADS,,,debit_card,-50000
61b7018cd8beac1599eb3cc0,50200023535069,409622.81,60ec41ba55c00300382672d9,HDFC,Transfer in/Revenue-other,5eecc6d6449e4f7cfb1c2708,2021-03-22T00:00:00.000Z,ZOOBOP ME WORK-ARATA,,,Other,487.44
61b7018cd8beac1599eb3cc7,50200023535069,410100.65,60ec41ba55c00300382672d9,HDFC,Transfer in/Revenue-other,5eecc6d6449e4f7cfb1c2708,2021-03-22T00:00:00.000Z,4060004904-21 03 2021-HDFAZCUR1,,,Other,477.84
61b7018dd8beac1599eb3ccd,50200023535069,411308.09,60ec41ba55c00300382672d9,HDFC,Transfer in/Revenue-other,5eecc6d6449e4f7cfb1c2708,2021-03-22T00:00:00.000Z,FT - C76042220321144954 - - 50200050045 240 - ZOOBOP ME WORKS PRIVATE LIMITED,,,Other,1207.44
61b7018ed8beac1599eb3cd4,50200023535069,472373.28,60ec41ba55c00300382672d9,HDFC,Revenue-COD,5eecc6d6449e4f7cfb1c2708,2021-03-22T00:00:00.000Z,NEFT CR-KKBK0000958-BIGFOOT RETAIL SOLUT,,,net_banking_transfer,61065.19
61b7018fd8beac1599eb3cdb,50200023535069,472300.93,60ec41ba55c00300382672d9,HDFC,direct expenses,5eecc6d6449e4f7cfb1c2708,2021-03-22T00:00:00.000Z,POS 514834XXXXXX9486 RAZ*MARMETO,,,debit_card,-72.35
61b70190d8beac1599eb3ce2,50200023535069,497724.03,60ec41ba55c00300382672d9,HDFC,Transfer in/Revenue-other,5eecc6d6449e4f7cfb1c2708,2021-03-23T00:00:00.000Z,IMPS-108205949840-NA-HDFC-XXXXXXXXXX0007 -ALL20210323216820000330830668628,,,net_banking_transfer,25423.1
61b70191d8beac1599eb3ce5,50200023535069,604383.87,60ec41ba55c00300382672d9,HDFC,Revenue-Mktplace,5eecc6d6449e4f7cfb1c2708,2021-03-23T00:00:00.000Z,IMPS-108211025525-AMAZON SELLER SERVIC-H DFC-XXXXXXXX6004-44Y6UPZIICWAELJ2SLICK O RGANICS PVT LTD,shopping,,net_banking_transfer,106659.84
61b70192d8beac1599eb3cf5,50200023535069,1011723.76,60ec41ba55c00300382672d9,HDFC,Revenue-Mktplace,5eecc6d6449e4f7cfb1c2708,2021-03-23T00:00:00.000Z,NEFT CR-DEUT0797BGL-AMAZON PAY (INDIA) P RIVATE LIMITED-SLICK ORGANICS PVT LTD-03 2300184GN00098,shopping,,net_banking_transfer,407339.89
61b70193d8beac1599eb3cf9,50200023535069,946973.76,60ec41ba55c00300382672d9,HDFC,direct expenses,5eecc6d6449e4f7cfb1c2708,2021-03-23T00:00:00.000Z,"NEFT DR-UBIN0531855-MOHANISH KOTHARI-NET BANK, MUM-N082211448152534-64750",,,net_banking_transfer,-64750
61b70194d8beac1599eb3d05,50200023535069,962769.76,60ec41ba55c00300382672d9,HDFC,Transfer in/Revenue-other,5eecc6d6449e4f7cfb1c2708,2021-03-23T00:00:00.000Z,NEFT CR-KKBK0000958-SQUADRUN SOLUTIONS P VT LTD-SLICK ORGANICS PVT LTD-KKBK210821 627869,investments,,net_banking_transfer,15796
61b70195d8beac1599eb3d0d,50200023535069,831810.76,60ec41ba55c00300382672d9,HDFC,direct expenses,5eecc6d6449e4f7cfb1c2708,2021-03-23T00:00:00.000Z,02711600008220-TPT-130959-VARUN SINGH,,,net_banking_transfer,-130959
61b70196d8beac1599eb3d14,50200023535069,831601.38,60ec41ba55c00300382672d9,HDFC,bank charges,5eecc6d6449e4f7cfb1c2708,2021-03-23T00:00:00.000Z,.DC INTL POS TXN MARKUP+ST 190321 210321 -CDT2107003388014,,,international_transaction_arbitrage,-209.38
61b70197d8beac1599eb3d1b,50200023535069,832011.58,60ec41ba55c00300382672d9,HDFC,Revenue-Mktplace,5eecc6d6449e4f7cfb1c2708,2021-03-23T00:00:00.000Z,NEFT CR-ICIC0000105-MANASH LIFETYLE PVT LTD-SLICKORGANICSPRIVATELIMITEDMPGGN-ICI B210820027228,,,net_banking_transfer,410.2
61b70198d8beac1599eb3d28,50200023535069,845326.99,60ec41ba55c00300382672d9,HDFC,Revenue-PG-split enabled,5eecc6d6449e4f7cfb1c2708,2021-03-23T00:00:00.000Z,NEFT CR-UTIB0001506-RAZORPAY SOFTWARE PR IVATE LIMITED-SLICK ORGANICS PVT LITD-AX ISCN0073728236,investments,,net_banking_transfer,13315.41
61b70199d8beac1599eb3d2f,50200023535069,869801.62,60ec41ba55c00300382672d9,HDFC,Transfer in/Revenue-other,5eecc6d6449e4f7cfb1c2708,2021-03-24T00:00:00.000Z,IMPS-108305975174-NA-HDFC-XXXXXXXXXX0007 -ALL20210324216820000330830668628,,,net_banking_transfer,24474.63
61b7019ad8beac1599eb3d35,50200023535069,874547.36,60ec41ba55c00300382672d9,HDFC,Revenue-Mktplace,5eecc6d6449e4f7cfb1c2708,2021-03-24T00:00:00.000Z,NEFT CR-DEUT0797BGL-FLIPKART INTERNET PR IVATE LIMITED-SLICK ORGANICS PVT LTD-032 400065GN00003,shopping,,net_banking_transfer,4745.74
61b7019bd8beac1599eb3d3d,50200023535069,882444.51,60ec41ba55c00300382672d9,HDFC,Revenue-Mktplace,5eecc6d6449e4f7cfb1c2708,2021-03-24T00:00:00.000Z,NEFT CR-DEUT0797BGL-FLIPKART INTERNET PR IVATE LIMITED-SLICK ORGANICS PVT LTD-032 400107GN00133,shopping,,net_banking_transfer,7897.15
61b7019cd8beac1599eb3d3f,50200023535069,900847.61,60ec41ba55c00300382672d9,HDFC,Revenue-Mktplace,5eecc6d6449e4f7cfb1c2708,2021-03-24T00:00:00.000Z,NEFT CR-DEUT0797BGL-MYNTRA DESIGNS PRIVA,shopping,,net_banking_transfer,18403.1
61b7019dd8beac1599eb3d45,50200023535069,888847.61,60ec41ba55c00300382672d9,HDFC,direct expenses,5eecc6d6449e4f7cfb1c2708,2021-03-24T00:00:00.000Z,50100103558878-TPT-12000-GUNJA SHAILENDR A TIWARI,,,net_banking_transfer,-12000
61b7019ed8beac1599eb3d53,50200023535069,891357.31,60ec41ba55c00300382672d9,HDFC,Revenue-Mktplace,5eecc6d6449e4f7cfb1c2708,2021-03-24T00:00:00.000Z,NEFT CR-DEUT0797BGL-MYNTRA DESIGNS PRIVA TE LIMITED-SLICK ORGANICS PRIVATE LIMITE D-032400235GN00036,shopping,,net_banking_transfer,2509.7
61b7019fd8beac1599eb3d78,50200023535069,915493.15,60ec41ba55c00300382672d9,HDFC,Transfer in/Revenue-other,5eecc6d6449e4f7cfb1c2708,2021-03-25T00:00:00.000Z,IMPS-108405986141-NA-HDFC-XXXXXXXXXX0007 -ALL20210325216820000330830668628,,,net_banking_transfer,24135.84
61b701a0d8beac1599eb3d7d,50200023535069,915878.35,60ec41ba55c00300382672d9,HDFC,Revenue-Mktplace,5eecc6d6449e4f7cfb1c2708,2021-03-25T00:00:00.000Z,NEFT CR-ICIC0000105-MANASH LIFETYLE PVT LTD-SLICKORGANICSPRIVATELIMITEDMPMUM-ICI B210840010845,,,net_banking_transfer,385.2
61b701a1d8beac1599eb3d86,50200023535069,917533.12,60ec41ba55c00300382672d9,HDFC,Revenue-Mktplace,5eecc6d6449e4f7cfb1c2708,2021-03-25T00:00:00.000Z,NEFT CR-ICIC0000105-MANASH LIFETYLE PVT LTD-SLICKORGANICSPRIVATELIMITEDMPGGN-ICI B210840009019,,,net_banking_transfer,1654.77
61b701a2d8beac1599eb3d8d,50200023535069,907533.12,60ec41ba55c00300382672d9,HDFC,direct expenses,5eecc6d6449e4f7cfb1c2708,2021-03-25T00:00:00.000Z,50100201107051-TPT-10000-SHEETAL KLER,,,net_banking_transfer,-10000
61b701a3d8beac1599eb3d92,50200023535069,737533.12,60ec41ba55c00300382672d9,HDFC,direct expenses,5eecc6d6449e4f7cfb1c2708,2021-03-25T00:00:00.000Z,"NEFT DR-INDB0000148-ACQUISORY INDIA CONS ULTING PVT LTD-NETBANK, MUM-N08421145074 9518-170000",,,net_banking_transfer,-170000
61b701a4d8beac1599eb3d9c,50200023535069,709908.12,60ec41ba55c00300382672d9,HDFC,direct expenses,5eecc6d6449e4f7cfb1c2708,2021-03-25T00:00:00.000Z,"NEFT DR-KKBK0001393-MASCOT SPINCONTROL I NDIA PVT LTD-NETBANK, MUM-N0842114507658 81-27625",,,net_banking_transfer,-27625
61b701a5d8beac1599eb3dc1,50200023535069,709293.12,60ec41ba55c00300382672d9,HDFC,bank charges,5eecc6d6449e4f7cfb1c2708,2021-03-25T00:00:00.000Z,"NEFT DR-UTIB0000131-FREECHARGE PAYMENT T ECHNOLOGIES PRIVATE-NETBANK, MUM-N084211 450791298-615",ewallet,,net_banking_transfer,-615
61b701a6d8beac1599eb3dc4,50200023535069,712165.06,60ec41ba55c00300382672d9,HDFC,Revenue-Mktplace,5eecc6d6449e4f7cfb1c2708,2021-03-25T00:00:00.000Z,4060004851-TIMES INTERNET LIMITED NODAL,,,Other,2871.94
61b701a7d8beac1599eb3dc9,50200023535069,726846.06,60ec41ba55c00300382672d9,HDFC,Revenue-Mktplace,5eecc6d6449e4f7cfb1c2708,2021-03-25T00:00:00.000Z,NEFT CR-SCBL0036001-M/S DREAMPLUG TECHNO -SLICK ORGANICS PRIVATE LIMITEDSLICK-SIN 31436Q0013132,investments,,net_banking_transfer,14681
61b701a8d8beac1599eb3dce,50200023535069,792080.21,60ec41ba55c00300382672d9,HDFC,Revenue-PG-split enabled,5eecc6d6449e4f7cfb1c2708,2021-03-25T00:00:00.000Z,NEFT CR-UTIB0001506-RAZORPAY SOFTWARE PR,,,net_banking_transfer,65234.15
61b701a8d8beac1599eb3dda,50200023535069,882084.46,60ec41ba55c00300382672d9,HDFC,Transfer in/Revenue-other,5eecc6d6449e4f7cfb1c2708,2021-03-26T00:00:00.000Z,IMPS-108505996915-NA-HDFC-XXXXXXXXXX0007 -ALL20210326216820000330830668628,,,net_banking_transfer,90004.25
61b701a9d8beac1599eb3de9,50200023535069,893900.11,60ec41ba55c00300382672d9,HDFC,Revenue-Mktplace,5eecc6d6449e4f7cfb1c2708,2021-03-26T00:00:00.000Z,NEFT CR-DEUT0797BGL-FLIPKART INTERNET PR IVATE LIMITED-SLICK ORGANICS PVT LTD-032 600111GN00185,shopping,,net_banking_transfer,11815.65
61b701aad8beac1599eb3df0,50200023535069,915832.22,60ec41ba55c00300382672d9,HDFC,Revenue-Mktplace,5eecc6d6449e4f7cfb1c2708,2021-03-26T00:00:00.000Z,NEFT CR-DEUT0797BGL-FLIPKART INTERNET PR IVATE LIMITED-SLICK ORGANICS PVT LTD-032 600145GN00152,shopping,,net_banking_transfer,21932.11
61b701abd8beac1599eb3df7,50200023535069,912193.62,60ec41ba55c00300382672d9,HDFC,direct expenses,5eecc6d6449e4f7cfb1c2708,2021-03-26T00:00:00.000Z,POS 514834XXXXXX9486 FRESHWORKS INC,,,debit_card,-3638.6
61b701acd8beac1599eb3dfe,50200023535069,925068.32,60ec41ba55c00300382672d9,HDFC,Revenue-Mktplace,5eecc6d6449e4f7cfb1c2708,2021-03-26T00:00:00.000Z,NEFT CR-DEUT0797BGL-MYNTRA DESIGNS PRIVA TE LIMITED-SLICK ORGANICS PRIVATE LIMITE D-032600257GN00163,shopping,,net_banking_transfer,12874.7
61b701add8beac1599eb3e06,50200023535069,925038.28,60ec41ba55c00300382672d9,HDFC,bank charges,5eecc6d6449e4f7cfb1c2708,2021-03-26T00:00:00.000Z,.DC INTL POS TXN MARKUP+ST 160321 230321 -CDT2107003388014,,,international_transaction_arbitrage,-30.04
61b701aed8beac1599eb3e0d,50200023535069,924982.48,60ec41ba55c00300382672d9,HDFC,bank charges,5eecc6d6449e4f7cfb1c2708,2021-03-26T00:00:00.000Z,.DC INTL POS TXN MARKUP+ST 170321 230321 -CDT2107003388014,,,international_transaction_arbitrage,-55.8
61b701afd8beac1599eb3e13,50200023535069,924716.19,60ec41ba55c00300382672d9,HDFC,bank charges,5eecc6d6449e4f7cfb1c2708,2021-03-26T00:00:00.000Z,.DC INTL POS TXN MARKUP+ST 200321 230321 -CDT2107003388014,,,international_transaction_arbitrage,-266.29
61b701b0d8beac1599eb3e16,50200023535069,926990.21,60ec41ba55c00300382672d9,HDFC,Revenue-PG-non-split,5eecc6d6449e4f7cfb1c2708,2021-03-26T00:00:00.000Z,NEFT CR-IDFB0010204-SEZZLE PAYMENTS PRIV ATE LIMITED-SLICK ORGANICS PRIVATE LIMIT ED-IDFBH21085951632,investments,,net_banking_transfer,2274.02
61b701b1d8beac1599eb3e1b,50200023535069,927832.65,60ec41ba55c00300382672d9,HDFC,Revenue-Mktplace,5eecc6d6449e4f7cfb1c2708,2021-03-26T00:00:00.000Z,NEFT CR-ICIC0000105-MANASH LIFETYLE PVT LTD-SLICKORGANICSPRIVATELIMITEDMPGGN-ICI B210850034154,,,net_banking_transfer,842.44
61b701b2d8beac1599eb3e26,50200023535069,928595.72,60ec41ba55c00300382672d9,HDFC,Revenue-Mktplace,5eecc6d6449e4f7cfb1c2708,2021-03-26T00:00:00.000Z,NEFT CR-ICIC0000105-MANASH LIFETYLE PVT LTD-SLICKORGANICSPRIVATELIMITEDMPMUM-ICI B210850034155,,,net_banking_transfer,763.07
61b701b3d8beac1599eb3e2c,50200023535069,931998.31,60ec41ba55c00300382672d9,HDFC,Revenue-Mktplace,5eecc6d6449e4f7cfb1c2708,2021-03-26T00:00:00.000Z,NEFT CR-DEUT0797BGL-MYNTRA DESIGNS PRIVA TE LIMITED-SLICK ORGANICS PRIVATE LIMITE D-032600285GN00118,shopping,,net_banking_transfer,3402.59
61b701b4d8beac1599eb3e32,50200023535069,947705.56,60ec41ba55c00300382672d9,HDFC,Revenue-COD,5eecc6d6449e4f7cfb1c2708,2021-03-26T00:00:00.000Z,NEFT CR-KKBK0000958-BIGFOOT RETAIL SOLUT,,,net_banking_transfer,15707.25
61b701b5d8beac1599eb3e3b,50200023535069,858340.56,60ec41ba55c00300382672d9,HDFC,direct expenses,5eecc6d6449e4f7cfb1c2708,2021-03-26T00:00:00.000Z,00921000075586-TPT-89365-ROET BINDRA,,,net_banking_transfer,-89365
61b701b6d8beac1599eb3e42,50200023535069,879980.55,60ec41ba55c00300382672d9,HDFC,Transfer in/Revenue-other,5eecc6d6449e4f7cfb1c2708,2021-03-27T00:00:00.000Z,IMPS-108605054008-NA-HDFC-XXXXXXXXXX0007 -ALL20210327216820000330830668628,,,net_banking_transfer,21639.99
61b701b7d8beac1599eb3e48,50200023535069,679980.55,60ec41ba55c00300382672d9,HDFC,direct expenses,5eecc6d6449e4f7cfb1c2708,2021-03-27T00:00:00.000Z,57500000443889-TPT-ABC-WEBKLIPPER TECHNO LOGIES PRIVATE LIMITED,,,net_banking_transfer,-200000
61b701b8d8beac1599eb3e52,50200023535069,696940.36,60ec41ba55c00300382672d9,HDFC,Transfer in/Revenue-other,5eecc6d6449e4f7cfb1c2708,2021-03-28T00:00:00.000Z,IMPS-108705096388-NA-HDFC-XXXXXXXXXX0007 -ALL20210328216820000330830668628,,,net_banking_transfer,16959.81
61b701b9d8beac1599eb3e5b,50200023535069,720970.04,60ec41ba55c00300382672d9,HDFC,Transfer in/Revenue-other,5eecc6d6449e4f7cfb1c2708,2021-03-29T00:00:00.000Z,IMPS-108805976723-NA-HDFC-XXXXXXXXXX0007 -ALL20210329216820000330830668628,,,net_banking_transfer,24029.68
61b701bad8beac1599eb3e5f,50200023535069,742445.68,60ec41ba55c00300382672d9,HDFC,Revenue-Mktplace,5eecc6d6449e4f7cfb1c2708,2021-03-29T00:00:00.000Z,NEFT CR-DEUT0797BGL-FLIPKART INTERNET PR IVATE LIMITED-SLICK ORGANICS PVT LTD-032 900335GN00145,shopping,,net_banking_transfer,21475.64
61b701bbd8beac1599eb3e64,50200023535069,752727.91,60ec41ba55c00300382672d9,HDFC,Revenue-Mktplace,5eecc6d6449e4f7cfb1c2708,2021-03-29T00:00:00.000Z,NEFT CR-DEUT0797BGL-FLIPKART INTERNET PR IVATE LIMITED-SLICK ORGANICS PVT LTD-032 900322GN00074,shopping,,net_banking_transfer,10282.23
61b701bcd8beac1599eb3e6d,50200023535069,773582.38,60ec41ba55c00300382672d9,HDFC,Transfer in/Revenue-other,5eecc6d6449e4f7cfb1c2708,2021-03-30T00:00:00.000Z,IMPS-108905637941-NA-HDFC-XXXXXXXXXX0007 -ALL20210330216820000330830668628,,,net_banking_transfer,20854.47
61b701bdd8beac1599eb3e74,50200023535069,913397.96,60ec41ba55c00300382672d9,HDFC,Revenue-Mktplace,5eecc6d6449e4f7cfb1c2708,2021-03-30T00:00:00.000Z,IMPS-108911177518-AMAZON SELLER SERVIC-H DFC-XXXXXXXX6004-83OL4C08QBD0036TSLICK O RGANICS PVT LTD,shopping,,net_banking_transfer,139815.58
61b701bed8beac1599eb3e7a,50200023535069,1327796.54,60ec41ba55c00300382672d9,HDFC,Revenue-Mktplace,5eecc6d6449e4f7cfb1c2708,2021-03-30T00:00:00.000Z,NEFT CR-DEUT0797BGL-AMAZON PAY (INDIA) P RIVATE LIMITED-SLICK ORGANICS PVT LTD-03 3000504GN00118,shopping,,net_banking_transfer,414398.58
61b701bfd8beac1599eb3e83,50200023535069,1341857.6,60ec41ba55c00300382672d9,HDFC,Revenue-PG-non-split,5eecc6d6449e4f7cfb1c2708,2021-03-30T00:00:00.000Z,NEFT CR-IDFB0010204-SEZZLE PAYMENTS PRIV ATE LIMITED-SLICK ORGANICS PRIVATE LIMIT ED-IDFBH21089090359,investments,,net_banking_transfer,14061.06
61b701c0d8beac1599eb3e8b,50200023535069,1343185.93,60ec41ba55c00300382672d9,HDFC,Transfer in/Revenue-other,5eecc6d6449e4f7cfb1c2708,2021-03-30T00:00:00.000Z,NEFT CR-ICIC0SF0002-ICICI BANK NODAL ACC -SLICK ORGANICS-23889312411DC,investments,,net_banking_transfer,1328.33
61b701c1d8beac1599eb3e91,50200023535069,1421442.07,60ec41ba55c00300382672d9,HDFC,Revenue-COD,5eecc6d6449e4f7cfb1c2708,2021-03-30T00:00:00.000Z,NEFT CR-KKBK0000958-BIGFOOT RETAIL SOLUT,,,net_banking_transfer,78256.14
61b701c2d8beac1599eb3e99,50200023535069,1448360.67,60ec41ba55c00300382672d9,HDFC,Transfer in/Revenue-other,5eecc6d6449e4f7cfb1c2708,2021-03-31T00:00:00.000Z,IMPS-109005656528-NA-HDFC-XXXXXXXXXX0007 -ALL20210331216820000330830668628,,,net_banking_transfer,26918.6
61b701c2d8beac1599eb3ea5,50200023535069,1428360.67,60ec41ba55c00300382672d9,HDFC,direct expenses,5eecc6d6449e4f7cfb1c2708,2021-03-31T00:00:00.000Z,SARVAN KUMAR - CHQ PAID - DEVLI ROAD K,,,chq,-20000
61b701c3d8beac1599eb3ea8,50200023535069,1523360.67,60ec41ba55c00300382672d9,HDFC,Transfer in/Revenue-other,5eecc6d6449e4f7cfb1c2708,2021-03-31T00:00:00.000Z,NEFT CR-PYTM0000001-ARATA-SLICK ORGANICS PRIVATE LIMITED-PYTM210900349384,investments,,net_banking_transfer,95000
61b701c4d8beac1599eb3ead,50200023535069,1555093.67,60ec41ba55c00300382672d9,HDFC,Investments-New,5eecc6d6449e4f7cfb1c2708,2021-03-31T00:00:00.000Z,50200019889031-TPT-INV NO 143-1908 E-VEN TURES PRIVATE LIMITED,,,net_banking_transfer,31733
61b701c5d8beac1599eb3eb1,50200023535069,1596013.67,60ec41ba55c00300382672d9,HDFC,Transfer in/Revenue-other,5eecc6d6449e4f7cfb1c2708,2021-03-31T00:00:00.000Z,ACH C- AAYCS0313H-AY2020-21-CE2114665092,,,Other,40920
61b701c6d8beac1599eb3eba,50200023535069,1597818.13,60ec41ba55c00300382672d9,HDFC,Revenue-Mktplace,5eecc6d6449e4f7cfb1c2708,2021-03-31T00:00:00.000Z,NEFT CR-DEUT0784BBY-TATA UNISTORE LTD-NO DAL-SLICK ORGANICS PVT LTD-033101771GN00 271,investments,,net_banking_transfer,1804.46
61b701c7d8beac1599eb3ec2,50200023535069,1599965.23,60ec41ba55c00300382672d9,HDFC,Revenue-Mktplace,5eecc6d6449e4f7cfb1c2708,2021-03-31T00:00:00.000Z,NEFT CR-DEUT0784BBY-TATA UNISTORE LIMITE D-SLICK ORGANICS PVT LTD-033101765GN0019 1,investments,,net_banking_transfer,2147.1
61b701c8d8beac1599eb3ec7,50200023535069,1600858.33,60ec41ba55c00300382672d9,HDFC,Revenue-Mktplace,5eecc6d6449e4f7cfb1c2708,2021-03-31T00:00:00.000Z,NEFT CR-KKBK0000958-SUPERMARKET GROCERY SUPPLIES PVT LTD-SLICK ORGANICS PVT LTD- KKBK210903818907,shopping,,net_banking_transfer,893.1
61b701c9d8beac1599eb3ecf,50200023535069,1611424.62,60ec41ba55c00300382672d9,HDFC,Revenue-Mktplace,5eecc6d6449e4f7cfb1c2708,2021-03-31T00:00:00.000Z,NEFT CR-KKBK0000958-SUPERMARKET GROCERY SUPPLIES PVT LTD-SLICK ORGANICS PVT LTD- KKBK210903809308,shopping,,net_banking_transfer,10566.29
61b701cad8beac1599eb3ed5,50200023535069,1611922.3,60ec41ba55c00300382672d9,HDFC,Revenue-Mktplace,5eecc6d6449e4f7cfb1c2708,2021-03-31T00:00:00.000Z,NEFT CR-ICIC0000105-MANASH LIFETYLE PVT LTD-SLICKORGANICSPRIVATELIMITEDMPGGN-ICI B210900044505,,,net_banking_transfer,497.68
61b701cbd8beac1599eb3edb,50200023535069,1612127.41,60ec41ba55c00300382672d9,HDFC,Revenue-Mktplace,5eecc6d6449e4f7cfb1c2708,2021-03-31T00:00:00.000Z,NEFT CR-ICIC0000105-MANASH LIFETYLE PVT LTD-SLICKORGANICSPRIVATELIMITEDMPMUM-ICI B210900044507,,,net_banking_transfer,205.11
61b701ccd8beac1599eb3ee2,50200023535069,1620296.17,60ec41ba55c00300382672d9,HDFC,Revenue-PG-non-split,5eecc6d6449e4f7cfb1c2708,2021-03-31T00:00:00.000Z,NEFT CR-IDFB0010204-SEZZLE PAYMENTS PRIV,,,net_banking_transfer,8168.76
61b701cdd8beac1599eb3eea,50200023535069,1637019.98,60ec41ba55c00300382672d9,HDFC,Transfer in/Revenue-other,5eecc6d6449e4f7cfb1c2708,2021-04-01T00:00:00.000Z,IMPS-109105635746-NA-HDFC-XXXXXXXXXX0007 -ALL20210401216820000330830668628,,,net_banking_transfer,16723.81
61b701ced8beac1599eb3eee,50200023535069,1587019.98,60ec41ba55c00300382672d9,HDFC,Marketing Expense,5eecc6d6449e4f7cfb1c2708,2021-04-01T00:00:00.000Z,POS 514834XXXXXX9486 GOOGLE ADS,,,debit_card,-50000
61b701cfd8beac1599eb3ef3,50200023535069,1519519.98,60ec41ba55c00300382672d9,HDFC,direct expenses,5eecc6d6449e4f7cfb1c2708,2021-04-01T00:00:00.000Z,"NEFT DR-ANDB0002029-HITESH ARORA-NETBANK , MUM-N091211458903180-67500",,,net_banking_transfer,-67500
61b701d0d8beac1599eb3f00,50200023535069,1425519.98,60ec41ba55c00300382672d9,HDFC,direct expenses,5eecc6d6449e4f7cfb1c2708,2021-04-01T00:00:00.000Z,"NEFT DR-YESB0000551-VISTTA COSMETICS-NET BANK, MUM-N091211458904327-94000",,,net_banking_transfer,-94000
61b701d1d8beac1599eb3f07,50200023535069,1423395.35,60ec41ba55c00300382672d9,HDFC,direct expenses,5eecc6d6449e4f7cfb1c2708,2021-04-01T00:00:00.000Z,POS 514834XXXXXX9486 SEOPTIMER,,,debit_card,-2124.63
61b701d2d8beac1599eb3f0d,50200023535069,1243395.35,60ec41ba55c00300382672d9,HDFC,direct expenses,5eecc6d6449e4f7cfb1c2708,2021-04-01T00:00:00.000Z,"NEFT DR-SCBL0036025-DHRUV MADHOK-NETBANK , MUM-N091211459235119-180000",,,net_banking_transfer,-180000
61b701d3d8beac1599eb3f12,50200023535069,1043395.35,60ec41ba55c00300382672d9,HDFC,direct expenses,5eecc6d6449e4f7cfb1c2708,2021-04-01T00:00:00.000Z,02711930004579-TPT-200000-DHRUV BHASIN,,,net_banking_transfer,-200000
61b701d4d8beac1599eb3f19,50200023535069,1062596.14,60ec41ba55c00300382672d9,HDFC,Transfer in/Revenue-other,5eecc6d6449e4f7cfb1c2708,2021-04-02T00:00:00.000Z,IMPS-109205984430-NA-HDFC-XXXXXXXXXX0007 -ALL20210402216820000330830668628,,,net_banking_transfer,19200.79
61b701d5d8beac1599eb3f1d,50200023535069,1053290.04,60ec41ba55c00300382672d9,HDFC,Marketing Expense,5eecc6d6449e4f7cfb1c2708,2021-04-02T00:00:00.000Z,POS 514834XXXXXX9486 GOOGLE ADWORDS,,,debit_card,-9306.1
61b701d6d8beac1599eb3f25,50200023535069,1043851.22,60ec41ba55c00300382672d9,HDFC,direct expenses,5eecc6d6449e4f7cfb1c2708,2021-04-02T00:00:00.000Z,POS 514834XXXXXX4081 ONLINE PAYMENT,,,debit_card,-9438.82
61b701d7d8beac1599eb3f3a,50200023535069,1060822.9,60ec41ba55c00300382672d9,HDFC,Transfer in/Revenue-other,5eecc6d6449e4f7cfb1c2708,2021-04-03T00:00:00.000Z,IMPS-109305407086-NA-HDFC-XXXXXXXXXX0007 -ALL20210403216820000330830668628,,,net_banking_transfer,16971.68
61b701d8d8beac1599eb3f3f,50200023535069,1061009.63,60ec41ba55c00300382672d9,HDFC,Revenue-Mktplace,5eecc6d6449e4f7cfb1c2708,2021-04-03T00:00:00.000Z,NEFT CR-ICIC0000105-MANASH LIFETYLE PVT LTD-SLICKORGANICSPRIVATELIMITEDMPMUM-ICI B210930026144,,,net_banking_transfer,186.73
61b701d9d8beac1599eb3f4c,50200023535069,1062106.44,60ec41ba55c00300382672d9,HDFC,Revenue-Mktplace,5eecc6d6449e4f7cfb1c2708,2021-04-03T00:00:00.000Z,NEFT CR-ICIC0000105-MANASH LIFETYLE PVT LTD-SLICKORGANICSPRIVATELIMITEDMPGGN-ICI B210930026143,,,net_banking_transfer,1096.81
61b701d9d8beac1599eb3f53,50200023535069,1072131.56,60ec41ba55c00300382672d9,HDFC,Revenue-Mktplace,5eecc6d6449e4f7cfb1c2708,2021-04-03T00:00:00.000Z,NEFT CR-DEUT0797BGL-MYNTRA DESIGNS PRIVA TE LIMITED-SLICK ORGANICS PRIVATE LIMITE D-040300222GN00273,shopping,,net_banking_transfer,10025.12
61b701dad8beac1599eb3f5c,50200023535069,1091180.9,60ec41ba55c00300382672d9,HDFC,Revenue-Mktplace,5eecc6d6449e4f7cfb1c2708,2021-04-03T00:00:00.000Z,NEFT CR-DEUT0797BGL-MYNTRA DESIGNS PRIVA TE LIMITED-SLICK ORGANICS PRIVATE LIMITE D-040300227GN00028,shopping,,net_banking_transfer,19049.34
61b701dbd8beac1599eb3f77,50200023535069,1115018.76,60ec41ba55c00300382672d9,HDFC,Transfer in/Revenue-other,5eecc6d6449e4f7cfb1c2708,2021-04-04T00:00:00.000Z,IMPS-109405507567-NA-HDFC-XXXXXXXXXX0007,,,net_banking_transfer,23837.86
61b701dcd8beac1599eb3f82,50200023535069,1104190.78,60ec41ba55c00300382672d9,HDFC,direct expenses,5eecc6d6449e4f7cfb1c2708,2021-04-04T00:00:00.000Z,POS 514834XXXXXX9486 STK*SHUTTERSTOCK,,,debit_card,-10827.98
61b701ddd8beac1599eb3f97,50200023535069,1134885.75,60ec41ba55c00300382672d9,HDFC,Transfer in/Revenue-other,5eecc6d6449e4f7cfb1c2708,2021-04-05T00:00:00.000Z,IMPS-109506512161-NA-HDFC-XXXXXXXXXX0007 -ALL20210405216820000330830668628,,,net_banking_transfer,30694.97
61b701ded8beac1599eb3fa6,50200023535069,1112410.75,60ec41ba55c00300382672d9,HDFC,direct expenses,5eecc6d6449e4f7cfb1c2708,2021-04-05T00:00:00.000Z,"NEFT DR-YESB0000162-VINAY REDDY-NETBANK, MUM-N095211462470880-22475",,,net_banking_transfer,-22475
61b701dfd8beac1599eb3fb8,50200023535069,1130424.24,60ec41ba55c00300382672d9,HDFC,Revenue-Mktplace,5eecc6d6449e4f7cfb1c2708,2021-04-05T00:00:00.000Z,NEFT CR-DEUT0797BGL-FLIPKART INTERNET PR IVATE LIMITED-SLICK ORGANICS PVT LTD-040 500147GN00252,shopping,,net_banking_transfer,18013.49
61b701e0d8beac1599eb3fc4,50200023535069,1130921.29,60ec41ba55c00300382672d9,HDFC,Revenue-Mktplace,5eecc6d6449e4f7cfb1c2708,2021-04-05T00:00:00.000Z,NEFT CR-DEUT0797BGL-MYNTRA DESIGNS PRIVA TE LIMITED-SLICK ORGANICS PRIVATE LIMITE D-040500370GN00082,shopping,,net_banking_transfer,497.05
61b701e1d8beac1599eb3fd6,50200023535069,1131434.54,60ec41ba55c00300382672d9,HDFC,Revenue-Mktplace,5eecc6d6449e4f7cfb1c2708,2021-04-05T00:00:00.000Z,NEFT CR-DEUT0797BGL-MYNTRA DESIGNS PRIVA TE LIMITED-SLICK ORGANICS PRIVATE LIMITE D-040500392GN00190,shopping,,net_banking_transfer,513.25
61b701e2d8beac1599eb3fdf,50200023535069,1121434.54,60ec41ba55c00300382672d9,HDFC,direct expenses,5eecc6d6449e4f7cfb1c2708,2021-04-05T00:00:00.000Z,"NEFT DR-PYTM0123456-PAYTM-NETBANK, MUM-N 095211462777480-10000",ewallet,,net_banking_transfer,-10000
61b701e3d8beac1599eb3fe4,50200023535069,1122213.58,60ec41ba55c00300382672d9,HDFC,Transfer in/Revenue-other,5eecc6d6449e4f7cfb1c2708,2021-04-05T00:00:00.000Z,FT - C74895050421121108 - - 50200050045 240 - ZOOBOP ME WORKS PRIVATE LIMITED,,,Other,779.04
61b701e4d8beac1599eb3ff6,50200023535069,1127830.77,60ec41ba55c00300382672d9,HDFC,Revenue-PG-non-split,5eecc6d6449e4f7cfb1c2708,2021-04-05T00:00:00.000Z,NEFT CR-IDFB0010204-SEZZLE PAYMENTS PRIV ATE LIMITED-SLICK ORGANICS PRIVATE LIMIT ED-IDFBH21095426232,investments,,net_banking_transfer,5617.19
61b701e5d8beac1599eb3fff,50200023535069,1130535.09,60ec41ba55c00300382672d9,HDFC,Transfer in/Revenue-other,5eecc6d6449e4f7cfb1c2708,2021-04-05T00:00:00.000Z,ZOOBOP ME WORK-ARATA,,,Other,2704.32
61b701e6d8beac1599eb4007,50200023535069,1131396.68,60ec41ba55c00300382672d9,HDFC,Revenue-Mktplace,5eecc6d6449e4f7cfb1c2708,2021-04-05T00:00:00.000Z,NEFT CR-ICIC0000105-MANASH LIFETYLE PVT LTD-SLICKORGANICSPRIVATELIMITEDMPGGN-ICI B210950064377,,,net_banking_transfer,861.59
61b701e7d8beac1599eb4011,50200023535069,1212484.52,60ec41ba55c00300382672d9,HDFC,Revenue-COD,5eecc6d6449e4f7cfb1c2708,2021-04-05T00:00:00.000Z,NEFT CR-KKBK0000958-BIGFOOT RETAIL SOLUT IONS PRIVATE LIMITED-SLICK ORGANICS PVT LTD-KKBK210954696010,,,net_banking_transfer,81087.84
61b701e8d8beac1599eb401b,50200023535069,1280446.44,60ec41ba55c00300382672d9,HDFC,Revenue-COD,5eecc6d6449e4f7cfb1c2708,2021-04-05T00:00:00.000Z,NEFT CR-KKBK0000958-BIGFOOT RETAIL SOLUT,,,net_banking_transfer,67961.92
61b701e9d8beac1599eb4022,50200023535069,1280906.3,60ec41ba55c00300382672d9,HDFC,Revenue-PG-non-split,5eecc6d6449e4f7cfb1c2708,2021-04-05T00:00:00.000Z,NEFT CR-ICIC0000031-PAYTM E COMMERCE PVT LTD-SLICK ORGANICS PVT LTD-CMS189395181 4,investments,,net_banking_transfer,459.86
61b701ead8beac1599eb402c,50200023535069,1077650.88,60ec41ba55c00300382672d9,HDFC,direct expenses,5eecc6d6449e4f7cfb1c2708,2021-04-05T00:00:00.000Z,ADVANCE PAYMENT OF IMPORT BILL,bills,,Other,-203255.42
61b701ebd8beac1599eb4038,50200023535069,1100091.1,60ec41ba55c00300382672d9,HDFC,Transfer in/Revenue-other,5eecc6d6449e4f7cfb1c2708,2021-04-06T00:00:00.000Z,IMPS-109605727721-NA-HDFC-XXXXXXXXXX0007 -ALL20210406216820000330830668628,,,net_banking_transfer,22440.22
61b701ecd8beac1599eb403c,50200023535069,1003883.1,60ec41ba55c00300382672d9,HDFC,Marketing Expense,5eecc6d6449e4f7cfb1c2708,2021-04-06T00:00:00.000Z,"NEFT DR-CITI0000006-FACEBOOK INDIA ONLIN E SERVICES PVT LTD-NETBANK, MUM-N0962114 64269273-96208",,,net_banking_transfer,-96208
61b701edd8beac1599eb4044,50200023535069,-553235.9,60ec41ba55c00300382672d9,HDFC,Marketing Expense,5eecc6d6449e4f7cfb1c2708,2021-04-06T00:00:00.000Z,"NEFT DR-CITI0000006-FACEBOOK INDIA ONLIN E SERVICES PVT LTD-NETBANK, MUM-N0962114 64321003-1557119",,,net_banking_transfer,-1557119
61b701eed8beac1599eb404b,50200023535069,-474098.61,60ec41ba55c00300382672d9,HDFC,Revenue-Mktplace,5eecc6d6449e4f7cfb1c2708,2021-04-06T00:00:00.000Z,IMPS-109611377809-AMAZON SELLER SERVIC-H DFC-XXXXXXXX6004-2MQI8LM90WYMDEUFSLICK O RGANICS PVT LTD,shopping,,net_banking_transfer,79137.29
61b701efd8beac1599eb4056,50200023535069,-115407.24,60ec41ba55c00300382672d9,HDFC,Revenue-Mktplace,5eecc6d6449e4f7cfb1c2708,2021-04-06T00:00:00.000Z,NEFT CR-DEUT0797BGL-AMAZON PAY (INDIA) P RIVATE LIMITED-SLICK ORGANICS PVT LTD-04 0600137GN00273,shopping,,net_banking_transfer,358691.37
61b701f0d8beac1599eb4060,50200023535069,-119907.24,60ec41ba55c00300382672d9,HDFC,agency/vendor expense,5eecc6d6449e4f7cfb1c2708,2021-04-06T00:00:00.000Z,50200055013567-TPT-4500-NEO MEDIAWORKS,,,net_banking_transfer,-4500
61b701f1d8beac1599eb408f,50200023535069,-119429.13,60ec41ba55c00300382672d9,HDFC,Transfer in/Revenue-other,5eecc6d6449e4f7cfb1c2708,2021-04-06T00:00:00.000Z,NEFT CR-YESB0000001-ILUMINAR MEDIA-SLICK ORGANICS PVT. LTD-N096210558547079,,,net_banking_transfer,478.11
61b701f2d8beac1599eb4096,50200023535069,-118791.74,60ec41ba55c00300382672d9,HDFC,Revenue-Mktplace,5eecc6d6449e4f7cfb1c2708,2021-04-06T00:00:00.000Z,NEFT CR-ICIC0000105-MANASH LIFETYLE PVT LTD-SLICKORGANICSPRIVATELIMITEDMPGGN-ICI B210960091253,,,net_banking_transfer,637.39
61b701f3d8beac1599eb409c,50200023535069,-117098.72,60ec41ba55c00300382672d9,HDFC,Revenue-Mktplace,5eecc6d6449e4f7cfb1c2708,2021-04-06T00:00:00.000Z,NEFT CR-ICIC0000105-MANASH LIFETYLE PVT LTD-SLICKORGANICSPRIVATELIMITEDMPMUM-ICI B210960091256,,,net_banking_transfer,1693.02
61b701f3d8beac1599eb40a3,50200023535069,-101503.72,60ec41ba55c00300382672d9,HDFC,Revenue-Mktplace,5eecc6d6449e4f7cfb1c2708,2021-04-06T00:00:00.000Z,NEFT CR-RATN0000999-DREAMPLUG TECHNOLOGI ES PRIVATE LIMI-SLICK ORGANICS PRIVATE L IMITED-000169487380,,,net_banking_transfer,15595
61b701f4d8beac1599eb40b3,50200023535069,354448.28,60ec41ba55c00300382672d9,HDFC,Transfer in/Revenue-other,5eecc6d6449e4f7cfb1c2708,2021-04-06T00:00:00.000Z,00640330000510-SLICK ORGANICS PVT L,investments,,Other,455952
61b701f5d8beac1599eb40b7,50200023535069,351648.28,60ec41ba55c00300382672d9,HDFC,direct expenses,5eecc6d6449e4f7cfb1c2708,2021-04-06T00:00:00.000Z,POS 514834XXXXXX9486 E-COMMERCE RP,,,debit_card,-2800
61b701f6d8beac1599eb40d7,50200023535069,361087.1,60ec41ba55c00300382672d9,HDFC,Transfer in/Revenue-other,5eecc6d6449e4f7cfb1c2708,2021-04-06T00:00:00.000Z,POS 514834******4081 RVSL DT - 02/04/21,,,Other,9438.82
61b701f7d8beac1599eb40dc,50200023535069,385742.4,60ec41ba55c00300382672d9,HDFC,Transfer in/Revenue-other,5eecc6d6449e4f7cfb1c2708,2021-04-07T00:00:00.000Z,IMPS-109705755872-NA-HDFC-XXXXXXXXXX0007 -ALL20210407216820000330830668628,,,net_banking_transfer,24655.3
61b701f8d8beac1599eb40e7,50200023535069,307033.4,60ec41ba55c00300382672d9,HDFC,Salary/Emp/consultant Expense,5eecc6d6449e4f7cfb1c2708,2021-04-07T00:00:00.000Z,"NEFT DR-CITI0000002-DHIRAJ-NETBANK, MUM- N097211465669735-MARCH SALARY",,,net_banking_transfer,-78709
61b701f9d8beac1599eb40f1,50200023535069,213073.4,60ec41ba55c00300382672d9,HDFC,Salary/Emp/consultant Expense,5eecc6d6449e4f7cfb1c2708,2021-04-07T00:00:00.000Z,"NEFT DR-ICIC0000542-AVANTIKA SUKHIA-NETB ANK, MUM-N097211465669824-MARCH SALARY",,,net_banking_transfer,-93960
61b701fad8beac1599eb40f9,50200023535069,192073.4,60ec41ba55c00300382672d9,HDFC,Salary/Emp/consultant Expense,5eecc6d6449e4f7cfb1c2708,2021-04-07T00:00:00.000Z,"NEFT DR-SIBL0000555-JAIVEER KUMAR-NETBAN K, MUM-N097211465672105-MARCH SALARY",,,net_banking_transfer,-21000
61b701fbd8beac1599eb4100,50200023535069,177073.4,60ec41ba55c00300382672d9,HDFC,direct expenses,5eecc6d6449e4f7cfb1c2708,2021-04-07T00:00:00.000Z,"NEFT DR-PUNB0398000-MEENA SINGH-NETBANK, MUM-N097211465669911-15000",,,net_banking_transfer,-15000
61b701fcd8beac1599eb4103,50200023535069,142073.4,60ec41ba55c00300382672d9,HDFC,direct expenses,5eecc6d6449e4f7cfb1c2708,2021-04-07T00:00:00.000Z,"NEFT DR-ICIC0003374-SIDDHARTH KANOJIA-NE TBANK, MUM-N097211465681478-35000",,,net_banking_transfer,-35000
61b701fdd8beac1599eb410b,50200023535069,132073.4,60ec41ba55c00300382672d9,HDFC,Salary/Emp/consultant Expense,5eecc6d6449e4f7cfb1c2708,2021-04-07T00:00:00.000Z,"NEFT DR-ALLA0210591-CHAMPA DEVI-NETBANK, MUM-N097211465672567-MARCH SALARY",,,net_banking_transfer,-10000
61b701fed8beac1599eb4116,50200023535069,82073.4,60ec41ba55c00300382672d9,HDFC,Salary/Emp/consultant Expense,5eecc6d6449e4f7cfb1c2708,2021-04-07T00:00:00.000Z,"NEFT DR-UTIB0000120-ADNAN ALI-NETBANK, M UM-N097211465685425-MARCH SALARY",,,net_banking_transfer,-50000
61b701ffd8beac1599eb411d,50200023535069,32348.4,60ec41ba55c00300382672d9,HDFC,direct expenses,5eecc6d6449e4f7cfb1c2708,2021-04-07T00:00:00.000Z,"NEFT DR-SYNB0005170-SNEHAL TAYDE-NETBANK , MUM-N097211465685491-MARCH",,,net_banking_transfer,-49725
61b70200d8beac1599eb4121,50200023535069,14348.4,60ec41ba55c00300382672d9,HDFC,Salary/Emp/consultant Expense,5eecc6d6449e4f7cfb1c2708,2021-04-07T00:00:00.000Z,"NEFT DR-PUNB0482100-RAM BHAVAN YADAV-NET BANK, MUM-N097211465672761-MARCH SALARY",,,net_banking_transfer,-18000
61b70201d8beac1599eb4126,50200023535069,-5651.6,60ec41ba55c00300382672d9,HDFC,Salary/Emp/consultant Expense,5eecc6d6449e4f7cfb1c2708,2021-04-07T00:00:00.000Z,"NEFT DR-PUNB0307800-PRAKASH JHA-NETBANK, MUM-N097211465685704-MARCH SALARY",,,net_banking_transfer,-20000
61b70202d8beac1599eb412f,50200023535069,-41651.6,60ec41ba55c00300382672d9,HDFC,direct expenses,5eecc6d6449e4f7cfb1c2708,2021-04-07T00:00:00.000Z,00901610080520-TPT-36000-POOJA KAPIL SHR OTRIYA,,,net_banking_transfer,-36000
61b70203d8beac1599eb4135,50200023535069,-141651.6,60ec41ba55c00300382672d9,HDFC,direct expenses,5eecc6d6449e4f7cfb1c2708,2021-04-07T00:00:00.000Z,02771610131904-TPT-MARCH-DIGANT BHATT,,,net_banking_transfer,-100000
61b70204d8beac1599eb413d,50200023535069,-180809.6,60ec41ba55c00300382672d9,HDFC,Salary/Emp/consultant Expense,5eecc6d6449e4f7cfb1c2708,2021-04-07T00:00:00.000Z,50100330586095-TPT-MARCH SALARY-DIWAKAR UNIYAL,,,net_banking_transfer,-39158
61b70205d8beac1599eb4143,50200023535069,-250809.6,60ec41ba55c00300382672d9,HDFC,direct expenses,5eecc6d6449e4f7cfb1c2708,2021-04-07T00:00:00.000Z,50100301160692-TPT-MARCH-TARUN GARG,,,net_banking_transfer,-70000
61b70206d8beac1599eb414a,50200023535069,-289309.6,60ec41ba55c00300382672d9,HDFC,direct expenses,5eecc6d6449e4f7cfb1c2708,2021-04-07T00:00:00.000Z,50100293329616-TPT-38500-SADIYA BANO,,,net_banking_transfer,-38500
61b70207d8beac1599eb414f,50200023535069,-324309.6,60ec41ba55c00300382672d9,HDFC,direct expenses,5eecc6d6449e4f7cfb1c2708,2021-04-07T00:00:00.000Z,50100064106714-TPT-35000-AKSHARANSH BHAT,,,net_banking_transfer,-35000
61b70208d8beac1599eb4156,50200023535069,-416809.6,60ec41ba55c00300382672d9,HDFC,direct expenses,5eecc6d6449e4f7cfb1c2708,2021-04-07T00:00:00.000Z,"NEFT DR-BARB0VJMATU-ARTISTO DESIGNZ-NETB ANK, MUM-N097211465686865-MARCH",,,net_banking_transfer,-92500
61b70209d8beac1599eb4161,50200023535069,-431809.6,60ec41ba55c00300382672d9,HDFC,direct expenses,5eecc6d6449e4f7cfb1c2708,2021-04-07T00:00:00.000Z,"NEFT DR-BARB0DBKHAN-ARUNT RANSPORT-NETBA NK, MUM-N097211465674013-15000",travel,,net_banking_transfer,-15000
61b7020ad8beac1599eb4179,50200023535069,-455809.6,60ec41ba55c00300382672d9,HDFC,direct expenses,5eecc6d6449e4f7cfb1c2708,2021-04-07T00:00:00.000Z,"NEFT DR-YESB0000551-VISTTA COSMETICS-NET BANK, MUM-N097211465684727-24000",,,net_banking_transfer,-24000
61b7020bd8beac1599eb417f,50200023535069,-495849.6,60ec41ba55c00300382672d9,HDFC,direct expenses,5eecc6d6449e4f7cfb1c2708,2021-04-07T00:00:00.000Z,"NEFT DR-KKBK0000173-MATRIX PRINTING SOLU TIONS PRIVATE LIMITE-NETBANK, MUM-N09721 1465695549-40040",,,net_banking_transfer,-40040
61b7020cd8beac1599eb4186,50200023535069,-655224.6,60ec41ba55c00300382672d9,HDFC,direct expenses,5eecc6d6449e4f7cfb1c2708,2021-04-07T00:00:00.000Z,"NEFT DR-PUNB0092200-AKANKSHA GUPTA-NETBA NK, MUM-N097211465689134-159375",,,net_banking_transfer,-159375
61b7020dd8beac1599eb418e,50200023535069,-710474.6,60ec41ba55c00300382672d9,HDFC,direct expenses,5eecc6d6449e4f7cfb1c2708,2021-04-07T00:00:00.000Z,"NEFT DR-KKBK0000173-ONE STOP ADVERTISING -NETBANK, MUM-N097211466231706-55250",,,net_banking_transfer,-55250
61b7020ed8beac1599eb419a,50200023535069,-716474.6,60ec41ba55c00300382672d9,HDFC,direct expenses,5eecc6d6449e4f7cfb1c2708,2021-04-07T00:00:00.000Z,POS 514834XXXXXX9486 PAYU MONEY,,,debit_card,-6000
61b7020ed8beac1599eb41a1,50200023535069,-711270,60ec41ba55c00300382672d9,HDFC,Revenue-PG-non-split,5eecc6d6449e4f7cfb1c2708,2021-04-07T00:00:00.000Z,NEFT CR-IDFB0010204-SEZZLE PAYMENTS PRIV ATE LIMITED-SLICK ORGANICS PRIVATE LIMIT ED-IDFBH21097555414,investments,,net_banking_transfer,5204.6
61b7020fd8beac1599eb41a8,50200023535069,-710480.47,60ec41ba55c00300382672d9,HDFC,Revenue-Mktplace,5eecc6d6449e4f7cfb1c2708,2021-04-07T00:00:00.000Z,NEFT CR-ICIC0000105-MANASH LIFETYLE PVT LTD-SLICKORGANICSPRIVATELIMITEDMPMUM-ICI B210970118060,,,net_banking_transfer,789.53
61b70210d8beac1599eb41ae,50200023535069,-666195.27,60ec41ba55c00300382672d9,HDFC,Revenue-COD,5eecc6d6449e4f7cfb1c2708,2021-04-07T00:00:00.000Z,NEFT CR-KKBK0000958-BIGFOOT RETAIL SOLUT IONS PRIVATE LIMITED-SLICK ORGANICS PVT LTD-KKBK210975357119,,,net_banking_transfer,44285.2
61b70211d8beac1599eb41b4,50200023535069,-666183.54,60ec41ba55c00300382672d9,HDFC,Transfer in/Revenue-other,5eecc6d6449e4f7cfb1c2708,2021-04-08T00:00:00.000Z,INT. ON SWCR ON-50300498262188,,,Other,11.73
61b70212d8beac1599eb41be,50200023535069,-660531.54,60ec41ba55c00300382672d9,HDFC,Loan-in,5eecc6d6449e4f7cfb1c2708,2021-04-08T00:00:00.000Z,SWEEP-IN CREDIT - 50300498262188,,,self_transfer,5652
61b70213d8beac1599eb41c3,50200023535069,-660459.02,60ec41ba55c00300382672d9,HDFC,Transfer in/Revenue-other,5eecc6d6449e4f7cfb1c2708,2021-04-08T00:00:00.000Z,INT. ON SWCR ON-50300498262188,,,Other,72.52
61b70214d8beac1599eb41c7,50200023535069,-624459.02,60ec41ba55c00300382672d9,HDFC,Loan-in,5eecc6d6449e4f7cfb1c2708,2021-04-08T00:00:00.000Z,SWEEP-IN CREDIT - 50300498262188,,,self_transfer,36000
61b70215d8beac1599eb41da,50200023535069,-624258.23,60ec41ba55c00300382672d9,HDFC,Transfer in/Revenue-other,5eecc6d6449e4f7cfb1c2708,2021-04-08T00:00:00.000Z,INT. ON SWCR ON-50300498262188,,,Other,200.79
61b70216d8beac1599eb41f3,50200023535069,-524258.23,60ec41ba55c00300382672d9,HDFC,Loan-in,5eecc6d6449e4f7cfb1c2708,2021-04-08T00:00:00.000Z,SWEEP-IN CREDIT - 50300498262188,,,self_transfer,100000
61b70217d8beac1599eb41f7,50200023535069,-524179.98,60ec41ba55c00300382672d9,HDFC,Transfer in/Revenue-other,5eecc6d6449e4f7cfb1c2708,2021-04-08T00:00:00.000Z,INT. ON SWCR ON-50300498262188,,,Other,78.25
61b70218d8beac1599eb41fd,50200023535069,-485021.98,60ec41ba55c00300382672d9,HDFC,Loan-in,5eecc6d6449e4f7cfb1c2708,2021-04-08T00:00:00.000Z,SWEEP-IN CREDIT - 50300498262188,,,self_transfer,39158
61b70219d8beac1599eb420b,50200023535069,-484881.13,60ec41ba55c00300382672d9,HDFC,Transfer in/Revenue-other,5eecc6d6449e4f7cfb1c2708,2021-04-08T00:00:00.000Z,INT. ON SWCR ON-50300498262188,,,Other,140.85
61b7021ad8beac1599eb4210,50200023535069,-414881.13,60ec41ba55c00300382672d9,HDFC,Loan-in,5eecc6d6449e4f7cfb1c2708,2021-04-08T00:00:00.000Z,SWEEP-IN CREDIT - 50300498262188,,,self_transfer,70000
61b7021bd8beac1599eb4218,50200023535069,-414803.61,60ec41ba55c00300382672d9,HDFC,Transfer in/Revenue-other,5eecc6d6449e4f7cfb1c2708,2021-04-08T00:00:00.000Z,INT. ON SWCR ON-50300498262188,,,Other,77.52
61b7021cd8beac1599eb4220,50200023535069,-376303.61,60ec41ba55c00300382672d9,HDFC,Loan-in,5eecc6d6449e4f7cfb1c2708,2021-04-08T00:00:00.000Z,SWEEP-IN CREDIT - 50300498262188,,,self_transfer,38500
61b7021dd8beac1599eb4228,50200023535069,-376233.68,60ec41ba55c00300382672d9,HDFC,Transfer in/Revenue-other,5eecc6d6449e4f7cfb1c2708,2021-04-08T00:00:00.000Z,INT. ON SWCR ON-50300498262188,,,Other,69.93
61b7021ed8beac1599eb422d,50200023535069,-341233.68,60ec41ba55c00300382672d9,HDFC,Loan-in,5eecc6d6449e4f7cfb1c2708,2021-04-08T00:00:00.000Z,SWEEP-IN CREDIT - 50300498262188,,,self_transfer,35000
61b7021fd8beac1599eb4231,50200023535069,-341047.88,60ec41ba55c00300382672d9,HDFC,Transfer in/Revenue-other,5eecc6d6449e4f7cfb1c2708,2021-04-08T00:00:00.000Z,INT. ON SWCR ON-50300498262188,,,Other,185.8
61b70220d8beac1599eb4238,50200023535069,-248547.88,60ec41ba55c00300382672d9,HDFC,Loan-in,5eecc6d6449e4f7cfb1c2708,2021-04-08T00:00:00.000Z,SWEEP-IN CREDIT - 50300498262188,,,self_transfer,92500
61b70221d8beac1599eb4248,50200023535069,-248517.91,60ec41ba55c00300382672d9,HDFC,Transfer in/Revenue-other,5eecc6d6449e4f7cfb1c2708,2021-04-08T00:00:00.000Z,INT. ON SWCR ON-50300498262188,,,Other,29.97
61b70222d8beac1599eb424f,50200023535069,-233517.91,60ec41ba55c00300382672d9,HDFC,Loan-in,5eecc6d6449e4f7cfb1c2708,2021-04-08T00:00:00.000Z,SWEEP-IN CREDIT - 50300498262188,,,self_transfer,15000
61b70223d8beac1599eb4257,50200023535069,-233469.56,60ec41ba55c00300382672d9,HDFC,Transfer in/Revenue-other,5eecc6d6449e4f7cfb1c2708,2021-04-08T00:00:00.000Z,INT. ON SWCR ON-50300498262188,,,Other,48.35
61b70224d8beac1599eb425e,50200023535069,-209469.56,60ec41ba55c00300382672d9,HDFC,Loan-in,5eecc6d6449e4f7cfb1c2708,2021-04-08T00:00:00.000Z,SWEEP-IN CREDIT - 50300498262188,,,self_transfer,24000
61b70225d8beac1599eb4271,50200023535069,-209388.66,60ec41ba55c00300382672d9,HDFC,Transfer in/Revenue-other,5eecc6d6449e4f7cfb1c2708,2021-04-08T00:00:00.000Z,INT. ON SWCR ON-50300498262188,,,Other,80.9
61b70226d8beac1599eb4279,50200023535069,-169348.66,60ec41ba55c00300382672d9,HDFC,Loan-in,5eecc6d6449e4f7cfb1c2708,2021-04-08T00:00:00.000Z,SWEEP-IN CREDIT - 50300498262188,,,self_transfer,40040
61b70227d8beac1599eb4283,50200023535069,-169028.75,60ec41ba55c00300382672d9,HDFC,Transfer in/Revenue-other,5eecc6d6449e4f7cfb1c2708,2021-04-08T00:00:00.000Z,INT. ON SWCR ON-50300498262188,,,Other,319.91
61b70227d8beac1599eb4286,50200023535069,-9653.75,60ec41ba55c00300382672d9,HDFC,Loan-in,5eecc6d6449e4f7cfb1c2708,2021-04-08T00:00:00.000Z,SWEEP-IN CREDIT - 50300498262188,,,self_transfer,159375
61b70228d8beac1599eb428c,50200023535069,-9642.16,60ec41ba55c00300382672d9,HDFC,Transfer in/Revenue-other,5eecc6d6449e4f7cfb1c2708,2021-04-08T00:00:00.000Z,INT. ON SWCR ON-50300498262188,,,Other,11.59
61b70229d8beac1599eb4290,50200023535069,-3642.16,60ec41ba55c00300382672d9,HDFC,Loan-in,5eecc6d6449e4f7cfb1c2708,2021-04-08T00:00:00.000Z,SWEEP-IN CREDIT - 50300498262188,,,self_transfer,6000
61b7022ad8beac1599eb429e,50200023535069,-3634.62,60ec41ba55c00300382672d9,HDFC,Transfer in/Revenue-other,5eecc6d6449e4f7cfb1c2708,2021-04-08T00:00:00.000Z,INT. ON SWCR ON-50300498262188,,,Other,7.54
61b7022bd8beac1599eb42a5,50200023535069,8.38,60ec41ba55c00300382672d9,HDFC,Loan-in,5eecc6d6449e4f7cfb1c2708,2021-04-08T00:00:00.000Z,SWEEP-IN CREDIT - 50300498262188,,,self_transfer,3643
61b7022cd8beac1599eb42ab,50200023535069,23721.17,60ec41ba55c00300382672d9,HDFC,Transfer in/Revenue-other,5eecc6d6449e4f7cfb1c2708,2021-04-08T00:00:00.000Z,IMPS-109805787445-NA-HDFC-XXXXXXXXXX0007 -ALL20210408216820000330830668628,,,net_banking_transfer,23712.79
61b7022dd8beac1599eb42b2,50200023535069,-4028.83,60ec41ba55c00300382672d9,HDFC,direct expenses,5eecc6d6449e4f7cfb1c2708,2021-04-08T00:00:00.000Z,"NEFT DR-KKBK0000654-NIHARIKA MISHRA-NETB ANK, MUM-N098211467687790-27750",,,net_banking_transfer,-27750
61b7022ed8beac1599eb42b9,50200023535069,-54028.83,60ec41ba55c00300382672d9,HDFC,Marketing Expense,5eecc6d6449e4f7cfb1c2708,2021-04-08T00:00:00.000Z,POS 514834XXXXXX9486 GOOGLE ADS,,,debit_card,-50000
61b7022fd8beac1599eb42c0,50200023535069,-48405.74,60ec41ba55c00300382672d9,HDFC,Revenue-PG-non-split,5eecc6d6449e4f7cfb1c2708,2021-04-08T00:00:00.000Z,NEFT CR-IDFB0010204-SEZZLE PAYMENTS PRIV ATE LIMITED-SLICK ORGANICS PRIVATE LIMIT ED-IDFBH21098627069,investments,,net_banking_transfer,5623.09
61b70230d8beac1599eb42ca,50200023535069,-379905.74,60ec41ba55c00300382672d9,HDFC,SAAS/tech expense,5eecc6d6449e4f7cfb1c2708,2021-04-08T00:00:00.000Z,"NEFT DR-DEUT0797BGL-AMAZON SELLER SERVIC ES PVT LTD-NETBANK, MUM-N098211468297356 -331500",shopping,,net_banking_transfer,-331500
61b70231d8beac1599eb42ef,50200023535069,-379200.33,60ec41ba55c00300382672d9,HDFC,Revenue-Mktplace,5eecc6d6449e4f7cfb1c2708,2021-04-08T00:00:00.000Z,NEFT CR-DEUT0797BGL-FLIPKART INTERNET PR,shopping,,net_banking_transfer,705.41
61b70232d8beac1599eb42f3,50200023535069,-377358.04,60ec41ba55c00300382672d9,HDFC,Revenue-Mktplace,5eecc6d6449e4f7cfb1c2708,2021-04-08T00:00:00.000Z,NEFT CR-DEUT0797BGL-MYNTRA DESIGNS PRIVA TE LIMITED-SLICK ORGANICS PRIVATE LIMITE D-040700307GN00287,shopping,,net_banking_transfer,1842.29
61b70233d8beac1599eb42f8,50200023535069,-386796.86,60ec41ba55c00300382672d9,HDFC,direct expenses,5eecc6d6449e4f7cfb1c2708,2021-04-08T00:00:00.000Z,POS 514834******4081 DT-02/04/21,,,debit_card,-9438.82
61b70234d8beac1599eb4302,50200023535069,-382534.15,60ec41ba55c00300382672d9,HDFC,Revenue-Mktplace,5eecc6d6449e4f7cfb1c2708,2021-04-08T00:00:00.000Z,NEFT CR-DEUT0797BGL-MYNTRA DESIGNS PRIVA TE LIMITED-SLICK ORGANICS PRIVATE LIMITE D-040700339GN00057,shopping,,net_banking_transfer,4262.71
61b70235d8beac1599eb4307,50200023535069,-382431.26,60ec41ba55c00300382672d9,HDFC,Transfer in/Revenue-other,5eecc6d6449e4f7cfb1c2708,2021-04-09T00:00:00.000Z,INT. ON SWCR ON-50300498262188,,,Other,102.89
61b70236d8beac1599eb430f,50200023535069,-332431.26,60ec41ba55c00300382672d9,HDFC,Loan-in,5eecc6d6449e4f7cfb1c2708,2021-04-09T00:00:00.000Z,SWEEP-IN CREDIT - 50300498262188,,,self_transfer,50000
61b70237d8beac1599eb4319,50200023535069,-332422.88,60ec41ba55c00300382672d9,HDFC,Transfer in/Revenue-other,5eecc6d6449e4f7cfb1c2708,2021-04-09T00:00:00.000Z,INT. ON SWCR ON-50300498262188,,,Other,8.38
61b70238d8beac1599eb4321,50200023535069,-328393.88,60ec41ba55c00300382672d9,HDFC,Loan-in,5eecc6d6449e4f7cfb1c2708,2021-04-09T00:00:00.000Z,SWEEP-IN CREDIT - 50300498262188,,,self_transfer,4029
61b70239d8beac1599eb4328,50200023535069,-327720.92,60ec41ba55c00300382672d9,HDFC,Transfer in/Revenue-other,5eecc6d6449e4f7cfb1c2708,2021-04-09T00:00:00.000Z,INT. ON SWCR ON-50300498262188,,,Other,672.96
61b7023ad8beac1599eb4331,50200023535069,-1843.92,60ec41ba55c00300382672d9,HDFC,Loan-in,5eecc6d6449e4f7cfb1c2708,2021-04-09T00:00:00.000Z,SWEEP-IN CREDIT - 50300498262188,,,self_transfer,325877
61b7023bd8beac1599eb4339,50200023535069,-1839.66,60ec41ba55c00300382672d9,HDFC,Transfer in/Revenue-other,5eecc6d6449e4f7cfb1c2708,2021-04-09T00:00:00.000Z,INT. ON SWCR ON-50300498262188,,,Other,4.26
61b7023cd8beac1599eb433c,50200023535069,4.34,60ec41ba55c00300382672d9,HDFC,Loan-in,5eecc6d6449e4f7cfb1c2708,2021-04-09T00:00:00.000Z,SWEEP-IN CREDIT - 50300498262188,,,self_transfer,1844
61b7023dd8beac1599eb4340,50200023535069,16445.29,60ec41ba55c00300382672d9,HDFC,Transfer in/Revenue-other,5eecc6d6449e4f7cfb1c2708,2021-04-09T00:00:00.000Z,IMPS-109906886975-NA-HDFC-XXXXXXXXXX0007 -ALL20210409216820000330830668628,,,net_banking_transfer,16440.95
61b7023ed8beac1599eb4346,50200023535069,23061.84,60ec41ba55c00300382672d9,HDFC,Revenue-Mktplace,5eecc6d6449e4f7cfb1c2708,2021-04-09T00:00:00.000Z,NEFT CR-DEUT0797BGL-MYNTRA DESIGNS PRIVA TE LIMITED-SLICK ORGANICS PRIVATE LIMITE D-040900072GN00176,shopping,,net_banking_transfer,6616.55
61b7023fd8beac1599eb434b,50200023535069,-26938.16,60ec41ba55c00300382672d9,HDFC,direct expenses,5eecc6d6449e4f7cfb1c2708,2021-04-09T00:00:00.000Z,"NEFT DR-PYTM0123456-PAYTM-NETBANK, MUM-N 099211469495793-50000",ewallet,,net_banking_transfer,-50000
61b70240d8beac1599eb4352,50200023535069,198061.84,60ec41ba55c00300382672d9,HDFC,Internal Transfers,5eecc6d6449e4f7cfb1c2708,2021-04-09T00:00:00.000Z,IB FUNDS TRANSFER CR-50200035187206 -SL ICK ORGANICS PVT LTD,investments,,Other,225000
61b70241d8beac1599eb4358,50200023535069,-201938.16,60ec41ba55c00300382672d9,HDFC,direct expenses,5eecc6d6449e4f7cfb1c2708,2021-04-09T00:00:00.000Z,"NEFT DR-KKBK0000180-VEDIC COSMECEUTICALS PVT LTD-NETBANK, MUM-N099211469566051-4 00000",,,net_banking_transfer,-400000
61b70242d8beac1599eb435f,50200023535069,-217549.16,60ec41ba55c00300382672d9,HDFC,Salary/Emp/consultant Expense,5eecc6d6449e4f7cfb1c2708,2021-04-09T00:00:00.000Z,"NEFT DR-UTIB0003142-ARIA DESAI UG ELIZAB ETH THOMAS ALEX-NETBANK, MUM-N0992114698 24404-15611",,,net_banking_transfer,-15611
61b70243d8beac1599eb4365,50200023535069,-208236.27,60ec41ba55c00300382672d9,HDFC,Revenue-Mktplace,5eecc6d6449e4f7cfb1c2708,2021-04-09T00:00:00.000Z,NEFT CR-DEUT0797BGL-FLIPKART INTERNET PR,shopping,,net_banking_transfer,9312.89
61b70244d8beac1599eb436c,50200023535069,-206761.82,60ec41ba55c00300382672d9,HDFC,Revenue-Mktplace,5eecc6d6449e4f7cfb1c2708,2021-04-09T00:00:00.000Z,NEFT CR-DEUT0797BGL-MYNTRA DESIGNS PRIVA TE LIMITED-SLICK ORGANICS PRIVATE LIMITE D-040900085GN00045,shopping,,net_banking_transfer,1474.45
61b70245d8beac1599eb4376,50200023535069,-188699.05,60ec41ba55c00300382672d9,HDFC,Revenue-COD,5eecc6d6449e4f7cfb1c2708,2021-04-09T00:00:00.000Z,NEFT CR-KKBK0000958-BIGFOOT RETAIL SOLUT IONS PRIVATE LIMITED-SLICK ORGANICS PVT LTD-KKBK210995892594,,,net_banking_transfer,18062.77
61b70246d8beac1599eb437b,50200023535069,-116491.53,60ec41ba55c00300382672d9,HDFC,Transfer in/Revenue-other,5eecc6d6449e4f7cfb1c2708,2021-04-09T00:00:00.000Z,NEFT CR-UTIB0000114-MILA STAR RETAIL PRI VATE LTD-SLICK ORGANICS PVT LTD-AXISP001 92988809,,,net_banking_transfer,72207.52
61b70247d8beac1599eb437f,50200023535069,-116355.69,60ec41ba55c00300382672d9,HDFC,Revenue-Mktplace,5eecc6d6449e4f7cfb1c2708,2021-04-09T00:00:00.000Z,NEFT CR-DEUT0784BBY-TATA UNISTORE LIMITE D-SLICK ORGANICS PVT LTD-040901503GN0026 2,investments,,net_banking_transfer,135.84
61b70248d8beac1599eb4386,50200023535069,-115581.5,60ec41ba55c00300382672d9,HDFC,Revenue-Mktplace,5eecc6d6449e4f7cfb1c2708,2021-04-09T00:00:00.000Z,NEFT CR-DEUT0784BBY-TATA UNISTORE LTD-NO DAL-SLICK ORGANICS PVT LTD-040901509GN00 385,investments,,net_banking_transfer,774.19
61b70249d8beac1599eb438e,50200023535069,-113634.57,60ec41ba55c00300382672d9,HDFC,Revenue-PG-non-split,5eecc6d6449e4f7cfb1c2708,2021-04-09T00:00:00.000Z,NEFT CR-IDFB0010204-SEZZLE PAYMENTS PRIV ATE LIMITED-SLICK ORGANICS PRIVATE LIMIT ED-IDFBH21099724685,investments,,net_banking_transfer,1946.93
61b70249d8beac1599eb4394,50200023535069,-109493.05,60ec41ba55c00300382672d9,HDFC,Revenue-Mktplace,5eecc6d6449e4f7cfb1c2708,2021-04-09T00:00:00.000Z,NEFT CR-DEUT0797BGL-FLIPKART INTERNET PR IVATE LIMITED-SLICK ORGANICS PVT LTD-040 700154GN00287,shopping,,net_banking_transfer,4141.52
61b7024ad8beac1599eb439a,50200023535069,-104825.8,60ec41ba55c00300382672d9,HDFC,Revenue-PG-non-split,5eecc6d6449e4f7cfb1c2708,2021-04-09T00:00:00.000Z,NEFT CR-IDFB0010204-SEZZLE PAYMENTS PRIV ATE LIMITED-SLICK ORGANICS PRIVATE LIMIT ED-IDFBH21099752911,investments,,net_banking_transfer,4667.25
61b7024bd8beac1599eb43a2,50200023535069,-104768.63,60ec41ba55c00300382672d9,HDFC,Transfer in/Revenue-other,5eecc6d6449e4f7cfb1c2708,2021-04-10T00:00:00.000Z,INT. ON SWCR ON-50300498262188,,,Other,57.17
61b7024cd8beac1599eb43a8,50200023535069,-77829.63,60ec41ba55c00300382672d9,HDFC,Loan-in,5eecc6d6449e4f7cfb1c2708,2021-04-10T00:00:00.000Z,SWEEP-IN CREDIT - 50300498262188,,,self_transfer,26939
61b7024dd8beac1599eb43b0,50200023535069,-77664.93,60ec41ba55c00300382672d9,HDFC,Transfer in/Revenue-other,5eecc6d6449e4f7cfb1c2708,2021-04-10T00:00:00.000Z,INT. ON SWCR ON-50300498262188,,,Other,164.7
61b7024ed8beac1599eb43b8,50200023535069,165.07,60ec41ba55c00300382672d9,HDFC,Loan-in,5eecc6d6449e4f7cfb1c2708,2021-04-10T00:00:00.000Z,SWEEP-IN CREDIT - 50300498262188,,,self_transfer,77830
61b7024fd8beac1599eb43bc,50200023535069,86747.85,60ec41ba55c00300382672d9,HDFC,Transfer in/Revenue-other,5eecc6d6449e4f7cfb1c2708,2021-04-10T00:00:00.000Z,IMPS-110005972103-NA-HDFC-XXXXXXXXXX0007,,,net_banking_transfer,86582.78
61b70250d8beac1599eb43c2,50200023535069,-13252.15,60ec41ba55c00300382672d9,HDFC,direct expenses,5eecc6d6449e4f7cfb1c2708,2021-04-10T00:00:00.000Z,"NEFT DR-YESB0000162-VINAY REDDY-NETBANK, MUM-N100211471212626-100000",,,net_banking_transfer,-100000
61b70251d8beac1599eb43c6,50200023535069,-23252.15,60ec41ba55c00300382672d9,HDFC,direct expenses,5eecc6d6449e4f7cfb1c2708,2021-04-10T00:00:00.000Z,IMPS-110014159626-PAYTM-PYTM-XXXXXXXX383 9-10000,ewallet,,net_banking_transfer,-10000
61b70252d8beac1599eb43d1,50200023535069,-23223.48,60ec41ba55c00300382672d9,HDFC,Transfer in/Revenue-other,5eecc6d6449e4f7cfb1c2708,2021-04-11T00:00:00.000Z,INT. ON SWCR ON-50300498262188,,,Other,28.67
61b70253d8beac1599eb43d8,50200023535069,-9970.48,60ec41ba55c00300382672d9,HDFC,Loan-in,5eecc6d6449e4f7cfb1c2708,2021-04-11T00:00:00.000Z,SWEEP-IN CREDIT - 50300498262188,,,self_transfer,13253
61b70254d8beac1599eb43e6,50200023535069,-9948.49,60ec41ba55c00300382672d9,HDFC,Transfer in/Revenue-other,5eecc6d6449e4f7cfb1c2708,2021-04-11T00:00:00.000Z,INT. ON SWCR ON-50300498262188,,,Other,21.99
61b70255d8beac1599eb43ef,50200023535069,22.51,60ec41ba55c00300382672d9,HDFC,Loan-in,5eecc6d6449e4f7cfb1c2708,2021-04-11T00:00:00.000Z,SWEEP-IN CREDIT - 50300498262188,,,self_transfer,9971
61b70256d8beac1599eb4405,50200023535069,23175.56,60ec41ba55c00300382672d9,HDFC,Transfer in/Revenue-other,5eecc6d6449e4f7cfb1c2708,2021-04-11T00:00:00.000Z,IMPS-110105893860-NA-HDFC-XXXXXXXXXX0007 -ALL20210411216820000330830668628,,,net_banking_transfer,23153.05
61b70257d8beac1599eb4419,50200023535069,38618.4,60ec41ba55c00300382672d9,HDFC,Transfer in/Revenue-other,5eecc6d6449e4f7cfb1c2708,2021-04-12T00:00:00.000Z,IMPS-110205793655-NA-HDFC-XXXXXXXXXX0007 -ALL20210412216820000330830668628,,,net_banking_transfer,15442.84
61b70258d8beac1599eb4428,50200023535069,50053.89,60ec41ba55c00300382672d9,HDFC,Revenue-Mktplace,5eecc6d6449e4f7cfb1c2708,2021-04-12T00:00:00.000Z,NEFT CR-DEUT0797BGL-FLIPKART INTERNET PR IVATE LIMITED-SLICK ORGANICS PVT LTD-041 200141GN00191,shopping,,net_banking_transfer,11435.49
61b70259d8beac1599eb4438,50200023535069,54571.34,60ec41ba55c00300382672d9,HDFC,Revenue-Mktplace,5eecc6d6449e4f7cfb1c2708,2021-04-12T00:00:00.000Z,NEFT CR-DEUT0797BGL-MYNTRA DESIGNS PRIVA TE LIMITED-SLICK ORGANICS PRIVATE LIMITE D-041200329GN00176,shopping,,net_banking_transfer,4517.45
61b7025ad8beac1599eb443e,50200023535069,-45428.66,60ec41ba55c00300382672d9,HDFC,Marketing Expense,5eecc6d6449e4f7cfb1c2708,2021-04-12T00:00:00.000Z,POS 514834XXXXXX9486 GOOGLE ADS,,,debit_card,-100000
61b7025bd8beac1599eb4445,50200023535069,-63128.66,60ec41ba55c00300382672d9,HDFC,direct expenses,5eecc6d6449e4f7cfb1c2708,2021-04-12T00:00:00.000Z,"NEFT DR-KKBK0000187-APPLIED LIFE PRIVATE LIMITED-NETBANK, MUM-N102211472079906-1 7700",,,net_banking_transfer,-17700
61b7025cd8beac1599eb4458,50200023535069,-57774.91,60ec41ba55c00300382672d9,HDFC,Revenue-Mktplace,5eecc6d6449e4f7cfb1c2708,2021-04-12T00:00:00.000Z,NEFT CR-DEUT0797BGL-FLIPKART INTERNET PR IVATE LIMITED-SLICK ORGANICS PVT LTD-040 900393GN00280,shopping,,net_banking_transfer,5353.75
61b7025dd8beac1599eb4460,50200023535069,-50183.31,60ec41ba55c00300382672d9,HDFC,Revenue-Mktplace,5eecc6d6449e4f7cfb1c2708,2021-04-12T00:00:00.000Z,NEFT CR-DEUT0797BGL-FLIPKART INTERNET PR IVATE LIMITED-SLICK ORGANICS PVT LTD-041 200081GN00256,shopping,,net_banking_transfer,7591.6
61b7025ed8beac1599eb446b,50200023535069,-48442.02,60ec41ba55c00300382672d9,HDFC,Revenue-PG-non-split,5eecc6d6449e4f7cfb1c2708,2021-04-12T00:00:00.000Z,NEFT CR-IDFB0010204-SEZZLE PAYMENTS PRIV ATE LIMITED-SLICK ORGANICS PRIVATE LIMIT ED-IDFBH21102858903,investments,,net_banking_transfer,1741.29
61b7025fd8beac1599eb4474,50200023535069,-47156.18,60ec41ba55c00300382672d9,HDFC,Revenue-Mktplace,5eecc6d6449e4f7cfb1c2708,2021-04-12T00:00:00.000Z,NEFT CR-DEUT0797BGL-MYNTRA DESIGNS PRIVA,shopping,,net_banking_transfer,1285.84
61b70260d8beac1599eb447d,50200023535069,-45287.46,60ec41ba55c00300382672d9,HDFC,Revenue-Mktplace,5eecc6d6449e4f7cfb1c2708,2021-04-12T00:00:00.000Z,NEFT CR-ICIC0000105-MANASH LIFETYLE PVT LTD-SLICKORGANICSPRIVATELIMITEDMPMUM-ICI B211020058952,,,net_banking_transfer,1868.72
61b70261d8beac1599eb4485,50200023535069,-44826.24,60ec41ba55c00300382672d9,HDFC,Transfer in/Revenue-other,5eecc6d6449e4f7cfb1c2708,2021-04-12T00:00:00.000Z,4060000209-12 04 2021-HDFAZCUR1,,,Other,461.22
61b70262d8beac1599eb448d,50200023535069,-48492.99,60ec41ba55c00300382672d9,HDFC,direct expenses,5eecc6d6449e4f7cfb1c2708,2021-04-12T00:00:00.000Z,POS 514834XXXXXX9486 WWW.FAQPRIME.COM,,,debit_card,-3666.75
61b70262d8beac1599eb4498,50200023535069,-9662.53,60ec41ba55c00300382672d9,HDFC,Revenue-COD,5eecc6d6449e4f7cfb1c2708,2021-04-12T00:00:00.000Z,NEFT CR-KKBK0000958-BIGFOOT RETAIL SOLUT IONS PRIVATE LIMITED-SLICK ORGANICS PVT LTD-KKBK211026445557,,,net_banking_transfer,38830.46
61b70263d8beac1599eb44a1,50200023535069,-9640.42,60ec41ba55c00300382672d9,HDFC,Transfer in/Revenue-other,5eecc6d6449e4f7cfb1c2708,2021-04-13T00:00:00.000Z,INT. ON SWCR ON-50300498262188,,,Other,22.11
61b70264d8beac1599eb44a7,50200023535069,22.58,60ec41ba55c00300382672d9,HDFC,Loan-in,5eecc6d6449e4f7cfb1c2708,2021-04-13T00:00:00.000Z,SWEEP-IN CREDIT - 50300498262188,,,self_transfer,9663
61b70265d8beac1599eb44b0,50200023535069,22645.53,60ec41ba55c00300382672d9,HDFC,Transfer in/Revenue-other,5eecc6d6449e4f7cfb1c2708,2021-04-13T00:00:00.000Z,IMPS-110305160954-NA-HDFC-XXXXXXXXXX0007 -ALL20210413216820000330830668628,,,net_banking_transfer,22622.95
61b70266d8beac1599eb44bd,50200023535069,-57354.47,60ec41ba55c00300382672d9,HDFC,direct expenses,5eecc6d6449e4f7cfb1c2708,2021-04-13T00:00:00.000Z,"NEFT DR-CITI0000027-RISHIEKA JAINI-NETBA NK, MUM-N103211473355307-80000",,,net_banking_transfer,-80000
61b70267d8beac1599eb44c5,50200023535069,-257354.47,60ec41ba55c00300382672d9,HDFC,direct expenses,5eecc6d6449e4f7cfb1c2708,2021-04-13T00:00:00.000Z,"NEFT DR-PUNB0642000-UFLEX LIMITED-NETBAN K, MUM-N103211473544512-200000",loans,lender_transaction,net_banking_transfer,-200000
61b70268d8beac1599eb44cd,50200023535069,-279063.47,60ec41ba55c00300382672d9,HDFC,direct expenses,5eecc6d6449e4f7cfb1c2708,2021-04-13T00:00:00.000Z,50200021241300-TPT-21709-AFFLE INDIA LIM ITED,,,net_banking_transfer,-21709
61b70269d8beac1599eb44db,50200023535069,-300510.47,60ec41ba55c00300382672d9,HDFC,direct expenses,5eecc6d6449e4f7cfb1c2708,2021-04-13T00:00:00.000Z,"NEFT DR-CITI0000002-OMG NETWORK INDIA PR IVATE LIMITED-NETBANK, MUM-N103211473554 961-21447",,,net_banking_transfer,-21447
61b7026ad8beac1599eb44f5,50200023535069,-147314.28,60ec41ba55c00300382672d9,HDFC,Revenue-Mktplace,5eecc6d6449e4f7cfb1c2708,2021-04-13T00:00:00.000Z,IMPS-110311162088-AMAZON SELLER SERVIC-H DFC-XXXXXXXX6004-6K95EN2OC4SM7GAGSLICK O RGANICS PVT LTD,shopping,,net_banking_transfer,153196.19
61b7026bd8beac1599eb44fe,50200023535069,473536.31,60ec41ba55c00300382672d9,HDFC,Revenue-Mktplace,5eecc6d6449e4f7cfb1c2708,2021-04-13T00:00:00.000Z,NEFT CR-DEUT0797BGL-AMAZON PAY (INDIA) P RIVATE LIMITED-SLICK ORGANICS PVT LTD-04 1300119GN00419,shopping,,net_banking_transfer,620850.59
61b7026cd8beac1599eb4513,50200023535069,478968.97,60ec41ba55c00300382672d9,HDFC,Revenue-PG-non-split,5eecc6d6449e4f7cfb1c2708,2021-04-14T00:00:00.000Z,UPI-PAYTM-PAYOUTS@PAYTM-PYTM0123456-1104 78786016-ALL202104142168200,ewallet,,upi,5432.66
61b7026dd8beac1599eb4519,50200023535069,481732.08,60ec41ba55c00300382672d9,HDFC,Revenue-Mktplace,5eecc6d6449e4f7cfb1c2708,2021-04-14T00:00:00.000Z,NEFT CR-DEUT0797BGL-FLIPKART INTERNET PR,shopping,,net_banking_transfer,2763.11
61b7026ed8beac1599eb451c,50200023535069,485212.87,60ec41ba55c00300382672d9,HDFC,Revenue-Mktplace,5eecc6d6449e4f7cfb1c2708,2021-04-14T00:00:00.000Z,NEFT CR-DEUT0797BGL-FLIPKART INTERNET PR IVATE LIMITED-SLICK ORGANICS PVT LTD-041 400138GN00171,shopping,,net_banking_transfer,3480.79
61b7026fd8beac1599eb452f,50200023535069,490961.8,60ec41ba55c00300382672d9,HDFC,Revenue-Mktplace,5eecc6d6449e4f7cfb1c2708,2021-04-14T00:00:00.000Z,4060000174-TIMES INTERNET LIMITED NODAL,,,Other,5748.93
61b70270d8beac1599eb453a,50200023535069,515087.38,60ec41ba55c00300382672d9,HDFC,Revenue-COD,5eecc6d6449e4f7cfb1c2708,2021-04-14T00:00:00.000Z,NEFT CR-KKBK0000958-BIGFOOT RETAIL SOLUT IONS PRIVATE LIMITED-SLICK ORGANICS PVT LTD-KKBK211046877226,,,net_banking_transfer,24125.58
61b70271d8beac1599eb4543,50200023535069,517245.04,60ec41ba55c00300382672d9,HDFC,Revenue-Mktplace,5eecc6d6449e4f7cfb1c2708,2021-04-14T00:00:00.000Z,NEFT CR-DEUT0797BGL-MYNTRA DESIGNS PRIVA TE LIMITED-SLICK ORGANICS PRIVATE LIMITE D-041400320GN00103,shopping,,net_banking_transfer,2157.66
61b70272d8beac1599eb4550,50200023535069,529472,60ec41ba55c00300382672d9,HDFC,Transfer in/Revenue-other,5eecc6d6449e4f7cfb1c2708,2021-04-15T00:00:00.000Z,IMPS-110505440098-NA-HDFC-XXXXXXXXXX0007 -ALL20210415216820000330830668628,,,net_banking_transfer,12226.96
61b70273d8beac1599eb4556,50200023535069,396722,60ec41ba55c00300382672d9,HDFC,direct expenses,5eecc6d6449e4f7cfb1c2708,2021-04-15T00:00:00.000Z,CHQ PAID-MICR CTS-NO-TATA AIG GENERAL IN,,,chq,-132750
61b70274d8beac1599eb455d,50200023535069,236722,60ec41ba55c00300382672d9,HDFC,direct expenses,5eecc6d6449e4f7cfb1c2708,2021-04-15T00:00:00.000Z,IMPS-110510146021-PAYTM-PYTM-XXXXXXXX383 9-160000,ewallet,,net_banking_transfer,-160000
61b70275d8beac1599eb4562,50200023535069,236634.26,60ec41ba55c00300382672d9,HDFC,bank charges,5eecc6d6449e4f7cfb1c2708,2021-04-15T00:00:00.000Z,.DC INTL POS TXN MARKUP+ST 010421 020421 -CDT2110003809166,,,international_transaction_arbitrage,-87.74
61b70276d8beac1599eb456b,50200023535069,59834.26,60ec41ba55c00300382672d9,HDFC,direct expenses,5eecc6d6449e4f7cfb1c2708,2021-04-15T00:00:00.000Z,"NEFT DR-SCBL0036031-PR PUNDIT PUBLIC REL ATIONS PRIVATE LIMIT-NETBANK, MUM-N10521 1475594034-176800",investments,,net_banking_transfer,-176800
61b70277d8beac1599eb4575,50200023535069,59387.06,60ec41ba55c00300382672d9,HDFC,bank charges,5eecc6d6449e4f7cfb1c2708,2021-04-15T00:00:00.000Z,.DC INTL POS TXN MARKUP+ST 040421 060421 -CDT2110003809166,,,international_transaction_arbitrage,-447.2
61b70278d8beac1599eb457d,50200023535069,-171612.94,60ec41ba55c00300382672d9,HDFC,direct expenses,5eecc6d6449e4f7cfb1c2708,2021-04-15T00:00:00.000Z,"NEFT DR-YESB0000551-VISTTA COSMETICS-NET BANK, MUM-N105211475668934-231000",,,net_banking_transfer,-231000
61b70279d8beac1599eb4580,50200023535069,-171402.69,60ec41ba55c00300382672d9,HDFC,Revenue-Mktplace,5eecc6d6449e4f7cfb1c2708,2021-04-15T00:00:00.000Z,NEFT CR-ICIC0000105-MANASH LIFETYLE PVT LTD-SLICKORGANICSPRIVATELIMITEDMPGGN-ICI B211050032634,,,net_banking_transfer,210.25
61b7027ad8beac1599eb4586,50200023535069,-169756.74,60ec41ba55c00300382672d9,HDFC,Revenue-Mktplace,5eecc6d6449e4f7cfb1c2708,2021-04-15T00:00:00.000Z,NEFT CR-ICIC0000105-MANASH LIFETYLE PVT,,,net_banking_transfer,1645.95
61b7027bd8beac1599eb458c,50200023535069,-154131.61,60ec41ba55c00300382672d9,HDFC,Revenue-PG-non-split,5eecc6d6449e4f7cfb1c2708,2021-04-15T00:00:00.000Z,NEFT CR-IDFB0010204-SEZZLE PAYMENTS PRIV ATE LIMITED-SLICK ORGANICS PRIVATE LIMIT ED-IDFBH21105016711,investments,,net_banking_transfer,15625.13
61b7027cd8beac1599eb4590,50200023535069,-148766.61,60ec41ba55c00300382672d9,HDFC,Revenue-Mktplace,5eecc6d6449e4f7cfb1c2708,2021-04-15T00:00:00.000Z,NEFT CR-KKBK0000958-SURFBOATS SOLUTIONS PVT LTD-SLICK ORGANICS PRIVATE LIMITED-K KBK211057200667,investments,,net_banking_transfer,5365
61b7027dd8beac1599eb4597,50200023535069,-148249.28,60ec41ba55c00300382672d9,HDFC,Revenue-PG-non-split,5eecc6d6449e4f7cfb1c2708,2021-04-15T00:00:00.000Z,NEFT CR-ICIC0000031-PAYTM E COMMERCE PVT LTD-SLICK ORGANICS PVT LTD-CMS190967148 3,investments,,net_banking_transfer,517.33
61b7027ed8beac1599eb459c,50200023535069,-259249.28,60ec41ba55c00300382672d9,HDFC,direct expenses,5eecc6d6449e4f7cfb1c2708,2021-04-15T00:00:00.000Z,IMPS-110519382725-UFLEX LIMITED-PUNB-XXX XXXXXXX1854-ADVANCE,loans,lender_transaction,net_banking_transfer,-111000
61b7027fd8beac1599eb45a3,50200023535069,-258829.29,60ec41ba55c00300382672d9,HDFC,Transfer in/Revenue-other,5eecc6d6449e4f7cfb1c2708,2021-04-16T00:00:00.000Z,INT. ON SWCR ON-50300498262188,,,Other,419.99
61b70280d8beac1599eb45a8,50200023535069,-87216.29,60ec41ba55c00300382672d9,HDFC,Loan-in,5eecc6d6449e4f7cfb1c2708,2021-04-16T00:00:00.000Z,SWEEP-IN CREDIT - 50300498262188,,,self_transfer,171613
61b70280d8beac1599eb45af,50200023535069,-87002.36,60ec41ba55c00300382672d9,HDFC,Transfer in/Revenue-other,5eecc6d6449e4f7cfb1c2708,2021-04-16T00:00:00.000Z,INT. ON SWCR ON-50300498262188,,,Other,213.93
61b70281d8beac1599eb45b3,50200023535069,214.64,60ec41ba55c00300382672d9,HDFC,Loan-in,5eecc6d6449e4f7cfb1c2708,2021-04-16T00:00:00.000Z,SWEEP-IN CREDIT - 50300498262188,,,self_transfer,87217
61b70282d8beac1599eb45b6,50200023535069,19149.12,60ec41ba55c00300382672d9,HDFC,Transfer in/Revenue-other,5eecc6d6449e4f7cfb1c2708,2021-04-16T00:00:00.000Z,IMPS-110605622016-NA-HDFC-XXXXXXXXXX0007 -ALL20210416216820000330830668628,,,net_banking_transfer,18934.48
61b70283d8beac1599eb45ba,50200023535069,25272.23,60ec41ba55c00300382672d9,HDFC,Revenue-Mktplace,5eecc6d6449e4f7cfb1c2708,2021-04-16T00:00:00.000Z,NEFT CR-DEUT0797BGL-FLIPKART INTERNET PR IVATE LIMITED-SLICK ORGANICS PVT LTD-041 600245GN00168,shopping,,net_banking_transfer,6123.11
61b70284d8beac1599eb45c5,50200023535069,32225.85,60ec41ba55c00300382672d9,HDFC,Revenue-Mktplace,5eecc6d6449e4f7cfb1c2708,2021-04-16T00:00:00.000Z,NEFT CR-DEUT0797BGL-FLIPKART INTERNET PR IVATE LIMITED-SLICK ORGANICS PVT LTD-041 600318GN00005,shopping,,net_banking_transfer,6953.62
61b70285d8beac1599eb45cb,50200023535069,36056.03,60ec41ba55c00300382672d9,HDFC,Revenue-Mktplace,5eecc6d6449e4f7cfb1c2708,2021-04-16T00:00:00.000Z,NEFT CR-DEUT0797BGL-MYNTRA DESIGNS PRIVA TE LIMITED-SLICK ORGANICS PRIVATE LIMITE D-041600500GN00196,shopping,,net_banking_transfer,3830.18
61b70286d8beac1599eb45d0,50200023535069,38302.71,60ec41ba55c00300382672d9,HDFC,Revenue-Mktplace,5eecc6d6449e4f7cfb1c2708,2021-04-16T00:00:00.000Z,NEFT CR-DEUT0797BGL-MYNTRA DESIGNS PRIVA TE LIMITED-SLICK ORGANICS PRIVATE LIMITE D-041600499GN00285,shopping,,net_banking_transfer,2246.68
61b70287d8beac1599eb45d5,50200023535069,34203.71,60ec41ba55c00300382672d9,HDFC,SAAS/tech expense,5eecc6d6449e4f7cfb1c2708,2021-04-16T00:00:00.000Z,POS 514834XXXXXX9486 AMAZON,shopping,,debit_card,-4099
61b70288d8beac1599eb45da,50200023535069,34010.12,60ec41ba55c00300382672d9,HDFC,direct expenses,5eecc6d6449e4f7cfb1c2708,2021-04-16T00:00:00.000Z,NEFT DR-PUNB0642000-UFLEX LIMITED-NETBAN,loans,lender_transaction,net_banking_transfer,-193.59
61b70289d8beac1599eb45e0,50200023535069,-297489.88,60ec41ba55c00300382672d9,HDFC,SAAS/tech expense,5eecc6d6449e4f7cfb1c2708,2021-04-16T00:00:00.000Z,"NEFT DR-DEUT0797BGL-AMAZON SELLER SERVIC ES PVT LTD-NETBANK, MUM-N106211476761777 -331500",shopping,,net_banking_transfer,-331500
61b7028ad8beac1599eb45e5,50200023535069,-296553.81,60ec41ba55c00300382672d9,HDFC,Transfer in/Revenue-other,5eecc6d6449e4f7cfb1c2708,2021-04-16T00:00:00.000Z,NEFT CR-YESB0000001-ILUMINAR MEDIA-SLICK ORGANICS-N106210567926885,,,net_banking_transfer,936.07
61b7028bd8beac1599eb45ec,50200023535069,-248814.26,60ec41ba55c00300382672d9,HDFC,Revenue-COD,5eecc6d6449e4f7cfb1c2708,2021-04-16T00:00:00.000Z,NEFT CR-KKBK0000958-BIGFOOT RETAIL SOLUT IONS PRIVATE LIMITED-SLICK ORGANICS PVT LTD-KKBK211067479685,,,net_banking_transfer,47739.55
61b7028cd8beac1599eb45ee,50200023535069,-247665.27,60ec41ba55c00300382672d9,HDFC,Revenue-Mktplace,5eecc6d6449e4f7cfb1c2708,2021-04-16T00:00:00.000Z,NEFT CR-ICIC0000105-MANASH LIFETYLE PVT LTD-SLICKORGANICSPRIVATELIMITEDMPGGN-ICI B211060078885,,,net_banking_transfer,1148.99
61b7028dd8beac1599eb45f2,50200023535069,-242021.77,60ec41ba55c00300382672d9,HDFC,Revenue-Mktplace,5eecc6d6449e4f7cfb1c2708,2021-04-16T00:00:00.000Z,NEFT CR-ICIC0000105-MANASH LIFETYLE PVT LTD-SLICKORGANICSPRIVATELIMITEDMPMUM-ICI B211060078886,,,net_banking_transfer,5643.5
61b7028ed8beac1599eb45f9,50200023535069,-229206.77,60ec41ba55c00300382672d9,HDFC,Revenue-Mktplace,5eecc6d6449e4f7cfb1c2708,2021-04-16T00:00:00.000Z,NEFT CR-RATN0000999-DREAMPLUG TECHNOLOGI ES PRIVATE LIMI-SLICK ORGANICS PRIVATE L IMITED-000171346035,,,net_banking_transfer,12815
61b7028fd8beac1599eb45ff,50200023535069,-223547.33,60ec41ba55c00300382672d9,HDFC,Revenue-PG-non-split,5eecc6d6449e4f7cfb1c2708,2021-04-16T00:00:00.000Z,NEFT CR-IDFB0010204-SEZZLE PAYMENTS PRIV ATE LIMITED-SLICK ORGANICS PRIVATE LIMIT ED-IDFBH21106096265,investments,,net_banking_transfer,5659.44
61b70290d8beac1599eb4603,50200023535069,-223168.76,60ec41ba55c00300382672d9,HDFC,Revenue-Mktplace,5eecc6d6449e4f7cfb1c2708,2021-04-16T00:00:00.000Z,NEFT CR-DEUT0784BBY-TATA UNISTORE LIMITE D-SLICK ORGANICS PVT LTD-041601907GN0021 6,investments,,net_banking_transfer,378.57
61b70291d8beac1599eb4609,50200023535069,-221631.95,60ec41ba55c00300382672d9,HDFC,Revenue-Mktplace,5eecc6d6449e4f7cfb1c2708,2021-04-16T00:00:00.000Z,NEFT CR-DEUT0784BBY-TATA UNISTORE LTD-NO DAL-SLICK ORGANICS PVT LTD-041601910GN00 315,investments,,net_banking_transfer,1536.81
61b70292d8beac1599eb460e,50200023535069,-212164.03,60ec41ba55c00300382672d9,HDFC,Revenue-Mktplace,5eecc6d6449e4f7cfb1c2708,2021-04-16T00:00:00.000Z,NEFT CR-KKBK0000958-SUPERMARKET GROCERY SUPPLIES PVT LTD-SLICK ORGANICS PVT LTD- KKBK211067527393,shopping,,net_banking_transfer,9467.92
61b70293d8beac1599eb4614,50200023535069,-211725.28,60ec41ba55c00300382672d9,HDFC,Revenue-Mktplace,5eecc6d6449e4f7cfb1c2708,2021-04-16T00:00:00.000Z,NEFT CR-KKBK0000958-SUPERMARKET GROCERY,shopping,,net_banking_transfer,438.75
61b70294d8beac1599eb461a,50200023535069,-391725.28,60ec41ba55c00300382672d9,HDFC,direct expenses,5eecc6d6449e4f7cfb1c2708,2021-04-16T00:00:00.000Z,02771610131904-TPT-180000-DIGANT BHATT,,,net_banking_transfer,-180000
61b70295d8beac1599eb4622,50200023535069,-391166.73,60ec41ba55c00300382672d9,HDFC,Transfer in/Revenue-other,5eecc6d6449e4f7cfb1c2708,2021-04-16T00:00:00.000Z,NEFT CR-YESB0000001-ILLUMINAR MEDIA-SLIC K ORGANICS PVT LTD-N106210568112968,,,net_banking_transfer,558.55
61b70296d8beac1599eb4625,50200023535069,-591166.73,60ec41ba55c00300382672d9,HDFC,direct expenses,5eecc6d6449e4f7cfb1c2708,2021-04-16T00:00:00.000Z,"NEFT DR-KKBK0000180-VEDIC COSMECEUTICALS PVT LTD-NETBANK, MUM-N106211477627186-2 00000",,,net_banking_transfer,-200000
61b70297d8beac1599eb4629,50200023535069,-791166.73,60ec41ba55c00300382672d9,HDFC,direct expenses,5eecc6d6449e4f7cfb1c2708,2021-04-16T00:00:00.000Z,IMPS-110619161419-VEDIC COSMECEUTICALS P VT LTD-KKBK-XXXXXX1039-200000,,,net_banking_transfer,-200000
61b70297d8beac1599eb462c,50200023535069,-791915.23,60ec41ba55c00300382672d9,HDFC,direct expenses,5eecc6d6449e4f7cfb1c2708,2021-04-16T00:00:00.000Z,POS 514834XXXXXX9486 MANYCHAT COM PRO,,,debit_card,-748.5
61b70298d8beac1599eb4635,50200023535069,-791170.86,60ec41ba55c00300382672d9,HDFC,Transfer in/Revenue-other,5eecc6d6449e4f7cfb1c2708,2021-04-17T00:00:00.000Z,INT. ON SWCR ON-50300498262188,,,Other,744.37
61b70299d8beac1599eb4639,50200023535069,-493680.86,60ec41ba55c00300382672d9,HDFC,Loan-in,5eecc6d6449e4f7cfb1c2708,2021-04-17T00:00:00.000Z,SWEEP-IN CREDIT - 50300498262188,,,self_transfer,297490
61b7029ad8beac1599eb463f,50200023535069,-493679.16,60ec41ba55c00300382672d9,HDFC,Transfer in/Revenue-other,5eecc6d6449e4f7cfb1c2708,2021-04-17T00:00:00.000Z,INT. ON SWCR ON-50300498262188,,,Other,1.7
61b7029bd8beac1599eb4644,50200023535069,-492930.16,60ec41ba55c00300382672d9,HDFC,Loan-in,5eecc6d6449e4f7cfb1c2708,2021-04-17T00:00:00.000Z,SWEEP-IN CREDIT - 50300498262188,,,self_transfer,749
61b7029cd8beac1599eb466a,50200023535069,-492694.05,60ec41ba55c00300382672d9,HDFC,Transfer in/Revenue-other,5eecc6d6449e4f7cfb1c2708,2021-04-17T00:00:00.000Z,INT. ON SWCR ON-50300498262188,,,Other,236.11
61b7029dd8beac1599eb4670,50200023535069,-398458.05,60ec41ba55c00300382672d9,HDFC,Loan-in,5eecc6d6449e4f7cfb1c2708,2021-04-17T00:00:00.000Z,SWEEP-IN CREDIT - 50300498262188,,,self_transfer,94236
61b7029ed8beac1599eb4676,50200023535069,-397959.25,60ec41ba55c00300382672d9,HDFC,Transfer in/Revenue-other,5eecc6d6449e4f7cfb1c2708,2021-04-17T00:00:00.000Z,INT. ON SWCR ON-50300498262188,,,Other,498.8
61b7029fd8beac1599eb467e,50200023535069,-198517.25,60ec41ba55c00300382672d9,HDFC,Loan-in,5eecc6d6449e4f7cfb1c2708,2021-04-17T00:00:00.000Z,SWEEP-IN CREDIT - 50300498262188,,,self_transfer,199442
61b702a0d8beac1599eb4680,50200023535069,-198020.08,60ec41ba55c00300382672d9,HDFC,Transfer in/Revenue-other,5eecc6d6449e4f7cfb1c2708,2021-04-17T00:00:00.000Z,INT. ON SWCR ON-50300498262188,,,Other,497.17
61b702a1d8beac1599eb468a,50200023535069,497.92,60ec41ba55c00300382672d9,HDFC,Loan-in,5eecc6d6449e4f7cfb1c2708,2021-04-17T00:00:00.000Z,SWEEP-IN CREDIT - 50300498262188,,,self_transfer,198518
61b702a2d8beac1599eb4691,50200023535069,36661.77,60ec41ba55c00300382672d9,HDFC,Transfer in/Revenue-other,5eecc6d6449e4f7cfb1c2708,2021-04-17T00:00:00.000Z,IMPS-110705666500-NA-HDFC-XXXXXXXXXX0007 -ALL20210417216820000330830668628,,,net_banking_transfer,36163.85
61b702a3d8beac1599eb4699,50200023535069,56309.97,60ec41ba55c00300382672d9,HDFC,Transfer in/Revenue-other,5eecc6d6449e4f7cfb1c2708,2021-04-18T00:00:00.000Z,IMPS-110805574430-NA-HDFC-XXXXXXXXXX0007 -ALL20210418216820000330830668628,,,net_banking_transfer,19648.2
61b702a4d8beac1599eb469e,50200023535069,56312.39,60ec41ba55c00300382672d9,HDFC,Adjustments/Reversal,5eecc6d6449e4f7cfb1c2708,2021-04-18T00:00:00.000Z,DEBIT CARD PUR ADJ DT 16/04/21,,,Other,2.42
61b702a5d8beac1599eb46a4,50200023535069,110252.8,60ec41ba55c00300382672d9,HDFC,Transfer in/Revenue-other,5eecc6d6449e4f7cfb1c2708,2021-04-19T00:00:00.000Z,IMPS-110905351770-NA-HDFC-XXXXXXXXXX0007 -ALL20210419216820000330830668628,,,net_banking_transfer,53940.41
61b702a6d8beac1599eb46ac,50200023535069,114490.99,60ec41ba55c00300382672d9,HDFC,Revenue-Mktplace,5eecc6d6449e4f7cfb1c2708,2021-04-19T00:00:00.000Z,NEFT CR-DEUT0797BGL-FLIPKART INTERNET PR IVATE LIMITED-SLICK ORGANICS PVT LTD-041 900076GN00286,shopping,,net_banking_transfer,4238.19
61b702a7d8beac1599eb46b4,50200023535069,119522.14,60ec41ba55c00300382672d9,HDFC,Revenue-Mktplace,5eecc6d6449e4f7cfb1c2708,2021-04-19T00:00:00.000Z,NEFT CR-DEUT0797BGL-FLIPKART INTERNET PR,shopping,,net_banking_transfer,5031.15
61b702a8d8beac1599eb46de,50200023535069,126566.32,60ec41ba55c00300382672d9,HDFC,Revenue-Mktplace,5eecc6d6449e4f7cfb1c2708,2021-04-19T00:00:00.000Z,NEFT CR-DEUT0797BGL-MYNTRA DESIGNS PRIVA TE LIMITED-SLICK ORGANICS PRIVATE LIMITE D-041900276GN00291,shopping,,net_banking_transfer,7044.18
61b702a9d8beac1599eb4716,50200023535069,182473.91,60ec41ba55c00300382672d9,HDFC,Revenue-PG-split enabled,5eecc6d6449e4f7cfb1c2708,2021-04-19T00:00:00.000Z,NEFT CR-UTIB0001506-RAZORPAY SOFTWARE PR IVATE LIMITED-SLICK ORGANICS PVT LITD-AX ISCN0076087725,investments,,net_banking_transfer,55907.59
61b702aad8beac1599eb4719,50200023535069,185014.99,60ec41ba55c00300382672d9,HDFC,Revenue-Mktplace,5eecc6d6449e4f7cfb1c2708,2021-04-19T00:00:00.000Z,NEFT CR-DEUT0797BGL-MYNTRA DESIGNS PRIVA TE LIMITED-SLICK ORGANICS PRIVATE LIMITE D-041900343GN00266,shopping,,net_banking_transfer,2541.08
61b702abd8beac1599eb471d,50200023535069,165014.99,60ec41ba55c00300382672d9,HDFC,direct expenses,5eecc6d6449e4f7cfb1c2708,2021-04-19T00:00:00.000Z,"SELF - CHQ PAID - KALKAJI, NEW",,,chq,-20000
61b702acd8beac1599eb4728,50200023535069,160014.99,60ec41ba55c00300382672d9,HDFC,direct expenses,5eecc6d6449e4f7cfb1c2708,2021-04-19T00:00:00.000Z,"NEFT DR-PUNB0476900-SANDHYA SHUKLA-NETBA NK, MUM-N109211479184899-5000",,,net_banking_transfer,-5000
61b702add8beac1599eb4730,50200023535069,166936.16,60ec41ba55c00300382672d9,HDFC,Revenue-Mktplace,5eecc6d6449e4f7cfb1c2708,2021-04-19T00:00:00.000Z,NEFT CR-ICIC0000105-MANASH LIFETYLE PVT LTD-SLICKORGANICSPRIVATELIMITEDMPMUM-ICI B211090029547,,,net_banking_transfer,6921.17
61b702aed8beac1599eb4736,50200023535069,168362.3,60ec41ba55c00300382672d9,HDFC,Revenue-Mktplace,5eecc6d6449e4f7cfb1c2708,2021-04-19T00:00:00.000Z,NEFT CR-ICIC0000105-MANASH LIFETYLE PVT LTD-SLICKORGANICSPRIVATELIMITEDMPGGN-ICI B211090030956,,,net_banking_transfer,1426.14
61b702afd8beac1599eb473e,50200023535069,198362.3,60ec41ba55c00300382672d9,HDFC,Transfer in/Revenue-other,5eecc6d6449e4f7cfb1c2708,2021-04-19T00:00:00.000Z,MC CANCELLED,,,Other,30000
61b702b0d8beac1599eb475d,50200023535069,201419.46,60ec41ba55c00300382672d9,HDFC,Revenue-PG-non-split,5eecc6d6449e4f7cfb1c2708,2021-04-19T00:00:00.000Z,NEFT CR-IDFB0010204-SEZZLE PAYMENTS PRIV ATE LIMITED-SLICK ORGANICS PRIVATE LIMIT ED-IDFBH21109229344,investments,,net_banking_transfer,3057.16
61b702b1d8beac1599eb4764,50200023535069,208637.79,60ec41ba55c00300382672d9,HDFC,Revenue-PG-split enabled,5eecc6d6449e4f7cfb1c2708,2021-04-19T00:00:00.000Z,NEFT CR-UTIB0001506-RAZORPAY SOFTWARE PR IVATE LIMITED-SLICK ORGANICS PVT LITD-AX ISCN0076142832,investments,,net_banking_transfer,7218.33
61b702b2d8beac1599eb476a,50200023535069,293557.75,60ec41ba55c00300382672d9,HDFC,Revenue-COD,5eecc6d6449e4f7cfb1c2708,2021-04-19T00:00:00.000Z,NEFT CR-KKBK0000958-BIGFOOT RETAIL SOLUT IONS PRIVATE LIMITED-SLICK ORGANICS PVT LTD-KKBK211098054661,,,net_banking_transfer,84919.96
61b702b3d8beac1599eb4774,50200023535069,243557.75,60ec41ba55c00300382672d9,HDFC,Marketing Expense,5eecc6d6449e4f7cfb1c2708,2021-04-19T00:00:00.000Z,POS 514834XXXXXX9486 GOOGLE ADS,,,debit_card,-50000
61b702b3d8beac1599eb4778,50200023535069,247214.63,60ec41ba55c00300382672d9,HDFC,Revenue-PG-non-split,5eecc6d6449e4f7cfb1c2708,2021-04-20T00:00:00.000Z,UPI-PAYTM-PAYOUTS@PAYTM-PYTM0123456-1110 22375052-ALL202104202168200,ewallet,,upi,3656.88
61b702b5d8beac1599eb4786,50200023535069,258763.07,60ec41ba55c00300382672d9,HDFC,Revenue-PG-split enabled,5eecc6d6449e4f7cfb1c2708,2021-04-20T00:00:00.000Z,NEFT CR-UTIB0001506-RAZORPAY SOFTWARE PR,,,net_banking_transfer,11548.44
61b702b5d8beac1599eb478d,50200023535069,253513.74,60ec41ba55c00300382672d9,HDFC,direct expenses,5eecc6d6449e4f7cfb1c2708,2021-04-20T00:00:00.000Z,POS 514834XXXXXX9486 FEEDBACKFIVE,,,debit_card,-5249.33
61b702b6d8beac1599eb4795,50200023535069,-146486.26,60ec41ba55c00300382672d9,HDFC,direct expenses,5eecc6d6449e4f7cfb1c2708,2021-04-20T00:00:00.000Z,"NEFT DR-YESB0000551-VISTTA COSMETICS-NET BANK, MUM-N110211479969031-400000",,,net_banking_transfer,-400000
61b702b7d8beac1599eb47a8,50200023535069,653513.74,60ec41ba55c00300382672d9,HDFC,Internal Transfers,5eecc6d6449e4f7cfb1c2708,2021-04-20T00:00:00.000Z,IB FUNDS TRANSFER CR-50200035187206 -SL ICK ORGANICS PVT LTD,investments,,Other,800000
61b702b8d8beac1599eb47bc,50200023535069,643513.74,60ec41ba55c00300382672d9,HDFC,direct expenses,5eecc6d6449e4f7cfb1c2708,2021-04-20T00:00:00.000Z,IMPS-111011181904-PAYTM-PYTM-XXXXXXXX383 9-10000,ewallet,,net_banking_transfer,-10000
61b702b9d8beac1599eb47c1,50200023535069,749165.73,60ec41ba55c00300382672d9,HDFC,Revenue-Mktplace,5eecc6d6449e4f7cfb1c2708,2021-04-20T00:00:00.000Z,IMPS-111011173931-AMAZON SELLER SERVIC-H DFC-XXXXXXXX6004-7EBAA5ARODX1YWCPSLICK O RGANICS PVT LTD,shopping,,net_banking_transfer,105651.99
61b702bad8beac1599eb47cf,50200023535069,1158218.21,60ec41ba55c00300382672d9,HDFC,Revenue-Mktplace,5eecc6d6449e4f7cfb1c2708,2021-04-20T00:00:00.000Z,NEFT CR-DEUT0797BGL-AMAZON PAY (INDIA) P RIVATE LIMITED-SLICK ORGANICS PVT LTD-04 2000146GN00188,shopping,,net_banking_transfer,409052.48
61b702bbd8beac1599eb47d7,50200023535069,403218.21,60ec41ba55c00300382672d9,HDFC,SAAS/tech expense,5eecc6d6449e4f7cfb1c2708,2021-04-20T00:00:00.000Z,VHDF9916832879/BILLDKAMAZONSELLERSE,shopping,,Other,-755000
61b702bcd8beac1599eb47dd,50200023535069,292218.21,60ec41ba55c00300382672d9,HDFC,direct expenses,5eecc6d6449e4f7cfb1c2708,2021-04-20T00:00:00.000Z,"NEFT DR-YESB0000551-VISTTA COSMETICS-NET BANK, MUM-N110211480267623-111000",,,net_banking_transfer,-111000
61b702bdd8beac1599eb47f2,50200023535069,6816.21,60ec41ba55c00300382672d9,HDFC,direct expenses,5eecc6d6449e4f7cfb1c2708,2021-04-20T00:00:00.000Z,05892560000649-TPT-285402-DECORPAC INDIA PRIVATE LIMITED,,,net_banking_transfer,-285402
61b702bed8beac1599eb47f4,50200023535069,-93183.79,60ec41ba55c00300382672d9,HDFC,direct expenses,5eecc6d6449e4f7cfb1c2708,2021-04-20T00:00:00.000Z,57500000443889-TPT-100000-WEBKLIPPER TEC HNOLOGIES PRIVATE LIMITED,,,net_banking_transfer,-100000
61b702bfd8beac1599eb47f8,50200023535069,-92013.48,60ec41ba55c00300382672d9,HDFC,Revenue-Mktplace,5eecc6d6449e4f7cfb1c2708,2021-04-20T00:00:00.000Z,NEFT CR-ICIC0000105-MANASH LIFETYLE PVT LTD-SLICKORGANICSPRIVATELIMITEDMPMUM-ICI B211100048284,,,net_banking_transfer,1170.31
61b702c0d8beac1599eb4800,50200023535069,-89674.31,60ec41ba55c00300382672d9,HDFC,Revenue-Mktplace,5eecc6d6449e4f7cfb1c2708,2021-04-20T00:00:00.000Z,NEFT CR-ICIC0000105-MANASH LIFETYLE PVT LTD-SLICKORGANICSPRIVATELIMITEDMPGGN-ICI B211100048282,,,net_banking_transfer,2339.17
61b702c1d8beac1599eb480a,50200023535069,-77510.74,60ec41ba55c00300382672d9,HDFC,Revenue-PG-split enabled,5eecc6d6449e4f7cfb1c2708,2021-04-20T00:00:00.000Z,NEFT CR-UTIB0001506-RAZORPAY SOFTWARE PR IVATE LIMITED-SLICK ORGANICS PVT LITD-AX ISCN0076234928,investments,,net_banking_transfer,12163.57
61b702c2d8beac1599eb4811,50200023535069,-76430,60ec41ba55c00300382672d9,HDFC,Revenue-PG-non-split,5eecc6d6449e4f7cfb1c2708,2021-04-20T00:00:00.000Z,NEFT CR-IDFB0010204-SEZZLE PAYMENTS PRIV,,,net_banking_transfer,1080.74
61b702c3d8beac1599eb4819,50200023535069,-83106.05,60ec41ba55c00300382672d9,HDFC,direct expenses,5eecc6d6449e4f7cfb1c2708,2021-04-20T00:00:00.000Z,POS 514834XXXXXX9486 HOTJAR,,,debit_card,-6676.05
61b702c4d8beac1599eb4821,50200023535069,-82879.47,60ec41ba55c00300382672d9,HDFC,Transfer in/Revenue-other,5eecc6d6449e4f7cfb1c2708,2021-04-21T00:00:00.000Z,INT. ON SWCR ON-50300498262188,,,Other,226.58
61b702c5d8beac1599eb4827,50200023535069,227.53,60ec41ba55c00300382672d9,HDFC,Loan-in,5eecc6d6449e4f7cfb1c2708,2021-04-21T00:00:00.000Z,SWEEP-IN CREDIT - 50300498262188,,,self_transfer,83107
61b702c6d8beac1599eb482c,50200023535069,18506.89,60ec41ba55c00300382672d9,HDFC,Transfer in/Revenue-other,5eecc6d6449e4f7cfb1c2708,2021-04-21T00:00:00.000Z,IMPS-111105450412-NA-HDFC-XXXXXXXXXX0007 -ALL20210421216820000330830668628,,,net_banking_transfer,18279.36
61b702c7d8beac1599eb4836,50200023535069,23589.82,60ec41ba55c00300382672d9,HDFC,Revenue-Mktplace,5eecc6d6449e4f7cfb1c2708,2021-04-21T00:00:00.000Z,NEFT CR-DEUT0797BGL-FLIPKART INTERNET PR IVATE LIMITED-SLICK ORGANICS PVT LTD-042 100194GN00219,shopping,,net_banking_transfer,5082.93
61b702c8d8beac1599eb4839,50200023535069,31309.55,60ec41ba55c00300382672d9,HDFC,Revenue-Mktplace,5eecc6d6449e4f7cfb1c2708,2021-04-21T00:00:00.000Z,NEFT CR-DEUT0797BGL-FLIPKART INTERNET PR IVATE LIMITED-SLICK ORGANICS PVT LTD-042 100260GN00214,shopping,,net_banking_transfer,7719.73
61b702c9d8beac1599eb483d,50200023535069,34939.24,60ec41ba55c00300382672d9,HDFC,Revenue-Mktplace,5eecc6d6449e4f7cfb1c2708,2021-04-21T00:00:00.000Z,NEFT CR-DEUT0797BGL-MYNTRA DESIGNS PRIVA TE LIMITED-SLICK ORGANICS PRIVATE LIMITE D-042100454GN00042,shopping,,net_banking_transfer,3629.69
61b702cad8beac1599eb4842,50200023535069,-45257.76,60ec41ba55c00300382672d9,HDFC,direct expenses,5eecc6d6449e4f7cfb1c2708,2021-04-21T00:00:00.000Z,"NEFT DR-YESB0000162-VINAY REDDY-NETBANK, MUM-N111211481112338-80197",,,net_banking_transfer,-80197
61b702cbd8beac1599eb4849,50200023535069,-45225.06,60ec41ba55c00300382672d9,HDFC,Revenue-Mktplace,5eecc6d6449e4f7cfb1c2708,2021-04-21T00:00:00.000Z,NEFT CR-ICIC0000105-MANASH LIFETYLE PVT LTD-SLICKORGANICSPRIVATELIMITEDMPMUM-ICI B211110012193,,,net_banking_transfer,32.7
61b702ccd8beac1599eb4857,50200023535069,-44183.47,60ec41ba55c00300382672d9,HDFC,Revenue-Mktplace,5eecc6d6449e4f7cfb1c2708,2021-04-21T00:00:00.000Z,NEFT CR-ICIC0000105-MANASH LIFETYLE PVT LTD-SLICKORGANICSPRIVATELIMITEDMPGGN-ICI B211110010497,,,net_banking_transfer,1041.59
61b702cdd8beac1599eb4863,50200023535069,-43470.79,60ec41ba55c00300382672d9,HDFC,Revenue-Mktplace,5eecc6d6449e4f7cfb1c2708,2021-04-21T00:00:00.000Z,NEFT CR-DEUT0797BGL-MYNTRA DESIGNS PRIVA TE LIMITED-SLICK ORGANICS PRIVATE LIMITE D-042100453GN00109,shopping,,net_banking_transfer,712.68
61b702cdd8beac1599eb487a,50200023535069,-58470.79,60ec41ba55c00300382672d9,HDFC,direct expenses,5eecc6d6449e4f7cfb1c2708,2021-04-21T00:00:00.000Z,"NEFT DR-BARB0DBKHAN-ARUNT RANSPORT-NETBA NK, MUM-N111211481524661-15000",travel,,net_banking_transfer,-15000
61b702ced8beac1599eb4888,50200023535069,-58344.99,60ec41ba55c00300382672d9,HDFC,Transfer in/Revenue-other,5eecc6d6449e4f7cfb1c2708,2021-04-22T00:00:00.000Z,INT. ON SWCR ON-50300498262188,,,Other,125.8
61b702cfd8beac1599eb489c,50200023535069,-13086.99,60ec41ba55c00300382672d9,HDFC,Loan-in,5eecc6d6449e4f7cfb1c2708,2021-04-22T00:00:00.000Z,SWEEP-IN CREDIT - 50300498262188,,,self_transfer,45258
61b702d0d8beac1599eb48ab,50200023535069,-13050.25,60ec41ba55c00300382672d9,HDFC,Transfer in/Revenue-other,5eecc6d6449e4f7cfb1c2708,2021-04-22T00:00:00.000Z,INT. ON SWCR ON-50300498262188,,,Other,36.74
61b702d1d8beac1599eb48b2,50200023535069,36.75,60ec41ba55c00300382672d9,HDFC,Loan-in,5eecc6d6449e4f7cfb1c2708,2021-04-22T00:00:00.000Z,SWEEP-IN CREDIT - 50300498262188,,,self_transfer,13087
61b702d2d8beac1599eb48b7,50200023535069,109808.05,60ec41ba55c00300382672d9,HDFC,Transfer in/Revenue-other,5eecc6d6449e4f7cfb1c2708,2021-04-22T00:00:00.000Z,IMPS-111205369193-NA-HDFC-XXXXXXXXXX0007 -ALL20210422216820000330830668628,,,net_banking_transfer,109771.3
61b702d3d8beac1599eb48c3,50200023535069,358061.58,60ec41ba55c00300382672d9,HDFC,Revenue-PG-split enabled,5eecc6d6449e4f7cfb1c2708,2021-04-22T00:00:00.000Z,RTGS CR-UTIB0001506-RAZORPAY SOFTWARE PR IVATE LIMITED --SLICK ORGANICS PVT LITD- UTIBR52021042200345733,,,net_banking_transfer,248253.53
61b702d4d8beac1599eb48ca,50200023535069,358513.37,60ec41ba55c00300382672d9,HDFC,Revenue-PG-split enabled,5eecc6d6449e4f7cfb1c2708,2021-04-22T00:00:00.000Z,NEFT CR-UTIB0001506-RAZORPAY SOFTWARE PR IVATE LIMITED-SLICK ORGANICS-AXISCN00763 11984,investments,,net_banking_transfer,451.79
61b702d5d8beac1599eb48d4,50200023535069,362282.57,60ec41ba55c00300382672d9,HDFC,Transfer in/Revenue-other,5eecc6d6449e4f7cfb1c2708,2021-04-22T00:00:00.000Z,ZOOBOP ME WORK-ARATA,,,Other,3769.2
61b702d6d8beac1599eb48db,50200023535069,362832.65,60ec41ba55c00300382672d9,HDFC,Transfer in/Revenue-other,5eecc6d6449e4f7cfb1c2708,2021-04-22T00:00:00.000Z,FT - C71288220421164149 - - 50200050045 240 - ZOOBOP ME WORKS PRIVATE LIMITED,,,Other,550.08
61b702d7d8beac1599eb48e6,50200023535069,363390.95,60ec41ba55c00300382672d9,HDFC,Revenue-PG-non-split,5eecc6d6449e4f7cfb1c2708,2021-04-22T00:00:00.000Z,NEFT CR-IDFB0010204-SEZZLE PAYMENTS PRIV ATE LIMITED-SLICK ORGANICS PRIVATE LIMIT ED-IDFBH21112391704,investments,,net_banking_transfer,558.3
61b702d8d8beac1599eb48ee,50200023535069,378039.41,60ec41ba55c00300382672d9,HDFC,Revenue-PG-split enabled,5eecc6d6449e4f7cfb1c2708,2021-04-22T00:00:00.000Z,NEFT CR-UTIB0001506-RAZORPAY SOFTWARE PR IVATE LIMITED-SLICK ORGANICS PVT LITD-AX ISCN0076558354,investments,,net_banking_transfer,14648.46
61b702d9d8beac1599eb48f6,50200023535069,402676.7,60ec41ba55c00300382672d9,HDFC,Transfer in/Revenue-other,5eecc6d6449e4f7cfb1c2708,2021-04-23T00:00:00.000Z,IMPS-111305295939-NA-HDFC-XXXXXXXXXX0007 -ALL20210423216820000330830668628,,,net_banking_transfer,24637.29
61b702dad8beac1599eb48fe,50200023535069,423783.25,60ec41ba55c00300382672d9,HDFC,Revenue-PG-split enabled,5eecc6d6449e4f7cfb1c2708,2021-04-23T00:00:00.000Z,NEFT CR-UTIB0001506-RAZORPAY SOFTWARE PR IVATE LIMITED-SLICK ORGANICS PVT LITD-AX ISCN0076589957,investments,,net_banking_transfer,21106.55
61b702dbd8beac1599eb4908,50200023535069,426238.32,60ec41ba55c00300382672d9,HDFC,Revenue-Mktplace,5eecc6d6449e4f7cfb1c2708,2021-04-23T00:00:00.000Z,NEFT CR-DEUT0797BGL-MYNTRA DESIGNS PRIVA TE LIMITED-SLICK ORGANICS PRIVATE LIMITE D-042300138GN00242,shopping,,net_banking_transfer,2455.07
61b702dcd8beac1599eb490d,50200023535069,428717.19,60ec41ba55c00300382672d9,HDFC,Revenue-Mktplace,5eecc6d6449e4f7cfb1c2708,2021-04-23T00:00:00.000Z,NEFT CR-DEUT0797BGL-MYNTRA DESIGNS PRIVA TE LIMITED-SLICK ORGANICS PRIVATE LIMITE D-042300137GN00296,shopping,,net_banking_transfer,2478.87
61b702ddd8beac1599eb4916,50200023535069,450008.77,60ec41ba55c00300382672d9,HDFC,Revenue-Mktplace,5eecc6d6449e4f7cfb1c2708,2021-04-23T00:00:00.000Z,NEFT CR-DEUT0797BGL-FLIPKART INTERNET PR,shopping,,net_banking_transfer,21291.58
61b702ded8beac1599eb491e,50200023535069,449857.33,60ec41ba55c00300382672d9,HDFC,bank charges,5eecc6d6449e4f7cfb1c2708,2021-04-23T00:00:00.000Z,.DC INTL POS TXN MARKUP+ST 120421 140421 -CDT2110003809166,,,international_transaction_arbitrage,-151.44
61b702dfd8beac1599eb4926,50200023535069,452984.3,60ec41ba55c00300382672d9,HDFC,Revenue-Mktplace,5eecc6d6449e4f7cfb1c2708,2021-04-23T00:00:00.000Z,NEFT CR-DEUT0797BGL-FLIPKART INTERNET PR IVATE LIMITED-SLICK ORGANICS PVT LTD-042 300258GN00175,shopping,,net_banking_transfer,3126.97
61b702e0d8beac1599eb492e,50200023535069,457609.23,60ec41ba55c00300382672d9,HDFC,Revenue-PG-non-split,5eecc6d6449e4f7cfb1c2708,2021-04-23T00:00:00.000Z,NEFT CR-IDFB0010204-SEZZLE PAYMENTS PRIV ATE LIMITED-SLICK ORGANICS PRIVATE LIMIT ED-IDFBH21113439376,investments,,net_banking_transfer,4624.93
61b702e1d8beac1599eb4937,50200023535069,458716.77,60ec41ba55c00300382672d9,HDFC,Revenue-Mktplace,5eecc6d6449e4f7cfb1c2708,2021-04-23T00:00:00.000Z,NEFT CR-ICIC0000105-MANASH LIFETYLE PVT LTD-SLICKORGANICSPRIVATELIMITEDMPGGN-ICI B211130047866,,,net_banking_transfer,1107.54
61b702e2d8beac1599eb493f,50200023535069,460544.89,60ec41ba55c00300382672d9,HDFC,Revenue-Mktplace,5eecc6d6449e4f7cfb1c2708,2021-04-23T00:00:00.000Z,NEFT CR-ICIC0000105-MANASH LIFETYLE PVT LTD-SLICKORGANICSPRIVATELIMITEDMPMUM-ICI B211130045990,,,net_banking_transfer,1828.12
61b702e3d8beac1599eb4945,50200023535069,556010.03,60ec41ba55c00300382672d9,HDFC,Revenue-COD,5eecc6d6449e4f7cfb1c2708,2021-04-23T00:00:00.000Z,NEFT CR-KKBK0000958-BIGFOOT RETAIL SOLUT IONS PRIVATE LIMITED-SLICK ORGANICS PVT LTD-KKBK211138950992,,,net_banking_transfer,95465.14
61b702e4d8beac1599eb494e,50200023535069,553768.07,60ec41ba55c00300382672d9,HDFC,direct expenses,5eecc6d6449e4f7cfb1c2708,2021-04-23T00:00:00.000Z,POS 514834XXXXXX9486 RAZ*ARATA,,,debit_card,-2241.96
61b702e5d8beac1599eb4957,50200023535069,559260.07,60ec41ba55c00300382672d9,HDFC,Revenue-Mktplace,5eecc6d6449e4f7cfb1c2708,2021-04-23T00:00:00.000Z,NEFT CR-RATN0000999-DREAMPLUG TECHNOLOGI ES PRIVATE LIMI-SLICK ORGANICS PRIVATE L IMITED-000172417447,,,net_banking_transfer,5492
61b702e6d8beac1599eb495d,50200023535069,580867.77,60ec41ba55c00300382672d9,HDFC,Revenue-PG-split enabled,5eecc6d6449e4f7cfb1c2708,2021-04-23T00:00:00.000Z,NEFT CR-UTIB0001506-RAZORPAY SOFTWARE PR IVATE LIMITED-SLICK ORGANICS PVT LITD-AX ISCN0076657602,investments,,net_banking_transfer,21607.7
61b702e6d8beac1599eb4961,50200023535069,581646.45,60ec41ba55c00300382672d9,HDFC,Revenue-Mktplace,5eecc6d6449e4f7cfb1c2708,2021-04-23T00:00:00.000Z,NEFT CR-DEUT0784BBY-TATA UNISTORE LTD-NO DAL-SLICK ORGANICS PVT LTD-042301665GN00 316,investments,,net_banking_transfer,778.68
61b702e7d8beac1599eb4965,50200023535069,582056.08,60ec41ba55c00300382672d9,HDFC,Revenue-PG-non-split,5eecc6d6449e4f7cfb1c2708,2021-04-23T00:00:00.000Z,NEFT CR-ICIC0000031-PAYTM E COMMERCE PVT LTD-SLICK ORGANICS PVT LTD-CMS192079152 4,investments,,net_banking_transfer,409.63
61b702e8d8beac1599eb4970,50200023535069,532056.08,60ec41ba55c00300382672d9,HDFC,Marketing Expense,5eecc6d6449e4f7cfb1c2708,2021-04-23T00:00:00.000Z,POS 514834XXXXXX9486 GOOGLE ADS,,,debit_card,-50000
61b702e9d8beac1599eb4975,50200023535069,544663.86,60ec41ba55c00300382672d9,HDFC,Transfer in/Revenue-other,5eecc6d6449e4f7cfb1c2708,2021-04-24T00:00:00.000Z,IMPS-111405259541-NA-HDFC-XXXXXXXXXX0007,,,net_banking_transfer,12607.78
61b702ead8beac1599eb497c,50200023535069,567012.19,60ec41ba55c00300382672d9,HDFC,Transfer in/Revenue-other,5eecc6d6449e4f7cfb1c2708,2021-04-25T00:00:00.000Z,IMPS-111505000771-NA-HDFC-XXXXXXXXXX0007 -ALL20210425216820000330830668628,,,net_banking_transfer,22348.33
61b702ebd8beac1599eb49a1,50200023535069,589305.94,60ec41ba55c00300382672d9,HDFC,Transfer in/Revenue-other,5eecc6d6449e4f7cfb1c2708,2021-04-26T00:00:00.000Z,IMPS-111605561012-NA-HDFC-XXXXXXXXXX0007 -ALL20210426216820000330830668628,,,net_banking_transfer,22293.75
61b702ecd8beac1599eb49a6,50200023535069,591397.76,60ec41ba55c00300382672d9,HDFC,Revenue-Mktplace,5eecc6d6449e4f7cfb1c2708,2021-04-26T00:00:00.000Z,NEFT CR-DEUT0797BGL-FLIPKART INTERNET PR IVATE LIMITED-SLICK ORGANICS PVT LTD-042 600081GN00197,shopping,,net_banking_transfer,2091.82
61b702edd8beac1599eb49ad,50200023535069,593102.9,60ec41ba55c00300382672d9,HDFC,Revenue-Mktplace,5eecc6d6449e4f7cfb1c2708,2021-04-26T00:00:00.000Z,NEFT CR-DEUT0797BGL-FLIPKART INTERNET PR IVATE LIMITED-SLICK ORGANICS PVT LTD-042 600135GN00057,shopping,,net_banking_transfer,1705.14
61b702eed8beac1599eb49b5,50200023535069,680264.72,60ec41ba55c00300382672d9,HDFC,Revenue-PG-split enabled,5eecc6d6449e4f7cfb1c2708,2021-04-26T00:00:00.000Z,NEFT CR-UTIB0001506-RAZORPAY SOFTWARE PR IVATE LIMITED-SLICK ORGANICS PVT LITD-AX ISCN0076699980,investments,,net_banking_transfer,87161.82
61b702efd8beac1599eb49bc,50200023535069,687961.31,60ec41ba55c00300382672d9,HDFC,Revenue-Mktplace,5eecc6d6449e4f7cfb1c2708,2021-04-26T00:00:00.000Z,NEFT CR-DEUT0797BGL-MYNTRA DESIGNS PRIVA TE LIMITED-SLICK ORGANICS PRIVATE LIMITE D-042600335GN00215,shopping,,net_banking_transfer,7696.59
61b702f0d8beac1599eb49be,50200023535069,688675.35,60ec41ba55c00300382672d9,HDFC,Revenue-Mktplace,5eecc6d6449e4f7cfb1c2708,2021-04-26T00:00:00.000Z,NEFT CR-DEUT0797BGL-MYNTRA DESIGNS PRIVA TE LIMITED-SLICK ORGANICS PRIVATE LIMITE D-042600334GN00267,shopping,,net_banking_transfer,714.04
61b702f1d8beac1599eb49c1,50200023535069,685036.75,60ec41ba55c00300382672d9,HDFC,direct expenses,5eecc6d6449e4f7cfb1c2708,2021-04-26T00:00:00.000Z,POS 514834XXXXXX9486 FRESHWORKS INC,,,debit_card,-3638.6
61b702f2d8beac1599eb49c5,50200023535069,701402.75,60ec41ba55c00300382672d9,HDFC,Investments-New,5eecc6d6449e4f7cfb1c2708,2021-04-26T00:00:00.000Z,50200019889031-TPT-BRAND PAYMENT-1908 E- VENTURES PRIVATE LIMITED,,,net_banking_transfer,16366
61b702f3d8beac1599eb49cb,50200023535069,701371.94,60ec41ba55c00300382672d9,HDFC,bank charges,5eecc6d6449e4f7cfb1c2708,2021-04-26T00:00:00.000Z,.DC INTL POS TXN MARKUP+ST 160421 180421 -CDT2110003809166,,,international_transaction_arbitrage,-30.81
61b702f4d8beac1599eb49d0,50200023535069,701253.94,60ec41ba55c00300382672d9,HDFC,bank charges,5eecc6d6449e4f7cfb1c2708,2021-04-26T00:00:00.000Z,DD/MC CANCELLATION CHARGE 190421-CDT2111 404044403,,,bank_charge,-118
61b702f5d8beac1599eb49d7,50200023535069,701037.13,60ec41ba55c00300382672d9,HDFC,bank charges,5eecc6d6449e4f7cfb1c2708,2021-04-26T00:00:00.000Z,.DC INTL POS TXN MARKUP+ST 190421 210421 -CDT2110003809166,,,international_transaction_arbitrage,-216.81
61b702f6d8beac1599eb49dc,50200023535069,703339.67,60ec41ba55c00300382672d9,HDFC,Revenue-PG-non-split,5eecc6d6449e4f7cfb1c2708,2021-04-26T00:00:00.000Z,NEFT CR-IDFB0010204-SEZZLE PAYMENTS PRIV,,,net_banking_transfer,2302.54
61b702f7d8beac1599eb49e1,50200023535069,703815.76,60ec41ba55c00300382672d9,HDFC,Transfer in/Revenue-other,5eecc6d6449e4f7cfb1c2708,2021-04-26T00:00:00.000Z,4060000508-26 04 2021-HDFAZCUR1,,,Other,476.09
61b702f8d8beac1599eb49e9,50200023535069,713167.38,60ec41ba55c00300382672d9,HDFC,Revenue-COD,5eecc6d6449e4f7cfb1c2708,2021-04-26T00:00:00.000Z,NEFT CR-KKBK0000958-BIGFOOT RETAIL SOLUT IONS PRIVATE LIMITED-SLICK ORGANICS PVT LTD-KKBK211169394438,,,net_banking_transfer,9351.62
61b702f9d8beac1599eb49f1,50200023535069,703167.38,60ec41ba55c00300382672d9,HDFC,direct expenses,5eecc6d6449e4f7cfb1c2708,2021-04-26T00:00:00.000Z,IMPS-111617143687-PAYTM-PYTM-XXXXXXXX383 9-10000,ewallet,,net_banking_transfer,-10000
61b702fad8beac1599eb49f4,50200023535069,597930.38,60ec41ba55c00300382672d9,HDFC,direct expenses,5eecc6d6449e4f7cfb1c2708,2021-04-26T00:00:00.000Z,"NEFT DR-INDB0000333-NOASTRIX PRIVATE LIM ITED-NETBANK, MUM-N116211485136631-10523 7",,,net_banking_transfer,-105237
61b702fbd8beac1599eb49f7,50200023535069,607649.72,60ec41ba55c00300382672d9,HDFC,Revenue-PG-split enabled,5eecc6d6449e4f7cfb1c2708,2021-04-26T00:00:00.000Z,NEFT CR-UTIB0001506-RAZORPAY SOFTWARE PR IVATE LIMITED-SLICK ORGANICS PVT LITD-AX ISCN0076773168,investments,,net_banking_transfer,9719.34
61b702fcd8beac1599eb49fc,50200023535069,597649.72,60ec41ba55c00300382672d9,HDFC,direct expenses,5eecc6d6449e4f7cfb1c2708,2021-04-26T00:00:00.000Z,50100201107051-TPT-10000-SHEETAL KLER,,,net_banking_transfer,-10000
61b702fdd8beac1599eb4a0b,50200023535069,498673.72,60ec41ba55c00300382672d9,HDFC,Tax,5eecc6d6449e4f7cfb1c2708,2021-04-26T00:00:00.000Z,GST/BANK REFERENCE NO: R2111626340838/CI N NO: HDFC21040700313927,,,Other,-98976
61b702fed8beac1599eb4a14,50200023535069,418476.72,60ec41ba55c00300382672d9,HDFC,direct expenses,5eecc6d6449e4f7cfb1c2708,2021-04-26T00:00:00.000Z,"NEFT DR-YESB0000162-VINAY REDDY-NETBANK, MUM-N116211485157302-80197",,,net_banking_transfer,-80197
61b702fed8beac1599eb4a19,50200023535069,440073.66,60ec41ba55c00300382672d9,HDFC,Transfer in/Revenue-other,5eecc6d6449e4f7cfb1c2708,2021-04-27T00:00:00.000Z,IMPS-111705695086-NA-HDFC-XXXXXXXXXX0007 -ALL20210427216820000330830668628,,,net_banking_transfer,21596.94
61b702ffd8beac1599eb4a1f,50200023535069,453858.95,60ec41ba55c00300382672d9,HDFC,Revenue-PG-split enabled,5eecc6d6449e4f7cfb1c2708,2021-04-27T00:00:00.000Z,NEFT CR-UTIB0001506-RAZORPAY SOFTWARE PR IVATE LIMITED-SLICK ORGANICS PVT LITD-AX ISCN0076803886,investments,,net_banking_transfer,13785.29
61b70300d8beac1599eb4a24,50200023535069,403858.95,60ec41ba55c00300382672d9,HDFC,Marketing Expense,5eecc6d6449e4f7cfb1c2708,2021-04-27T00:00:00.000Z,POS 514834XXXXXX9486 GOOGLE ADS,,,debit_card,-50000
61b70301d8beac1599eb4a2b,50200023535069,403583.23,60ec41ba55c00300382672d9,HDFC,bank charges,5eecc6d6449e4f7cfb1c2708,2021-04-27T00:00:00.000Z,.DC INTL POS TXN MARKUP+ST 200421 220421 -CDT2110003809166,,,international_transaction_arbitrage,-275.72
61b70302d8beac1599eb4a32,50200023535069,405952.62,60ec41ba55c00300382672d9,HDFC,Revenue-Mktplace,5eecc6d6449e4f7cfb1c2708,2021-04-27T00:00:00.000Z,4060000472-TIMES INTERNET LIMITED NODAL,,,Other,2369.39
61b70303d8beac1599eb4a3f,50200023535069,407922.82,60ec41ba55c00300382672d9,HDFC,Revenue-PG-non-split,5eecc6d6449e4f7cfb1c2708,2021-04-27T00:00:00.000Z,NEFT CR-SCBL0036001-STRIPE INDIA PRIVATE -SLICK ORGANICS PRIVATE LIMITED-SSG17413 Q0242529,investments,,net_banking_transfer,1970.2
61b70304d8beac1599eb4a42,50200023535069,518450.17,60ec41ba55c00300382672d9,HDFC,Revenue-Mktplace,5eecc6d6449e4f7cfb1c2708,2021-04-27T00:00:00.000Z,IMPS-111711215845-AMAZON SELLER SERVIC-H,shopping,,net_banking_transfer,110527.35
61b70305d8beac1599eb4a45,50200023535069,865997.93,60ec41ba55c00300382672d9,HDFC,Revenue-Mktplace,5eecc6d6449e4f7cfb1c2708,2021-04-27T00:00:00.000Z,NEFT CR-DEUT0797BGL-AMAZON PAY (INDIA) P RIVATE LIMITED-SLICK ORGANICS PVT LTD-04 2700885GN00101,shopping,,net_banking_transfer,347547.76
61b70306d8beac1599eb4a4e,50200023535069,867254.3,60ec41ba55c00300382672d9,HDFC,Revenue-Mktplace,5eecc6d6449e4f7cfb1c2708,2021-04-27T00:00:00.000Z,NEFT CR-ICIC0000105-MANASH LIFETYLE PVT LTD-SLICKORGANICSPRIVATELIMITEDMPMUM-ICI B211170012645,,,net_banking_transfer,1256.37
61b70307d8beac1599eb4a53,50200023535069,871615.57,60ec41ba55c00300382672d9,HDFC,Revenue-PG-non-split,5eecc6d6449e4f7cfb1c2708,2021-04-27T00:00:00.000Z,NEFT CR-IDFB0010204-SEZZLE PAYMENTS PRIV ATE LIMITED-SLICK ORGANICS PRIVATE LIMIT ED-IDFBH21117597401,investments,,net_banking_transfer,4361.27
61b70308d8beac1599eb4a57,50200023535069,897452.1,60ec41ba55c00300382672d9,HDFC,Revenue-PG-split enabled,5eecc6d6449e4f7cfb1c2708,2021-04-27T00:00:00.000Z,NEFT CR-UTIB0001506-RAZORPAY SOFTWARE PR IVATE LIMITED-SLICK ORGANICS PVT LITD-AX ISCN0076874209,investments,,net_banking_transfer,25836.53
61b70309d8beac1599eb4a61,50200023535069,938929.22,60ec41ba55c00300382672d9,HDFC,Transfer in/Revenue-other,5eecc6d6449e4f7cfb1c2708,2021-04-28T00:00:00.000Z,IMPS-111805713140-NA-HDFC-XXXXXXXXXX0007 -ALL20210428216820000330830668628,,,net_banking_transfer,41477.12
61b7030ad8beac1599eb4a66,50200023535069,950378.21,60ec41ba55c00300382672d9,HDFC,Revenue-Mktplace,5eecc6d6449e4f7cfb1c2708,2021-04-28T00:00:00.000Z,NEFT CR-DEUT0797BGL-FLIPKART INTERNET PR IVATE LIMITED-SLICK ORGANICS PVT LTD-042 800151GN00156,shopping,,net_banking_transfer,11448.99
61b7030bd8beac1599eb4a71,50200023535069,984828.69,60ec41ba55c00300382672d9,HDFC,Revenue-PG-split enabled,5eecc6d6449e4f7cfb1c2708,2021-04-28T00:00:00.000Z,NEFT CR-UTIB0001506-RAZORPAY SOFTWARE PR IVATE LIMITED-SLICK ORGANICS PVT LITD-AX ISCN0076897118,investments,,net_banking_transfer,34450.48
61b7030cd8beac1599eb4a76,50200023535069,964828.69,60ec41ba55c00300382672d9,HDFC,direct expenses,5eecc6d6449e4f7cfb1c2708,2021-04-28T00:00:00.000Z,IMPS-111811199747-PAYTM-PYTM-XXXXXXXX383 9-20000,ewallet,,net_banking_transfer,-20000
61b7030dd8beac1599eb4a7d,50200023535069,972645.86,60ec41ba55c00300382672d9,HDFC,Revenue-Mktplace,5eecc6d6449e4f7cfb1c2708,2021-04-28T00:00:00.000Z,NEFT CR-DEUT0797BGL-FLIPKART INTERNET PR IVATE LIMITED-SLICK ORGANICS PVT LTD-042 800076GN00234,shopping,,net_banking_transfer,7817.17
61b7030ed8beac1599eb4a80,50200023535069,973505.71,60ec41ba55c00300382672d9,HDFC,Revenue-PG-non-split,5eecc6d6449e4f7cfb1c2708,2021-04-28T00:00:00.000Z,NEFT CR-IDFB0010204-SEZZLE PAYMENTS PRIV ATE LIMITED-SLICK ORGANICS PRIVATE LIMIT ED-IDFBH21118646561,investments,,net_banking_transfer,859.85
61b7030fd8beac1599eb4a83,50200023535069,982409.65,60ec41ba55c00300382672d9,HDFC,Revenue-COD,5eecc6d6449e4f7cfb1c2708,2021-04-28T00:00:00.000Z,NEFT CR-ICIC0000104-SHIPROCKET COD CRF I D 2364545-SLICK ORGANICS PVT LTD-CMS1925 427908,investments,,net_banking_transfer,8903.94
61b70310d8beac1599eb4a87,50200023535069,982774.68,60ec41ba55c00300382672d9,HDFC,Revenue-Mktplace,5eecc6d6449e4f7cfb1c2708,2021-04-28T00:00:00.000Z,NEFT CR-ICIC0000105-MANASH LIFETYLE PVT,,,net_banking_transfer,365.03
61b70311d8beac1599eb4a8d,50200023535069,983688.76,60ec41ba55c00300382672d9,HDFC,Revenue-Mktplace,5eecc6d6449e4f7cfb1c2708,2021-04-28T00:00:00.000Z,NEFT CR-ICIC0000105-MANASH LIFETYLE PVT LTD-SLICKORGANICSPRIVATELIMITEDMPMUM-ICI B211180049234,,,net_banking_transfer,914.08
61b70312d8beac1599eb4a91,50200023535069,1015053.82,60ec41ba55c00300382672d9,HDFC,Revenue-PG-split enabled,5eecc6d6449e4f7cfb1c2708,2021-04-28T00:00:00.000Z,NEFT CR-UTIB0001506-RAZORPAY SOFTWARE PR IVATE LIMITED-SLICK ORGANICS PVT LITD-AX ISCN0076963524,investments,,net_banking_transfer,31365.06
61b70313d8beac1599eb4a97,50200023535069,815053.82,60ec41ba55c00300382672d9,HDFC,direct expenses,5eecc6d6449e4f7cfb1c2708,2021-04-28T00:00:00.000Z,"NEFT DR-BARC0INBBIR-SHOPIFY COMMERCE IND IA PVT LTD-NETBANK, MUM-N118211487432628 -200000",,,net_banking_transfer,-200000
61b70314d8beac1599eb4a9d,50200023535069,615053.82,60ec41ba55c00300382672d9,HDFC,direct expenses,5eecc6d6449e4f7cfb1c2708,2021-04-28T00:00:00.000Z,IMPS-111819161760-SHOPIFY COMMERCE INDIA PVT LTD-BARC-XXXXXXXX3765-200000,,,net_banking_transfer,-200000
61b70315d8beac1599eb4aa4,50200023535069,588397.82,60ec41ba55c00300382672d9,HDFC,direct expenses,5eecc6d6449e4f7cfb1c2708,2021-04-28T00:00:00.000Z,02711600008220-TPT-26656-VARUN SINGH,,,net_banking_transfer,-26656
61b70316d8beac1599eb4aae,50200023535069,627492.83,60ec41ba55c00300382672d9,HDFC,Transfer in/Revenue-other,5eecc6d6449e4f7cfb1c2708,2021-04-29T00:00:00.000Z,IMPS-111905659750-NA-HDFC-XXXXXXXXXX0007 -ALL20210429216820000330830668628,,,net_banking_transfer,39095.01
61b70317d8beac1599eb4abb,50200023535069,672342.43,60ec41ba55c00300382672d9,HDFC,Revenue-PG-split enabled,5eecc6d6449e4f7cfb1c2708,2021-04-29T00:00:00.000Z,NEFT CR-UTIB0001506-RAZORPAY SOFTWARE PR IVATE LIMITED-SLICK ORGANICS PVT LITD-AX ISCN0077359644,investments,,net_banking_transfer,44849.6
61b70318d8beac1599eb4ac1,50200023535069,675255.11,60ec41ba55c00300382672d9,HDFC,Revenue-PG-non-split,5eecc6d6449e4f7cfb1c2708,2021-04-29T00:00:00.000Z,NEFT CR-IDFB0010204-SEZZLE PAYMENTS PRIV ATE LIMITED-SLICK ORGANICS PRIVATE LIMIT ED-IDFBH21119692837,investments,,net_banking_transfer,2912.68
61b70319d8beac1599eb4ad1,50200023535069,704013.99,60ec41ba55c00300382672d9,HDFC,Revenue-PG-split enabled,5eecc6d6449e4f7cfb1c2708,2021-04-29T00:00:00.000Z,NEFT CR-UTIB0001506-RAZORPAY SOFTWARE PR IVATE LIMITED-SLICK ORGANICS PVT LITD-AX ISCN0077421113,investments,,net_banking_transfer,28758.88
61b7031ad8beac1599eb4ad5,50200023535069,604013.99,60ec41ba55c00300382672d9,HDFC,direct expenses,5eecc6d6449e4f7cfb1c2708,2021-04-29T00:00:00.000Z,"NEFT DR-BARC0INBBIR-SHOPIFY COMMERCE IND IA PVT LTD-NETBANK, MUM-N119211488567271 -100000",,,net_banking_transfer,-100000
61b7031bd8beac1599eb4adc,50200023535069,638705.28,60ec41ba55c00300382672d9,HDFC,Transfer in/Revenue-other,5eecc6d6449e4f7cfb1c2708,2021-04-30T00:00:00.000Z,IMPS-112005572022-NA-HDFC-XXXXXXXXXX0007 -ALL20210430216820000330830668628,,,net_banking_transfer,34691.29
61b7031cd8beac1599eb4ae0,50200023535069,654726.27,60ec41ba55c00300382672d9,HDFC,Revenue-PG-split enabled,5eecc6d6449e4f7cfb1c2708,2021-04-30T00:00:00.000Z,NEFT CR-UTIB0001506-RAZORPAY SOFTWARE PR,,,net_banking_transfer,16020.99
61b7031dd8beac1599eb4ae5,50200023535069,161010.5,60ec41ba55c00300382672d9,HDFC,direct expenses,5eecc6d6449e4f7cfb1c2708,2021-04-30T00:00:00.000Z,ADVANCE PAYMENT OF IMPORT BILL,bills,,Other,-493715.77
61b7031ed8beac1599eb4aeb,50200023535069,111010.5,60ec41ba55c00300382672d9,HDFC,Marketing Expense,5eecc6d6449e4f7cfb1c2708,2021-04-30T00:00:00.000Z,POS 514834XXXXXX9486 GOOGLE ADS,,,debit_card,-50000
61b7031ed8beac1599eb4af0,50200023535069,113487.76,60ec41ba55c00300382672d9,HDFC,Revenue-PG-non-split,5eecc6d6449e4f7cfb1c2708,2021-04-30T00:00:00.000Z,NEFT CR-IDFB0010204-SEZZLE PAYMENTS PRIV ATE LIMITED-SLICK ORGANICS PRIVATE LIMIT ED-IDFBH21120747084,investments,,net_banking_transfer,2477.26
61b7031fd8beac1599eb4af8,50200023535069,113938.73,60ec41ba55c00300382672d9,HDFC,Transfer in/Revenue-other,5eecc6d6449e4f7cfb1c2708,2021-04-30T00:00:00.000Z,NEFT CR-YESB0000001-ILUMINAR MEDIA-SLICK ORGANICS-N120210579528702,,,net_banking_transfer,450.97
61b70320d8beac1599eb4b03,50200023535069,175865.46,60ec41ba55c00300382672d9,HDFC,Revenue-COD,5eecc6d6449e4f7cfb1c2708,2021-04-30T00:00:00.000Z,NEFT CR-ICIC0000104-SHIPROCKET COD CRF I D 2376605-SLICK ORGANICS PVT LTD-CMS1928 668924,investments,,net_banking_transfer,61926.73
61b70321d8beac1599eb4b09,50200023535069,120865.46,60ec41ba55c00300382672d9,HDFC,direct expenses,5eecc6d6449e4f7cfb1c2708,2021-04-30T00:00:00.000Z,"NEFT DR-YESB0000551-VISTTA COSMETICS-NET BANK, MUM-N120211489851923-55000",,,net_banking_transfer,-55000
61b70322d8beac1599eb4b0c,50200023535069,20865.46,60ec41ba55c00300382672d9,HDFC,direct expenses,5eecc6d6449e4f7cfb1c2708,2021-04-30T00:00:00.000Z,57500000443889-TPT-100000-WEBKLIPPER TEC HNOLOGIES PRIVATE LIMITED,,,net_banking_transfer,-100000
61b70323d8beac1599eb4b10,50200023535069,47342.16,60ec41ba55c00300382672d9,HDFC,Revenue-PG-split enabled,5eecc6d6449e4f7cfb1c2708,2021-04-30T00:00:00.000Z,NEFT CR-UTIB0001506-RAZORPAY SOFTWARE PR IVATE LIMITED-SLICK ORGANICS PVT LITD-AX ISCN0077701291,investments,,net_banking_transfer,26476.7
61b70324d8beac1599eb4b17,50200023535069,48691.85,60ec41ba55c00300382672d9,HDFC,Revenue-Mktplace,5eecc6d6449e4f7cfb1c2708,2021-04-30T00:00:00.000Z,NEFT CR-DEUT0784BBY-TATA UNISTORE LTD-NO DAL-SLICK ORGANICS PVT LTD-043002756GN00 261,investments,,net_banking_transfer,1349.69
61b70325d8beac1599eb4b1d,50200023535069,49103.27,60ec41ba55c00300382672d9,HDFC,Revenue-Mktplace,5eecc6d6449e4f7cfb1c2708,2021-04-30T00:00:00.000Z,NEFT CR-DEUT0784BBY-TATA UNISTORE LTD-NO DAL-SLICK ORGANICS PVT LTD-043002756GN00 188,investments,,net_banking_transfer,411.42
61b70326d8beac1599eb4b22,50200023535069,49505.53,60ec41ba55c00300382672d9,HDFC,Revenue-Mktplace,5eecc6d6449e4f7cfb1c2708,2021-04-30T00:00:00.000Z,NEFT CR-DEUT0784BBY-TATA UNISTORE LIMITE,,,net_banking_transfer,402.26
61b70327d8beac1599eb4b28,50200023535069,73651.02,60ec41ba55c00300382672d9,HDFC,Transfer in/Revenue-other,5eecc6d6449e4f7cfb1c2708,2021-05-01T00:00:00.000Z,IMPS-112105622156-NA-HDFC-XXXXXXXXXX0007 -ALL20210501216820000330830668628,,,net_banking_transfer,24145.49
61b70328d8beac1599eb4b2f,50200023535069,84821.95,60ec41ba55c00300382672d9,HDFC,Revenue-Mktplace,5eecc6d6449e4f7cfb1c2708,2021-05-01T00:00:00.000Z,NEFT CR-DEUT0797BGL-MYNTRA DESIGNS PRIVA TE LIMITED-SLICK ORGANICS PRIVATE LIMITE D-050100055GN00084,shopping,,net_banking_transfer,11170.93
61b70329d8beac1599eb4b33,50200023535069,82675.66,60ec41ba55c00300382672d9,HDFC,direct expenses,5eecc6d6449e4f7cfb1c2708,2021-05-01T00:00:00.000Z,POS 514834XXXXXX9486 SEOPTIMER,,,debit_card,-2146.29
61b7032ad8beac1599eb4b3c,50200023535069,140412.98,60ec41ba55c00300382672d9,HDFC,Transfer in/Revenue-other,5eecc6d6449e4f7cfb1c2708,2021-05-02T00:00:00.000Z,IMPS-112205553482-NA-HDFC-XXXXXXXXXX0007 -ALL20210502216820000330830668628,,,net_banking_transfer,57737.32
61b7032bd8beac1599eb4b44,50200023535069,-59587.02,60ec41ba55c00300382672d9,HDFC,Marketing Expense,5eecc6d6449e4f7cfb1c2708,2021-05-02T00:00:00.000Z,POS 514834XXXXXX9486 GOOGLE ADS,,,debit_card,-200000
61b7032cd8beac1599eb4b46,50200023535069,-59563.02,60ec41ba55c00300382672d9,HDFC,Transfer in/Revenue-other,5eecc6d6449e4f7cfb1c2708,2021-05-03T00:00:00.000Z,INT. ON SWCR ON-50300247022509,,,Other,24
61b7032dd8beac1599eb4b49,50200023535069,24.98,60ec41ba55c00300382672d9,HDFC,Loan-in,5eecc6d6449e4f7cfb1c2708,2021-05-03T00:00:00.000Z,SWEEP-IN CREDIT - 50300247022509,,,self_transfer,59588
61b7032ed8beac1599eb4b4d,50200023535069,34216.67,60ec41ba55c00300382672d9,HDFC,Transfer in/Revenue-other,5eecc6d6449e4f7cfb1c2708,2021-05-03T00:00:00.000Z,IMPS-112305297796-NA-HDFC-XXXXXXXXXX0007 -ALL20210503216820000330830668628,,,net_banking_transfer,34191.69
61b7032fd8beac1599eb4b55,50200023535069,43830.93,60ec41ba55c00300382672d9,HDFC,Revenue-Mktplace,5eecc6d6449e4f7cfb1c2708,2021-05-03T00:00:00.000Z,NEFT CR-DEUT0797BGL-FLIPKART INTERNET PR IVATE LIMITED-SLICK ORGANICS PVT LTD-050 300134GN00236,shopping,,net_banking_transfer,9614.26
61b70330d8beac1599eb4b59,50200023535069,354396.65,60ec41ba55c00300382672d9,HDFC,Revenue-PG-split enabled,5eecc6d6449e4f7cfb1c2708,2021-05-03T00:00:00.000Z,RTGS CR-UTIB0001506-RAZORPAY SOFTWARE PR IVATE LIMITED --SLICK ORGANICS PVT LITD- UTIBR52021050300335491,,,net_banking_transfer,310565.72
61b70331d8beac1599eb4b5d,50200023535069,357794.61,60ec41ba55c00300382672d9,HDFC,Revenue-Mktplace,5eecc6d6449e4f7cfb1c2708,2021-05-03T00:00:00.000Z,NEFT CR-DEUT0797BGL-MYNTRA DESIGNS PRIVA TE LIMITED-SLICK ORGANICS PRIVATE LIMITE D-050300253GN00211,shopping,,net_banking_transfer,3397.96
61b70332d8beac1599eb4b63,50200023535069,297805.61,60ec41ba55c00300382672d9,HDFC,SAAS/tech expense,5eecc6d6449e4f7cfb1c2708,2021-05-03T00:00:00.000Z,POS 514834XXXXXX9486 AMAZON,shopping,,debit_card,-59989
61b70333d8beac1599eb4b69,50200023535069,284353.61,60ec41ba55c00300382672d9,HDFC,direct expenses,5eecc6d6449e4f7cfb1c2708,2021-05-03T00:00:00.000Z,"NEFT DR-SBIN0008078-PANDIT PLASTICS-NETB ANK, MUM-N123211492068243-13452",,,net_banking_transfer,-13452
61b70334d8beac1599eb4b70,50200023535069,284351.61,60ec41ba55c00300382672d9,HDFC,SAAS/tech expense,5eecc6d6449e4f7cfb1c2708,2021-05-03T00:00:00.000Z,POS 514834XXXXXX9486 AMAZON INTERNET,shopping,,debit_card,-2
61b70335d8beac1599eb4b77,50200023535069,284350.61,60ec41ba55c00300382672d9,HDFC,Marketing Expense,5eecc6d6449e4f7cfb1c2708,2021-05-03T00:00:00.000Z,POS 514834XXXXXX9486 GOOGLE *TEMPORAR,,,debit_card,-1
61b70336d8beac1599eb4b7b,50200023535069,284351.61,60ec41ba55c00300382672d9,HDFC,Transfer in/Revenue-other,5eecc6d6449e4f7cfb1c2708,2021-05-03T00:00:00.000Z,POS 514834XXXXXX9486 GOOGLE *TEMPORAR,,,debit_card,1
61b70336d8beac1599eb4b7e,50200023535069,283051.61,60ec41ba55c00300382672d9,HDFC,Marketing Expense,5eecc6d6449e4f7cfb1c2708,2021-05-03T00:00:00.000Z,POS 514834XXXXXX9486 GOOGLE *GOOGLE S,,,debit_card,-1300
61b70337d8beac1599eb4b83,50200023535069,183051.61,60ec41ba55c00300382672d9,HDFC,direct expenses,5eecc6d6449e4f7cfb1c2708,2021-05-03T00:00:00.000Z,57500000443889-TPT-100000-WEBKLIPPER TEC,,,net_banking_transfer,-100000
61b70338d8beac1599eb4b8b,50200023535069,183547.92,60ec41ba55c00300382672d9,HDFC,Revenue-Mktplace,5eecc6d6449e4f7cfb1c2708,2021-05-03T00:00:00.000Z,NEFT CR-ICIC0000105-MANASH LIFETYLE PVT LTD-SLICKORGANICSPRIVATELIMITEDMPMUM-ICI B211230018447,,,net_banking_transfer,496.31
61b70339d8beac1599eb4b91,50200023535069,144032.92,60ec41ba55c00300382672d9,HDFC,direct expenses,5eecc6d6449e4f7cfb1c2708,2021-05-03T00:00:00.000Z,"NEFT DR-SBIN0001859-PARSHOTAM AND ASSOCI ATES-NETBANK, MUM-N123211492257733-39515",,,net_banking_transfer,-39515
61b7033ad8beac1599eb4b95,50200023535069,147851.29,60ec41ba55c00300382672d9,HDFC,Revenue-Mktplace,5eecc6d6449e4f7cfb1c2708,2021-05-03T00:00:00.000Z,NEFT CR-DEUT0797BGL-MYNTRA DESIGNS PRIVA TE LIMITED-SLICK ORGANICS PRIVATE LIMITE D-050300252GN00220,shopping,,net_banking_transfer,3818.37
61b7033bd8beac1599eb4b99,50200023535069,151220.87,60ec41ba55c00300382672d9,HDFC,Revenue-PG-non-split,5eecc6d6449e4f7cfb1c2708,2021-05-03T00:00:00.000Z,NEFT CR-SCBL0036001-STRIPE INDIA PRIVATE -SLICK ORGANICS PRIVATE LIMITED-SSG17413 Q0248395,insurance,,net_banking_transfer,3369.58
61b7033cd8beac1599eb4ba0,50200023535069,158063.98,60ec41ba55c00300382672d9,HDFC,Revenue-Mktplace,5eecc6d6449e4f7cfb1c2708,2021-05-03T00:00:00.000Z,NEFT CR-DEUT0797BGL-FLIPKART INTERNET PR IVATE LIMITED-SLICK ORGANICS PVT LTD-050 300081GN00186,shopping,,net_banking_transfer,6843.11
61b7033dd8beac1599eb4ba5,50200023535069,223092.01,60ec41ba55c00300382672d9,HDFC,Revenue-COD,5eecc6d6449e4f7cfb1c2708,2021-05-03T00:00:00.000Z,NEFT CR-ICIC0000104-SHIPROCKET COD CRF I D 2384910-SLICK ORGANICS PVT LTD-CMS1931 613744,insurance,,net_banking_transfer,65028.03
61b7033ed8beac1599eb4bab,50200023535069,254567.69,60ec41ba55c00300382672d9,HDFC,Revenue-PG-split enabled,5eecc6d6449e4f7cfb1c2708,2021-05-03T00:00:00.000Z,NEFT CR-UTIB0001506-RAZORPAY SOFTWARE PR IVATE LIMITED-SLICK ORGANICS PVT LITD-AX ISCN0077881720,insurance,,net_banking_transfer,31475.68
61b7033fd8beac1599eb4bb3,50200023535069,282965.95,60ec41ba55c00300382672d9,HDFC,Transfer in/Revenue-other,5eecc6d6449e4f7cfb1c2708,2021-05-04T00:00:00.000Z,IMPS-112405630910-NA-HDFC-XXXXXXXXXX0007 -ALL20210504216820000330830668628,,,net_banking_transfer,28398.26
61b70340d8beac1599eb4bb5,50200023535069,314797.58,60ec41ba55c00300382672d9,HDFC,Revenue-PG-split enabled,5eecc6d6449e4f7cfb1c2708,2021-05-04T00:00:00.000Z,NEFT CR-UTIB0001506-RAZORPAY SOFTWARE PR IVATE LIMITED-SLICK ORGANICS PVT LITD-AX ISCN0077910472,insurance,,net_banking_transfer,31831.63
61b70341d8beac1599eb4bb8,50200023535069,638810.87,60ec41ba55c00300382672d9,HDFC,Revenue-Mktplace,5eecc6d6449e4f7cfb1c2708,2021-05-04T00:00:00.000Z,NEFT CR-DEUT0797BGL-AMAZON PAY (INDIA) P RIVATE LIMITED-SLICK ORGANICS PVT LTD-05 0400136GN00192,shopping,,net_banking_transfer,324013.29
61b70342d8beac1599eb4bbd,50200023535069,627908.85,60ec41ba55c00300382672d9,HDFC,direct expenses,5eecc6d6449e4f7cfb1c2708,2021-05-04T00:00:00.000Z,POS 514834XXXXXX9486 STK*SHUTTERSTOCK,,,debit_card,-10902.02
61b70343d8beac1599eb4bc5,50200023535069,628574.42,60ec41ba55c00300382672d9,HDFC,Revenue-Mktplace,5eecc6d6449e4f7cfb1c2708,2021-05-04T00:00:00.000Z,NEFT CR-ICIC0000105-MANASH LIFETYLE PVT,,,net_banking_transfer,665.57
61b70344d8beac1599eb4bd2,50200023535069,660618.65,60ec41ba55c00300382672d9,HDFC,Revenue-PG-split enabled,5eecc6d6449e4f7cfb1c2708,2021-05-04T00:00:00.000Z,NEFT CR-UTIB0001506-RAZORPAY SOFTWARE PR IVATE LIMITED-SLICK ORGANICS PVT LITD-AX ISCN0077993248,insurance,,net_banking_transfer,32044.23
61b70345d8beac1599eb4be2,50200023535069,676459.4,60ec41ba55c00300382672d9,HDFC,Revenue-PG-non-split,5eecc6d6449e4f7cfb1c2708,2021-05-04T00:00:00.000Z,NEFT CR-IDFB0010204-SEZZLE PAYMENTS PRIV ATE LIMITED-SLICK ORGANICS PRIVATE LIMIT ED-IDFBH21124957664,insurance,,net_banking_transfer,15840.75
61b70346d8beac1599eb4bff,50200023535069,706798.88,60ec41ba55c00300382672d9,HDFC,Transfer in/Revenue-other,5eecc6d6449e4f7cfb1c2708,2021-05-05T00:00:00.000Z,IMPS-112505959248-NA-HDFC-XXXXXXXXXX0007 -ALL20210505216820000330830668628,,,net_banking_transfer,30339.48
61b70347d8beac1599eb4c25,50200023535069,707708.9,60ec41ba55c00300382672d9,HDFC,Revenue-Mktplace,5eecc6d6449e4f7cfb1c2708,2021-05-05T00:00:00.000Z,NEFT CR-DEUT0797BGL-FLIPKART INTERNET PR IVATE LIMITED-SLICK ORGANICS PVT LTD-050 500067GN00008,shopping,,net_banking_transfer,910.02
61b70348d8beac1599eb4c30,50200023535069,709963.28,60ec41ba55c00300382672d9,HDFC,Revenue-Mktplace,5eecc6d6449e4f7cfb1c2708,2021-05-05T00:00:00.000Z,NEFT CR-DEUT0797BGL-FLIPKART INTERNET PR IVATE LIMITED-SLICK ORGANICS PVT LTD-050 500149GN00098,shopping,,net_banking_transfer,2254.38
61b70349d8beac1599eb4c42,50200023535069,710875.34,60ec41ba55c00300382672d9,HDFC,Revenue-Mktplace,5eecc6d6449e4f7cfb1c2708,2021-05-05T00:00:00.000Z,NEFT CR-DEUT0797BGL-MYNTRA DESIGNS PRIVA TE LIMITED-SLICK ORGANICS PRIVATE LIMITE D-050500303GN00187,shopping,,net_banking_transfer,912.06
61b7034ad8beac1599eb4c4d,50200023535069,712983.35,60ec41ba55c00300382672d9,HDFC,Revenue-Mktplace,5eecc6d6449e4f7cfb1c2708,2021-05-05T00:00:00.000Z,NEFT CR-DEUT0797BGL-MYNTRA DESIGNS PRIVA TE LIMITED-SLICK ORGANICS PRIVATE LIMITE D-050500320GN00096,shopping,,net_banking_transfer,2108.01
61b7034bd8beac1599eb4c53,50200023535069,747144.58,60ec41ba55c00300382672d9,HDFC,Revenue-PG-split enabled,5eecc6d6449e4f7cfb1c2708,2021-05-05T00:00:00.000Z,NEFT CR-UTIB0001506-RAZORPAY SOFTWARE PR IVATE LIMITED-SLICK ORGANICS PVT LITD-AX ISCN0078024381,insurance,,net_banking_transfer,34161.23
61b7034cd8beac1599eb4c5e,50200023535069,755796.36,60ec41ba55c00300382672d9,HDFC,Revenue-COD,5eecc6d6449e4f7cfb1c2708,2021-05-05T00:00:00.000Z,NEFT CR-ICIC0000155-SHIPROCKET COD CRF I D 2397203-SLICK ORGANICS PVT LTD-CMS1934 395122,insurance,,net_banking_transfer,8651.78
61b7034dd8beac1599eb4c6e,50200023535069,756115.39,60ec41ba55c00300382672d9,HDFC,Revenue-Mktplace,5eecc6d6449e4f7cfb1c2708,2021-05-05T00:00:00.000Z,NEFT CR-ICIC0000105-MANASH LIFETYLE PVT LTD-SLICKORGANICSPRIVATELIMITEDMPMUM-ICI B211250053535,,,net_banking_transfer,319.03
61b7034ed8beac1599eb4c74,50200023535069,757798.39,60ec41ba55c00300382672d9,HDFC,Revenue-Mktplace,5eecc6d6449e4f7cfb1c2708,2021-05-05T00:00:00.000Z,NEFT CR-ICIC0000105-MANASH LIFETYLE PVT,,,net_banking_transfer,1683
61b7034fd8beac1599eb4c7b,50200023535069,688736.39,60ec41ba55c00300382672d9,HDFC,direct expenses,5eecc6d6449e4f7cfb1c2708,2021-05-05T00:00:00.000Z,"NEFT DR-KKBK0000173-ONE STOP ADVERTISING -NETBANK, MUM-N125211495255919-69062",,,net_banking_transfer,-69062
61b7034fd8beac1599eb4c82,50200023535069,692267.9,60ec41ba55c00300382672d9,HDFC,Revenue-PG-non-split,5eecc6d6449e4f7cfb1c2708,2021-05-05T00:00:00.000Z,NEFT CR-IDFB0010204-SEZZLE PAYMENTS PRIV ATE LIMITED-SLICK ORGANICS PRIVATE LIMIT ED-IDFBH21125008459,insurance,,net_banking_transfer,3531.51
61b70350d8beac1599eb4c89,50200023535069,709265.4,60ec41ba55c00300382672d9,HDFC,Revenue-PG-split enabled,5eecc6d6449e4f7cfb1c2708,2021-05-05T00:00:00.000Z,NEFT CR-UTIB0001506-RAZORPAY SOFTWARE PR IVATE LIMITED-SLICK ORGANICS PVT LITD-AX ISCN0078096328,insurance,,net_banking_transfer,16997.5
61b70351d8beac1599eb4c96,50200023535069,713842.4,60ec41ba55c00300382672d9,HDFC,Revenue-Mktplace,5eecc6d6449e4f7cfb1c2708,2021-05-05T00:00:00.000Z,NEFT CR-RATN0000999-DREAMPLUG TECHNOLOGI ES PRIVATE LIMI-SLICK ORGANICS PRIVATE L IMITED-000174706311,,,net_banking_transfer,4577
61b70352d8beac1599eb4c9e,50200023535069,513842.4,60ec41ba55c00300382672d9,HDFC,direct expenses,5eecc6d6449e4f7cfb1c2708,2021-05-05T00:00:00.000Z,"NEFT DR-INDB0000148-ACQUISORY INDIA CONS ULTING PVT LTD-NETBANK, MUM-N12521149540 9126-200000",,,net_banking_transfer,-200000
61b70353d8beac1599eb4ca6,50200023535069,263842.4,60ec41ba55c00300382672d9,HDFC,direct expenses,5eecc6d6449e4f7cfb1c2708,2021-05-05T00:00:00.000Z,02711930004579-TPT-250000-DHRUV BHASIN,,,net_banking_transfer,-250000
61b70354d8beac1599eb4cab,50200023535069,-6157.6,60ec41ba55c00300382672d9,HDFC,direct expenses,5eecc6d6449e4f7cfb1c2708,2021-05-05T00:00:00.000Z,"NEFT DR-SCBL0036025-DHRUV MADHOK-NETBANK , MUM-N125211495429177-270000",,,net_banking_transfer,-270000
61b70355d8beac1599eb4cb0,50200023535069,-6155.6,60ec41ba55c00300382672d9,HDFC,Revenue-Mktplace,5eecc6d6449e4f7cfb1c2708,2021-05-05T00:00:00.000Z,CRV POS-514834******9486-0503-AMAZON INT,shopping,,refund,2
61b70356d8beac1599eb4cb7,50200023535069,-6152.6,60ec41ba55c00300382672d9,HDFC,Transfer in/Revenue-other,5eecc6d6449e4f7cfb1c2708,2021-05-06T00:00:00.000Z,INT. ON SWCR ON-50300247022509,,,Other,3
61b70357d8beac1599eb4cc0,50200023535069,-880.01,60ec41ba55c00300382672d9,HDFC,Loan-in,5eecc6d6449e4f7cfb1c2708,2021-05-06T00:00:00.000Z,SWEEP-IN CREDIT - 50300247022509,,,self_transfer,5272.59
61b70358d8beac1599eb4cc5,50200023535069,-877.36,60ec41ba55c00300382672d9,HDFC,Transfer in/Revenue-other,5eecc6d6449e4f7cfb1c2708,2021-05-06T00:00:00.000Z,INT. ON SWCR ON-50300498262188,,,Other,2.65
61b70359d8beac1599eb4cce,50200023535069,3.64,60ec41ba55c00300382672d9,HDFC,Loan-in,5eecc6d6449e4f7cfb1c2708,2021-05-06T00:00:00.000Z,SWEEP-IN CREDIT - 50300498262188,,,self_transfer,881
61b7035ad8beac1599eb4cd5,50200023535069,12746.25,60ec41ba55c00300382672d9,HDFC,Transfer in/Revenue-other,5eecc6d6449e4f7cfb1c2708,2021-05-06T00:00:00.000Z,IMPS-112605086600-NA-HDFC-XXXXXXXXXX0007 -ALL20210506216820000330830668628,,,net_banking_transfer,12742.61
61b7035bd8beac1599eb4cdb,50200023535069,-2253.75,60ec41ba55c00300382672d9,HDFC,Marketing Expense,5eecc6d6449e4f7cfb1c2708,2021-05-06T00:00:00.000Z,POS 514834XXXXXX9486 GOOGLE WORKSPACE,,,debit_card,-15000
61b7035cd8beac1599eb4ce2,50200023535069,21373.69,60ec41ba55c00300382672d9,HDFC,Revenue-PG-split enabled,5eecc6d6449e4f7cfb1c2708,2021-05-06T00:00:00.000Z,NEFT CR-UTIB0001506-RAZORPAY SOFTWARE PR IVATE LIMITED-SLICK ORGANICS PVT LITD-AX ISCN0078197745,insurance,,net_banking_transfer,23627.44
61b7035dd8beac1599eb4ce9,50200023535069,121373.69,60ec41ba55c00300382672d9,HDFC,Internal Transfers,5eecc6d6449e4f7cfb1c2708,2021-05-06T00:00:00.000Z,IB FUNDS TRANSFER CR-50200035187206 -SL ICK ORGANICS PVT LTD,insurance,,Other,100000
61b7035ed8beac1599eb4cec,50200023535069,32008.69,60ec41ba55c00300382672d9,HDFC,direct expenses,5eecc6d6449e4f7cfb1c2708,2021-05-06T00:00:00.000Z,00921000075586-TPT-89365-ROET BINDRA,,,net_banking_transfer,-89365
61b7035fd8beac1599eb4cef,50200023535069,-2452.31,60ec41ba55c00300382672d9,HDFC,agency/vendor expense,5eecc6d6449e4f7cfb1c2708,2021-05-06T00:00:00.000Z,"NEFT DR-IDFB0021001-CLICKONIK DIGITAL ME DIA PVT LTD-NETBANK, MUM-N12621149609992 3-34461",insurance,,net_banking_transfer,-34461
61b70360d8beac1599eb4cf4,50200023535069,97547.69,60ec41ba55c00300382672d9,HDFC,Internal Transfers,5eecc6d6449e4f7cfb1c2708,2021-05-06T00:00:00.000Z,IB FUNDS TRANSFER CR-50200035187206 -SL ICK ORGANICS PVT LTD,insurance,,Other,100000
61b70361d8beac1599eb4cfb,50200023535069,65066.69,60ec41ba55c00300382672d9,HDFC,direct expenses,5eecc6d6449e4f7cfb1c2708,2021-05-06T00:00:00.000Z,"NEFT DR-ICIC0000399-RAPIDMILE BUSINESS S OLUTIONS PRIVATE LIM-NETBANK, MUM-N12621 1496152981-32481",loans,lender_transaction,net_banking_transfer,-32481
61b70362d8beac1599eb4cff,50200023535069,20866.69,60ec41ba55c00300382672d9,HDFC,direct expenses,5eecc6d6449e4f7cfb1c2708,2021-05-06T00:00:00.000Z,"NEFT DR-KKBK0000424-SUPER MARKET GROCERY SUPPLIES PVT LTD-NETBANK, MUM-N12621149 6154328-44200",shopping,,net_banking_transfer,-44200
61b70363d8beac1599eb4d06,50200023535069,21379.07,60ec41ba55c00300382672d9,HDFC,Revenue-Mktplace,5eecc6d6449e4f7cfb1c2708,2021-05-06T00:00:00.000Z,NEFT CR-ICIC0000105-MANASH LIFETYLE PVT LTD-SLICK ORGANICS PRIVATE LIMITED MP GGN-ICIB211260012650,,,net_banking_transfer,512.38
61b70364d8beac1599eb4d0a,50200023535069,22517.43,60ec41ba55c00300382672d9,HDFC,Revenue-Mktplace,5eecc6d6449e4f7cfb1c2708,2021-05-06T00:00:00.000Z,NEFT CR-ICIC0000105-MANASH LIFETYLE PVT LTD-SLICK ORGANICS PRIVATE LIMITED MP MUM-ICIB211260011298,,,net_banking_transfer,1138.36
61b70365d8beac1599eb4d10,50200023535069,15947.12,60ec41ba55c00300382672d9,HDFC,SAAS/tech expense,5eecc6d6449e4f7cfb1c2708,2021-05-06T00:00:00.000Z,POS 514834XXXXXX9486 AMAZON INTERNET,shopping,,debit_card,-6570.31
61b70366d8beac1599eb4d18,50200023535069,10008.64,60ec41ba55c00300382672d9,HDFC,SAAS/tech expense,5eecc6d6449e4f7cfb1c2708,2021-05-06T00:00:00.000Z,POS 514834XXXXXX9486 AMAZON INTERNET,shopping,,debit_card,-5938.48
61b70367d8beac1599eb4d21,50200023535069,8311.11,60ec41ba55c00300382672d9,HDFC,SAAS/tech expense,5eecc6d6449e4f7cfb1c2708,2021-05-06T00:00:00.000Z,POS 514834XXXXXX9486 AMAZON INTERNET,shopping,,debit_card,-1697.53
61b70368d8beac1599eb4d26,50200023535069,28841.23,60ec41ba55c00300382672d9,HDFC,Revenue-PG-split enabled,5eecc6d6449e4f7cfb1c2708,2021-05-06T00:00:00.000Z,NEFT CR-UTIB0001506-RAZORPAY SOFTWARE PR IVATE LIMITED-SLICK ORGANICS PVT LITD-AX ISCN0078291352,insurance,,net_banking_transfer,20530.12
61b70369d8beac1599eb4d29,50200023535069,26509.31,60ec41ba55c00300382672d9,HDFC,SAAS/tech expense,5eecc6d6449e4f7cfb1c2708,2021-05-06T00:00:00.000Z,POS 514834XXXXXX9486 AMAZON INTERNET,shopping,,debit_card,-2331.92
61b70369d8beac1599eb4d2c,50200023535069,24747.34,60ec41ba55c00300382672d9,HDFC,SAAS/tech expense,5eecc6d6449e4f7cfb1c2708,2021-05-06T00:00:00.000Z,POS 514834XXXXXX9486 AMAZON INTERNET,shopping,,debit_card,-1761.97
61b7036ad8beac1599eb4d33,50200023535069,18368.48,60ec41ba55c00300382672d9,HDFC,SAAS/tech expense,5eecc6d6449e4f7cfb1c2708,2021-05-06T00:00:00.000Z,POS 514834XXXXXX9486 AMAZON INTERNET,shopping,,debit_card,-6378.86
61b7036bd8beac1599eb4d37,50200023535069,11764.54,60ec41ba55c00300382672d9,HDFC,SAAS/tech expense,5eecc6d6449e4f7cfb1c2708,2021-05-06T00:00:00.000Z,POS 514834XXXXXX9486 AMAZON INTERNET,shopping,,debit_card,-6603.94
61b7036cd8beac1599eb4d3b,50200023535069,5225.43,60ec41ba55c00300382672d9,HDFC,SAAS/tech expense,5eecc6d6449e4f7cfb1c2708,2021-05-06T00:00:00.000Z,POS 514834XXXXXX9486 AMAZON INTERNET,shopping,,debit_card,-6539.11
61b7036dd8beac1599eb4d40,50200023535069,-1170.05,60ec41ba55c00300382672d9,HDFC,SAAS/tech expense,5eecc6d6449e4f7cfb1c2708,2021-05-06T00:00:00.000Z,POS 514834XXXXXX9486 AMAZON INTERNET,shopping,,debit_card,-6395.48
61b7036ed8beac1599eb4d45,50200023535069,-7702.04,60ec41ba55c00300382672d9,HDFC,SAAS/tech expense,5eecc6d6449e4f7cfb1c2708,2021-05-06T00:00:00.000Z,POS 514834XXXXXX9486 AMAZON INTERNET,shopping,,debit_card,-6531.99
61b7036fd8beac1599eb4d4b,50200023535069,-5297.4,60ec41ba55c00300382672d9,HDFC,Revenue-PG-non-split,5eecc6d6449e4f7cfb1c2708,2021-05-06T00:00:00.000Z,NEFT CR-IDFB0010204-SEZZLE PAYMENTS PRIV,,,net_banking_transfer,2404.64
61b70370d8beac1599eb4d52,50200023535069,-11798.31,60ec41ba55c00300382672d9,HDFC,SAAS/tech expense,5eecc6d6449e4f7cfb1c2708,2021-05-06T00:00:00.000Z,POS 514834XXXXXX9486 AMAZON INTERNET,shopping,,debit_card,-6500.91
61b70371d8beac1599eb4d5a,50200023535069,-11790.22,60ec41ba55c00300382672d9,HDFC,Transfer in/Revenue-other,5eecc6d6449e4f7cfb1c2708,2021-05-07T00:00:00.000Z,INT. ON SWCR ON-50300498262188,,,Other,8.09
61b70372d8beac1599eb4d85,50200023535069,-9536.22,60ec41ba55c00300382672d9,HDFC,Loan-in,5eecc6d6449e4f7cfb1c2708,2021-05-07T00:00:00.000Z,SWEEP-IN CREDIT - 50300498262188,,,self_transfer,2254
61b70373d8beac1599eb4d88,50200023535069,-9535.3,60ec41ba55c00300382672d9,HDFC,Transfer in/Revenue-other,5eecc6d6449e4f7cfb1c2708,2021-05-07T00:00:00.000Z,INT. ON SWCR ON-50300498262188,,,Other,0.92
61b70374d8beac1599eb4d8d,50200023535069,-9336.3,60ec41ba55c00300382672d9,HDFC,Loan-in,5eecc6d6449e4f7cfb1c2708,2021-05-07T00:00:00.000Z,SWEEP-IN CREDIT - 50300498262188,,,self_transfer,199
61b70375d8beac1599eb4d96,50200023535069,-9317.41,60ec41ba55c00300382672d9,HDFC,Transfer in/Revenue-other,5eecc6d6449e4f7cfb1c2708,2021-05-07T00:00:00.000Z,INT. ON SWCR ON-50300498262188,,,Other,18.89
61b70376d8beac1599eb4da7,50200023535069,-4067.41,60ec41ba55c00300382672d9,HDFC,Loan-in,5eecc6d6449e4f7cfb1c2708,2021-05-07T00:00:00.000Z,SWEEP-IN CREDIT - 50300498262188,,,self_transfer,5250
61b70377d8beac1599eb4dac,50200023535069,-4053.05,60ec41ba55c00300382672d9,HDFC,Transfer in/Revenue-other,5eecc6d6449e4f7cfb1c2708,2021-05-07T00:00:00.000Z,INT. ON SWCR ON-50300498262188,,,Other,14.36
61b70378d8beac1599eb4daf,50200023535069,14.95,60ec41ba55c00300382672d9,HDFC,Loan-in,5eecc6d6449e4f7cfb1c2708,2021-05-07T00:00:00.000Z,SWEEP-IN CREDIT - 50300498262188,,,self_transfer,4068
61b70379d8beac1599eb4db7,50200023535069,31120.91,60ec41ba55c00300382672d9,HDFC,Transfer in/Revenue-other,5eecc6d6449e4f7cfb1c2708,2021-05-07T00:00:00.000Z,IMPS-112705014774-NA-HDFC-XXXXXXXXXX0007 -ALL20210507216820000330830668628,,,net_banking_transfer,31105.96
61b7037ad8beac1599eb4dbe,50200023535069,35100.49,60ec41ba55c00300382672d9,HDFC,Revenue-Mktplace,5eecc6d6449e4f7cfb1c2708,2021-05-07T00:00:00.000Z,NEFT CR-DEUT0797BGL-FLIPKART INTERNET PR IVATE LIMITED-SLICK ORGANICS PVT LTD-050 700080GN00283,shopping,,net_banking_transfer,3979.58
61b7037bd8beac1599eb4dc5,50200023535069,43684.39,60ec41ba55c00300382672d9,HDFC,Revenue-Mktplace,5eecc6d6449e4f7cfb1c2708,2021-05-07T00:00:00.000Z,NEFT CR-DEUT0797BGL-FLIPKART INTERNET PR IVATE LIMITED-SLICK ORGANICS PVT LTD-050 700150GN00004,shopping,,net_banking_transfer,8583.9
61b7037cd8beac1599eb4dca,50200023535069,44095.61,60ec41ba55c00300382672d9,HDFC,Revenue-Mktplace,5eecc6d6449e4f7cfb1c2708,2021-05-07T00:00:00.000Z,NEFT CR-DEUT0797BGL-MYNTRA DESIGNS PRIVA TE LIMITED-SLICK ORGANICS PRIVATE LIMITE D-050700311GN00202,shopping,,net_banking_transfer,411.22
61b7037dd8beac1599eb4dcd,50200023535069,45782.74,60ec41ba55c00300382672d9,HDFC,Revenue-Mktplace,5eecc6d6449e4f7cfb1c2708,2021-05-07T00:00:00.000Z,NEFT CR-DEUT0797BGL-MYNTRA DESIGNS PRIVA TE LIMITED-SLICK ORGANICS PRIVATE LIMITE D-050700336GN00085,shopping,,net_banking_transfer,1687.13
61b7037dd8beac1599eb4dd0,50200023535069,1045782.74,60ec41ba55c00300382672d9,HDFC,Internal Transfers,5eecc6d6449e4f7cfb1c2708,2021-05-07T00:00:00.000Z,IB FUNDS TRANSFER CR-50200035187206 -SL ICK ORGANICS PVT LTD,insurance,,Other,1000000
61b7037ed8beac1599eb4dd9,50200023535069,1078787.22,60ec41ba55c00300382672d9,HDFC,Revenue-PG-split enabled,5eecc6d6449e4f7cfb1c2708,2021-05-07T00:00:00.000Z,NEFT CR-UTIB0001506-RAZORPAY SOFTWARE PR IVATE LIMITED-SLICK ORGANICS PVT LITD-AX ISCN0078325053,insurance,,net_banking_transfer,33004.48
61b7037fd8beac1599eb4ddd,50200023535069,986287.22,60ec41ba55c00300382672d9,HDFC,direct expenses,5eecc6d6449e4f7cfb1c2708,2021-05-07T00:00:00.000Z,"NEFT DR-CITI0000002-DHIRAJ-NETBANK, MUM- N127211497109003-92500",,,net_banking_transfer,-92500
61b70380d8beac1599eb4de1,50200023535069,895707.22,60ec41ba55c00300382672d9,HDFC,direct expenses,5eecc6d6449e4f7cfb1c2708,2021-05-07T00:00:00.000Z,NEFT DR-ICIC0000542-AVANTIKA SUKHIA-NETB,,,net_banking_transfer,-90580
61b70381d8beac1599eb4de5,50200023535069,874707.22,60ec41ba55c00300382672d9,HDFC,direct expenses,5eecc6d6449e4f7cfb1c2708,2021-05-07T00:00:00.000Z,"NEFT DR-SIBL0000555-JAIVEER KUMAR-NETBAN K, MUM-N127211497114232-21000",,,net_banking_transfer,-21000
61b70382d8beac1599eb4dea,50200023535069,859707.22,60ec41ba55c00300382672d9,HDFC,direct expenses,5eecc6d6449e4f7cfb1c2708,2021-05-07T00:00:00.000Z,"NEFT DR-PUNB0398000-MEENA SINGH-NETBANK, MUM-N127211497121540-15000",,,net_banking_transfer,-15000
61b70383d8beac1599eb4df1,50200023535069,824033.22,60ec41ba55c00300382672d9,HDFC,direct expenses,5eecc6d6449e4f7cfb1c2708,2021-05-07T00:00:00.000Z,"NEFT DR-ICIC0003374-SIDDHARTH KANOJIA-NE TBANK, MUM-N127211497126051-35674",,,net_banking_transfer,-35674
61b70384d8beac1599eb4df9,50200023535069,814033.22,60ec41ba55c00300382672d9,HDFC,direct expenses,5eecc6d6449e4f7cfb1c2708,2021-05-07T00:00:00.000Z,"NEFT DR-ALLA0210591-CHAMPA DEVI-NETBANK, MUM-N127211497118401-10000",,,net_banking_transfer,-10000
61b70385d8beac1599eb4e00,50200023535069,764033.22,60ec41ba55c00300382672d9,HDFC,direct expenses,5eecc6d6449e4f7cfb1c2708,2021-05-07T00:00:00.000Z,"NEFT DR-UTIB0000120-ADNAN ALI-NETBANK, M UM-N127211497122288-50000",,,net_banking_transfer,-50000
61b70386d8beac1599eb4e03,50200023535069,714308.22,60ec41ba55c00300382672d9,HDFC,direct expenses,5eecc6d6449e4f7cfb1c2708,2021-05-07T00:00:00.000Z,"NEFT DR-SYNB0005170-SNEHAL TAYDE-NETBANK , MUM-N127211497126925-49725",,,net_banking_transfer,-49725
61b70387d8beac1599eb4e06,50200023535069,696308.22,60ec41ba55c00300382672d9,HDFC,direct expenses,5eecc6d6449e4f7cfb1c2708,2021-05-07T00:00:00.000Z,"NEFT DR-PUNB0482100-RAM BHAVAN YADAV-NET BANK, MUM-N127211497128465-18000",,,net_banking_transfer,-18000
61b70388d8beac1599eb4e0b,50200023535069,676308.22,60ec41ba55c00300382672d9,HDFC,direct expenses,5eecc6d6449e4f7cfb1c2708,2021-05-07T00:00:00.000Z,"NEFT DR-PUNB0307800-PRAKASH JHA-NETBANK, MUM-N127211497134776-20000",,,net_banking_transfer,-20000
61b70389d8beac1599eb4e11,50200023535069,671308.22,60ec41ba55c00300382672d9,HDFC,direct expenses,5eecc6d6449e4f7cfb1c2708,2021-05-07T00:00:00.000Z,"NEFT DR-PUNB0476900-SANDHYA SHUKLA-NETBA NK, MUM-N127211497142228-5000",,,net_banking_transfer,-5000
61b7038ad8beac1599eb4e15,50200023535069,635308.22,60ec41ba55c00300382672d9,HDFC,direct expenses,5eecc6d6449e4f7cfb1c2708,2021-05-07T00:00:00.000Z,00901610080520-TPT-36000-POOJA KAPIL SHR OTRIYA,,,net_banking_transfer,-36000
61b7038bd8beac1599eb4e19,50200023535069,504808.22,60ec41ba55c00300382672d9,HDFC,direct expenses,5eecc6d6449e4f7cfb1c2708,2021-05-07T00:00:00.000Z,02771610131904-TPT-130500-DIGANT BHATT,,,net_banking_transfer,-130500
61b7038cd8beac1599eb4e1e,50200023535069,438808.22,60ec41ba55c00300382672d9,HDFC,direct expenses,5eecc6d6449e4f7cfb1c2708,2021-05-07T00:00:00.000Z,50100330586095-TPT-66000-DIWAKAR UNIYAL,,,net_banking_transfer,-66000
61b7038dd8beac1599eb4e22,50200023535069,334893.22,60ec41ba55c00300382672d9,HDFC,direct expenses,5eecc6d6449e4f7cfb1c2708,2021-05-07T00:00:00.000Z,50100301160692-TPT-103915-TARUN GARG,,,net_banking_transfer,-103915
61b7038ed8beac1599eb4e36,50200023535069,296393.22,60ec41ba55c00300382672d9,HDFC,direct expenses,5eecc6d6449e4f7cfb1c2708,2021-05-07T00:00:00.000Z,50100293329616-TPT-38500-SADIYA BANO,,,net_banking_transfer,-38500
61b7038fd8beac1599eb4e3d,50200023535069,261393.22,60ec41ba55c00300382672d9,HDFC,direct expenses,5eecc6d6449e4f7cfb1c2708,2021-05-07T00:00:00.000Z,50100064106714-TPT-35000-AKSHARANSH BHAT T,,,net_banking_transfer,-35000
61b70390d8beac1599eb4e40,50200023535069,229018.22,60ec41ba55c00300382672d9,HDFC,direct expenses,5eecc6d6449e4f7cfb1c2708,2021-05-07T00:00:00.000Z,"NEFT DR-UBIN0531855-MOHANISH KOTHARI-NET BANK, MUM-N127211497166451-32375",,,net_banking_transfer,-32375
61b70391d8beac1599eb4e43,50200023535069,139018.22,60ec41ba55c00300382672d9,HDFC,direct expenses,5eecc6d6449e4f7cfb1c2708,2021-05-07T00:00:00.000Z,"NEFT DR-BKDN0450123-ARTISTO DESIGNZ-NETB ANK, MUM-N127211497176945-90000",,,net_banking_transfer,-90000
61b70392d8beac1599eb4e46,50200023535069,112018.22,60ec41ba55c00300382672d9,HDFC,direct expenses,5eecc6d6449e4f7cfb1c2708,2021-05-07T00:00:00.000Z,NEFT DR-KKBK0000654-NIHARIKA MISHRA-NETB,,,net_banking_transfer,-27000
61b70393d8beac1599eb4e4d,50200023535069,1112018.22,60ec41ba55c00300382672d9,HDFC,Internal Transfers,5eecc6d6449e4f7cfb1c2708,2021-05-07T00:00:00.000Z,IB FUNDS TRANSFER CR-50200035187206 -SL ICK ORGANICS PVT LTD,insurance,,Other,1000000
61b70394d8beac1599eb4e58,50200023535069,1102578.22,60ec41ba55c00300382672d9,HDFC,direct expenses,5eecc6d6449e4f7cfb1c2708,2021-05-07T00:00:00.000Z,02711600008220-TPT-9440-VARUN SINGH,,,net_banking_transfer,-9440
61b70395d8beac1599eb4e5d,50200023535069,843578.22,60ec41ba55c00300382672d9,HDFC,direct expenses,5eecc6d6449e4f7cfb1c2708,2021-05-07T00:00:00.000Z,"NEFT DR-YESB0000551-VISTTA COSMETICS-NET BANK, MUM-N127211497473407-259000",,,net_banking_transfer,-259000
61b70396d8beac1599eb4e60,50200023535069,88578.22,60ec41ba55c00300382672d9,HDFC,SAAS/tech expense,5eecc6d6449e4f7cfb1c2708,2021-05-07T00:00:00.000Z,VHDF9953019910/BILLDKAMAZONSELLERSE,shopping,,Other,-755000
61b70397d8beac1599eb4e67,50200023535069,89037.51,60ec41ba55c00300382672d9,HDFC,Transfer in/Revenue-other,5eecc6d6449e4f7cfb1c2708,2021-05-07T00:00:00.000Z,NEFT CR-YESB0000001-ILUMINAR MEDIA-SLICK ORGANICS PVT. LTD-N127210589147089,,,net_banking_transfer,459.29
61b70398d8beac1599eb4e6f,50200023535069,139535.65,60ec41ba55c00300382672d9,HDFC,Revenue-COD,5eecc6d6449e4f7cfb1c2708,2021-05-07T00:00:00.000Z,NEFT CR-ICIC0000155-SHIPROCKET COD CRF I D 2409441-SLICK ORGANICS PVT LTD-CMS1937 108883,insurance,,net_banking_transfer,50498.14
61b70399d8beac1599eb4e77,50200023535069,141318.37,60ec41ba55c00300382672d9,HDFC,Transfer in/Revenue-other,5eecc6d6449e4f7cfb1c2708,2021-05-07T00:00:00.000Z,ZOOBOP ME WORK-ARATA,,,Other,1782.72
61b7039ad8beac1599eb4e7f,50200023535069,158751.96,60ec41ba55c00300382672d9,HDFC,Revenue-PG-split enabled,5eecc6d6449e4f7cfb1c2708,2021-05-07T00:00:00.000Z,NEFT CR-UTIB0001506-RAZORPAY SOFTWARE PR IVATE LIMITED-SLICK ORGANICS PVT LITD-AX ISCN0078455571,insurance,,net_banking_transfer,17433.59
61b7039bd8beac1599eb4e82,50200023535069,162798.36,60ec41ba55c00300382672d9,HDFC,Revenue-PG-non-split,5eecc6d6449e4f7cfb1c2708,2021-05-07T00:00:00.000Z,NEFT CR-IDFB0010204-SEZZLE PAYMENTS PRIV ATE LIMITED-SLICK ORGANICS PRIVATE LIMIT ED-IDFBH21127145769,insurance,,net_banking_transfer,4046.4
61b7039cd8beac1599eb4e87,50200023535069,192294.96,60ec41ba55c00300382672d9,HDFC,Transfer in/Revenue-other,5eecc6d6449e4f7cfb1c2708,2021-05-08T00:00:00.000Z,IMPS-112806454459-NA-HDFC-XXXXXXXXXX0007 -ALL20210508216820000330830668628,,,net_banking_transfer,29496.6
61b7039dd8beac1599eb4e8e,50200023535069,194876.15,60ec41ba55c00300382672d9,HDFC,Transfer in/Revenue-other,5eecc6d6449e4f7cfb1c2708,2021-05-08T00:00:00.000Z,FT - C75386080521144329 - - 50200050045 240 - ZOOBOP ME WORKS PRIVATE LIMITED,,,Other,2581.19
61b7039ed8beac1599eb4e92,50200023535069,245547.63,60ec41ba55c00300382672d9,HDFC,Transfer in/Revenue-other,5eecc6d6449e4f7cfb1c2708,2021-05-09T00:00:00.000Z,IMPS-112905086944-NA-HDFC-XXXXXXXXXX0007 -ALL20210509216820000330830668628,,,net_banking_transfer,50671.48
61b7039ed8beac1599eb4e98,50200023535069,262499.34,60ec41ba55c00300382672d9,HDFC,Transfer in/Revenue-other,5eecc6d6449e4f7cfb1c2708,2021-05-10T00:00:00.000Z,IMPS-113005796217-NA-HDFC-XXXXXXXXXX0007 -ALL20210510216820000330830668628,,,net_banking_transfer,16951.71
61b7039fd8beac1599eb4e9c,50200023535069,273346.37,60ec41ba55c00300382672d9,HDFC,Revenue-Mktplace,5eecc6d6449e4f7cfb1c2708,2021-05-10T00:00:00.000Z,NEFT CR-DEUT0797BGL-FLIPKART INTERNET PR IVATE LIMITED-SLICK ORGANICS PVT LTD-051 000137GN00245,shopping,,net_banking_transfer,10847.03
61b703a0d8beac1599eb4ea1,50200023535069,274966.82,60ec41ba55c00300382672d9,HDFC,Revenue-Mktplace,5eecc6d6449e4f7cfb1c2708,2021-05-10T00:00:00.000Z,NEFT CR-DEUT0797BGL-MYNTRA DESIGNS PRIVA,shopping,,net_banking_transfer,1620.45
61b703a1d8beac1599eb4ea7,50200023535069,281801.12,60ec41ba55c00300382672d9,HDFC,Revenue-Mktplace,5eecc6d6449e4f7cfb1c2708,2021-05-10T00:00:00.000Z,NEFT CR-DEUT0797BGL-MYNTRA DESIGNS PRIVA TE LIMITED-SLICK ORGANICS PRIVATE LIMITE D-051000290GN00226,shopping,,net_banking_transfer,6834.3
61b703a2d8beac1599eb4eb2,50200023535069,356961.8,60ec41ba55c00300382672d9,HDFC,Revenue-PG-split enabled,5eecc6d6449e4f7cfb1c2708,2021-05-10T00:00:00.000Z,NEFT CR-UTIB0001506-RAZORPAY SOFTWARE PR IVATE LIMITED-SLICK ORGANICS PVT LITD-AX ISCN0078589592,insurance,,net_banking_transfer,75160.68
61b703a3d8beac1599eb4eb9,50200023535069,359329.17,60ec41ba55c00300382672d9,HDFC,Transfer in/Revenue-other,5eecc6d6449e4f7cfb1c2708,2021-05-10T00:00:00.000Z,4060000927-09 05 2021-HDFAZCUR1,,,Other,2367.37
61b703a4d8beac1599eb4ebc,50200023535069,157329.17,60ec41ba55c00300382672d9,HDFC,direct expenses,5eecc6d6449e4f7cfb1c2708,2021-05-10T00:00:00.000Z,"NEFT DR-YESB0000551-VISTTA COSMETICS-NET BANK, MUM-N130211499949596-202000",,,net_banking_transfer,-202000
61b703a5d8beac1599eb4ebe,50200023535069,112238.17,60ec41ba55c00300382672d9,HDFC,Salary/Emp/consultant Expense,5eecc6d6449e4f7cfb1c2708,2021-05-10T00:00:00.000Z,"NEFT DR-UTIB0003142-ARIA DESAI UG ELIZAB ETH THOMAS ALEX-NETBANK, MUM-N1302114999 60232-45091",,,net_banking_transfer,-45091
61b703a6d8beac1599eb4ec1,50200023535069,116055.54,60ec41ba55c00300382672d9,HDFC,Revenue-Mktplace,5eecc6d6449e4f7cfb1c2708,2021-05-10T00:00:00.000Z,NEFT CR-DEUT0797BGL-FLIPKART INTERNET PR IVATE LIMITED-SLICK ORGANICS PVT LTD-051 000075GN00296,shopping,,net_banking_transfer,3817.37
61b703a7d8beac1599eb4ec9,50200023535069,195562.09,60ec41ba55c00300382672d9,HDFC,Revenue-COD,5eecc6d6449e4f7cfb1c2708,2021-05-10T00:00:00.000Z,NEFT CR-ICIC0000155-SHIPROCKET COD CRF I D 2418656-SLICK ORGANICS PVT LTD-CMS1939 598289,insurance,,net_banking_transfer,79506.55
61b703a8d8beac1599eb4ed1,50200023535069,195778.2,60ec41ba55c00300382672d9,HDFC,Revenue-PG-non-split,5eecc6d6449e4f7cfb1c2708,2021-05-10T00:00:00.000Z,NEFT CR-ICIC0000031-PAYTM E COMMERCE PVT LTD-SLICK ORGANICS PVT LTD-CMS194047651 4,ewallet,,net_banking_transfer,216.11
61b703a9d8beac1599eb4ed6,50200023535069,208421.47,60ec41ba55c00300382672d9,HDFC,Revenue-PG-split enabled,5eecc6d6449e4f7cfb1c2708,2021-05-10T00:00:00.000Z,NEFT CR-UTIB0001506-RAZORPAY SOFTWARE PR IVATE LIMITED-SLICK ORGANICS PVT LITD-AX ISCN0078664279,insurance,,net_banking_transfer,12643.27
61b703aad8beac1599eb4ed9,50200023535069,234918.06,60ec41ba55c00300382672d9,HDFC,Transfer in/Revenue-other,5eecc6d6449e4f7cfb1c2708,2021-05-11T00:00:00.000Z,IMPS-113106882156-NA-HDFC-XXXXXXXXXX0007 -ALL20210511216820000330830668628,,,net_banking_transfer,26496.59
61b703abd8beac1599eb4edf,50200023535069,234829.42,60ec41ba55c00300382672d9,HDFC,bank charges,5eecc6d6449e4f7cfb1c2708,2021-05-11T00:00:00.000Z,.DC INTL POS TXN MARKUP+ST 010521 020521 -CDT2112804190988,,,international_transaction_arbitrage,-88.64
61b703acd8beac1599eb4ee5,50200023535069,234379.17,60ec41ba55c00300382672d9,HDFC,bank charges,5eecc6d6449e4f7cfb1c2708,2021-05-11T00:00:00.000Z,.DC INTL POS TXN MARKUP+ST 040521 050521 -CDT2112804190988,,,international_transaction_arbitrage,-450.25
61b703add8beac1599eb4f0e,50200023535069,265423.6,60ec41ba55c00300382672d9,HDFC,Revenue-PG-split enabled,5eecc6d6449e4f7cfb1c2708,2021-05-11T00:00:00.000Z,NEFT CR-UTIB0001506-RAZORPAY SOFTWARE PR,,,net_banking_transfer,31044.43
61b703aed8beac1599eb4f12,50200023535069,306469.51,60ec41ba55c00300382672d9,HDFC,Revenue-Mktplace,5eecc6d6449e4f7cfb1c2708,2021-05-11T00:00:00.000Z,IMPS-113111123792-AMAZON SELLER SERVIC-H DFC-XXXXXXXX6004-2FTKTSWBIAMT6S55SLICK O RGANICS PVT LTD,shopping,,net_banking_transfer,41045.91
61b703afd8beac1599eb4f15,50200023535069,733227.05,60ec41ba55c00300382672d9,HDFC,Revenue-Mktplace,5eecc6d6449e4f7cfb1c2708,2021-05-11T00:00:00.000Z,NEFT CR-DEUT0797BGL-AMAZON PAY (INDIA) P RIVATE LIMITED-SLICK ORGANICS PVT LTD-05 1100419GN00438,shopping,,net_banking_transfer,426757.54
61b703b0d8beac1599eb4f1a,50200023535069,743936.95,60ec41ba55c00300382672d9,HDFC,Revenue-Mktplace,5eecc6d6449e4f7cfb1c2708,2021-05-11T00:00:00.000Z,NEFT CR-ICIC0000105-MANASH LIFETYLE PVT LTD-SLICKORGANICSPRIVATELIMITEDMPGGN-ICI B211310046831,,,net_banking_transfer,10709.9
61b703b1d8beac1599eb4f21,50200023535069,753917.64,60ec41ba55c00300382672d9,HDFC,Revenue-Mktplace,5eecc6d6449e4f7cfb1c2708,2021-05-11T00:00:00.000Z,NEFT CR-ICIC0000105-MANASH LIFETYLE PVT LTD-SLICKORGANICSPRIVATELIMITEDMPMUM-ICI B211310046833,,,net_banking_transfer,9980.69
61b703b2d8beac1599eb4f27,50200023535069,766161.62,60ec41ba55c00300382672d9,HDFC,Revenue-PG-split enabled,5eecc6d6449e4f7cfb1c2708,2021-05-11T00:00:00.000Z,NEFT CR-UTIB0001506-RAZORPAY SOFTWARE PR IVATE LIMITED-SLICK ORGANICS PVT LITD-AX ISCN0078818382,insurance,,net_banking_transfer,12243.98
61b703b3d8beac1599eb4f2b,50200023535069,804905.41,60ec41ba55c00300382672d9,HDFC,Transfer in/Revenue-other,5eecc6d6449e4f7cfb1c2708,2021-05-12T00:00:00.000Z,IMPS-113205878173-NA-HDFC-XXXXXXXXXX0007 -ALL20210512216820000330830668628,,,net_banking_transfer,38743.79
61b703b4d8beac1599eb4f2f,50200023535069,805371.86,60ec41ba55c00300382672d9,HDFC,Revenue-PG-non-split,5eecc6d6449e4f7cfb1c2708,2021-05-12T00:00:00.000Z,NEFT CR-ICIC0000031-PAYTM E COMMERCE PVT LTD-SLICK ORGANICS PVT LTD-CMS194200930 7,ewallet,,net_banking_transfer,466.45
61b703b4d8beac1599eb4f34,50200023535069,821783.68,60ec41ba55c00300382672d9,HDFC,Revenue-Mktplace,5eecc6d6449e4f7cfb1c2708,2021-05-12T00:00:00.000Z,NEFT CR-DEUT0797BGL-FLIPKART INTERNET PR IVATE LIMITED-SLICK ORGANICS PVT LTD-051 200140GN00265,shopping,,net_banking_transfer,16411.82
61b703b5d8beac1599eb4f58,50200023535069,821856.66,60ec41ba55c00300382672d9,HDFC,Revenue-Mktplace,5eecc6d6449e4f7cfb1c2708,2021-05-12T00:00:00.000Z,NEFT CR-DEUT0797BGL-MYNTRA DESIGNS PRIVA TE LIMITED-SLICK ORGANICS PRIVATE LIMITE D-051200298GN00191,shopping,,net_banking_transfer,72.98
61b703b6d8beac1599eb4f5f,50200023535069,828192.08,60ec41ba55c00300382672d9,HDFC,Revenue-Mktplace,5eecc6d6449e4f7cfb1c2708,2021-05-12T00:00:00.000Z,NEFT CR-DEUT0797BGL-MYNTRA DESIGNS PRIVA TE LIMITED-SLICK ORGANICS PRIVATE LIMITE D-051200309GN00135,shopping,,net_banking_transfer,6335.42
61b703b7d8beac1599eb4f67,50200023535069,833817.73,60ec41ba55c00300382672d9,HDFC,Revenue-PG-split enabled,5eecc6d6449e4f7cfb1c2708,2021-05-12T00:00:00.000Z,NEFT CR-UTIB0001506-RAZORPAY SOFTWARE PR,,,net_banking_transfer,5625.65
61b703b8d8beac1599eb4f6a,50200023535069,830281.27,60ec41ba55c00300382672d9,HDFC,direct expenses,5eecc6d6449e4f7cfb1c2708,2021-05-12T00:00:00.000Z,H9KJLIHJMXHQGE/RAZPLITTLEBLACKBOOK,,,Other,-3536.46
61b703b9d8beac1599eb4f8c,50200023535069,810281.27,60ec41ba55c00300382672d9,HDFC,direct expenses,5eecc6d6449e4f7cfb1c2708,2021-05-12T00:00:00.000Z,"SARVAN KUMAR - CHQ PAID - GKII, NEW DE",,,chq,-20000
61b703bad8beac1599eb4f95,50200023535069,755281.27,60ec41ba55c00300382672d9,HDFC,direct expenses,5eecc6d6449e4f7cfb1c2708,2021-05-12T00:00:00.000Z,"NEFT DR-PYTM0123456-PAYTM-NETBANK, MUM-N 132211502567249-55000",ewallet,,net_banking_transfer,-55000
61b703bbd8beac1599eb4f9f,50200023535069,696855.27,60ec41ba55c00300382672d9,HDFC,Marketing Expense,5eecc6d6449e4f7cfb1c2708,2021-05-12T00:00:00.000Z,"NEFT DR-CITI0000006-FACEBOOK INDIA ONLIN E SERVICES PVT LTD-NETBANK, MUM-N1322115 02573798-58426",,,net_banking_transfer,-58426
61b703bcd8beac1599eb4fad,50200023535069,2196855.27,60ec41ba55c00300382672d9,HDFC,Internal Transfers,5eecc6d6449e4f7cfb1c2708,2021-05-12T00:00:00.000Z,IB FUNDS TRANSFER CR-50200035187206 -SL ICK ORGANICS PVT LTD,insurance,,Other,1500000
61b703bdd8beac1599eb4fb8,50200023535069,243216.27,60ec41ba55c00300382672d9,HDFC,Marketing Expense,5eecc6d6449e4f7cfb1c2708,2021-05-12T00:00:00.000Z,"NEFT DR-CITI0000006-FACEBOOK INDIA ONLIN E SERVICES PVT LTD-NETBANK, MUM-N1322115 02585322-1953639",,,net_banking_transfer,-1953639
61b703bed8beac1599eb4fc9,50200023535069,250894.15,60ec41ba55c00300382672d9,HDFC,Revenue-PG-non-split,5eecc6d6449e4f7cfb1c2708,2021-05-12T00:00:00.000Z,NEFT CR-IDFB0010204-SEZZLE PAYMENTS PRIV ATE LIMITED-SLICK ORGANICS PRIVATE LIMIT ED-IDFBH21132338024,insurance,,net_banking_transfer,7677.88
61b703bfd8beac1599eb4fd7,50200023535069,150894.15,60ec41ba55c00300382672d9,HDFC,direct expenses,5eecc6d6449e4f7cfb1c2708,2021-05-12T00:00:00.000Z,57500000443889-TPT-100000-WEBKLIPPER TEC HNOLOGIES PRIVATE LIMITED,,,net_banking_transfer,-100000
61b703c0d8beac1599eb4fe1,50200023535069,153724.53,60ec41ba55c00300382672d9,HDFC,Revenue-Mktplace,5eecc6d6449e4f7cfb1c2708,2021-05-12T00:00:00.000Z,4060000897-TIMES INTERNET LIMITED NODAL,,,Other,2830.38
61b703c1d8beac1599eb4fed,50200023535069,155389.94,60ec41ba55c00300382672d9,HDFC,Revenue-Mktplace,5eecc6d6449e4f7cfb1c2708,2021-05-12T00:00:00.000Z,NEFT CR-ICIC0000105-MANASH LIFETYLE PVT LTD-SLICKORGANICSPRIVATELIMITEDMPGGN-ICI B211320032810,,,net_banking_transfer,1665.41
61b703c2d8beac1599eb4ffa,50200023535069,156796.59,60ec41ba55c00300382672d9,HDFC,Revenue-Mktplace,5eecc6d6449e4f7cfb1c2708,2021-05-12T00:00:00.000Z,NEFT CR-ICIC0000105-MANASH LIFETYLE PVT LTD-SLICKORGANICSPRIVATELIMITEDMPMUM-ICI B211320032811,,,net_banking_transfer,1406.65
61b703c3d8beac1599eb5003,50200023535069,160165.18,60ec41ba55c00300382672d9,HDFC,Revenue-PG-non-split,5eecc6d6449e4f7cfb1c2708,2021-05-12T00:00:00.000Z,NEFT CR-IDFB0010204-SEZZLE PAYMENTS PRIV ATE LIMITED-SLICK ORGANICS PRIVATE LIMIT ED-IDFBH21132352807,insurance,,net_banking_transfer,3368.59
61b703c4d8beac1599eb5008,50200023535069,176472.43,60ec41ba55c00300382672d9,HDFC,Revenue-PG-split enabled,5eecc6d6449e4f7cfb1c2708,2021-05-12T00:00:00.000Z,NEFT CR-UTIB0001506-RAZORPAY SOFTWARE PR,,,net_banking_transfer,16307.25
61b703c5d8beac1599eb5018,50200023535069,232789.07,60ec41ba55c00300382672d9,HDFC,Revenue-COD,5eecc6d6449e4f7cfb1c2708,2021-05-12T00:00:00.000Z,NEFT CR-ICIC0000155-SHIPROCKET COD CRF I D 2430969-SLICK ORGANICS PVT LTD-CMS1942 811186,insurance,,net_banking_transfer,56316.64
61b703c6d8beac1599eb501d,50200023535069,229186.15,60ec41ba55c00300382672d9,HDFC,direct expenses,5eecc6d6449e4f7cfb1c2708,2021-05-12T00:00:00.000Z,POS 514834XXXXXX9486 WWW.FAQPRIME.COM,,,debit_card,-3602.92
61b703c7d8beac1599eb5023,50200023535069,179186.15,60ec41ba55c00300382672d9,HDFC,Marketing Expense,5eecc6d6449e4f7cfb1c2708,2021-05-12T00:00:00.000Z,POS 514834XXXXXX9486 GOOGLE ADS,,,debit_card,-50000
61b703c8d8beac1599eb502a,50200023535069,-4135.85,60ec41ba55c00300382672d9,HDFC,agency/vendor expense,5eecc6d6449e4f7cfb1c2708,2021-05-12T00:00:00.000Z,"NEFT DR-KKBK0000298-ADMITAD MEDIA PRIVAT E LIMITED-NETBANK, MUM-N132211503450299- 183322",loans,lender_transaction,net_banking_transfer,-183322
61b703c9d8beac1599eb5033,50200023535069,-19135.85,60ec41ba55c00300382672d9,HDFC,direct expenses,5eecc6d6449e4f7cfb1c2708,2021-05-12T00:00:00.000Z,"NEFT DR-BARB0DBKHAN-ARUNT RANSPORT-NETBA NK, MUM-N132211503465988-15000",travel,,net_banking_transfer,-15000
61b703cad8beac1599eb503b,50200023535069,-19119.51,60ec41ba55c00300382672d9,HDFC,Transfer in/Revenue-other,5eecc6d6449e4f7cfb1c2708,2021-05-13T00:00:00.000Z,INT. ON SWCR ON-50300498262188,,,Other,16.34
61b703cbd8beac1599eb5043,50200023535069,-14983.51,60ec41ba55c00300382672d9,HDFC,Loan-in,5eecc6d6449e4f7cfb1c2708,2021-05-13T00:00:00.000Z,SWEEP-IN CREDIT - 50300498262188,,,self_transfer,4136
61b703ccd8beac1599eb504c,50200023535069,-14924.54,60ec41ba55c00300382672d9,HDFC,Transfer in/Revenue-other,5eecc6d6449e4f7cfb1c2708,2021-05-13T00:00:00.000Z,INT. ON SWCR ON-50300498262188,,,Other,58.97
61b703cdd8beac1599eb5070,50200023535069,59.46,60ec41ba55c00300382672d9,HDFC,Loan-in,5eecc6d6449e4f7cfb1c2708,2021-05-13T00:00:00.000Z,SWEEP-IN CREDIT - 50300498262188,,,self_transfer,14984
61b703ced8beac1599eb5075,50200023535069,21966,60ec41ba55c00300382672d9,HDFC,Transfer in/Revenue-other,5eecc6d6449e4f7cfb1c2708,2021-05-13T00:00:00.000Z,IMPS-113305779417-NA-HDFC-XXXXXXXXXX0007 -ALL20210513216820000330830668628,,,net_banking_transfer,21906.54
61b703cfd8beac1599eb507e,50200023535069,24878.92,60ec41ba55c00300382672d9,HDFC,Revenue-Mktplace,5eecc6d6449e4f7cfb1c2708,2021-05-13T00:00:00.000Z,NEFT CR-DEUT0797BGL-MYNTRA DESIGNS PRIVA TE LIMITED-SLICK ORGANICS PRIVATE LIMITE D-051300280GN00141,shopping,,net_banking_transfer,2912.92
61b703cfd8beac1599eb5083,50200023535069,26141.13,60ec41ba55c00300382672d9,HDFC,Revenue-Mktplace,5eecc6d6449e4f7cfb1c2708,2021-05-13T00:00:00.000Z,NEFT CR-DEUT0797BGL-MYNTRA DESIGNS PRIVA TE LIMITED-SLICK ORGANICS PRIVATE LIMITE D-051300278GN00270,shopping,,net_banking_transfer,1262.21
61b703d0d8beac1599eb50a8,50200023535069,1726141.13,60ec41ba55c00300382672d9,HDFC,Internal Transfers,5eecc6d6449e4f7cfb1c2708,2021-05-13T00:00:00.000Z,IB FUNDS TRANSFER CR-50200035187206 -SL ICK ORGANICS PVT LTD,insurance,,Other,1700000
61b703d1d8beac1599eb50af,50200023535069,1726948.2,60ec41ba55c00300382672d9,HDFC,Revenue-Mktplace,5eecc6d6449e4f7cfb1c2708,2021-05-13T00:00:00.000Z,NEFT CR-ICIC0000105-MANASH LIFETYLE PVT LTD-SLICKORGANICSPRIVATELIMITEDMPMUM-ICI B211330026440,,,net_banking_transfer,807.07
61b703d2d8beac1599eb50b6,50200023535069,1727444.44,60ec41ba55c00300382672d9,HDFC,Revenue-Mktplace,5eecc6d6449e4f7cfb1c2708,2021-05-13T00:00:00.000Z,NEFT CR-ICIC0000105-MANASH LIFETYLE PVT LTD-SLICKORGANICSPRIVATELIMITEDMPGGN-ICI B211330026439,,,net_banking_transfer,496.24
61b703d3d8beac1599eb50bd,50200023535069,146506.57,60ec41ba55c00300382672d9,HDFC,direct expenses,5eecc6d6449e4f7cfb1c2708,2021-05-13T00:00:00.000Z,ADVANCE PAYMENT OF IMPORT BILL,bills,,Other,-1580937.87
61b703d4d8beac1599eb50c7,50200023535069,179318.19,60ec41ba55c00300382672d9,HDFC,Transfer in/Revenue-other,5eecc6d6449e4f7cfb1c2708,2021-05-14T00:00:00.000Z,IMPS-113405650892-NA-HDFC-XXXXXXXXXX0007,,,net_banking_transfer,32811.62
61b703d5d8beac1599eb50cf,50200023535069,202398.44,60ec41ba55c00300382672d9,HDFC,Revenue-Mktplace,5eecc6d6449e4f7cfb1c2708,2021-05-14T00:00:00.000Z,NEFT CR-DEUT0797BGL-FLIPKART INTERNET PR IVATE LIMITED-SLICK ORGANICS PVT LTD-051 400137GN00085,shopping,,net_banking_transfer,23080.25
61b703d6d8beac1599eb50df,50200023535069,205674.57,60ec41ba55c00300382672d9,HDFC,Revenue-Mktplace,5eecc6d6449e4f7cfb1c2708,2021-05-14T00:00:00.000Z,NEFT CR-DEUT0797BGL-MYNTRA DESIGNS PRIVA TE LIMITED-SLICK ORGANICS PRIVATE LIMITE D-051400294GN00213,shopping,,net_banking_transfer,3276.13
61b703d7d8beac1599eb50e2,50200023535069,243152.56,60ec41ba55c00300382672d9,HDFC,Revenue-PG-split enabled,5eecc6d6449e4f7cfb1c2708,2021-05-14T00:00:00.000Z,NEFT CR-UTIB0001506-RAZORPAY SOFTWARE PR IVATE LIMITED-SLICK ORGANICS PVT LITD-AX ISCN0079025141,insurance,,net_banking_transfer,37477.99
61b703d8d8beac1599eb50e8,50200023535069,43152.56,60ec41ba55c00300382672d9,HDFC,direct expenses,5eecc6d6449e4f7cfb1c2708,2021-05-14T00:00:00.000Z,"NEFT DR-BARC0INBBIR-SHOPIFY COMMERCE IND IA PVT LTD-NETBANK, MUM-N134211504444503 -200000",,,net_banking_transfer,-200000
61b703d9d8beac1599eb50ef,50200023535069,44285.86,60ec41ba55c00300382672d9,HDFC,Revenue-PG-non-split,5eecc6d6449e4f7cfb1c2708,2021-05-14T00:00:00.000Z,NEFT CR-IDFB0010204-SEZZLE PAYMENTS PRIV ATE LIMITED-SLICK ORGANICS PRIVATE LIMIT ED-IDFBH21134441081,insurance,,net_banking_transfer,1133.3
61b703dad8beac1599eb50f6,50200023535069,60762.86,60ec41ba55c00300382672d9,HDFC,Revenue-Mktplace,5eecc6d6449e4f7cfb1c2708,2021-05-14T00:00:00.000Z,NEFT CR-RATN0000999-DREAMPLUG TECHNOLOGI ES PRIVATE LIMI-SLICK ORGANICS PRIVATE L IMITED-000176149257,,,net_banking_transfer,16477
61b703dbd8beac1599eb50fa,50200023535069,61564.42,60ec41ba55c00300382672d9,HDFC,Revenue-Mktplace,5eecc6d6449e4f7cfb1c2708,2021-05-14T00:00:00.000Z,NEFT CR-DEUT0784BBY-TATA UNISTORE LTD-NO DAL-SLICK ORGANICS PVT LTD-051401785GN00 228,insurance,,net_banking_transfer,801.56
61b703dcd8beac1599eb5105,50200023535069,128638.91,60ec41ba55c00300382672d9,HDFC,Revenue-PG-split enabled,5eecc6d6449e4f7cfb1c2708,2021-05-14T00:00:00.000Z,NEFT CR-UTIB0001506-RAZORPAY SOFTWARE PR IVATE LIMITED-SLICK ORGANICS PVT LITD-AX ISCN0079079692,insurance,,net_banking_transfer,67074.49
61b703ddd8beac1599eb510a,50200023535069,1128638.91,60ec41ba55c00300382672d9,HDFC,Internal Transfers,5eecc6d6449e4f7cfb1c2708,2021-05-14T00:00:00.000Z,IB FUNDS TRANSFER CR-50200035187206 -SL ICK ORGANICS PVT LTD,insurance,,Other,1000000
61b703ded8beac1599eb5111,50200023535069,928638.91,60ec41ba55c00300382672d9,HDFC,direct expenses,5eecc6d6449e4f7cfb1c2708,2021-05-14T00:00:00.000Z,"NEFT DR-SCBL0036025-DHRUV MADHOK-NETBANK , MUM-N134211504998729-200000",,,net_banking_transfer,-200000
61b703dfd8beac1599eb5119,50200023535069,728638.91,60ec41ba55c00300382672d9,HDFC,direct expenses,5eecc6d6449e4f7cfb1c2708,2021-05-14T00:00:00.000Z,IMPS-113420101348-DHRUV MADHOK-SCBL-XXXX XXX0749-200000,,,net_banking_transfer,-200000
61b703e0d8beac1599eb5121,50200023535069,818945.46,60ec41ba55c00300382672d9,HDFC,Transfer in/Revenue-other,5eecc6d6449e4f7cfb1c2708,2021-05-15T00:00:00.000Z,IMPS-113505417431-NA-HDFC-XXXXXXXXXX0007,,,net_banking_transfer,90306.55
61b703e1d8beac1599eb5127,50200023535069,826153.7,60ec41ba55c00300382672d9,HDFC,Revenue-PG-split enabled,5eecc6d6449e4f7cfb1c2708,2021-05-15T00:00:00.000Z,NEFT CR-UTIB0001506-RAZORPAY SOFTWARE PR IVATE LIMITED-SLICK ORGANICS PVT LITD-AX ISCN0079086347,insurance,,net_banking_transfer,7208.24
61b703e2d8beac1599eb512d,50200023535069,776153.7,60ec41ba55c00300382672d9,HDFC,direct expenses,5eecc6d6449e4f7cfb1c2708,2021-05-15T00:00:00.000Z,"NEFT DR-SCBL0036025-DHRUV MADHOK-NETBANK , MUM-N135211505128582-50000",,,net_banking_transfer,-50000
61b703e3d8beac1599eb5134,50200023535069,326153.7,60ec41ba55c00300382672d9,HDFC,direct expenses,5eecc6d6449e4f7cfb1c2708,2021-05-15T00:00:00.000Z,02711930004579-TPT-450000-DHRUV BHASIN,,,net_banking_transfer,-450000
61b703e4d8beac1599eb5138,50200023535069,335218,60ec41ba55c00300382672d9,HDFC,Revenue-PG-non-split,5eecc6d6449e4f7cfb1c2708,2021-05-15T00:00:00.000Z,NEFT CR-IDFB0010204-SEZZLE PAYMENTS PRIV ATE LIMITED-SLICK ORGANICS PRIVATE LIMIT ED-IDFBH21135515616,insurance,,net_banking_transfer,9064.3
61b703e5d8beac1599eb513e,50200023535069,357165.41,60ec41ba55c00300382672d9,HDFC,Revenue-PG-split enabled,5eecc6d6449e4f7cfb1c2708,2021-05-15T00:00:00.000Z,NEFT CR-UTIB0001506-RAZORPAY SOFTWARE PR IVATE LIMITED-SLICK ORGANICS PVT LITD-AX ISCN0079146684,insurance,,net_banking_transfer,21947.41
61b703e6d8beac1599eb5141,50200023535069,354687.41,60ec41ba55c00300382672d9,HDFC,direct expenses,5eecc6d6449e4f7cfb1c2708,2021-05-15T00:00:00.000Z,POS 514834XXXXXX9486 RAZ*KNOWLARITY,,,debit_card,-2478
61b703e7d8beac1599eb5147,50200023535069,372149.68,60ec41ba55c00300382672d9,HDFC,Transfer in/Revenue-other,5eecc6d6449e4f7cfb1c2708,2021-05-16T00:00:00.000Z,IMPS-113605065441-NA-HDFC-XXXXXXXXXX0007 -ALL20210516216820000330830668628,,,net_banking_transfer,17462.27
61b703e8d8beac1599eb514c,50200023535069,389722.21,60ec41ba55c00300382672d9,HDFC,Transfer in/Revenue-other,5eecc6d6449e4f7cfb1c2708,2021-05-17T00:00:00.000Z,IMPS-113705699871-NA-HDFC-XXXXXXXXXX0007 -ALL20210517216820000330830668628,,,net_banking_transfer,17572.53
61b703e9d8beac1599eb5152,50200023535069,335372.21,60ec41ba55c00300382672d9,HDFC,direct expenses,5eecc6d6449e4f7cfb1c2708,2021-05-17T00:00:00.000Z,"NEFT DR-ICIC0000369-BO INTERNATIONAL-NET BANK, MUM-N137211506023558-54350",,,net_banking_transfer,-54350
61b703ead8beac1599eb5159,50200023535069,435372.21,60ec41ba55c00300382672d9,HDFC,Internal Transfers,5eecc6d6449e4f7cfb1c2708,2021-05-17T00:00:00.000Z,IB FUNDS TRANSFER CR-50200035187206 -SL ICK ORGANICS PVT LTD,insurance,,Other,100000
61b703ebd8beac1599eb515d,50200023535069,79121.21,60ec41ba55c00300382672d9,HDFC,direct expenses,5eecc6d6449e4f7cfb1c2708,2021-05-17T00:00:00.000Z,"NEFT DR-YESB0000551-VISTTA COSMETICS-NET BANK, MUM-N137211506036147-356251",,,net_banking_transfer,-356251
61b703ecd8beac1599eb5163,50200023535069,100522.92,60ec41ba55c00300382672d9,HDFC,Revenue-Mktplace,5eecc6d6449e4f7cfb1c2708,2021-05-17T00:00:00.000Z,NEFT CR-DEUT0797BGL-FLIPKART INTERNET PR IVATE LIMITED-SLICK ORGANICS PVT LTD-051 700136GN00156,shopping,,net_banking_transfer,21401.71
61b703edd8beac1599eb516c,50200023535069,109965.88,60ec41ba55c00300382672d9,HDFC,Revenue-PG-split enabled,5eecc6d6449e4f7cfb1c2708,2021-05-17T00:00:00.000Z,NEFT CR-UTIB0001506-RAZORPAY SOFTWARE PR IVATE LIMITED-SLICK ORGANICS PVT LITD-AX ISCN0079164290,insurance,,net_banking_transfer,9442.96
61b703eed8beac1599eb5170,50200023535069,114137.86,60ec41ba55c00300382672d9,HDFC,Revenue-Mktplace,5eecc6d6449e4f7cfb1c2708,2021-05-17T00:00:00.000Z,NEFT CR-DEUT0797BGL-MYNTRA DESIGNS PRIVA,shopping,,net_banking_transfer,4171.98
61b703efd8beac1599eb5176,50200023535069,117241.88,60ec41ba55c00300382672d9,HDFC,Revenue-Mktplace,5eecc6d6449e4f7cfb1c2708,2021-05-17T00:00:00.000Z,NEFT CR-DEUT0797BGL-MYNTRA DESIGNS PRIVA TE LIMITED-SLICK ORGANICS PRIVATE LIMITE D-051700293GN00272,shopping,,net_banking_transfer,3104.02
61b703f0d8beac1599eb517c,50200023535069,117093.08,60ec41ba55c00300382672d9,HDFC,bank charges,5eecc6d6449e4f7cfb1c2708,2021-05-17T00:00:00.000Z,.DC INTL POS TXN MARKUP+ST 120521 140521 -CDT2112804190988,,,international_transaction_arbitrage,-148.8
61b703f1d8beac1599eb5181,50200023535069,118806.08,60ec41ba55c00300382672d9,HDFC,Revenue-Mktplace,5eecc6d6449e4f7cfb1c2708,2021-05-17T00:00:00.000Z,NEFT CR-KKBK0000958-SURFBOATS SOLUTIONS PVT LTD-SLICK ORGANICS PRIVATE LIMITED-K KBK211375087060,insurance,,net_banking_transfer,1713
61b703f2d8beac1599eb5187,50200023535069,125892.41,60ec41ba55c00300382672d9,HDFC,Revenue-Mktplace,5eecc6d6449e4f7cfb1c2708,2021-05-17T00:00:00.000Z,NEFT CR-DEUT0797BGL-FLIPKART INTERNET PR IVATE LIMITED-SLICK ORGANICS PVT LTD-051 400067GN00079,shopping,,net_banking_transfer,7086.33
61b703f3d8beac1599eb518d,50200023535069,136949.93,60ec41ba55c00300382672d9,HDFC,Revenue-Mktplace,5eecc6d6449e4f7cfb1c2708,2021-05-17T00:00:00.000Z,NEFT CR-DEUT0797BGL-FLIPKART INTERNET PR IVATE LIMITED-SLICK ORGANICS PVT LTD-051 700071GN00291,shopping,,net_banking_transfer,11057.52
61b703f4d8beac1599eb5193,50200023535069,86949.93,60ec41ba55c00300382672d9,HDFC,Marketing Expense,5eecc6d6449e4f7cfb1c2708,2021-05-17T00:00:00.000Z,POS 514834XXXXXX9486 GOOGLE ADS,,,debit_card,-50000
61b703f5d8beac1599eb5198,50200023535069,80101.93,60ec41ba55c00300382672d9,HDFC,direct expenses,5eecc6d6449e4f7cfb1c2708,2021-05-17T00:00:00.000Z,"NEFT DR-KKBK0000180-VEDIC COSMECEUTICALS PVT LTD-NETBANK, MUM-N137211506568634-6 848",,,net_banking_transfer,-6848
61b703f6d8beac1599eb519e,50200023535069,163219.04,60ec41ba55c00300382672d9,HDFC,Revenue-COD,5eecc6d6449e4f7cfb1c2708,2021-05-17T00:00:00.000Z,NEFT CR-ICIC0000155-SHIPROCKET COD CRF I D 2443213-SLICK ORGANICS PVT LTD-CMS1947 140032,insurance,,net_banking_transfer,83117.11
61b703f7d8beac1599eb51a5,50200023535069,165518.49,60ec41ba55c00300382672d9,HDFC,Revenue-Mktplace,5eecc6d6449e4f7cfb1c2708,2021-05-17T00:00:00.000Z,NEFT CR-ICIC0000105-MANASH LIFETYLE PVT LTD-SLICKORGANICSPRIVATELIMITEDMPMUM-ICI B211370039286,,,net_banking_transfer,2299.45
61b703f8d8beac1599eb51a9,50200023535069,170469.22,60ec41ba55c00300382672d9,HDFC,Revenue-Mktplace,5eecc6d6449e4f7cfb1c2708,2021-05-17T00:00:00.000Z,NEFT CR-ICIC0000105-MANASH LIFETYLE PVT LTD-SLICKORGANICSPRIVATELIMITEDMPGGN-ICI B211370039284,,,net_banking_transfer,4950.73
61b703f9d8beac1599eb51ae,50200023535069,175813.12,60ec41ba55c00300382672d9,HDFC,Revenue-COD,5eecc6d6449e4f7cfb1c2708,2021-05-17T00:00:00.000Z,NEFT CR-ICIC0000155-SHIPROCKET COD CRF I D 2451417-SLICK ORGANICS PVT LTD-CMS1947 154515,insurance,,net_banking_transfer,5343.9
61b703fad8beac1599eb51b2,50200023535069,189997.94,60ec41ba55c00300382672d9,HDFC,Revenue-PG-split enabled,5eecc6d6449e4f7cfb1c2708,2021-05-17T00:00:00.000Z,NEFT CR-UTIB0001506-RAZORPAY SOFTWARE PR,,,net_banking_transfer,14184.82
61b703fad8beac1599eb51b6,50200023535069,192746.91,60ec41ba55c00300382672d9,HDFC,Revenue-PG-non-split,5eecc6d6449e4f7cfb1c2708,2021-05-17T00:00:00.000Z,NEFT CR-IDFB0010204-SEZZLE PAYMENTS PRIV ATE LIMITED-SLICK ORGANICS PRIVATE LIMIT ED-IDFBH21137582363,insurance,,net_banking_transfer,2748.97
61b703fbd8beac1599eb51bb,50200023535069,193213.36,60ec41ba55c00300382672d9,HDFC,Revenue-PG-non-split,5eecc6d6449e4f7cfb1c2708,2021-05-17T00:00:00.000Z,NEFT CR-ICIC0000031-PAYTM E COMMERCE PVT LTD-SLICK ORGANICS PVT LTD-CMS194736109 4,ewallet,,net_banking_transfer,466.45
61b703fcd8beac1599eb51c2,50200023535069,168213.36,60ec41ba55c00300382672d9,HDFC,direct expenses,5eecc6d6449e4f7cfb1c2708,2021-05-17T00:00:00.000Z,"NEFT DR-YESB0000162-VINAY REDDY-NETBANK, MUM-N137211506844069-25000",,,net_banking_transfer,-25000
61b703fdd8beac1599eb51c9,50200023535069,189710.61,60ec41ba55c00300382672d9,HDFC,Transfer in/Revenue-other,5eecc6d6449e4f7cfb1c2708,2021-05-18T00:00:00.000Z,IMPS-113805532852-NA-HDFC-XXXXXXXXXX0007 -ALL20210518216820000330830668628,,,net_banking_transfer,21497.25
61b703fed8beac1599eb51ce,50200023535069,192309.93,60ec41ba55c00300382672d9,HDFC,Revenue-PG-split enabled,5eecc6d6449e4f7cfb1c2708,2021-05-18T00:00:00.000Z,NEFT CR-UTIB0001506-RAZORPAY SOFTWARE PR IVATE LIMITED-SLICK ORGANICS PVT LITD-AX ISCN0079258431,insurance,,net_banking_transfer,2599.32
61b703ffd8beac1599eb51d1,50200023535069,193753.79,60ec41ba55c00300382672d9,HDFC,Revenue-Mktplace,5eecc6d6449e4f7cfb1c2708,2021-05-18T00:00:00.000Z,IMPS-113811029259-AMAZON SELLER SERVIC-H DFC-XXXXXXXX6004-581OW3G44W3WMEUZSLICK O RGANICS PVT LTD,shopping,,net_banking_transfer,1443.86
61b70400d8beac1599eb51d5,50200023535069,649791.7,60ec41ba55c00300382672d9,HDFC,Revenue-Mktplace,5eecc6d6449e4f7cfb1c2708,2021-05-18T00:00:00.000Z,NEFT CR-DEUT0797BGL-AMAZON PAY (INDIA) P RIVATE LIMITED-SLICK ORGANICS PVT LTD-05 1800152GN00019,shopping,,net_banking_transfer,456037.91
61b70401d8beac1599eb51dd,50200023535069,653085.58,60ec41ba55c00300382672d9,HDFC,Revenue-PG-non-split,5eecc6d6449e4f7cfb1c2708,2021-05-18T00:00:00.000Z,NEFT CR-IDFB0010204-SEZZLE PAYMENTS PRIV ATE LIMITED-SLICK ORGANICS PRIVATE LIMIT ED-IDFBH21138613118,insurance,,net_banking_transfer,3293.88
61b70402d8beac1599eb51e0,50200023535069,690292.49,60ec41ba55c00300382672d9,HDFC,Revenue-PG-split enabled,5eecc6d6449e4f7cfb1c2708,2021-05-18T00:00:00.000Z,NEFT CR-UTIB0001506-RAZORPAY SOFTWARE PR IVATE LIMITED-SLICK ORGANICS PVT LITD-AX ISCN0079338972,insurance,,net_banking_transfer,37206.91
61b70403d8beac1599eb51e6,50200023535069,690751.94,60ec41ba55c00300382672d9,HDFC,Revenue-Mktplace,5eecc6d6449e4f7cfb1c2708,2021-05-18T00:00:00.000Z,NEFT CR-ICIC0000104-GOQII TECHNOLOGIES P VT LTD-SLICK ORGANICS PRIVATE LIMITED-CM S1948494530,,,net_banking_transfer,459.45
61b70404d8beac1599eb51e8,50200023535069,692798.5,60ec41ba55c00300382672d9,HDFC,Revenue-Mktplace,5eecc6d6449e4f7cfb1c2708,2021-05-18T00:00:00.000Z,NEFT CR-ICIC0000105-MANASH LIFETYLE PVT,,,net_banking_transfer,2046.56
61b70405d8beac1599eb51ee,50200023535069,695157.31,60ec41ba55c00300382672d9,HDFC,Revenue-Mktplace,5eecc6d6449e4f7cfb1c2708,2021-05-18T00:00:00.000Z,NEFT CR-ICIC0000105-MANASH LIFETYLE PVT LTD-SLICKORGANICSPRIVATELIMITEDMPGGN-ICI B211380059571,,,net_banking_transfer,2358.81
61b70406d8beac1599eb51f4,50200023535069,697138.63,60ec41ba55c00300382672d9,HDFC,Revenue-Mktplace,5eecc6d6449e4f7cfb1c2708,2021-05-18T00:00:00.000Z,NEFT CR-ICIC0000105-MANASH LIFETYLE PVT LTD-SLICKORGANICSPRIVATELIMITEDMPMUM-ICI B211380059439,,,net_banking_transfer,1981.32
61b70407d8beac1599eb51fb,50200023535069,750101.95,60ec41ba55c00300382672d9,HDFC,Transfer in/Revenue-other,5eecc6d6449e4f7cfb1c2708,2021-05-19T00:00:00.000Z,IMPS-113905279250-NA-HDFC-XXXXXXXXXX0007 -ALL20210519216820000330830668628,,,net_banking_transfer,52963.32
61b70408d8beac1599eb51ff,50200023535069,766028.35,60ec41ba55c00300382672d9,HDFC,Revenue-Mktplace,5eecc6d6449e4f7cfb1c2708,2021-05-19T00:00:00.000Z,NEFT CR-DEUT0797BGL-FLIPKART INTERNET PR IVATE LIMITED-SLICK ORGANICS PVT LTD-051 900181GN00019,shopping,,net_banking_transfer,15926.4
61b70409d8beac1599eb5204,50200023535069,767547.5,60ec41ba55c00300382672d9,HDFC,Revenue-Mktplace,5eecc6d6449e4f7cfb1c2708,2021-05-19T00:00:00.000Z,NEFT CR-DEUT0797BGL-MYNTRA DESIGNS PRIVA TE LIMITED-SLICK ORGANICS PRIVATE LIMITE D-051900337GN00149,shopping,,net_banking_transfer,1519.15
61b7040ad8beac1599eb5207,50200023535069,769992.92,60ec41ba55c00300382672d9,HDFC,Revenue-PG-split enabled,5eecc6d6449e4f7cfb1c2708,2021-05-19T00:00:00.000Z,NEFT CR-UTIB0001506-RAZORPAY SOFTWARE PR IVATE LIMITED-SLICK ORGANICS PVT LITD-AX ISCN0079362639,insurance,,net_banking_transfer,2445.42
61b7040bd8beac1599eb520f,50200023535069,770634.67,60ec41ba55c00300382672d9,HDFC,Revenue-Mktplace,5eecc6d6449e4f7cfb1c2708,2021-05-19T00:00:00.000Z,NEFT CR-DEUT0797BGL-MYNTRA DESIGNS PRIVA TE LIMITED-SLICK ORGANICS PRIVATE LIMITE D-051900335GN00033,shopping,,net_banking_transfer,641.75
61b7040cd8beac1599eb5213,50200023535069,842885.69,60ec41ba55c00300382672d9,HDFC,Revenue-COD,5eecc6d6449e4f7cfb1c2708,2021-05-19T00:00:00.000Z,NEFT CR-ICIC0000155-SHIPROCKET COD CRF I D 2463734-SLICK ORGANICS PVT LTD-CMS1949 327644,insurance,,net_banking_transfer,72251.02
61b7040dd8beac1599eb5237,50200023535069,707948.69,60ec41ba55c00300382672d9,HDFC,direct expenses,5eecc6d6449e4f7cfb1c2708,2021-05-19T00:00:00.000Z,"NEFT DR-INDB0000333-NOASTRIX PRIVATE LIM ITED-NETBANK, MUM-N139211508642326-13493 7",,,net_banking_transfer,-134937
61b7040ed8beac1599eb523b,50200023535069,725401.59,60ec41ba55c00300382672d9,HDFC,Revenue-PG-split enabled,5eecc6d6449e4f7cfb1c2708,2021-05-19T00:00:00.000Z,NEFT CR-UTIB0001506-RAZORPAY SOFTWARE PR IVATE LIMITED-SLICK ORGANICS PVT LITD-AX ISCN0079419631,insurance,,net_banking_transfer,17452.9
61b7040fd8beac1599eb523f,50200023535069,726369.91,60ec41ba55c00300382672d9,HDFC,Revenue-Mktplace,5eecc6d6449e4f7cfb1c2708,2021-05-19T00:00:00.000Z,NEFT CR-ICIC0000105-MANASH LIFETYLE PVT,,,net_banking_transfer,968.32
61b70410d8beac1599eb5245,50200023535069,726453.47,60ec41ba55c00300382672d9,HDFC,Revenue-Mktplace,5eecc6d6449e4f7cfb1c2708,2021-05-19T00:00:00.000Z,NEFT CR-ICIC0000105-MANASH LIFETYLE PVT LTD-SLICKORGANICSPRIVATELIMITEDMPMUM-ICI B211390041086,,,net_banking_transfer,83.56
61b70411d8beac1599eb524b,50200023535069,726919.66,60ec41ba55c00300382672d9,HDFC,Revenue-Mktplace,5eecc6d6449e4f7cfb1c2708,2021-05-19T00:00:00.000Z,NEFT CR-ICIC0000105-MANASH LIFETYLE PVT LTD-DSSLICKORGANICSPRIVATELIMITED-ICIB21 1390041164,insurance,,net_banking_transfer,466.19
61b70412d8beac1599eb5252,50200023535069,755437.09,60ec41ba55c00300382672d9,HDFC,Transfer in/Revenue-other,5eecc6d6449e4f7cfb1c2708,2021-05-20T00:00:00.000Z,IMPS-114005056994-NA-HDFC-XXXXXXXXXX0007 -ALL20210520216820000330830668628,,,net_banking_transfer,28517.43
61b70413d8beac1599eb5256,50200023535069,755639.15,60ec41ba55c00300382672d9,HDFC,Revenue-PG-split enabled,5eecc6d6449e4f7cfb1c2708,2021-05-20T00:00:00.000Z,NEFT CR-UTIB0001506-RAZORPAY SOFTWARE PR IVATE LIMITED-SLICK ORGANICS PVT LITD-AX ISCN0079446388,insurance,,net_banking_transfer,202.06
61b70413d8beac1599eb5259,50200023535069,750511.44,60ec41ba55c00300382672d9,HDFC,direct expenses,5eecc6d6449e4f7cfb1c2708,2021-05-20T00:00:00.000Z,POS 514834XXXXXX9486 FEEDBACKFIVE,,,debit_card,-5127.71
61b70414d8beac1599eb525f,50200023535069,850511.44,60ec41ba55c00300382672d9,HDFC,Internal Transfers,5eecc6d6449e4f7cfb1c2708,2021-05-20T00:00:00.000Z,IB FUNDS TRANSFER CR-50200035187206 -SL ICK ORGANICS PVT LTD,insurance,,Other,100000
61b70415d8beac1599eb526b,50200023535069,851341.94,60ec41ba55c00300382672d9,HDFC,Revenue-Mktplace,5eecc6d6449e4f7cfb1c2708,2021-05-20T00:00:00.000Z,NEFT CR-ICIC0000105-MANASH LIFETYLE PVT LTD-SLICK ORGANICS PRIVATE LIMITED MP GGN-ICIB211400022816,,,net_banking_transfer,830.5
61b70416d8beac1599eb5271,50200023535069,852288.99,60ec41ba55c00300382672d9,HDFC,Revenue-Mktplace,5eecc6d6449e4f7cfb1c2708,2021-05-20T00:00:00.000Z,NEFT CR-ICIC0000105-MANASH LIFETYLE PVT LTD-SLICK ORGANICS PRIVATE LIMITED MP MUM-ICIB211400022817,,,net_banking_transfer,947.05
61b70417d8beac1599eb5277,50200023535069,852580.71,60ec41ba55c00300382672d9,HDFC,Revenue-Mktplace,5eecc6d6449e4f7cfb1c2708,2021-05-20T00:00:00.000Z,NEFT CR-ICIC0000105-MANASH LIFETYLE PVT LTD-DS SLICK ORGANICS PRIVATE LIMITED- ICIB211400022764,insurance,,net_banking_transfer,291.72
61b70418d8beac1599eb527a,50200023535069,873333.14,60ec41ba55c00300382672d9,HDFC,Revenue-PG-split enabled,5eecc6d6449e4f7cfb1c2708,2021-05-20T00:00:00.000Z,NEFT CR-UTIB0001506-RAZORPAY SOFTWARE PR IVATE LIMITED-SLICK ORGANICS PVT LITD-AX ISCN0079500597,insurance,,net_banking_transfer,20752.43
61b70419d8beac1599eb5280,50200023535069,866079.01,60ec41ba55c00300382672d9,HDFC,direct expenses,5eecc6d6449e4f7cfb1c2708,2021-05-20T00:00:00.000Z,POS 514834XXXXXX9486 HOTJAR,,,debit_card,-7254.13
61b7041ad8beac1599eb5288,50200023535069,766079.01,60ec41ba55c00300382672d9,HDFC,SAAS/tech expense,5eecc6d6449e4f7cfb1c2708,2021-05-20T00:00:00.000Z,POS 514834XXXXXX9486 AMAZON,shopping,,debit_card,-100000
61b7041bd8beac1599eb528f,50200023535069,796680.42,60ec41ba55c00300382672d9,HDFC,Transfer in/Revenue-other,5eecc6d6449e4f7cfb1c2708,2021-05-21T00:00:00.000Z,IMPS-114106850473-NA-HDFC-XXXXXXXXXX0007 -ALL20210521216820000330830668628,,,net_banking_transfer,30601.41
61b7041cd8beac1599eb5293,50200023535069,746680.42,60ec41ba55c00300382672d9,HDFC,Marketing Expense,5eecc6d6449e4f7cfb1c2708,2021-05-21T00:00:00.000Z,POS 514834XXXXXX9486 GOOGLE ADS,,,debit_card,-50000
61b7041dd8beac1599eb5297,50200023535069,774385.69,60ec41ba55c00300382672d9,HDFC,Revenue-Mktplace,5eecc6d6449e4f7cfb1c2708,2021-05-21T00:00:00.000Z,NEFT CR-DEUT0797BGL-FLIPKART INTERNET PR IVATE LIMITED-SLICK ORGANICS PVT LTD-052 100152GN00052,shopping,,net_banking_transfer,27705.27
61b7041ed8beac1599eb52a1,50200023535069,791668.44,60ec41ba55c00300382672d9,HDFC,Revenue-PG-split enabled,5eecc6d6449e4f7cfb1c2708,2021-05-21T00:00:00.000Z,NEFT CR-UTIB0001506-RAZORPAY SOFTWARE PR IVATE LIMITED-SLICK ORGANICS PVT LITD-AX ISCN0079525037,insurance,,net_banking_transfer,17282.75
61b7041fd8beac1599eb52ad,50200023535069,794566.17,60ec41ba55c00300382672d9,HDFC,Revenue-Mktplace,5eecc6d6449e4f7cfb1c2708,2021-05-21T00:00:00.000Z,NEFT CR-DEUT0797BGL-MYNTRA DESIGNS PRIVA TE LIMITED-SLICK ORGANICS PRIVATE LIMITE D-052100307GN00176,shopping,,net_banking_transfer,2897.73
61b70420d8beac1599eb52b0,50200023535069,799244.19,60ec41ba55c00300382672d9,HDFC,Revenue-Mktplace,5eecc6d6449e4f7cfb1c2708,2021-05-21T00:00:00.000Z,NEFT CR-DEUT0797BGL-MYNTRA DESIGNS PRIVA TE LIMITED-SLICK ORGANICS PRIVATE LIMITE D-052100309GN00267,shopping,,net_banking_transfer,4678.02
61b70421d8beac1599eb52b8,50200023535069,801513.04,60ec41ba55c00300382672d9,HDFC,Revenue-PG-non-split,5eecc6d6449e4f7cfb1c2708,2021-05-21T00:00:00.000Z,NEFT CR-IDFB0010204-SEZZLE PAYMENTS PRIV ATE LIMITED-SLICK ORGANICS PRIVATE LIMIT ED-IDFBH21141713371,insurance,,net_banking_transfer,2268.85
61b70422d8beac1599eb52ba,50200023535069,802997.08,60ec41ba55c00300382672d9,HDFC,Revenue-PG-non-split,5eecc6d6449e4f7cfb1c2708,2021-05-21T00:00:00.000Z,NEFT CR-IDFB0010204-SEZZLE PAYMENTS PRIV ATE LIMITED-SLICK ORGANICS PRIVATE LIMIT ED-IDFBH21141713470,insurance,,net_banking_transfer,1484.04
61b70423d8beac1599eb52bf,50200023535069,806879.52,60ec41ba55c00300382672d9,HDFC,Revenue-Mktplace,5eecc6d6449e4f7cfb1c2708,2021-05-21T00:00:00.000Z,NEFT CR-DEUT0797BGL-FLIPKART INTERNET PR IVATE LIMITED-SLICK ORGANICS PVT LTD-052 100077GN00044,shopping,,net_banking_transfer,3882.44
61b70424d8beac1599eb52c6,50200023535069,834621.55,60ec41ba55c00300382672d9,HDFC,Revenue-PG-split enabled,5eecc6d6449e4f7cfb1c2708,2021-05-21T00:00:00.000Z,NEFT CR-UTIB0001506-RAZORPAY SOFTWARE PR IVATE LIMITED-SLICK ORGANICS PVT LITD-AX ISCN0079587887,insurance,,net_banking_transfer,27742.03
61b70425d8beac1599eb52d5,50200023535069,835049.7,60ec41ba55c00300382672d9,HDFC,Revenue-PG-non-split,5eecc6d6449e4f7cfb1c2708,2021-05-21T00:00:00.000Z,NEFT CR-IDFB0010204-SEZZLE PAYMENTS PRIV ATE LIMITED-SLICK ORGANICS PRIVATE LIMIT ED-IDFBH21141726426,insurance,,net_banking_transfer,428.15
61b70426d8beac1599eb52d8,50200023535069,902329.05,60ec41ba55c00300382672d9,HDFC,Revenue-COD,5eecc6d6449e4f7cfb1c2708,2021-05-21T00:00:00.000Z,NEFT CR-KKBK0000958-BIGFOOT RETAIL SOLUT IONS PRIVATE LIMITED-SLICK ORGANICS PVT LTD-KKBK211415992253,,,net_banking_transfer,67279.35
61b70427d8beac1599eb52dc,50200023535069,940158.77,60ec41ba55c00300382672d9,HDFC,Transfer in/Revenue-other,5eecc6d6449e4f7cfb1c2708,2021-05-22T00:00:00.000Z,IMPS-114206605143-NA-HDFC-XXXXXXXXXX0007,,,net_banking_transfer,37829.72
61b70428d8beac1599eb52e1,50200023535069,941415.9,60ec41ba55c00300382672d9,HDFC,Transfer in/Revenue-other,5eecc6d6449e4f7cfb1c2708,2021-05-22T00:00:00.000Z,FT - C72659220521131004 - - 50200050045 240 - ZOOBOP ME WORKS PRIVATE LIMITED,,,Other,1257.13
61b70429d8beac1599eb52eb,50200023535069,686415.9,60ec41ba55c00300382672d9,HDFC,SAAS/tech expense,5eecc6d6449e4f7cfb1c2708,2021-05-22T00:00:00.000Z,POS 514834XXXXXX9486 AMAZON,shopping,,debit_card,-255000
61b7042ad8beac1599eb52ef,50200023535069,586415.9,60ec41ba55c00300382672d9,HDFC,SAAS/tech expense,5eecc6d6449e4f7cfb1c2708,2021-05-22T00:00:00.000Z,POS 514834XXXXXX9486 AMAZON,shopping,,debit_card,-100000
61b7042bd8beac1599eb52fa,50200023535069,607149.32,60ec41ba55c00300382672d9,HDFC,Transfer in/Revenue-other,5eecc6d6449e4f7cfb1c2708,2021-05-23T00:00:00.000Z,IMPS-114305284836-NA-HDFC-XXXXXXXXXX0007 -ALL20210523216820000330830668628,,,net_banking_transfer,20733.42
61b7042cd8beac1599eb52fe,50200023535069,557149.32,60ec41ba55c00300382672d9,HDFC,Marketing Expense,5eecc6d6449e4f7cfb1c2708,2021-05-23T00:00:00.000Z,POS 514834XXXXXX9486 GOOGLE ADS,,,debit_card,-50000
61b7042dd8beac1599eb5302,50200023535069,595210.11,60ec41ba55c00300382672d9,HDFC,Transfer in/Revenue-other,5eecc6d6449e4f7cfb1c2708,2021-05-24T00:00:00.000Z,IMPS-114405046634-NA-HDFC-XXXXXXXXXX0007 -ALL20210524216820000330830668628,,,net_banking_transfer,38060.79
61b7042ed8beac1599eb5309,50200023535069,597037.06,60ec41ba55c00300382672d9,HDFC,Revenue-Mktplace,5eecc6d6449e4f7cfb1c2708,2021-05-24T00:00:00.000Z,NEFT CR-DEUT0797BGL-MYNTRA DESIGNS PRIVA TE LIMITED-SLICK ORGANICS PRIVATE LIMITE D-052400109GN00285,shopping,,net_banking_transfer,1826.95
61b7042fd8beac1599eb530e,50200023535069,604961.74,60ec41ba55c00300382672d9,HDFC,Revenue-Mktplace,5eecc6d6449e4f7cfb1c2708,2021-05-24T00:00:00.000Z,NEFT CR-DEUT0797BGL-MYNTRA DESIGNS PRIVA TE LIMITED-SLICK ORGANICS PRIVATE LIMITE D-052400110GN00071,shopping,,net_banking_transfer,7924.68
61b70430d8beac1599eb5315,50200023535069,655985.88,60ec41ba55c00300382672d9,HDFC,Revenue-PG-split enabled,5eecc6d6449e4f7cfb1c2708,2021-05-24T00:00:00.000Z,NEFT CR-UTIB0001506-RAZORPAY SOFTWARE PR IVATE LIMITED-SLICK ORGANICS PVT LITD-AX ISCN0079628656,insurance,,net_banking_transfer,51024.14
61b70431d8beac1599eb5318,50200023535069,656731.8,60ec41ba55c00300382672d9,HDFC,Transfer in/Revenue-other,5eecc6d6449e4f7cfb1c2708,2021-05-24T00:00:00.000Z,ZOOBOP ME WORK-ARATA,,,Other,745.92
61b70432d8beac1599eb531c,50200023535069,656520.03,60ec41ba55c00300382672d9,HDFC,bank charges,5eecc6d6449e4f7cfb1c2708,2021-05-24T00:00:00.000Z,.DC INTL POS TXN MARKUP+ST 190521 210521 -CDT2112804190988,,,international_transaction_arbitrage,-211.77
61b70433d8beac1599eb5325,50200023535069,664201.38,60ec41ba55c00300382672d9,HDFC,Revenue-Mktplace,5eecc6d6449e4f7cfb1c2708,2021-05-24T00:00:00.000Z,NEFT CR-DEUT0797BGL-FLIPKART INTERNET PR IVATE LIMITED-SLICK ORGANICS PVT LTD-052 400272GN00081,shopping,,net_banking_transfer,7681.35
61b70434d8beac1599eb5332,50200023535069,666381.29,60ec41ba55c00300382672d9,HDFC,Revenue-PG-non-split,5eecc6d6449e4f7cfb1c2708,2021-05-24T00:00:00.000Z,NEFT CR-IDFB0010204-SEZZLE PAYMENTS PRIV ATE LIMITED-SLICK ORGANICS PRIVATE LIMIT ED-IDFBH21144765521,insurance,,net_banking_transfer,2179.91
61b70435d8beac1599eb533b,50200023535069,695733.58,60ec41ba55c00300382672d9,HDFC,Revenue-COD,5eecc6d6449e4f7cfb1c2708,2021-05-24T00:00:00.000Z,NEFT CR-KKBK0000958-BIGFOOT RETAIL SOLUT IONS PRIVATE LIMITED-SLICK ORGANICS PVT LTD-KKBK211446387593,,,net_banking_transfer,29352.29
61b70436d8beac1599eb534f,50200023535069,695879.44,60ec41ba55c00300382672d9,HDFC,Revenue-Mktplace,5eecc6d6449e4f7cfb1c2708,2021-05-24T00:00:00.000Z,NEFT CR-ICIC0000105-MANASH LIFETYLE PVT,,,net_banking_transfer,145.86
61b70436d8beac1599eb535b,50200023535069,696229.82,60ec41ba55c00300382672d9,HDFC,Revenue-Mktplace,5eecc6d6449e4f7cfb1c2708,2021-05-24T00:00:00.000Z,NEFT CR-ICIC0000105-MANASH LIFETYLE PVT LTD-DS SLICK ORGANICS PVT LTD-ICIB21144 0032395,insurance,,net_banking_transfer,350.38
61b70437d8beac1599eb5367,50200023535069,679398.82,60ec41ba55c00300382672d9,HDFC,direct expenses,5eecc6d6449e4f7cfb1c2708,2021-05-24T00:00:00.000Z,50100097355028-TPT-16831-PALLAVI JUNEJA,,,net_banking_transfer,-16831
61b70438d8beac1599eb5376,50200023535069,696883.53,60ec41ba55c00300382672d9,HDFC,Revenue-PG-split enabled,5eecc6d6449e4f7cfb1c2708,2021-05-24T00:00:00.000Z,NEFT CR-UTIB0001506-RAZORPAY SOFTWARE PR IVATE LIMITED-SLICK ORGANICS PVT LITD-AX ISCN0079710783,insurance,,net_banking_transfer,17484.71
61b70439d8beac1599eb5380,50200023535069,698785.5,60ec41ba55c00300382672d9,HDFC,Revenue-PG-non-split,5eecc6d6449e4f7cfb1c2708,2021-05-24T00:00:00.000Z,NEFT CR-ICIC0000031-PAYTM E COMMERCE PVT LTD-SLICK ORGANICS PVT LTD-CMS195351503 0,ewallet,,net_banking_transfer,1901.97
61b7043ad8beac1599eb5387,50200023535069,723894.92,60ec41ba55c00300382672d9,HDFC,Transfer in/Revenue-other,5eecc6d6449e4f7cfb1c2708,2021-05-25T00:00:00.000Z,IMPS-114505763396-NA-HDFC-XXXXXXXXXX0007 -ALL20210525216820000330830668628,,,net_banking_transfer,25109.42
61b7043bd8beac1599eb5394,50200023535069,719833.92,60ec41ba55c00300382672d9,HDFC,direct expenses,5eecc6d6449e4f7cfb1c2708,2021-05-25T00:00:00.000Z,POS 514834XXXXXX9486 PAYU*GROFERS IND,groceries,,debit_card,-4061
61b7043cd8beac1599eb5398,50200023535069,722075.72,60ec41ba55c00300382672d9,HDFC,Revenue-PG-split enabled,5eecc6d6449e4f7cfb1c2708,2021-05-25T00:00:00.000Z,NEFT CR-UTIB0001506-RAZORPAY SOFTWARE PR IVATE LIMITED-SLICK ORGANICS PVT LITD-AX ISCN0079736598,insurance,,net_banking_transfer,2241.8
61b7043dd8beac1599eb53a3,50200023535069,1214811.53,60ec41ba55c00300382672d9,HDFC,Revenue-Mktplace,5eecc6d6449e4f7cfb1c2708,2021-05-25T00:00:00.000Z,NEFT CR-DEUT0797BGL-AMAZON PAY (INDIA) P RIVATE LIMITED-SLICK ORGANICS PVT LTD-05 2500147GN00267,shopping,,net_banking_transfer,492735.81
61b7043ed8beac1599eb53a6,50200023535069,1225175.1,60ec41ba55c00300382672d9,HDFC,Revenue-PG-non-split,5eecc6d6449e4f7cfb1c2708,2021-05-25T00:00:00.000Z,NEFT CR-IDFB0010204-SEZZLE PAYMENTS PRIV ATE LIMITED-SLICK ORGANICS PRIVATE LIMIT ED-IDFBH21145795322,insurance,,net_banking_transfer,10363.57
61b7043fd8beac1599eb53b1,50200023535069,1237075.1,60ec41ba55c00300382672d9,HDFC,Revenue-Mktplace,5eecc6d6449e4f7cfb1c2708,2021-05-25T00:00:00.000Z,NEFT CR-SCBL0036001-M/S DREAMPLUG TECHNO -SLICK ORGANICS PRIVATE LIMITEDSLICK-SIN 31436Q0013905,insurance,,net_banking_transfer,11900
61b70440d8beac1599eb53b7,50200023535069,1262930.57,60ec41ba55c00300382672d9,HDFC,Revenue-PG-split enabled,5eecc6d6449e4f7cfb1c2708,2021-05-25T00:00:00.000Z,NEFT CR-UTIB0001506-RAZORPAY SOFTWARE PR IVATE LIMITED-SLICK ORGANICS PVT LITD-AX ISCN0079803314,insurance,,net_banking_transfer,25855.47
61b70441d8beac1599eb53c0,50200023535069,1263255.57,60ec41ba55c00300382672d9,HDFC,Transfer in/Revenue-other,5eecc6d6449e4f7cfb1c2708,2021-05-26T00:00:00.000Z,NEFT CR-ICIC0SF0002-EARTH LOVE ECOMMERCE -SLICK ORGANICS PVT LTD-24228264761DC,,,net_banking_transfer,325
61b70442d8beac1599eb53ca,50200023535069,1286810.91,60ec41ba55c00300382672d9,HDFC,Transfer in/Revenue-other,5eecc6d6449e4f7cfb1c2708,2021-05-26T00:00:00.000Z,IMPS-114605474539-NA-HDFC-XXXXXXXXXX0007,,,net_banking_transfer,23555.34
61b70443d8beac1599eb53d7,50200023535069,1289486.09,60ec41ba55c00300382672d9,HDFC,Revenue-Mktplace,5eecc6d6449e4f7cfb1c2708,2021-05-26T00:00:00.000Z,NEFT CR-DEUT0797BGL-FLIPKART INTERNET PR IVATE LIMITED-SLICK ORGANICS PVT LTD-052 600064GN00093,shopping,,net_banking_transfer,2675.18
61b70444d8beac1599eb53dd,50200023535069,1291962.1,60ec41ba55c00300382672d9,HDFC,Revenue-Mktplace,5eecc6d6449e4f7cfb1c2708,2021-05-26T00:00:00.000Z,NEFT CR-DEUT0797BGL-FLIPKART INTERNET PR IVATE LIMITED-SLICK ORGANICS PVT LTD-052 600151GN00113,shopping,,net_banking_transfer,2476.01
61b70445d8beac1599eb53e2,50200023535069,1292890.38,60ec41ba55c00300382672d9,HDFC,Revenue-Mktplace,5eecc6d6449e4f7cfb1c2708,2021-05-26T00:00:00.000Z,NEFT CR-DEUT0797BGL-MYNTRA DESIGNS PRIVA TE LIMITED-SLICK ORGANICS PRIVATE LIMITE D-052600307GN00140,shopping,,net_banking_transfer,928.28
61b70446d8beac1599eb53e8,50200023535069,1295232.39,60ec41ba55c00300382672d9,HDFC,Revenue-Mktplace,5eecc6d6449e4f7cfb1c2708,2021-05-26T00:00:00.000Z,NEFT CR-DEUT0797BGL-MYNTRA DESIGNS PRIVA TE LIMITED-SLICK ORGANICS PRIVATE LIMITE D-052600318GN00110,shopping,,net_banking_transfer,2342.01
61b70447d8beac1599eb53f1,50200023535069,1245232.39,60ec41ba55c00300382672d9,HDFC,direct expenses,5eecc6d6449e4f7cfb1c2708,2021-05-26T00:00:00.000Z,IMPS-114611179721-PAYTM-PYTM-XXXXXXXX383 9-50000,ewallet,,net_banking_transfer,-50000
61b70448d8beac1599eb53f7,50200023535069,1195232.39,60ec41ba55c00300382672d9,HDFC,Marketing Expense,5eecc6d6449e4f7cfb1c2708,2021-05-26T00:00:00.000Z,POS 514834XXXXXX9486 GOOGLE ADS,,,debit_card,-50000
61b70449d8beac1599eb5400,50200023535069,1202830.3,60ec41ba55c00300382672d9,HDFC,Revenue-Mktplace,5eecc6d6449e4f7cfb1c2708,2021-05-26T00:00:00.000Z,NEFT CR-DEUT0797BGL-FLIPKART INTERNET PR IVATE LIMITED-SLICK ORGANICS PVT LTD-052 600460GN00228,shopping,,net_banking_transfer,7597.91
61b7044ad8beac1599eb5407,50200023535069,1228118.28,60ec41ba55c00300382672d9,HDFC,Transfer in/Revenue-other,5eecc6d6449e4f7cfb1c2708,2021-05-27T00:00:00.000Z,IMPS-114705181178-NA-HDFC-XXXXXXXXXX0007 -ALL20210527216820000330830668628,,,net_banking_transfer,25287.98
61b7044bd8beac1599eb540d,50200023535069,1252005.63,60ec41ba55c00300382672d9,HDFC,Revenue-PG-split enabled,5eecc6d6449e4f7cfb1c2708,2021-05-27T00:00:00.000Z,NEFT CR-UTIB0001506-RAZORPAY SOFTWARE PR IVATE LIMITED-SLICK ORGANICS PVT LITD-AX ISCN0079873372,insurance,,net_banking_transfer,23887.35
61b7044cd8beac1599eb5441,50200023535069,1262787.82,60ec41ba55c00300382672d9,HDFC,Revenue-COD,5eecc6d6449e4f7cfb1c2708,2021-05-27T00:00:00.000Z,NEFT CR-ICIC0000155-SHIPROCKET COD CRF I D 2496495-SLICK ORGANICS PVT LTD-CMS1956 088234,insurance,,net_banking_transfer,10782.19
61b7044dd8beac1599eb5451,50200023535069,1266171.72,60ec41ba55c00300382672d9,HDFC,Revenue-PG-non-split,5eecc6d6449e4f7cfb1c2708,2021-05-27T00:00:00.000Z,NEFT CR-IDFB0010204-SEZZLE PAYMENTS PRIV ATE LIMITED-SLICK ORGANICS PRIVATE LIMIT ED-IDFBH21147849924,insurance,,net_banking_transfer,3383.9
61b7044ed8beac1599eb5458,50200023535069,1268037.04,60ec41ba55c00300382672d9,HDFC,Revenue-Mktplace,5eecc6d6449e4f7cfb1c2708,2021-05-27T00:00:00.000Z,NEFT CR-DEUT0797BGL-MYNTRA DESIGNS PRIVA,shopping,,net_banking_transfer,1865.32
61b7044fd8beac1599eb545b,50200023535069,1270955.08,60ec41ba55c00300382672d9,HDFC,Revenue-Mktplace,5eecc6d6449e4f7cfb1c2708,2021-05-27T00:00:00.000Z,NEFT CR-DEUT0797BGL-MYNTRA DESIGNS PRIVA TE LIMITED-SLICK ORGANICS PRIVATE LIMITE D-052700481GN00269,shopping,,net_banking_transfer,2918.04
61b70450d8beac1599eb5461,50200023535069,1326019.09,60ec41ba55c00300382672d9,HDFC,Transfer in/Revenue-other,5eecc6d6449e4f7cfb1c2708,2021-05-27T00:00:00.000Z,NEFT CR-UTIB0000114-MILA STAR RETAIL PRI VATE LTD-SLICK ORGANICS PVT LTD-AXISP002 01272297,,,net_banking_transfer,55064.01
61b70451d8beac1599eb5468,50200023535069,1327434.42,60ec41ba55c00300382672d9,HDFC,Revenue-Mktplace,5eecc6d6449e4f7cfb1c2708,2021-05-27T00:00:00.000Z,4060001466-TIMES INTERNET LIMITED NODAL,,,Other,1415.33
61b70452d8beac1599eb546c,50200023535069,1328459.13,60ec41ba55c00300382672d9,HDFC,Revenue-Mktplace,5eecc6d6449e4f7cfb1c2708,2021-05-27T00:00:00.000Z,NEFT CR-ICIC0000105-MANASH LIFETYLE PVT LTD-SLICK ORGANICSPVT LTD HYD-ICIB211470 039643,,,net_banking_transfer,1024.71
61b70453d8beac1599eb5473,50200023535069,1329226.6,60ec41ba55c00300382672d9,HDFC,Revenue-Mktplace,5eecc6d6449e4f7cfb1c2708,2021-05-27T00:00:00.000Z,NEFT CR-ICIC0000105-MANASH LIFETYLE PVT LTD-SLICK ORGANICSPVT LTDMP MUM-ICIB2114 70039640,,,net_banking_transfer,767.47
61b70454d8beac1599eb547d,50200023535069,1284226.6,60ec41ba55c00300382672d9,HDFC,direct expenses,5eecc6d6449e4f7cfb1c2708,2021-05-27T00:00:00.000Z,02771610131904-TPT-45000-DIGANT BHATT,,,net_banking_transfer,-45000
61b70454d8beac1599eb5481,50200023535069,1299186.77,60ec41ba55c00300382672d9,HDFC,Revenue-PG-split enabled,5eecc6d6449e4f7cfb1c2708,2021-05-27T00:00:00.000Z,NEFT CR-UTIB0001506-RAZORPAY SOFTWARE PR IVATE LIMITED-SLICK ORGANICS PVT LITD-AX ISCN0079934897,insurance,,net_banking_transfer,14960.17
61b70455d8beac1599eb5485,50200023535069,1324187.48,60ec41ba55c00300382672d9,HDFC,Transfer in/Revenue-other,5eecc6d6449e4f7cfb1c2708,2021-05-28T00:00:00.000Z,IMPS-114805833485-NA-HDFC-XXXXXXXXXX0007 -ALL20210528216820000330830668628,,,net_banking_transfer,25000.71
61b70456d8beac1599eb5497,50200023535069,2163931.6,60ec41ba55c00300382672d9,HDFC,Revenue-Mktplace,5eecc6d6449e4f7cfb1c2708,2021-05-28T00:00:00.000Z,NEFT CR-KKBK0000958-NYKAA E RETAIL PRIVA TE LIMITED NYKAA-SLICK ORGANICS PVT LTD- KKBK211487127412,insurance,,net_banking_transfer,839744.12
61b70457d8beac1599eb549c,50200023535069,1908931.6,60ec41ba55c00300382672d9,HDFC,SAAS/tech expense,5eecc6d6449e4f7cfb1c2708,2021-05-28T00:00:00.000Z,VHDF9999612648/BILLDKAMAZONSELLERSE,shopping,,Other,-255000
61b70458d8beac1599eb54a1,50200023535069,1931094.96,60ec41ba55c00300382672d9,HDFC,Revenue-Mktplace,5eecc6d6449e4f7cfb1c2708,2021-05-28T00:00:00.000Z,NEFT CR-DEUT0797BGL-FLIPKART INTERNET PR IVATE LIMITED-SLICK ORGANICS PVT LTD-052 800094GN00139,shopping,,net_banking_transfer,22163.36
61b70459d8beac1599eb54a4,50200023535069,1927456.36,60ec41ba55c00300382672d9,HDFC,direct expenses,5eecc6d6449e4f7cfb1c2708,2021-05-28T00:00:00.000Z,POS 514834XXXXXX9486 FRESHWORKS INC,,,debit_card,-3638.6
61b7045ad8beac1599eb54a7,50200023535069,1827456.36,60ec41ba55c00300382672d9,HDFC,Tax,5eecc6d6449e4f7cfb1c2708,2021-05-28T00:00:00.000Z,051030828052112502- CBDT TAX,,,Other,-100000
61b7045bd8beac1599eb54b0,50200023535069,1841222.88,60ec41ba55c00300382672d9,HDFC,Revenue-Mktplace,5eecc6d6449e4f7cfb1c2708,2021-05-28T00:00:00.000Z,NEFT CR-DEUT0797BGL-FLIPKART INTERNET PR,shopping,,net_banking_transfer,13766.52
61b7045cd8beac1599eb54b2,50200023535069,1948420.07,60ec41ba55c00300382672d9,HDFC,Revenue-COD,5eecc6d6449e4f7cfb1c2708,2021-05-28T00:00:00.000Z,NEFT CR-ICIC0000155-SHIPROCKET COD CRF I D 2508734-SLICK ORGANICS PVT LTD-CMS1957 465759,insurance,,net_banking_transfer,107197.19
61b7045dd8beac1599eb54b8,50200023535069,1949994.81,60ec41ba55c00300382672d9,HDFC,Revenue-PG-split enabled,5eecc6d6449e4f7cfb1c2708,2021-05-28T00:00:00.000Z,NEFT CR-UTIB0001506-RAZORPAY SOFTWARE PR IVATE LIMITED-SLICK ORGANICS-AXISCN00804 68244,insurance,,net_banking_transfer,1574.74
61b7045ed8beac1599eb54bb,50200023535069,1950370.63,60ec41ba55c00300382672d9,HDFC,Revenue-Mktplace,5eecc6d6449e4f7cfb1c2708,2021-05-28T00:00:00.000Z,NEFT CR-DEUT0784BBY-TATA UNISTORE LIMITE D-SLICK ORGANICS PVT LTD-052801479GN0018 2,insurance,,net_banking_transfer,375.82
61b7045fd8beac1599eb54c0,50200023535069,1950748.05,60ec41ba55c00300382672d9,HDFC,Revenue-Mktplace,5eecc6d6449e4f7cfb1c2708,2021-05-28T00:00:00.000Z,NEFT CR-DEUT0784BBY-TATA UNISTORE LTD-NO DAL-SLICK ORGANICS PVT LTD-052801488GN00 286,insurance,,net_banking_transfer,377.42
61b70460d8beac1599eb54c6,50200023535069,1953712.38,60ec41ba55c00300382672d9,HDFC,Revenue-PG-non-split,5eecc6d6449e4f7cfb1c2708,2021-05-28T00:00:00.000Z,NEFT CR-IDFB0010204-SEZZLE PAYMENTS PRIV ATE LIMITED-SLICK ORGANICS PRIVATE LIMIT ED-IDFBH21148891960,insurance,,net_banking_transfer,2964.33
61b70461d8beac1599eb54cc,50200023535069,1987925.17,60ec41ba55c00300382672d9,HDFC,Revenue-PG-split enabled,5eecc6d6449e4f7cfb1c2708,2021-05-28T00:00:00.000Z,NEFT CR-UTIB0001506-RAZORPAY SOFTWARE PR IVATE LIMITED-SLICK ORGANICS PVT LITD-AX ISCN0080540944,insurance,,net_banking_transfer,34212.79
61b70462d8beac1599eb54d3,50200023535069,1988199.33,60ec41ba55c00300382672d9,HDFC,Revenue-Mktplace,5eecc6d6449e4f7cfb1c2708,2021-05-28T00:00:00.000Z,NEFT CR-ICIC0000105-MANASH LIFETYLE PVT LTD-SLICKORGANICSPRIVATELIMITEDHYD-ICIB2 11480085231,,,net_banking_transfer,274.16
61b70463d8beac1599eb54d6,50200023535069,1989145.64,60ec41ba55c00300382672d9,HDFC,Revenue-Mktplace,5eecc6d6449e4f7cfb1c2708,2021-05-28T00:00:00.000Z,NEFT CR-ICIC0000105-MANASH LIFETYLE PVT LTD-SLICKORGANICSPRIVATELIMITEDMPGGN-ICI B211480085229,,,net_banking_transfer,946.31
61b70464d8beac1599eb54db,50200023535069,1989721.78,60ec41ba55c00300382672d9,HDFC,Revenue-Mktplace,5eecc6d6449e4f7cfb1c2708,2021-05-28T00:00:00.000Z,NEFT CR-ICIC0000105-MANASH LIFETYLE PVT LTD-SLICKORGANICSPRIVATELIMITEDMPMUM-ICI B211480086080,,,net_banking_transfer,576.14
61b70465d8beac1599eb54e5,50200023535069,2023015.89,60ec41ba55c00300382672d9,HDFC,Transfer in/Revenue-other,5eecc6d6449e4f7cfb1c2708,2021-05-29T00:00:00.000Z,IMPS-114905494314-NA-HDFC-XXXXXXXXXX0007 -ALL20210529216820000330830668628,,,net_banking_transfer,33294.11
61b70466d8beac1599eb54e9,50200023535069,2043221.3,60ec41ba55c00300382672d9,HDFC,Revenue-PG-split enabled,5eecc6d6449e4f7cfb1c2708,2021-05-29T00:00:00.000Z,NEFT CR-UTIB0001506-RAZORPAY SOFTWARE PR,,,net_banking_transfer,20205.41
61b70467d8beac1599eb54f7,50200023535069,2049854.12,60ec41ba55c00300382672d9,HDFC,Revenue-PG-split enabled,5eecc6d6449e4f7cfb1c2708,2021-05-29T00:00:00.000Z,NEFT CR-UTIB0001506-RAZORPAY SOFTWARE PR IVATE LIMITED-SLICK ORGANICS PVT LITD-AX ISCN0080603665,insurance,,net_banking_transfer,6632.82
61b70468d8beac1599eb54fd,50200023535069,2079090.62,60ec41ba55c00300382672d9,HDFC,Transfer in/Revenue-other,5eecc6d6449e4f7cfb1c2708,2021-05-30T00:00:00.000Z,IMPS-115005123552-NA-HDFC-XXXXXXXXXX0007 -ALL20210530216820000330830668628,,,net_banking_transfer,29236.5
61b70469d8beac1599eb5500,50200023535069,2029090.62,60ec41ba55c00300382672d9,HDFC,Marketing Expense,5eecc6d6449e4f7cfb1c2708,2021-05-30T00:00:00.000Z,POS 514834XXXXXX9486 GOOGLE ADS,,,debit_card,-50000
61b7046ad8beac1599eb5504,50200023535069,2130829.09,60ec41ba55c00300382672d9,HDFC,Transfer in/Revenue-other,5eecc6d6449e4f7cfb1c2708,2021-05-31T00:00:00.000Z,IMPS-115105683603-NA-HDFC-XXXXXXXXXX0007 -ALL20210531216820000330830668628,,,net_banking_transfer,101738.47
61b7046bd8beac1599eb550c,50200023535069,2267670.18,60ec41ba55c00300382672d9,HDFC,Revenue-PG-split enabled,5eecc6d6449e4f7cfb1c2708,2021-05-31T00:00:00.000Z,NEFT CR-UTIB0001506-RAZORPAY SOFTWARE PR IVATE LIMITED-SLICK ORGANICS PVT LITD-AX ISCN0080630328,insurance,,net_banking_transfer,136841.09
61b7046cd8beac1599eb5513,50200023535069,2267370.59,60ec41ba55c00300382672d9,HDFC,bank charges,5eecc6d6449e4f7cfb1c2708,2021-05-31T00:00:00.000Z,.DC INTL POS TXN MARKUP+ST 200521 280521 -CDT2112804190988,,,international_transaction_arbitrage,-299.59
61b7046cd8beac1599eb5517,50200023535069,2304074.48,60ec41ba55c00300382672d9,HDFC,Revenue-COD,5eecc6d6449e4f7cfb1c2708,2021-05-31T00:00:00.000Z,NEFT CR-ICIC0000155-SHIPROCKET COD CRF I D 2516959-SLICK ORGANICS PVT LTD-CMS1960 441029,insurance,,net_banking_transfer,36703.89
61b7046dd8beac1599eb5521,50200023535069,2309516.12,60ec41ba55c00300382672d9,HDFC,Revenue-PG-non-split,5eecc6d6449e4f7cfb1c2708,2021-05-31T00:00:00.000Z,NEFT CR-IDFB0010204-SEZZLE PAYMENTS PRIV ATE LIMITED-SLICK ORGANICS PRIVATE LIMIT ED-IDFBH21151974548,insurance,,net_banking_transfer,5441.64
61b7046ed8beac1599eb5528,50200023535069,2311120.88,60ec41ba55c00300382672d9,HDFC,Revenue-PG-non-split,5eecc6d6449e4f7cfb1c2708,2021-05-31T00:00:00.000Z,NEFT CR-IDFB0010204-SEZZLE PAYMENTS PRIV ATE LIMITED-SLICK ORGANICS PRIVATE LIMIT ED-IDFBH21151974608,insurance,,net_banking_transfer,1604.76
61b7046fd8beac1599eb552f,50200023535069,2320382.11,60ec41ba55c00300382672d9,HDFC,Revenue-PG-split enabled,5eecc6d6449e4f7cfb1c2708,2021-05-31T00:00:00.000Z,NEFT CR-UTIB0001506-RAZORPAY SOFTWARE PR IVATE LIMITED-SLICK ORGANICS PVT LITD-AX ISCN0080702405,insurance,,net_banking_transfer,9261.23
61b70470d8beac1599eb5533,50200023535069,2320711.22,60ec41ba55c00300382672d9,HDFC,Revenue-Mktplace,5eecc6d6449e4f7cfb1c2708,2021-05-31T00:00:00.000Z,NEFT CR-ICIC0000105-MANASH LIFETYLE PVT LTD-SLICK ORGANICS PVT LTD MP GGN-ICIB 211510061934,,,net_banking_transfer,329.11
61b70471d8beac1599eb5539,50200023535069,2323766.36,60ec41ba55c00300382672d9,HDFC,Revenue-Mktplace,5eecc6d6449e4f7cfb1c2708,2021-05-31T00:00:00.000Z,NEFT CR-ICIC0000105-MANASH LIFETYLE PVT LTD-SLICK ORGANICS PVT LTD MP MUM-ICIB 211510061935,,,net_banking_transfer,3055.14
61b70472d8beac1599eb553c,50200023535069,2323958.41,60ec41ba55c00300382672d9,HDFC,Revenue-Mktplace,5eecc6d6449e4f7cfb1c2708,2021-05-31T00:00:00.000Z,NEFT CR-ICIC0000105-MANASH LIFETYLE PVT,,,net_banking_transfer,192.05
61b70473d8beac1599eb5543,50200023535069,2324753.74,60ec41ba55c00300382672d9,HDFC,Revenue-Mktplace,5eecc6d6449e4f7cfb1c2708,2021-05-31T00:00:00.000Z,NEFT CR-ICIC0000105-MANASH LIFETYLE PVT,,,net_banking_transfer,795.33
61b70474d8beac1599eb554a,50200023535069,2348254.57,60ec41ba55c00300382672d9,HDFC,Transfer in/Revenue-other,5eecc6d6449e4f7cfb1c2708,2021-06-01T00:00:00.000Z,IMPS-115205499729-NA-HDFC-XXXXXXXXXX0007 -ALL20210601216820000330830668628,,,net_banking_transfer,23500.83
61b70475d8beac1599eb5550,50200023535069,1805254.57,60ec41ba55c00300382672d9,HDFC,direct expenses,5eecc6d6449e4f7cfb1c2708,2021-06-01T00:00:00.000Z,"NEFT DR-YESB0000551-VISTTA COSMETICS-NET BANK, MUM-N152211518665987-543000",,,net_banking_transfer,-543000
61b70477d8beac1599eb5556,50200023535069,1821196.06,60ec41ba55c00300382672d9,HDFC,Revenue-PG-split enabled,5eecc6d6449e4f7cfb1c2708,2021-06-01T00:00:00.000Z,NEFT CR-UTIB0001506-RAZORPAY SOFTWARE PR IVATE LIMITED-SLICK ORGANICS PVT LITD-AX ISCN0080742407,insurance,,net_banking_transfer,15941.49
61b70478d8beac1599eb5559,50200023535069,1827238.16,60ec41ba55c00300382672d9,HDFC,Revenue-Mktplace,5eecc6d6449e4f7cfb1c2708,2021-06-01T00:00:00.000Z,NEFT CR-DEUT0797BGL-MYNTRA DESIGNS PRIVA TE LIMITED-SLICK ORGANICS PRIVATE LIMITE D-060100101GN00036,shopping,,net_banking_transfer,6042.1
61b70479d8beac1599eb5560,50200023535069,1727238.16,60ec41ba55c00300382672d9,HDFC,direct expenses,5eecc6d6449e4f7cfb1c2708,2021-06-01T00:00:00.000Z,57500000443889-TPT-100000-WEBKLIPPER TEC HNOLOGIES PRIVATE LIMITED,,,net_banking_transfer,-100000
61b7047ad8beac1599eb5565,50200023535069,1502238.16,60ec41ba55c00300382672d9,HDFC,direct expenses,5eecc6d6449e4f7cfb1c2708,2021-06-01T00:00:00.000Z,02711930004579-TPT-225000-DHRUV BHASIN,,,net_banking_transfer,-225000
61b7047bd8beac1599eb5569,50200023535069,1277238.16,60ec41ba55c00300382672d9,HDFC,direct expenses,5eecc6d6449e4f7cfb1c2708,2021-06-01T00:00:00.000Z,"NEFT DR-SCBL0036025-DHRUV MADHOK-NETBANK , MUM-N152211518766399-225000",,,net_banking_transfer,-225000
61b7047cd8beac1599eb556e,50200023535069,1340485.54,60ec41ba55c00300382672d9,HDFC,Revenue-Mktplace,5eecc6d6449e4f7cfb1c2708,2021-06-01T00:00:00.000Z,IMPS-115211102024-AMAZON SELLER SERVIC-H DFC-XXXXXXXX6004-4LIIPL1ZT75EUQJ1SLICK O RGANICS PVT LTD,shopping,,net_banking_transfer,63247.38
61b7047cd8beac1599eb5571,50200023535069,1338378.93,60ec41ba55c00300382672d9,HDFC,direct expenses,5eecc6d6449e4f7cfb1c2708,2021-06-01T00:00:00.000Z,POS 514834XXXXXX9486 SEOPTIMER,,,debit_card,-2106.61
61b7047dd8beac1599eb5575,50200023535069,1781175.23,60ec41ba55c00300382672d9,HDFC,Revenue-Mktplace,5eecc6d6449e4f7cfb1c2708,2021-06-01T00:00:00.000Z,NEFT CR-DEUT0797BGL-AMAZON PAY (INDIA) P RIVATE LIMITED-SLICK ORGANICS PVT LTD-06 0100176GN00023,shopping,,net_banking_transfer,442796.3
61b7047ed8beac1599eb557d,50200023535069,1785792.13,60ec41ba55c00300382672d9,HDFC,Revenue-Mktplace,5eecc6d6449e4f7cfb1c2708,2021-06-01T00:00:00.000Z,NEFT CR-DEUT0797BGL-MYNTRA DESIGNS PRIVA TE LIMITED-SLICK ORGANICS PRIVATE LIMITE D-060100096GN00217,shopping,,net_banking_transfer,4616.9
61b7047fd8beac1599eb5581,50200023535069,1785793.13,60ec41ba55c00300382672d9,HDFC,Revenue-PG-non-split,5eecc6d6449e4f7cfb1c2708,2021-06-01T00:00:00.000Z,IMPS-115215029531-PAYTM OE-HDFC-XXXXXXXX XX0003-,ewallet,,net_banking_transfer,1
61b70480d8beac1599eb5587,50200023535069,1789778.09,60ec41ba55c00300382672d9,HDFC,Revenue-PG-non-split,5eecc6d6449e4f7cfb1c2708,2021-06-01T00:00:00.000Z,NEFT CR-IDFB0010204-SEZZLE PAYMENTS PRIV,,,net_banking_transfer,3984.96
61b70481d8beac1599eb558b,50200023535069,1795969.67,60ec41ba55c00300382672d9,HDFC,Revenue-PG-split enabled,5eecc6d6449e4f7cfb1c2708,2021-06-01T00:00:00.000Z,NEFT CR-UTIB0001506-RAZORPAY SOFTWARE PR IVATE LIMITED-SLICK ORGANICS PVT LITD-AX ISCN0080825521,insurance,,net_banking_transfer,6191.58
61b70482d8beac1599eb558d,50200023535069,1349319.67,60ec41ba55c00300382672d9,HDFC,direct expenses,5eecc6d6449e4f7cfb1c2708,2021-06-01T00:00:00.000Z,CHQ PAID-INWARD TRAN-CAVALIER LOGISTICS,,,chq,-446650
61b70483d8beac1599eb5597,50200023535069,1349759.7,60ec41ba55c00300382672d9,HDFC,Revenue-PG-non-split,5eecc6d6449e4f7cfb1c2708,2021-06-01T00:00:00.000Z,NEFT CR-ICIC0000031-PAYTM E COMMERCE PVT LTD-SLICK ORGANICS PVT LTD-CMS196321521 5,ewallet,,net_banking_transfer,440.03
61b70484d8beac1599eb5599,50200023535069,1311894.7,60ec41ba55c00300382672d9,HDFC,direct expenses,5eecc6d6449e4f7cfb1c2708,2021-06-01T00:00:00.000Z,"NEFT DR-YESB0000162-VINAY REDDY-NETBANK, MUM-N152211519811670-37865",,,net_banking_transfer,-37865
61b70485d8beac1599eb559f,50200023535069,1331416.36,60ec41ba55c00300382672d9,HDFC,Transfer in/Revenue-other,5eecc6d6449e4f7cfb1c2708,2021-06-02T00:00:00.000Z,IMPS-115305385807-NA-HDFC-XXXXXXXXXX0007 -ALL20210602216820000330830668628,,,net_banking_transfer,19521.66
61b70486d8beac1599eb55a2,50200023535069,1332968.52,60ec41ba55c00300382672d9,HDFC,Revenue-Mktplace,5eecc6d6449e4f7cfb1c2708,2021-06-02T00:00:00.000Z,NEFT CR-DEUT0797BGL-FLIPKART INTERNET PR IVATE LIMITED-SLICK ORGANICS PVT LTD-060 200103GN00100,shopping,,net_banking_transfer,1552.16
61b70487d8beac1599eb55a5,50200023535069,1337120.44,60ec41ba55c00300382672d9,HDFC,Revenue-Mktplace,5eecc6d6449e4f7cfb1c2708,2021-06-02T00:00:00.000Z,NEFT CR-DEUT0797BGL-MYNTRA DESIGNS PRIVA TE LIMITED-SLICK ORGANICS PRIVATE LIMITE D-060200119GN00066,shopping,,net_banking_transfer,4151.92
61b70488d8beac1599eb55ab,50200023535069,1337271.21,60ec41ba55c00300382672d9,HDFC,Revenue-Mktplace,5eecc6d6449e4f7cfb1c2708,2021-06-02T00:00:00.000Z,NEFT CR-DEUT0797BGL-MYNTRA DESIGNS PRIVA TE LIMITED-SLICK ORGANICS PRIVATE LIMITE D-060200120GN00273,shopping,,net_banking_transfer,150.77
61b70489d8beac1599eb55b1,50200023535069,1350473.69,60ec41ba55c00300382672d9,HDFC,Revenue-PG-split enabled,5eecc6d6449e4f7cfb1c2708,2021-06-02T00:00:00.000Z,NEFT CR-UTIB0001506-RAZORPAY SOFTWARE PR IVATE LIMITED-SLICK ORGANICS PVT LITD-AX ISCN0080858257,insurance,,net_banking_transfer,13202.48
61b7048ad8beac1599eb55d6,50200023535069,1300473.69,60ec41ba55c00300382672d9,HDFC,Marketing Expense,5eecc6d6449e4f7cfb1c2708,2021-06-02T00:00:00.000Z,POS 514834XXXXXX9486 GOOGLE ADS,,,debit_card,-50000
61b7048bd8beac1599eb55da,50200023535069,545473.69,60ec41ba55c00300382672d9,HDFC,SAAS/tech expense,5eecc6d6449e4f7cfb1c2708,2021-06-02T00:00:00.000Z,VHDF0011516316/BILLDKAMAZONSELLERSE,shopping,,Other,-755000
61b7048cd8beac1599eb55e0,50200023535069,448341.69,60ec41ba55c00300382672d9,HDFC,direct expenses,5eecc6d6449e4f7cfb1c2708,2021-06-02T00:00:00.000Z,"NEFT DR-KKBK0000173-MATRIX PRINTING SOLU TIONS PRIVATE LIMITE-NETBANK, MUM-N15321 1520655497-97132",,,net_banking_transfer,-97132
61b7048dd8beac1599eb55e8,50200023535069,450841.55,60ec41ba55c00300382672d9,HDFC,Revenue-PG-non-split,5eecc6d6449e4f7cfb1c2708,2021-06-02T00:00:00.000Z,NEFT CR-IDFB0010204-SEZZLE PAYMENTS PRIV ATE LIMITED-SLICK ORGANICS PRIVATE LIMIT ED-IDFBH21153064338,insurance,,net_banking_transfer,2499.86
61b7048ed8beac1599eb55ec,50200023535069,463423.42,60ec41ba55c00300382672d9,HDFC,Revenue-PG-split enabled,5eecc6d6449e4f7cfb1c2708,2021-06-02T00:00:00.000Z,NEFT CR-UTIB0001506-RAZORPAY SOFTWARE PR,,,net_banking_transfer,12581.87
61b7048fd8beac1599eb55f2,50200023535069,463652.66,60ec41ba55c00300382672d9,HDFC,Revenue-PG-non-split,5eecc6d6449e4f7cfb1c2708,2021-06-02T00:00:00.000Z,NEFT CR-ICIC0000031-PAYTM E COMMERCE PVT LTD-SLICK ORGANICS PVT LTD-CMS196428084 2,ewallet,,net_banking_transfer,229.24
61b70490d8beac1599eb55f6,50200023535069,464272.59,60ec41ba55c00300382672d9,HDFC,Transfer in/Revenue-other,5eecc6d6449e4f7cfb1c2708,2021-06-02T00:00:00.000Z,FT - C73845020621191349 - - 50200050045 240 - ZOOBOP ME WORKS PRIVATE LIMITED,,,Other,619.93
61b70491d8beac1599eb55f9,50200023535069,444272.59,60ec41ba55c00300382672d9,HDFC,Marketing Expense,5eecc6d6449e4f7cfb1c2708,2021-06-02T00:00:00.000Z,POS 514834XXXXXX9486 GOOGLE WORKSPACE,,,debit_card,-20000
61b70492d8beac1599eb5600,50200023535069,476527.22,60ec41ba55c00300382672d9,HDFC,Transfer in/Revenue-other,5eecc6d6449e4f7cfb1c2708,2021-06-03T00:00:00.000Z,IMPS-115405147967-NA-HDFC-XXXXXXXXXX0007 -ALL20210603216820000330830668628,,,net_banking_transfer,32254.63
61b70493d8beac1599eb561f,50200023535069,493164.65,60ec41ba55c00300382672d9,HDFC,Revenue-PG-split enabled,5eecc6d6449e4f7cfb1c2708,2021-06-03T00:00:00.000Z,NEFT CR-UTIB0001506-RAZORPAY SOFTWARE PR IVATE LIMITED-SLICK ORGANICS PVT LITD-AX ISCN0080964085,insurance,,net_banking_transfer,16637.43
61b70494d8beac1599eb562d,50200023535069,496956.9,60ec41ba55c00300382672d9,HDFC,Transfer in/Revenue-other,5eecc6d6449e4f7cfb1c2708,2021-06-03T00:00:00.000Z,ZOOBOP ME WORK-ARATA,,,Other,3792.25
61b70495d8beac1599eb5633,50200023535069,565813.9,60ec41ba55c00300382672d9,HDFC,Revenue-Mktplace,5eecc6d6449e4f7cfb1c2708,2021-06-03T00:00:00.000Z,NEFT CR-ICIC0SF0002-THREPSI SOLUTIONS PV -SLICK ORGANICS PRIVATE LIMITED-24276890 041DC,insurance,,net_banking_transfer,68857
61b70495d8beac1599eb563c,50200023535069,465813.9,60ec41ba55c00300382672d9,HDFC,direct expenses,5eecc6d6449e4f7cfb1c2708,2021-06-03T00:00:00.000Z,IMPS-115416113073-PAYTM-PYTM-XXXXXXXX383 9-100000,ewallet,,net_banking_transfer,-100000
61b70496d8beac1599eb5641,50200023535069,513853.01,60ec41ba55c00300382672d9,HDFC,Revenue-COD,5eecc6d6449e4f7cfb1c2708,2021-06-03T00:00:00.000Z,NEFT CR-KKBK0000958-BIGFOOT RETAIL SOLUT IONS PRIVATE LIMITED-SLICK ORGANICS PVT LTD-KKBK211548855031,,,net_banking_transfer,48039.11
61b70497d8beac1599eb56ac,50200023535069,528600.02,60ec41ba55c00300382672d9,HDFC,Revenue-PG-split enabled,5eecc6d6449e4f7cfb1c2708,2021-06-03T00:00:00.000Z,NEFT CR-UTIB0001506-RAZORPAY SOFTWARE PR IVATE LIMITED-SLICK ORGANICS PVT LITD-AX ISCN0081079699,insurance,,net_banking_transfer,14747.01
61b70498d8beac1599eb56f3,50200023535069,530130.56,60ec41ba55c00300382672d9,HDFC,Revenue-PG-non-split,5eecc6d6449e4f7cfb1c2708,2021-06-03T00:00:00.000Z,NEFT CR-IDFB0010204-SEZZLE PAYMENTS PRIV ATE LIMITED-SLICK ORGANICS PRIVATE LIMIT ED-IDFBH21154105883,insurance,,net_banking_transfer,1530.54
61b70499d8beac1599eb56f7,50200023535069,530323.22,60ec41ba55c00300382672d9,HDFC,Revenue-PG-non-split,5eecc6d6449e4f7cfb1c2708,2021-06-03T00:00:00.000Z,NEFT CR-ICIC0000031-PAYTM E COMMERCE PVT LTD-SLICK ORGANICS PVT LTD-CMS196557159 4,ewallet,,net_banking_transfer,192.66
61b7049ad8beac1599eb56f9,50200023535069,563885.08,60ec41ba55c00300382672d9,HDFC,Transfer in/Revenue-other,5eecc6d6449e4f7cfb1c2708,2021-06-04T00:00:00.000Z,IMPS-115505887422-NA-HDFC-XXXXXXXXXX0007,,,net_banking_transfer,33561.86
61b7049bd8beac1599eb56fe,50200023535069,574333.54,60ec41ba55c00300382672d9,HDFC,Revenue-Mktplace,5eecc6d6449e4f7cfb1c2708,2021-06-04T00:00:00.000Z,NEFT CR-DEUT0797BGL-FLIPKART INTERNET PR IVATE LIMITED-SLICK ORGANICS PVT LTD-060 400110GN00291,shopping,,net_banking_transfer,10448.46
61b7049cd8beac1599eb5705,50200023535069,577845.42,60ec41ba55c00300382672d9,HDFC,Revenue-Mktplace,5eecc6d6449e4f7cfb1c2708,2021-06-04T00:00:00.000Z,NEFT CR-DEUT0797BGL-MYNTRA DESIGNS PRIVA TE LIMITED-SLICK ORGANICS PRIVATE LIMITE D-060400131GN00242,shopping,,net_banking_transfer,3511.88
61b7049dd8beac1599eb5709,50200023535069,596972.77,60ec41ba55c00300382672d9,HDFC,Revenue-PG-split enabled,5eecc6d6449e4f7cfb1c2708,2021-06-04T00:00:00.000Z,NEFT CR-UTIB0001506-RAZORPAY SOFTWARE PR IVATE LIMITED-SLICK ORGANICS PVT LITD-AX ISCN0081165655,insurance,,net_banking_transfer,19127.35
61b7049ed8beac1599eb5710,50200023535069,576972.77,60ec41ba55c00300382672d9,HDFC,direct expenses,5eecc6d6449e4f7cfb1c2708,2021-06-04T00:00:00.000Z,"SELF - CHQ PAID - KALKAJI, NEW",,,chq,-20000
61b7049fd8beac1599eb5713,50200023535069,578704.9,60ec41ba55c00300382672d9,HDFC,Revenue-Mktplace,5eecc6d6449e4f7cfb1c2708,2021-06-04T00:00:00.000Z,NEFT CR-DEUT0797BGL-MYNTRA DESIGNS PRIVA TE LIMITED-SLICK ORGANICS PRIVATE LIMITE D-060400132GN00139,shopping,,net_banking_transfer,1732.13
61b704a0d8beac1599eb5718,50200023535069,584571.49,60ec41ba55c00300382672d9,HDFC,Revenue-Mktplace,5eecc6d6449e4f7cfb1c2708,2021-06-04T00:00:00.000Z,NEFT CR-DEUT0797BGL-FLIPKART INTERNET PR IVATE LIMITED-SLICK ORGANICS PVT LTD-060 400130GN00147,shopping,,net_banking_transfer,5866.59
61b704a1d8beac1599eb5722,50200023535069,573787.13,60ec41ba55c00300382672d9,HDFC,direct expenses,5eecc6d6449e4f7cfb1c2708,2021-06-04T00:00:00.000Z,POS 514834XXXXXX9486 STK*SHUTTERSTOCK,,,debit_card,-10784.36
61b704a2d8beac1599eb5727,50200023535069,676742.67,60ec41ba55c00300382672d9,HDFC,Revenue-COD,5eecc6d6449e4f7cfb1c2708,2021-06-04T00:00:00.000Z,NEFT CR-ICIC0000155-SHIPROCKET COD CRF I D 2541535-SLICK ORGANICS PVT LTD-CMS1966 726226,insurance,,net_banking_transfer,102955.54
61b704a3d8beac1599eb572c,50200023535069,677344.47,60ec41ba55c00300382672d9,HDFC,Revenue-Mktplace,5eecc6d6449e4f7cfb1c2708,2021-06-04T00:00:00.000Z,NEFT CR-ICIC0000105-MANASH LIFETYLE PVT LTD-SLICKORGANICSPRIVATELIMITEDKOLKATA-I CIB211550051820,,,net_banking_transfer,601.8
61b704a4d8beac1599eb572f,50200023535069,678139.8,60ec41ba55c00300382672d9,HDFC,Revenue-Mktplace,5eecc6d6449e4f7cfb1c2708,2021-06-04T00:00:00.000Z,NEFT CR-ICIC0000105-MANASH LIFETYLE PVT LTD-SLICKORGANICSPRIVATELIMITEDHYD-ICIB2 11550047853,,,net_banking_transfer,795.33
61b704a5d8beac1599eb5732,50200023535069,690039.8,60ec41ba55c00300382672d9,HDFC,Revenue-Mktplace,5eecc6d6449e4f7cfb1c2708,2021-06-04T00:00:00.000Z,NEFT CR-SCBL0036001-M/S DREAMPLUG TECHNO -SLICK ORGANICS PRIVATE LIMITEDSLICK-SIN 31436Q0014569,insurance,,net_banking_transfer,11900
61b704a6d8beac1599eb5757,50200023535069,691379.86,60ec41ba55c00300382672d9,HDFC,Revenue-PG-non-split,5eecc6d6449e4f7cfb1c2708,2021-06-04T00:00:00.000Z,NEFT CR-IDFB0010204-SEZZLE PAYMENTS PRIV,,,net_banking_transfer,1340.06
61b704a7d8beac1599eb575d,50200023535069,691656.03,60ec41ba55c00300382672d9,HDFC,Revenue-Mktplace,5eecc6d6449e4f7cfb1c2708,2021-06-04T00:00:00.000Z,NEFT CR-DEUT0784BBY-TATA UNISTORE LIMITE D-SLICK ORGANICS PVT LTD-060402025GN0020 1,insurance,,net_banking_transfer,276.17
61b704a8d8beac1599eb5762,50200023535069,693516.27,60ec41ba55c00300382672d9,HDFC,Revenue-Mktplace,5eecc6d6449e4f7cfb1c2708,2021-06-04T00:00:00.000Z,NEFT CR-DEUT0784BBY-TATA UNISTORE LTD-NO DAL-SLICK ORGANICS PVT LTD-060402033GN00 318,insurance,,net_banking_transfer,1860.24
61b704a9d8beac1599eb5768,50200023535069,600025.27,60ec41ba55c00300382672d9,HDFC,direct expenses,5eecc6d6449e4f7cfb1c2708,2021-06-04T00:00:00.000Z,"NEFT DR-ICIC0000004-ICICI LOMBARD GIC LT D-NETBANK, MUM-N155211523387314-93491",,,net_banking_transfer,-93491
61b704aad8beac1599eb576d,50200023535069,630014.13,60ec41ba55c00300382672d9,HDFC,Transfer in/Revenue-other,5eecc6d6449e4f7cfb1c2708,2021-06-05T00:00:00.000Z,IMPS-115605616621-NA-HDFC-XXXXXXXXXX0007 -ALL20210605216820000330830668628,,,net_banking_transfer,29988.86
61b704abd8beac1599eb5773,50200023535069,580014.13,60ec41ba55c00300382672d9,HDFC,Marketing Expense,5eecc6d6449e4f7cfb1c2708,2021-06-05T00:00:00.000Z,POS 514834XXXXXX9486 GOOGLE ADS,,,debit_card,-50000
61b704acd8beac1599eb5783,50200023535069,482459.13,60ec41ba55c00300382672d9,HDFC,agency/vendor expense,5eecc6d6449e4f7cfb1c2708,2021-06-05T00:00:00.000Z,"NEFT DR-KKBK0000298-ADMITAD MEDIA PRIVAT E LIMITED-NETBANK, MUM-N156211524393886- 97555",loans,lender_transaction,net_banking_transfer,-97555
61b704add8beac1599eb5792,50200023535069,396360.13,60ec41ba55c00300382672d9,HDFC,direct expenses,5eecc6d6449e4f7cfb1c2708,2021-06-05T00:00:00.000Z,"NEFT DR-CITI0000002-OMG NETWORK INDIA PR IVATE LIMITED-NETBANK, MUM-N156211524406 363-86099",,,net_banking_transfer,-86099
61b704aed8beac1599eb57a4,50200023535069,400011.16,60ec41ba55c00300382672d9,HDFC,Revenue-PG-non-split,5eecc6d6449e4f7cfb1c2708,2021-06-05T00:00:00.000Z,NEFT CR-YESB0000001-RZPX PVT LTD NODAL A CCOUNT-SLICKORGANICS-N156210618043588,insurance,,salary,3651.03
61b704afd8beac1599eb57af,50200023535069,419637.12,60ec41ba55c00300382672d9,HDFC,Transfer in/Revenue-other,5eecc6d6449e4f7cfb1c2708,2021-06-06T00:00:00.000Z,IMPS-115705276600-NA-HDFC-XXXXXXXXXX0007 -ALL20210606216820000330830668628,,,net_banking_transfer,19625.96
61b704b0d8beac1599eb57c9,50200023535069,420349.44,60ec41ba55c00300382672d9,HDFC,Transfer in/Revenue-other,5eecc6d6449e4f7cfb1c2708,2021-06-06T00:00:00.000Z,50200050675669-TPT-OG MAY REMIT-HOUZ OF NATURE PVT LTD,,,net_banking_transfer,712.32
61b704b0d8beac1599eb57d5,50200023535069,462087.15,60ec41ba55c00300382672d9,HDFC,Transfer in/Revenue-other,5eecc6d6449e4f7cfb1c2708,2021-06-07T00:00:00.000Z,IMPS-115805874685-NA-HDFC-XXXXXXXXXX0007 -ALL20210607216820000330830668628,,,net_banking_transfer,41737.71
61b704b1d8beac1599eb57dc,50200023535069,371507.15,60ec41ba55c00300382672d9,HDFC,direct expenses,5eecc6d6449e4f7cfb1c2708,2021-06-07T00:00:00.000Z,"NEFT DR-ICIC0000542-AVANTIKA SUKHIA-NETB ANK, MUM-N158211524873340-90580",,,net_banking_transfer,-90580
61b704b2d8beac1599eb57e4,50200023535069,336507.15,60ec41ba55c00300382672d9,HDFC,direct expenses,5eecc6d6449e4f7cfb1c2708,2021-06-07T00:00:00.000Z,"NEFT DR-ICIC0003374-SIDDHARTH KANOJIA-NE TBANK, MUM-N158211524873466-35000",,,net_banking_transfer,-35000
61b704b3d8beac1599eb57f0,50200023535069,244007.15,60ec41ba55c00300382672d9,HDFC,direct expenses,5eecc6d6449e4f7cfb1c2708,2021-06-07T00:00:00.000Z,"NEFT DR-CITI0000002-DHIRAJ-NETBANK, MUM-",,,net_banking_transfer,-92500
61b704b4d8beac1599eb57f4,50200023535069,194007.15,60ec41ba55c00300382672d9,HDFC,direct expenses,5eecc6d6449e4f7cfb1c2708,2021-06-07T00:00:00.000Z,"NEFT DR-UTIB0000120-ADNAN ALI-NETBANK, M UM-N158211524864625-50000",,,net_banking_transfer,-50000
61b704b5d8beac1599eb5805,50200023535069,147657.15,60ec41ba55c00300382672d9,HDFC,direct expenses,5eecc6d6449e4f7cfb1c2708,2021-06-07T00:00:00.000Z,"NEFT DR-SYNB0005170-SNEHAL TAYDE-NETBANK , MUM-N158211524870015-46350",,,net_banking_transfer,-46350
61b704b6d8beac1599eb580c,50200023535069,111657.15,60ec41ba55c00300382672d9,HDFC,direct expenses,5eecc6d6449e4f7cfb1c2708,2021-06-07T00:00:00.000Z,00901610080520-TPT-36000-POOJA KAPIL SHR OTRIYA,,,net_banking_transfer,-36000
61b704b7d8beac1599eb5814,50200023535069,93657.15,60ec41ba55c00300382672d9,HDFC,direct expenses,5eecc6d6449e4f7cfb1c2708,2021-06-07T00:00:00.000Z,"NEFT DR-PUNB0482100-RAM BHAVAN YADAV-NET BANK, MUM-N158211524876962-18000",,,net_banking_transfer,-18000
61b704b8d8beac1599eb5818,50200023535069,55157.15,60ec41ba55c00300382672d9,HDFC,direct expenses,5eecc6d6449e4f7cfb1c2708,2021-06-07T00:00:00.000Z,50100293329616-TPT-38500-SADIYA BANO,,,net_banking_transfer,-38500
61b704b9d8beac1599eb5820,50200023535069,20157.15,60ec41ba55c00300382672d9,HDFC,direct expenses,5eecc6d6449e4f7cfb1c2708,2021-06-07T00:00:00.000Z,50100064106714-TPT-35000-AKSHARANSH BHAT T,,,net_banking_transfer,-35000
61b704bad8beac1599eb582c,50200023535069,420157.15,60ec41ba55c00300382672d9,HDFC,Internal Transfers,5eecc6d6449e4f7cfb1c2708,2021-06-07T00:00:00.000Z,IB FUNDS TRANSFER CR-50200035187206 -SL ICK ORGANICS PVT LTD,insurance,,Other,400000
61b704bbd8beac1599eb5836,50200023535069,289657.15,60ec41ba55c00300382672d9,HDFC,direct expenses,5eecc6d6449e4f7cfb1c2708,2021-06-07T00:00:00.000Z,02771610131904-TPT-130500-DIGANT BHATT,,,net_banking_transfer,-130500
61b704bcd8beac1599eb5840,50200023535069,223657.15,60ec41ba55c00300382672d9,HDFC,direct expenses,5eecc6d6449e4f7cfb1c2708,2021-06-07T00:00:00.000Z,50100330586095-TPT-66000-DIWAKAR UNIYAL,,,net_banking_transfer,-66000
61b704bdd8beac1599eb5846,50200023535069,151657.15,60ec41ba55c00300382672d9,HDFC,direct expenses,5eecc6d6449e4f7cfb1c2708,2021-06-07T00:00:00.000Z,50100301160692-TPT-72000-TARUN GARG,,,net_banking_transfer,-72000
61b704bed8beac1599eb584d,50200023535069,60251.15,60ec41ba55c00300382672d9,HDFC,direct expenses,5eecc6d6449e4f7cfb1c2708,2021-06-07T00:00:00.000Z,"NEFT DR-BARB0VJMATU-ARTISTO DESIGNZ-NETB ANK, MUM-N158211524886242-91406",,,net_banking_transfer,-91406
61b704bfd8beac1599eb5856,50200023535069,2576.15,60ec41ba55c00300382672d9,HDFC,direct expenses,5eecc6d6449e4f7cfb1c2708,2021-06-07T00:00:00.000Z,"NEFT DR-ICIC0000399-RAPIDMILE BUSINESS S OLUTIONS PRIVATE LIM-NETBANK, MUM-N15821 1524886992-57675",loans,lender_transaction,net_banking_transfer,-57675
61b704c0d8beac1599eb585a,50200023535069,202576.15,60ec41ba55c00300382672d9,HDFC,Internal Transfers,5eecc6d6449e4f7cfb1c2708,2021-06-07T00:00:00.000Z,IB FUNDS TRANSFER CR-50200035187206 -SL ICK ORGANICS PVT LTD,insurance,,Other,200000
61b704c1d8beac1599eb5860,50200023535069,181476.15,60ec41ba55c00300382672d9,HDFC,direct expenses,5eecc6d6449e4f7cfb1c2708,2021-06-07T00:00:00.000Z,"NEFT DR-SIBL0000555-JAIVEER KUMAR-NETBAN K, MUM-N158211524906204-21100",,,net_banking_transfer,-21100
61b704c2d8beac1599eb5864,50200023535069,183970.66,60ec41ba55c00300382672d9,HDFC,Revenue-Mktplace,5eecc6d6449e4f7cfb1c2708,2021-06-07T00:00:00.000Z,NEFT CR-DEUT0797BGL-FLIPKART INTERNET PR IVATE LIMITED-SLICK ORGANICS PVT LTD-060 700099GN00219,shopping,,net_banking_transfer,2494.51
61b704c3d8beac1599eb5867,50200023535069,187122.88,60ec41ba55c00300382672d9,HDFC,Revenue-Mktplace,5eecc6d6449e4f7cfb1c2708,2021-06-07T00:00:00.000Z,NEFT CR-DEUT0797BGL-MYNTRA DESIGNS PRIVA TE LIMITED-SLICK ORGANICS PRIVATE LIMITE D-060700118GN00147,shopping,,net_banking_transfer,3152.22
61b704c4d8beac1599eb586c,50200023535069,167122.88,60ec41ba55c00300382672d9,HDFC,direct expenses,5eecc6d6449e4f7cfb1c2708,2021-06-07T00:00:00.000Z,"NEFT DR-PUNB0307800-PRAKASH JHA-NETBANK,",,,net_banking_transfer,-20000
61b704c5d8beac1599eb5874,50200023535069,367122.88,60ec41ba55c00300382672d9,HDFC,Internal Transfers,5eecc6d6449e4f7cfb1c2708,2021-06-07T00:00:00.000Z,IB FUNDS TRANSFER CR-50200035187206 -SL ICK ORGANICS PVT LTD,insurance,,Other,200000
61b704c6d8beac1599eb5879,50200023535069,190322.88,60ec41ba55c00300382672d9,HDFC,direct expenses,5eecc6d6449e4f7cfb1c2708,2021-06-07T00:00:00.000Z,"NEFT DR-SCBL0036031-PR PUNDIT PUBLIC REL ATIONS PRIVATE LIMIT-NETBANK, MUM-N15821 1524966621-176800",insurance,,net_banking_transfer,-176800
61b704c7d8beac1599eb587f,50200023535069,174335.88,60ec41ba55c00300382672d9,HDFC,direct expenses,5eecc6d6449e4f7cfb1c2708,2021-06-07T00:00:00.000Z,"NEFT DR-KKBK0000187-APPLIED LIFE PRIVATE LIMITED-NETBANK, MUM-N158211525028226-1 5987",,,net_banking_transfer,-15987
61b704c8d8beac1599eb5882,50200023535069,175057.19,60ec41ba55c00300382672d9,HDFC,Transfer in/Revenue-other,5eecc6d6449e4f7cfb1c2708,2021-06-07T00:00:00.000Z,NEFT CR-YESB0000001-ILLUMINAR MEDIA-SLIC K ORGANICS PVT LTD-N158210619490956,,,net_banking_transfer,721.31
61b704c8d8beac1599eb5888,50200023535069,148057.19,60ec41ba55c00300382672d9,HDFC,direct expenses,5eecc6d6449e4f7cfb1c2708,2021-06-07T00:00:00.000Z,"NEFT DR-KKBK0000654-NIHARIKA MISHRA-NETB ANK, MUM-N158211525083288-27000",,,net_banking_transfer,-27000
61b704c9d8beac1599eb588f,50200023535069,115657.19,60ec41ba55c00300382672d9,HDFC,direct expenses,5eecc6d6449e4f7cfb1c2708,2021-06-07T00:00:00.000Z,"NEFT DR-BARB0VJMATU-ARTISTO DESIGNZ-NETB ANK, MUM-N158211525201479-32400",,,net_banking_transfer,-32400
61b704cad8beac1599eb5896,50200023535069,94417.19,60ec41ba55c00300382672d9,HDFC,direct expenses,5eecc6d6449e4f7cfb1c2708,2021-06-07T00:00:00.000Z,428607689/CSHFREINSTASPACES,,,Other,-21240
61b704cbd8beac1599eb589b,50200023535069,84979.19,60ec41ba55c00300382672d9,HDFC,direct expenses,5eecc6d6449e4f7cfb1c2708,2021-06-07T00:00:00.000Z,02711600008220-TPT-9438-VARUN SINGH,,,net_banking_transfer,-9438
61b704ccd8beac1599eb589d,50200023535069,89183.84,60ec41ba55c00300382672d9,HDFC,Revenue-Mktplace,5eecc6d6449e4f7cfb1c2708,2021-06-07T00:00:00.000Z,NEFT CR-DEUT0797BGL-MYNTRA DESIGNS PRIVA TE LIMITED-SLICK ORGANICS PRIVATE LIMITE D-060700117GN00072,shopping,,net_banking_transfer,4204.65
61b704cdd8beac1599eb58a2,50200023535069,94612.2,60ec41ba55c00300382672d9,HDFC,Revenue-Mktplace,5eecc6d6449e4f7cfb1c2708,2021-06-07T00:00:00.000Z,NEFT CR-DEUT0797BGL-FLIPKART INTERNET PR IVATE LIMITED-SLICK ORGANICS PVT LTD-060 700127GN00110,shopping,,net_banking_transfer,5428.36
61b704ced8beac1599eb58ab,50200023535069,79612.2,60ec41ba55c00300382672d9,HDFC,direct expenses,5eecc6d6449e4f7cfb1c2708,2021-06-07T00:00:00.000Z,"NEFT DR-PUNB0151400-BHUWAN CHANDER JOSHI -NETBANK, MUM-N158211525618518-15000",,,net_banking_transfer,-15000
61b704cfd8beac1599eb58af,50200023535069,64612.2,60ec41ba55c00300382672d9,HDFC,direct expenses,5eecc6d6449e4f7cfb1c2708,2021-06-07T00:00:00.000Z,02711600008220-TPT-15000-VARUN SINGH,,,net_banking_transfer,-15000
61b704d0d8beac1599eb58b7,50200023535069,64872.78,60ec41ba55c00300382672d9,HDFC,Revenue-Mktplace,5eecc6d6449e4f7cfb1c2708,2021-06-07T00:00:00.000Z,NEFT CR-ICIC0000105-MANASH LIFETYLE PVT LTD-SLICK ORGANICS PVT LTD MP MUM-ICIB21 1580055605,,,net_banking_transfer,260.58
61b704d1d8beac1599eb58bb,50200023535069,65284.02,60ec41ba55c00300382672d9,HDFC,Revenue-Mktplace,5eecc6d6449e4f7cfb1c2708,2021-06-07T00:00:00.000Z,NEFT CR-ICIC0000105-MANASH LIFETYLE PVT,,,net_banking_transfer,411.24
61b704d2d8beac1599eb58be,50200023535069,80574.23,60ec41ba55c00300382672d9,HDFC,Revenue-COD,5eecc6d6449e4f7cfb1c2708,2021-06-07T00:00:00.000Z,NEFT CR-ICIC0000155-SHIPROCKET COD CRF I D 2549737-SLICK ORGANICS PVT LTD-CMS1969 848423,insurance,,net_banking_transfer,15290.21
61b704d3d8beac1599eb58cb,50200023535069,83140.11,60ec41ba55c00300382672d9,HDFC,Revenue-PG-non-split,5eecc6d6449e4f7cfb1c2708,2021-06-07T00:00:00.000Z,NEFT CR-IDFB0010204-SEZZLE PAYMENTS PRIV ATE LIMITED-SLICK ORGANICS PRIVATE LIMIT ED-IDFBH21158297149,insurance,,net_banking_transfer,2565.88
61b704d4d8beac1599eb58cf,50200023535069,87874.47,60ec41ba55c00300382672d9,HDFC,Revenue-PG-non-split,5eecc6d6449e4f7cfb1c2708,2021-06-07T00:00:00.000Z,NEFT CR-IDFB0010204-SEZZLE PAYMENTS PRIV ATE LIMITED-SLICK ORGANICS PRIVATE LIMIT ED-IDFBH21158297377,insurance,,net_banking_transfer,4734.36
61b704d5d8beac1599eb58d4,50200023535069,134290.63,60ec41ba55c00300382672d9,HDFC,Transfer in/Revenue-other,5eecc6d6449e4f7cfb1c2708,2021-06-08T00:00:00.000Z,IMPS-115905678678-NA-HDFC-XXXXXXXXXX0007 -ALL20210608216820000330830668628,,,net_banking_transfer,46416.16
61b704d6d8beac1599eb58d9,50200023535069,242047.53,60ec41ba55c00300382672d9,HDFC,Revenue-Mktplace,5eecc6d6449e4f7cfb1c2708,2021-06-08T00:00:00.000Z,IMPS-115911260021-AMAZON SELLER SERVIC-H DFC-XXXXXXXX6004-31JGHV6WVZ2CV0DZSLICK O RGANICS PVT LTD,shopping,,net_banking_transfer,107756.9
61b704d7d8beac1599eb58dc,50200023535069,781319.88,60ec41ba55c00300382672d9,HDFC,Revenue-Mktplace,5eecc6d6449e4f7cfb1c2708,2021-06-08T00:00:00.000Z,NEFT CR-DEUT0797BGL-AMAZON PAY (INDIA) P RIVATE LIMITED-SLICK ORGANICS PVT LTD-06 0800144GN00108,shopping,,net_banking_transfer,539272.35
61b704d8d8beac1599eb58e9,50200023535069,731319.88,60ec41ba55c00300382672d9,HDFC,Marketing Expense,5eecc6d6449e4f7cfb1c2708,2021-06-08T00:00:00.000Z,POS 514834XXXXXX9486 GOOGLE ADS,,,debit_card,-50000
61b704d9d8beac1599eb58ef,50200023535069,733484.42,60ec41ba55c00300382672d9,HDFC,Revenue-Mktplace,5eecc6d6449e4f7cfb1c2708,2021-06-08T00:00:00.000Z,NEFT CR-ICIC0000105-MANASH LIFETYLE PVT LTD-SLICK ORGANICS PVT LTD MP MUM-ICIB 211590105619,,,net_banking_transfer,2164.54
61b704dad8beac1599eb58f4,50200023535069,733499.78,60ec41ba55c00300382672d9,HDFC,Revenue-Mktplace,5eecc6d6449e4f7cfb1c2708,2021-06-08T00:00:00.000Z,NEFT CR-ICIC0000105-MANASH LIFETYLE PVT LTD-SLICK ORGANICS PVT LTD MP GGN-ICIB 211590105795,,,net_banking_transfer,15.36
61b704dbd8beac1599eb58fa,50200023535069,734328.07,60ec41ba55c00300382672d9,HDFC,Revenue-Mktplace,5eecc6d6449e4f7cfb1c2708,2021-06-08T00:00:00.000Z,NEFT CR-ICIC0000105-MANASH LIFETYLE PVT LTD-SLICK ORGANICS PVT LTD KOLKATA-ICI B211590105621,,,net_banking_transfer,828.29
61b704dcd8beac1599eb58ff,50200023535069,737334,60ec41ba55c00300382672d9,HDFC,Revenue-PG-non-split,5eecc6d6449e4f7cfb1c2708,2021-06-08T00:00:00.000Z,NEFT CR-IDFB0010204-SEZZLE PAYMENTS PRIV ATE LIMITED-SLICK ORGANICS PRIVATE LIMIT ED-IDFBH21159353757,insurance,,net_banking_transfer,3005.93
61b704ddd8beac1599eb5903,50200023535069,737800.45,60ec41ba55c00300382672d9,HDFC,Revenue-PG-non-split,5eecc6d6449e4f7cfb1c2708,2021-06-08T00:00:00.000Z,NEFT CR-ICIC0000031-PAYTM E COMMERCE PVT,ewallet,,net_banking_transfer,466.45
61b704ded8beac1599eb592b,50200023535069,437800.45,60ec41ba55c00300382672d9,HDFC,direct expenses,5eecc6d6449e4f7cfb1c2708,2021-06-08T00:00:00.000Z,05892560000649-TPT-300000-DECORPAC INDIA PRIVATE LIMITED,,,net_banking_transfer,-300000
61b704dfd8beac1599eb5955,50200023535069,457163.19,60ec41ba55c00300382672d9,HDFC,Transfer in/Revenue-other,5eecc6d6449e4f7cfb1c2708,2021-06-09T00:00:00.000Z,IMPS-116005489871-NA-HDFC-XXXXXXXXXX0007 -ALL20210609216820000330830668628,,,net_banking_transfer,19362.74
61b704e0d8beac1599eb5959,50200023535069,460365.28,60ec41ba55c00300382672d9,HDFC,Revenue-Mktplace,5eecc6d6449e4f7cfb1c2708,2021-06-09T00:00:00.000Z,NEFT CR-DEUT0797BGL-FLIPKART INTERNET PR IVATE LIMITED-SLICK ORGANICS PVT LTD-060 900095GN00207,shopping,,net_banking_transfer,3202.09
61b704e0d8beac1599eb595c,50200023535069,463694.26,60ec41ba55c00300382672d9,HDFC,Revenue-Mktplace,5eecc6d6449e4f7cfb1c2708,2021-06-09T00:00:00.000Z,NEFT CR-DEUT0797BGL-FLIPKART INTERNET PR IVATE LIMITED-SLICK ORGANICS PVT LTD-060 900098GN00273,shopping,,net_banking_transfer,3328.98
61b704e1d8beac1599eb5961,50200023535069,469990.78,60ec41ba55c00300382672d9,HDFC,Revenue-Mktplace,5eecc6d6449e4f7cfb1c2708,2021-06-09T00:00:00.000Z,NEFT CR-DEUT0797BGL-MYNTRA DESIGNS PRIVA TE LIMITED-SLICK ORGANICS PRIVATE LIMITE D-060900125GN00164,shopping,,net_banking_transfer,6296.52
61b704e2d8beac1599eb596a,50200023535069,236490.78,60ec41ba55c00300382672d9,HDFC,direct expenses,5eecc6d6449e4f7cfb1c2708,2021-06-09T00:00:00.000Z,"NEFT DR-YESB0000551-VISTTA COSMETICS-NET BANK, MUM-N160211528288877-233500",,,net_banking_transfer,-233500
61b704e3d8beac1599eb596d,50200023535069,237270.04,60ec41ba55c00300382672d9,HDFC,Revenue-PG-non-split,5eecc6d6449e4f7cfb1c2708,2021-06-09T00:00:00.000Z,NEFT CR-IDFB0010204-SEZZLE PAYMENTS PRIV ATE LIMITED-SLICK ORGANICS PRIVATE LIMIT ED-IDFBH21160387533,insurance,,net_banking_transfer,779.26
61b704e4d8beac1599eb5973,50200023535069,282862.07,60ec41ba55c00300382672d9,HDFC,Revenue-COD,5eecc6d6449e4f7cfb1c2708,2021-06-09T00:00:00.000Z,NEFT CR-ICIC0000155-SHIPROCKET COD CRF I D 2562090-SLICK ORGANICS PVT LTD-CMS1973 532675,insurance,,net_banking_transfer,45592.03
61b704e5d8beac1599eb5977,50200023535069,237328.07,60ec41ba55c00300382672d9,HDFC,Salary/Emp/consultant Expense,5eecc6d6449e4f7cfb1c2708,2021-06-09T00:00:00.000Z,"NEFT DR-UTIB0003142-ARIA DESAI UG ELIZAB ETH THOMAS ALEX-NETBANK, MUM-N1602115289 21199-45534",,,net_banking_transfer,-45534
61b704e6d8beac1599eb597b,50200023535069,235113.07,60ec41ba55c00300382672d9,HDFC,direct expenses,5eecc6d6449e4f7cfb1c2708,2021-06-09T00:00:00.000Z,50100097355028-TPT-2215-PALLAVI JUNEJA,,,net_banking_transfer,-2215
61b704e7d8beac1599eb5984,50200023535069,235026.06,60ec41ba55c00300382672d9,HDFC,bank charges,5eecc6d6449e4f7cfb1c2708,2021-06-09T00:00:00.000Z,.DC INTL POS TXN MARKUP+ST 010621 020621 -CDT2116004454936,,,international_transaction_arbitrage,-87.01
61b704e8d8beac1599eb5987,50200023535069,238194.12,60ec41ba55c00300382672d9,HDFC,Revenue-Mktplace,5eecc6d6449e4f7cfb1c2708,2021-06-09T00:00:00.000Z,NEFT CR-ICIC0000105-ICICI BANK NODAL AC MANASH LIFESTYL-SLICKORGANICSPRIVATELIMI TEDMPMUM-ICIJ211600003817,,,net_banking_transfer,3168.06
61b704e9d8beac1599eb598d,50200023535069,238757.06,60ec41ba55c00300382672d9,HDFC,Transfer in/Revenue-other,5eecc6d6449e4f7cfb1c2708,2021-06-09T00:00:00.000Z,NEFT CR-ICIC0000105-ICICI BANK NODAL AC,,,net_banking_transfer,562.94
61b704ead8beac1599eb5990,50200023535069,238932.24,60ec41ba55c00300382672d9,HDFC,Revenue-Mktplace,5eecc6d6449e4f7cfb1c2708,2021-06-09T00:00:00.000Z,NEFT CR-ICIC0000105-ICICI BANK NODAL AC MANASH LIFESTYL-SLICKORGANICSPRIVATELIMI TEDHYD-ICIJ211600003818,,,net_banking_transfer,175.18
61b704ebd8beac1599eb5993,50200023535069,241777.03,60ec41ba55c00300382672d9,HDFC,Revenue-Mktplace,5eecc6d6449e4f7cfb1c2708,2021-06-09T00:00:00.000Z,NEFT CR-ICIC0000105-ICICI BANK NODAL AC MANASH LIFESTYL-SLICKORGANICSPRIVATELIMI TEDMPGGN-ICIJ211600003815,,,net_banking_transfer,2844.79
61b704ecd8beac1599eb599b,50200023535069,269084.8,60ec41ba55c00300382672d9,HDFC,Transfer in/Revenue-other,5eecc6d6449e4f7cfb1c2708,2021-06-10T00:00:00.000Z,IMPS-116105286854-NA-HDFC-XXXXXXXXXX0007 -ALL20210610216820000330830668628,,,net_banking_transfer,27307.77
61b704edd8beac1599eb59a1,50200023535069,179722.8,60ec41ba55c00300382672d9,HDFC,direct expenses,5eecc6d6449e4f7cfb1c2708,2021-06-10T00:00:00.000Z,00921000075586-TPT-89362-ROET BINDRA,,,net_banking_transfer,-89362
61b704eed8beac1599eb59a5,50200023535069,164722.8,60ec41ba55c00300382672d9,HDFC,direct expenses,5eecc6d6449e4f7cfb1c2708,2021-06-10T00:00:00.000Z,"NEFT DR-BARB0DBKHAN-ARUNT RANSPORT-NETBA NK, MUM-N161211530347314-15000",travel,,net_banking_transfer,-15000
61b704efd8beac1599eb59ab,50200023535069,165234.43,60ec41ba55c00300382672d9,HDFC,Revenue-Mktplace,5eecc6d6449e4f7cfb1c2708,2021-06-10T00:00:00.000Z,NEFT CR-ICIC0000105-MANASH LIFETYLE PVT LTD-SLICK ORGANICS PRIVATE LIMITED HYD -ICIB211610060668,,,net_banking_transfer,511.63
61b704f0d8beac1599eb59ae,50200023535069,170615.44,60ec41ba55c00300382672d9,HDFC,Revenue-Mktplace,5eecc6d6449e4f7cfb1c2708,2021-06-10T00:00:00.000Z,NEFT CR-ICIC0000105-MANASH LIFETYLE PVT LTD-SLICK ORGANICS PRIVATE LIMITED MP MUM-ICIB211610060667,,,net_banking_transfer,5381.01
61b704f1d8beac1599eb59d3,50200023535069,180326.27,60ec41ba55c00300382672d9,HDFC,Revenue-Mktplace,5eecc6d6449e4f7cfb1c2708,2021-06-10T00:00:00.000Z,NEFT CR-ICIC0000105-MANASH LIFETYLE PVT LTD-SLICK ORGANICS PRIVATE LIMITED MP GGN-ICIB211610060665,,,net_banking_transfer,9710.83
61b704f2d8beac1599eb59d8,50200023535069,171830.27,60ec41ba55c00300382672d9,HDFC,direct expenses,5eecc6d6449e4f7cfb1c2708,2021-06-10T00:00:00.000Z,"NEFT DR-SBIN0008078-PANDIT PLASTICS-NETB ANK, MUM-N161211530381498-8496",,,net_banking_transfer,-8496
61b704f3d8beac1599eb59dc,50200023535069,191693.89,60ec41ba55c00300382672d9,HDFC,Transfer in/Revenue-other,5eecc6d6449e4f7cfb1c2708,2021-06-11T00:00:00.000Z,IMPS-116205060284-NA-HDFC-XXXXXXXXXX0007 -ALL20210611216820000330830668628,,,net_banking_transfer,19863.62
61b704f4d8beac1599eb59e1,50200023535069,198920.38,60ec41ba55c00300382672d9,HDFC,Revenue-Mktplace,5eecc6d6449e4f7cfb1c2708,2021-06-11T00:00:00.000Z,NEFT CR-DEUT0797BGL-FLIPKART INTERNET PR IVATE LIMITED-SLICK ORGANICS PVT LTD-061 100089GN00272,shopping,,net_banking_transfer,7226.49
61b704f5d8beac1599eb59e4,50200023535069,206857.84,60ec41ba55c00300382672d9,HDFC,Revenue-Mktplace,5eecc6d6449e4f7cfb1c2708,2021-06-11T00:00:00.000Z,NEFT CR-DEUT0797BGL-FLIPKART INTERNET PR,shopping,,net_banking_transfer,7937.46
61b704f6d8beac1599eb59e8,50200023535069,427469.93,60ec41ba55c00300382672d9,HDFC,Revenue-PG-split enabled,5eecc6d6449e4f7cfb1c2708,2021-06-11T00:00:00.000Z,RTGS CR-UTIB0001506-RAZORPAY SOFTWARE PR IVATE LIMITED --SLICK ORGANICS PVT LITD- UTIBR52021061100333940,,,net_banking_transfer,220612.09
61b704f7d8beac1599eb59f2,50200023535069,436059.79,60ec41ba55c00300382672d9,HDFC,Revenue-Mktplace,5eecc6d6449e4f7cfb1c2708,2021-06-11T00:00:00.000Z,NEFT CR-DEUT0797BGL-MYNTRA DESIGNS PRIVA TE LIMITED-SLICK ORGANICS PRIVATE LIMITE D-061100112GN00209,shopping,,net_banking_transfer,8589.86
61b704f8d8beac1599eb59ff,50200023535069,4436059.79,60ec41ba55c00300382672d9,HDFC,Internal Transfers,5eecc6d6449e4f7cfb1c2708,2021-06-11T00:00:00.000Z,IB FUNDS TRANSFER CR-50200035187206 -SL ICK ORGANICS PVT LTD,insurance,,Other,4000000
61b704f9d8beac1599eb5a06,50200023535069,783374.18,60ec41ba55c00300382672d9,HDFC,direct expenses,5eecc6d6449e4f7cfb1c2708,2021-06-11T00:00:00.000Z,ADVANCE PAYMENT OF IMPORT BILL,bills,,Other,-3652685.61
61b704fad8beac1599eb5a0a,50200023535069,383374.18,60ec41ba55c00300382672d9,HDFC,direct expenses,5eecc6d6449e4f7cfb1c2708,2021-06-11T00:00:00.000Z,"NEFT DR-PYTM0123456-PAYTM-NETBANK, MUM-N 162211531096758-400000",ewallet,,net_banking_transfer,-400000
61b704fad8beac1599eb5a0d,50200023535069,329054.18,60ec41ba55c00300382672d9,HDFC,Marketing Expense,5eecc6d6449e4f7cfb1c2708,2021-06-11T00:00:00.000Z,"NEFT DR-CITI0000006-FACEBOOK INDIA ONLIN E SERVICES PVT LTD-NETBANK, MUM-N1622115 31108041-54320",,,net_banking_transfer,-54320
61b704fbd8beac1599eb5a16,50200023535069,1329054.18,60ec41ba55c00300382672d9,HDFC,Internal Transfers,5eecc6d6449e4f7cfb1c2708,2021-06-11T00:00:00.000Z,IB FUNDS TRANSFER CR-50200035187206 -SL ICK ORGANICS PVT LTD,insurance,,Other,1000000
61b704fcd8beac1599eb5a1a,50200023535069,24374.18,60ec41ba55c00300382672d9,HDFC,Marketing Expense,5eecc6d6449e4f7cfb1c2708,2021-06-11T00:00:00.000Z,"NEFT DR-CITI0000006-FACEBOOK INDIA ONLIN E SERVICES PVT LTD-NETBANK, MUM-N1622115 31132258-1304680",,,net_banking_transfer,-1304680
61b704fdd8beac1599eb5a1f,50200023535069,25816.37,60ec41ba55c00300382672d9,HDFC,Revenue-Mktplace,5eecc6d6449e4f7cfb1c2708,2021-06-11T00:00:00.000Z,NEFT CR-DEUT0784BBY-TATA UNISTORE LIMITE D-SLICK ORGANICS PVT LTD-061101045GN0013 9,insurance,,net_banking_transfer,1442.19
61b704fed8beac1599eb5a27,50200023535069,28062.95,60ec41ba55c00300382672d9,HDFC,Revenue-Mktplace,5eecc6d6449e4f7cfb1c2708,2021-06-11T00:00:00.000Z,NEFT CR-DEUT0784BBY-TATA UNISTORE LTD-NO DAL-SLICK ORGANICS PVT LTD-061101050GN00 199,insurance,,net_banking_transfer,2246.58
61b704ffd8beac1599eb5a2d,50200023535069,29968.31,60ec41ba55c00300382672d9,HDFC,Transfer in/Revenue-other,5eecc6d6449e4f7cfb1c2708,2021-06-11T00:00:00.000Z,4060001797-10 06 2021-HDFAZCUR1,,,Other,1905.36
61b70500d8beac1599eb5a34,50200023535069,18168.31,60ec41ba55c00300382672d9,HDFC,direct expenses,5eecc6d6449e4f7cfb1c2708,2021-06-11T00:00:00.000Z,POS 514834XXXXXX9486 PAYU-WWW.TOWNSCR,,,debit_card,-11800
61b70501d8beac1599eb5a6e,50200023535069,18667.49,60ec41ba55c00300382672d9,HDFC,Revenue-Mktplace,5eecc6d6449e4f7cfb1c2708,2021-06-11T00:00:00.000Z,NEFT CR-ICIC0000105-ICICI BANK NODAL AC MANASH LIFESTYL-SLICK ORGANICS PRIVATE L IMITED KOLK-ICIJ211620005394,,,net_banking_transfer,499.18
61b70502d8beac1599eb5a96,50200023535069,29713.5,60ec41ba55c00300382672d9,HDFC,Transfer in/Revenue-other,5eecc6d6449e4f7cfb1c2708,2021-06-11T00:00:00.000Z,NEFT CR-ICIC0000105-ICICI BANK NODAL AC,,,net_banking_transfer,11046.01
61b70503d8beac1599eb5ac5,50200023535069,39937.39,60ec41ba55c00300382672d9,HDFC,Revenue-Mktplace,5eecc6d6449e4f7cfb1c2708,2021-06-11T00:00:00.000Z,NEFT CR-ICIC0000105-ICICI BANK NODAL AC MANASH LIFESTYL-SLICK ORGANICS PRIVATE L IMITED MP G-ICIJ211620005390,,,net_banking_transfer,10223.89
61b70504d8beac1599eb5aca,50200023535069,79800.34,60ec41ba55c00300382672d9,HDFC,Revenue-PG-split enabled,5eecc6d6449e4f7cfb1c2708,2021-06-11T00:00:00.000Z,NEFT CR-UTIB0001506-RAZORPAY SOFTWARE PR IVATE LIMITED-SLICK ORGANICS PVT LITD-AX ISCN0081814260,insurance,,net_banking_transfer,39862.95
61b70505d8beac1599eb5ad6,50200023535069,198967.4,60ec41ba55c00300382672d9,HDFC,Revenue-COD,5eecc6d6449e4f7cfb1c2708,2021-06-11T00:00:00.000Z,NEFT CR-ICIC0000155-SHIPROCKET COD CRF I D 2574318-SLICK ORGANICS PVT LTD-CMS1976 679327,insurance,,net_banking_transfer,119167.06
61b70506d8beac1599eb5adb,50200023535069,203109.84,60ec41ba55c00300382672d9,HDFC,Revenue-PG-non-split,5eecc6d6449e4f7cfb1c2708,2021-06-11T00:00:00.000Z,NEFT CR-IDFB0010204-SEZZLE PAYMENTS PRIV ATE LIMITED-SLICK ORGANICS PRIVATE LIMIT ED-IDFBH21162518607,insurance,,net_banking_transfer,4142.44
61b70507d8beac1599eb5adf,50200023535069,203783,60ec41ba55c00300382672d9,HDFC,Transfer in/Revenue-other,5eecc6d6449e4f7cfb1c2708,2021-06-11T00:00:00.000Z,NEFT CR-YESB0000001-ILLUMINAR MEDIA-SLIC K ORGANICS PVT LTD-N162210625595053,,,net_banking_transfer,673.16
61b70508d8beac1599eb5ae4,50200023535069,203984.88,60ec41ba55c00300382672d9,HDFC,Transfer in/Revenue-other,5eecc6d6449e4f7cfb1c2708,2021-06-11T00:00:00.000Z,NEFT CR-YESB0000001-ILUMINAR MEDIA-SLICK ORGANICS-N162210625596597,,,net_banking_transfer,201.88
61b70509d8beac1599eb5ae8,50200023535069,284768.58,60ec41ba55c00300382672d9,HDFC,Transfer in/Revenue-other,5eecc6d6449e4f7cfb1c2708,2021-06-12T00:00:00.000Z,IMPS-116305832507-NA-HDFC-XXXXXXXXXX0007 -ALL20210612216820000330830668628,,,net_banking_transfer,80783.7
61b7050ad8beac1599eb5af1,50200023535069,281178.2,60ec41ba55c00300382672d9,HDFC,direct expenses,5eecc6d6449e4f7cfb1c2708,2021-06-12T00:00:00.000Z,POS 514834XXXXXX9486 WWW.FAQPRIME.COM,,,debit_card,-3590.38
61b7050bd8beac1599eb5af7,50200023535069,298740.18,60ec41ba55c00300382672d9,HDFC,Transfer in/Revenue-other,5eecc6d6449e4f7cfb1c2708,2021-06-13T00:00:00.000Z,IMPS-116406656408-NA-HDFC-XXXXXXXXXX0007 -ALL20210613216820000330830668628,,,net_banking_transfer,17561.98
61b7050cd8beac1599eb5afd,50200023535069,248740.18,60ec41ba55c00300382672d9,HDFC,Marketing Expense,5eecc6d6449e4f7cfb1c2708,2021-06-13T00:00:00.000Z,POS 514834XXXXXX9486 GOOGLE ADS,,,debit_card,-50000
61b7050dd8beac1599eb5b03,50200023535069,250761.18,60ec41ba55c00300382672d9,HDFC,Revenue-PG-non-split,5eecc6d6449e4f7cfb1c2708,2021-06-14T00:00:00.000Z,NEFT CR-YESB0000001-RZPX PVT LTD-SLICKOR GANICS-N165210627145678,insurance,,salary,2021
61b7050ed8beac1599eb5b08,50200023535069,252049.37,60ec41ba55c00300382672d9,HDFC,Revenue-PG-non-split,5eecc6d6449e4f7cfb1c2708,2021-06-14T00:00:00.000Z,NEFT CR-YESB0000001-RZPX PVT LTD-SLICKOR GANICS-N165210627148652,insurance,,salary,1288.19
61b7050fd8beac1599eb5b0e,50200023535069,284507.16,60ec41ba55c00300382672d9,HDFC,Transfer in/Revenue-other,5eecc6d6449e4f7cfb1c2708,2021-06-14T00:00:00.000Z,IMPS-116506301800-NA-HDFC-XXXXXXXXXX0007 -ALL20210614216820000330830668628,,,net_banking_transfer,32457.79
61b70510d8beac1599eb5b16,50200023535069,294421.48,60ec41ba55c00300382672d9,HDFC,Revenue-Mktplace,5eecc6d6449e4f7cfb1c2708,2021-06-14T00:00:00.000Z,NEFT CR-DEUT0797BGL-FLIPKART INTERNET PR,shopping,,net_banking_transfer,9914.32
61b70511d8beac1599eb5b1b,50200023535069,300574.92,60ec41ba55c00300382672d9,HDFC,Revenue-Mktplace,5eecc6d6449e4f7cfb1c2708,2021-06-14T00:00:00.000Z,NEFT CR-DEUT0797BGL-MYNTRA DESIGNS PRIVA TE LIMITED-SLICK ORGANICS PRIVATE LIMITE D-061400169GN00128,shopping,,net_banking_transfer,6153.44
61b70512d8beac1599eb5b20,50200023535069,367784.69,60ec41ba55c00300382672d9,HDFC,Revenue-PG-split enabled,5eecc6d6449e4f7cfb1c2708,2021-06-14T00:00:00.000Z,NEFT CR-UTIB0001506-RAZORPAY SOFTWARE PR IVATE LIMITED-SLICK ORGANICS PVT LITD-AX ISCN0081851907,insurance,,net_banking_transfer,67209.77
61b70513d8beac1599eb5b24,50200023535069,380071.47,60ec41ba55c00300382672d9,HDFC,Revenue-Mktplace,5eecc6d6449e4f7cfb1c2708,2021-06-14T00:00:00.000Z,NEFT CR-DEUT0797BGL-FLIPKART INTERNET PR IVATE LIMITED-SLICK ORGANICS PVT LTD-061 400080GN00066,shopping,,net_banking_transfer,12286.78
61b70513d8beac1599eb5b2b,50200023535069,379626.08,60ec41ba55c00300382672d9,HDFC,bank charges,5eecc6d6449e4f7cfb1c2708,2021-06-14T00:00:00.000Z,.DC INTL POS TXN MARKUP+ST 040621 050621 -CDT2116004454936,,,international_transaction_arbitrage,-445.39
61b70514d8beac1599eb5b33,50200023535069,377148.08,60ec41ba55c00300382672d9,HDFC,direct expenses,5eecc6d6449e4f7cfb1c2708,2021-06-14T00:00:00.000Z,POS 514834XXXXXX9486 RAZ*KNOWLARITY,,,debit_card,-2478
61b70515d8beac1599eb5b37,50200023535069,427738.25,60ec41ba55c00300382672d9,HDFC,Revenue-COD,5eecc6d6449e4f7cfb1c2708,2021-06-14T00:00:00.000Z,NEFT CR-ICIC0000155-SHIPROCKET COD CRF I D 2582530-SLICK ORGANICS PVT LTD-CMS1979 309077,insurance,,net_banking_transfer,50590.17
61b70516d8beac1599eb5b3e,50200023535069,431998.69,60ec41ba55c00300382672d9,HDFC,Revenue-Mktplace,5eecc6d6449e4f7cfb1c2708,2021-06-14T00:00:00.000Z,4060001767-TIMES INTERNET LIMITED NODAL,,,Other,4260.44
61b70517d8beac1599eb5b44,50200023535069,437083.55,60ec41ba55c00300382672d9,HDFC,Revenue-Mktplace,5eecc6d6449e4f7cfb1c2708,2021-06-14T00:00:00.000Z,NEFT CR-ICIC0000105-ICICI BANK NODAL AC MANASH LIFESTYL-SLICK ORGANICS PRIVATE L IMITED MP G-ICIJ211650003081,,,net_banking_transfer,5084.86
61b70518d8beac1599eb5b48,50200023535069,437901.59,60ec41ba55c00300382672d9,HDFC,Revenue-Mktplace,5eecc6d6449e4f7cfb1c2708,2021-06-14T00:00:00.000Z,NEFT CR-ICIC0000105-ICICI BANK NODAL AC MANASH LIFESTYL-SLICK ORGANICS PRIVATE L IMITED HYD-ICIJ211650003084,,,net_banking_transfer,818.04
61b70519d8beac1599eb5b54,50200023535069,439836.76,60ec41ba55c00300382672d9,HDFC,Revenue-Mktplace,5eecc6d6449e4f7cfb1c2708,2021-06-14T00:00:00.000Z,NEFT CR-ICIC0000105-ICICI BANK NODAL AC MANASH LIFESTYL-SLICK ORGANICS PRIVATE L IMITED MP M-ICIJ211650003082,,,net_banking_transfer,1935.17
61b7051ad8beac1599eb5b56,50200023535069,452866.55,60ec41ba55c00300382672d9,HDFC,Revenue-PG-split enabled,5eecc6d6449e4f7cfb1c2708,2021-06-14T00:00:00.000Z,NEFT CR-UTIB0001506-RAZORPAY SOFTWARE PR IVATE LIMITED-SLICK ORGANICS PVT LITD-AX ISCN0081985275,insurance,,net_banking_transfer,13029.79
61b7051bd8beac1599eb5b7b,50200023535069,474416.12,60ec41ba55c00300382672d9,HDFC,Transfer in/Revenue-other,5eecc6d6449e4f7cfb1c2708,2021-06-15T00:00:00.000Z,IMPS-116605124687-NA-HDFC-XXXXXXXXXX0007 -ALL20210615216820000330830668628,,,net_banking_transfer,21549.57
61b7051cd8beac1599eb5b7f,50200023535069,474888.85,60ec41ba55c00300382672d9,HDFC,Revenue-PG-non-split,5eecc6d6449e4f7cfb1c2708,2021-06-15T00:00:00.000Z,NEFT CR-ICIC0000031-PAYTM E COMMERCE PVT,ewallet,,net_banking_transfer,472.73
61b7051dd8beac1599eb5b84,50200023535069,480169.84,60ec41ba55c00300382672d9,HDFC,Revenue-PG-split enabled,5eecc6d6449e4f7cfb1c2708,2021-06-15T00:00:00.000Z,NEFT CR-UTIB0001506-RAZORPAY SOFTWARE PR IVATE LIMITED-SLICK ORGANICS PVT LITD-AX ISCN0082010415,insurance,,net_banking_transfer,5280.99
61b7051ed8beac1599eb5b8c,50200023535069,603160.49,60ec41ba55c00300382672d9,HDFC,Revenue-Mktplace,5eecc6d6449e4f7cfb1c2708,2021-06-15T00:00:00.000Z,IMPS-116611138565-AMAZON SELLER SERVIC-H DFC-XXXXXXXX6004-3XH5J532ZB4O14Q9SLICK O RGANICS PVT LTD,shopping,,net_banking_transfer,122990.65
61b7051fd8beac1599eb5b92,50200023535069,1121330.33,60ec41ba55c00300382672d9,HDFC,Revenue-Mktplace,5eecc6d6449e4f7cfb1c2708,2021-06-15T00:00:00.000Z,NEFT CR-DEUT0797BGL-AMAZON PAY (INDIA) P RIVATE LIMITED-SLICK ORGANICS PVT LTD-06 1500154GN00369,shopping,,net_banking_transfer,518169.84
61b70520d8beac1599eb5b97,50200023535069,1122583.05,60ec41ba55c00300382672d9,HDFC,Revenue-Mktplace,5eecc6d6449e4f7cfb1c2708,2021-06-15T00:00:00.000Z,NEFT CR-ICIC0000105-MANASH LIFETYLE PVT LTD-SLICKORGANICSPRIVATELIMITEDMPMUM-ICI B211660045867,,,net_banking_transfer,1252.72
61b70521d8beac1599eb5b9e,50200023535069,1125509.95,60ec41ba55c00300382672d9,HDFC,Revenue-Mktplace,5eecc6d6449e4f7cfb1c2708,2021-06-15T00:00:00.000Z,NEFT CR-ICIC0000105-MANASH LIFETYLE PVT LTD-SLICKORGANICSPRIVATELIMITEDMPGGN-ICI B211660045865,,,net_banking_transfer,2926.9
61b70522d8beac1599eb5ba4,50200023535069,1131264.56,60ec41ba55c00300382672d9,HDFC,Revenue-PG-non-split,5eecc6d6449e4f7cfb1c2708,2021-06-15T00:00:00.000Z,NEFT CR-IDFB0010204-SEZZLE PAYMENTS PRIV ATE LIMITED-SLICK ORGANICS PRIVATE LIMIT ED-IDFBH21166655295,insurance,,net_banking_transfer,5754.61
61b70523d8beac1599eb5baa,50200023535069,1142236.33,60ec41ba55c00300382672d9,HDFC,Revenue-PG-split enabled,5eecc6d6449e4f7cfb1c2708,2021-06-15T00:00:00.000Z,NEFT CR-UTIB0001506-RAZORPAY SOFTWARE PR IVATE LIMITED-SLICK ORGANICS PVT LITD-AX ISCN0082099119,insurance,,net_banking_transfer,10971.77
61b70524d8beac1599eb5bb8,50200023535069,1141224.01,60ec41ba55c00300382672d9,HDFC,direct expenses,5eecc6d6449e4f7cfb1c2708,2021-06-15T00:00:00.000Z,POS 514834XXXXXX9486 DNH*GODADDY.COM,,,debit_card,-1012.32
61b70525d8beac1599eb5bc8,50200023535069,1174746.09,60ec41ba55c00300382672d9,HDFC,Transfer in/Revenue-other,5eecc6d6449e4f7cfb1c2708,2021-06-16T00:00:00.000Z,IMPS-116706973252-NA-HDFC-XXXXXXXXXX0007 -ALL20210616216820000330830668628,,,net_banking_transfer,33522.08
61b70526d8beac1599eb5bd8,50200023535069,1178473.9,60ec41ba55c00300382672d9,HDFC,Revenue-Mktplace,5eecc6d6449e4f7cfb1c2708,2021-06-16T00:00:00.000Z,NEFT CR-DEUT0797BGL-FLIPKART INTERNET PR IVATE LIMITED-SLICK ORGANICS PVT LTD-061 600063GN00037,shopping,,net_banking_transfer,3727.81
61b70527d8beac1599eb5be2,50200023535069,1191657.56,60ec41ba55c00300382672d9,HDFC,Revenue-Mktplace,5eecc6d6449e4f7cfb1c2708,2021-06-16T00:00:00.000Z,NEFT CR-DEUT0797BGL-FLIPKART INTERNET PR IVATE LIMITED-SLICK ORGANICS PVT LTD-061 600098GN00113,shopping,,net_banking_transfer,13183.66
61b70528d8beac1599eb5bf2,50200023535069,1195715.24,60ec41ba55c00300382672d9,HDFC,Revenue-Mktplace,5eecc6d6449e4f7cfb1c2708,2021-06-16T00:00:00.000Z,NEFT CR-DEUT0797BGL-MYNTRA DESIGNS PRIVA,shopping,,net_banking_transfer,4057.68
61b70529d8beac1599eb5c22,50200023535069,1152715.24,60ec41ba55c00300382672d9,HDFC,agency/vendor expense,5eecc6d6449e4f7cfb1c2708,2021-06-16T00:00:00.000Z,50200012277211-TPT-43000-VALUEFIRST DIGI TAL MEDIA PRIVATE LIMITED,,,net_banking_transfer,-43000
61b7052ad8beac1599eb5c2b,50200023535069,1158322.42,60ec41ba55c00300382672d9,HDFC,Revenue-PG-split enabled,5eecc6d6449e4f7cfb1c2708,2021-06-16T00:00:00.000Z,NEFT CR-UTIB0001506-RAZORPAY SOFTWARE PR IVATE LIMITED-SLICK ORGANICS PVT LITD-AX ISCN0082159796,insurance,,net_banking_transfer,5607.18
61b7052bd8beac1599eb5c33,50200023535069,1268030.81,60ec41ba55c00300382672d9,HDFC,Revenue-COD,5eecc6d6449e4f7cfb1c2708,2021-06-16T00:00:00.000Z,NEFT CR-ICIC0000155-SHIPROCKET COD CRF I D 2594883-SLICK ORGANICS PVT LTD-CMS1982 703743,insurance,,net_banking_transfer,109708.39
61b7052bd8beac1599eb5c41,50200023535069,1287115.57,60ec41ba55c00300382672d9,HDFC,Revenue-Mktplace,5eecc6d6449e4f7cfb1c2708,2021-06-16T00:00:00.000Z,NEFT CR-ICIC0000105-ICICI BANK NODAL AC MANASH LIFESTYL-SLICK ORGANICS PRIVATE L IMITED MP M-ICIJ211670001250,,,net_banking_transfer,19084.76
61b7052cd8beac1599eb5c46,50200023535069,1287364.07,60ec41ba55c00300382672d9,HDFC,Revenue-Mktplace,5eecc6d6449e4f7cfb1c2708,2021-06-16T00:00:00.000Z,NEFT CR-ICIC0000105-ICICI BANK NODAL AC MANASH LIFESTYL-SLICK ORGANICS PRIVATE L IMITED KOLK-ICIJ211670001251,,,net_banking_transfer,248.5
61b7052dd8beac1599eb5c52,50200023535069,1292891,60ec41ba55c00300382672d9,HDFC,Revenue-Mktplace,5eecc6d6449e4f7cfb1c2708,2021-06-16T00:00:00.000Z,NEFT CR-ICIC0000105-ICICI BANK NODAL AC MANASH LIFESTYL-SLICK ORGANICS PRIVATE L IMITED MP G-ICIJ211670001248,,,net_banking_transfer,5526.93
61b7052ed8beac1599eb5c58,50200023535069,1293718.33,60ec41ba55c00300382672d9,HDFC,Revenue-PG-non-split,5eecc6d6449e4f7cfb1c2708,2021-06-16T00:00:00.000Z,NEFT CR-IDFB0010204-SEZZLE PAYMENTS PRIV ATE LIMITED-SLICK ORGANICS PRIVATE LIMIT ED-IDFBH21167702273,insurance,,net_banking_transfer,827.33
61b7052fd8beac1599eb5c5e,50200023535069,1301952.33,60ec41ba55c00300382672d9,HDFC,Revenue-Mktplace,5eecc6d6449e4f7cfb1c2708,2021-06-16T00:00:00.000Z,NEFT CR-SCBL0036001-M/S DREAMPLUG TECHNO -SLICK ORGANICS PRIVATE LIMITEDSLICK-SIN 31436Q0015018,insurance,,net_banking_transfer,8234
61b70530d8beac1599eb5c62,50200023535069,1331589.06,60ec41ba55c00300382672d9,HDFC,Revenue-PG-split enabled,5eecc6d6449e4f7cfb1c2708,2021-06-16T00:00:00.000Z,NEFT CR-UTIB0001506-RAZORPAY SOFTWARE PR IVATE LIMITED-SLICK ORGANICS PVT LITD-AX ISCN0082202289,insurance,,net_banking_transfer,29636.73
61b70531d8beac1599eb5c6b,50200023535069,1171589.06,60ec41ba55c00300382672d9,HDFC,direct expenses,5eecc6d6449e4f7cfb1c2708,2021-06-16T00:00:00.000Z,"NEFT DR-YESB0000551-VISTTA COSMETICS-NET BANK, MUM-N167211536147865-160000",,,net_banking_transfer,-160000
61b70532d8beac1599eb5c74,50200023535069,1201932.74,60ec41ba55c00300382672d9,HDFC,Transfer in/Revenue-other,5eecc6d6449e4f7cfb1c2708,2021-06-17T00:00:00.000Z,50200019889031-TPT-BRAND TRANSFER-1908 E,,,net_banking_transfer,30343.68
61b70533d8beac1599eb5caf,50200023535069,1212658.88,60ec41ba55c00300382672d9,HDFC,Transfer in/Revenue-other,5eecc6d6449e4f7cfb1c2708,2021-06-17T00:00:00.000Z,IMPS-116805750640-NA-HDFC-XXXXXXXXXX0007 -ALL20210617216820000330830668628,,,net_banking_transfer,10726.14
61b70534d8beac1599eb5d08,50200023535069,1229389.26,60ec41ba55c00300382672d9,HDFC,Revenue-PG-split enabled,5eecc6d6449e4f7cfb1c2708,2021-06-17T00:00:00.000Z,NEFT CR-UTIB0001506-RAZORPAY SOFTWARE PR IVATE LIMITED-SLICK ORGANICS PVT LITD-AX ISCN0082237320,insurance,,net_banking_transfer,16730.38
61b70535d8beac1599eb5d2c,50200023535069,1179389.26,60ec41ba55c00300382672d9,HDFC,Marketing Expense,5eecc6d6449e4f7cfb1c2708,2021-06-17T00:00:00.000Z,POS 514834XXXXXX9486 GOOGLE ADS,,,debit_card,-50000
61b70536d8beac1599eb5d35,50200023535069,1183346,60ec41ba55c00300382672d9,HDFC,Revenue-Mktplace,5eecc6d6449e4f7cfb1c2708,2021-06-17T00:00:00.000Z,NEFT CR-ICIC0000105-ICICI BANK NODAL AC MANASH LIFESTYL-SLICK ORGANICS PRIVATE L IMITED MP G-ICIJ211680000180,,,net_banking_transfer,3956.74
61b70537d8beac1599eb5d41,50200023535069,1189428.43,60ec41ba55c00300382672d9,HDFC,Revenue-Mktplace,5eecc6d6449e4f7cfb1c2708,2021-06-17T00:00:00.000Z,NEFT CR-ICIC0000105-ICICI BANK NODAL AC MANASH LIFESTYL-SLICK ORGANICS PRIVATE L IMITED MP M-ICIJ211680002483,,,net_banking_transfer,6082.43
61b70538d8beac1599eb5d49,50200023535069,1190395.96,60ec41ba55c00300382672d9,HDFC,Revenue-Mktplace,5eecc6d6449e4f7cfb1c2708,2021-06-17T00:00:00.000Z,NEFT CR-ICIC0000105-ICICI BANK NODAL AC MANASH LIFESTYL-SLICK ORGANICS PRIVATE L IMITED HYD-ICIJ211680000181,,,net_banking_transfer,967.53
61b70539d8beac1599eb5d4f,50200023535069,935395.96,60ec41ba55c00300382672d9,HDFC,SAAS/tech expense,5eecc6d6449e4f7cfb1c2708,2021-06-17T00:00:00.000Z,VHDF0047577820/BILLDKAMAZONSELLERSE,shopping,,Other,-255000
61b7053ad8beac1599eb5d54,50200023535069,953288.57,60ec41ba55c00300382672d9,HDFC,Revenue-PG-split enabled,5eecc6d6449e4f7cfb1c2708,2021-06-17T00:00:00.000Z,NEFT CR-UTIB0001506-RAZORPAY SOFTWARE PR IVATE LIMITED-SLICK ORGANICS PVT LITD-AX ISCN0082312064,insurance,,net_banking_transfer,17892.61
61b7053bd8beac1599eb5d5a,50200023535069,955488.77,60ec41ba55c00300382672d9,HDFC,Revenue-PG-non-split,5eecc6d6449e4f7cfb1c2708,2021-06-17T00:00:00.000Z,NEFT CR-IDFB0010204-SEZZLE PAYMENTS PRIV ATE LIMITED-SLICK ORGANICS PRIVATE LIMIT ED-IDFBH21168754795,insurance,,net_banking_transfer,2200.2
61b7053cd8beac1599eb5d5e,50200023535069,979456.68,60ec41ba55c00300382672d9,HDFC,Transfer in/Revenue-other,5eecc6d6449e4f7cfb1c2708,2021-06-18T00:00:00.000Z,IMPS-116905587054-NA-HDFC-XXXXXXXXXX0007 -ALL20210618216820000330830668628,,,net_banking_transfer,23967.91
61b7053dd8beac1599eb5d67,50200023535069,985442.64,60ec41ba55c00300382672d9,HDFC,Revenue-Mktplace,5eecc6d6449e4f7cfb1c2708,2021-06-18T00:00:00.000Z,NEFT CR-DEUT0797BGL-MYNTRA DESIGNS PRIVA TE LIMITED-SLICK ORGANICS PRIVATE LIMITE D-061800103GN00253,shopping,,net_banking_transfer,5985.96
61b7053ed8beac1599eb5d6e,50200023535069,1001631.52,60ec41ba55c00300382672d9,HDFC,Revenue-PG-split enabled,5eecc6d6449e4f7cfb1c2708,2021-06-18T00:00:00.000Z,NEFT CR-UTIB0001506-RAZORPAY SOFTWARE PR IVATE LIMITED-SLICK ORGANICS PVT LITD-AX ISCN0082348849,insurance,,net_banking_transfer,16188.88
61b7053fd8beac1599eb5d74,50200023535069,1002890.34,60ec41ba55c00300382672d9,HDFC,Revenue-Mktplace,5eecc6d6449e4f7cfb1c2708,2021-06-18T00:00:00.000Z,NEFT CR-DEUT0784BBY-TATA UNISTORE LTD-NO,,,net_banking_transfer,1258.82
61b70540d8beac1599eb5d7a,50200023535069,1003239.58,60ec41ba55c00300382672d9,HDFC,Revenue-Mktplace,5eecc6d6449e4f7cfb1c2708,2021-06-18T00:00:00.000Z,NEFT CR-DEUT0784BBY-TATA UNISTORE LTD-NO DAL-SLICK ORGANICS PVT LTD-061800752GN00 374,insurance,,net_banking_transfer,349.24
61b70541d8beac1599eb5d82,50200023535069,1024827.71,60ec41ba55c00300382672d9,HDFC,Revenue-Mktplace,5eecc6d6449e4f7cfb1c2708,2021-06-18T00:00:00.000Z,NEFT CR-DEUT0797BGL-FLIPKART INTERNET PR IVATE LIMITED-SLICK ORGANICS PVT LTD-061 800310GN00018,shopping,,net_banking_transfer,21588.13
61b70542d8beac1599eb5d93,50200023535069,1037293.71,60ec41ba55c00300382672d9,HDFC,Transfer in/Revenue-other,5eecc6d6449e4f7cfb1c2708,2021-06-18T00:00:00.000Z,50200050241205-TPT-ARATA-NAPSA PRIVATE L IMITED,,,net_banking_transfer,12466
61b70543d8beac1599eb5d9a,50200023535069,1054867.64,60ec41ba55c00300382672d9,HDFC,Revenue-Mktplace,5eecc6d6449e4f7cfb1c2708,2021-06-18T00:00:00.000Z,NEFT CR-DEUT0797BGL-FLIPKART INTERNET PR IVATE LIMITED-SLICK ORGANICS PVT LTD-061 800308GN00057,shopping,,net_banking_transfer,17573.93
61b70544d8beac1599eb5d9e,50200023535069,1143298.3,60ec41ba55c00300382672d9,HDFC,Revenue-COD,5eecc6d6449e4f7cfb1c2708,2021-06-18T00:00:00.000Z,NEFT CR-ICIC0000155-SHIPROCKET COD CRF I D 2607117-SLICK ORGANICS PVT LTD-CMS1985 225598,insurance,,net_banking_transfer,88430.66
61b70544d8beac1599eb5da2,50200023535069,1147109.26,60ec41ba55c00300382672d9,HDFC,Transfer in/Revenue-other,5eecc6d6449e4f7cfb1c2708,2021-06-18T00:00:00.000Z,ZOOBOP ME WORK-ARATA,,,Other,3810.96
61b70545d8beac1599eb5da9,50200023535069,1152850.87,60ec41ba55c00300382672d9,HDFC,Revenue-Mktplace,5eecc6d6449e4f7cfb1c2708,2021-06-18T00:00:00.000Z,NEFT CR-ICIC0000105-ICICI BANK NODAL AC MANASH LIFESTYL-SLICK ORGANICS PRIVATE L IMITED MP M-ICIJ211690005189,,,net_banking_transfer,5741.61
61b70546d8beac1599eb5db3,50200023535069,1153097.89,60ec41ba55c00300382672d9,HDFC,Revenue-Mktplace,5eecc6d6449e4f7cfb1c2708,2021-06-18T00:00:00.000Z,NEFT CR-ICIC0000105-ICICI BANK NODAL AC MANASH LIFESTYL-SLICK ORGANICS PRIVATE L IMITED KOLK-ICIJ211690005191,,,net_banking_transfer,247.02
61b70547d8beac1599eb5dbd,50200023535069,1156466.83,60ec41ba55c00300382672d9,HDFC,Revenue-Mktplace,5eecc6d6449e4f7cfb1c2708,2021-06-18T00:00:00.000Z,NEFT CR-ICIC0000105-ICICI BANK NODAL AC MANASH LIFESTYL-SLICK ORGANICS PRIVATE L IMITED MP G-ICIJ211690005187,,,net_banking_transfer,3368.94
61b70548d8beac1599eb5dc7,50200023535069,1157028.51,60ec41ba55c00300382672d9,HDFC,Revenue-Mktplace,5eecc6d6449e4f7cfb1c2708,2021-06-18T00:00:00.000Z,NEFT CR-DEUT0784BBY-TATA UNISTORE LIMITE D-SLICK ORGANICS PVT LTD-061801354GN0025 7,insurance,,net_banking_transfer,561.68
61b70549d8beac1599eb5dca,50200023535069,1179721.8,60ec41ba55c00300382672d9,HDFC,Revenue-PG-split enabled,5eecc6d6449e4f7cfb1c2708,2021-06-18T00:00:00.000Z,NEFT CR-UTIB0001506-RAZORPAY SOFTWARE PR IVATE LIMITED-SLICK ORGANICS PVT LITD-AX ISCN0082427576,insurance,,net_banking_transfer,22693.29
61b7054ad8beac1599eb5dcf,50200023535069,1180519.25,60ec41ba55c00300382672d9,HDFC,Revenue-PG-non-split,5eecc6d6449e4f7cfb1c2708,2021-06-18T00:00:00.000Z,NEFT CR-IDFB0010204-SEZZLE PAYMENTS PRIV,,,net_banking_transfer,797.45
61b7054bd8beac1599eb5dda,50200023535069,1183580.73,60ec41ba55c00300382672d9,HDFC,Revenue-PG-non-split,5eecc6d6449e4f7cfb1c2708,2021-06-19T00:00:00.000Z,NEFT CR-YESB0000001-RZPX PVT LTD-SLICKOR GANICS-N170210633038404,insurance,,salary,3061.48
61b7054cd8beac1599eb5dde,50200023535069,1224327.05,60ec41ba55c00300382672d9,HDFC,Transfer in/Revenue-other,5eecc6d6449e4f7cfb1c2708,2021-06-19T00:00:00.000Z,IMPS-117005377128-NA-HDFC-XXXXXXXXXX0007 -ALL20210619216820000330830668628,,,net_banking_transfer,40746.32
61b7054dd8beac1599eb5de7,50200023535069,1254742.32,60ec41ba55c00300382672d9,HDFC,Revenue-PG-split enabled,5eecc6d6449e4f7cfb1c2708,2021-06-19T00:00:00.000Z,NEFT CR-UTIB0001506-RAZORPAY SOFTWARE PR IVATE LIMITED-SLICK ORGANICS PVT LITD-AX ISCN0082441121,insurance,,net_banking_transfer,30415.27
61b7054ed8beac1599eb5dea,50200023535069,1202242.32,60ec41ba55c00300382672d9,HDFC,direct expenses,5eecc6d6449e4f7cfb1c2708,2021-06-19T00:00:00.000Z,02771610131904-TPT-52500-DIGANT BHATT,,,net_banking_transfer,-52500
61b7054fd8beac1599eb5def,50200023535069,1202862.82,60ec41ba55c00300382672d9,HDFC,Revenue-PG-non-split,5eecc6d6449e4f7cfb1c2708,2021-06-19T00:00:00.000Z,NEFT CR-IDFB0010204-SEZZLE PAYMENTS PRIV ATE LIMITED-SLICK ORGANICS PRIVATE LIMIT ED-IDFBH21170851892,insurance,,net_banking_transfer,620.5
61b70550d8beac1599eb5df7,50200023535069,1211224.71,60ec41ba55c00300382672d9,HDFC,Revenue-PG-split enabled,5eecc6d6449e4f7cfb1c2708,2021-06-19T00:00:00.000Z,NEFT CR-UTIB0001506-RAZORPAY SOFTWARE PR IVATE LIMITED-SLICK ORGANICS PVT LITD-AX ISCN0082497886,insurance,,net_banking_transfer,8361.89
61b70551d8beac1599eb5dfc,50200023535069,1236418.25,60ec41ba55c00300382672d9,HDFC,Transfer in/Revenue-other,5eecc6d6449e4f7cfb1c2708,2021-06-20T00:00:00.000Z,IMPS-117105170775-NA-HDFC-XXXXXXXXXX0007 -ALL20210620216820000330830668628,,,net_banking_transfer,25193.54
61b70552d8beac1599eb5e02,50200023535069,1231220.1,60ec41ba55c00300382672d9,HDFC,direct expenses,5eecc6d6449e4f7cfb1c2708,2021-06-20T00:00:00.000Z,POS 514834XXXXXX9486 FEEDBACKFIVE,,,debit_card,-5198.15
61b70553d8beac1599eb5e07,50200023535069,1181220.1,60ec41ba55c00300382672d9,HDFC,Marketing Expense,5eecc6d6449e4f7cfb1c2708,2021-06-20T00:00:00.000Z,POS 514834XXXXXX9486 GOOGLE ADS,,,debit_card,-50000
61b70554d8beac1599eb5e0d,50200023535069,1173866.32,60ec41ba55c00300382672d9,HDFC,direct expenses,5eecc6d6449e4f7cfb1c2708,2021-06-20T00:00:00.000Z,POS 514834XXXXXX9486 HOTJAR,,,debit_card,-7353.78
61b70555d8beac1599eb5e16,50200023535069,1199644.05,60ec41ba55c00300382672d9,HDFC,Transfer in/Revenue-other,5eecc6d6449e4f7cfb1c2708,2021-06-21T00:00:00.000Z,IMPS-117205818685-NA-HDFC-XXXXXXXXXX0007 -ALL20210621216820000330830668628,,,net_banking_transfer,25777.73
61b70556d8beac1599eb5e1c,50200023535069,1208321.48,60ec41ba55c00300382672d9,HDFC,Revenue-Mktplace,5eecc6d6449e4f7cfb1c2708,2021-06-21T00:00:00.000Z,NEFT CR-DEUT0797BGL-FLIPKART INTERNET PR IVATE LIMITED-SLICK ORGANICS PVT LTD-062 100094GN00180,shopping,,net_banking_transfer,8677.43
61b70557d8beac1599eb5e23,50200023535069,1211907.64,60ec41ba55c00300382672d9,HDFC,Revenue-Mktplace,5eecc6d6449e4f7cfb1c2708,2021-06-21T00:00:00.000Z,NEFT CR-DEUT0797BGL-FLIPKART INTERNET PR IVATE LIMITED-SLICK ORGANICS PVT LTD-062 100119GN00161,shopping,,net_banking_transfer,3586.16
61b70558d8beac1599eb5e27,50200023535069,1220963.58,60ec41ba55c00300382672d9,HDFC,Revenue-Mktplace,5eecc6d6449e4f7cfb1c2708,2021-06-21T00:00:00.000Z,NEFT CR-DEUT0797BGL-MYNTRA DESIGNS PRIVA,shopping,,net_banking_transfer,9055.94
61b70559d8beac1599eb5e2a,50200023535069,1251927.68,60ec41ba55c00300382672d9,HDFC,Revenue-PG-split enabled,5eecc6d6449e4f7cfb1c2708,2021-06-21T00:00:00.000Z,NEFT CR-UTIB0001506-RAZORPAY SOFTWARE PR IVATE LIMITED-SLICK ORGANICS PVT LITD-AX ISCN0082523233,insurance,,net_banking_transfer,30964.1
61b7055ad8beac1599eb5e2f,50200023535069,1231927.68,60ec41ba55c00300382672d9,HDFC,direct expenses,5eecc6d6449e4f7cfb1c2708,2021-06-21T00:00:00.000Z,CASH W/D SARVAN KUMAR - CHQ PAID - NEHRU PLACE,,,chq,-20000
61b7055bd8beac1599eb5e38,50200023535069,1249978.19,60ec41ba55c00300382672d9,HDFC,Revenue-COD,5eecc6d6449e4f7cfb1c2708,2021-06-21T00:00:00.000Z,NEFT CR-ICIC0000155-SHIPROCKET COD CRF I D 2615318-SLICK ORGANICS PVT LTD-CMS1987 971874,insurance,,net_banking_transfer,18050.51
61b7055cd8beac1599eb5e3d,50200023535069,1254286.1,60ec41ba55c00300382672d9,HDFC,Revenue-Mktplace,5eecc6d6449e4f7cfb1c2708,2021-06-21T00:00:00.000Z,NEFT CR-ICIC0000105-ICICI BANK NODAL AC MANASH LIFESTYL-SLICK ORGANICS PRIVATE L IMITED MP G-ICIJ211720002819,,,net_banking_transfer,4307.91
61b7055dd8beac1599eb5e42,50200023535069,1260211.74,60ec41ba55c00300382672d9,HDFC,Revenue-Mktplace,5eecc6d6449e4f7cfb1c2708,2021-06-21T00:00:00.000Z,NEFT CR-ICIC0000105-ICICI BANK NODAL AC MANASH LIFESTYL-SLICK ORGANICS PRIVATE L IMITED MP M-ICIJ211720000721,,,net_banking_transfer,5925.64
61b7055dd8beac1599eb5e45,50200023535069,1260891.96,60ec41ba55c00300382672d9,HDFC,Revenue-Mktplace,5eecc6d6449e4f7cfb1c2708,2021-06-21T00:00:00.000Z,NEFT CR-ICIC0000105-ICICI BANK NODAL AC MANASH LIFESTYL-SLICK ORGANICS PRIVATE L IMITED KOLK-ICIJ211720000723,,,net_banking_transfer,680.22
61b7055ed8beac1599eb5e4d,50200023535069,1280921.11,60ec41ba55c00300382672d9,HDFC,Revenue-PG-split enabled,5eecc6d6449e4f7cfb1c2708,2021-06-21T00:00:00.000Z,NEFT CR-UTIB0001506-RAZORPAY SOFTWARE PR IVATE LIMITED-SLICK ORGANICS PVT LITD-AX ISCN0082684620,insurance,,net_banking_transfer,20029.15
61b7055fd8beac1599eb5e56,50200023535069,1321091.83,60ec41ba55c00300382672d9,HDFC,Transfer in/Revenue-other,5eecc6d6449e4f7cfb1c2708,2021-06-22T00:00:00.000Z,IMPS-117305670514-NA-HDFC-XXXXXXXXXX0007 -ALL20210622216820000330830668628,,,net_banking_transfer,40170.72
61b70560d8beac1599eb5e59,50200023535069,1336849.76,60ec41ba55c00300382672d9,HDFC,Revenue-PG-split enabled,5eecc6d6449e4f7cfb1c2708,2021-06-22T00:00:00.000Z,NEFT CR-UTIB0001506-RAZORPAY SOFTWARE PR IVATE LIMITED-SLICK ORGANICS PVT LITD-AX ISCN0082708568,insurance,,net_banking_transfer,15757.93
61b70561d8beac1599eb5e5e,50200023535069,1326049.76,60ec41ba55c00300382672d9,HDFC,direct expenses,5eecc6d6449e4f7cfb1c2708,2021-06-22T00:00:00.000Z,"NEFT DR-BKDN0450123-ARTISTO DESIGNZ-NETB ANK, MUM-N173211540289025-10800",,,net_banking_transfer,-10800
61b70562d8beac1599eb5e62,50200023535069,1312599.76,60ec41ba55c00300382672d9,HDFC,direct expenses,5eecc6d6449e4f7cfb1c2708,2021-06-22T00:00:00.000Z,"NEFT DR-SBIN0008078-PANDIT PLASTICS-NETB ANK, MUM-N173211540296335-13450",,,net_banking_transfer,-13450
61b70563d8beac1599eb5e67,50200023535069,1418630.64,60ec41ba55c00300382672d9,HDFC,Revenue-Mktplace,5eecc6d6449e4f7cfb1c2708,2021-06-22T00:00:00.000Z,IMPS-117311284303-AMAZON SELLER SERVIC-H,shopping,,net_banking_transfer,106030.88
61b70564d8beac1599eb5e71,50200023535069,1914086.98,60ec41ba55c00300382672d9,HDFC,Revenue-Mktplace,5eecc6d6449e4f7cfb1c2708,2021-06-22T00:00:00.000Z,NEFT CR-DEUT0797BGL-AMAZON PAY (INDIA) P RIVATE LIMITED-SLICK ORGANICS PVT LTD-06 2200141GN00225,shopping,,net_banking_transfer,495456.34
61b70565d8beac1599eb5e75,50200023535069,1923240.98,60ec41ba55c00300382672d9,HDFC,Revenue-Mktplace,5eecc6d6449e4f7cfb1c2708,2021-06-22T00:00:00.000Z,NEFT CR-SCBL0036001-M/S DREAMPLUG TECHNO -SLICK ORGANICS PRIVATE LIMITEDSLICK-SIN 31436Q0015343,insurance,,net_banking_transfer,9154
61b70566d8beac1599eb5e7d,50200023535069,1925280.96,60ec41ba55c00300382672d9,HDFC,Revenue-Mktplace,5eecc6d6449e4f7cfb1c2708,2021-06-22T00:00:00.000Z,NEFT CR-ICIC0000105-ICICI BANK NODAL AC MANASH LIFESTYL-SLICK ORGANICS PRIVATE L IMITED MP G-ICIJ211730003200,,,net_banking_transfer,2039.98
61b70567d8beac1599eb5e7f,50200023535069,1927305.55,60ec41ba55c00300382672d9,HDFC,Revenue-Mktplace,5eecc6d6449e4f7cfb1c2708,2021-06-22T00:00:00.000Z,NEFT CR-ICIC0000105-ICICI BANK NODAL AC MANASH LIFESTYL-SLICK ORGANICS PRIVATE L IMITED MP M-ICIJ211730001269,,,net_banking_transfer,2024.59
61b70568d8beac1599eb5e83,50200023535069,1942547.6,60ec41ba55c00300382672d9,HDFC,Revenue-PG-split enabled,5eecc6d6449e4f7cfb1c2708,2021-06-22T00:00:00.000Z,NEFT CR-UTIB0001506-RAZORPAY SOFTWARE PR IVATE LIMITED-SLICK ORGANICS PVT LITD-AX ISCN0082796926,insurance,,net_banking_transfer,15242.05
61b70569d8beac1599eb5e8c,50200023535069,1947741.29,60ec41ba55c00300382672d9,HDFC,Revenue-PG-non-split,5eecc6d6449e4f7cfb1c2708,2021-06-22T00:00:00.000Z,NEFT CR-IDFB0010204-SEZZLE PAYMENTS PRIV ATE LIMITED-SLICK ORGANICS PRIVATE LIMIT ED-IDFBH21173952046,insurance,,net_banking_transfer,5193.69
61b7056ad8beac1599eb5e8f,50200023535069,1948361.79,60ec41ba55c00300382672d9,HDFC,Revenue-PG-non-split,5eecc6d6449e4f7cfb1c2708,2021-06-22T00:00:00.000Z,NEFT CR-IDFB0010204-SEZZLE PAYMENTS PRIV ATE LIMITED-SLICK ORGANICS PRIVATE LIMIT ED-IDFBH21173952024,insurance,,net_banking_transfer,620.5
61b7056bd8beac1599eb5e93,50200023535069,1981531.79,60ec41ba55c00300382672d9,HDFC,Transfer in/Revenue-other,5eecc6d6449e4f7cfb1c2708,2021-06-23T00:00:00.000Z,IMPS-117405525815-NA-HDFC-XXXXXXXXXX0007 -ALL20210623216820000330830668628,,,net_banking_transfer,33170
61b7056cd8beac1599eb5ea5,50200023535069,1987063.86,60ec41ba55c00300382672d9,HDFC,Revenue-Mktplace,5eecc6d6449e4f7cfb1c2708,2021-06-23T00:00:00.000Z,NEFT CR-DEUT0797BGL-FLIPKART INTERNET PR IVATE LIMITED-SLICK ORGANICS PVT LTD-062 300078GN00095,shopping,,net_banking_transfer,5532.07
61b7056dd8beac1599eb5ea9,50200023535069,1993406.84,60ec41ba55c00300382672d9,HDFC,Revenue-Mktplace,5eecc6d6449e4f7cfb1c2708,2021-06-23T00:00:00.000Z,NEFT CR-DEUT0797BGL-FLIPKART INTERNET PR IVATE LIMITED-SLICK ORGANICS PVT LTD-062 300112GN00220,shopping,,net_banking_transfer,6342.98
61b7056ed8beac1599eb5eb3,50200023535069,2009971.48,60ec41ba55c00300382672d9,HDFC,Revenue-PG-split enabled,5eecc6d6449e4f7cfb1c2708,2021-06-23T00:00:00.000Z,NEFT CR-UTIB0001506-RAZORPAY SOFTWARE PR,,,net_banking_transfer,16564.64
61b7056fd8beac1599eb5eba,50200023535069,2013815.68,60ec41ba55c00300382672d9,HDFC,Revenue-Mktplace,5eecc6d6449e4f7cfb1c2708,2021-06-23T00:00:00.000Z,NEFT CR-DEUT0797BGL-MYNTRA DESIGNS PRIVA TE LIMITED-SLICK ORGANICS PRIVATE LIMITE D-062300195GN00036,shopping,,net_banking_transfer,3844.2
61b70570d8beac1599eb5ec0,50200023535069,2013416.68,60ec41ba55c00300382672d9,HDFC,SAAS/tech expense,5eecc6d6449e4f7cfb1c2708,2021-06-23T00:00:00.000Z,POS 514834XXXXXX9486 AMAZON,shopping,,debit_card,-399
61b70571d8beac1599eb5ec6,50200023535069,1913416.68,60ec41ba55c00300382672d9,HDFC,SAAS/tech expense,5eecc6d6449e4f7cfb1c2708,2021-06-23T00:00:00.000Z,VHDF0060919533/BILLDKAMAZONSELLERSE,shopping,,Other,-100000
61b70572d8beac1599eb5eca,50200023535069,1863416.68,60ec41ba55c00300382672d9,HDFC,Marketing Expense,5eecc6d6449e4f7cfb1c2708,2021-06-23T00:00:00.000Z,POS 514834XXXXXX9486 GOOGLE ADS,,,debit_card,-50000
61b70573d8beac1599eb5ecf,50200023535069,1864864.51,60ec41ba55c00300382672d9,HDFC,Revenue-PG-non-split,5eecc6d6449e4f7cfb1c2708,2021-06-23T00:00:00.000Z,NEFT CR-IDFB0010204-SEZZLE PAYMENTS PRIV ATE LIMITED-SLICK ORGANICS PRIVATE LIMIT ED-IDFBH21174996457,insurance,,net_banking_transfer,1447.83
61b70574d8beac1599eb5ed7,50200023535069,1885296.08,60ec41ba55c00300382672d9,HDFC,Revenue-PG-split enabled,5eecc6d6449e4f7cfb1c2708,2021-06-23T00:00:00.000Z,NEFT CR-UTIB0001506-RAZORPAY SOFTWARE PR IVATE LIMITED-SLICK ORGANICS PVT LITD-AX ISCN0082883256,insurance,,net_banking_transfer,20431.57
61b70575d8beac1599eb5edb,50200023535069,1921210.05,60ec41ba55c00300382672d9,HDFC,Transfer in/Revenue-other,5eecc6d6449e4f7cfb1c2708,2021-06-24T00:00:00.000Z,IMPS-117505547131-NA-HDFC-XXXXXXXXXX0007 -ALL20210624216820000330830668628,,,net_banking_transfer,35913.97
61b70576d8beac1599eb5edf,50200023535069,1929670.21,60ec41ba55c00300382672d9,HDFC,Revenue-PG-split enabled,5eecc6d6449e4f7cfb1c2708,2021-06-24T00:00:00.000Z,NEFT CR-UTIB0001506-RAZORPAY SOFTWARE PR IVATE LIMITED-SLICK ORGANICS PVT LITD-AX ISCN0082911060,insurance,,net_banking_transfer,8460.16
61b70577d8beac1599eb5ee1,50200023535069,1910505.21,60ec41ba55c00300382672d9,HDFC,direct expenses,5eecc6d6449e4f7cfb1c2708,2021-06-24T00:00:00.000Z,"NEFT DR-KKBK0000187-APPLIED LIFE PRIVATE LIMITED-NETBANK, MUM-N175211542419848-1 9165",,,net_banking_transfer,-19165
61b70578d8beac1599eb5ee6,50200023535069,1910356.93,60ec41ba55c00300382672d9,HDFC,bank charges,5eecc6d6449e4f7cfb1c2708,2021-06-24T00:00:00.000Z,.DC INTL POS TXN MARKUP+ST 120621 150621 -CDT2116004454936,,,international_transaction_arbitrage,-148.28
61b70578d8beac1599eb5ef7,50200023535069,1956260.93,60ec41ba55c00300382672d9,HDFC,Revenue-Mktplace,5eecc6d6449e4f7cfb1c2708,2021-06-24T00:00:00.000Z,NEFT CR-ICIC0SF0002-THREPSI SOLUTIONS PV -SLICK ORGANICS PVT LTD-24407647151DC,insurance,,net_banking_transfer,45904
61b70579d8beac1599eb5efa,50200023535069,1959897.59,60ec41ba55c00300382672d9,HDFC,Revenue-PG-non-split,5eecc6d6449e4f7cfb1c2708,2021-06-24T00:00:00.000Z,NEFT CR-IDFB0010204-SEZZLE PAYMENTS PRIV ATE LIMITED-SLICK ORGANICS PRIVATE LIMIT ED-IDFBH21175031513,insurance,,net_banking_transfer,3636.66
61b7057ad8beac1599eb5f01,50200023535069,1960373.68,60ec41ba55c00300382672d9,HDFC,Transfer in/Revenue-other,5eecc6d6449e4f7cfb1c2708,2021-06-24T00:00:00.000Z,4060002207-24 06 2021-HDFAZCUR1,,,Other,476.09
61b7057bd8beac1599eb5f04,50200023535069,1969260.65,60ec41ba55c00300382672d9,HDFC,Revenue-PG-split enabled,5eecc6d6449e4f7cfb1c2708,2021-06-24T00:00:00.000Z,NEFT CR-UTIB0001506-RAZORPAY SOFTWARE PR IVATE LIMITED-SLICK ORGANICS PVT LITD-AX ISCN0083007932,insurance,,net_banking_transfer,8886.97
61b7057cd8beac1599eb5f09,50200023535069,1969453.31,60ec41ba55c00300382672d9,HDFC,Revenue-PG-non-split,5eecc6d6449e4f7cfb1c2708,2021-06-24T00:00:00.000Z,NEFT CR-ICIC0000031-PAYTM E COMMERCE PVT,ewallet,,net_banking_transfer,192.66
61b7057dd8beac1599eb5f12,50200023535069,1986895.02,60ec41ba55c00300382672d9,HDFC,Transfer in/Revenue-other,5eecc6d6449e4f7cfb1c2708,2021-06-25T00:00:00.000Z,IMPS-117605146694-NA-HDFC-XXXXXXXXXX0007 -ALL20210625216820000330830668628,,,net_banking_transfer,17441.71
61b7057ed8beac1599eb5f16,50200023535069,1990878.7,60ec41ba55c00300382672d9,HDFC,Revenue-Mktplace,5eecc6d6449e4f7cfb1c2708,2021-06-25T00:00:00.000Z,NEFT CR-DEUT0797BGL-FLIPKART INTERNET PR IVATE LIMITED-SLICK ORGANICS PVT LTD-062 500404GN00288,shopping,,net_banking_transfer,3983.68
61b7057fd8beac1599eb5f1d,50200023535069,2004089.85,60ec41ba55c00300382672d9,HDFC,Revenue-Mktplace,5eecc6d6449e4f7cfb1c2708,2021-06-25T00:00:00.000Z,NEFT CR-DEUT0797BGL-FLIPKART INTERNET PR IVATE LIMITED-SLICK ORGANICS PVT LTD-062 500435GN00133,shopping,,net_banking_transfer,13211.15
61b70580d8beac1599eb5f21,50200023535069,2022427.7,60ec41ba55c00300382672d9,HDFC,Revenue-PG-split enabled,5eecc6d6449e4f7cfb1c2708,2021-06-25T00:00:00.000Z,NEFT CR-UTIB0001506-RAZORPAY SOFTWARE PR IVATE LIMITED-SLICK ORGANICS PVT LITD-AX ISCN0083037283,insurance,,net_banking_transfer,18337.85
61b70581d8beac1599eb5f24,50200023535069,2023859.61,60ec41ba55c00300382672d9,HDFC,Revenue-Mktplace,5eecc6d6449e4f7cfb1c2708,2021-06-25T00:00:00.000Z,4060002177-TIMES INTERNET LIMITED NODAL,,,Other,1431.91
61b70582d8beac1599eb5f2f,50200023535069,2024727.93,60ec41ba55c00300382672d9,HDFC,Transfer in/Revenue-other,5eecc6d6449e4f7cfb1c2708,2021-06-25T00:00:00.000Z,NEFT CR-ICIC0SF0002-ICICI BANK NODAL A-C -SLICK ORGANICS-24412964691DC,insurance,,net_banking_transfer,868.32
61b70583d8beac1599eb5f36,50200023535069,2059156.17,60ec41ba55c00300382672d9,HDFC,Revenue-Mktplace,5eecc6d6449e4f7cfb1c2708,2021-06-25T00:00:00.000Z,NEFT CR-ICIC0SF0002-THREPSI SOLUTIONS PV -SLICK ORGANICS PRIVATE LIMITED-24413306 951DC,insurance,,net_banking_transfer,34428.24
61b70584d8beac1599eb5f3b,50200023535069,2061413.23,60ec41ba55c00300382672d9,HDFC,Revenue-Mktplace,5eecc6d6449e4f7cfb1c2708,2021-06-25T00:00:00.000Z,NEFT CR-DEUT0784BBY-TATA UNISTORE LIMITE D-SLICK ORGANICS PVT LTD-062501167GN0026 1,insurance,,net_banking_transfer,2257.06
61b70585d8beac1599eb5f40,50200023535069,2062883.42,60ec41ba55c00300382672d9,HDFC,Revenue-Mktplace,5eecc6d6449e4f7cfb1c2708,2021-06-25T00:00:00.000Z,NEFT CR-DEUT0784BBY-TATA UNISTORE LTD-NO DAL-SLICK ORGANICS PVT LTD-062501174GN00 381,insurance,,net_banking_transfer,1470.19
61b70586d8beac1599eb5f43,50200023535069,2063302.54,60ec41ba55c00300382672d9,HDFC,Revenue-Mktplace,5eecc6d6449e4f7cfb1c2708,2021-06-25T00:00:00.000Z,NEFT CR-DEUT0784BBY-TATA UNISTORE LTD-NO DAL-SLICK ORGANICS PVT LTD-062501175GN00 270,insurance,,net_banking_transfer,419.12
61b70587d8beac1599eb5f48,50200023535069,2070524.36,60ec41ba55c00300382672d9,HDFC,Revenue-Mktplace,5eecc6d6449e4f7cfb1c2708,2021-06-25T00:00:00.000Z,NEFT CR-DEUT0797BGL-MYNTRA DESIGNS PRIVA TE LIMITED-SLICK ORGANICS PRIVATE LIMITE D-062500799GN00250,shopping,,net_banking_transfer,7221.82
61b70588d8beac1599eb5f4f,50200023535069,1815524.36,60ec41ba55c00300382672d9,HDFC,SAAS/tech expense,5eecc6d6449e4f7cfb1c2708,2021-06-25T00:00:00.000Z,VHDF0066760089/BILLDKAMAZONSELLERSE,shopping,,Other,-255000
61b70589d8beac1599eb5f53,50200023535069,1866346.03,60ec41ba55c00300382672d9,HDFC,Revenue-PG-split enabled,5eecc6d6449e4f7cfb1c2708,2021-06-25T00:00:00.000Z,NEFT CR-UTIB0001506-RAZORPAY SOFTWARE PR IVATE LIMITED-SLICK ORGANICS PVT LITD-AX ISCN0083122385,insurance,,net_banking_transfer,50821.67
61b7058ad8beac1599eb5f61,50200023535069,1867596.52,60ec41ba55c00300382672d9,HDFC,Revenue-PG-non-split,5eecc6d6449e4f7cfb1c2708,2021-06-25T00:00:00.000Z,NEFT CR-IDFB0010204-SEZZLE PAYMENTS PRIV ATE LIMITED-SLICK ORGANICS PRIVATE LIMIT ED-IDFBH21176113041,insurance,,net_banking_transfer,1250.49
61b7058bd8beac1599eb5f66,50200023535069,1868111.64,60ec41ba55c00300382672d9,HDFC,Transfer in/Revenue-other,5eecc6d6449e4f7cfb1c2708,2021-06-25T00:00:00.000Z,NEFT CR-YESB0000001-ILUMINAR MEDIA-SLICK ORGANICS-N176210639818671,,,net_banking_transfer,515.12
61b7058cd8beac1599eb5f6c,50200023535069,1926194.96,60ec41ba55c00300382672d9,HDFC,Transfer in/Revenue-other,5eecc6d6449e4f7cfb1c2708,2021-06-26T00:00:00.000Z,IMPS-117705993540-NA-HDFC-XXXXXXXXXX0007 -ALL20210626216820000330830668628,,,net_banking_transfer,58083.32
61b7058dd8beac1599eb5f78,50200023535069,1929449.09,60ec41ba55c00300382672d9,HDFC,Revenue-Mktplace,5eecc6d6449e4f7cfb1c2708,2021-06-26T00:00:00.000Z,NEFT CR-DEUT0797BGL-MYNTRA DESIGNS PRIVA TE LIMITED-SLICK ORGANICS PRIVATE LIMITE D-062600057GN00068,shopping,,net_banking_transfer,3254.13
61b7058ed8beac1599eb5f7c,50200023535069,1945997.75,60ec41ba55c00300382672d9,HDFC,Transfer in/Revenue-other,5eecc6d6449e4f7cfb1c2708,2021-06-27T00:00:00.000Z,IMPS-117805751485-NA-HDFC-XXXXXXXXXX0007 -ALL20210627216820000330830668628,,,net_banking_transfer,16548.66
61b7058fd8beac1599eb5f82,50200023535069,1895997.75,60ec41ba55c00300382672d9,HDFC,Marketing Expense,5eecc6d6449e4f7cfb1c2708,2021-06-27T00:00:00.000Z,POS 514834XXXXXX9486 GOOGLE ADS,,,debit_card,-50000
61b7058fd8beac1599eb5f87,50200023535069,1924774.17,60ec41ba55c00300382672d9,HDFC,Transfer in/Revenue-other,5eecc6d6449e4f7cfb1c2708,2021-06-28T00:00:00.000Z,IMPS-117905422235-NA-HDFC-XXXXXXXXXX0007 -ALL20210628216820000330830668628,,,net_banking_transfer,28776.42
61b70591d8beac1599eb5f92,50200023535069,1937325.14,60ec41ba55c00300382672d9,HDFC,Revenue-Mktplace,5eecc6d6449e4f7cfb1c2708,2021-06-28T00:00:00.000Z,NEFT CR-DEUT0797BGL-FLIPKART INTERNET PR IVATE LIMITED-SLICK ORGANICS PVT LTD-062 800127GN00012,shopping,,net_banking_transfer,12550.97
61b70591d8beac1599eb5f9e,50200023535069,2024123.13,60ec41ba55c00300382672d9,HDFC,Revenue-PG-split enabled,5eecc6d6449e4f7cfb1c2708,2021-06-28T00:00:00.000Z,NEFT CR-UTIB0001506-RAZORPAY SOFTWARE PR IVATE LIMITED-SLICK ORGANICS PVT LITD-AX ISCN0083172070,insurance,,net_banking_transfer,86797.99
61b70592d8beac1599eb5fa2,50200023535069,2023908.45,60ec41ba55c00300382672d9,HDFC,bank charges,5eecc6d6449e4f7cfb1c2708,2021-06-28T00:00:00.000Z,.DC INTL POS TXN MARKUP+ST 190621 220621 -CDT2116004454936,,,international_transaction_arbitrage,-214.68
61b70593d8beac1599eb5fa9,50200023535069,2023604.75,60ec41ba55c00300382672d9,HDFC,bank charges,5eecc6d6449e4f7cfb1c2708,2021-06-28T00:00:00.000Z,.DC INTL POS TXN MARKUP+ST 200621 220621 -CDT2116004454936,,,international_transaction_arbitrage,-303.7
61b70594d8beac1599eb5fae,50200023535069,2037266.53,60ec41ba55c00300382672d9,HDFC,Revenue-Mktplace,5eecc6d6449e4f7cfb1c2708,2021-06-28T00:00:00.000Z,NEFT CR-DEUT0797BGL-FLIPKART INTERNET PR IVATE LIMITED-SLICK ORGANICS PVT LTD-062 800630GN00088,shopping,,net_banking_transfer,13661.78
61b70595d8beac1599eb5fb3,50200023535069,2069967.64,60ec41ba55c00300382672d9,HDFC,Revenue-COD,5eecc6d6449e4f7cfb1c2708,2021-06-28T00:00:00.000Z,NEFT CR-ICIC0000155-SHIPROCKET COD CRF I,,,net_banking_transfer,32701.11
61b70596d8beac1599eb5fbe,50200023535069,2135848.43,60ec41ba55c00300382672d9,HDFC,Revenue-PG-split enabled,5eecc6d6449e4f7cfb1c2708,2021-06-28T00:00:00.000Z,NEFT CR-UTIB0001506-RAZORPAY SOFTWARE PR IVATE LIMITED-SLICK ORGANICS PVT LITD-AX ISCN0083259729,insurance,,net_banking_transfer,65880.79
61b70597d8beac1599eb5fc3,50200023535069,2137276.87,60ec41ba55c00300382672d9,HDFC,Revenue-PG-non-split,5eecc6d6449e4f7cfb1c2708,2021-06-28T00:00:00.000Z,NEFT CR-IDFB0010204-SEZZLE PAYMENTS PRIV ATE LIMITED-SLICK ORGANICS PRIVATE LIMIT ED-IDFBH21179189114,insurance,,net_banking_transfer,1428.44
61b70598d8beac1599eb5fc9,50200023535069,2189611.05,60ec41ba55c00300382672d9,HDFC,Transfer in/Revenue-other,5eecc6d6449e4f7cfb1c2708,2021-06-29T00:00:00.000Z,IMPS-118006323943-NA-HDFC-XXXXXXXXXX0007 -ALL20210629216820000330830668628,,,net_banking_transfer,52334.18
61b70599d8beac1599eb5fd6,50200023535069,2199898.83,60ec41ba55c00300382672d9,HDFC,Revenue-PG-split enabled,5eecc6d6449e4f7cfb1c2708,2021-06-29T00:00:00.000Z,NEFT CR-UTIB0001506-RAZORPAY SOFTWARE PR IVATE LIMITED-SLICK ORGANICS PVT LITD-AX ISCN0083297948,insurance,,net_banking_transfer,10287.78
61b7059ad8beac1599eb5fdc,50200023535069,2204094.89,60ec41ba55c00300382672d9,HDFC,Revenue-PG-non-split,5eecc6d6449e4f7cfb1c2708,2021-06-29T00:00:00.000Z,NEFT CR-SCBL0036001-STRIPE INDIA PRIVATE -SLICK ORGANICS PRIVATE LIMITED-SSG17413 Q0303030,insurance,,net_banking_transfer,4196.06
61b7059bd8beac1599eb5fe5,50200023535069,2315243.53,60ec41ba55c00300382672d9,HDFC,Revenue-Mktplace,5eecc6d6449e4f7cfb1c2708,2021-06-29T00:00:00.000Z,IMPS-118011382849-AMAZON SELLER SERVIC-H DFC-XXXXXXXX6004-17343MDRCWR7GWTBSLICK O RGANICS PVT LTD,shopping,,net_banking_transfer,111148.64
61b7059cd8beac1599eb5ff1,50200023535069,2809738.38,60ec41ba55c00300382672d9,HDFC,Revenue-Mktplace,5eecc6d6449e4f7cfb1c2708,2021-06-29T00:00:00.000Z,NEFT CR-DEUT0797BGL-AMAZON PAY (INDIA) P RIVATE LIMITED-SLICK ORGANICS PVT LTD-06 2900166GN00383,shopping,,net_banking_transfer,494494.85
61b7059dd8beac1599eb6001,50200023535069,2836122.18,60ec41ba55c00300382672d9,HDFC,Revenue-PG-split enabled,5eecc6d6449e4f7cfb1c2708,2021-06-29T00:00:00.000Z,NEFT CR-UTIB0001506-RAZORPAY SOFTWARE PR IVATE LIMITED-SLICK ORGANICS PVT LITD-AX ISCN0083385275,insurance,,net_banking_transfer,26383.8
61b7059ed8beac1599eb6014,50200023535069,2848160.74,60ec41ba55c00300382672d9,HDFC,Revenue-PG-non-split,5eecc6d6449e4f7cfb1c2708,2021-06-29T00:00:00.000Z,NEFT CR-IDFB0010204-SEZZLE PAYMENTS PRIV ATE LIMITED-SLICK ORGANICS PRIVATE LIMIT ED-IDFBH21180233048,insurance,,net_banking_transfer,12038.56
61b7059fd8beac1599eb6020,50200023535069,2748160.74,60ec41ba55c00300382672d9,HDFC,SAAS/tech expense,5eecc6d6449e4f7cfb1c2708,2021-06-29T00:00:00.000Z,VHDF0076613626/BILLDKAMAZONSELLERSE,shopping,,Other,-100000
61b705a0d8beac1599eb602c,50200023535069,2692379.74,60ec41ba55c00300382672d9,HDFC,SAAS/tech expense,5eecc6d6449e4f7cfb1c2708,2021-06-29T00:00:00.000Z,POS 514834XXXXXX9486 AMAZON,shopping,,debit_card,-55781
61b705a1d8beac1599eb6039,50200023535069,2726414.78,60ec41ba55c00300382672d9,HDFC,Transfer in/Revenue-other,5eecc6d6449e4f7cfb1c2708,2021-06-30T00:00:00.000Z,IMPS-118105183454-NA-HDFC-XXXXXXXXXX0007,,,net_banking_transfer,34035.04
61b705a2d8beac1599eb6040,50200023535069,2955078.35,60ec41ba55c00300382672d9,HDFC,Revenue-Mktplace,5eecc6d6449e4f7cfb1c2708,2021-06-30T00:00:00.000Z,NEFT CR-KKBK0000958-NYKAA E RETAIL PRIVA TE LIMITED NYKAA-SLICK ORGANICS PVT LTD- KKBK211815260760,insurance,,net_banking_transfer,228663.57
61b705a3d8beac1599eb604b,50200023535069,2966600.69,60ec41ba55c00300382672d9,HDFC,Revenue-PG-split enabled,5eecc6d6449e4f7cfb1c2708,2021-06-30T00:00:00.000Z,NEFT CR-UTIB0001506-RAZORPAY SOFTWARE PR IVATE LIMITED-SLICK ORGANICS PVT LITD-AX ISCN0083428197,insurance,,net_banking_transfer,11522.34
61b705a4d8beac1599eb6058,50200023535069,2969634.18,60ec41ba55c00300382672d9,HDFC,Revenue-PG-non-split,5eecc6d6449e4f7cfb1c2708,2021-06-30T00:00:00.000Z,NEFT CR-SCBL0036001-STRIPE INDIA PRIVATE -SLICK ORGANICS PRIVATE LIMITED-SSG17413 Q0305322,insurance,,net_banking_transfer,3033.49
61b705a5d8beac1599eb605e,50200023535069,3003994.72,60ec41ba55c00300382672d9,HDFC,Revenue-COD,5eecc6d6449e4f7cfb1c2708,2021-06-30T00:00:00.000Z,NEFT CR-ICIC0000155-SHIPROCKET COD CRF I D 2660426-SLICK ORGANICS PVT LTD-CMS2001 312399,insurance,,net_banking_transfer,34360.54
61b705a6d8beac1599eb606a,50200023535069,3004168.02,60ec41ba55c00300382672d9,HDFC,Revenue-Mktplace,5eecc6d6449e4f7cfb1c2708,2021-06-30T00:00:00.000Z,NEFT CR-DEUT0784BBY-TATA UNISTORE LIMITE D-SLICK ORGANICS PVT LTD-063002155GN0001 6,insurance,,net_banking_transfer,173.3
61b705a7d8beac1599eb6070,50200023535069,2994168.02,60ec41ba55c00300382672d9,HDFC,Marketing Expense,5eecc6d6449e4f7cfb1c2708,2021-06-30T00:00:00.000Z,POS 514834XXXXXX9486 GOOGLE ADS,,,debit_card,-10000
61b705a8d8beac1599eb6076,50200023535069,3009033.66,60ec41ba55c00300382672d9,HDFC,Revenue-PG-split enabled,5eecc6d6449e4f7cfb1c2708,2021-06-30T00:00:00.000Z,NEFT CR-UTIB0001506-RAZORPAY SOFTWARE PR IVATE LIMITED-SLICK ORGANICS PVT LITD-AX ISCN0083516923,insurance,,net_banking_transfer,14865.64
61b705a9d8beac1599eb607a,50200023535069,3011758.23,60ec41ba55c00300382672d9,HDFC,Revenue-PG-non-split,5eecc6d6449e4f7cfb1c2708,2021-06-30T00:00:00.000Z,NEFT CR-IDFB0010204-SEZZLE PAYMENTS PRIV,,,net_banking_transfer,2724.57
61b705aad8beac1599eb6081,50200023535069,3047913.38,60ec41ba55c00300382672d9,HDFC,Transfer in/Revenue-other,5eecc6d6449e4f7cfb1c2708,2021-07-01T00:00:00.000Z,IMPS-118205073249-NA-HDFC-XXXXXXXXXX0007 -ALL20210701216820000330830668628,,,net_banking_transfer,36155.15
61b705abd8beac1599eb608d,50200023535069,2453982.38,60ec41ba55c00300382672d9,HDFC,direct expenses,5eecc6d6449e4f7cfb1c2708,2021-07-01T00:00:00.000Z,"NEFT DR-YESB0000551-VISTTA COSMETICS-NET BANK, MUM-N182211549838395-593931",,,net_banking_transfer,-593931
61b705acd8beac1599eb6095,50200023535069,2030470.38,60ec41ba55c00300382672d9,HDFC,direct expenses,5eecc6d6449e4f7cfb1c2708,2021-07-01T00:00:00.000Z,05892560000649-TPT-423512-DECORPAC INDIA PRIVATE LIMITED,,,net_banking_transfer,-423512
61b705acd8beac1599eb609d,50200023535069,1830470.38,60ec41ba55c00300382672d9,HDFC,direct expenses,5eecc6d6449e4f7cfb1c2708,2021-07-01T00:00:00.000Z,IMPS-118210167078-PAYTM-PYTM-XXXXXXXX383 9-200000,ewallet,,net_banking_transfer,-200000
61b705add8beac1599eb60a3,50200023535069,1856596.47,60ec41ba55c00300382672d9,HDFC,Revenue-PG-split enabled,5eecc6d6449e4f7cfb1c2708,2021-07-01T00:00:00.000Z,NEFT CR-UTIB0001506-RAZORPAY SOFTWARE PR IVATE LIMITED-SLICK ORGANICS PVT LITD-AX ISCN0083573229,insurance,,net_banking_transfer,26126.09
61b705aed8beac1599eb60a8,50200023535069,1631596.47,60ec41ba55c00300382672d9,HDFC,direct expenses,5eecc6d6449e4f7cfb1c2708,2021-07-01T00:00:00.000Z,02711930004579-TPT-225000-DHRUV BHASIN,,,net_banking_transfer,-225000
61b705afd8beac1599eb60b4,50200023535069,1643409.85,60ec41ba55c00300382672d9,HDFC,Revenue-Mktplace,5eecc6d6449e4f7cfb1c2708,2021-07-01T00:00:00.000Z,NEFT CR-DEUT0797BGL-MYNTRA DESIGNS PRIVA TE LIMITED-SLICK ORGANICS PRIVATE LIMITE D-070100123GN00019,shopping,,net_banking_transfer,11813.38
61b705b0d8beac1599eb60b8,50200023535069,1418409.85,60ec41ba55c00300382672d9,HDFC,direct expenses,5eecc6d6449e4f7cfb1c2708,2021-07-01T00:00:00.000Z,"NEFT DR-SCBL0036025-DHRUV MADHOK-NETBANK , MUM-N182211550106539-225000",,,net_banking_transfer,-225000
61b705b1d8beac1599eb60bf,50200023535069,1338159.85,60ec41ba55c00300382672d9,HDFC,direct expenses,5eecc6d6449e4f7cfb1c2708,2021-07-01T00:00:00.000Z,"NEFT DR-ANDB0002029-HITESH ARORA-NETBANK , MUM-N182211550159110-80250",,,net_banking_transfer,-80250
61b705b2d8beac1599eb60c6,50200023535069,1336001.3,60ec41ba55c00300382672d9,HDFC,direct expenses,5eecc6d6449e4f7cfb1c2708,2021-07-01T00:00:00.000Z,POS 514834XXXXXX9486 SEOPTIMER,,,debit_card,-2158.55
61b705b3d8beac1599eb60cd,50200023535069,963627.3,60ec41ba55c00300382672d9,HDFC,direct expenses,5eecc6d6449e4f7cfb1c2708,2021-07-01T00:00:00.000Z,"NEFT DR-KKBK0000180-VEDIC COSMECEUTICALS PVT LTD-NETBANK, MUM-N182211550504992-3 72374",,,net_banking_transfer,-372374
61b705b4d8beac1599eb60d6,50200023535069,956627.3,60ec41ba55c00300382672d9,HDFC,direct expenses,5eecc6d6449e4f7cfb1c2708,2021-07-01T00:00:00.000Z,"NEFT DR-ICIC0000021-AKHILESH DIXIT-NETBA NK, MUM-N182211550580241-7000",,,net_banking_transfer,-7000
61b705b5d8beac1599eb60dc,50200023535069,956495.3,60ec41ba55c00300382672d9,HDFC,direct expenses,5eecc6d6449e4f7cfb1c2708,2021-07-01T00:00:00.000Z,"NEFT DR-BARB0VJNAZA-HEENA P TALREJA-NETB ANK, MUM-N182211550614479-132",,,net_banking_transfer,-132
61b705b6d8beac1599eb60e2,50200023535069,701495.3,60ec41ba55c00300382672d9,HDFC,SAAS/tech expense,5eecc6d6449e4f7cfb1c2708,2021-07-01T00:00:00.000Z,VHDF0081266930/BILLDKAMAZONSELLERSE,shopping,,Other,-255000
61b705b7d8beac1599eb60e9,50200023535069,703196.54,60ec41ba55c00300382672d9,HDFC,Revenue-PG-non-split,5eecc6d6449e4f7cfb1c2708,2021-07-01T00:00:00.000Z,NEFT CR-IDFB0010204-SEZZLE PAYMENTS PRIV,,,net_banking_transfer,1701.24
61b705b8d8beac1599eb60f0,50200023535069,772053.54,60ec41ba55c00300382672d9,HDFC,Revenue-Mktplace,5eecc6d6449e4f7cfb1c2708,2021-07-01T00:00:00.000Z,NEFT CR-ICIC0SF0002-THREPSI SOLUTIONS PV -SLICK ORGANICS PRIVATE LIMITED-24451876 901DC,insurance,,net_banking_transfer,68857
61b705b9d8beac1599eb60f7,50200023535069,785603.19,60ec41ba55c00300382672d9,HDFC,Revenue-PG-split enabled,5eecc6d6449e4f7cfb1c2708,2021-07-01T00:00:00.000Z,NEFT CR-UTIB0001506-RAZORPAY SOFTWARE PR IVATE LIMITED-SLICK ORGANICS PVT LITD-AX ISCN0083673859,insurance,,net_banking_transfer,13549.65
61b705bad8beac1599eb60ff,50200023535069,803656.25,60ec41ba55c00300382672d9,HDFC,Transfer in/Revenue-other,5eecc6d6449e4f7cfb1c2708,2021-07-02T00:00:00.000Z,IMPS-118305185724-NA-HDFC-XXXXXXXXXX0007 -ALL20210702216820000330830668628,,,net_banking_transfer,18053.06
61b705bbd8beac1599eb6104,50200023535069,816850.86,60ec41ba55c00300382672d9,HDFC,Revenue-Mktplace,5eecc6d6449e4f7cfb1c2708,2021-07-02T00:00:00.000Z,NEFT CR-DEUT0797BGL-FLIPKART INTERNET PR IVATE LIMITED-SLICK ORGANICS PVT LTD-070 200108GN00287,shopping,,net_banking_transfer,13194.61
61b705bcd8beac1599eb6108,50200023535069,823560.05,60ec41ba55c00300382672d9,HDFC,Revenue-Mktplace,5eecc6d6449e4f7cfb1c2708,2021-07-02T00:00:00.000Z,NEFT CR-DEUT0797BGL-FLIPKART INTERNET PR IVATE LIMITED-SLICK ORGANICS PVT LTD-070 200123GN00286,shopping,,net_banking_transfer,6709.19
61b705bdd8beac1599eb610c,50200023535069,825933.51,60ec41ba55c00300382672d9,HDFC,Revenue-Mktplace,5eecc6d6449e4f7cfb1c2708,2021-07-02T00:00:00.000Z,NEFT CR-DEUT0797BGL-MYNTRA DESIGNS PRIVA TE LIMITED-SLICK ORGANICS PRIVATE LIMITE D-070200178GN00094,shopping,,net_banking_transfer,2373.46
61b705bed8beac1599eb6136,50200023535069,625933.51,60ec41ba55c00300382672d9,HDFC,direct expenses,5eecc6d6449e4f7cfb1c2708,2021-07-02T00:00:00.000Z,"NEFT DR-INDB0000148-ACQUISORY INDIA CONS ULTING PVT LTD-NETBANK, MUM-N18321155161 8787-200000",,,net_banking_transfer,-200000
61b705bfd8beac1599eb615a,50200023535069,635351.77,60ec41ba55c00300382672d9,HDFC,Revenue-PG-split enabled,5eecc6d6449e4f7cfb1c2708,2021-07-02T00:00:00.000Z,NEFT CR-UTIB0001506-RAZORPAY SOFTWARE PR IVATE LIMITED-SLICK ORGANICS PVT LITD-AX ISCN0083705141,insurance,,net_banking_transfer,9418.26
61b705c0d8beac1599eb6172,50200023535069,622251.77,60ec41ba55c00300382672d9,HDFC,direct expenses,5eecc6d6449e4f7cfb1c2708,2021-07-02T00:00:00.000Z,"NEFT DR-ICIC0006956-LAKSHAY CARRYING COR PORATION-NETBANK, MUM-N183211551756632-1 3100",,,net_banking_transfer,-13100
61b705c1d8beac1599eb617d,50200023535069,607251.77,60ec41ba55c00300382672d9,HDFC,direct expenses,5eecc6d6449e4f7cfb1c2708,2021-07-02T00:00:00.000Z,"NEFT DR-BARB0DBKHAN-ARUNT RANSPORT-NETBA NK, MUM-N183211551744598-15000",travel,,net_banking_transfer,-15000
61b705c2d8beac1599eb6182,50200023535069,607728.55,60ec41ba55c00300382672d9,HDFC,Revenue-PG-non-split,5eecc6d6449e4f7cfb1c2708,2021-07-02T00:00:00.000Z,NEFT CR-UTIB0001506-RZPX PRIVATE LIMITED,,,net_banking_transfer,476.78
61b705c3d8beac1599eb618d,50200023535069,608580.73,60ec41ba55c00300382672d9,HDFC,Transfer in/Revenue-other,5eecc6d6449e4f7cfb1c2708,2021-07-02T00:00:00.000Z,ZOOBOP ME WORK-ARATA,,,Other,852.18
61b705c4d8beac1599eb6195,50200023535069,531020.73,60ec41ba55c00300382672d9,HDFC,direct expenses,5eecc6d6449e4f7cfb1c2708,2021-07-02T00:00:00.000Z,"NEFT DR-KKBK0000173-MATRIX PRINTING SOLU TIONS PRIVATE LIMITE-NETBANK, MUM-N18321 1551864200-77560",,,net_banking_transfer,-77560
61b705c5d8beac1599eb619a,50200023535069,511020.73,60ec41ba55c00300382672d9,HDFC,direct expenses,5eecc6d6449e4f7cfb1c2708,2021-07-02T00:00:00.000Z,SARVAN KUMAR - CHQ PAID - SAKET II,,,chq,-20000
61b705c6d8beac1599eb619f,50200023535069,512727.92,60ec41ba55c00300382672d9,HDFC,Revenue-Mktplace,5eecc6d6449e4f7cfb1c2708,2021-07-02T00:00:00.000Z,NEFT CR-ICIC0000105-ICICI BANK NODAL AC MANASH LIFESTYL-SLICK ORGANICS PRIVATE L IMITED MP M-ICIJ211830005922,,,net_banking_transfer,1707.19
61b705c6d8beac1599eb61a1,50200023535069,521053.5,60ec41ba55c00300382672d9,HDFC,Revenue-Mktplace,5eecc6d6449e4f7cfb1c2708,2021-07-02T00:00:00.000Z,NEFT CR-ICIC0000105-ICICI BANK NODAL AC MANASH LIFESTYL-SLICK ORGANICS PRIVATE L IMITED MP G-ICIJ211830005920,,,net_banking_transfer,8325.58
61b705c7d8beac1599eb61a6,50200023535069,522251.21,60ec41ba55c00300382672d9,HDFC,Revenue-Mktplace,5eecc6d6449e4f7cfb1c2708,2021-07-02T00:00:00.000Z,NEFT CR-ICIC0000105-ICICI BANK NODAL AC MANASH LIFESTYL-SLICK ORGANICS PRIVATE L IMITED BANG-ICIJ211830005927,,,net_banking_transfer,1197.71
61b705c8d8beac1599eb61b8,50200023535069,522732.8,60ec41ba55c00300382672d9,HDFC,Revenue-Mktplace,5eecc6d6449e4f7cfb1c2708,2021-07-02T00:00:00.000Z,NEFT CR-ICIC0000105-ICICI BANK NODAL AC MANASH LIFESTYL-SLICK ORGANICS PRIVATE L IMITED KOLK-ICIJ211830005923,,,net_banking_transfer,481.59
61b705c9d8beac1599eb61bc,50200023535069,522869.13,60ec41ba55c00300382672d9,HDFC,Revenue-Mktplace,5eecc6d6449e4f7cfb1c2708,2021-07-02T00:00:00.000Z,NEFT CR-ICIC0000105-ICICI BANK NODAL AC MANASH LIFESTYL-SLICK ORGANICS PRIVATE L IMITED HYD-ICIJ211830005925,,,net_banking_transfer,136.33
61b705cad8beac1599eb61c8,50200023535069,524316.96,60ec41ba55c00300382672d9,HDFC,Revenue-PG-non-split,5eecc6d6449e4f7cfb1c2708,2021-07-02T00:00:00.000Z,NEFT CR-IDFB0010204-SEZZLE PAYMENTS PRIV ATE LIMITED-SLICK ORGANICS PRIVATE LIMIT ED-IDFBH21183413384,insurance,,net_banking_transfer,1447.83
61b705cbd8beac1599eb61cf,50200023535069,532095.81,60ec41ba55c00300382672d9,HDFC,Revenue-PG-split enabled,5eecc6d6449e4f7cfb1c2708,2021-07-02T00:00:00.000Z,NEFT CR-UTIB0001506-RAZORPAY SOFTWARE PR IVATE LIMITED-SLICK ORGANICS PVT LITD-AX ISCN0083795740,insurance,,net_banking_transfer,7778.85
61b705ccd8beac1599eb61d6,50200023535069,532099.07,60ec41ba55c00300382672d9,HDFC,Revenue-Mktplace,5eecc6d6449e4f7cfb1c2708,2021-07-02T00:00:00.000Z,NEFT CR-DEUT0784BBY-TATA UNISTORE LIMITE D-SLICK ORGANICS PVT LTD-070201493GN0026 9,insurance,,net_banking_transfer,3.26
61b705cdd8beac1599eb61e1,50200023535069,532528.88,60ec41ba55c00300382672d9,HDFC,Revenue-Mktplace,5eecc6d6449e4f7cfb1c2708,2021-07-02T00:00:00.000Z,NEFT CR-DEUT0784BBY-TATA UNISTORE LTD-NO,,,net_banking_transfer,429.81
61b705ced8beac1599eb61e6,50200023535069,533605.77,60ec41ba55c00300382672d9,HDFC,Revenue-Mktplace,5eecc6d6449e4f7cfb1c2708,2021-07-02T00:00:00.000Z,NEFT CR-DEUT0784BBY-TATA UNISTORE LTD-NO DAL-SLICK ORGANICS PVT LTD-070201497GN00 390,insurance,,net_banking_transfer,1076.89
61b705cfd8beac1599eb61eb,50200023535069,534338.03,60ec41ba55c00300382672d9,HDFC,Revenue-PG-non-split,5eecc6d6449e4f7cfb1c2708,2021-07-02T00:00:00.000Z,NEFT CR-ICIC0000031-PAYTM E COMMERCE PVT LTD-SLICK ORGANICS PVT LTD-CMS200696404 6,ewallet,,net_banking_transfer,732.26
61b705d0d8beac1599eb61f1,50200023535069,543492.03,60ec41ba55c00300382672d9,HDFC,Revenue-Mktplace,5eecc6d6449e4f7cfb1c2708,2021-07-02T00:00:00.000Z,NEFT CR-SCBL0036001-M/S DREAMPLUG TECHNO -SLICK ORGANICS PRIVATE LIMITEDSLICK-SIN 31436Q0015979,insurance,,net_banking_transfer,9154
61b705d1d8beac1599eb61f5,50200023535069,562985.36,60ec41ba55c00300382672d9,HDFC,Transfer in/Revenue-other,5eecc6d6449e4f7cfb1c2708,2021-07-03T00:00:00.000Z,IMPS-118405411357-NA-HDFC-XXXXXXXXXX0007 -ALL20210703216820000330830668628,,,net_banking_transfer,19493.33
61b705d2d8beac1599eb6204,50200023535069,573013.07,60ec41ba55c00300382672d9,HDFC,Revenue-PG-split enabled,5eecc6d6449e4f7cfb1c2708,2021-07-03T00:00:00.000Z,NEFT CR-UTIB0001506-RAZORPAY SOFTWARE PR IVATE LIMITED-SLICK ORGANICS PVT LITD-AX ISCN0083815947,insurance,,net_banking_transfer,10027.71
61b705d3d8beac1599eb6211,50200023535069,575383.61,60ec41ba55c00300382672d9,HDFC,Transfer in/Revenue-other,5eecc6d6449e4f7cfb1c2708,2021-07-03T00:00:00.000Z,ZOOBOP ME WORK-ARATA,,,Other,2370.54
61b705d4d8beac1599eb6217,50200023535069,578205.66,60ec41ba55c00300382672d9,HDFC,Revenue-Mktplace,5eecc6d6449e4f7cfb1c2708,2021-07-03T00:00:00.000Z,NEFT CR-ICIC0000105-ICICI BANK NODAL AC MANASH LIFESTYL-SLICK ORGANICS PRIVATE L IMITED MP G-ICIJ211840002039,,,net_banking_transfer,2822.05
61b705d5d8beac1599eb621d,50200023535069,580985.98,60ec41ba55c00300382672d9,HDFC,Revenue-Mktplace,5eecc6d6449e4f7cfb1c2708,2021-07-03T00:00:00.000Z,NEFT CR-ICIC0000105-ICICI BANK NODAL AC MANASH LIFESTYL-SLICK ORGANICS PRIVATE L IMITED MP M-ICIJ211840003670,,,net_banking_transfer,2780.32
61b705d6d8beac1599eb6223,50200023535069,581131.84,60ec41ba55c00300382672d9,HDFC,Revenue-Mktplace,5eecc6d6449e4f7cfb1c2708,2021-07-03T00:00:00.000Z,NEFT CR-ICIC0000105-ICICI BANK NODAL AC MANASH LIFESTYL-SLICK ORGANICS PRIVATE L IMITED BANG-ICIJ211840003671,,,net_banking_transfer,145.86
61b705d7d8beac1599eb6228,50200023535069,481131.84,60ec41ba55c00300382672d9,HDFC,Marketing Expense,5eecc6d6449e4f7cfb1c2708,2021-07-03T00:00:00.000Z,POS 514834XXXXXX9486 GOOGLE ADS,,,debit_card,-100000
61b705d8d8beac1599eb6235,50200023535069,499922.54,60ec41ba55c00300382672d9,HDFC,Revenue-PG-split enabled,5eecc6d6449e4f7cfb1c2708,2021-07-04T00:00:00.000Z,NEFT CR-UTIB0001506-RAZORPAY SOFTWARE PR IVATE LIMITED-SLICK ORGANICS PVT LITD-AX ISCN0083895856,insurance,,net_banking_transfer,18790.7
61b705d9d8beac1599eb623b,50200023535069,530265.24,60ec41ba55c00300382672d9,HDFC,Transfer in/Revenue-other,5eecc6d6449e4f7cfb1c2708,2021-07-04T00:00:00.000Z,IMPS-118505369871-NA-HDFC-XXXXXXXXXX0007 -ALL20210704216820000330830668628,,,net_banking_transfer,30342.7
61b705dad8beac1599eb623f,50200023535069,330265.24,60ec41ba55c00300382672d9,HDFC,direct expenses,5eecc6d6449e4f7cfb1c2708,2021-07-04T00:00:00.000Z,NEFT DR-UTIB0000514-NATS ASSOCIATES-NETB,,,net_banking_transfer,-200000
61b705dbd8beac1599eb6241,50200023535069,206265.24,60ec41ba55c00300382672d9,HDFC,direct expenses,5eecc6d6449e4f7cfb1c2708,2021-07-04T00:00:00.000Z,IMPS-118507193295-NATS ASSOCIATES-UTIB-X XXXXXXXXXX6218-124000,,,net_banking_transfer,-124000
61b705dcd8beac1599eb6246,50200023535069,195270.59,60ec41ba55c00300382672d9,HDFC,direct expenses,5eecc6d6449e4f7cfb1c2708,2021-07-04T00:00:00.000Z,POS 514834XXXXXX9486 STK*SHUTTERSTOCK,,,debit_card,-10994.65
61b705ddd8beac1599eb6250,50200023535069,225681.29,60ec41ba55c00300382672d9,HDFC,Transfer in/Revenue-other,5eecc6d6449e4f7cfb1c2708,2021-07-05T00:00:00.000Z,IMPS-118605242062-NA-HDFC-XXXXXXXXXX0007 -ALL20210705216820000330830668628,,,net_banking_transfer,30410.7
61b705ded8beac1599eb6256,50200023535069,233650.26,60ec41ba55c00300382672d9,HDFC,Revenue-Mktplace,5eecc6d6449e4f7cfb1c2708,2021-07-05T00:00:00.000Z,NEFT CR-DEUT0797BGL-FLIPKART INTERNET PR IVATE LIMITED-SLICK ORGANICS PVT LTD-118 600115GN00291,shopping,,net_banking_transfer,7968.97
61b705dfd8beac1599eb625d,50200023535069,240891.79,60ec41ba55c00300382672d9,HDFC,Revenue-Mktplace,5eecc6d6449e4f7cfb1c2708,2021-07-05T00:00:00.000Z,NEFT CR-DEUT0797BGL-FLIPKART INTERNET PR IVATE LIMITED-SLICK ORGANICS PVT LTD-118 600138GN00165,shopping,,net_banking_transfer,7241.53
61b705dfd8beac1599eb6262,50200023535069,246766.43,60ec41ba55c00300382672d9,HDFC,Revenue-Mktplace,5eecc6d6449e4f7cfb1c2708,2021-07-05T00:00:00.000Z,NEFT CR-DEUT0797BGL-MYNTRA DESIGNS PRIVA TE LIMITED-SLICK ORGANICS PRIVATE LIMITE D-118600200GN00171,shopping,,net_banking_transfer,5874.64
61b705e0d8beac1599eb6265,50200023535069,296187.32,60ec41ba55c00300382672d9,HDFC,Revenue-PG-split enabled,5eecc6d6449e4f7cfb1c2708,2021-07-05T00:00:00.000Z,NEFT CR-UTIB0001506-RAZORPAY SOFTWARE PR IVATE LIMITED-SLICK ORGANICS PVT LITD-AX ISCN0083934367,insurance,,net_banking_transfer,49420.89
61b705e1d8beac1599eb626e,50200023535069,292548.72,60ec41ba55c00300382672d9,HDFC,direct expenses,5eecc6d6449e4f7cfb1c2708,2021-07-05T00:00:00.000Z,POS 514834XXXXXX9486 FRESHWORKS INC,,,debit_card,-3638.6
61b705e2d8beac1599eb6272,50200023535069,296187.32,60ec41ba55c00300382672d9,HDFC,Transfer in/Revenue-other,5eecc6d6449e4f7cfb1c2708,2021-07-05T00:00:00.000Z,POS 514834XXXXXX9486 FRESHWORKS INC,,,debit_card,3638.6
61b705e4d8beac1599eb6279,50200023535069,294635.57,60ec41ba55c00300382672d9,HDFC,Revenue-Mktplace,5eecc6d6449e4f7cfb1c2708,2021-07-05T00:00:00.000Z,NEFT CR-ICIC0000105-ICICI BANK NODAL AC MANASH LIFESTYL-SLICK ORGANICS PRIVATE L IMITED MP G-ICIJ211860001124,,,net_banking_transfer,2086.85
61b705e5d8beac1599eb627d,50200023535069,295000.6,60ec41ba55c00300382672d9,HDFC,Revenue-Mktplace,5eecc6d6449e4f7cfb1c2708,2021-07-05T00:00:00.000Z,NEFT CR-ICIC0000105-ICICI BANK NODAL AC MANASH LIFESTYL-SLICK ORGANICS PRIVATE L IMITED KOLK-ICIJ211860002824,,,net_banking_transfer,365.03
61b705e6d8beac1599eb6284,50200023535069,295512.23,60ec41ba55c00300382672d9,HDFC,Revenue-Mktplace,5eecc6d6449e4f7cfb1c2708,2021-07-05T00:00:00.000Z,NEFT CR-ICIC0000105-ICICI BANK NODAL AC MANASH LIFESTYL-SLICK ORGANICS PRIVATE L IMITED BANG-ICIJ211860001126,,,net_banking_transfer,511.63
61b705e7d8beac1599eb6289,50200023535069,296608.83,60ec41ba55c00300382672d9,HDFC,Transfer in/Revenue-other,5eecc6d6449e4f7cfb1c2708,2021-07-05T00:00:00.000Z,NEFT CR-ICIC0000105-ICICI BANK NODAL AC,,,net_banking_transfer,1096.6
61b705e8d8beac1599eb628d,50200023535069,333649.02,60ec41ba55c00300382672d9,HDFC,Revenue-COD,5eecc6d6449e4f7cfb1c2708,2021-07-05T00:00:00.000Z,NEFT CR-ICIC0000155-SHIPROCKET COD CRF I D 2680841-SLICK ORGANICS PVT LTD-CMS2010 018747,insurance,,net_banking_transfer,37040.19
61b705e9d8beac1599eb6294,50200023535069,354957.21,60ec41ba55c00300382672d9,HDFC,Revenue-PG-split enabled,5eecc6d6449e4f7cfb1c2708,2021-07-05T00:00:00.000Z,NEFT CR-UTIB0001506-RAZORPAY SOFTWARE PR IVATE LIMITED-SLICK ORGANICS PVT LITD-AX ISCN0084044123,insurance,,net_banking_transfer,21308.19
61b705ead8beac1599eb6298,50200023535069,387134.24,60ec41ba55c00300382672d9,HDFC,Transfer in/Revenue-other,5eecc6d6449e4f7cfb1c2708,2021-07-06T00:00:00.000Z,IMPS-118705711980-NA-HDFC-XXXXXXXXXX0007 -ALL20210706216820000330830668628,,,net_banking_transfer,32177.03
61b705ebd8beac1599eb629f,50200023535069,459142.61,60ec41ba55c00300382672d9,HDFC,Revenue-Mktplace,5eecc6d6449e4f7cfb1c2708,2021-07-06T00:00:00.000Z,IMPS-118705250064-AMAZON SELLER SERVIC-H DFC-XXXXXXXX6004-SQ9ALCN51KLXAZ5QSLICK O RGANICS PVT LTD,shopping,,net_banking_transfer,72008.37
61b705ecd8beac1599eb62a4,50200023535069,459360.05,60ec41ba55c00300382672d9,HDFC,Revenue-PG-non-split,5eecc6d6449e4f7cfb1c2708,2021-07-06T00:00:00.000Z,NEFT CR-ICIC0000031-PAYTM E COMMERCE PVT LTD-SLICK ORGANICS PVT LTD-CMS201049019 2,ewallet,,net_banking_transfer,217.44
61b705edd8beac1599eb62a9,50200023535069,912035.15,60ec41ba55c00300382672d9,HDFC,Revenue-Mktplace,5eecc6d6449e4f7cfb1c2708,2021-07-06T00:00:00.000Z,NEFT CR-DEUT0797BGL-AMAZON PAY (INDIA) P RIVATE LIMITED-SLICK ORGANICS PVT LTD-11 8700011GN00313,shopping,,net_banking_transfer,452675.1
61b705eed8beac1599eb62ad,50200023535069,815369.15,60ec41ba55c00300382672d9,HDFC,direct expenses,5eecc6d6449e4f7cfb1c2708,2021-07-06T00:00:00.000Z,"NEFT DR-ICIC0000021-AKHILESH DIXIT-NETBA NK, MUM-N187211556064710-96666",,,net_banking_transfer,-96666
61b705efd8beac1599eb62b0,50200023535069,822690.99,60ec41ba55c00300382672d9,HDFC,Revenue-PG-split enabled,5eecc6d6449e4f7cfb1c2708,2021-07-06T00:00:00.000Z,NEFT CR-UTIB0001506-RAZORPAY SOFTWARE PR IVATE LIMITED-SLICK ORGANICS PVT LITD-AX ISCN0084131253,insurance,,net_banking_transfer,7321.84
61b705f0d8beac1599eb62b5,50200023535069,732690.99,60ec41ba55c00300382672d9,HDFC,direct expenses,5eecc6d6449e4f7cfb1c2708,2021-07-06T00:00:00.000Z,"NEFT DR-UTIB0000131-SHARVI DUBEY-NETBANK , MUM-N187211556470673-90000",,,net_banking_transfer,-90000
61b705f1d8beac1599eb62bd,50200023535069,735068.81,60ec41ba55c00300382672d9,HDFC,Revenue-PG-non-split,5eecc6d6449e4f7cfb1c2708,2021-07-06T00:00:00.000Z,NEFT CR-IDFB0010204-SEZZLE PAYMENTS PRIV ATE LIMITED-SLICK ORGANICS PRIVATE LIMIT ED-IDFBH21187594827,insurance,,net_banking_transfer,2377.82
61b705f2d8beac1599eb62c1,50200023535069,751906.48,60ec41ba55c00300382672d9,HDFC,Revenue-PG-split enabled,5eecc6d6449e4f7cfb1c2708,2021-07-06T00:00:00.000Z,NEFT CR-UTIB0001506-RAZORPAY SOFTWARE PR IVATE LIMITED-SLICK ORGANICS PVT LITD-AX ISCN0084205775,insurance,,net_banking_transfer,16837.67
61b705f3d8beac1599eb62c8,50200023535069,752092.67,60ec41ba55c00300382672d9,HDFC,Transfer in/Revenue-other,5eecc6d6449e4f7cfb1c2708,2021-07-06T00:00:00.000Z,NEFT CR-ICIC0000105-ICICI BANK NODAL AC,,,net_banking_transfer,186.19
61b705f4d8beac1599eb62ce,50200023535069,752956.16,60ec41ba55c00300382672d9,HDFC,Revenue-Mktplace,5eecc6d6449e4f7cfb1c2708,2021-07-06T00:00:00.000Z,NEFT CR-ICIC0000105-ICICI BANK NODAL AC MANASH LIFESTYL-SLICK ORGANICS PRIVATE L IMITED MP M-ICIJ211870006567,,,net_banking_transfer,863.49
61b705f5d8beac1599eb62d3,50200023535069,753780.05,60ec41ba55c00300382672d9,HDFC,Revenue-Mktplace,5eecc6d6449e4f7cfb1c2708,2021-07-06T00:00:00.000Z,NEFT CR-ICIC0000105-ICICI BANK NODAL AC MANASH LIFESTYL-SLICK ORGANICS PRIVATE L IMITED MP G-ICIJ211870006566,,,net_banking_transfer,823.89
61b705f6d8beac1599eb62da,50200023535069,703780.05,60ec41ba55c00300382672d9,HDFC,SAAS/tech expense,5eecc6d6449e4f7cfb1c2708,2021-07-06T00:00:00.000Z,POS 514834XXXXXX9486 AMAZON,shopping,,debit_card,-50000
61b705f7d8beac1599eb62e0,50200023535069,725305.22,60ec41ba55c00300382672d9,HDFC,Transfer in/Revenue-other,5eecc6d6449e4f7cfb1c2708,2021-07-07T00:00:00.000Z,IMPS-118805896282-NA-HDFC-XXXXXXXXXX0007 -ALL20210707216820000330830668628,,,net_banking_transfer,21525.17
61b705f8d8beac1599eb62e5,50200023535069,634725.22,60ec41ba55c00300382672d9,HDFC,direct expenses,5eecc6d6449e4f7cfb1c2708,2021-07-07T00:00:00.000Z,"NEFT DR-ICIC0000542-AVANTIKA SUKHIA-NETB ANK, MUM-N188211557552387-90580",,,net_banking_transfer,-90580
61b705f9d8beac1599eb62e7,50200023535069,584725.22,60ec41ba55c00300382672d9,HDFC,direct expenses,5eecc6d6449e4f7cfb1c2708,2021-07-07T00:00:00.000Z,"NEFT DR-UTIB0000120-ADNAN ALI-NETBANK, M UM-N188211557547255-50000",,,net_banking_transfer,-50000
61b705fad8beac1599eb62eb,50200023535069,539725.22,60ec41ba55c00300382672d9,HDFC,direct expenses,5eecc6d6449e4f7cfb1c2708,2021-07-07T00:00:00.000Z,"NEFT DR-ICIC0003374-SIDDHARTH KANOJIA-NE TBANK, MUM-N188211557552873-45000",,,net_banking_transfer,-45000
61b705fad8beac1599eb62f7,50200023535069,519725.22,60ec41ba55c00300382672d9,HDFC,direct expenses,5eecc6d6449e4f7cfb1c2708,2021-07-07T00:00:00.000Z,"NEFT DR-PUNB0482100-RAM BHAVAN YADAV-NET BANK, MUM-N188211557556540-20000",,,net_banking_transfer,-20000
61b705fbd8beac1599eb62f9,50200023535069,429725.22,60ec41ba55c00300382672d9,HDFC,direct expenses,5eecc6d6449e4f7cfb1c2708,2021-07-07T00:00:00.000Z,"NEFT DR-BARB0VJMATU-ARTISTO DESIGNZ-NETB ANK, MUM-N188211557553735-90000",,,net_banking_transfer,-90000
61b705fcd8beac1599eb62fe,50200023535069,408625.22,60ec41ba55c00300382672d9,HDFC,direct expenses,5eecc6d6449e4f7cfb1c2708,2021-07-07T00:00:00.000Z,"NEFT DR-SIBL0000555-JAIVEER KUMAR-NETBAN K, MUM-N188211557548521-21100",,,net_banking_transfer,-21100
61b705fdd8beac1599eb6306,50200023535069,388625.22,60ec41ba55c00300382672d9,HDFC,direct expenses,5eecc6d6449e4f7cfb1c2708,2021-07-07T00:00:00.000Z,"NEFT DR-PUNB0307800-PRAKASH JHA-NETBANK, MUM-N188211557557235-20000",,,net_banking_transfer,-20000
61b705fed8beac1599eb6308,50200023535069,372625.22,60ec41ba55c00300382672d9,HDFC,direct expenses,5eecc6d6449e4f7cfb1c2708,2021-07-07T00:00:00.000Z,"NEFT DR-PUNB0151400-BHUWAN CHANDER JOSHI -NETBANK, MUM-N188211557548650-16000",,,net_banking_transfer,-16000
61b705ffd8beac1599eb6312,50200023535069,336625.22,60ec41ba55c00300382672d9,HDFC,direct expenses,5eecc6d6449e4f7cfb1c2708,2021-07-07T00:00:00.000Z,00901610080520-TPT-36000-POOJA KAPIL SHR OTRIYA,,,net_banking_transfer,-36000
61b70600d8beac1599eb6314,50200023535069,298125.22,60ec41ba55c00300382672d9,HDFC,direct expenses,5eecc6d6449e4f7cfb1c2708,2021-07-07T00:00:00.000Z,50100293329616-TPT-38500-SADIYA BANO,,,net_banking_transfer,-38500
61b70601d8beac1599eb6319,50200023535069,263125.22,60ec41ba55c00300382672d9,HDFC,direct expenses,5eecc6d6449e4f7cfb1c2708,2021-07-07T00:00:00.000Z,50100064106714-TPT-35000-AKSHARANSH BHAT T,,,net_banking_transfer,-35000
61b70602d8beac1599eb631d,50200023535069,197125.22,60ec41ba55c00300382672d9,HDFC,direct expenses,5eecc6d6449e4f7cfb1c2708,2021-07-07T00:00:00.000Z,50100330586095-TPT-66000-DIWAKAR UNIYAL,,,net_banking_transfer,-66000
61b70604d8beac1599eb6321,50200023535069,203922.9,60ec41ba55c00300382672d9,HDFC,Revenue-Mktplace,5eecc6d6449e4f7cfb1c2708,2021-07-07T00:00:00.000Z,NEFT CR-DEUT0797BGL-FLIPKART INTERNET PR IVATE LIMITED-SLICK ORGANICS PVT LTD-118 800063GN00265,shopping,,net_banking_transfer,6797.68
61b70604d8beac1599eb632b,50200023535069,103922.9,60ec41ba55c00300382672d9,HDFC,direct expenses,5eecc6d6449e4f7cfb1c2708,2021-07-07T00:00:00.000Z,50100301160692-TPT-100000-TARUN GARG,,,net_banking_transfer,-100000
61b70605d8beac1599eb632d,50200023535069,87922.9,60ec41ba55c00300382672d9,HDFC,direct expenses,5eecc6d6449e4f7cfb1c2708,2021-07-07T00:00:00.000Z,02711600008220-TPT-16000-VARUN SINGH,,,net_banking_transfer,-16000
61b70606d8beac1599eb6332,50200023535069,90368.34,60ec41ba55c00300382672d9,HDFC,Revenue-Mktplace,5eecc6d6449e4f7cfb1c2708,2021-07-07T00:00:00.000Z,NEFT CR-DEUT0797BGL-FLIPKART INTERNET PR IVATE LIMITED-SLICK ORGANICS PVT LTD-118 800102GN00094,shopping,,net_banking_transfer,2445.44
61b70607d8beac1599eb633f,50200023535069,93227.22,60ec41ba55c00300382672d9,HDFC,Revenue-Mktplace,5eecc6d6449e4f7cfb1c2708,2021-07-07T00:00:00.000Z,NEFT CR-DEUT0797BGL-MYNTRA DESIGNS PRIVA TE LIMITED-SLICK ORGANICS PRIVATE LIMITE D-118800184GN00202,shopping,,net_banking_transfer,2858.88
61b70608d8beac1599eb6343,50200023535069,102838.39,60ec41ba55c00300382672d9,HDFC,Revenue-PG-split enabled,5eecc6d6449e4f7cfb1c2708,2021-07-07T00:00:00.000Z,NEFT CR-UTIB0001506-RAZORPAY SOFTWARE PR IVATE LIMITED-SLICK ORGANICS PVT LITD-AX ISCN0084238289,insurance,,net_banking_transfer,9611.17
61b70609d8beac1599eb6357,50200023535069,144041.38,60ec41ba55c00300382672d9,HDFC,Revenue-COD,5eecc6d6449e4f7cfb1c2708,2021-07-07T00:00:00.000Z,NEFT CR-ICIC0000155-SHIPROCKET COD CRF I D 2693200-SLICK ORGANICS PVT LTD-CMS2013 798763,insurance,,net_banking_transfer,41202.99
61b7060ad8beac1599eb6360,50200023535069,148315.59,60ec41ba55c00300382672d9,HDFC,Revenue-PG-split enabled,5eecc6d6449e4f7cfb1c2708,2021-07-07T00:00:00.000Z,NEFT CR-UTIB0001506-RAZORPAY SOFTWARE PR IVATE LIMITED-SLICK ORGANICS PVT LITD-AX ISCN0084315096,insurance,,net_banking_transfer,4274.21
61b7060bd8beac1599eb6386,50200023535069,17815.59,60ec41ba55c00300382672d9,HDFC,direct expenses,5eecc6d6449e4f7cfb1c2708,2021-07-07T00:00:00.000Z,02771610131904-TPT-130500-DIGANT BHATT,,,net_banking_transfer,-130500
61b7060cd8beac1599eb638f,50200023535069,117815.59,60ec41ba55c00300382672d9,HDFC,Internal Transfers,5eecc6d6449e4f7cfb1c2708,2021-07-07T00:00:00.000Z,IB FUNDS TRANSFER CR-50200035187206 -SL ICK ORGANICS PVT LTD,insurance,,Other,100000
61b7060dd8beac1599eb6394,50200023535069,67815.59,60ec41ba55c00300382672d9,HDFC,Marketing Expense,5eecc6d6449e4f7cfb1c2708,2021-07-07T00:00:00.000Z,POS 514834XXXXXX9486 GOOGLE ADS,,,debit_card,-50000
61b7060ed8beac1599eb639a,50200023535069,93188.1,60ec41ba55c00300382672d9,HDFC,Transfer in/Revenue-other,5eecc6d6449e4f7cfb1c2708,2021-07-08T00:00:00.000Z,IMPS-118905913643-NA-HDFC-XXXXXXXXXX0007 -ALL20210708216820000330830668628,,,net_banking_transfer,25372.51
61b7060fd8beac1599eb63a1,50200023535069,97629.05,60ec41ba55c00300382672d9,HDFC,Revenue-Mktplace,5eecc6d6449e4f7cfb1c2708,2021-07-08T00:00:00.000Z,NEFT CR-DEUT0797BGL-MYNTRA DESIGNS PRIVA TE LIMITED-SLICK ORGANICS PRIVATE LIMITE D-118900452GN00234,shopping,,net_banking_transfer,4440.95
61b70610d8beac1599eb63a5,50200023535069,107312.46,60ec41ba55c00300382672d9,HDFC,Revenue-PG-split enabled,5eecc6d6449e4f7cfb1c2708,2021-07-08T00:00:00.000Z,NEFT CR-UTIB0001506-RAZORPAY SOFTWARE PR,,,net_banking_transfer,9683.41
61b70611d8beac1599eb63ab,50200023535069,107494.98,60ec41ba55c00300382672d9,HDFC,Revenue-Mktplace,5eecc6d6449e4f7cfb1c2708,2021-07-08T00:00:00.000Z,NEFT CR-ICIC0000105-ICICI BANK NODAL AC MANASH LIFESTYL-SLICK ORGANICS PRIVATE L IMITED KOLK-ICIJ211890003405,,,net_banking_transfer,182.52
61b70612d8beac1599eb63b2,50200023535069,109454.32,60ec41ba55c00300382672d9,HDFC,Revenue-Mktplace,5eecc6d6449e4f7cfb1c2708,2021-07-08T00:00:00.000Z,NEFT CR-ICIC0000105-ICICI BANK NODAL AC MANASH LIFESTYL-SLICK ORGANICS PRIVATE L IMITED MP M-ICIJ211890003403,,,net_banking_transfer,1959.34
61b70613d8beac1599eb63bb,50200023535069,109710.14,60ec41ba55c00300382672d9,HDFC,Revenue-Mktplace,5eecc6d6449e4f7cfb1c2708,2021-07-08T00:00:00.000Z,NEFT CR-ICIC0000105-ICICI BANK NODAL AC MANASH LIFESTYL-SLICK ORGANICS PRIVATE L IMITED MP G-ICIJ211890003402,,,net_banking_transfer,255.82
61b70614d8beac1599eb63c7,50200023535069,110132.08,60ec41ba55c00300382672d9,HDFC,Revenue-PG-non-split,5eecc6d6449e4f7cfb1c2708,2021-07-08T00:00:00.000Z,NEFT CR-IDFB0010204-SEZZLE PAYMENTS PRIV ATE LIMITED-SLICK ORGANICS PRIVATE LIMIT ED-IDFBH21189765481,insurance,,net_banking_transfer,421.94
61b70615d8beac1599eb63d6,50200023535069,112871.48,60ec41ba55c00300382672d9,HDFC,Revenue-PG-non-split,5eecc6d6449e4f7cfb1c2708,2021-07-08T00:00:00.000Z,NEFT CR-IDFB0010204-SEZZLE PAYMENTS PRIV ATE LIMITED-SLICK ORGANICS PRIVATE LIMIT ED-IDFBH21189765526,insurance,,net_banking_transfer,2739.4
61b70616d8beac1599eb63e8,50200023535069,113550.13,60ec41ba55c00300382672d9,HDFC,Revenue-PG-non-split,5eecc6d6449e4f7cfb1c2708,2021-07-08T00:00:00.000Z,NEFT CR-IDFB0010204-SEZZLE PAYMENTS PRIV ATE LIMITED-SLICK ORGANICS PRIVATE LIMIT ED-IDFBH21189765723,insurance,,net_banking_transfer,678.65
61b70617d8beac1599eb63f3,50200023535069,128653.82,60ec41ba55c00300382672d9,HDFC,Revenue-PG-split enabled,5eecc6d6449e4f7cfb1c2708,2021-07-08T00:00:00.000Z,NEFT CR-UTIB0001506-RAZORPAY SOFTWARE PR IVATE LIMITED-SLICK ORGANICS PVT LITD-AX ISCN0084507357,insurance,,net_banking_transfer,15103.69
61b70618d8beac1599eb63fd,50200023535069,129530.87,60ec41ba55c00300382672d9,HDFC,Revenue-PG-non-split,5eecc6d6449e4f7cfb1c2708,2021-07-08T00:00:00.000Z,NEFT CR-ICIC0000031-PAYTM E COMMERCE PVT LTD-SLICK ORGANICS PVT LTD-CMS201595173 9,ewallet,,net_banking_transfer,877.05
61b70619d8beac1599eb6407,50200023535069,152406.9,60ec41ba55c00300382672d9,HDFC,Transfer in/Revenue-other,5eecc6d6449e4f7cfb1c2708,2021-07-09T00:00:00.000Z,IMPS-119005876845-NA-HDFC-XXXXXXXXXX0007 -ALL20210709216820000330830668628,,,net_banking_transfer,22876.03
61b7061ad8beac1599eb641c,50200023535069,153463.77,60ec41ba55c00300382672d9,HDFC,Revenue-Mktplace,5eecc6d6449e4f7cfb1c2708,2021-07-09T00:00:00.000Z,NEFT CR-DEUT0797BGL-FLIPKART INTERNET PR IVATE LIMITED-SLICK ORGANICS PVT LTD-119 000073GN00242,shopping,,net_banking_transfer,1056.87
61b7061bd8beac1599eb6426,50200023535069,165433.26,60ec41ba55c00300382672d9,HDFC,Revenue-Mktplace,5eecc6d6449e4f7cfb1c2708,2021-07-09T00:00:00.000Z,NEFT CR-DEUT0797BGL-FLIPKART INTERNET PR,shopping,,net_banking_transfer,11969.49
61b7061cd8beac1599eb642e,50200023535069,179298.41,60ec41ba55c00300382672d9,HDFC,Revenue-PG-split enabled,5eecc6d6449e4f7cfb1c2708,2021-07-09T00:00:00.000Z,NEFT CR-UTIB0001506-RAZORPAY SOFTWARE PR IVATE LIMITED-SLICK ORGANICS PVT LITD-AX ISCN0084574942,insurance,,net_banking_transfer,13865.15
61b7061dd8beac1599eb643b,50200023535069,1104298.41,60ec41ba55c00300382672d9,HDFC,Internal Transfers,5eecc6d6449e4f7cfb1c2708,2021-07-09T00:00:00.000Z,IB FUNDS TRANSFER CR-50200035187206 -SL ICK ORGANICS PVT LTD,insurance,,Other,925000
61b7061ed8beac1599eb6445,50200023535069,62796.41,60ec41ba55c00300382672d9,HDFC,Marketing Expense,5eecc6d6449e4f7cfb1c2708,2021-07-09T00:00:00.000Z,"NEFT DR-CITI0000006-FACEBOOK INDIA ONLIN E SERVICES PVT LTD-NETBANK, MUM-N1902115 60864429-1041502",,,net_banking_transfer,-1041502
61b7061fd8beac1599eb644b,50200023535069,67796.41,60ec41ba55c00300382672d9,HDFC,Internal Transfers,5eecc6d6449e4f7cfb1c2708,2021-07-09T00:00:00.000Z,IB FUNDS TRANSFER CR-50200035187206 -SL ICK ORGANICS PVT LTD,insurance,,Other,5000
61b70620d8beac1599eb6451,50200023535069,87796.41,60ec41ba55c00300382672d9,HDFC,Internal Transfers,5eecc6d6449e4f7cfb1c2708,2021-07-09T00:00:00.000Z,IB FUNDS TRANSFER CR-50200050976833 -SL ICK ORGANICS PVT LTD,insurance,,Other,20000
61b70621d8beac1599eb645b,50200023535069,89921.23,60ec41ba55c00300382672d9,HDFC,Revenue-Mktplace,5eecc6d6449e4f7cfb1c2708,2021-07-09T00:00:00.000Z,NEFT CR-DEUT0797BGL-MYNTRA DESIGNS PRIVA TE LIMITED-SLICK ORGANICS PRIVATE LIMITE D-119000462GN00223,shopping,,net_banking_transfer,2124.82
61b70622d8beac1599eb6463,50200023535069,93394.23,60ec41ba55c00300382672d9,HDFC,Transfer in/Revenue-other,5eecc6d6449e4f7cfb1c2708,2021-07-09T00:00:00.000Z,NEFT CR-KKBK0000958-INNOVATIVE RETAIL CO NCEPTS PRIVATE LTD-SLICK ORGANICS PVT LT D-KKBK211908243101,,,net_banking_transfer,3473
61b70623d8beac1599eb646e,50200023535069,93594.82,60ec41ba55c00300382672d9,HDFC,Revenue-Mktplace,5eecc6d6449e4f7cfb1c2708,2021-07-09T00:00:00.000Z,NEFT CR-DEUT0784BBY-TATA UNISTORE LIMITE D-SLICK ORGANICS PVT LTD-119001117GN0019 0,insurance,,net_banking_transfer,200.59
61b70624d8beac1599eb6472,50200023535069,94603.59,60ec41ba55c00300382672d9,HDFC,Revenue-Mktplace,5eecc6d6449e4f7cfb1c2708,2021-07-09T00:00:00.000Z,NEFT CR-DEUT0784BBY-TATA UNISTORE LTD-NO DAL-SLICK ORGANICS PVT LTD-119001127GN00 280,insurance,,net_banking_transfer,1008.77
61b70625d8beac1599eb647a,50200023535069,193061.62,60ec41ba55c00300382672d9,HDFC,Revenue-COD,5eecc6d6449e4f7cfb1c2708,2021-07-09T00:00:00.000Z,NEFT CR-ICIC0000155-SHIPROCKET COD CRF I D 2705436-SLICK ORGANICS PVT LTD-CMS2017 536078,insurance,,net_banking_transfer,98458.03
61b70626d8beac1599eb6482,50200023535069,193609.91,60ec41ba55c00300382672d9,HDFC,Revenue-Mktplace,5eecc6d6449e4f7cfb1c2708,2021-07-09T00:00:00.000Z,NEFT CR-ICIC0000105-ICICI BANK NODAL AC MANASH LIFESTYL-SLICK ORGANICS PRIVATE L IMITED MP M-ICIJ211900006830,,,net_banking_transfer,548.29
61b70627d8beac1599eb648b,50200023535069,195072.99,60ec41ba55c00300382672d9,HDFC,Transfer in/Revenue-other,5eecc6d6449e4f7cfb1c2708,2021-07-09T00:00:00.000Z,NEFT CR-ICIC0000105-ICICI BANK NODAL AC,,,net_banking_transfer,1463.08
61b70627d8beac1599eb6499,50200023535069,204476.73,60ec41ba55c00300382672d9,HDFC,Revenue-PG-split enabled,5eecc6d6449e4f7cfb1c2708,2021-07-09T00:00:00.000Z,NEFT CR-UTIB0001506-RAZORPAY SOFTWARE PR IVATE LIMITED-SLICK ORGANICS PVT LITD-AX ISCN0084663927,insurance,,net_banking_transfer,9403.74
61b70628d8beac1599eb649f,50200023535069,238657.67,60ec41ba55c00300382672d9,HDFC,Transfer in/Revenue-other,5eecc6d6449e4f7cfb1c2708,2021-07-10T00:00:00.000Z,IMPS-119105898918-NA-HDFC-XXXXXXXXXX0007 -ALL20210710216820000330830668628,,,net_banking_transfer,34180.94
61b70629d8beac1599eb64a7,50200023535069,248657.67,60ec41ba55c00300382672d9,HDFC,Internal Transfers,5eecc6d6449e4f7cfb1c2708,2021-07-10T00:00:00.000Z,IB FUNDS TRANSFER CR-50200035187206 -SL ICK ORGANICS PVT LTD,insurance,,Other,10000
61b7062ad8beac1599eb64ad,50200023535069,267947.58,60ec41ba55c00300382672d9,HDFC,Transfer in/Revenue-other,5eecc6d6449e4f7cfb1c2708,2021-07-11T00:00:00.000Z,IMPS-119206807555-NA-HDFC-XXXXXXXXXX0007 -ALL20210711216820000330830668628,,,net_banking_transfer,19289.91
61b7062bd8beac1599eb64b1,50200023535069,257947.58,60ec41ba55c00300382672d9,HDFC,Marketing Expense,5eecc6d6449e4f7cfb1c2708,2021-07-11T00:00:00.000Z,POS 514834XXXXXX9486 GOOGLE ADS,,,debit_card,-10000
61b7062cd8beac1599eb64b9,50200023535069,303677.6,60ec41ba55c00300382672d9,HDFC,Transfer in/Revenue-other,5eecc6d6449e4f7cfb1c2708,2021-07-12T00:00:00.000Z,IMPS-119305669433-NA-HDFC-XXXXXXXXXX0007 -ALL20210712216820000330830668628,,,net_banking_transfer,45730.02
61b7062dd8beac1599eb64be,50200023535069,311336.25,60ec41ba55c00300382672d9,HDFC,Revenue-Mktplace,5eecc6d6449e4f7cfb1c2708,2021-07-12T00:00:00.000Z,NEFT CR-DEUT0797BGL-FLIPKART INTERNET PR IVATE LIMITED-SLICK ORGANICS PVT LTD-119 300108GN00282,shopping,,net_banking_transfer,7658.65
61b7062ed8beac1599eb64c1,50200023535069,317063.09,60ec41ba55c00300382672d9,HDFC,Revenue-Mktplace,5eecc6d6449e4f7cfb1c2708,2021-07-12T00:00:00.000Z,NEFT CR-DEUT0797BGL-MYNTRA DESIGNS PRIVA TE LIMITED-SLICK ORGANICS PRIVATE LIMITE D-119300185GN00083,shopping,,net_banking_transfer,5726.84
61b7062fd8beac1599eb64c6,50200023535069,377200.55,60ec41ba55c00300382672d9,HDFC,Revenue-PG-split enabled,5eecc6d6449e4f7cfb1c2708,2021-07-12T00:00:00.000Z,NEFT CR-UTIB0001506-RAZORPAY SOFTWARE PR IVATE LIMITED-SLICK ORGANICS PVT LITD-AX ISCN0084710746,insurance,,net_banking_transfer,60137.46
61b70630d8beac1599eb64ce,50200023535069,277200.55,60ec41ba55c00300382672d9,HDFC,SAAS/tech expense,5eecc6d6449e4f7cfb1c2708,2021-07-12T00:00:00.000Z,VHDF0107449957/BILLDKAMAZONSELLERSE,shopping,,Other,-100000
61b70631d8beac1599eb64d4,50200023535069,277568.57,60ec41ba55c00300382672d9,HDFC,Transfer in/Revenue-other,5eecc6d6449e4f7cfb1c2708,2021-07-12T00:00:00.000Z,4060002403-11 07 2021-HDFAZCUR1,,,Other,368.02
61b70632d8beac1599eb64dc,50200023535069,265235.57,60ec41ba55c00300382672d9,HDFC,direct expenses,5eecc6d6449e4f7cfb1c2708,2021-07-12T00:00:00.000Z,"NEFT DR-CITI0000002-DHIRAJ-NETBANK, MUM- N193211563535071-12333",,,net_banking_transfer,-12333
61b70633d8beac1599eb64e2,50200023535069,261035.57,60ec41ba55c00300382672d9,HDFC,direct expenses,5eecc6d6449e4f7cfb1c2708,2021-07-12T00:00:00.000Z,"NEFT DR-ICIC0000037-PURPLE PANDA FASHION S PVT LTD-NETBANK, MUM-N193211563580295- 4200",shopping,,net_banking_transfer,-4200
61b70634d8beac1599eb64e6,50200023535069,241035.57,60ec41ba55c00300382672d9,HDFC,direct expenses,5eecc6d6449e4f7cfb1c2708,2021-07-12T00:00:00.000Z,"SELF - CHQ PAID - KALKAJI, NEW",,,chq,-20000
61b70635d8beac1599eb64ea,50200023535069,251478.45,60ec41ba55c00300382672d9,HDFC,Revenue-Mktplace,5eecc6d6449e4f7cfb1c2708,2021-07-12T00:00:00.000Z,NEFT CR-DEUT0797BGL-FLIPKART INTERNET PR,shopping,,net_banking_transfer,10442.88
61b70636d8beac1599eb64f0,50200023535069,251995.94,60ec41ba55c00300382672d9,HDFC,Revenue-Mktplace,5eecc6d6449e4f7cfb1c2708,2021-07-12T00:00:00.000Z,NEFT CR-ICIC0000105-ICICI BANK NODAL AC MANASH LIFESTYL-SLICK ORGANICS PRIVATE L IMITED MP G-ICIJ211930000578,,,net_banking_transfer,517.49
61b70637d8beac1599eb64fb,50200023535069,252405.69,60ec41ba55c00300382672d9,HDFC,Revenue-Mktplace,5eecc6d6449e4f7cfb1c2708,2021-07-12T00:00:00.000Z,NEFT CR-ICIC0000105-ICICI BANK NODAL AC MANASH LIFESTYL-SLICK ORGANICS PRIVATE L IMITED MP M-ICIJ211930002667,,,net_banking_transfer,409.75
61b70638d8beac1599eb64fe,50200023535069,202405.69,60ec41ba55c00300382672d9,HDFC,Marketing Expense,5eecc6d6449e4f7cfb1c2708,2021-07-12T00:00:00.000Z,POS 514834XXXXXX9486 GOOGLE ADS,,,debit_card,-50000
61b70639d8beac1599eb6504,50200023535069,207580.04,60ec41ba55c00300382672d9,HDFC,Revenue-COD,5eecc6d6449e4f7cfb1c2708,2021-07-12T00:00:00.000Z,NEFT CR-ICIC0000155-SHIPROCKET COD CRF I D 2713609-SLICK ORGANICS PVT LTD-CMS2021 341949,insurance,,net_banking_transfer,5174.35
61b7063ad8beac1599eb650a,50200023535069,208479.55,60ec41ba55c00300382672d9,HDFC,Revenue-PG-non-split,5eecc6d6449e4f7cfb1c2708,2021-07-12T00:00:00.000Z,NEFT CR-IDFB0010204-SEZZLE PAYMENTS PRIV ATE LIMITED-SLICK ORGANICS PRIVATE LIMIT ED-IDFBH21193949564,insurance,,net_banking_transfer,899.51
61b7063bd8beac1599eb650e,50200023535069,230073.68,60ec41ba55c00300382672d9,HDFC,Revenue-PG-split enabled,5eecc6d6449e4f7cfb1c2708,2021-07-12T00:00:00.000Z,NEFT CR-UTIB0001506-RAZORPAY SOFTWARE PR IVATE LIMITED-SLICK ORGANICS PVT LITD-AX ISCN0084801088,insurance,,net_banking_transfer,21594.13
61b7063cd8beac1599eb6517,50200023535069,226418.13,60ec41ba55c00300382672d9,HDFC,direct expenses,5eecc6d6449e4f7cfb1c2708,2021-07-12T00:00:00.000Z,POS 514834XXXXXX9486 WWW.FAQPRIME.COM,,,debit_card,-3655.55
61b7063dd8beac1599eb651a,50200023535069,226884.58,60ec41ba55c00300382672d9,HDFC,Revenue-PG-non-split,5eecc6d6449e4f7cfb1c2708,2021-07-12T00:00:00.000Z,NEFT CR-ICIC0000031-PAYTM E COMMERCE PVT LTD-SLICK ORGANICS PVT LTD-CMS202200019 1,ewallet,,net_banking_transfer,466.45
61b7063ed8beac1599eb651f,50200023535069,669151.58,60ec41ba55c00300382672d9,HDFC,Investment/FD redeem,5eecc6d6449e4f7cfb1c2708,2021-07-13T00:00:00.000Z,PRIN AND INT AUTO_REDEEM 50300489334405,,,Other,442267
61b7063fd8beac1599eb6522,50200023535069,718938.07,60ec41ba55c00300382672d9,HDFC,Transfer in/Revenue-other,5eecc6d6449e4f7cfb1c2708,2021-07-13T00:00:00.000Z,IMPS-119405791257-NA-HDFC-XXXXXXXXXX0007 -ALL20210713216820000330830668628,,,net_banking_transfer,49786.49
61b7063fd8beac1599eb6526,50200023535069,818528.45,60ec41ba55c00300382672d9,HDFC,Revenue-Mktplace,5eecc6d6449e4f7cfb1c2708,2021-07-13T00:00:00.000Z,IMPS-119405072352-AMAZON SELLER SERVIC-H DFC-XXXXXXXX6004-77A6XAM2KW9A23P5SLICK O RGANICS PVT LTD,shopping,,net_banking_transfer,99590.38
61b70640d8beac1599eb6530,50200023535069,1297343.48,60ec41ba55c00300382672d9,HDFC,Revenue-Mktplace,5eecc6d6449e4f7cfb1c2708,2021-07-13T00:00:00.000Z,NEFT CR-DEUT0797BGL-AMAZON PAY (INDIA) P RIVATE LIMITED-SLICK ORGANICS PVT LTD-11 9400029GN00492,shopping,,net_banking_transfer,478815.03
61b70641d8beac1599eb6534,50200023535069,1316940.97,60ec41ba55c00300382672d9,HDFC,Revenue-PG-split enabled,5eecc6d6449e4f7cfb1c2708,2021-07-13T00:00:00.000Z,NEFT CR-UTIB0001506-RAZORPAY SOFTWARE PR,,,net_banking_transfer,19597.49
61b70642d8beac1599eb653a,50200023535069,1319857.96,60ec41ba55c00300382672d9,HDFC,Revenue-PG-non-split,5eecc6d6449e4f7cfb1c2708,2021-07-13T00:00:00.000Z,NEFT CR-SCBL0036001-STRIPE INDIA PRIVATE -SLICK ORGANICS PRIVATE LIMITED-SSG17413 Q0318695,insurance,,net_banking_transfer,2916.99
61b70643d8beac1599eb653f,50200023535069,1306053.96,60ec41ba55c00300382672d9,HDFC,direct expenses,5eecc6d6449e4f7cfb1c2708,2021-07-13T00:00:00.000Z,"NEFT DR-SBIN0008078-PANDIT PLASTICS-NETB ANK, MUM-N194211564826113-13804",,,net_banking_transfer,-13804
61b70644d8beac1599eb6545,50200023535069,1257453.96,60ec41ba55c00300382672d9,HDFC,direct expenses,5eecc6d6449e4f7cfb1c2708,2021-07-13T00:00:00.000Z,"NEFT DR-CNRB0015170-SNEHAL TAYDE-NETBANK , MUM-N194211564815211-48600",,,net_banking_transfer,-48600
61b70645d8beac1599eb6551,50200023535069,1233801.96,60ec41ba55c00300382672d9,HDFC,direct expenses,5eecc6d6449e4f7cfb1c2708,2021-07-13T00:00:00.000Z,"NEFT DR-KKBK0000187-APPLIED LIFE PRIVATE LIMITED-NETBANK, MUM-N194211564818917-2 3652",,,net_banking_transfer,-23652
61b70646d8beac1599eb6555,50200023535069,1183801.96,60ec41ba55c00300382672d9,HDFC,direct expenses,5eecc6d6449e4f7cfb1c2708,2021-07-13T00:00:00.000Z,"NEFT DR-PYTM0123456-PAYTM-NETBANK, MUM-N 194211564827861-50000",ewallet,,net_banking_transfer,-50000
61b70647d8beac1599eb655a,50200023535069,1129801.96,60ec41ba55c00300382672d9,HDFC,direct expenses,5eecc6d6449e4f7cfb1c2708,2021-07-13T00:00:00.000Z,"NEFT DR-KKBK0000654-NIHARIKA MISHRA-NETB ANK, MUM-N194211564971435-54000",,,net_banking_transfer,-54000
61b70648d8beac1599eb655e,50200023535069,998128.96,60ec41ba55c00300382672d9,HDFC,direct expenses,5eecc6d6449e4f7cfb1c2708,2021-07-13T00:00:00.000Z,"NEFT DR-PUNB0642000-UFLEX LIMITED-NETBAN K, MUM-N194211565028575-131673",loans,lender_transaction,net_banking_transfer,-131673
61b70649d8beac1599eb6562,50200023535069,968128.96,60ec41ba55c00300382672d9,HDFC,direct expenses,5eecc6d6449e4f7cfb1c2708,2021-07-13T00:00:00.000Z,"NEFT DR-ICIC0001878-BAMBOO INDIA-NETBANK , MUM-N194211565018757-30000",,,net_banking_transfer,-30000
61b7064ad8beac1599eb6568,50200023535069,987699.96,60ec41ba55c00300382672d9,HDFC,Transfer in/Revenue-other,5eecc6d6449e4f7cfb1c2708,2021-07-13T00:00:00.000Z,50200050241205-TPT-ARATA-NAPSA PRIVATE L IMITED,,,net_banking_transfer,19571
61b7064bd8beac1599eb6570,50200023535069,1002641.71,60ec41ba55c00300382672d9,HDFC,Revenue-PG-split enabled,5eecc6d6449e4f7cfb1c2708,2021-07-13T00:00:00.000Z,NEFT CR-UTIB0001506-RAZORPAY SOFTWARE PR IVATE LIMITED-SLICK ORGANICS PVT LITD-AX ISCN0084907773,insurance,,net_banking_transfer,14941.75
61b7064cd8beac1599eb6575,50200023535069,1038723.76,60ec41ba55c00300382672d9,HDFC,Transfer in/Revenue-other,5eecc6d6449e4f7cfb1c2708,2021-07-14T00:00:00.000Z,IMPS-119505922132-NA-HDFC-XXXXXXXXXX0007 -ALL20210714216820000330830668628,,,net_banking_transfer,36082.05
61b7064dd8beac1599eb6585,50200023535069,783723.76,60ec41ba55c00300382672d9,HDFC,SAAS/tech expense,5eecc6d6449e4f7cfb1c2708,2021-07-14T00:00:00.000Z,VHDF0112399664/BILLDKAMAZONSELLERSE,shopping,,Other,-255000
61b7064ed8beac1599eb658d,50200023535069,789610.84,60ec41ba55c00300382672d9,HDFC,Revenue-Mktplace,5eecc6d6449e4f7cfb1c2708,2021-07-14T00:00:00.000Z,NEFT CR-DEUT0797BGL-FLIPKART INTERNET PR IVATE LIMITED-SLICK ORGANICS PVT LTD-119 500074GN00111,shopping,,net_banking_transfer,5887.08
61b7064fd8beac1599eb6593,50200023535069,798142.6,60ec41ba55c00300382672d9,HDFC,Revenue-Mktplace,5eecc6d6449e4f7cfb1c2708,2021-07-14T00:00:00.000Z,NEFT CR-DEUT0797BGL-FLIPKART INTERNET PR,shopping,,net_banking_transfer,8531.76
61b70650d8beac1599eb659a,50200023535069,813138.26,60ec41ba55c00300382672d9,HDFC,Revenue-PG-split enabled,5eecc6d6449e4f7cfb1c2708,2021-07-14T00:00:00.000Z,NEFT CR-UTIB0001506-RAZORPAY SOFTWARE PR IVATE LIMITED-SLICK ORGANICS PVT LITD-AX ISCN0084934855,insurance,,net_banking_transfer,14995.66
61b70651d8beac1599eb659f,50200023535069,813049.11,60ec41ba55c00300382672d9,HDFC,bank charges,5eecc6d6449e4f7cfb1c2708,2021-07-14T00:00:00.000Z,.DC INTL POS TXN MARKUP+ST 010721 020721 -CDT2119104860993,,,international_transaction_arbitrage,-89.15
61b70652d8beac1599eb65a4,50200023535069,817934.23,60ec41ba55c00300382672d9,HDFC,Revenue-Mktplace,5eecc6d6449e4f7cfb1c2708,2021-07-14T00:00:00.000Z,NEFT CR-DEUT0797BGL-MYNTRA DESIGNS PRIVA TE LIMITED-SLICK ORGANICS PRIVATE LIMITE D-119500386GN00033,shopping,,net_banking_transfer,4885.12
61b70653d8beac1599eb65a6,50200023535069,817480.16,60ec41ba55c00300382672d9,HDFC,bank charges,5eecc6d6449e4f7cfb1c2708,2021-07-14T00:00:00.000Z,.DC INTL POS TXN MARKUP+ST 040721 060721 -CDT2119104860993,,,international_transaction_arbitrage,-454.07
61b70654d8beac1599eb65ac,50200023535069,917287.82,60ec41ba55c00300382672d9,HDFC,Revenue-COD,5eecc6d6449e4f7cfb1c2708,2021-07-14T00:00:00.000Z,NEFT CR-ICIC0000155-SHIPROCKET COD CRF I D 2725968-SLICK ORGANICS PVT LTD-CMS2025 242472,insurance,,net_banking_transfer,99807.66
61b70655d8beac1599eb65b6,50200023535069,920115.9,60ec41ba55c00300382672d9,HDFC,Revenue-PG-non-split,5eecc6d6449e4f7cfb1c2708,2021-07-14T00:00:00.000Z,NEFT CR-IDFB0010204-SEZZLE PAYMENTS PRIV ATE LIMITED-SLICK ORGANICS PRIVATE LIMIT ED-IDFBH21195058342,insurance,,net_banking_transfer,2828.08
61b70656d8beac1599eb65ba,50200023535069,926528.44,60ec41ba55c00300382672d9,HDFC,Revenue-PG-non-split,5eecc6d6449e4f7cfb1c2708,2021-07-14T00:00:00.000Z,NEFT CR-IDFB0010204-SEZZLE PAYMENTS PRIV ATE LIMITED-SLICK ORGANICS PRIVATE LIMIT ED-IDFBH21195058501,insurance,,net_banking_transfer,6412.54
61b70657d8beac1599eb65c0,50200023535069,927056.94,60ec41ba55c00300382672d9,HDFC,Revenue-Mktplace,5eecc6d6449e4f7cfb1c2708,2021-07-14T00:00:00.000Z,NEFT CR-ICIC0000105-ICICI BANK NODAL AC MANASH LIFESTYL-SLICK ORGANICS PRIVATE L IMITED MP G-ICIJ211950002364,,,net_banking_transfer,528.5
61b70658d8beac1599eb65c5,50200023535069,930548.24,60ec41ba55c00300382672d9,HDFC,Revenue-Mktplace,5eecc6d6449e4f7cfb1c2708,2021-07-14T00:00:00.000Z,NEFT CR-ICIC0000105-ICICI BANK NODAL AC MANASH LIFESTYL-SLICK ORGANICS PRIVATE L IMITED MP M-ICIJ211950002365,,,net_banking_transfer,3491.3
61b70659d8beac1599eb65ca,50200023535069,930932.33,60ec41ba55c00300382672d9,HDFC,Revenue-Mktplace,5eecc6d6449e4f7cfb1c2708,2021-07-14T00:00:00.000Z,NEFT CR-ICIC0000105-ICICI BANK NODAL AC MANASH LIFESTYL-SLICK ORGANICS PRIVATE L IMITED KOLK-ICIJ211950002366,,,net_banking_transfer,384.09
61b7065ad8beac1599eb65d4,50200023535069,932358.79,60ec41ba55c00300382672d9,HDFC,Transfer in/Revenue-other,5eecc6d6449e4f7cfb1c2708,2021-07-14T00:00:00.000Z,NEFT CR-ICIC0000105-ICICI BANK NODAL AC,,,net_banking_transfer,1426.46
61b7065bd8beac1599eb65d9,50200023535069,940226.71,60ec41ba55c00300382672d9,HDFC,Revenue-PG-split enabled,5eecc6d6449e4f7cfb1c2708,2021-07-14T00:00:00.000Z,NEFT CR-UTIB0001506-RAZORPAY SOFTWARE PR IVATE LIMITED-SLICK ORGANICS PVT LITD-AX ISCN0085004480,insurance,,net_banking_transfer,7867.92
61b7065cd8beac1599eb65de,50200023535069,967650.72,60ec41ba55c00300382672d9,HDFC,Transfer in/Revenue-other,5eecc6d6449e4f7cfb1c2708,2021-07-15T00:00:00.000Z,IMPS-119605131513-NA-HDFC-XXXXXXXXXX0007 -ALL20210715216820000330830668628,,,net_banking_transfer,27424.01
61b7065dd8beac1599eb65e0,50200023535069,979618.64,60ec41ba55c00300382672d9,HDFC,Revenue-PG-split enabled,5eecc6d6449e4f7cfb1c2708,2021-07-15T00:00:00.000Z,NEFT CR-UTIB0001506-RAZORPAY SOFTWARE PR IVATE LIMITED-SLICK ORGANICS PVT LITD-AX ISCN0085043213,insurance,,net_banking_transfer,11967.92
61b7065ed8beac1599eb65e4,50200023535069,422469.64,60ec41ba55c00300382672d9,HDFC,Marketing Expense,5eecc6d6449e4f7cfb1c2708,2021-07-15T00:00:00.000Z,"NEFT DR-CITI0000006-FACEBOOK INDIA ONLIN E SERVICES PVT LTD-NETBANK, MUM-N1962115 67328259-557149",,,net_banking_transfer,-557149
61b7065fd8beac1599eb660e,50200023535069,423984.45,60ec41ba55c00300382672d9,HDFC,Revenue-Mktplace,5eecc6d6449e4f7cfb1c2708,2021-07-15T00:00:00.000Z,4060002370-TIMES INTERNET LIMITED NODAL,,,Other,1514.81
61b70660d8beac1599eb6611,50200023535069,428187.45,60ec41ba55c00300382672d9,HDFC,Revenue-Mktplace,5eecc6d6449e4f7cfb1c2708,2021-07-15T00:00:00.000Z,NEFT CR-KKBK0000958-SURFBOATS SOLUTIONS PVT LTD-SLICK ORGANICS PRIVATE LIMITED-K KBK211969671737,insurance,,net_banking_transfer,4203
61b70661d8beac1599eb6616,50200023535069,428855.94,60ec41ba55c00300382672d9,HDFC,Revenue-Mktplace,5eecc6d6449e4f7cfb1c2708,2021-07-15T00:00:00.000Z,NEFT CR-ICIC0000105-ICICI BANK NODAL AC MANASH LIFESTYL-SLICK ORGANICS PRIVATE L IMITED MP G-ICIJ211960004619,,,net_banking_transfer,668.49
61b70662d8beac1599eb661d,50200023535069,429952.51,60ec41ba55c00300382672d9,HDFC,Revenue-Mktplace,5eecc6d6449e4f7cfb1c2708,2021-07-15T00:00:00.000Z,NEFT CR-ICIC0000105-ICICI BANK NODAL AC MANASH LIFESTYL-SLICK ORGANICS PRIVATE L IMITED KOLK-ICIJ211960004622,,,net_banking_transfer,1096.57
61b70663d8beac1599eb662b,50200023535069,429985.51,60ec41ba55c00300382672d9,HDFC,Revenue-Mktplace,5eecc6d6449e4f7cfb1c2708,2021-07-15T00:00:00.000Z,NEFT CR-ICIC0000105-ICICI BANK NODAL AC MANASH LIFESTYL-SLICK ORGANICS PRIVATE L IMITED MP M-ICIJ211960004621,,,net_banking_transfer,33
61b70664d8beac1599eb6638,50200023535069,430463.83,60ec41ba55c00300382672d9,HDFC,Revenue-PG-non-split,5eecc6d6449e4f7cfb1c2708,2021-07-15T00:00:00.000Z,NEFT CR-IDFB0010204-SEZZLE PAYMENTS PRIV ATE LIMITED-SLICK ORGANICS PRIVATE LIMIT ED-IDFBH21196130625,insurance,,net_banking_transfer,478.32
61b70665d8beac1599eb663c,50200023535069,445488.72,60ec41ba55c00300382672d9,HDFC,Revenue-PG-split enabled,5eecc6d6449e4f7cfb1c2708,2021-07-15T00:00:00.000Z,NEFT CR-UTIB0001506-RAZORPAY SOFTWARE PR IVATE LIMITED-SLICK ORGANICS PVT LITD-AX ISCN0085121971,insurance,,net_banking_transfer,15024.89
61b70665d8beac1599eb6641,50200023535069,443013.2,60ec41ba55c00300382672d9,HDFC,direct expenses,5eecc6d6449e4f7cfb1c2708,2021-07-15T00:00:00.000Z,POS 514834XXXXXX9486 RAZ*KNOWLARITY,,,debit_card,-2475.52
61b70666d8beac1599eb6644,50200023535069,440997.2,60ec41ba55c00300382672d9,HDFC,direct expenses,5eecc6d6449e4f7cfb1c2708,2021-07-15T00:00:00.000Z,02021120186434/ESIC,,,Other,-2016
61b70667d8beac1599eb6649,50200023535069,329600.2,60ec41ba55c00300382672d9,HDFC,direct expenses,5eecc6d6449e4f7cfb1c2708,2021-07-15T00:00:00.000Z,CHQ PAID-INWARD TRAN-CAVALIER LOGISTICS,,,chq,-111397
61b70668d8beac1599eb6657,50200023535069,279600.2,60ec41ba55c00300382672d9,HDFC,Marketing Expense,5eecc6d6449e4f7cfb1c2708,2021-07-15T00:00:00.000Z,POS 514834XXXXXX9486 GOOGLE ADS,,,debit_card,-50000
61b70669d8beac1599eb665f,50200023535069,297129.89,60ec41ba55c00300382672d9,HDFC,Transfer in/Revenue-other,5eecc6d6449e4f7cfb1c2708,2021-07-16T00:00:00.000Z,IMPS-119705229634-NA-HDFC-XXXXXXXXXX0007 -ALL20210716216820000330830668628,,,net_banking_transfer,17529.69
61b7066ad8beac1599eb6665,50200023535069,302491.94,60ec41ba55c00300382672d9,HDFC,Revenue-Mktplace,5eecc6d6449e4f7cfb1c2708,2021-07-16T00:00:00.000Z,NEFT CR-DEUT0797BGL-FLIPKART INTERNET PR IVATE LIMITED-SLICK ORGANICS PVT LTD-119 700106GN00184,shopping,,net_banking_transfer,5362.05
61b7066bd8beac1599eb666a,50200023535069,305544.88,60ec41ba55c00300382672d9,HDFC,Revenue-Mktplace,5eecc6d6449e4f7cfb1c2708,2021-07-16T00:00:00.000Z,NEFT CR-DEUT0797BGL-MYNTRA DESIGNS PRIVA TE LIMITED-SLICK ORGANICS PRIVATE LIMITE D-119700178GN00285,shopping,,net_banking_transfer,3052.94
61b7066cd8beac1599eb6671,50200023535069,315448.97,60ec41ba55c00300382672d9,HDFC,Revenue-PG-split enabled,5eecc6d6449e4f7cfb1c2708,2021-07-16T00:00:00.000Z,NEFT CR-UTIB0001506-RAZORPAY SOFTWARE PR IVATE LIMITED-SLICK ORGANICS PVT LITD-AX ISCN0085151361,insurance,,net_banking_transfer,9904.09
61b7066dd8beac1599eb667b,50200023535069,314104.97,60ec41ba55c00300382672d9,HDFC,direct expenses,5eecc6d6449e4f7cfb1c2708,2021-07-16T00:00:00.000Z,"NEFT DR-ICIC0000021-AKHILESH DIXIT-NETBA NK, MUM-N197211568638314-1344",,,net_banking_transfer,-1344
61b7066ed8beac1599eb6681,50200023535069,314192.94,60ec41ba55c00300382672d9,HDFC,Revenue-Mktplace,5eecc6d6449e4f7cfb1c2708,2021-07-16T00:00:00.000Z,NEFT CR-ICIC0000105-ICICI BANK NODAL AC MANASH LIFESTYL-SLICK ORGANICS PRIVATE L IMITED BANG-ICIJ211970002637,,,net_banking_transfer,87.97
61b7066fd8beac1599eb6689,50200023535069,314577.03,60ec41ba55c00300382672d9,HDFC,Revenue-Mktplace,5eecc6d6449e4f7cfb1c2708,2021-07-16T00:00:00.000Z,NEFT CR-ICIC0000105-ICICI BANK NODAL AC MANASH LIFESTYL-SLICK ORGANICS PRIVATE L IMITED KOLK-ICIJ211970004510,,,net_banking_transfer,384.09
61b70670d8beac1599eb668c,50200023535069,315071.07,60ec41ba55c00300382672d9,HDFC,Revenue-Mktplace,5eecc6d6449e4f7cfb1c2708,2021-07-16T00:00:00.000Z,NEFT CR-ICIC0000105-ICICI BANK NODAL AC MANASH LIFESTYL-SLICK ORGANICS PRIVATE L IMITED MP M-ICIJ211970002636,,,net_banking_transfer,494.04
61b70671d8beac1599eb668e,50200023535069,315619.36,60ec41ba55c00300382672d9,HDFC,Revenue-Mktplace,5eecc6d6449e4f7cfb1c2708,2021-07-16T00:00:00.000Z,NEFT CR-ICIC0000105-ICICI BANK NODAL AC MANASH LIFESTYL-SLICK ORGANICS PRIVATE L IMITED MP G-ICIJ211970002634,,,net_banking_transfer,548.29
61b70672d8beac1599eb6697,50200023535069,367468.98,60ec41ba55c00300382672d9,HDFC,Revenue-COD,5eecc6d6449e4f7cfb1c2708,2021-07-16T00:00:00.000Z,NEFT CR-ICIC0000155-SHIPROCKET COD CRF I D 2738171-SLICK ORGANICS PVT LTD-CMS2029 354419,insurance,,net_banking_transfer,51849.62
61b70673d8beac1599eb669e,50200023535069,367864.9,60ec41ba55c00300382672d9,HDFC,Revenue-Mktplace,5eecc6d6449e4f7cfb1c2708,2021-07-16T00:00:00.000Z,NEFT CR-DEUT0784BBY-TATA UNISTORE LIMITE,,,net_banking_transfer,395.92
61b70674d8beac1599eb66a1,50200023535069,368289.36,60ec41ba55c00300382672d9,HDFC,Revenue-Mktplace,5eecc6d6449e4f7cfb1c2708,2021-07-16T00:00:00.000Z,NEFT CR-DEUT0784BBY-TATA UNISTORE LIMITE D-SLICK ORGANICS PVT LTD-119701733GN0017 4,insurance,,net_banking_transfer,424.46
61b70675d8beac1599eb66a6,50200023535069,369109.02,60ec41ba55c00300382672d9,HDFC,Revenue-Mktplace,5eecc6d6449e4f7cfb1c2708,2021-07-16T00:00:00.000Z,NEFT CR-DEUT0784BBY-TATA UNISTORE LTD-NO DAL-SLICK ORGANICS PVT LTD-119701751GN00 250,insurance,,net_banking_transfer,819.66
61b70676d8beac1599eb66ab,50200023535069,372967.87,60ec41ba55c00300382672d9,HDFC,Revenue-Mktplace,5eecc6d6449e4f7cfb1c2708,2021-07-16T00:00:00.000Z,NEFT CR-DEUT0784BBY-TATA UNISTORE LTD-NO DAL-SLICK ORGANICS PVT LTD-119701751GN00 339,insurance,,net_banking_transfer,3858.85
61b70677d8beac1599eb66b0,50200023535069,393803.6,60ec41ba55c00300382672d9,HDFC,Revenue-PG-split enabled,5eecc6d6449e4f7cfb1c2708,2021-07-16T00:00:00.000Z,NEFT CR-UTIB0001506-RAZORPAY SOFTWARE PR IVATE LIMITED-SLICK ORGANICS PVT LITD-AX ISCN0085220494,insurance,,net_banking_transfer,20835.73
61b70678d8beac1599eb66b9,50200023535069,415239.6,60ec41ba55c00300382672d9,HDFC,Revenue-Mktplace,5eecc6d6449e4f7cfb1c2708,2021-07-16T00:00:00.000Z,NEFT CR-SCBL0036001-M/S DREAMPLUG TECHNO -SLICK ORGANICS PRIVATE LIMITEDSLICK-SIN 31436Q0016696,insurance,,net_banking_transfer,21436
61b7067ad8beac1599eb66bf,50200023535069,418409.09,60ec41ba55c00300382672d9,HDFC,Transfer in/Revenue-other,5eecc6d6449e4f7cfb1c2708,2021-07-16T00:00:00.000Z,NEFT CR-ICIC0SF0002-ICICI BANK NODAL A-C -SLICK ORGANICS-24560704731DC,insurance,,net_banking_transfer,3169.49
61b7067ad8beac1599eb66c1,50200023535069,418626.53,60ec41ba55c00300382672d9,HDFC,Revenue-PG-non-split,5eecc6d6449e4f7cfb1c2708,2021-07-16T00:00:00.000Z,NEFT CR-ICIC0000031-PAYTM E COMMERCE PVT LTD-SLICK ORGANICS PVT LTD-CMS202958691 1,ewallet,,net_banking_transfer,217.44
61b7067bd8beac1599eb66c5,50200023535069,466887.75,60ec41ba55c00300382672d9,HDFC,Transfer in/Revenue-other,5eecc6d6449e4f7cfb1c2708,2021-07-17T00:00:00.000Z,IMPS-119805268221-NA-HDFC-XXXXXXXXXX0007 -ALL20210717216820000330830668628,,,net_banking_transfer,48261.22
61b7067cd8beac1599eb66cc,50200023535069,485983.85,60ec41ba55c00300382672d9,HDFC,Revenue-PG-split enabled,5eecc6d6449e4f7cfb1c2708,2021-07-17T00:00:00.000Z,NEFT CR-UTIB0001506-RAZORPAY SOFTWARE PR IVATE LIMITED-SLICK ORGANICS PVT LITD-AX ISCN0085242067,insurance,,net_banking_transfer,19096.1
61b7067dd8beac1599eb66d1,50200023535069,487316.41,60ec41ba55c00300382672d9,HDFC,Revenue-PG-non-split,5eecc6d6449e4f7cfb1c2708,2021-07-17T00:00:00.000Z,NEFT CR-IDFB0010204-SEZZLE PAYMENTS PRIV ATE LIMITED-SLICK ORGANICS PRIVATE LIMIT ED-IDFBH21198263124,insurance,,net_banking_transfer,1332.56
61b7067ed8beac1599eb66d4,50200023535069,497683.24,60ec41ba55c00300382672d9,HDFC,Revenue-PG-split enabled,5eecc6d6449e4f7cfb1c2708,2021-07-17T00:00:00.000Z,NEFT CR-UTIB0001506-RAZORPAY SOFTWARE PR,,,net_banking_transfer,10366.83
61b7067fd8beac1599eb66d9,50200023535069,524813.46,60ec41ba55c00300382672d9,HDFC,Transfer in/Revenue-other,5eecc6d6449e4f7cfb1c2708,2021-07-18T00:00:00.000Z,IMPS-119905215559-NA-HDFC-XXXXXXXXXX0007 -ALL20210718216820000330830668628,,,net_banking_transfer,27130.22
61b70680d8beac1599eb66e0,50200023535069,554477.02,60ec41ba55c00300382672d9,HDFC,Transfer in/Revenue-other,5eecc6d6449e4f7cfb1c2708,2021-07-19T00:00:00.000Z,IMPS-120005202995-NA-HDFC-XXXXXXXXXX0007 -ALL20210719216820000330830668628,,,net_banking_transfer,29663.56
61b70681d8beac1599eb66e9,50200023535069,564984.15,60ec41ba55c00300382672d9,HDFC,Revenue-Mktplace,5eecc6d6449e4f7cfb1c2708,2021-07-19T00:00:00.000Z,NEFT CR-DEUT0797BGL-FLIPKART INTERNET PR IVATE LIMITED-SLICK ORGANICS PVT LTD-120 000103GN00251,shopping,,net_banking_transfer,10507.13
61b70682d8beac1599eb66ee,50200023535069,570859.86,60ec41ba55c00300382672d9,HDFC,Revenue-Mktplace,5eecc6d6449e4f7cfb1c2708,2021-07-19T00:00:00.000Z,NEFT CR-DEUT0797BGL-FLIPKART INTERNET PR IVATE LIMITED-SLICK ORGANICS PVT LTD-120 000132GN00254,shopping,,net_banking_transfer,5875.71
61b70683d8beac1599eb66f4,50200023535069,633799.9,60ec41ba55c00300382672d9,HDFC,Revenue-PG-split enabled,5eecc6d6449e4f7cfb1c2708,2021-07-19T00:00:00.000Z,NEFT CR-UTIB0001506-RAZORPAY SOFTWARE PR IVATE LIMITED-SLICK ORGANICS PVT LITD-AX ISCN0085334947,insurance,,net_banking_transfer,62940.04
61b70684d8beac1599eb66f8,50200023535069,639384.43,60ec41ba55c00300382672d9,HDFC,Revenue-Mktplace,5eecc6d6449e4f7cfb1c2708,2021-07-19T00:00:00.000Z,NEFT CR-DEUT0797BGL-MYNTRA DESIGNS PRIVA TE LIMITED-SLICK ORGANICS PRIVATE LIMITE D-120000390GN00207,shopping,,net_banking_transfer,5584.53
61b70685d8beac1599eb66fa,50200023535069,589384.43,60ec41ba55c00300382672d9,HDFC,Marketing Expense,5eecc6d6449e4f7cfb1c2708,2021-07-19T00:00:00.000Z,POS 514834XXXXXX9486 GOOGLE ADS,,,debit_card,-50000
61b70686d8beac1599eb66ff,50200023535069,529384.43,60ec41ba55c00300382672d9,HDFC,direct expenses,5eecc6d6449e4f7cfb1c2708,2021-07-19T00:00:00.000Z,02771610131904-TPT-60000-DIGANT BHATT,,,net_banking_transfer,-60000
61b70687d8beac1599eb670f,50200023535069,353134.43,60ec41ba55c00300382672d9,HDFC,direct expenses,5eecc6d6449e4f7cfb1c2708,2021-07-19T00:00:00.000Z,"NEFT DR-INDB0000333-NOASTRIX PRIVATE LIM ITED-NETBANK, MUM-N200211571176950-17625 0",,,net_banking_transfer,-176250
61b70688d8beac1599eb6712,50200023535069,358627.21,60ec41ba55c00300382672d9,HDFC,Revenue-PG-non-split,5eecc6d6449e4f7cfb1c2708,2021-07-19T00:00:00.000Z,NEFT CR-IDFB0010204-SEZZLE PAYMENTS PRIV ATE LIMITED-SLICK ORGANICS PRIVATE LIMIT ED-IDFBH21200332874,insurance,,net_banking_transfer,5492.78
61b70689d8beac1599eb6717,50200023535069,359519.28,60ec41ba55c00300382672d9,HDFC,Revenue-Mktplace,5eecc6d6449e4f7cfb1c2708,2021-07-19T00:00:00.000Z,NEFT CR-ICIC0000105-ICICI BANK NODAL AC MANASH LIFESTYL-SLICK ORGANICS PRIVATE L IMITED KOLK-ICIJ212000000599,,,net_banking_transfer,892.07
61b7068ad8beac1599eb671d,50200023535069,360560.88,60ec41ba55c00300382672d9,HDFC,Revenue-Mktplace,5eecc6d6449e4f7cfb1c2708,2021-07-19T00:00:00.000Z,NEFT CR-ICIC0000105-ICICI BANK NODAL AC MANASH LIFESTYL-SLICK ORGANICS PRIVATE L IMITED MP G-ICIJ212000000596,,,net_banking_transfer,1041.6
61b7068bd8beac1599eb6721,50200023535069,361054.18,60ec41ba55c00300382672d9,HDFC,Transfer in/Revenue-other,5eecc6d6449e4f7cfb1c2708,2021-07-19T00:00:00.000Z,NEFT CR-ICIC0000105-ICICI BANK NODAL AC,,,net_banking_transfer,493.3
61b7068cd8beac1599eb6732,50200023535069,361767.38,60ec41ba55c00300382672d9,HDFC,Revenue-Mktplace,5eecc6d6449e4f7cfb1c2708,2021-07-19T00:00:00.000Z,NEFT CR-ICIC0000105-ICICI BANK NODAL AC MANASH LIFESTYL-SLICK ORGANICS PRIVATE L IMITED BANG-ICIJ212000000601,,,net_banking_transfer,713.2
61b7068dd8beac1599eb6742,50200023535069,384392.93,60ec41ba55c00300382672d9,HDFC,Revenue-PG-split enabled,5eecc6d6449e4f7cfb1c2708,2021-07-19T00:00:00.000Z,NEFT CR-UTIB0001506-RAZORPAY SOFTWARE PR IVATE LIMITED-SLICK ORGANICS PVT LITD-AX ISCN0085417039,insurance,,net_banking_transfer,22625.55
61b7068ed8beac1599eb6756,50200023535069,129392.93,60ec41ba55c00300382672d9,HDFC,SAAS/tech expense,5eecc6d6449e4f7cfb1c2708,2021-07-19T00:00:00.000Z,KQRHQ7ULA5ZK7PORCI/PAYUAMAZON,shopping,,Other,-255000
61b7068fd8beac1599eb6759,50200023535069,151828,60ec41ba55c00300382672d9,HDFC,Transfer in/Revenue-other,5eecc6d6449e4f7cfb1c2708,2021-07-20T00:00:00.000Z,IMPS-120105297082-NA-HDFC-XXXXXXXXXX0007 -ALL20210720216820000330830668628,,,net_banking_transfer,22435.07
61b70690d8beac1599eb6768,50200023535069,284721.61,60ec41ba55c00300382672d9,HDFC,Revenue-Mktplace,5eecc6d6449e4f7cfb1c2708,2021-07-20T00:00:00.000Z,IMPS-120105227524-AMAZON SELLER SERVIC-H DFC-XXXXXXXX6004-2TRXHB8SBP8YGYU8SLICK O RGANICS PVT LTD,shopping,,net_banking_transfer,132893.61
61b70691d8beac1599eb6779,50200023535069,737986.37,60ec41ba55c00300382672d9,HDFC,Revenue-Mktplace,5eecc6d6449e4f7cfb1c2708,2021-07-20T00:00:00.000Z,NEFT CR-DEUT0797BGL-AMAZON PAY (INDIA) P RIVATE LIMITED-SLICK ORGANICS PVT LTD-12 0100029GN01060,shopping,,net_banking_transfer,453264.76
61b70691d8beac1599eb677f,50200023535069,711404.37,60ec41ba55c00300382672d9,HDFC,direct expenses,5eecc6d6449e4f7cfb1c2708,2021-07-20T00:00:00.000Z,"NEFT DR-ICIC0000021-AKHILESH DIXIT-NETBA NK, MUM-N201211571671288-26582",,,net_banking_transfer,-26582
61b70692d8beac1599eb6785,50200023535069,746750.73,60ec41ba55c00300382672d9,HDFC,Revenue-PG-split enabled,5eecc6d6449e4f7cfb1c2708,2021-07-20T00:00:00.000Z,NEFT CR-UTIB0001506-RAZORPAY SOFTWARE PR IVATE LIMITED-SLICK ORGANICS PVT LITD-AX ISCN0085453615,insurance,,net_banking_transfer,35346.36
61b70693d8beac1599eb678c,50200023535069,741502.39,60ec41ba55c00300382672d9,HDFC,direct expenses,5eecc6d6449e4f7cfb1c2708,2021-07-20T00:00:00.000Z,POS 514834XXXXXX9486 FEEDBACKFIVE,,,debit_card,-5248.34
61b70694d8beac1599eb679b,50200023535069,742764.63,60ec41ba55c00300382672d9,HDFC,Revenue-Mktplace,5eecc6d6449e4f7cfb1c2708,2021-07-20T00:00:00.000Z,NEFT CR-ICIC0000105-ICICI BANK NODAL AC MANASH LIFESTYL-SLICK ORGANICS PRIVATE L IMITED MP G-ICIJ212010010583,,,net_banking_transfer,1262.24
61b70695d8beac1599eb67a5,50200023535069,743285.8,60ec41ba55c00300382672d9,HDFC,Revenue-Mktplace,5eecc6d6449e4f7cfb1c2708,2021-07-20T00:00:00.000Z,NEFT CR-ICIC0000105-ICICI BANK NODAL AC MANASH LIFESTYL-SLICK ORGANICS PRIVATE L IMITED HYD-ICIJ212010012739,,,net_banking_transfer,521.17
61b70696d8beac1599eb67aa,50200023535069,744630.87,60ec41ba55c00300382672d9,HDFC,Transfer in/Revenue-other,5eecc6d6449e4f7cfb1c2708,2021-07-20T00:00:00.000Z,NEFT CR-ICIC0000105-ICICI BANK NODAL AC,,,net_banking_transfer,1345.07
61b70697d8beac1599eb67b5,50200023535069,744822.92,60ec41ba55c00300382672d9,HDFC,Revenue-Mktplace,5eecc6d6449e4f7cfb1c2708,2021-07-20T00:00:00.000Z,NEFT CR-ICIC0000105-ICICI BANK NODAL AC MANASH LIFESTYL-SLICK ORGANICS PRIVATE L IMITED KOLK-ICIJ212010012737,,,net_banking_transfer,192.05
61b70698d8beac1599eb67b8,50200023535069,747787.9,60ec41ba55c00300382672d9,HDFC,Revenue-Mktplace,5eecc6d6449e4f7cfb1c2708,2021-07-20T00:00:00.000Z,NEFT CR-ICIC0000105-ICICI BANK NODAL AC MANASH LIFESTYL-SLICK ORGANICS PRIVATE L IMITED MP M-ICIJ212010012736,,,net_banking_transfer,2964.98
61b70699d8beac1599eb67bc,50200023535069,766685.9,60ec41ba55c00300382672d9,HDFC,Investments-New,5eecc6d6449e4f7cfb1c2708,2021-07-20T00:00:00.000Z,50200019889031-TPT-ADV-1908 E-VENTURES P RIVATE LIMITED,,,net_banking_transfer,18898
61b7069ad8beac1599eb67c5,50200023535069,772674.13,60ec41ba55c00300382672d9,HDFC,Revenue-PG-non-split,5eecc6d6449e4f7cfb1c2708,2021-07-20T00:00:00.000Z,NEFT CR-IDFB0010204-SEZZLE PAYMENTS PRIV ATE LIMITED-SLICK ORGANICS PRIVATE LIMIT ED-IDFBH21201391867,insurance,,net_banking_transfer,5988.23
61b7069bd8beac1599eb67cf,50200023535069,840991.86,60ec41ba55c00300382672d9,HDFC,Revenue-PG-split enabled,5eecc6d6449e4f7cfb1c2708,2021-07-20T00:00:00.000Z,NEFT CR-UTIB0001506-RAZORPAY SOFTWARE PR IVATE LIMITED-SLICK ORGANICS PVT LITD-AX ISCN0085580203,insurance,,net_banking_transfer,68317.73
61b7069cd8beac1599eb67d4,50200023535069,833567.08,60ec41ba55c00300382672d9,HDFC,direct expenses,5eecc6d6449e4f7cfb1c2708,2021-07-20T00:00:00.000Z,POS 514834XXXXXX9486 HOTJAR,,,debit_card,-7424.78
61b7069dd8beac1599eb67db,50200023535069,931992.4,60ec41ba55c00300382672d9,HDFC,Transfer in/Revenue-other,5eecc6d6449e4f7cfb1c2708,2021-07-21T00:00:00.000Z,IMPS-120205362682-NA-HDFC-XXXXXXXXXX0007 -ALL20210721216820000330830668628,,,net_banking_transfer,98425.32
61b7069ed8beac1599eb67e2,50200023535069,937122.25,60ec41ba55c00300382672d9,HDFC,Revenue-Mktplace,5eecc6d6449e4f7cfb1c2708,2021-07-21T00:00:00.000Z,NEFT CR-DEUT0797BGL-FLIPKART INTERNET PR IVATE LIMITED-SLICK ORGANICS PVT LTD-120 200105GN00134,shopping,,net_banking_transfer,5129.85
61b7069fd8beac1599eb67ed,50200023535069,943117.05,60ec41ba55c00300382672d9,HDFC,Revenue-Mktplace,5eecc6d6449e4f7cfb1c2708,2021-07-21T00:00:00.000Z,NEFT CR-DEUT0797BGL-FLIPKART INTERNET PR IVATE LIMITED-SLICK ORGANICS PVT LTD-120 200129GN00220,shopping,,net_banking_transfer,5994.8
61b706a0d8beac1599eb67f6,50200023535069,946147.22,60ec41ba55c00300382672d9,HDFC,Revenue-Mktplace,5eecc6d6449e4f7cfb1c2708,2021-07-21T00:00:00.000Z,NEFT CR-DEUT0797BGL-MYNTRA DESIGNS PRIVA TE LIMITED-SLICK ORGANICS PRIVATE LIMITE D-120200202GN00153,shopping,,net_banking_transfer,3030.17
61b706a1d8beac1599eb6803,50200023535069,746147.22,60ec41ba55c00300382672d9,HDFC,direct expenses,5eecc6d6449e4f7cfb1c2708,2021-07-21T00:00:00.000Z,"NEFT DR-YESB0000551-VISTTA COSMETICS-NET BANK, MUM-N202211573403857-200000",,,net_banking_transfer,-200000
61b706a2d8beac1599eb680d,50200023535069,546147.22,60ec41ba55c00300382672d9,HDFC,direct expenses,5eecc6d6449e4f7cfb1c2708,2021-07-21T00:00:00.000Z,IMPS-120218138689-VISTTA COSMETICS-YESB- XXXXXXXXXXX1450-200000,,,net_banking_transfer,-200000
61b706a3d8beac1599eb680f,50200023535069,346147.22,60ec41ba55c00300382672d9,HDFC,direct expenses,5eecc6d6449e4f7cfb1c2708,2021-07-21T00:00:00.000Z,05892560000649-TPT-200000-DECORPAC INDIA,,,net_banking_transfer,-200000
61b706a4d8beac1599eb6814,50200023535069,202487.22,60ec41ba55c00300382672d9,HDFC,direct expenses,5eecc6d6449e4f7cfb1c2708,2021-07-21T00:00:00.000Z,05892560000649-TPT-143660-DECORPAC INDIA PRIVATE LIMITED,,,net_banking_transfer,-143660
61b706a5d8beac1599eb6824,50200023535069,237464.47,60ec41ba55c00300382672d9,HDFC,Transfer in/Revenue-other,5eecc6d6449e4f7cfb1c2708,2021-07-22T00:00:00.000Z,IMPS-120305255240-NA-HDFC-XXXXXXXXXX0007 -ALL20210722216820000330830668628,,,net_banking_transfer,34977.25
61b706a6d8beac1599eb6827,50200023535069,295636.99,60ec41ba55c00300382672d9,HDFC,Revenue-PG-split enabled,5eecc6d6449e4f7cfb1c2708,2021-07-22T00:00:00.000Z,NEFT CR-UTIB0001506-RAZORPAY SOFTWARE PR IVATE LIMITED-SLICK ORGANICS PVT LITD-AX ISCN0085648712,insurance,,net_banking_transfer,58172.52
61b706a7d8beac1599eb682b,50200023535069,215636.99,60ec41ba55c00300382672d9,HDFC,direct expenses,5eecc6d6449e4f7cfb1c2708,2021-07-22T00:00:00.000Z,"MC ISSUED - KALKAJI, NEW - 027112175346 - - EMIRATES SHIPPING AGENCIES (INDIA) PVT LTD",,,Other,-80000
61b706a8d8beac1599eb6832,50200023535069,107636.99,60ec41ba55c00300382672d9,HDFC,direct expenses,5eecc6d6449e4f7cfb1c2708,2021-07-22T00:00:00.000Z,"NEFT DR-ICIC0001944-TUNRAROUND CORPORATE ADVISORS PVT LTD-NETBANK, MUM-N20321157 3951604-108000",,,net_banking_transfer,-108000
61b706a9d8beac1599eb6836,50200023535069,168604.31,60ec41ba55c00300382672d9,HDFC,Revenue-COD,5eecc6d6449e4f7cfb1c2708,2021-07-22T00:00:00.000Z,NEFT CR-ICIC0000155-SHIPROCKET COD CRF I D 2758739-SLICK ORGANICS PVT LTD-CMS2037 739867,insurance,,net_banking_transfer,60967.32
61b706aad8beac1599eb683d,50200023535069,118604.31,60ec41ba55c00300382672d9,HDFC,Marketing Expense,5eecc6d6449e4f7cfb1c2708,2021-07-22T00:00:00.000Z,POS 514834XXXXXX9486 GOOGLE ADS,,,debit_card,-50000
61b706abd8beac1599eb6848,50200023535069,122038.46,60ec41ba55c00300382672d9,HDFC,Revenue-PG-non-split,5eecc6d6449e4f7cfb1c2708,2021-07-22T00:00:00.000Z,NEFT CR-SCBL0036001-STRIPE INDIA PRIVATE -SLICK ORGANICS PRIVATE LIMITED-SSG17413 Q0328505,insurance,,net_banking_transfer,3434.15
61b706acd8beac1599eb685a,50200023535069,132773.32,60ec41ba55c00300382672d9,HDFC,Revenue-PG-split enabled,5eecc6d6449e4f7cfb1c2708,2021-07-22T00:00:00.000Z,NEFT CR-UTIB0001506-RAZORPAY SOFTWARE PR IVATE LIMITED-SLICK ORGANICS PVT LITD-AX ISCN0085746220,insurance,,net_banking_transfer,10734.86
61b706add8beac1599eb685d,50200023535069,149735.32,60ec41ba55c00300382672d9,HDFC,Transfer in/Revenue-other,5eecc6d6449e4f7cfb1c2708,2021-07-23T00:00:00.000Z,IMPS-120405109201-NA-HDFC-XXXXXXXXXX0007 -ALL20210723216820000330830668628,,,net_banking_transfer,16962
61b706aed8beac1599eb6861,50200023535069,155101.06,60ec41ba55c00300382672d9,HDFC,Revenue-PG-split enabled,5eecc6d6449e4f7cfb1c2708,2021-07-23T00:00:00.000Z,NEFT CR-UTIB0001506-RAZORPAY SOFTWARE PR IVATE LIMITED-SLICK ORGANICS PVT LITD-AX ISCN0085781668,insurance,,net_banking_transfer,5365.74
61b706afd8beac1599eb686d,50200023535069,165028.29,60ec41ba55c00300382672d9,HDFC,Revenue-Mktplace,5eecc6d6449e4f7cfb1c2708,2021-07-23T00:00:00.000Z,NEFT CR-DEUT0797BGL-MYNTRA DESIGNS PRIVA TE LIMITED-SLICK ORGANICS PRIVATE LIMITE D-120400385GN00125,shopping,,net_banking_transfer,9927.23
61b706b0d8beac1599eb6870,50200023535069,170317.68,60ec41ba55c00300382672d9,HDFC,Revenue-Mktplace,5eecc6d6449e4f7cfb1c2708,2021-07-23T00:00:00.000Z,NEFT CR-DEUT0797BGL-FLIPKART INTERNET PR,shopping,,net_banking_transfer,5289.39
61b706b1d8beac1599eb6874,50200023535069,179192.72,60ec41ba55c00300382672d9,HDFC,Revenue-Mktplace,5eecc6d6449e4f7cfb1c2708,2021-07-23T00:00:00.000Z,NEFT CR-DEUT0797BGL-FLIPKART INTERNET PR IVATE LIMITED-SLICK ORGANICS PVT LTD-120 400510GN00041,shopping,,net_banking_transfer,8875.04
61b706b2d8beac1599eb687f,50200023535069,179538.47,60ec41ba55c00300382672d9,HDFC,Revenue-Mktplace,5eecc6d6449e4f7cfb1c2708,2021-07-23T00:00:00.000Z,NEFT CR-DEUT0784BBY-TATA UNISTORE LIMITE D-SLICK ORGANICS PVT LTD-120400899GN0011 9,insurance,,net_banking_transfer,345.75
61b706b2d8beac1599eb688c,50200023535069,180722.05,60ec41ba55c00300382672d9,HDFC,Revenue-Mktplace,5eecc6d6449e4f7cfb1c2708,2021-07-23T00:00:00.000Z,NEFT CR-DEUT0784BBY-TATA UNISTORE LTD-NO DAL-SLICK ORGANICS PVT LTD-120400922GN00 134,insurance,,net_banking_transfer,1183.58
61b706b3d8beac1599eb6895,50200023535069,183472.1,60ec41ba55c00300382672d9,HDFC,Revenue-Mktplace,5eecc6d6449e4f7cfb1c2708,2021-07-23T00:00:00.000Z,NEFT CR-DEUT0784BBY-TATA UNISTORE LTD-NO DAL-SLICK ORGANICS PVT LTD-120400918GN00 176,insurance,,net_banking_transfer,2750.05
61b706b4d8beac1599eb6899,50200023535069,184881.91,60ec41ba55c00300382672d9,HDFC,Transfer in/Revenue-other,5eecc6d6449e4f7cfb1c2708,2021-07-23T00:00:00.000Z,NEFT CR-YESB0000001-ILUMINAR MEDIA-SLICK ORGANICS-N204210676867542,,,net_banking_transfer,1409.81
61b706b5d8beac1599eb68a6,50200023535069,185484.45,60ec41ba55c00300382672d9,HDFC,Revenue-Mktplace,5eecc6d6449e4f7cfb1c2708,2021-07-23T00:00:00.000Z,NEFT CR-ICIC0000105-ICICI BANK NODAL AC MANASH LIFESTYL-SLICK ORGANICS PRIVATE L IMITED BANG-ICIJ212040004182,,,net_banking_transfer,602.54
61b706b6d8beac1599eb68d6,50200023535069,185758.59,60ec41ba55c00300382672d9,HDFC,Revenue-Mktplace,5eecc6d6449e4f7cfb1c2708,2021-07-23T00:00:00.000Z,NEFT CR-ICIC0000105-ICICI BANK NODAL AC MANASH LIFESTYL-SLICK ORGANICS PRIVATE L IMITED MP M-ICIJ212040004177,,,net_banking_transfer,274.14
61b706b7d8beac1599eb68f0,50200023535069,186333.99,60ec41ba55c00300382672d9,HDFC,Revenue-Mktplace,5eecc6d6449e4f7cfb1c2708,2021-07-23T00:00:00.000Z,NEFT CR-ICIC0000105-ICICI BANK NODAL AC MANASH LIFESTYL-SLICK ORGANICS PRIVATE L IMITED MP G-ICIJ212040004175,,,net_banking_transfer,575.4
61b706b8d8beac1599eb68f6,50200023535069,188914.9,60ec41ba55c00300382672d9,HDFC,Revenue-Mktplace,5eecc6d6449e4f7cfb1c2708,2021-07-23T00:00:00.000Z,NEFT CR-ICIC0000105-ICICI BANK NODAL AC MANASH LIFESTYL-SLICK ORGANICS PRIVATE L IMITED KOLK-ICIJ212040004178,,,net_banking_transfer,2580.91
61b706b9d8beac1599eb68fd,50200023535069,189298.27,60ec41ba55c00300382672d9,HDFC,Revenue-Mktplace,5eecc6d6449e4f7cfb1c2708,2021-07-23T00:00:00.000Z,NEFT CR-ICIC0000105-ICICI BANK NODAL AC MANASH LIFESTYL-SLICK ORGANICS PRIVATE L IMITED HYD-ICIJ212040004180,,,net_banking_transfer,383.37
61b706bad8beac1599eb6901,50200023535069,190495.93,60ec41ba55c00300382672d9,HDFC,Transfer in/Revenue-other,5eecc6d6449e4f7cfb1c2708,2021-07-23T00:00:00.000Z,NEFT CR-ICIC0SF0002-ICICI BANK NODAL A-C,,,net_banking_transfer,1197.66
61b706bbd8beac1599eb6905,50200023535069,249125.93,60ec41ba55c00300382672d9,HDFC,Revenue-Mktplace,5eecc6d6449e4f7cfb1c2708,2021-07-23T00:00:00.000Z,NEFT CR-SCBL0036001-M/S DREAMPLUG TECHNO -SLICK ORGANICS PRIVATE LIMITEDSLICK-SIN 31436Q0017075,insurance,,net_banking_transfer,58630
61b706bcd8beac1599eb690b,50200023535069,259362.11,60ec41ba55c00300382672d9,HDFC,Revenue-PG-non-split,5eecc6d6449e4f7cfb1c2708,2021-07-23T00:00:00.000Z,NEFT CR-IDFB0010204-SEZZLE PAYMENTS PRIV ATE LIMITED-SLICK ORGANICS PRIVATE LIMIT ED-IDFBH21204538566,insurance,,net_banking_transfer,10236.18
61b706bdd8beac1599eb6932,50200023535069,271370.03,60ec41ba55c00300382672d9,HDFC,Revenue-PG-split enabled,5eecc6d6449e4f7cfb1c2708,2021-07-23T00:00:00.000Z,NEFT CR-UTIB0001506-RAZORPAY SOFTWARE PR IVATE LIMITED-SLICK ORGANICS PVT LITD-AX ISCN0085869082,insurance,,net_banking_transfer,12007.92
61b706bed8beac1599eb696d,50200023535069,272500.39,60ec41ba55c00300382672d9,HDFC,Transfer in/Revenue-other,5eecc6d6449e4f7cfb1c2708,2021-07-23T00:00:00.000Z,4060002843-23 07 2021-HDFAZCUR1,,,Other,1130.36
61b706bfd8beac1599eb69d7,50200023535069,306928.39,60ec41ba55c00300382672d9,HDFC,Revenue-Mktplace,5eecc6d6449e4f7cfb1c2708,2021-07-23T00:00:00.000Z,NEFT CR-ICIC0SF0002-THREPSI SOLUTIONS PV -SLICK ORGANICS PRIVATE LIMITED-24605480 591DC,insurance,,net_banking_transfer,34428
61b706c0d8beac1599eb69e2,50200023535069,341523.05,60ec41ba55c00300382672d9,HDFC,Transfer in/Revenue-other,5eecc6d6449e4f7cfb1c2708,2021-07-24T00:00:00.000Z,IMPS-120505021455-NA-HDFC-XXXXXXXXXX0007 -ALL20210724216820000330830668628,,,net_banking_transfer,34594.66
61b706c1d8beac1599eb69e5,50200023535069,86523.05,60ec41ba55c00300382672d9,HDFC,SAAS/tech expense,5eecc6d6449e4f7cfb1c2708,2021-07-24T00:00:00.000Z,WHDF0137010929/BILLDKAMAZONSELLERSE,shopping,,Other,-255000
61b706c2d8beac1599eb69ea,50200023535069,119214.68,60ec41ba55c00300382672d9,HDFC,Transfer in/Revenue-other,5eecc6d6449e4f7cfb1c2708,2021-07-25T00:00:00.000Z,IMPS-120606175393-NA-HDFC-XXXXXXXXXX0007 -ALL20210725216820000330830668628,,,net_banking_transfer,32691.63
61b706c3d8beac1599eb69f5,50200023535069,1119214.68,60ec41ba55c00300382672d9,HDFC,Internal Transfers,5eecc6d6449e4f7cfb1c2708,2021-07-25T00:00:00.000Z,IB FUNDS TRANSFER CR-50200035187206 -SL ICK ORGANICS PVT LTD,insurance,,Other,1000000
61b706c4d8beac1599eb69f9,50200023535069,1069214.68,60ec41ba55c00300382672d9,HDFC,Marketing Expense,5eecc6d6449e4f7cfb1c2708,2021-07-25T00:00:00.000Z,POS 514834XXXXXX9486 GOOGLE ADS,,,debit_card,-50000
61b706c5d8beac1599eb69fc,50200023535069,819214.68,60ec41ba55c00300382672d9,HDFC,SAAS/tech expense,5eecc6d6449e4f7cfb1c2708,2021-07-25T00:00:00.000Z,WHDF0139972724/BILLDKAMAZONSELLERSE,shopping,,Other,-250000
61b706c6d8beac1599eb6a03,50200023535069,837983.54,60ec41ba55c00300382672d9,HDFC,Transfer in/Revenue-other,5eecc6d6449e4f7cfb1c2708,2021-07-26T00:00:00.000Z,IMPS-120705949500-NA-HDFC-XXXXXXXXXX0007 -ALL20210726216820000330830668628,,,net_banking_transfer,18768.86
61b706c7d8beac1599eb6a07,50200023535069,845737.54,60ec41ba55c00300382672d9,HDFC,Transfer in/Revenue-other,5eecc6d6449e4f7cfb1c2708,2021-07-26T00:00:00.000Z,NEFT CR-KKBK0000958-EKANEK NETWORKS PRIV ATE LIMITED-SLICK ORGANICS PVT LTD-KKBK2 12072783561,,,net_banking_transfer,7754
61b706c8d8beac1599eb6a0f,50200023535069,853458.44,60ec41ba55c00300382672d9,HDFC,Revenue-Mktplace,5eecc6d6449e4f7cfb1c2708,2021-07-26T00:00:00.000Z,NEFT CR-DEUT0797BGL-FLIPKART INTERNET PR IVATE LIMITED-SLICK ORGANICS PVT LTD-120 700116GN00029,shopping,,net_banking_transfer,7720.9
61b706c9d8beac1599eb6a15,50200023535069,877399.06,60ec41ba55c00300382672d9,HDFC,Revenue-Mktplace,5eecc6d6449e4f7cfb1c2708,2021-07-26T00:00:00.000Z,NEFT CR-DEUT0797BGL-MYNTRA DESIGNS PRIVA,shopping,,net_banking_transfer,23940.62
61b706cad8beac1599eb6a1a,50200023535069,883606.29,60ec41ba55c00300382672d9,HDFC,Revenue-Mktplace,5eecc6d6449e4f7cfb1c2708,2021-07-26T00:00:00.000Z,NEFT CR-DEUT0797BGL-FLIPKART INTERNET PR IVATE LIMITED-SLICK ORGANICS PVT LTD-120 700234GN00123,shopping,,net_banking_transfer,6207.23
61b706cbd8beac1599eb6a1d,50200023535069,984798.07,60ec41ba55c00300382672d9,HDFC,Revenue-PG-split enabled,5eecc6d6449e4f7cfb1c2708,2021-07-26T00:00:00.000Z,NEFT CR-UTIB0001506-RAZORPAY SOFTWARE PR IVATE LIMITED-SLICK ORGANICS PVT LITD-AX ISCN0085927940,insurance,,net_banking_transfer,101191.78
61b706ccd8beac1599eb6a20,50200023535069,985166.78,60ec41ba55c00300382672d9,HDFC,Revenue-Mktplace,5eecc6d6449e4f7cfb1c2708,2021-07-26T00:00:00.000Z,4060002811-TIMES INTERNET LIMITED NODAL,,,Other,368.71
61b706cdd8beac1599eb6a2a,50200023535069,885166.78,60ec41ba55c00300382672d9,HDFC,direct expenses,5eecc6d6449e4f7cfb1c2708,2021-07-26T00:00:00.000Z,IMPS-120714130959-PAYTM-PYTM-XXXXXXXX383 9-100000,ewallet,,net_banking_transfer,-100000
61b706ced8beac1599eb6a30,50200023535069,885495.91,60ec41ba55c00300382672d9,HDFC,Revenue-Mktplace,5eecc6d6449e4f7cfb1c2708,2021-07-26T00:00:00.000Z,NEFT CR-ICIC0000105-ICICI BANK NODAL AC MANASH LIFESTYL-SLICK ORGANICS PRIVATE L IMITED BANG-ICIJ212070005024,,,net_banking_transfer,329.13
61b706cfd8beac1599eb6a75,50200023535069,886621.81,60ec41ba55c00300382672d9,HDFC,Revenue-Mktplace,5eecc6d6449e4f7cfb1c2708,2021-07-26T00:00:00.000Z,NEFT CR-ICIC0000105-ICICI BANK NODAL AC MANASH LIFESTYL-SLICK ORGANICS PRIVATE L IMITED MP G-ICIJ212070005022,,,net_banking_transfer,1125.9
61b706cfd8beac1599eb6ab6,50200023535069,886813.86,60ec41ba55c00300382672d9,HDFC,Revenue-Mktplace,5eecc6d6449e4f7cfb1c2708,2021-07-26T00:00:00.000Z,NEFT CR-ICIC0000105-ICICI BANK NODAL AC MANASH LIFESTYL-SLICK ORGANICS PRIVATE L IMITED KOLK-ICIJ212070002605,,,net_banking_transfer,192.05
61b706d0d8beac1599eb6aba,50200023535069,896685.15,60ec41ba55c00300382672d9,HDFC,Revenue-PG-split enabled,5eecc6d6449e4f7cfb1c2708,2021-07-26T00:00:00.000Z,NEFT CR-UTIB0001506-RAZORPAY SOFTWARE PR IVATE LIMITED-SLICK ORGANICS PVT LITD-AX ISCN0086041365,insurance,,net_banking_transfer,9871.29
61b706d1d8beac1599eb6ac3,50200023535069,912449.46,60ec41ba55c00300382672d9,HDFC,Transfer in/Revenue-other,5eecc6d6449e4f7cfb1c2708,2021-07-27T00:00:00.000Z,IMPS-120805024080-NA-HDFC-XXXXXXXXXX0007 -ALL20210727216820000330830668628,,,net_banking_transfer,15764.31
61b706d2d8beac1599eb6ac5,50200023535069,1064689.01,60ec41ba55c00300382672d9,HDFC,Revenue-Mktplace,5eecc6d6449e4f7cfb1c2708,2021-07-27T00:00:00.000Z,IMPS-120805305571-AMAZON SELLER SERVIC-H DFC-XXXXXXXX6004-6K87ZNHWA5NHWUAZSLICK O RGANICS PVT LTD,shopping,,net_banking_transfer,152239.55
61b706d3d8beac1599eb6acc,50200023535069,1492194.15,60ec41ba55c00300382672d9,HDFC,Revenue-Mktplace,5eecc6d6449e4f7cfb1c2708,2021-07-27T00:00:00.000Z,NEFT CR-DEUT0797BGL-AMAZON PAY (INDIA) P,shopping,,net_banking_transfer,427505.14
61b706d4d8beac1599eb6ad0,50200023535069,1505906.7,60ec41ba55c00300382672d9,HDFC,Revenue-PG-split enabled,5eecc6d6449e4f7cfb1c2708,2021-07-27T00:00:00.000Z,NEFT CR-UTIB0001506-RAZORPAY SOFTWARE PR IVATE LIMITED-SLICK ORGANICS PVT LITD-AX ISCN0086080457,insurance,,net_banking_transfer,13712.55
61b706d5d8beac1599eb6ad4,50200023535069,1508221.07,60ec41ba55c00300382672d9,HDFC,Revenue-Mktplace,5eecc6d6449e4f7cfb1c2708,2021-07-27T00:00:00.000Z,NEFT CR-DEUT0797BGL-MYNTRA DESIGNS PRIVA TE LIMITED-SLICK ORGANICS PRIVATE LIMITE D-120800079GN00140,shopping,,net_banking_transfer,2314.37
61b706d6d8beac1599eb6ada,50200023535069,1508070.11,60ec41ba55c00300382672d9,HDFC,bank charges,5eecc6d6449e4f7cfb1c2708,2021-07-27T00:00:00.000Z,.DC INTL POS TXN MARKUP+ST 120721 140721 -CDT2119104860993,,,international_transaction_arbitrage,-150.96
61b706d7d8beac1599eb6b01,50200023535069,1510539.59,60ec41ba55c00300382672d9,HDFC,Revenue-Mktplace,5eecc6d6449e4f7cfb1c2708,2021-07-27T00:00:00.000Z,NEFT CR-ICIC0000105-ICICI BANK NODAL AC MANASH LIFESTYL-SLICK ORGANICS PRIVATE L IMITED MP M-ICIJ212080002948,,,net_banking_transfer,2469.48
61b706d8d8beac1599eb6b05,50200023535069,1511883.91,60ec41ba55c00300382672d9,HDFC,Revenue-Mktplace,5eecc6d6449e4f7cfb1c2708,2021-07-27T00:00:00.000Z,NEFT CR-ICIC0000105-ICICI BANK NODAL AC MANASH LIFESTYL-SLICK ORGANICS PRIVATE L IMITED MP G-ICIJ212080002946,,,net_banking_transfer,1344.32
61b706d9d8beac1599eb6b08,50200023535069,1512644.16,60ec41ba55c00300382672d9,HDFC,Revenue-PG-non-split,5eecc6d6449e4f7cfb1c2708,2021-07-27T00:00:00.000Z,NEFT CR-IDFB0010204-SEZZLE PAYMENTS PRIV ATE LIMITED-SLICK ORGANICS PRIVATE LIMIT ED-IDFBH21208733855,insurance,,net_banking_transfer,760.25
61b706dad8beac1599eb6b0d,50200023535069,1513982.58,60ec41ba55c00300382672d9,HDFC,Revenue-PG-non-split,5eecc6d6449e4f7cfb1c2708,2021-07-27T00:00:00.000Z,NEFT CR-IDFB0010204-SEZZLE PAYMENTS PRIV ATE LIMITED-SLICK ORGANICS PRIVATE LIMIT ED-IDFBH21208733909,insurance,,net_banking_transfer,1338.42
61b706dbd8beac1599eb6b12,50200023535069,1521615.79,60ec41ba55c00300382672d9,HDFC,Revenue-PG-split enabled,5eecc6d6449e4f7cfb1c2708,2021-07-27T00:00:00.000Z,NEFT CR-UTIB0001506-RAZORPAY SOFTWARE PR IVATE LIMITED-SLICK ORGANICS PVT LITD-AX ISCN0086198098,insurance,,net_banking_transfer,7633.21
61b706dcd8beac1599eb6b19,50200023535069,1544536.2,60ec41ba55c00300382672d9,HDFC,Transfer in/Revenue-other,5eecc6d6449e4f7cfb1c2708,2021-07-28T00:00:00.000Z,IMPS-120905021795-NA-HDFC-XXXXXXXXXX0007 -ALL20210728216820000330830668628,,,net_banking_transfer,22920.41
61b706ddd8beac1599eb6b1f,50200023535069,1550297.66,60ec41ba55c00300382672d9,HDFC,Revenue-Mktplace,5eecc6d6449e4f7cfb1c2708,2021-07-28T00:00:00.000Z,NEFT CR-DEUT0797BGL-FLIPKART INTERNET PR IVATE LIMITED-SLICK ORGANICS PVT LTD-120 900071GN00272,shopping,,net_banking_transfer,5761.46
61b706ded8beac1599eb6b23,50200023535069,1554121.5,60ec41ba55c00300382672d9,HDFC,Revenue-Mktplace,5eecc6d6449e4f7cfb1c2708,2021-07-28T00:00:00.000Z,NEFT CR-DEUT0797BGL-FLIPKART INTERNET PR IVATE LIMITED-SLICK ORGANICS PVT LTD-120 900107GN00200,shopping,,net_banking_transfer,3823.84
61b706dfd8beac1599eb6b26,50200023535069,1560880.11,60ec41ba55c00300382672d9,HDFC,Revenue-Mktplace,5eecc6d6449e4f7cfb1c2708,2021-07-28T00:00:00.000Z,NEFT CR-DEUT0797BGL-MYNTRA DESIGNS PRIVA,shopping,,net_banking_transfer,6758.61
61b706e0d8beac1599eb6b36,50200023535069,1574110.53,60ec41ba55c00300382672d9,HDFC,Revenue-PG-split enabled,5eecc6d6449e4f7cfb1c2708,2021-07-28T00:00:00.000Z,NEFT CR-UTIB0001506-RAZORPAY SOFTWARE PR IVATE LIMITED-SLICK ORGANICS PVT LITD-AX ISCN0086251062,insurance,,net_banking_transfer,13230.42
61b706e1d8beac1599eb6b41,50200023535069,574110.53,60ec41ba55c00300382672d9,HDFC,Marketing Expense,5eecc6d6449e4f7cfb1c2708,2021-07-28T00:00:00.000Z,"NEFT DR-CITI0000006-FACEBOOK INDIA ONLIN E SERVICES PVT LTD-NETBANK, MUM-N2092115 79240685-1000000",,,net_banking_transfer,-1000000
61b706e2d8beac1599eb6b5d,50200023535069,573893.78,60ec41ba55c00300382672d9,HDFC,bank charges,5eecc6d6449e4f7cfb1c2708,2021-07-28T00:00:00.000Z,.DC INTL POS TXN MARKUP+ST 190721 210721 -CDT2119104860993,,,international_transaction_arbitrage,-216.75
61b706e3d8beac1599eb6b62,50200023535069,573587.13,60ec41ba55c00300382672d9,HDFC,bank charges,5eecc6d6449e4f7cfb1c2708,2021-07-28T00:00:00.000Z,.DC INTL POS TXN MARKUP+ST 200721 220721 -CDT2119104860993,,,international_transaction_arbitrage,-306.65
61b706e4d8beac1599eb6b68,50200023535069,2073587.13,60ec41ba55c00300382672d9,HDFC,Internal Transfers,5eecc6d6449e4f7cfb1c2708,2021-07-28T00:00:00.000Z,IB FUNDS TRANSFER CR-50200035187206 -SL ICK ORGANICS PVT LTD,insurance,,Other,1500000
61b706e5d8beac1599eb6b71,50200023535069,2023587.13,60ec41ba55c00300382672d9,HDFC,Marketing Expense,5eecc6d6449e4f7cfb1c2708,2021-07-28T00:00:00.000Z,POS 514834XXXXXX9486 GOOGLE ADS,,,debit_card,-50000
61b706e6d8beac1599eb6b79,50200023535069,525283.13,60ec41ba55c00300382672d9,HDFC,Marketing Expense,5eecc6d6449e4f7cfb1c2708,2021-07-28T00:00:00.000Z,"NEFT DR-CITI0000006-FACEBOOK INDIA ONLIN E SERVICES PVT LTD-NETBANK, MUM-N2092115 79502367-1498304",,,net_banking_transfer,-1498304
61b706e7d8beac1599eb6b7e,50200023535069,528614.67,60ec41ba55c00300382672d9,HDFC,Revenue-PG-non-split,5eecc6d6449e4f7cfb1c2708,2021-07-28T00:00:00.000Z,NEFT CR-SCBL0036001-STRIPE INDIA PRIVATE -SLICK ORGANICS PRIVATE LIMITED-SSG17413 Q0334183,insurance,,net_banking_transfer,3331.54
61b706e8d8beac1599eb6b8a,50200023535069,548998.67,60ec41ba55c00300382672d9,HDFC,Revenue-COD,5eecc6d6449e4f7cfb1c2708,2021-07-28T00:00:00.000Z,NEFT CR-ICIC0000155-SHIPROCKET COD CRF I D 2791464-SLICK ORGANICS PVT LTD-CMS2045 990467,insurance,,net_banking_transfer,20384
61b706e9d8beac1599eb6b8c,50200023535069,558998.67,60ec41ba55c00300382672d9,HDFC,Transfer in/Revenue-other,5eecc6d6449e4f7cfb1c2708,2021-07-28T00:00:00.000Z,NEFT CR-UTIB0003683-ALPHACMA PRIVATE LIM ITED-SLICK ORGANICS PVT LTD-AXIC21209502 1379,,,net_banking_transfer,10000
61b706ead8beac1599eb6b90,50200023535069,560414.85,60ec41ba55c00300382672d9,HDFC,Revenue-Mktplace,5eecc6d6449e4f7cfb1c2708,2021-07-28T00:00:00.000Z,NEFT CR-ICIC0000105-ICICI BANK NODAL AC MANASH LIFESTYL-SLICK ORGANICS PRIVATE L IMITED MP M-ICIJ212090004656,,,net_banking_transfer,1416.18
61b706ebd8beac1599eb6b9b,50200023535069,560551.93,60ec41ba55c00300382672d9,HDFC,Transfer in/Revenue-other,5eecc6d6449e4f7cfb1c2708,2021-07-28T00:00:00.000Z,NEFT CR-ICIC0000105-ICICI BANK NODAL AC,,,net_banking_transfer,137.08
61b706ecd8beac1599eb6ba0,50200023535069,561773.35,60ec41ba55c00300382672d9,HDFC,Revenue-PG-non-split,5eecc6d6449e4f7cfb1c2708,2021-07-28T00:00:00.000Z,NEFT CR-IDFB0010204-SEZZLE PAYMENTS PRIV ATE LIMITED-SLICK ORGANICS PRIVATE LIMIT ED-IDFBH21209790953,insurance,,net_banking_transfer,1221.42
61b706ecd8beac1599eb6ba4,50200023535069,572123.28,60ec41ba55c00300382672d9,HDFC,Revenue-PG-split enabled,5eecc6d6449e4f7cfb1c2708,2021-07-28T00:00:00.000Z,NEFT CR-UTIB0001506-RAZORPAY SOFTWARE PR IVATE LIMITED-SLICK ORGANICS PVT LITD-AX ISCN0086366127,insurance,,net_banking_transfer,10349.93
61b706edd8beac1599eb6ba9,50200023535069,1606997.31,60ec41ba55c00300382672d9,HDFC,Revenue-Mktplace,5eecc6d6449e4f7cfb1c2708,2021-07-28T00:00:00.000Z,NEFT CR-KKBK0000958-NYKAA E RETAIL PRIVA TE LIMITED NYKAA-SLICK ORGANICS PVT LTD- KKBK212093561342,insurance,,net_banking_transfer,1034874.03
61b706eed8beac1599eb6bac,50200023535069,1675854.31,60ec41ba55c00300382672d9,HDFC,Revenue-Mktplace,5eecc6d6449e4f7cfb1c2708,2021-07-28T00:00:00.000Z,NEFT CR-ICIC0SF0002-THREPSI SOLUTIONS PV -SLICK ORGANICS PVT LTD-24634758261DC,insurance,,net_banking_transfer,68857
61b706efd8beac1599eb6bb5,50200023535069,2071581.47,60ec41ba55c00300382672d9,HDFC,Transfer in/Revenue-other,5eecc6d6449e4f7cfb1c2708,2021-07-28T00:00:00.000Z,NEFT CR-HSBC0110005-HANDS ON TRADES PRIV ATE LIMITED-SLICK ORGANICS PRIVATE LIMIT ED-HSBCN21209284121,,,net_banking_transfer,395727.16
61b706f0d8beac1599eb6bb7,50200023535069,2087899.14,60ec41ba55c00300382672d9,HDFC,Transfer in/Revenue-other,5eecc6d6449e4f7cfb1c2708,2021-07-29T00:00:00.000Z,IMPS-121005928464-NA-HDFC-XXXXXXXXXX0007 -ALL20210729216820000330830668628,,,net_banking_transfer,16317.67
61b706f1d8beac1599eb6bbe,50200023535069,2098659.95,60ec41ba55c00300382672d9,HDFC,Revenue-PG-split enabled,5eecc6d6449e4f7cfb1c2708,2021-07-29T00:00:00.000Z,NEFT CR-UTIB0001506-RAZORPAY SOFTWARE PR IVATE LIMITED-SLICK ORGANICS PVT LITD-AX ISCN0086408094,insurance,,net_banking_transfer,10760.81
61b706f2d8beac1599eb6bc2,50200023535069,2097367.95,60ec41ba55c00300382672d9,HDFC,direct expenses,5eecc6d6449e4f7cfb1c2708,2021-07-29T00:00:00.000Z,"NEFT DR-ICIC0000021-AKHILESH DIXIT-NETBA NK, MUM-N210211580488520-1292",,,net_banking_transfer,-1292
61b706f3d8beac1599eb6bcf,50200023535069,2100269.46,60ec41ba55c00300382672d9,HDFC,Revenue-PG-non-split,5eecc6d6449e4f7cfb1c2708,2021-07-29T00:00:00.000Z,NEFT CR-SCBL0036001-STRIPE INDIA PRIVATE -SLICK ORGANICS PRIVATE LIMITED-SSG17413 Q0336129,insurance,,net_banking_transfer,2901.51
61b706f4d8beac1599eb6bd7,50200023535069,2124382.61,60ec41ba55c00300382672d9,HDFC,Revenue-PG-split enabled,5eecc6d6449e4f7cfb1c2708,2021-07-29T00:00:00.000Z,NEFT CR-UTIB0001506-RAZORPAY SOFTWARE PR IVATE LIMITED-SLICK ORGANICS PVT LITD-AX ISCN0086593818,insurance,,net_banking_transfer,24113.15
61b706f5d8beac1599eb6be1,50200023535069,2124904.36,60ec41ba55c00300382672d9,HDFC,Revenue-PG-non-split,5eecc6d6449e4f7cfb1c2708,2021-07-29T00:00:00.000Z,NEFT CR-IDFB0010204-SEZZLE PAYMENTS PRIV ATE LIMITED-SLICK ORGANICS PRIVATE LIMIT ED-IDFBH21210860297,insurance,,net_banking_transfer,521.75
61b706f6d8beac1599eb6be5,50200023535069,2186239.05,60ec41ba55c00300382672d9,HDFC,Transfer in/Revenue-other,5eecc6d6449e4f7cfb1c2708,2021-07-30T00:00:00.000Z,IMPS-121105788004-NA-HDFC-XXXXXXXXXX0007,,,net_banking_transfer,61334.69
61b706f7d8beac1599eb6be8,50200023535069,2214473.71,60ec41ba55c00300382672d9,HDFC,Revenue-PG-split enabled,5eecc6d6449e4f7cfb1c2708,2021-07-30T00:00:00.000Z,NEFT CR-UTIB0001506-RAZORPAY SOFTWARE PR IVATE LIMITED-SLICK ORGANICS PVT LITD-AX ISCN0086624337,insurance,,net_banking_transfer,28234.66
61b706f8d8beac1599eb6bef,50200023535069,2223306.64,60ec41ba55c00300382672d9,HDFC,Revenue-Mktplace,5eecc6d6449e4f7cfb1c2708,2021-07-30T00:00:00.000Z,NEFT CR-DEUT0797BGL-FLIPKART INTERNET PR IVATE LIMITED-SLICK ORGANICS PVT LTD-121 100102GN00288,shopping,,net_banking_transfer,8832.93
61b706f9d8beac1599eb6bf6,50200023535069,1573306.64,60ec41ba55c00300382672d9,HDFC,direct expenses,5eecc6d6449e4f7cfb1c2708,2021-07-30T00:00:00.000Z,"NEFT DR-PYTM0123456-PAYTM-NETBANK, MUM-N 211211581790669-650000",ewallet,,net_banking_transfer,-650000
61b706fad8beac1599eb6c06,50200023535069,1601779.81,60ec41ba55c00300382672d9,HDFC,Revenue-COD,5eecc6d6449e4f7cfb1c2708,2021-07-30T00:00:00.000Z,NEFT CR-ICIC0000155-SHIPROCKET COD CRF I D 2803702-SLICK ORGANICS PVT LTD-CMS2049 793818,insurance,,net_banking_transfer,28473.17
61b706fbd8beac1599eb6c0c,50200023535069,1608777.61,60ec41ba55c00300382672d9,HDFC,Revenue-Mktplace,5eecc6d6449e4f7cfb1c2708,2021-07-30T00:00:00.000Z,NEFT CR-DEUT0797BGL-FLIPKART INTERNET PR IVATE LIMITED-SLICK ORGANICS PVT LTD-121 100074GN00145,shopping,,net_banking_transfer,6997.8
61b706fcd8beac1599eb6c10,50200023535069,1609641.74,60ec41ba55c00300382672d9,HDFC,Revenue-PG-non-split,5eecc6d6449e4f7cfb1c2708,2021-07-30T00:00:00.000Z,NEFT CR-IDFB0010204-SEZZLE PAYMENTS PRIV ATE LIMITED-SLICK ORGANICS PRIVATE LIMIT ED-IDFBH21211926016,insurance,,net_banking_transfer,864.13
61b706fdd8beac1599eb6c12,50200023535069,1609780.38,60ec41ba55c00300382672d9,HDFC,Revenue-Mktplace,5eecc6d6449e4f7cfb1c2708,2021-07-30T00:00:00.000Z,NEFT CR-DEUT0784BBY-TATA UNISTORE LIMITE D-SLICK ORGANICS PVT LTD-121102464GN0012 1,insurance,,net_banking_transfer,138.64
61b706fed8beac1599eb6c18,50200023535069,1611784.6,60ec41ba55c00300382672d9,HDFC,Revenue-Mktplace,5eecc6d6449e4f7cfb1c2708,2021-07-30T00:00:00.000Z,NEFT CR-DEUT0784BBY-TATA UNISTORE LTD-NO DAL-SLICK ORGANICS PVT LTD-121102472GN00 178,insurance,,net_banking_transfer,2004.22
61b706ffd8beac1599eb6c2c,50200023535069,1612862.29,60ec41ba55c00300382672d9,HDFC,Transfer in/Revenue-other,5eecc6d6449e4f7cfb1c2708,2021-07-30T00:00:00.000Z,NEFT CR-YESB0000001-ILUMINAR MEDIA-SLICK ORGANICS-N211210686275817,,,net_banking_transfer,1077.69
61b70700d8beac1599eb6c34,50200023535069,1620723.57,60ec41ba55c00300382672d9,HDFC,Revenue-PG-split enabled,5eecc6d6449e4f7cfb1c2708,2021-07-30T00:00:00.000Z,NEFT CR-UTIB0001506-RAZORPAY SOFTWARE PR IVATE LIMITED-SLICK ORGANICS PVT LITD-AX ISCN0086716911,insurance,,net_banking_transfer,7861.28
61b70701d8beac1599eb6c3b,50200023535069,1645333.15,60ec41ba55c00300382672d9,HDFC,Transfer in/Revenue-other,5eecc6d6449e4f7cfb1c2708,2021-07-31T00:00:00.000Z,IMPS-121205697098-NA-HDFC-XXXXXXXXXX0007 -ALL20210731216820000330830668628,,,net_banking_transfer,24609.58
61b70702d8beac1599eb6c42,50200023535069,1653167.75,60ec41ba55c00300382672d9,HDFC,Revenue-PG-split enabled,5eecc6d6449e4f7cfb1c2708,2021-07-31T00:00:00.000Z,NEFT CR-UTIB0001506-RAZORPAY SOFTWARE PR,,,net_banking_transfer,7834.6
61b70703d8beac1599eb6c46,50200023535069,1603167.75,60ec41ba55c00300382672d9,HDFC,Marketing Expense,5eecc6d6449e4f7cfb1c2708,2021-07-31T00:00:00.000Z,POS 514834XXXXXX9486 GOOGLE ADS,,,debit_card,-50000
61b70704d8beac1599eb6c57,50200023535069,1617781.32,60ec41ba55c00300382672d9,HDFC,Revenue-PG-split enabled,5eecc6d6449e4f7cfb1c2708,2021-07-31T00:00:00.000Z,NEFT CR-UTIB0001506-RAZORPAY SOFTWARE PR,,,net_banking_transfer,14613.57
61b70705d8beac1599eb6c68,50200023535069,835540.88,60ec41ba55c00300382672d9,HDFC,Revenue-PG-non-split,5eecc6d6449e4f7cfb1c2708,2021-09-01T00:00:00.000Z,IMPS-124405093531-ONE97 COMMUNICATIONS-H DFC-XXXXXXXXXX0007-ALL202109012168200003 30830668628,ewallet,,net_banking_transfer,25151.25
61b70706d8beac1599eb6c7a,50200023535069,735540.88,60ec41ba55c00300382672d9,HDFC,Marketing Expense,5eecc6d6449e4f7cfb1c2708,2021-09-01T00:00:00.000Z,POS 514834XXXXXX9486 GOOGLE ADS,,,debit_card,-100000
61b70707d8beac1599eb6c84,50200023535069,748551.64,60ec41ba55c00300382672d9,HDFC,Revenue-Mktplace,5eecc6d6449e4f7cfb1c2708,2021-09-01T00:00:00.000Z,NEFT CR-DEUT0797BGL-FLIPKART INTERNET PR IVATE LIMITED-SLICK ORGANICS PVT LTD-124 400134GN00046,shopping,,net_banking_transfer,13010.76
61b70708d8beac1599eb6c8e,50200023535069,523551.64,60ec41ba55c00300382672d9,HDFC,direct expenses,5eecc6d6449e4f7cfb1c2708,2021-09-01T00:00:00.000Z,"NEFT DR-SCBL0036025-DHRUV MADHOK-NETBANK , MUM-N244211619851555-225000",,,net_banking_transfer,-225000
61b70709d8beac1599eb6ca0,50200023535069,298551.64,60ec41ba55c00300382672d9,HDFC,direct expenses,5eecc6d6449e4f7cfb1c2708,2021-09-01T00:00:00.000Z,02711930004579-TPT-225000-DHRUV BHASIN,,,net_banking_transfer,-225000
61b7070ad8beac1599eb6ca6,50200023535069,1298551.64,60ec41ba55c00300382672d9,HDFC,Internal Transfers,5eecc6d6449e4f7cfb1c2708,2021-09-01T00:00:00.000Z,IB FUNDS TRANSFER CR-50200035187206 -SL ICK ORGANICS PVT LTD,insurance,,Other,1000000
61b7070bd8beac1599eb6cad,50200023535069,298551.64,60ec41ba55c00300382672d9,HDFC,Marketing Expense,5eecc6d6449e4f7cfb1c2708,2021-09-01T00:00:00.000Z,"NEFT DR-CITI0000006-FACEBOOK INDIA ONLIN E SERVICES PVT LTD-NETBANK, MUM-N2442116 19895225-1000000",,,net_banking_transfer,-1000000
61b7070cd8beac1599eb6cbc,50200023535069,48551.64,60ec41ba55c00300382672d9,HDFC,direct expenses,5eecc6d6449e4f7cfb1c2708,2021-09-01T00:00:00.000Z,"NEFT DR-PYTM0123456-PAYTM-NETBANK, MUM-N 244211619919481-250000",ewallet,,net_banking_transfer,-250000
61b7070dd8beac1599eb6cd4,50200023535069,548551.64,60ec41ba55c00300382672d9,HDFC,Internal Transfers,5eecc6d6449e4f7cfb1c2708,2021-09-01T00:00:00.000Z,IB FUNDS TRANSFER CR-50200035187206 -SL ICK ORGANICS PVT LTD,insurance,,Other,500000
61b7070ed8beac1599eb6cde,50200023535069,546434.67,60ec41ba55c00300382672d9,HDFC,direct expenses,5eecc6d6449e4f7cfb1c2708,2021-09-01T00:00:00.000Z,POS 514834XXXXXX9486 SEOPTIMER,,,debit_card,-2116.97
61b7070fd8beac1599eb6ceb,50200023535069,557676.9,60ec41ba55c00300382672d9,HDFC,Revenue-Mktplace,5eecc6d6449e4f7cfb1c2708,2021-09-01T00:00:00.000Z,NEFT CR-DEUT0797BGL-FLIPKART INTERNET PR IVATE LIMITED-SLICK ORGANICS PVT LTD-124 400137GN00171,shopping,,net_banking_transfer,11242.23
61b70710d8beac1599eb6cfd,50200023535069,1057676.9,60ec41ba55c00300382672d9,HDFC,Internal Transfers,5eecc6d6449e4f7cfb1c2708,2021-09-01T00:00:00.000Z,IB FUNDS TRANSFER CR-50200035187206 -SL ICK ORGANICS PVT LTD,insurance,,Other,500000
61b70711d8beac1599eb6d03,50200023535069,674086.9,60ec41ba55c00300382672d9,HDFC,direct expenses,5eecc6d6449e4f7cfb1c2708,2021-09-01T00:00:00.000Z,"NEFT DR-PUNB0642000-UFLEX LIMITED-NETBAN K, MUM-N244211620464419-383590",loans,lender_transaction,net_banking_transfer,-383590
61b70712d8beac1599eb6d0d,50200023535069,396936.9,60ec41ba55c00300382672d9,HDFC,direct expenses,5eecc6d6449e4f7cfb1c2708,2021-09-01T00:00:00.000Z,"NEFT DR-YESB0000551-VISTTA COSMETICS-NET BANK, MUM-N244211620529561-277150",,,net_banking_transfer,-277150
61b70714d8beac1599eb6d19,50200023535069,141936.9,60ec41ba55c00300382672d9,HDFC,SAAS/tech expense,5eecc6d6449e4f7cfb1c2708,2021-09-01T00:00:00.000Z,WHDF0238540650/BILLDKAMAZONSELLERSE,shopping,,Other,-255000
61b70715d8beac1599eb6d20,50200023535069,44059.9,60ec41ba55c00300382672d9,HDFC,Tax,5eecc6d6449e4f7cfb1c2708,2021-09-01T00:00:00.000Z,051030801092118295- CBDT TAX,,,Other,-97877
61b70716d8beac1599eb6d28,50200023535069,86575.69,60ec41ba55c00300382672d9,HDFC,Revenue-COD,5eecc6d6449e4f7cfb1c2708,2021-09-01T00:00:00.000Z,NEFT CR-ICIC0000155-SHIPROCKET COD CRF I D 2979859-SLICK ORGANICS PVT LTD-CMS2104 427335,insurance,,net_banking_transfer,42515.79
61b70717d8beac1599eb6d35,50200023535069,92547.19,60ec41ba55c00300382672d9,HDFC,Revenue-PG-non-split,5eecc6d6449e4f7cfb1c2708,2021-09-01T00:00:00.000Z,NEFT CR-IDFB0010204-SEZZLE PAYMENTS PRIV ATE LIMITED-SLICK ORGANICS PRIVATE LIMIT ED-IDFBH21244093858,insurance,,net_banking_transfer,5971.5
61b70718d8beac1599eb6d41,50200023535069,27040.19,60ec41ba55c00300382672d9,HDFC,direct expenses,5eecc6d6449e4f7cfb1c2708,2021-09-01T00:00:00.000Z,00921000075586-TPT-65507-ROET BINDRA,,,net_banking_transfer,-65507
61b70719d8beac1599eb6d45,50200023535069,41450.13,60ec41ba55c00300382672d9,HDFC,Revenue-PG-split enabled,5eecc6d6449e4f7cfb1c2708,2021-09-01T00:00:00.000Z,NEFT CR-UTIB0001506-RAZORPAY SOFTWARE PR IVATE LIMITED-SLICK ORGANICS PVT LITD-AX ISCN0090579767,insurance,,net_banking_transfer,14409.94
61b7071ad8beac1599eb6d4c,50200023535069,245218.54,60ec41ba55c00300382672d9,HDFC,Revenue-Mktplace,5eecc6d6449e4f7cfb1c2708,2021-09-01T00:00:00.000Z,NEFT CR-KKBK0000958-NYKAA E RETAIL PRIVA TE LIMITED NYKAA-SLICK ORGANICS PVT LTD- KKBK212443839349,insurance,,net_banking_transfer,203768.41
61b7071bd8beac1599eb6d51,50200023535069,264121.85,60ec41ba55c00300382672d9,HDFC,Revenue-PG-non-split,5eecc6d6449e4f7cfb1c2708,2021-09-02T00:00:00.000Z,IMPS-124505573845-ONE97 COMMUNICATIONS-H DFC-XXXXXXXXXX0007-ALL202109022168200003 30830668628,ewallet,,net_banking_transfer,18903.31
61b7071cd8beac1599eb6d54,50200023535069,52441.85,60ec41ba55c00300382672d9,HDFC,direct expenses,5eecc6d6449e4f7cfb1c2708,2021-09-02T00:00:00.000Z,05892560000649-TPT-211680-DECORPAC INDIA PRIVATE LIMITED,,,net_banking_transfer,-211680
61b7071dd8beac1599eb6d5f,50200023535069,-58.15,60ec41ba55c00300382672d9,HDFC,agency/vendor expense,5eecc6d6449e4f7cfb1c2708,2021-09-02T00:00:00.000Z,"NEFT DR-KKBK0000298-ADMITAD MEDIA PRIVAT E LIMITED-NETBANK, MUM-N245211621434184- 52500",loans,lender_transaction,net_banking_transfer,-52500
61b7071ed8beac1599eb6d69,50200023535069,1433.82,60ec41ba55c00300382672d9,HDFC,Revenue-PG-split enabled,5eecc6d6449e4f7cfb1c2708,2021-09-02T00:00:00.000Z,NEFT CR-UTIB0001506-RAZORPAY SOFTWARE PR IVATE LIMITED-SLICK ORGANICS PVT LITD-AX ISCN0090628069,insurance,,net_banking_transfer,1491.97
61b7071fd8beac1599eb6d78,50200023535069,501433.82,60ec41ba55c00300382672d9,HDFC,Internal Transfers,5eecc6d6449e4f7cfb1c2708,2021-09-02T00:00:00.000Z,IB FUNDS TRANSFER CR-50200035187206 -SL ICK ORGANICS PVT LTD,insurance,,Other,500000
61b70720d8beac1599eb6d7c,50200023535069,321433.82,60ec41ba55c00300382672d9,HDFC,direct expenses,5eecc6d6449e4f7cfb1c2708,2021-09-02T00:00:00.000Z,50200031284040-TPT-180000-BURGEON LAW LL P,,,net_banking_transfer,-180000
61b70720d8beac1599eb6d81,50200023535069,219620.82,60ec41ba55c00300382672d9,HDFC,Tax,5eecc6d6449e4f7cfb1c2708,2021-09-02T00:00:00.000Z,051030802092114552- CBDT TAX,,,Other,-101813
61b70721d8beac1599eb6d8b,50200023535069,221178.18,60ec41ba55c00300382672d9,HDFC,Transfer in/Revenue-other,5eecc6d6449e4f7cfb1c2708,2021-09-02T00:00:00.000Z,ZOOBOP ME WORK-ARATA,,,Other,1557.36
61b70722d8beac1599eb6d90,50200023535069,222380.95,60ec41ba55c00300382672d9,HDFC,Transfer in/Revenue-other,5eecc6d6449e4f7cfb1c2708,2021-09-02T00:00:00.000Z,50200050675669-TPT-REMITTANCE OG AUG21-H,,,net_banking_transfer,1202.77
61b70723d8beac1599eb6d96,50200023535069,256808.95,60ec41ba55c00300382672d9,HDFC,Revenue-Mktplace,5eecc6d6449e4f7cfb1c2708,2021-09-02T00:00:00.000Z,NEFT CR-ICIC0SF0002-THREPSI SOLUTIONS PV -SLICK ORGANICS PVT LTD-24893918121DC,insurance,,net_banking_transfer,34428
61b70724d8beac1599eb6d9a,50200023535069,268520.95,60ec41ba55c00300382672d9,HDFC,Revenue-Mktplace,5eecc6d6449e4f7cfb1c2708,2021-09-02T00:00:00.000Z,NEFT CR-ICIC0SF0002-THREPSI SOLUTIONS PV -SLICK ORGANICS PRIVATE LIMITED-24893921 701DC,insurance,,net_banking_transfer,11712
61b70725d8beac1599eb6da6,50200023535069,292273.15,60ec41ba55c00300382672d9,HDFC,Revenue-PG-split enabled,5eecc6d6449e4f7cfb1c2708,2021-09-02T00:00:00.000Z,NEFT CR-UTIB0001506-RAZORPAY SOFTWARE PR IVATE LIMITED-SLICK ORGANICS PVT LITD-AX ISCN0090835547,insurance,,net_banking_transfer,23752.2
61b70726d8beac1599eb6dad,50200023535069,316096.1,60ec41ba55c00300382672d9,HDFC,Revenue-PG-non-split,5eecc6d6449e4f7cfb1c2708,2021-09-03T00:00:00.000Z,IMPS-124605859281-ONE97 COMMUNICATIONS-H DFC-XXXXXXXXXX0007-ALL202109032168200003 30830668628,ewallet,,net_banking_transfer,23822.95
61b70727d8beac1599eb6db7,50200023535069,322046.4,60ec41ba55c00300382672d9,HDFC,Revenue-Mktplace,5eecc6d6449e4f7cfb1c2708,2021-09-03T00:00:00.000Z,NEFT CR-DEUT0797BGL-FLIPKART INTERNET PR IVATE LIMITED-SLICK ORGANICS PVT LTD-124 600100GN00107,shopping,,net_banking_transfer,5950.3
61b70728d8beac1599eb6dba,50200023535069,327979.33,60ec41ba55c00300382672d9,HDFC,Revenue-PG-split enabled,5eecc6d6449e4f7cfb1c2708,2021-09-03T00:00:00.000Z,NEFT CR-UTIB0001506-RAZORPAY SOFTWARE PR IVATE LIMITED-SLICK ORGANICS PVT LITD-AX ISCN0090872484,insurance,,net_banking_transfer,5932.93
61b70729d8beac1599eb6dc2,50200023535069,285002.71,60ec41ba55c00300382672d9,HDFC,direct expenses,5eecc6d6449e4f7cfb1c2708,2021-09-03T00:00:00.000Z,POS 514834XXXXXX9486 CITRUS PAY GS1IN,ewallet,,debit_card,-42976.62
61b7072ad8beac1599eb6dc7,50200023535069,135002.71,60ec41ba55c00300382672d9,HDFC,direct expenses,5eecc6d6449e4f7cfb1c2708,2021-09-03T00:00:00.000Z,IMPS-124613129208-PAYTM-PYTM-XXXXXXXX383 9-150000,ewallet,,net_banking_transfer,-150000
61b7072bd8beac1599eb6dcb,50200023535069,35002.71,60ec41ba55c00300382672d9,HDFC,direct expenses,5eecc6d6449e4f7cfb1c2708,2021-09-03T00:00:00.000Z,"NEFT DR-YESB0000551-VISTTA COSMETICS-NET BANK, MUM-N246211623254276-100000",,,net_banking_transfer,-100000
61b7072cd8beac1599eb6de4,50200023535069,29602.71,60ec41ba55c00300382672d9,HDFC,direct expenses,5eecc6d6449e4f7cfb1c2708,2021-09-03T00:00:00.000Z,"NEFT DR-SBIN0001859-PARSHOTAM AND ASSOCI ATES-NETBANK, MUM-N246211623312064-5400",,,net_banking_transfer,-5400
61b7072dd8beac1599eb6e90,50200023535069,38893.45,60ec41ba55c00300382672d9,HDFC,Revenue-Mktplace,5eecc6d6449e4f7cfb1c2708,2021-09-03T00:00:00.000Z,NEFT CR-DEUT0797BGL-FLIPKART INTERNET PR IVATE LIMITED-SLICK ORGANICS PVT LTD-124 600105GN00258,shopping,,net_banking_transfer,9290.74
61b7072ed8beac1599eb6e95,50200023535069,65353.36,60ec41ba55c00300382672d9,HDFC,Revenue-COD,5eecc6d6449e4f7cfb1c2708,2021-09-03T00:00:00.000Z,NEFT CR-ICIC0000155-SHIPROCKET COD CRF I D 2992087-SLICK ORGANICS PVT LTD-CMS2108 217837,insurance,,net_banking_transfer,26459.91
61b7072fd8beac1599eb6e97,50200023535069,98352.53,60ec41ba55c00300382672d9,HDFC,Revenue-PG-split enabled,5eecc6d6449e4f7cfb1c2708,2021-09-03T00:00:00.000Z,NEFT CR-UTIB0001506-RAZORPAY SOFTWARE PR,,,net_banking_transfer,32999.17
61b70730d8beac1599eb6ea3,50200023535069,120882.53,60ec41ba55c00300382672d9,HDFC,Revenue-Mktplace,5eecc6d6449e4f7cfb1c2708,2021-09-03T00:00:00.000Z,NEFT CR-SCBL0036001-M/S DREAMPLUG TECHNO -SLICK ORGANICS PRIVATE LIMITEDSLICK-SIN 31436Q0019356,insurance,,net_banking_transfer,22530
61b70731d8beac1599eb6eaf,50200023535069,149677.39,60ec41ba55c00300382672d9,HDFC,Revenue-PG-non-split,5eecc6d6449e4f7cfb1c2708,2021-09-04T00:00:00.000Z,IMPS-124705986817-ONE97 COMMUNICATIONS-H DFC-XXXXXXXXXX0007-ALL202109042168200003 30830668628,ewallet,,net_banking_transfer,28794.86
61b70732d8beac1599eb6eb3,50200023535069,109677.39,60ec41ba55c00300382672d9,HDFC,direct expenses,5eecc6d6449e4f7cfb1c2708,2021-09-04T00:00:00.000Z,"NEFT DR-ICIC0000021-AKHILESH DIXIT-NETBA NK, MUM-N247211624321650-40000",,,net_banking_transfer,-40000
61b70733d8beac1599eb6ebb,50200023535069,1109677.39,60ec41ba55c00300382672d9,HDFC,Internal Transfers,5eecc6d6449e4f7cfb1c2708,2021-09-04T00:00:00.000Z,IB FUNDS TRANSFER CR-50200035187206 -SL ICK ORGANICS PVT LTD,insurance,,Other,1000000
61b70734d8beac1599eb6ed9,50200023535069,965241.39,60ec41ba55c00300382672d9,HDFC,direct expenses,5eecc6d6449e4f7cfb1c2708,2021-09-04T00:00:00.000Z,"NEFT DR-YESB0000162-VINAY REDDY-NETBANK, MUM-N247211624329098-144436",,,net_banking_transfer,-144436
61b70735d8beac1599eb6ee4,50200023535069,890241.39,60ec41ba55c00300382672d9,HDFC,direct expenses,5eecc6d6449e4f7cfb1c2708,2021-09-04T00:00:00.000Z,IMPS-124711115788-PAYTM-PYTM-XXXXXXXX383 9-75000,ewallet,,net_banking_transfer,-75000
61b70736d8beac1599eb6eef,50200023535069,885241.39,60ec41ba55c00300382672d9,HDFC,direct expenses,5eecc6d6449e4f7cfb1c2708,2021-09-04T00:00:00.000Z,IMPS-124711119356-PAYTM-PYTM-XXXXXXXX383 9-5000,ewallet,,net_banking_transfer,-5000
61b70737d8beac1599eb6ef3,50200023535069,709566.39,60ec41ba55c00300382672d9,HDFC,direct expenses,5eecc6d6449e4f7cfb1c2708,2021-09-04T00:00:00.000Z,IMPS-124711119717-NOASTRIX PRIVATE LIMIT ED-INDB-XXXXXXXX0140-175675,,,net_banking_transfer,-175675
61b70738d8beac1599eb6efb,50200023535069,698787.24,60ec41ba55c00300382672d9,HDFC,direct expenses,5eecc6d6449e4f7cfb1c2708,2021-09-04T00:00:00.000Z,POS 514834XXXXXX9486 STK*SHUTTERSTOCK,,,debit_card,-10779.15
61b70739d8beac1599eb6efd,50200023535069,374787.24,60ec41ba55c00300382672d9,HDFC,direct expenses,5eecc6d6449e4f7cfb1c2708,2021-09-04T00:00:00.000Z,"NEFT DR-UTIB0000514-NATS ASSOCIATES-NETB ANK, MUM-N247211624947506-324000",,,net_banking_transfer,-324000
61b7073ad8beac1599eb6f00,50200023535069,874787.24,60ec41ba55c00300382672d9,HDFC,Internal Transfers,5eecc6d6449e4f7cfb1c2708,2021-09-04T00:00:00.000Z,IB FUNDS TRANSFER CR-50200035187206 -SL ICK ORGANICS PVT LTD,insurance,,Other,500000
61b7073bd8beac1599eb6f07,50200023535069,73756.24,60ec41ba55c00300382672d9,HDFC,Tax,5eecc6d6449e4f7cfb1c2708,2021-09-04T00:00:00.000Z,051030804092133627- CBDT TAX,,,Other,-801031
61b7073bd8beac1599eb6f18,50200023535069,89670.4,60ec41ba55c00300382672d9,HDFC,Revenue-PG-split enabled,5eecc6d6449e4f7cfb1c2708,2021-09-04T00:00:00.000Z,NEFT CR-UTIB0001506-RAZORPAY SOFTWARE PR IVATE LIMITED-SLICK ORGANICS PVT LITD-AX ISCN0091036888,insurance,,net_banking_transfer,15914.16
61b7073cd8beac1599eb6f1e,50200023535069,119998.31,60ec41ba55c00300382672d9,HDFC,Revenue-PG-non-split,5eecc6d6449e4f7cfb1c2708,2021-09-05T00:00:00.000Z,IMPS-124805129331-ONE97 COMMUNICATIONS-H,ewallet,,net_banking_transfer,30327.91
61b7073dd8beac1599eb6f22,50200023535069,160885.27,60ec41ba55c00300382672d9,HDFC,Revenue-PG-non-split,5eecc6d6449e4f7cfb1c2708,2021-09-06T00:00:00.000Z,IMPS-124904333198-ONE97 COMMUNICATIONS-H DFC-XXXXXXXXXX0007-ALL202109062168200003 30830668628,ewallet,,net_banking_transfer,40886.96
61b7073ed8beac1599eb6f27,50200023535069,167455.82,60ec41ba55c00300382672d9,HDFC,Revenue-Mktplace,5eecc6d6449e4f7cfb1c2708,2021-09-06T00:00:00.000Z,NEFT CR-DEUT0797BGL-FLIPKART INTERNET PR IVATE LIMITED-SLICK ORGANICS PVT LTD-124 900113GN00226,shopping,,net_banking_transfer,6570.55
61b7073fd8beac1599eb6f48,50200023535069,179249.47,60ec41ba55c00300382672d9,HDFC,Revenue-Mktplace,5eecc6d6449e4f7cfb1c2708,2021-09-06T00:00:00.000Z,NEFT CR-DEUT0797BGL-FLIPKART INTERNET PR IVATE LIMITED-SLICK ORGANICS PVT LTD-124 900127GN00123,shopping,,net_banking_transfer,11793.65
61b70740d8beac1599eb6f4b,50200023535069,264746.62,60ec41ba55c00300382672d9,HDFC,Revenue-PG-split enabled,5eecc6d6449e4f7cfb1c2708,2021-09-06T00:00:00.000Z,NEFT CR-UTIB0001506-RAZORPAY SOFTWARE PR IVATE LIMITED-SLICK ORGANICS PVT LITD-AX ISCN0091079598,insurance,,net_banking_transfer,85497.15
61b70741d8beac1599eb6f6e,50200023535069,9746.62,60ec41ba55c00300382672d9,HDFC,SAAS/tech expense,5eecc6d6449e4f7cfb1c2708,2021-09-06T00:00:00.000Z,WHDF0249872489/BILLDKAMAZONSELLERSE,shopping,,Other,-255000
61b70742d8beac1599eb6f77,50200023535069,7097.62,60ec41ba55c00300382672d9,HDFC,SAAS/tech expense,5eecc6d6449e4f7cfb1c2708,2021-09-06T00:00:00.000Z,WHDF0250014763/BILLDKAMAZONSELLERSE,shopping,,Other,-2649
61b70743d8beac1599eb6f7a,50200023535069,25862.62,60ec41ba55c00300382672d9,HDFC,Transfer in/Revenue-other,5eecc6d6449e4f7cfb1c2708,2021-09-06T00:00:00.000Z,50200050241205-TPT-ARATA-NAPSA PRIVATE L IMITED,,,net_banking_transfer,18765
61b70744d8beac1599eb6f89,50200023535069,27309.88,60ec41ba55c00300382672d9,HDFC,Revenue-PG-non-split,5eecc6d6449e4f7cfb1c2708,2021-09-06T00:00:00.000Z,NEFT CR-IDFB0010204-SEZZLE PAYMENTS PRIV ATE LIMITED-SLICK ORGANICS PRIVATE LIMIT ED-IDFBH21249399574,insurance,,net_banking_transfer,1447.26
61b70745d8beac1599eb6f92,50200023535069,28848.72,60ec41ba55c00300382672d9,HDFC,Revenue-PG-non-split,5eecc6d6449e4f7cfb1c2708,2021-09-06T00:00:00.000Z,NEFT CR-IDFB0010204-SEZZLE PAYMENTS PRIV ATE LIMITED-SLICK ORGANICS PRIVATE LIMIT ED-IDFBH21249399307,insurance,,net_banking_transfer,1538.84
61b70746d8beac1599eb6fa8,50200023535069,30582.57,60ec41ba55c00300382672d9,HDFC,Revenue-PG-non-split,5eecc6d6449e4f7cfb1c2708,2021-09-06T00:00:00.000Z,NEFT CR-IDFB0010204-SEZZLE PAYMENTS PRIV ATE LIMITED-SLICK ORGANICS PRIVATE LIMIT ED-IDFBH21249400219,insurance,,net_banking_transfer,1733.85
61b70747d8beac1599eb6fab,50200023535069,230582.57,60ec41ba55c00300382672d9,HDFC,Internal Transfers,5eecc6d6449e4f7cfb1c2708,2021-09-06T00:00:00.000Z,IB FUNDS TRANSFER CR-50200035187206 -SL ICK ORGANICS PVT LTD,insurance,,Other,200000
61b70748d8beac1599eb6fc0,50200023535069,68582.57,60ec41ba55c00300382672d9,HDFC,direct expenses,5eecc6d6449e4f7cfb1c2708,2021-09-06T00:00:00.000Z,50200059455690-TPT-162000-KAMIYA SAMAR V ERMA,,,net_banking_transfer,-162000
61b70749d8beac1599eb6fc6,50200023535069,103298.94,60ec41ba55c00300382672d9,HDFC,Revenue-PG-split enabled,5eecc6d6449e4f7cfb1c2708,2021-09-06T00:00:00.000Z,NEFT CR-UTIB0001506-RAZORPAY SOFTWARE PR,,,net_banking_transfer,34716.37
61b7074ad8beac1599eb6fcb,50200023535069,133022.83,60ec41ba55c00300382672d9,HDFC,Revenue-PG-non-split,5eecc6d6449e4f7cfb1c2708,2021-09-07T00:00:00.000Z,IMPS-125005698693-ONE97 COMMUNICATIONS-H DFC-XXXXXXXXXX0007-ALL202109072168200003 30830668628,ewallet,,net_banking_transfer,29723.89
61b7074bd8beac1599eb6fd0,50200023535069,300107.47,60ec41ba55c00300382672d9,HDFC,Revenue-Mktplace,5eecc6d6449e4f7cfb1c2708,2021-09-07T00:00:00.000Z,IMPS-125005245631-AMAZON SELLER SERVIC-H DFC-XXXXXXXX6004-5QF32NTMXFQERFZ1SLICK O RGANICS PVT LTD,shopping,,net_banking_transfer,167084.64
61b7074cd8beac1599eb6fd6,50200023535069,792567.8,60ec41ba55c00300382672d9,HDFC,Revenue-Mktplace,5eecc6d6449e4f7cfb1c2708,2021-09-07T00:00:00.000Z,NEFT CR-DEUT0797BGL-AMAZON PAY (INDIA) P RIVATE LIMITED-SLICK ORGANICS PVT LTD-12 5000039GN00373,shopping,,net_banking_transfer,492460.33
61b7074dd8beac1599eb6fd9,50200023535069,701987.8,60ec41ba55c00300382672d9,HDFC,direct expenses,5eecc6d6449e4f7cfb1c2708,2021-09-07T00:00:00.000Z,"NEFT DR-ICIC0000542-AVANTIKA SUKHIA-NETB ANK, MUM-N250211627753692-90580",,,net_banking_transfer,-90580
61b7074ed8beac1599eb6fe8,50200023535069,651987.8,60ec41ba55c00300382672d9,HDFC,direct expenses,5eecc6d6449e4f7cfb1c2708,2021-09-07T00:00:00.000Z,"NEFT DR-UTIB0000120-ADNAN ALI-NETBANK, M UM-N250211627761078-50000",,,net_banking_transfer,-50000
61b7074fd8beac1599eb6ff3,50200023535069,611987.8,60ec41ba55c00300382672d9,HDFC,direct expenses,5eecc6d6449e4f7cfb1c2708,2021-09-07T00:00:00.000Z,"NEFT DR-ICIC0003374-SIDDHARTH KANOJIA-NE TBANK, MUM-N250211627761165-40000",,,net_banking_transfer,-40000
61b70750d8beac1599eb700c,50200023535069,590887.8,60ec41ba55c00300382672d9,HDFC,direct expenses,5eecc6d6449e4f7cfb1c2708,2021-09-07T00:00:00.000Z,"NEFT DR-SIBL0000555-JAIVEER KUMAR-NETBAN K, MUM-N250211627771656-21100",,,net_banking_transfer,-21100
61b70751d8beac1599eb7016,50200023535069,554887.8,60ec41ba55c00300382672d9,HDFC,direct expenses,5eecc6d6449e4f7cfb1c2708,2021-09-07T00:00:00.000Z,00901610080520-TPT-36000-POOJA KAPIL SHR OTRIYA,,,net_banking_transfer,-36000
61b70752d8beac1599eb701a,50200023535069,448887.8,60ec41ba55c00300382672d9,HDFC,direct expenses,5eecc6d6449e4f7cfb1c2708,2021-09-07T00:00:00.000Z,"NEFT DR-ICIC0000021-AKHILESH DIXIT-NETBA NK, MUM-N250211627753983-106000",,,net_banking_transfer,-106000
61b70753d8beac1599eb701e,50200023535069,382887.8,60ec41ba55c00300382672d9,HDFC,direct expenses,5eecc6d6449e4f7cfb1c2708,2021-09-07T00:00:00.000Z,50100330586095-TPT-66000-DIWAKAR UNIYAL,,,net_banking_transfer,-66000
61b70754d8beac1599eb7025,50200023535069,347887.8,60ec41ba55c00300382672d9,HDFC,direct expenses,5eecc6d6449e4f7cfb1c2708,2021-09-07T00:00:00.000Z,50100064106714-TPT-35000-AKSHARANSH BHAT T,,,net_banking_transfer,-35000
61b70755d8beac1599eb702a,50200023535069,292387.8,60ec41ba55c00300382672d9,HDFC,direct expenses,5eecc6d6449e4f7cfb1c2708,2021-09-07T00:00:00.000Z,50100293329616-TPT-55500-SADIYA BANO,,,net_banking_transfer,-55500
61b70756d8beac1599eb7031,50200023535069,276627.8,60ec41ba55c00300382672d9,HDFC,direct expenses,5eecc6d6449e4f7cfb1c2708,2021-09-07T00:00:00.000Z,02711600008220-TPT-15760-VARUN SINGH,,,net_banking_transfer,-15760
61b70757d8beac1599eb7033,50200023535069,260867.8,60ec41ba55c00300382672d9,HDFC,direct expenses,5eecc6d6449e4f7cfb1c2708,2021-09-07T00:00:00.000Z,"NEFT DR-PUNB0151400-BHUWAN CHANDER JOSHI -NETBANK, MUM-N250211627766738-15760",,,net_banking_transfer,-15760
61b70758d8beac1599eb7037,50200023535069,241167.8,60ec41ba55c00300382672d9,HDFC,direct expenses,5eecc6d6449e4f7cfb1c2708,2021-09-07T00:00:00.000Z,"NEFT DR-PUNB0482100-RAM BHAVAN YADAV-NET BANK, MUM-N250211627762123-19700",,,net_banking_transfer,-19700
61b70759d8beac1599eb7040,50200023535069,221467.8,60ec41ba55c00300382672d9,HDFC,direct expenses,5eecc6d6449e4f7cfb1c2708,2021-09-07T00:00:00.000Z,"NEFT DR-PUNB0307800-PRAKASH JHA-NETBANK,",,,net_banking_transfer,-19700
61b7075ad8beac1599eb7045,50200023535069,99967.8,60ec41ba55c00300382672d9,HDFC,direct expenses,5eecc6d6449e4f7cfb1c2708,2021-09-07T00:00:00.000Z,"NEFT DR-UBIN0531855-MOHANISH KOTHARI-NET BANK, MUM-N250211627763483-121500",,,net_banking_transfer,-121500
61b7075bd8beac1599eb704c,50200023535069,9967.8,60ec41ba55c00300382672d9,HDFC,direct expenses,5eecc6d6449e4f7cfb1c2708,2021-09-07T00:00:00.000Z,"NEFT DR-BARB0VJMATU-ARTISTO DESIGNZ-NETB ANK, MUM-N250211627777649-90000",,,net_banking_transfer,-90000
61b7075bd8beac1599eb7050,50200023535069,6879.8,60ec41ba55c00300382672d9,HDFC,direct expenses,5eecc6d6449e4f7cfb1c2708,2021-09-07T00:00:00.000Z,50100097355028-TPT-3088-PALLAVI JUNEJA,,,net_banking_transfer,-3088
61b7075cd8beac1599eb7055,50200023535069,20710.68,60ec41ba55c00300382672d9,HDFC,Revenue-PG-split enabled,5eecc6d6449e4f7cfb1c2708,2021-09-07T00:00:00.000Z,NEFT CR-UTIB0001506-RAZORPAY SOFTWARE PR IVATE LIMITED-SLICK ORGANICS PVT LITD-AX ISCN0091242590,insurance,,net_banking_transfer,13830.88
61b7075dd8beac1599eb706b,50200023535069,710.68,60ec41ba55c00300382672d9,HDFC,direct expenses,5eecc6d6449e4f7cfb1c2708,2021-09-07T00:00:00.000Z,IMPS-125010178153-PAYTM-PYTM-XXXXXXXX383 9-20000,ewallet,,net_banking_transfer,-20000
61b7075ed8beac1599eb707a,50200023535069,1000710.68,60ec41ba55c00300382672d9,HDFC,Internal Transfers,5eecc6d6449e4f7cfb1c2708,2021-09-07T00:00:00.000Z,IB FUNDS TRANSFER CR-50200035187206 -SL ICK ORGANICS PVT LTD,insurance,,Other,1000000
61b7075fd8beac1599eb7080,50200023535069,928710.68,60ec41ba55c00300382672d9,HDFC,direct expenses,5eecc6d6449e4f7cfb1c2708,2021-09-07T00:00:00.000Z,50100301160692-TPT-72000-TARUN GARG,,,net_banking_transfer,-72000
61b70760d8beac1599eb7085,50200023535069,787710.68,60ec41ba55c00300382672d9,HDFC,direct expenses,5eecc6d6449e4f7cfb1c2708,2021-09-07T00:00:00.000Z,"NEFT DR-SCBL0036031-PR PUNDIT PUBLIC REL ATIONS PRIVATE LIMIT-NETBANK, MUM-N25021 1627932785-141000",insurance,,net_banking_transfer,-141000
61b70761d8beac1599eb7093,50200023535069,741495.68,60ec41ba55c00300382672d9,HDFC,direct expenses,5eecc6d6449e4f7cfb1c2708,2021-09-07T00:00:00.000Z,"NEFT DR-KKBK0000187-APPLIED LIFE PRIVATE LIMITED-NETBANK, MUM-N250211627938089-4 6215",,,net_banking_transfer,-46215
61b70762d8beac1599eb709c,50200023535069,191495.68,60ec41ba55c00300382672d9,HDFC,direct expenses,5eecc6d6449e4f7cfb1c2708,2021-09-07T00:00:00.000Z,"NEFT DR-PYTM0123456-PAYTM-NETBANK, MUM-N 250211627956735-550000",ewallet,,net_banking_transfer,-550000
61b70763d8beac1599eb70b2,50200023535069,89435.68,60ec41ba55c00300382672d9,HDFC,direct expenses,5eecc6d6449e4f7cfb1c2708,2021-09-07T00:00:00.000Z,"NEFT DR-KKBK0001393-MASCOT SPINCONTROL I NDIA PVT LTD-NETBANK, MUM-N2502116279584 26-102060",,,net_banking_transfer,-102060
61b70764d8beac1599eb70b6,50200023535069,56435.68,60ec41ba55c00300382672d9,HDFC,direct expenses,5eecc6d6449e4f7cfb1c2708,2021-09-07T00:00:00.000Z,"NEFT DR-SCBL0036031-PR PUNDIT PUBLIC REL ATIONS PRIVATE LIMIT-NETBANK, MUM-N25021 1628067094-33000",insurance,,net_banking_transfer,-33000
61b70765d8beac1599eb70b9,50200023535069,7835.68,60ec41ba55c00300382672d9,HDFC,direct expenses,5eecc6d6449e4f7cfb1c2708,2021-09-07T00:00:00.000Z,"NEFT DR-CNRB0015170-SNEHAL TAYDE-NETBANK , MUM-N250211628467443-48600",,,net_banking_transfer,-48600
61b70766d8beac1599eb70be,50200023535069,507835.68,60ec41ba55c00300382672d9,HDFC,Internal Transfers,5eecc6d6449e4f7cfb1c2708,2021-09-07T00:00:00.000Z,IB FUNDS TRANSFER CR-50200035187206 -SL ICK ORGANICS PVT LTD,insurance,,Other,500000
61b70767d8beac1599eb70c2,50200023535069,279405.68,60ec41ba55c00300382672d9,HDFC,direct expenses,5eecc6d6449e4f7cfb1c2708,2021-09-07T00:00:00.000Z,NEFT DR-PUNB0100110-KRAUTER HEALTHCARE L,,,net_banking_transfer,-228430
61b70768d8beac1599eb70c9,50200023535069,6010.68,60ec41ba55c00300382672d9,HDFC,direct expenses,5eecc6d6449e4f7cfb1c2708,2021-09-07T00:00:00.000Z,"NEFT DR-YESB0000551-VISTTA COSMETICS-NET BANK, MUM-N250211628503200-273395",,,net_banking_transfer,-273395
61b70769d8beac1599eb70ce,50200023535069,506010.68,60ec41ba55c00300382672d9,HDFC,Internal Transfers,5eecc6d6449e4f7cfb1c2708,2021-09-07T00:00:00.000Z,IB FUNDS TRANSFER CR-50200035187206 -SL ICK ORGANICS PVT LTD,insurance,,Other,500000
61b7076ad8beac1599eb70d4,50200023535069,137530.68,60ec41ba55c00300382672d9,HDFC,direct expenses,5eecc6d6449e4f7cfb1c2708,2021-09-07T00:00:00.000Z,05892560000649-TPT-368480-DECORPAC INDIA PRIVATE LIMITED,,,net_banking_transfer,-368480
61b7076bd8beac1599eb70d6,50200023535069,138414.68,60ec41ba55c00300382672d9,HDFC,Revenue-Mktplace,5eecc6d6449e4f7cfb1c2708,2021-09-07T00:00:00.000Z,NEFT CR-ICIC0000105-ICICI BANK NODAL AC MANASH LIFESTYL-SLICK ORGANICS PRIVATE L IMITED KOLK-ICIJ212500012645,,,net_banking_transfer,884
61b7076cd8beac1599eb70d9,50200023535069,144731.1,60ec41ba55c00300382672d9,HDFC,Revenue-PG-non-split,5eecc6d6449e4f7cfb1c2708,2021-09-07T00:00:00.000Z,NEFT CR-IDFB0010204-SEZZLE PAYMENTS PRIV ATE LIMITED-SLICK ORGANICS PRIVATE LIMIT ED-IDFBH21250490495,insurance,,net_banking_transfer,6316.42
61b7076dd8beac1599eb70e3,50200023535069,156009.54,60ec41ba55c00300382672d9,HDFC,Revenue-PG-split enabled,5eecc6d6449e4f7cfb1c2708,2021-09-07T00:00:00.000Z,NEFT CR-UTIB0001506-RAZORPAY SOFTWARE PR IVATE LIMITED-SLICK ORGANICS PVT LITD-AX ISCN0091329835,insurance,,net_banking_transfer,11278.44
61b7076ed8beac1599eb70e8,50200023535069,188929.42,60ec41ba55c00300382672d9,HDFC,Revenue-PG-non-split,5eecc6d6449e4f7cfb1c2708,2021-09-08T00:00:00.000Z,IMPS-125105081184-ONE97 COMMUNICATIONS-H DFC-XXXXXXXXXX0007-ALL202109082168200003 30830668628,ewallet,,net_banking_transfer,32919.88
61b7076fd8beac1599eb70ed,50200023535069,205975.73,60ec41ba55c00300382672d9,HDFC,Revenue-Mktplace,5eecc6d6449e4f7cfb1c2708,2021-09-08T00:00:00.000Z,NEFT CR-DEUT0797BGL-FLIPKART INTERNET PR IVATE LIMITED-SLICK ORGANICS PVT LTD-125 100106GN00006,shopping,,net_banking_transfer,17046.31
61b70770d8beac1599eb70f3,50200023535069,217659.24,60ec41ba55c00300382672d9,HDFC,Revenue-Mktplace,5eecc6d6449e4f7cfb1c2708,2021-09-08T00:00:00.000Z,NEFT CR-DEUT0797BGL-FLIPKART INTERNET PR IVATE LIMITED-SLICK ORGANICS PVT LTD-125 100117GN00285,shopping,,net_banking_transfer,11683.51
61b70771d8beac1599eb70f6,50200023535069,222410.14,60ec41ba55c00300382672d9,HDFC,Revenue-PG-split enabled,5eecc6d6449e4f7cfb1c2708,2021-09-08T00:00:00.000Z,NEFT CR-UTIB0001506-RAZORPAY SOFTWARE PR IVATE LIMITED-SLICK ORGANICS PVT LITD-AX ISCN0091379635,insurance,,net_banking_transfer,4750.9
61b70772d8beac1599eb7100,50200023535069,224828.14,60ec41ba55c00300382672d9,HDFC,Transfer in/Revenue-other,5eecc6d6449e4f7cfb1c2708,2021-09-08T00:00:00.000Z,NEFT CR-KKBK0000958-INNOVATIVE RETAIL CO NCEPTS PRIVATE LTD-SLICK ORGANICS PVT LT D-KKBK212515654015,,,net_banking_transfer,2418
61b70773d8beac1599eb7104,50200023535069,214828.14,60ec41ba55c00300382672d9,HDFC,direct expenses,5eecc6d6449e4f7cfb1c2708,2021-09-08T00:00:00.000Z,1553082408/TECHFLIPKARTPAYMENTS,shopping,,Other,-10000
61b70774d8beac1599eb710a,50200023535069,194828.14,60ec41ba55c00300382672d9,HDFC,direct expenses,5eecc6d6449e4f7cfb1c2708,2021-09-08T00:00:00.000Z,SARWAN KUMAR - CHQ PAID - DEVLI ROAD K,,,chq,-20000
61b70774d8beac1599eb710e,50200023535069,245463.69,60ec41ba55c00300382672d9,HDFC,Revenue-COD,5eecc6d6449e4f7cfb1c2708,2021-09-08T00:00:00.000Z,NEFT CR-ICIC0000155-SHIPROCKET COD CRF I D 3012624-SLICK ORGANICS PVT LTD-CMS2117 856101,insurance,,net_banking_transfer,50635.55
61b70775d8beac1599eb7111,50200023535069,248543.55,60ec41ba55c00300382672d9,HDFC,Revenue-PG-non-split,5eecc6d6449e4f7cfb1c2708,2021-09-08T00:00:00.000Z,NEFT CR-IDFB0010204-SEZZLE PAYMENTS PRIV ATE LIMITED-SLICK ORGANICS PRIVATE LIMIT ED-IDFBH21251570613,insurance,,net_banking_transfer,3079.86
61b70776d8beac1599eb7117,50200023535069,267106.67,60ec41ba55c00300382672d9,HDFC,Revenue-PG-split enabled,5eecc6d6449e4f7cfb1c2708,2021-09-08T00:00:00.000Z,NEFT CR-UTIB0001506-RAZORPAY SOFTWARE PR IVATE LIMITED-SLICK ORGANICS PVT LITD-AX ISCN0091459390,insurance,,net_banking_transfer,18563.12
61b70777d8beac1599eb7120,50200023535069,292395.03,60ec41ba55c00300382672d9,HDFC,Revenue-PG-non-split,5eecc6d6449e4f7cfb1c2708,2021-09-09T00:00:00.000Z,IMPS-125205382225-ONE97 COMMUNICATIONS-H DFC-XXXXXXXXXX0007-ALL202109092168200003 30830668628,ewallet,,net_banking_transfer,25288.36
61b70778d8beac1599eb7123,50200023535069,294995.62,60ec41ba55c00300382672d9,HDFC,Revenue-PG-split enabled,5eecc6d6449e4f7cfb1c2708,2021-09-09T00:00:00.000Z,NEFT CR-UTIB0001506-RAZORPAY SOFTWARE PR IVATE LIMITED-SLICK ORGANICS PVT LITD-AX ISCN0091505282,insurance,,net_banking_transfer,2600.59
61b70779d8beac1599eb7127,50200023535069,244995.62,60ec41ba55c00300382672d9,HDFC,Marketing Expense,5eecc6d6449e4f7cfb1c2708,2021-09-09T00:00:00.000Z,POS 514834XXXXXX9486 GOOGLE ADS,,,debit_card,-50000
61b7077ad8beac1599eb712e,50200023535069,208853.62,60ec41ba55c00300382672d9,HDFC,direct expenses,5eecc6d6449e4f7cfb1c2708,2021-09-09T00:00:00.000Z,"NEFT DR-IOBA0001834-VINDHYA SINGH-NETBAN K, MUM-N252211631656113-36142",,,net_banking_transfer,-36142
61b7077bd8beac1599eb7134,50200023535069,1208853.62,60ec41ba55c00300382672d9,HDFC,Internal Transfers,5eecc6d6449e4f7cfb1c2708,2021-09-09T00:00:00.000Z,IB FUNDS TRANSFER CR-50200035187206 -SL ICK ORGANICS PVT LTD,insurance,,Other,1000000
61b7077cd8beac1599eb7142,50200023535069,166863.62,60ec41ba55c00300382672d9,HDFC,Marketing Expense,5eecc6d6449e4f7cfb1c2708,2021-09-09T00:00:00.000Z,"NEFT DR-CITI0000006-FACEBOOK INDIA ONLIN E SERVICES PVT LTD-NETBANK, MUM-N2522116 31714490-1041990",,,net_banking_transfer,-1041990
61b7077dd8beac1599eb714a,50200023535069,10263.62,60ec41ba55c00300382672d9,HDFC,direct expenses,5eecc6d6449e4f7cfb1c2708,2021-09-09T00:00:00.000Z,"NEFT DR-KKBK0005289-HILL GROOVE CONSULTI NG LLP-NETBANK, MUM-N252211631726558-156 600",,,net_banking_transfer,-156600
61b7077ed8beac1599eb7157,50200023535069,3699.62,60ec41ba55c00300382672d9,HDFC,agency/vendor expense,5eecc6d6449e4f7cfb1c2708,2021-09-09T00:00:00.000Z,"NEFT DR-IDFB0021001-CLICKONIK DIGITAL ME DIA PVT LTD-NETBANK, MUM-N25221163177583 9-6564",insurance,,net_banking_transfer,-6564
61b7077fd8beac1599eb7160,50200023535069,2501.84,60ec41ba55c00300382672d9,HDFC,bank charges,5eecc6d6449e4f7cfb1c2708,2021-09-09T00:00:00.000Z,.DC INTL POS TXN MARKUP+ST 300821 310821,,,international_transaction_arbitrage,-1197.78
61b70780d8beac1599eb7171,50200023535069,102501.84,60ec41ba55c00300382672d9,HDFC,Internal Transfers,5eecc6d6449e4f7cfb1c2708,2021-09-09T00:00:00.000Z,IB FUNDS TRANSFER CR-50200035187206 -SL ICK ORGANICS PVT LTD,insurance,,Other,100000
61b70781d8beac1599eb7184,50200023535069,22688.84,60ec41ba55c00300382672d9,HDFC,agency/vendor expense,5eecc6d6449e4f7cfb1c2708,2021-09-09T00:00:00.000Z,"NEFT DR-KKBK0000298-ADMITAD MEDIA PRIVAT E LIMITED-NETBANK, MUM-N252211632843393- 79813",loans,lender_transaction,net_banking_transfer,-79813
61b70782d8beac1599eb718c,50200023535069,22854.16,60ec41ba55c00300382672d9,HDFC,Revenue-Mktplace,5eecc6d6449e4f7cfb1c2708,2021-09-09T00:00:00.000Z,NEFT CR-DEUT0784BBY-TATA UNISTORE LIMITE D-SLICK ORGANICS PVT LTD-125201961GN0014 4,insurance,,net_banking_transfer,165.32
61b70783d8beac1599eb719c,50200023535069,23378.09,60ec41ba55c00300382672d9,HDFC,Revenue-Mktplace,5eecc6d6449e4f7cfb1c2708,2021-09-09T00:00:00.000Z,NEFT CR-DEUT0784BBY-TATA UNISTORE LTD-NO DAL-SLICK ORGANICS PVT LTD-125201977GN00 225,insurance,,net_banking_transfer,523.93
61b70784d8beac1599eb71b4,50200023535069,69440.19,60ec41ba55c00300382672d9,HDFC,Revenue-PG-split enabled,5eecc6d6449e4f7cfb1c2708,2021-09-09T00:00:00.000Z,NEFT CR-UTIB0001506-RAZORPAY SOFTWARE PR IVATE LIMITED-SLICK ORGANICS PVT LITD-AX ISCN0091587824,insurance,,net_banking_transfer,46062.1
61b70785d8beac1599eb71be,50200023535069,56015.19,60ec41ba55c00300382672d9,HDFC,agency/vendor expense,5eecc6d6449e4f7cfb1c2708,2021-09-09T00:00:00.000Z,"NEFT DR-IDFB0021001-CLICKONIK DIGITAL ME DIA PVT LTD-NETBANK, MUM-N25221163297976 4-13425",insurance,,net_banking_transfer,-13425
61b70786d8beac1599eb71c8,50200023535069,79015.19,60ec41ba55c00300382672d9,HDFC,Internal Transfers,5eecc6d6449e4f7cfb1c2708,2021-09-09T00:00:00.000Z,IB FUNDS TRANSFER CR-50200050976833 -SL ICK ORGANICS PVT LTD,insurance,,Other,23000
61b70787d8beac1599eb71d6,50200023535069,14369.19,60ec41ba55c00300382672d9,HDFC,direct expenses,5eecc6d6449e4f7cfb1c2708,2021-09-09T00:00:00.000Z,"NEFT DR-KKBK0005289-HILL GROOVE CONSULTI NG LLP-NETBANK, MUM-N252211632980283-646 46",,,net_banking_transfer,-64646
61b70788d8beac1599eb71df,50200023535069,14749.86,60ec41ba55c00300382672d9,HDFC,Transfer in/Revenue-other,5eecc6d6449e4f7cfb1c2708,2021-09-09T00:00:00.000Z,4060004262-09 09 2021-HDFAZCUR1,,,Other,380.67
61b70789d8beac1599eb71e3,50200023535069,68301.91,60ec41ba55c00300382672d9,HDFC,Revenue-PG-non-split,5eecc6d6449e4f7cfb1c2708,2021-09-10T00:00:00.000Z,IMPS-125305654227-ONE97 COMMUNICATIONS-H DFC-XXXXXXXXXX0007-ALL202109102168200003 30830668628,ewallet,,net_banking_transfer,53552.05
61b7078ad8beac1599eb71e6,50200023535069,48415.91,60ec41ba55c00300382672d9,HDFC,direct expenses,5eecc6d6449e4f7cfb1c2708,2021-09-10T00:00:00.000Z,POS 514834XXXXXX9486 RAZ*CLEARTRIP,,,debit_card,-19886
61b7078bd8beac1599eb71fa,50200023535069,26094.91,60ec41ba55c00300382672d9,HDFC,direct expenses,5eecc6d6449e4f7cfb1c2708,2021-09-10T00:00:00.000Z,"NEFT DR-ICIC0000021-AKHILESH DIXIT-NETBA NK, MUM-N253211633331851-22321",,,net_banking_transfer,-22321
61b7078cd8beac1599eb7202,50200023535069,29690.89,60ec41ba55c00300382672d9,HDFC,Revenue-PG-non-split,5eecc6d6449e4f7cfb1c2708,2021-09-10T00:00:00.000Z,NEFT CR-IDFB0010204-SEZZLE PAYMENTS PRIV,,,net_banking_transfer,3595.98
61b7078dd8beac1599eb7208,50200023535069,329690.89,60ec41ba55c00300382672d9,HDFC,Internal Transfers,5eecc6d6449e4f7cfb1c2708,2021-09-10T00:00:00.000Z,IB FUNDS TRANSFER CR-50200035187206 -SL ICK ORGANICS PVT LTD,insurance,,Other,300000
61b7078ed8beac1599eb720f,50200023535069,74690.89,60ec41ba55c00300382672d9,HDFC,SAAS/tech expense,5eecc6d6449e4f7cfb1c2708,2021-09-10T00:00:00.000Z,WHDF0261074172/BILLDKAMAZONSELLERSE,shopping,,Other,-255000
61b7078fd8beac1599eb7215,50200023535069,99111.66,60ec41ba55c00300382672d9,HDFC,Revenue-PG-non-split,5eecc6d6449e4f7cfb1c2708,2021-09-11T00:00:00.000Z,IMPS-125405846273-ONE97 COMMUNICATIONS-H DFC-XXXXXXXXXX0007-ALL202109112168200003 30830668628,ewallet,,net_banking_transfer,24420.77
61b70790d8beac1599eb721f,50200023535069,-888.34,60ec41ba55c00300382672d9,HDFC,direct expenses,5eecc6d6449e4f7cfb1c2708,2021-09-11T00:00:00.000Z,"NEFT DR-YESB0000551-VISTTA COSMETICS-NET BANK, MUM-N254211634313339-100000",,,net_banking_transfer,-100000
61b70791d8beac1599eb7228,50200023535069,-871.7,60ec41ba55c00300382672d9,HDFC,Transfer in/Revenue-other,5eecc6d6449e4f7cfb1c2708,2021-09-12T00:00:00.000Z,INT. ON SWCR ON-50300498262188,,,Other,16.64
61b70791d8beac1599eb7291,50200023535069,17.3,60ec41ba55c00300382672d9,HDFC,Loan-in,5eecc6d6449e4f7cfb1c2708,2021-09-12T00:00:00.000Z,SWEEP-IN CREDIT - 50300498262188,,,self_transfer,889
61b70792d8beac1599eb72cd,50200023535069,24747.08,60ec41ba55c00300382672d9,HDFC,Revenue-PG-non-split,5eecc6d6449e4f7cfb1c2708,2021-09-12T00:00:00.000Z,IMPS-125504008678-ONE97 COMMUNICATIONS-H DFC-XXXXXXXXXX0007-ALL202109122168200003 30830668628,ewallet,,net_banking_transfer,24729.78
61b70793d8beac1599eb72d3,50200023535069,21140.39,60ec41ba55c00300382672d9,HDFC,direct expenses,5eecc6d6449e4f7cfb1c2708,2021-09-12T00:00:00.000Z,POS 514834XXXXXX9486 WWW.FAQPRIME.COM,,,debit_card,-3606.69
61b70794d8beac1599eb72e6,50200023535069,43920.49,60ec41ba55c00300382672d9,HDFC,Revenue-PG-non-split,5eecc6d6449e4f7cfb1c2708,2021-09-13T00:00:00.000Z,IMPS-125604147393-ONE97 COMMUNICATIONS-H DFC-XXXXXXXXXX0007-ALL202109132168200003 30830668628,ewallet,,net_banking_transfer,22780.1
61b70795d8beac1599eb72ff,50200023535069,53276.25,60ec41ba55c00300382672d9,HDFC,Revenue-Mktplace,5eecc6d6449e4f7cfb1c2708,2021-09-13T00:00:00.000Z,NEFT CR-DEUT0797BGL-FLIPKART INTERNET PR IVATE LIMITED-SLICK ORGANICS PVT LTD-125 600112GN00210,shopping,,net_banking_transfer,9355.76
61b70796d8beac1599eb7304,50200023535069,112705.36,60ec41ba55c00300382672d9,HDFC,Revenue-PG-split enabled,5eecc6d6449e4f7cfb1c2708,2021-09-13T00:00:00.000Z,NEFT CR-UTIB0001506-RAZORPAY SOFTWARE PR IVATE LIMITED-SLICK ORGANICS PVT LITD-AX ISCN0091686180,insurance,,net_banking_transfer,59429.11
61b70797d8beac1599eb7309,50200023535069,62705.36,60ec41ba55c00300382672d9,HDFC,Marketing Expense,5eecc6d6449e4f7cfb1c2708,2021-09-13T00:00:00.000Z,POS 514834XXXXXX9486 GOOGLE ADS,,,debit_card,-50000
61b70798d8beac1599eb7310,50200023535069,70781.09,60ec41ba55c00300382672d9,HDFC,Revenue-Mktplace,5eecc6d6449e4f7cfb1c2708,2021-09-13T00:00:00.000Z,NEFT CR-DEUT0797BGL-FLIPKART INTERNET PR IVATE LIMITED-SLICK ORGANICS PVT LTD-125 600117GN00220,shopping,,net_banking_transfer,8075.73
61b70799d8beac1599eb7314,50200023535069,74859.61,60ec41ba55c00300382672d9,HDFC,Revenue-PG-non-split,5eecc6d6449e4f7cfb1c2708,2021-09-13T00:00:00.000Z,NEFT CR-IDFB0010204-SEZZLE PAYMENTS PRIV ATE LIMITED-SLICK ORGANICS PRIVATE LIMIT ED-IDFBH21256815207,insurance,,net_banking_transfer,4078.52
61b7079ad8beac1599eb731c,50200023535069,88435.12,60ec41ba55c00300382672d9,HDFC,Revenue-PG-split enabled,5eecc6d6449e4f7cfb1c2708,2021-09-13T00:00:00.000Z,NEFT CR-UTIB0001506-RAZORPAY SOFTWARE PR,,,net_banking_transfer,13575.51
61b7079bd8beac1599eb7322,50200023535069,139566.7,60ec41ba55c00300382672d9,HDFC,Revenue-COD,5eecc6d6449e4f7cfb1c2708,2021-09-13T00:00:00.000Z,NEFT CR-ICIC0000155-SHIPROCKET COD CRF I D 3033016-SLICK ORGANICS PVT LTD-CMS2125 300326,insurance,,net_banking_transfer,51131.58
61b7079cd8beac1599eb7328,50200023535069,160677.15,60ec41ba55c00300382672d9,HDFC,Revenue-PG-non-split,5eecc6d6449e4f7cfb1c2708,2021-09-14T00:00:00.000Z,IMPS-125705550931-ONE97 COMMUNICATIONS-H DFC-XXXXXXXXXX0007-ALL202109142168200003 30830668628,ewallet,,net_banking_transfer,21110.45
61b7079dd8beac1599eb733c,50200023535069,172551.04,60ec41ba55c00300382672d9,HDFC,Revenue-Mktplace,5eecc6d6449e4f7cfb1c2708,2021-09-14T00:00:00.000Z,IMPS-125705108012-AMAZON SELLER SERVIC-H DFC-XXXXXXXX6004-4NKTV2GVTRS67TINSLICK O RGANICS PVT LTD,shopping,,net_banking_transfer,11873.89
61b7079ed8beac1599eb7340,50200023535069,672899.04,60ec41ba55c00300382672d9,HDFC,Revenue-Mktplace,5eecc6d6449e4f7cfb1c2708,2021-09-14T00:00:00.000Z,NEFT CR-DEUT0797BGL-AMAZON PAY (INDIA) P RIVATE LIMITED-SLICK ORGANICS PVT LTD-12 5700075GN00350,shopping,,net_banking_transfer,500348
61b7079fd8beac1599eb734c,50200023535069,679354.2,60ec41ba55c00300382672d9,HDFC,Revenue-PG-split enabled,5eecc6d6449e4f7cfb1c2708,2021-09-14T00:00:00.000Z,NEFT CR-UTIB0001506-RAZORPAY SOFTWARE PR IVATE LIMITED-SLICK ORGANICS PVT LITD-AX ISCN0091942268,insurance,,net_banking_transfer,6455.16
61b707a2d8beac1599eb7355,50200023535069,2806229.15,60ec41ba55c00300382672d9,HDFC,Revenue-Mktplace,5eecc6d6449e4f7cfb1c2708,2021-09-14T00:00:00.000Z,NEFT CR-KKBK0000958-NYKAA E RETAIL PRIVA TE LIMITED NYKAA-SLICK ORGANICS PVT LTD- KKBK212577098413,insurance,,net_banking_transfer,2126874.95
61b707a3d8beac1599eb7359,50200023535069,2806141.72,60ec41ba55c00300382672d9,HDFC,bank charges,5eecc6d6449e4f7cfb1c2708,2021-09-14T00:00:00.000Z,.DC INTL POS TXN MARKUP+ST 010921 020921 -CDT2125005546675,,,international_transaction_arbitrage,-87.43
61b707a4d8beac1599eb7360,50200023535069,2306141.72,60ec41ba55c00300382672d9,HDFC,direct expenses,5eecc6d6449e4f7cfb1c2708,2021-09-14T00:00:00.000Z,"NEFT DR-PYTM0123456-PAYTM-NETBANK, MUM-N 257211636784262-500000",ewallet,,net_banking_transfer,-500000
61b707a5d8beac1599eb7365,50200023535069,2106141.72,60ec41ba55c00300382672d9,HDFC,direct expenses,5eecc6d6449e4f7cfb1c2708,2021-09-14T00:00:00.000Z,"NEFT DR-YESB0000551-VISTTA COSMETICS-NET BANK, MUM-N257211636802372-200000",,,net_banking_transfer,-200000
61b707a6d8beac1599eb736b,50200023535069,1998141.72,60ec41ba55c00300382672d9,HDFC,direct expenses,5eecc6d6449e4f7cfb1c2708,2021-09-14T00:00:00.000Z,"NEFT DR-SCBL0036031-PR PUNDIT PUBLIC REL ATIONS PRIVATE LIMIT-NETBANK, MUM-N25721 1636825726-108000",insurance,,net_banking_transfer,-108000
61b707a7d8beac1599eb736e,50200023535069,1999273.69,60ec41ba55c00300382672d9,HDFC,Revenue-Mktplace,5eecc6d6449e4f7cfb1c2708,2021-09-14T00:00:00.000Z,4060004228-TIMES INTERNET LIMITED NODAL,,,Other,1131.97
61b707a8d8beac1599eb7371,50200023535069,1998828.52,60ec41ba55c00300382672d9,HDFC,bank charges,5eecc6d6449e4f7cfb1c2708,2021-09-14T00:00:00.000Z,.DC INTL POS TXN MARKUP+ST 040921 050921 -CDT2125005546675,,,international_transaction_arbitrage,-445.17
61b707a9d8beac1599eb7378,50200023535069,1997384.52,60ec41ba55c00300382672d9,HDFC,direct expenses,5eecc6d6449e4f7cfb1c2708,2021-09-14T00:00:00.000Z,POS 514834XXXXXX9486 PAYU-HTTPS://STO,,,debit_card,-1444
61b707aad8beac1599eb737d,50200023535069,2002798.7,60ec41ba55c00300382672d9,HDFC,Revenue-PG-non-split,5eecc6d6449e4f7cfb1c2708,2021-09-14T00:00:00.000Z,NEFT CR-IDFB0010204-SEZZLE PAYMENTS PRIV ATE LIMITED-SLICK ORGANICS PRIVATE LIMIT ED-IDFBH21257891159,insurance,,net_banking_transfer,5414.18
61b707aad8beac1599eb7381,50200023535069,2009886.98,60ec41ba55c00300382672d9,HDFC,Revenue-PG-split enabled,5eecc6d6449e4f7cfb1c2708,2021-09-14T00:00:00.000Z,NEFT CR-UTIB0001506-RAZORPAY SOFTWARE PR IVATE LIMITED-SLICK ORGANICS PVT LITD-AX ISCN0092036693,insurance,,net_banking_transfer,7088.28
61b707abd8beac1599eb7388,50200023535069,2039095.47,60ec41ba55c00300382672d9,HDFC,Revenue-PG-non-split,5eecc6d6449e4f7cfb1c2708,2021-09-15T00:00:00.000Z,IMPS-125805921961-ONE97 COMMUNICATIONS-H DFC-XXXXXXXXXX0007-ALL202109152168200003 30830668628,ewallet,,net_banking_transfer,29208.49
61b707acd8beac1599eb738d,50200023535069,2035099.47,60ec41ba55c00300382672d9,HDFC,direct expenses,5eecc6d6449e4f7cfb1c2708,2021-09-15T00:00:00.000Z,02021128403153/ESIC,,,Other,-3996
61b707add8beac1599eb7397,50200023535069,2035124.56,60ec41ba55c00300382672d9,HDFC,Revenue-Mktplace,5eecc6d6449e4f7cfb1c2708,2021-09-15T00:00:00.000Z,NEFT CR-DEUT0797BGL-FLIPKART INTERNET PR IVATE LIMITED-SLICK ORGANICS PVT LTD-125 800896GN00067,shopping,,net_banking_transfer,25.09
61b707aed8beac1599eb739a,50200023535069,2046227.73,60ec41ba55c00300382672d9,HDFC,Revenue-PG-split enabled,5eecc6d6449e4f7cfb1c2708,2021-09-15T00:00:00.000Z,NEFT CR-UTIB0001506-RAZORPAY SOFTWARE PR IVATE LIMITED-SLICK ORGANICS PVT LITD-AX ISCN0092075631,insurance,,net_banking_transfer,11103.17
61b707afd8beac1599eb73a0,50200023535069,2016317.73,60ec41ba55c00300382672d9,HDFC,direct expenses,5eecc6d6449e4f7cfb1c2708,2021-09-15T00:00:00.000Z,"NEFT DR-SBIN0008078-PANDIT PLASTICS-NETB ANK, MUM-N258211637964255-29910",,,net_banking_transfer,-29910
61b707b0d8beac1599eb73a6,50200023535069,1913504.73,60ec41ba55c00300382672d9,HDFC,agency/vendor expense,5eecc6d6449e4f7cfb1c2708,2021-09-15T00:00:00.000Z,"NEFT DR-KKBK0000298-ADMITAD MEDIA PRIVAT E LIMITED-NETBANK, MUM-N258211637964575- 102813",loans,lender_transaction,net_banking_transfer,-102813
61b707b1d8beac1599eb73a8,50200023535069,1870504.73,60ec41ba55c00300382672d9,HDFC,agency/vendor expense,5eecc6d6449e4f7cfb1c2708,2021-09-15T00:00:00.000Z,"NEFT DR-IDFB0021001-CLICKONIK DIGITAL ME DIA PVT LTD-NETBANK, MUM-N25821163797920 2-43000",insurance,,net_banking_transfer,-43000
61b707b2d8beac1599eb73ac,50200023535069,1864436.73,60ec41ba55c00300382672d9,HDFC,direct expenses,5eecc6d6449e4f7cfb1c2708,2021-09-15T00:00:00.000Z,50200021241300-TPT-6068-AFFLE INDIA LIMI TED,,,net_banking_transfer,-6068
61b707b3d8beac1599eb73b5,50200023535069,1826321.73,60ec41ba55c00300382672d9,HDFC,direct expenses,5eecc6d6449e4f7cfb1c2708,2021-09-15T00:00:00.000Z,"NEFT DR-ICIC0000399-RAPIDMILE BUSINESS S OLUTIONS PRIVATE LIM-NETBANK, MUM-N25821 1638060454-38115",loans,lender_transaction,net_banking_transfer,-38115
61b707b4d8beac1599eb73b7,50200023535069,1814496.73,60ec41ba55c00300382672d9,HDFC,direct expenses,5eecc6d6449e4f7cfb1c2708,2021-09-15T00:00:00.000Z,"NEFT DR-ICIC0001878-BAMBOO INDIA-NETBANK , MUM-N258211638231550-11825",,,net_banking_transfer,-11825
61b707b5d8beac1599eb73c5,50200023535069,1810858.13,60ec41ba55c00300382672d9,HDFC,direct expenses,5eecc6d6449e4f7cfb1c2708,2021-09-15T00:00:00.000Z,POS 514834XXXXXX9486 FRESHWORKS INC,,,debit_card,-3638.6
61b707b6d8beac1599eb73d2,50200023535069,1810986.51,60ec41ba55c00300382672d9,HDFC,Revenue-Mktplace,5eecc6d6449e4f7cfb1c2708,2021-09-15T00:00:00.000Z,NEFT CR-HSBC0400002-AMAZON SERVICES LLC- SLICK ORGANICS PRIVATE LIMITED-HSBCN2125 8335161,shopping,,net_banking_transfer,128.38
61b707b7d8beac1599eb73ff,50200023535069,1898687.3,60ec41ba55c00300382672d9,HDFC,Revenue-COD,5eecc6d6449e4f7cfb1c2708,2021-09-15T00:00:00.000Z,NEFT CR-ICIC0000155-SHIPROCKET COD CRF I D 3053577-SLICK ORGANICS PVT LTD-CMS2129 890391,insurance,,net_banking_transfer,87700.79
61b707b8d8beac1599eb7425,50200023535069,1899626.28,60ec41ba55c00300382672d9,HDFC,Revenue-Mktplace,5eecc6d6449e4f7cfb1c2708,2021-09-15T00:00:00.000Z,NEFT CR-ICIC0000105-ICICI BANK NODAL AC MANASH LIFESTYL-SLICK ORGANICS PRIVATE L IMITED MP G-ICIJ212580003140,,,net_banking_transfer,938.98
61b707b9d8beac1599eb742a,50200023535069,1899747.21,60ec41ba55c00300382672d9,HDFC,Revenue-Mktplace,5eecc6d6449e4f7cfb1c2708,2021-09-15T00:00:00.000Z,NEFT CR-ICIC0000105-ICICI BANK NODAL AC MANASH LIFESTYL-SLICK ORGANICS PRIVATE L IMITED KOLK-ICIJ212580000805,,,net_banking_transfer,120.93
61b707bad8beac1599eb7435,50200023535069,1900595.29,60ec41ba55c00300382672d9,HDFC,Revenue-Mktplace,5eecc6d6449e4f7cfb1c2708,2021-09-15T00:00:00.000Z,NEFT CR-ICIC0000105-ICICI BANK NODAL AC MANASH LIFESTYL-SLICK ORGANICS PRIVATE L IMITED HYD-ICIJ212580003142,,,net_banking_transfer,848.08
61b707bbd8beac1599eb7438,50200023535069,1917971.3,60ec41ba55c00300382672d9,HDFC,Revenue-PG-split enabled,5eecc6d6449e4f7cfb1c2708,2021-09-15T00:00:00.000Z,NEFT CR-UTIB0001506-RAZORPAY SOFTWARE PR IVATE LIMITED-SLICK ORGANICS PVT LITD-AX ISCN0092183553,insurance,,net_banking_transfer,17376.01
61b707bcd8beac1599eb743b,50200023535069,1945955.3,60ec41ba55c00300382672d9,HDFC,Revenue-Mktplace,5eecc6d6449e4f7cfb1c2708,2021-09-15T00:00:00.000Z,NEFT CR-SCBL0036001-M/S DREAMPLUG TECHNO -SLICK ORGANICS PRIVATE LIMITEDSLICK-SIN 31436Q0020128,insurance,,net_banking_transfer,27984
61b707bdd8beac1599eb744b,50200023535069,1955954.3,60ec41ba55c00300382672d9,HDFC,Revenue-Mktplace,5eecc6d6449e4f7cfb1c2708,2021-09-15T00:00:00.000Z,NEFT CR-ICIC0SF0002-THREPSI SOLUTIONS PV -SLICK ORGANICS PRIVATE LIMITED-24997740 121DC,insurance,,net_banking_transfer,9999
61b707bed8beac1599eb7450,50200023535069,1700954.3,60ec41ba55c00300382672d9,HDFC,SAAS/tech expense,5eecc6d6449e4f7cfb1c2708,2021-09-15T00:00:00.000Z,WHDF0271927104/BILLDKAMAZONSELLERSE,shopping,,Other,-255000
61b707bfd8beac1599eb7454,50200023535069,1445954.3,60ec41ba55c00300382672d9,HDFC,SAAS/tech expense,5eecc6d6449e4f7cfb1c2708,2021-09-15T00:00:00.000Z,WHDF0272267663/BILLDKAMAZONSELLERSE,shopping,,Other,-255000
61b707c0d8beac1599eb745a,50200023535069,1438955.3,60ec41ba55c00300382672d9,HDFC,SAAS/tech expense,5eecc6d6449e4f7cfb1c2708,2021-09-15T00:00:00.000Z,POS 514834XXXXXX9486 AMAZON,shopping,,debit_card,-6999
61b707c1d8beac1599eb74a2,50200023535069,1456363.12,60ec41ba55c00300382672d9,HDFC,Revenue-PG-non-split,5eecc6d6449e4f7cfb1c2708,2021-09-16T00:00:00.000Z,IMPS-125904196817-ONE97 COMMUNICATIONS-H DFC-XXXXXXXXXX0007-ALL202109162168200003 30830668628,ewallet,,net_banking_transfer,17407.82
61b707c2d8beac1599eb754c,50200023535069,1468806.25,60ec41ba55c00300382672d9,HDFC,Transfer in/Revenue-other,5eecc6d6449e4f7cfb1c2708,2021-09-16T00:00:00.000Z,57500000644820-SLICK ORGANICS,insurance,,Other,12443.13
61b707c3d8beac1599eb75a4,50200023535069,1490489.99,60ec41ba55c00300382672d9,HDFC,Revenue-PG-split enabled,5eecc6d6449e4f7cfb1c2708,2021-09-16T00:00:00.000Z,NEFT CR-UTIB0001506-RAZORPAY SOFTWARE PR,,,net_banking_transfer,21683.74
61b707c4d8beac1599eb75ab,50200023535069,1290489.99,60ec41ba55c00300382672d9,HDFC,direct expenses,5eecc6d6449e4f7cfb1c2708,2021-09-16T00:00:00.000Z,"NEFT DR-INDB0000148-ACQUISORY INDIA CONS ULTING PVT LTD-NETBANK, MUM-N25921164025 6666-200000",,,net_banking_transfer,-200000
61b707c5d8beac1599eb75b8,50200023535069,1310239.45,60ec41ba55c00300382672d9,HDFC,Revenue-PG-non-split,5eecc6d6449e4f7cfb1c2708,2021-09-17T00:00:00.000Z,IMPS-126004435388-ONE97 COMMUNICATIONS-H DFC-XXXXXXXXXX0007-ALL202109172168200003 30830668628,ewallet,,net_banking_transfer,19749.46
61b707c6d8beac1599eb75be,50200023535069,310239.45,60ec41ba55c00300382672d9,HDFC,Marketing Expense,5eecc6d6449e4f7cfb1c2708,2021-09-17T00:00:00.000Z,"NEFT DR-CITI0000006-FACEBOOK INDIA ONLIN E SERVICES PVT LTD-NETBANK, MUM-N2602116 40319445-1000000",,,net_banking_transfer,-1000000
61b707c7d8beac1599eb75c7,50200023535069,312778.21,60ec41ba55c00300382672d9,HDFC,Revenue-Mktplace,5eecc6d6449e4f7cfb1c2708,2021-09-17T00:00:00.000Z,NEFT CR-DEUT0797BGL-FLIPKART INTERNET PR IVATE LIMITED-SLICK ORGANICS PVT LTD-126 000069GN00274,shopping,,net_banking_transfer,2538.76
61b707c8d8beac1599eb75cd,50200023535069,315367.74,60ec41ba55c00300382672d9,HDFC,Revenue-Mktplace,5eecc6d6449e4f7cfb1c2708,2021-09-17T00:00:00.000Z,NEFT CR-DEUT0797BGL-FLIPKART INTERNET PR IVATE LIMITED-SLICK ORGANICS PVT LTD-126 000073GN00186,shopping,,net_banking_transfer,2589.53
61b707cad8beac1599eb75d3,50200023535069,316390.93,60ec41ba55c00300382672d9,HDFC,Revenue-PG-split enabled,5eecc6d6449e4f7cfb1c2708,2021-09-17T00:00:00.000Z,NEFT CR-UTIB0001506-RAZORPAY SOFTWARE PR IVATE LIMITED-SLICK ORGANICS PVT LITD-AX ISCN0092398338,insurance,,net_banking_transfer,1023.19
61b707cbd8beac1599eb75dc,50200023535069,316978.52,60ec41ba55c00300382672d9,HDFC,Transfer in/Revenue-other,5eecc6d6449e4f7cfb1c2708,2021-09-17T00:00:00.000Z,NEFT CR-ICIC0SF0002-ICICI BANK NODAL A-C -SLICK ORGANICS-25010007511DC,insurance,,net_banking_transfer,587.59
61b707ccd8beac1599eb75e5,50200023535069,396978.52,60ec41ba55c00300382672d9,HDFC,Transfer in/Revenue-other,5eecc6d6449e4f7cfb1c2708,2021-09-17T00:00:00.000Z,MC CANCELLED,,,Other,80000
61b707cdd8beac1599eb75e8,50200023535069,397105.16,60ec41ba55c00300382672d9,HDFC,Revenue-Mktplace,5eecc6d6449e4f7cfb1c2708,2021-09-17T00:00:00.000Z,NEFT CR-DEUT0784BBY-TATA UNISTORE LIMITE D-SLICK ORGANICS PVT LTD-126001664GN0034 1,insurance,,net_banking_transfer,126.64
61b707ced8beac1599eb75fb,50200023535069,397384.66,60ec41ba55c00300382672d9,HDFC,Revenue-Mktplace,5eecc6d6449e4f7cfb1c2708,2021-09-17T00:00:00.000Z,NEFT CR-DEUT0784BBY-TATA UNISTORE LTD-NO DAL-SLICK ORGANICS PVT LTD-126001703GN00 570,insurance,,net_banking_transfer,279.5
61b707cfd8beac1599eb7600,50200023535069,398288.44,60ec41ba55c00300382672d9,HDFC,Transfer in/Revenue-other,5eecc6d6449e4f7cfb1c2708,2021-09-17T00:00:00.000Z,NEFT CR-ICIC0000105-ICICI BANK NODAL AC,,,net_banking_transfer,903.78
61b707cfd8beac1599eb760b,50200023535069,399536.74,60ec41ba55c00300382672d9,HDFC,Revenue-Mktplace,5eecc6d6449e4f7cfb1c2708,2021-09-17T00:00:00.000Z,NEFT CR-ICIC0000105-ICICI BANK NODAL AC MANASH LIFESTYL-SLICK ORGANICS PRIVATE L IMITED HYD-ICIJ212600001934,,,net_banking_transfer,1248.3
61b707d0d8beac1599eb7617,50200023535069,400787.25,60ec41ba55c00300382672d9,HDFC,Revenue-Mktplace,5eecc6d6449e4f7cfb1c2708,2021-09-17T00:00:00.000Z,NEFT CR-ICIC0000105-ICICI BANK NODAL AC MANASH LIFESTYL-SLICK ORGANICS PRIVATE L IMITED MP M-ICIJ212600003771,,,net_banking_transfer,1250.51
61b707d1d8beac1599eb761d,50200023535069,401653.68,60ec41ba55c00300382672d9,HDFC,Revenue-Mktplace,5eecc6d6449e4f7cfb1c2708,2021-09-17T00:00:00.000Z,NEFT CR-ICIC0000105-ICICI BANK NODAL AC MANASH LIFESTYL-SLICK ORGANICS PRIVATE L IMITED BANG-ICIJ212600001936,,,net_banking_transfer,866.43
61b707d2d8beac1599eb7622,50200023535069,419565.62,60ec41ba55c00300382672d9,HDFC,Revenue-PG-split enabled,5eecc6d6449e4f7cfb1c2708,2021-09-17T00:00:00.000Z,NEFT CR-UTIB0001506-RAZORPAY SOFTWARE PR IVATE LIMITED-SLICK ORGANICS PVT LITD-AX ISCN0092491220,insurance,,net_banking_transfer,17911.94
61b707d3d8beac1599eb762f,50200023535069,421011.3,60ec41ba55c00300382672d9,HDFC,Revenue-PG-non-split,5eecc6d6449e4f7cfb1c2708,2021-09-17T00:00:00.000Z,NEFT CR-IDFB0010204-SEZZLE PAYMENTS PRIV ATE LIMITED-SLICK ORGANICS PRIVATE LIMIT ED-IDFBH21260090062,insurance,,net_banking_transfer,1445.68
61b707d4d8beac1599eb7636,50200023535069,422859.3,60ec41ba55c00300382672d9,HDFC,Revenue-COD,5eecc6d6449e4f7cfb1c2708,2021-09-17T00:00:00.000Z,PICKRR TECHNOL-CODAKHILESHARATAIN17,,,Other,1848
61b707d5d8beac1599eb763c,50200023535069,448450.27,60ec41ba55c00300382672d9,HDFC,Revenue-PG-non-split,5eecc6d6449e4f7cfb1c2708,2021-09-18T00:00:00.000Z,IMPS-126105612906-ONE97 COMMUNICATIONS-H DFC-XXXXXXXXXX0007-ALL202109182168200003 30830668628,ewallet,,net_banking_transfer,25590.97
61b707d6d8beac1599eb7643,50200023535069,470733.32,60ec41ba55c00300382672d9,HDFC,Revenue-PG-split enabled,5eecc6d6449e4f7cfb1c2708,2021-09-18T00:00:00.000Z,NEFT CR-UTIB0001506-RAZORPAY SOFTWARE PR IVATE LIMITED-SLICK ORGANICS PVT LITD-AX ISCN0092590192,insurance,,net_banking_transfer,22283.05
61b707d7d8beac1599eb7649,50200023535069,501646.7,60ec41ba55c00300382672d9,HDFC,Revenue-PG-non-split,5eecc6d6449e4f7cfb1c2708,2021-09-19T00:00:00.000Z,IMPS-126207859277-ONE97 COMMUNICATIONS-H DFC-XXXXXXXXXX0007-ALL202109192168200003 30830668628,ewallet,,net_banking_transfer,30913.38
61b707d8d8beac1599eb764f,50200023535069,399315.7,60ec41ba55c00300382672d9,HDFC,agency/vendor expense,5eecc6d6449e4f7cfb1c2708,2021-09-19T00:00:00.000Z,"NEFT DR-KKBK0000298-ADMITAD MEDIA PRIVAT E LIMITED-NETBANK, MUM-N262211642495587- 102331",loans,lender_transaction,net_banking_transfer,-102331
61b707d9d8beac1599eb7653,50200023535069,216700.7,60ec41ba55c00300382672d9,HDFC,direct expenses,5eecc6d6449e4f7cfb1c2708,2021-09-19T00:00:00.000Z,"NEFT DR-INDB0000333-NOASTRIX PRIVATE LIM ITED-NETBANK, MUM-N262211642480222-18261 5",,,net_banking_transfer,-182615
61b707dad8beac1599eb765b,50200023535069,245602.47,60ec41ba55c00300382672d9,HDFC,Revenue-PG-non-split,5eecc6d6449e4f7cfb1c2708,2021-09-20T00:00:00.000Z,IMPS-126305801965-ONE97 COMMUNICATIONS-H,ewallet,,net_banking_transfer,28901.77
61b707dbd8beac1599eb7664,50200023535069,256564.06,60ec41ba55c00300382672d9,HDFC,Revenue-Mktplace,5eecc6d6449e4f7cfb1c2708,2021-09-20T00:00:00.000Z,NEFT CR-DEUT0797BGL-FLIPKART INTERNET PR IVATE LIMITED-SLICK ORGANICS PVT LTD-126 300098GN00002,shopping,,net_banking_transfer,10961.59
61b707dcd8beac1599eb7667,50200023535069,263847.68,60ec41ba55c00300382672d9,HDFC,Revenue-Mktplace,5eecc6d6449e4f7cfb1c2708,2021-09-20T00:00:00.000Z,NEFT CR-DEUT0797BGL-FLIPKART INTERNET PR IVATE LIMITED-SLICK ORGANICS PVT LTD-126 300116GN00149,shopping,,net_banking_transfer,7283.62
61b707ddd8beac1599eb766d,50200023535069,209847.68,60ec41ba55c00300382672d9,HDFC,direct expenses,5eecc6d6449e4f7cfb1c2708,2021-09-20T00:00:00.000Z,"NEFT DR-KKBK0000654-NIHARIKA MISHRA-NETB ANK, MUM-N263211642655390-54000",,,net_banking_transfer,-54000
61b707ded8beac1599eb7671,50200023535069,9847.68,60ec41ba55c00300382672d9,HDFC,direct expenses,5eecc6d6449e4f7cfb1c2708,2021-09-20T00:00:00.000Z,"NEFT DR-PYTM0123456-PAYTM-NETBANK, MUM-N 263211642653452-200000",ewallet,,net_banking_transfer,-200000
61b707dfd8beac1599eb7676,50200023535069,4691.48,60ec41ba55c00300382672d9,HDFC,direct expenses,5eecc6d6449e4f7cfb1c2708,2021-09-20T00:00:00.000Z,POS 514834XXXXXX9486 FEEDBACKFIVE,,,debit_card,-5156.2
61b707e0d8beac1599eb767d,50200023535069,26357.03,60ec41ba55c00300382672d9,HDFC,Revenue-PG-split enabled,5eecc6d6449e4f7cfb1c2708,2021-09-20T00:00:00.000Z,NEFT CR-UTIB0001506-RAZORPAY SOFTWARE PR IVATE LIMITED-SLICK ORGANICS PVT LITD-AX ISCN0092630432,insurance,,net_banking_transfer,21665.55
61b707e1d8beac1599eb7681,50200023535069,26208.08,60ec41ba55c00300382672d9,HDFC,bank charges,5eecc6d6449e4f7cfb1c2708,2021-09-20T00:00:00.000Z,.DC INTL POS TXN MARKUP+ST 120921 140921 -CDT2125005546675,,,international_transaction_arbitrage,-148.95
61b707e2d8beac1599eb7687,50200023535069,-13138,60ec41ba55c00300382672d9,HDFC,direct expenses,5eecc6d6449e4f7cfb1c2708,2021-09-20T00:00:00.000Z,POS 514834XXXXXX9486 THE ROCKET SCIEN,,,debit_card,-39346.08
61b707e3d8beac1599eb768c,50200023535069,-9766.24,60ec41ba55c00300382672d9,HDFC,Transfer in/Revenue-other,5eecc6d6449e4f7cfb1c2708,2021-09-20T00:00:00.000Z,ZOOBOP ME WORK-ARATA,,,Other,3371.76
61b707e4d8beac1599eb768f,50200023535069,-8724.61,60ec41ba55c00300382672d9,HDFC,Revenue-Mktplace,5eecc6d6449e4f7cfb1c2708,2021-09-20T00:00:00.000Z,NEFT CR-ICIC0000105-ICICI BANK NODAL AC MANASH LIFESTYL-SLICK ORGANICS PRIVATE L IMITED MP M-ICIJ212630005203,,,net_banking_transfer,1041.63
61b707e5d8beac1599eb7696,50200023535069,-8506.18,60ec41ba55c00300382672d9,HDFC,Revenue-Mktplace,5eecc6d6449e4f7cfb1c2708,2021-09-20T00:00:00.000Z,NEFT CR-ICIC0000105-ICICI BANK NODAL AC MANASH LIFESTYL-SLICK ORGANICS PRIVATE L IMITED HYD-ICIJ212630005205,,,net_banking_transfer,218.43
61b707e6d8beac1599eb769b,50200023535069,-7757.02,60ec41ba55c00300382672d9,HDFC,Revenue-Mktplace,5eecc6d6449e4f7cfb1c2708,2021-09-20T00:00:00.000Z,NEFT CR-ICIC0000105-ICICI BANK NODAL AC MANASH LIFESTYL-SLICK ORGANICS PRIVATE L IMITED BANG-ICIJ212630002985,,,net_banking_transfer,749.16
61b707e7d8beac1599eb769f,50200023535069,-3853.04,60ec41ba55c00300382672d9,HDFC,Transfer in/Revenue-other,5eecc6d6449e4f7cfb1c2708,2021-09-20T00:00:00.000Z,NEFT CR-ICIC0000105-ICICI BANK NODAL AC,,,net_banking_transfer,3903.98
61b707e7d8beac1599eb76a6,50200023535069,-760.89,60ec41ba55c00300382672d9,HDFC,Revenue-PG-split enabled,5eecc6d6449e4f7cfb1c2708,2021-09-20T00:00:00.000Z,NEFT CR-UTIB0001506-RAZORPAY SOFTWARE PR IVATE LIMITED-SLICK ORGANICS PVT LITD-AX ISCN0092733305,insurance,,net_banking_transfer,3092.15
61b707e8d8beac1599eb76aa,50200023535069,1015.34,60ec41ba55c00300382672d9,HDFC,Revenue-PG-non-split,5eecc6d6449e4f7cfb1c2708,2021-09-20T00:00:00.000Z,NEFT CR-IDFB0010204-SEZZLE PAYMENTS PRIV ATE LIMITED-SLICK ORGANICS PRIVATE LIMIT ED-IDFBH21263237201,insurance,,net_banking_transfer,1776.23
61b707e9d8beac1599eb76b4,50200023535069,2115.5,60ec41ba55c00300382672d9,HDFC,Transfer in/Revenue-other,5eecc6d6449e4f7cfb1c2708,2021-09-20T00:00:00.000Z,FT - C72150200921153433 - - 50200050045 240 - ZOOBOP ME WORKS PRIVATE LIMITED,,,Other,1100.16
61b707ead8beac1599eb76b7,50200023535069,-5178.92,60ec41ba55c00300382672d9,HDFC,direct expenses,5eecc6d6449e4f7cfb1c2708,2021-09-20T00:00:00.000Z,POS 514834XXXXXX9486 HOTJAR,,,debit_card,-7294.42
61b707ebd8beac1599eb76bd,50200023535069,17095.39,60ec41ba55c00300382672d9,HDFC,Revenue-COD,5eecc6d6449e4f7cfb1c2708,2021-09-20T00:00:00.000Z,NEFT CR-ICIC0000155-SHIPROCKET COD CRF I D 3082164-SLICK ORGANICS PVT LTD-CMS2137 505082,insurance,,net_banking_transfer,22274.31
61b707ecd8beac1599eb76c2,50200023535069,40708.69,60ec41ba55c00300382672d9,HDFC,Revenue-PG-non-split,5eecc6d6449e4f7cfb1c2708,2021-09-21T00:00:00.000Z,IMPS-126404064034-ONE97 COMMUNICATIONS-H DFC-XXXXXXXXXX0007-ALL202109212168200003 30830668628,ewallet,,net_banking_transfer,23613.3
61b707edd8beac1599eb76c5,50200023535069,94872.87,60ec41ba55c00300382672d9,HDFC,Revenue-Mktplace,5eecc6d6449e4f7cfb1c2708,2021-09-21T00:00:00.000Z,IMPS-126405158335-AMAZON SELLER SERVIC-H DFC-XXXXXXXX6004-QR95F6SLKR8MO5N7SLICK O RGANICS PVT LTD,shopping,,net_banking_transfer,54164.18
61b707eed8beac1599eb76ca,50200023535069,347383.47,60ec41ba55c00300382672d9,HDFC,Revenue-Mktplace,5eecc6d6449e4f7cfb1c2708,2021-09-21T00:00:00.000Z,NEFT CR-DEUT0797BGL-AMAZON PAY (INDIA) P RIVATE LIMITED-SLICK ORGANICS PVT LTD-12 6400044GN00071,shopping,,net_banking_transfer,252510.6
61b707efd8beac1599eb76d2,50200023535069,354645.32,60ec41ba55c00300382672d9,HDFC,Revenue-PG-split enabled,5eecc6d6449e4f7cfb1c2708,2021-09-21T00:00:00.000Z,NEFT CR-UTIB0001506-RAZORPAY SOFTWARE PR IVATE LIMITED-SLICK ORGANICS PVT LITD-AX ISCN0092794020,insurance,,net_banking_transfer,7261.85
61b707f0d8beac1599eb76d5,50200023535069,357281.24,60ec41ba55c00300382672d9,HDFC,Revenue-Mktplace,5eecc6d6449e4f7cfb1c2708,2021-09-21T00:00:00.000Z,NEFT CR-ICIC0000105-ICICI BANK NODAL AC MANASH LIFESTYL-SLICK ORGANICS PRIVATE L IMITED MP M-ICIJ212640004263,,,net_banking_transfer,2635.92
61b707f1d8beac1599eb76e0,50200023535069,363316.08,60ec41ba55c00300382672d9,HDFC,Revenue-Mktplace,5eecc6d6449e4f7cfb1c2708,2021-09-21T00:00:00.000Z,NEFT CR-ICIC0000105-ICICI BANK NODAL AC MANASH LIFESTYL-SLICK ORGANICS PRIVATE L IMITED MP G-ICIJ212640002386,,,net_banking_transfer,6034.84
61b707f2d8beac1599eb76e6,50200023535069,365962.98,60ec41ba55c00300382672d9,HDFC,Transfer in/Revenue-other,5eecc6d6449e4f7cfb1c2708,2021-09-21T00:00:00.000Z,NEFT CR-ICIC0000105-ICICI BANK NODAL AC,,,net_banking_transfer,2646.9
61b707f3d8beac1599eb76eb,50200023535069,367683.33,60ec41ba55c00300382672d9,HDFC,Revenue-Mktplace,5eecc6d6449e4f7cfb1c2708,2021-09-21T00:00:00.000Z,NEFT CR-ICIC0000105-ICICI BANK NODAL AC MANASH LIFESTYL-SLICK ORGANICS PRIVATE L IMITED BANG-ICIJ212640004268,,,net_banking_transfer,1720.35
61b707f4d8beac1599eb76fb,50200023535069,368370.14,60ec41ba55c00300382672d9,HDFC,Revenue-Mktplace,5eecc6d6449e4f7cfb1c2708,2021-09-21T00:00:00.000Z,NEFT CR-ICIC0000105-ICICI BANK NODAL AC MANASH LIFESTYL-SLICK ORGANICS PRIVATE L IMITED HYD-ICIJ212640004266,,,net_banking_transfer,686.81
61b707f5d8beac1599eb7709,50200023535069,397675.14,60ec41ba55c00300382672d9,HDFC,Revenue-COD,5eecc6d6449e4f7cfb1c2708,2021-09-21T00:00:00.000Z,PICKRR TECHNOL-CODAKHILESHARATAIN21,,,Other,29305
61b707f6d8beac1599eb771d,50200023535069,404361.09,60ec41ba55c00300382672d9,HDFC,Revenue-PG-split enabled,5eecc6d6449e4f7cfb1c2708,2021-09-21T00:00:00.000Z,NEFT CR-UTIB0001506-RAZORPAY SOFTWARE PR IVATE LIMITED-SLICK ORGANICS PVT LITD-AX ISCN0092887127,insurance,,net_banking_transfer,6685.95
61b707f7d8beac1599eb7729,50200023535069,408126.97,60ec41ba55c00300382672d9,HDFC,Revenue-PG-non-split,5eecc6d6449e4f7cfb1c2708,2021-09-21T00:00:00.000Z,NEFT CR-IDFB0010204-SEZZLE PAYMENTS PRIV ATE LIMITED-SLICK ORGANICS PRIVATE LIMIT ED-IDFBH21264300847,insurance,,net_banking_transfer,3765.88
61b707f8d8beac1599eb7730,50200023535069,366136.97,60ec41ba55c00300382672d9,HDFC,SAAS/tech expense,5eecc6d6449e4f7cfb1c2708,2021-09-21T00:00:00.000Z,POS 514834XXXXXX9486 AMAZON,shopping,,debit_card,-41990
61b707f9d8beac1599eb773e,50200023535069,403648.29,60ec41ba55c00300382672d9,HDFC,Revenue-PG-non-split,5eecc6d6449e4f7cfb1c2708,2021-09-22T00:00:00.000Z,IMPS-126505175295-ONE97 COMMUNICATIONS-H DFC-XXXXXXXXXX0007-ALL202109222168200003 30830668628,ewallet,,net_banking_transfer,37511.32
61b707fad8beac1599eb7747,50200023535069,418467.66,60ec41ba55c00300382672d9,HDFC,Revenue-Mktplace,5eecc6d6449e4f7cfb1c2708,2021-09-22T00:00:00.000Z,NEFT CR-DEUT0797BGL-FLIPKART INTERNET PR IVATE LIMITED-SLICK ORGANICS PVT LTD-126 500342GN00207,shopping,,net_banking_transfer,14819.37
61b707fbd8beac1599eb774d,50200023535069,428415.93,60ec41ba55c00300382672d9,HDFC,Revenue-Mktplace,5eecc6d6449e4f7cfb1c2708,2021-09-22T00:00:00.000Z,NEFT CR-DEUT0797BGL-FLIPKART INTERNET PR IVATE LIMITED-SLICK ORGANICS PVT LTD-126 500357GN00269,shopping,,net_banking_transfer,9948.27
61b707fbd8beac1599eb775b,50200023535069,431770.64,60ec41ba55c00300382672d9,HDFC,Revenue-PG-split enabled,5eecc6d6449e4f7cfb1c2708,2021-09-22T00:00:00.000Z,NEFT CR-UTIB0001506-RAZORPAY SOFTWARE PR IVATE LIMITED-SLICK ORGANICS PVT LITD-AX ISCN0092921925,insurance,,net_banking_transfer,3354.71
61b707fcd8beac1599eb7761,50200023535069,431652.64,60ec41ba55c00300382672d9,HDFC,bank charges,5eecc6d6449e4f7cfb1c2708,2021-09-22T00:00:00.000Z,DD/MC CANCELLATION CHARGE 170921-CDT2126 405757669,,,bank_charge,-118
61b707fdd8beac1599eb776c,50200023535069,364152.64,60ec41ba55c00300382672d9,HDFC,Marketing Expense,5eecc6d6449e4f7cfb1c2708,2021-09-22T00:00:00.000Z,POS 514834XXXXXX9486 GOOGLE ADS,,,debit_card,-67500
61b707fed8beac1599eb7770,50200023535069,379092.82,60ec41ba55c00300382672d9,HDFC,Revenue-PG-non-split,5eecc6d6449e4f7cfb1c2708,2021-09-22T00:00:00.000Z,NEFT CR-SCBL0036001-STRIPE INDIA PRIVATE,,,net_banking_transfer,14940.18
61b707ffd8beac1599eb7775,50200023535069,406227.21,60ec41ba55c00300382672d9,HDFC,Revenue-COD,5eecc6d6449e4f7cfb1c2708,2021-09-22T00:00:00.000Z,NEFT CR-ICIC0000155-SHIPROCKET COD CRF I D 3094523-SLICK ORGANICS PVT LTD-CMS2141 713431,insurance,,net_banking_transfer,27134.39
61b70800d8beac1599eb777d,50200023535069,406662.61,60ec41ba55c00300382672d9,HDFC,Revenue-Mktplace,5eecc6d6449e4f7cfb1c2708,2021-09-22T00:00:00.000Z,NEFT CR-ICIC0000105-ICICI BANK NODAL AC MANASH LIFESTYL-SLICK ORGANICS PRIVATE L IMITED KOLK-ICIJ212650005576,,,net_banking_transfer,435.4
61b70801d8beac1599eb7782,50200023535069,406925.77,60ec41ba55c00300382672d9,HDFC,Revenue-Mktplace,5eecc6d6449e4f7cfb1c2708,2021-09-22T00:00:00.000Z,NEFT CR-ICIC0000105-ICICI BANK NODAL AC MANASH LIFESTYL-SLICK ORGANICS PRIVATE L IMITED BANG-ICIJ212650003341,,,net_banking_transfer,263.16
61b70802d8beac1599eb7788,50200023535069,407168.4,60ec41ba55c00300382672d9,HDFC,Revenue-Mktplace,5eecc6d6449e4f7cfb1c2708,2021-09-22T00:00:00.000Z,NEFT CR-ICIC0000105-ICICI BANK NODAL AC MANASH LIFESTYL-SLICK ORGANICS PRIVATE L IMITED HYD-ICIJ212650003339,,,net_banking_transfer,242.63
61b70803d8beac1599eb7791,50200023535069,408421.13,60ec41ba55c00300382672d9,HDFC,Revenue-Mktplace,5eecc6d6449e4f7cfb1c2708,2021-09-22T00:00:00.000Z,NEFT CR-ICIC0000105-ICICI BANK NODAL AC MANASH LIFESTYL-SLICK ORGANICS PRIVATE L IMITED MP G-ICIJ212650005574,,,net_banking_transfer,1252.73
61b70804d8beac1599eb7799,50200023535069,409223.76,60ec41ba55c00300382672d9,HDFC,Revenue-Mktplace,5eecc6d6449e4f7cfb1c2708,2021-09-22T00:00:00.000Z,NEFT CR-ICIC0000105-ICICI BANK NODAL AC MANASH LIFESTYL-SLICK ORGANICS PRIVATE L IMITED MP M-ICIJ212650005575,,,net_banking_transfer,802.63
61b70805d8beac1599eb77a0,50200023535069,409604.43,60ec41ba55c00300382672d9,HDFC,Transfer in/Revenue-other,5eecc6d6449e4f7cfb1c2708,2021-09-22T00:00:00.000Z,4060004819-22 09 2021-HDFAZCUR1,,,Other,380.67
61b70806d8beac1599eb77a7,50200023535069,420966.73,60ec41ba55c00300382672d9,HDFC,Revenue-PG-split enabled,5eecc6d6449e4f7cfb1c2708,2021-09-22T00:00:00.000Z,NEFT CR-UTIB0001506-RAZORPAY SOFTWARE PR IVATE LIMITED-SLICK ORGANICS PVT LITD-AX ISCN0093013131,insurance,,net_banking_transfer,11362.3
61b70807d8beac1599eb77ad,50200023535069,421197.69,60ec41ba55c00300382672d9,HDFC,Revenue-PG-non-split,5eecc6d6449e4f7cfb1c2708,2021-09-22T00:00:00.000Z,NEFT CR-IDFB0010204-SEZZLE PAYMENTS PRIV ATE LIMITED-SLICK ORGANICS PRIVATE LIMIT ED-IDFBH21265374433,insurance,,net_banking_transfer,230.96
61b70808d8beac1599eb77b9,50200023535069,446911,60ec41ba55c00300382672d9,HDFC,Revenue-PG-non-split,5eecc6d6449e4f7cfb1c2708,2021-09-23T00:00:00.000Z,IMPS-126604374152-ONE97 COMMUNICATIONS-H DFC-XXXXXXXXXX0007-ALL202109232168200003 30830668628,ewallet,,net_banking_transfer,25713.31
61b70809d8beac1599eb77bf,50200023535069,451977.58,60ec41ba55c00300382672d9,HDFC,Revenue-PG-split enabled,5eecc6d6449e4f7cfb1c2708,2021-09-23T00:00:00.000Z,NEFT CR-UTIB0001506-RAZORPAY SOFTWARE PR,,,net_banking_transfer,5066.58
61b7080ad8beac1599eb77d0,50200023535069,394215.58,60ec41ba55c00300382672d9,HDFC,direct expenses,5eecc6d6449e4f7cfb1c2708,2021-09-23T00:00:00.000Z,"NEFT DR-ICIC0000007-DLF UTILITIES LTD-NE TBANK, MUM-N266211646540951-57762",,,net_banking_transfer,-57762
61b7080bd8beac1599eb77d4,50200023535069,374215.58,60ec41ba55c00300382672d9,HDFC,direct expenses,5eecc6d6449e4f7cfb1c2708,2021-09-23T00:00:00.000Z,"NEFT DR-ICIC0000021-AKHILESH DIXIT-NETBA NK, MUM-N266211646592069-20000",,,net_banking_transfer,-20000
61b7080cd8beac1599eb77d8,50200023535069,290209.58,60ec41ba55c00300382672d9,HDFC,direct expenses,5eecc6d6449e4f7cfb1c2708,2021-09-23T00:00:00.000Z,"NEFT DR-YESB0000162-VINAY REDDY-NETBANK, MUM-N266211646646371-84006",,,net_banking_transfer,-84006
61b7080dd8beac1599eb77e0,50200023535069,290208.58,60ec41ba55c00300382672d9,HDFC,Marketing Expense,5eecc6d6449e4f7cfb1c2708,2021-09-23T00:00:00.000Z,POS 514834XXXXXX9486 GOOGLE *TEMPORAR,,,debit_card,-1
61b7080ed8beac1599eb77e6,50200023535069,290209.58,60ec41ba55c00300382672d9,HDFC,Transfer in/Revenue-other,5eecc6d6449e4f7cfb1c2708,2021-09-23T00:00:00.000Z,POS 514834XXXXXX9486 GOOGLE *TEMPORAR,,,debit_card,1
61b7080fd8beac1599eb77ec,50200023535069,290207.58,60ec41ba55c00300382672d9,HDFC,Marketing Expense,5eecc6d6449e4f7cfb1c2708,2021-09-23T00:00:00.000Z,POS 514834XXXXXX9486 GOOGLE ADS,,,debit_card,-2
61b70810d8beac1599eb77f4,50200023535069,288086.95,60ec41ba55c00300382672d9,HDFC,Marketing Expense,5eecc6d6449e4f7cfb1c2708,2021-09-23T00:00:00.000Z,POS 514834XXXXXX9486 GOOGLE ADS,,,debit_card,-2120.63
61b70811d8beac1599eb77f8,50200023535069,248086.95,60ec41ba55c00300382672d9,HDFC,direct expenses,5eecc6d6449e4f7cfb1c2708,2021-09-23T00:00:00.000Z,IMPS-126613140608-PAYTM-PYTM-XXXXXXXX383 9-40000,ewallet,,net_banking_transfer,-40000
61b70812d8beac1599eb7800,50200023535069,248595.09,60ec41ba55c00300382672d9,HDFC,Revenue-PG-non-split,5eecc6d6449e4f7cfb1c2708,2021-09-23T00:00:00.000Z,NEFT CR-IDFB0010204-SEZZLE PAYMENTS PRIV ATE LIMITED-SLICK ORGANICS PRIVATE LIMIT ED-IDFBH21266429831,insurance,,net_banking_transfer,508.14
61b70813d8beac1599eb7807,50200023535069,267175.09,60ec41ba55c00300382672d9,HDFC,Revenue-Mktplace,5eecc6d6449e4f7cfb1c2708,2021-09-23T00:00:00.000Z,NEFT CR-SCBL0036001-M/S DREAMPLUG TECHNO -SLICK ORGANICS PRIVATE LIMITEDSLICK-SIN 31436Q0020624,insurance,,net_banking_transfer,18580
61b70813d8beac1599eb780c,50200023535069,274926.49,60ec41ba55c00300382672d9,HDFC,Revenue-PG-split enabled,5eecc6d6449e4f7cfb1c2708,2021-09-23T00:00:00.000Z,NEFT CR-UTIB0001506-RAZORPAY SOFTWARE PR IVATE LIMITED-SLICKORGANICSPVTLITD-AXISC N0093561420,insurance,,net_banking_transfer,7751.4
61b70814d8beac1599eb7811,50200023535069,290537.69,60ec41ba55c00300382672d9,HDFC,Revenue-PG-non-split,5eecc6d6449e4f7cfb1c2708,2021-09-24T00:00:00.000Z,IMPS-126705768750-PAYTM PAYMENTS SERVI-H DFC-XXXXXXXXXX0008-ALL202109242168200003 30830668628,ewallet,,net_banking_transfer,15611.2
61b70815d8beac1599eb7815,50200023535069,300317.66,60ec41ba55c00300382672d9,HDFC,Revenue-Mktplace,5eecc6d6449e4f7cfb1c2708,2021-09-24T00:00:00.000Z,NEFT CR-DEUT0797BGL-FLIPKART INTERNET PR IVATE LIMITED-SLICK ORGANICS PVT LTD-126 700129GN00085,shopping,,net_banking_transfer,9779.97
61b70816d8beac1599eb782e,50200023535069,302349.64,60ec41ba55c00300382672d9,HDFC,Revenue-Mktplace,5eecc6d6449e4f7cfb1c2708,2021-09-24T00:00:00.000Z,NEFT CR-DEUT0797BGL-FLIPKART INTERNET PR IVATE LIMITED-SLICK ORGANICS PVT LTD-126 700138GN00162,shopping,,net_banking_transfer,2031.98
61b70817d8beac1599eb7835,50200023535069,305896.6,60ec41ba55c00300382672d9,HDFC,Revenue-PG-split enabled,5eecc6d6449e4f7cfb1c2708,2021-09-24T00:00:00.000Z,NEFT CR-UTIB0001506-RAZORPAY SOFTWARE PR,,,net_banking_transfer,3546.96
61b70818d8beac1599eb7839,50200023535069,1024836.6,60ec41ba55c00300382672d9,HDFC,Internal Transfers,5eecc6d6449e4f7cfb1c2708,2021-09-24T00:00:00.000Z,IB FUNDS TRANSFER CR-50200035187206 -SL ICK ORGANICS PVT LTD,insurance,,Other,718940
61b70819d8beac1599eb783f,50200023535069,24836.6,60ec41ba55c00300382672d9,HDFC,Marketing Expense,5eecc6d6449e4f7cfb1c2708,2021-09-24T00:00:00.000Z,"NEFT DR-CITI0000006-FACEBOOK INDIA ONLIN E SERVICES PVT LTD-NETBANK, MUM-N2672116 47590432-1000000",,,net_banking_transfer,-1000000
61b7081ad8beac1599eb7845,50200023535069,24835.6,60ec41ba55c00300382672d9,HDFC,Marketing Expense,5eecc6d6449e4f7cfb1c2708,2021-09-24T00:00:00.000Z,POS 514834XXXXXX9486 GOOGLE *TEMPORAR,,,debit_card,-1
61b7081bd8beac1599eb784a,50200023535069,24836.6,60ec41ba55c00300382672d9,HDFC,Transfer in/Revenue-other,5eecc6d6449e4f7cfb1c2708,2021-09-24T00:00:00.000Z,POS 514834XXXXXX9486 GOOGLE *TEMPORAR,,,debit_card,1
61b7081cd8beac1599eb7859,50200023535069,26203.09,60ec41ba55c00300382672d9,HDFC,Transfer in/Revenue-other,5eecc6d6449e4f7cfb1c2708,2021-09-24T00:00:00.000Z,NEFT CR-ICIC0SF0002-ICICI BANK NODAL A-C -SLICK ORGANICS-25064013311DC,insurance,,net_banking_transfer,1366.49
61b7081dd8beac1599eb785d,50200023535069,27214.28,60ec41ba55c00300382672d9,HDFC,Transfer in/Revenue-other,5eecc6d6449e4f7cfb1c2708,2021-09-24T00:00:00.000Z,NEFT CR-YESB0000001-ILLUMINAR MEDIA-SLIC K ORGANICS PVT LTD-N267210768749100,,,net_banking_transfer,1011.19
61b7081ed8beac1599eb7863,50200023535069,17214.28,60ec41ba55c00300382672d9,HDFC,direct expenses,5eecc6d6449e4f7cfb1c2708,2021-09-24T00:00:00.000Z,1568948842/TECHFLIPKARTPAYMENTS,shopping,,Other,-10000
61b7081fd8beac1599eb7866,50200023535069,17616.1,60ec41ba55c00300382672d9,HDFC,Transfer in/Revenue-other,5eecc6d6449e4f7cfb1c2708,2021-09-24T00:00:00.000Z,NEFT CR-YESB0000001-ILUMINAR MEDIA-SLICK ORGANICS PVT. LTD-N267210768753677,,,net_banking_transfer,401.82
61b70820d8beac1599eb7869,50200023535069,21705.1,60ec41ba55c00300382672d9,HDFC,Transfer in/Revenue-other,5eecc6d6449e4f7cfb1c2708,2021-09-24T00:00:00.000Z,NEFT CR-KKBK0000958-INNOVATIVE RETAIL CO NCEPTS PRIVATE LTD-SLICK ORGANICS PVT LT D-KKBK212679804106,,,net_banking_transfer,4089
61b70821d8beac1599eb7873,50200023535069,48128.82,60ec41ba55c00300382672d9,HDFC,Revenue-COD,5eecc6d6449e4f7cfb1c2708,2021-09-24T00:00:00.000Z,NEFT CR-ICIC0000155-SHIPROCKET COD CRF I D 3114929-SLICK ORGANICS PVT LTD-CMS2145 107633,insurance,,net_banking_transfer,26423.72
61b70822d8beac1599eb7879,50200023535069,-1871.18,60ec41ba55c00300382672d9,HDFC,Marketing Expense,5eecc6d6449e4f7cfb1c2708,2021-09-24T00:00:00.000Z,POS 514834XXXXXX9486 GOOGLE ADS,,,debit_card,-50000
61b70823d8beac1599eb787d,50200023535069,-1583.8,60ec41ba55c00300382672d9,HDFC,Revenue-Mktplace,5eecc6d6449e4f7cfb1c2708,2021-09-24T00:00:00.000Z,NEFT CR-DEUT0784BBY-TATA UNISTORE LIMITE D-SLICK ORGANICS PVT LTD-126701745GN0033 4,insurance,,net_banking_transfer,287.38
61b70824d8beac1599eb7885,50200023535069,-136.52,60ec41ba55c00300382672d9,HDFC,Revenue-Mktplace,5eecc6d6449e4f7cfb1c2708,2021-09-24T00:00:00.000Z,NEFT CR-DEUT0784BBY-TATA UNISTORE LTD-NO DAL-SLICK ORGANICS PVT LTD-126701752GN00 484,insurance,,net_banking_transfer,1447.28
61b70825d8beac1599eb788b,50200023535069,1007.73,60ec41ba55c00300382672d9,HDFC,Revenue-Mktplace,5eecc6d6449e4f7cfb1c2708,2021-09-24T00:00:00.000Z,NEFT CR-ICIC0000105-ICICI BANK NODAL AC MANASH LIFESTYL-SLICK ORGANICS PRIVATE L IMITED MP G-ICIJ212670006691,,,net_banking_transfer,1144.25
61b70826d8beac1599eb7893,50200023535069,1416.75,60ec41ba55c00300382672d9,HDFC,Transfer in/Revenue-other,5eecc6d6449e4f7cfb1c2708,2021-09-24T00:00:00.000Z,NEFT CR-ICIC0000105-ICICI BANK NODAL AC,,,net_banking_transfer,409.02
61b70827d8beac1599eb7897,50200023535069,3219.62,60ec41ba55c00300382672d9,HDFC,Revenue-Mktplace,5eecc6d6449e4f7cfb1c2708,2021-09-24T00:00:00.000Z,NEFT CR-DEUT0784BBY-TATA UNISTORE LTD-NO DAL-SLICK ORGANICS PVT LTD-126702038GN00 464,insurance,,net_banking_transfer,1802.87
61b70828d8beac1599eb789d,50200023535069,3915.8,60ec41ba55c00300382672d9,HDFC,Revenue-Mktplace,5eecc6d6449e4f7cfb1c2708,2021-09-24T00:00:00.000Z,NEFT CR-DEUT0784BBY-TATA UNISTORE LTD-NO DAL-SLICK ORGANICS PVT LTD-126702038GN00 611,insurance,,net_banking_transfer,696.18
61b70829d8beac1599eb78a0,50200023535069,29306.87,60ec41ba55c00300382672d9,HDFC,Revenue-PG-non-split,5eecc6d6449e4f7cfb1c2708,2021-09-25T00:00:00.000Z,IMPS-126804569509-PAYTM PAYMENTS SERVI-H DFC-XXXXXXXXXX0008-ALL202109252168200003 30830668628,ewallet,,net_banking_transfer,25391.07
61b7082ad8beac1599eb78a9,50200023535069,29780.61,60ec41ba55c00300382672d9,HDFC,Revenue-PG-non-split,5eecc6d6449e4f7cfb1c2708,2021-09-25T00:00:00.000Z,NEFT CR-IDFB0010204-SEZZLE PAYMENTS PRIV ATE LIMITED-SLICK ORGANICS PRIVATE LIMIT ED-IDFBH21268561641,insurance,,net_banking_transfer,473.74
61b7082bd8beac1599eb78b0,50200023535069,115635.87,60ec41ba55c00300382672d9,HDFC,Revenue-PG-non-split,5eecc6d6449e4f7cfb1c2708,2021-09-26T00:00:00.000Z,IMPS-126905837707-PAYTM PAYMENTS SERVI-H DFC-XXXXXXXXXX0008-ALL202109262168200003 30830668628,ewallet,,net_banking_transfer,85855.26
61b7082cd8beac1599eb78b5,50200023535069,76645.87,60ec41ba55c00300382672d9,HDFC,SAAS/tech expense,5eecc6d6449e4f7cfb1c2708,2021-09-26T00:00:00.000Z,POS 514834XXXXXX9486 AMAZON,shopping,,debit_card,-38990
61b7082dd8beac1599eb78ba,50200023535069,111432.63,60ec41ba55c00300382672d9,HDFC,Revenue-PG-non-split,5eecc6d6449e4f7cfb1c2708,2021-09-27T00:00:00.000Z,IMPS-127005982500-PAYTM PAYMENTS SERVI-H DFC-XXXXXXXXXX0008-ALL202109272168200003 30830668628,ewallet,,net_banking_transfer,34786.76
61b7082dd8beac1599eb78bf,50200023535069,156595.11,60ec41ba55c00300382672d9,HDFC,Revenue-PG-split enabled,5eecc6d6449e4f7cfb1c2708,2021-09-27T00:00:00.000Z,NEFT CR-UTIB0001506-RAZORPAY SOFTWARE PR IVATE LIMITED-SLICKORGANICSPVTLITD-AXISC N0093949007,insurance,,net_banking_transfer,45162.48
61b7082ed8beac1599eb78c5,50200023535069,158119.65,60ec41ba55c00300382672d9,HDFC,Revenue-Mktplace,5eecc6d6449e4f7cfb1c2708,2021-09-27T00:00:00.000Z,4060004792-TIMES INTERNET LIMITED NODAL,,,Other,1524.54
61b7082fd8beac1599eb78cf,50200023535069,176499.59,60ec41ba55c00300382672d9,HDFC,Revenue-Mktplace,5eecc6d6449e4f7cfb1c2708,2021-09-27T00:00:00.000Z,NEFT CR-DEUT0797BGL-FLIPKART INTERNET PR IVATE LIMITED-SLICK ORGANICS PVT LTD-127 000084GN00097,shopping,,net_banking_transfer,18379.94
61b70830d8beac1599eb78d4,50200023535069,184177.93,60ec41ba55c00300382672d9,HDFC,Revenue-Mktplace,5eecc6d6449e4f7cfb1c2708,2021-09-27T00:00:00.000Z,NEFT CR-DEUT0797BGL-FLIPKART INTERNET PR IVATE LIMITED-SLICK ORGANICS PVT LTD-127 000165GN00086,shopping,,net_banking_transfer,7678.34
61b70831d8beac1599eb78d8,50200023535069,134177.93,60ec41ba55c00300382672d9,HDFC,direct expenses,5eecc6d6449e4f7cfb1c2708,2021-09-27T00:00:00.000Z,IMPS-127013151745-PAYTM-PYTM-XXXXXXXX383,ewallet,,net_banking_transfer,-50000
61b70832d8beac1599eb78df,50200023535069,135056.81,60ec41ba55c00300382672d9,HDFC,Revenue-Mktplace,5eecc6d6449e4f7cfb1c2708,2021-09-27T00:00:00.000Z,NEFT CR-ICIC0000105-ICICI BANK NODAL AC MANASH LIFESTYL-SLICK ORGANICS PRIVATE L IMITED HYD-ICIJ212700000972,,,net_banking_transfer,878.88
61b70833d8beac1599eb78e3,50200023535069,135670.35,60ec41ba55c00300382672d9,HDFC,Revenue-Mktplace,5eecc6d6449e4f7cfb1c2708,2021-09-27T00:00:00.000Z,NEFT CR-ICIC0000105-ICICI BANK NODAL AC MANASH LIFESTYL-SLICK ORGANICS PRIVATE L IMITED KOLK-ICIJ212700000970,,,net_banking_transfer,613.54
61b70834d8beac1599eb78e7,50200023535069,137144.44,60ec41ba55c00300382672d9,HDFC,Revenue-Mktplace,5eecc6d6449e4f7cfb1c2708,2021-09-27T00:00:00.000Z,NEFT CR-ICIC0000105-ICICI BANK NODAL AC MANASH LIFESTYL-SLICK ORGANICS PRIVATE L IMITED MP M-ICIJ212700000968,,,net_banking_transfer,1474.09
61b70835d8beac1599eb78f0,50200023535069,157761.44,60ec41ba55c00300382672d9,HDFC,Revenue-COD,5eecc6d6449e4f7cfb1c2708,2021-09-27T00:00:00.000Z,NEFT CR-ICIC0000155-SHIPROCKET COD CRF I D 3123123-SLICK ORGANICS PVT LTD-CMS2149 091993,insurance,,net_banking_transfer,20617
61b70836d8beac1599eb78f4,50200023535069,161597.06,60ec41ba55c00300382672d9,HDFC,Revenue-PG-non-split,5eecc6d6449e4f7cfb1c2708,2021-09-27T00:00:00.000Z,NEFT CR-IDFB0010204-SEZZLE PAYMENTS PRIV ATE LIMITED-SLICK ORGANICS PRIVATE LIMIT ED-IDFBH21270665150,insurance,,net_banking_transfer,3835.62
61b70837d8beac1599eb78fa,50200023535069,186249.54,60ec41ba55c00300382672d9,HDFC,Revenue-PG-split enabled,5eecc6d6449e4f7cfb1c2708,2021-09-27T00:00:00.000Z,NEFT CR-UTIB0001506-RAZORPAY SOFTWARE PR IVATE LIMITED-SLICKORGANICSPVTLITD-AXISC N0094163394,insurance,,net_banking_transfer,24652.48
61b70838d8beac1599eb78fe,50200023535069,212946.54,60ec41ba55c00300382672d9,HDFC,Revenue-COD,5eecc6d6449e4f7cfb1c2708,2021-09-27T00:00:00.000Z,NEFT CR-KKBK0000958-PICKRR TECHNOLOGIES PVT LTD-SLICKORGANICSPRIVATELIMITED-CMS2 702101441018,insurance,,net_banking_transfer,26697
61b70839d8beac1599eb7903,50200023535069,212947.54,60ec41ba55c00300382672d9,HDFC,Transfer in/Revenue-other,5eecc6d6449e4f7cfb1c2708,2021-09-27T00:00:00.000Z,IMPS-127023563821-RELIANCERETAILVENTUR-H DFC-XXXXXXX4531-52,loans,lender_transaction,net_banking_transfer,1
61b7083ad8beac1599eb790c,50200023535069,238943.27,60ec41ba55c00300382672d9,HDFC,Revenue-PG-non-split,5eecc6d6449e4f7cfb1c2708,2021-09-28T00:00:00.000Z,IMPS-127105306721-PAYTM PAYMENTS SERVI-H DFC-XXXXXXXXXX0008-ALL202109282168200003 30830668628,ewallet,,net_banking_transfer,25995.73
61b7083bd8beac1599eb7910,50200023535069,398897.87,60ec41ba55c00300382672d9,HDFC,Revenue-Mktplace,5eecc6d6449e4f7cfb1c2708,2021-09-28T00:00:00.000Z,NEFT CR-DEUT0797BGL-AMAZON PAY (INDIA) P RIVATE LIMITED-SLICK ORGANICS PVT LTD-12 7100041GN00238,shopping,,net_banking_transfer,159954.6
61b7083cd8beac1599eb7916,50200023535069,418247.87,60ec41ba55c00300382672d9,HDFC,Transfer in/Revenue-other,5eecc6d6449e4f7cfb1c2708,2021-09-28T00:00:00.000Z,NEFT CR-SCBL0036001-AARDAE PTE LTD-SLICK,insurance,,net_banking_transfer,19350
61b7083dd8beac1599eb7919,50200023535069,401867.87,60ec41ba55c00300382672d9,HDFC,direct expenses,5eecc6d6449e4f7cfb1c2708,2021-09-28T00:00:00.000Z,"NEFT DR-IBKL0000165-SHIV ENTERPRISES-NET BANK, MUM-N271211650965615-16380",,,net_banking_transfer,-16380
61b7083ed8beac1599eb791d,50200023535069,401654.92,60ec41ba55c00300382672d9,HDFC,bank charges,5eecc6d6449e4f7cfb1c2708,2021-09-28T00:00:00.000Z,.DC INTL POS TXN MARKUP+ST 190921 210921 -CDT2125005546675,,,international_transaction_arbitrage,-212.95
61b7083fd8beac1599eb7925,50200023535069,383654.92,60ec41ba55c00300382672d9,HDFC,direct expenses,5eecc6d6449e4f7cfb1c2708,2021-09-28T00:00:00.000Z,"NEFT DR-ICIC0000021-AKHILESH DIXIT-NETBA NK, MUM-N271211651495595-18000",,,net_banking_transfer,-18000
61b70840d8beac1599eb792b,50200023535069,397663.26,60ec41ba55c00300382672d9,HDFC,Revenue-PG-non-split,5eecc6d6449e4f7cfb1c2708,2021-09-28T00:00:00.000Z,NEFT CR-IDFB0010204-SEZZLE PAYMENTS PRIV ATE LIMITED-SLICK ORGANICS PRIVATE LIMIT ED-IDFBH21271731665,insurance,,net_banking_transfer,14008.34
61b70841d8beac1599eb792f,50200023535069,433970.1,60ec41ba55c00300382672d9,HDFC,Revenue-PG-split enabled,5eecc6d6449e4f7cfb1c2708,2021-09-28T00:00:00.000Z,NEFT CR-UTIB0001506-RAZORPAY SOFTWARE PR IVATE LIMITED-SLICKORGANICSPVTLITD-AXISC N0094533908,insurance,,net_banking_transfer,36306.84
61b70842d8beac1599eb7934,50200023535069,490197.5,60ec41ba55c00300382672d9,HDFC,Revenue-PG-non-split,5eecc6d6449e4f7cfb1c2708,2021-09-29T00:00:00.000Z,IMPS-127205650142-PAYTM PAYMENTS SERVI-H DFC-XXXXXXXXXX0008-ALL202109292168200003 30830668628,ewallet,,net_banking_transfer,56227.4
61b70843d8beac1599eb7937,50200023535069,235197.5,60ec41ba55c00300382672d9,HDFC,SAAS/tech expense,5eecc6d6449e4f7cfb1c2708,2021-09-29T00:00:00.000Z,KQSX25ELBJ72FO6UCI/PAYUAMAZON,shopping,,Other,-255000
61b70843d8beac1599eb7940,50200023535069,260938.46,60ec41ba55c00300382672d9,HDFC,Revenue-Mktplace,5eecc6d6449e4f7cfb1c2708,2021-09-29T00:00:00.000Z,NEFT CR-DEUT0797BGL-FLIPKART INTERNET PR IVATE LIMITED-SLICK ORGANICS PVT LTD-127 200093GN00165,shopping,,net_banking_transfer,25740.96
61b70844d8beac1599eb7943,50200023535069,274188.43,60ec41ba55c00300382672d9,HDFC,Revenue-Mktplace,5eecc6d6449e4f7cfb1c2708,2021-09-29T00:00:00.000Z,NEFT CR-DEUT0797BGL-FLIPKART INTERNET PR IVATE LIMITED-SLICK ORGANICS PVT LTD-127 200102GN00123,shopping,,net_banking_transfer,13249.97
61b70845d8beac1599eb794a,50200023535069,269263.43,60ec41ba55c00300382672d9,HDFC,direct expenses,5eecc6d6449e4f7cfb1c2708,2021-09-29T00:00:00.000Z,"NEFT DR-CITI0000027-RISHIEKA JAINI-NETBA NK, MUM-N272211652682118-4925",,,net_banking_transfer,-4925
61b70846d8beac1599eb7950,50200023535069,269961.43,60ec41ba55c00300382672d9,HDFC,Revenue-Mktplace,5eecc6d6449e4f7cfb1c2708,2021-09-29T00:00:00.000Z,NEFT CR-ICIC0000985-DIGITAL AGE RETAIL P VT LTD-SLICK ORGANICS PVT LTD-CMS2152487 201,,,net_banking_transfer,698
61b70847d8beac1599eb7955,50200023535069,269660.17,60ec41ba55c00300382672d9,HDFC,bank charges,5eecc6d6449e4f7cfb1c2708,2021-09-29T00:00:00.000Z,.DC INTL POS TXN MARKUP+ST 200921 220921 -CDT2125005546675,,,international_transaction_arbitrage,-301.26
61b70848d8beac1599eb7959,50200023535069,269815.56,60ec41ba55c00300382672d9,HDFC,Transfer in/Revenue-other,5eecc6d6449e4f7cfb1c2708,2021-09-29T00:00:00.000Z,NEFT CR-ICIC0000105-ICICI BANK NODAL AC,,,net_banking_transfer,155.39
61b70849d8beac1599eb7962,50200023535069,270458.41,60ec41ba55c00300382672d9,HDFC,Revenue-Mktplace,5eecc6d6449e4f7cfb1c2708,2021-09-29T00:00:00.000Z,NEFT CR-ICIC0000105-ICICI BANK NODAL AC MANASH LIFESTYL-SLICK ORGANICS PRIVATE L IMITED BANG-ICIJ212720008307,,,net_banking_transfer,642.85
61b7084ad8beac1599eb7968,50200023535069,274081.7,60ec41ba55c00300382672d9,HDFC,Revenue-Mktplace,5eecc6d6449e4f7cfb1c2708,2021-09-29T00:00:00.000Z,NEFT CR-ICIC0000105-ICICI BANK NODAL AC MANASH LIFESTYL-SLICK ORGANICS PRIVATE L IMITED MP G-ICIJ212720008303,,,net_banking_transfer,3623.29
61b7084bd8beac1599eb796e,50200023535069,274163.08,60ec41ba55c00300382672d9,HDFC,Revenue-Mktplace,5eecc6d6449e4f7cfb1c2708,2021-09-29T00:00:00.000Z,NEFT CR-ICIC0000105-ICICI BANK NODAL AC MANASH LIFESTYL-SLICK ORGANICS PRIVATE L IMITED KOLK-ICIJ212720008306,,,net_banking_transfer,81.38
61b7084cd8beac1599eb7974,50200023535069,275069.92,60ec41ba55c00300382672d9,HDFC,Revenue-PG-split enabled,5eecc6d6449e4f7cfb1c2708,2021-09-29T00:00:00.000Z,NEFT CR-UTIB0001506-RAZORPAY SOFTWARE PR IVATE LIMITED-SLICKORGANICSPVTLITD-AXISC N0094691682,insurance,,net_banking_transfer,906.84
61b7084dd8beac1599eb7978,50200023535069,276787.61,60ec41ba55c00300382672d9,HDFC,Revenue-PG-non-split,5eecc6d6449e4f7cfb1c2708,2021-09-29T00:00:00.000Z,NEFT CR-IDFB0010204-SEZZLE PAYMENTS PRIV ATE LIMITED-SLICK ORGANICS PRIVATE LIMIT ED-IDFBH21272820402,insurance,,net_banking_transfer,1717.69
61b7084ed8beac1599eb7981,50200023535069,314810.45,60ec41ba55c00300382672d9,HDFC,Revenue-COD,5eecc6d6449e4f7cfb1c2708,2021-09-29T00:00:00.000Z,NEFT CR-ICIC0000155-SHIPROCKET COD CRF I D 3135490-SLICK ORGANICS PVT LTD-CMS2153 865957,insurance,,net_banking_transfer,38022.84
61b7084fd8beac1599eb7986,50200023535069,814810.45,60ec41ba55c00300382672d9,HDFC,Internal Transfers,5eecc6d6449e4f7cfb1c2708,2021-09-29T00:00:00.000Z,IB FUNDS TRANSFER CR-50200035187206 -SL ICK ORGANICS PVT LTD,insurance,,Other,500000
61b70850d8beac1599eb798c,50200023535069,114810.45,60ec41ba55c00300382672d9,HDFC,direct expenses,5eecc6d6449e4f7cfb1c2708,2021-09-29T00:00:00.000Z,"NEFT DR-YESB0000551-VISTTA COSMETICS-NET BANK, MUM-N272211653503084-700000",,,net_banking_transfer,-700000
61b70851d8beac1599eb798f,50200023535069,128949.72,60ec41ba55c00300382672d9,HDFC,Revenue-PG-non-split,5eecc6d6449e4f7cfb1c2708,2021-09-30T00:00:00.000Z,IMPS-127304849656-PAYTM PAYMENTS SERVI-H DFC-XXXXXXXXXX0008-ALL202109302168200003 30830668628,ewallet,,net_banking_transfer,14139.27
61b70852d8beac1599eb7994,50200023535069,131204.38,60ec41ba55c00300382672d9,HDFC,Revenue-PG-split enabled,5eecc6d6449e4f7cfb1c2708,2021-09-30T00:00:00.000Z,NEFT CR-UTIB0001506-RAZORPAY SOFTWARE PR IVATE LIMITED-SLICKORGANICSPVTLITD-AXISC N0094765166,insurance,,net_banking_transfer,2254.66
61b70853d8beac1599eb799e,50200023535069,91204.38,60ec41ba55c00300382672d9,HDFC,direct expenses,5eecc6d6449e4f7cfb1c2708,2021-09-30T00:00:00.000Z,IMPS-127312124640-PAYTM-PYTM-XXXXXXXX383 9-40000,ewallet,,net_banking_transfer,-40000
61b70854d8beac1599eb79a3,50200023535069,93293.32,60ec41ba55c00300382672d9,HDFC,Revenue-PG-non-split,5eecc6d6449e4f7cfb1c2708,2021-09-30T00:00:00.000Z,NEFT CR-IDFB0010204-SEZZLE PAYMENTS PRIV,,,net_banking_transfer,2088.94
61b70855d8beac1599eb79a7,50200023535069,127062.63,60ec41ba55c00300382672d9,HDFC,Revenue-PG-non-split,5eecc6d6449e4f7cfb1c2708,2021-10-01T00:00:00.000Z,IMPS-127405109688-PAYTM PAYMENTS SERVI-H DFC-XXXXXXXXXX0008-ALL202110012168200003 30830668628,ewallet,,net_banking_transfer,33769.31
61b70856d8beac1599eb79ac,50200023535069,130612.69,60ec41ba55c00300382672d9,HDFC,Revenue-PG-split enabled,5eecc6d6449e4f7cfb1c2708,2021-10-01T00:00:00.000Z,NEFT CR-UTIB0001506-RAZORPAY SOFTWARE PR IVATE LIMITED-SLICKORGANICSPVTLITD-AXISC N0094909088,insurance,,net_banking_transfer,3550.06
61b70857d8beac1599eb79af,50200023535069,137719.61,60ec41ba55c00300382672d9,HDFC,Revenue-Mktplace,5eecc6d6449e4f7cfb1c2708,2021-10-01T00:00:00.000Z,NEFT CR-DEUT0797BGL-FLIPKART INTERNET PR IVATE LIMITED-SLICK ORGANICS PVT LTD-127 400110GN00271,shopping,,net_banking_transfer,7106.92
61b70858d8beac1599eb79b8,50200023535069,155981.49,60ec41ba55c00300382672d9,HDFC,Revenue-Mktplace,5eecc6d6449e4f7cfb1c2708,2021-10-01T00:00:00.000Z,NEFT CR-DEUT0797BGL-FLIPKART INTERNET PR IVATE LIMITED-SLICK ORGANICS PVT LTD-127 400117GN00060,shopping,,net_banking_transfer,18261.88
61b70858d8beac1599eb79bd,50200023535069,1155981.49,60ec41ba55c00300382672d9,HDFC,Internal Transfers,5eecc6d6449e4f7cfb1c2708,2021-10-01T00:00:00.000Z,IB FUNDS TRANSFER CR-50200035187206 -SL ICK ORGANICS PVT LTD,insurance,,Other,1000000
61b70859d8beac1599eb79c3,50200023535069,155981.49,60ec41ba55c00300382672d9,HDFC,Marketing Expense,5eecc6d6449e4f7cfb1c2708,2021-10-01T00:00:00.000Z,"NEFT DR-CITI0000006-FACEBOOK INDIA ONLIN E SERVICES PVT LTD-NETBANK, MUM-N2742116 55872799-1000000",,,net_banking_transfer,-1000000
61b7085ad8beac1599eb79c9,50200023535069,159737.32,60ec41ba55c00300382672d9,HDFC,Revenue-PG-split enabled,5eecc6d6449e4f7cfb1c2708,2021-10-01T00:00:00.000Z,NEFT CR-UTIB0001506-RAZORPAY SOFTWARE PR IVATE LIMITED-SLICKORGANICSPVTLITD-AXISC N0095065823,insurance,,net_banking_transfer,3755.83
61b7085bd8beac1599eb79ce,50200023535069,3159737.32,60ec41ba55c00300382672d9,HDFC,Investments-New,5eecc6d6449e4f7cfb1c2708,2021-10-01T00:00:00.000Z,02711930004579-TPT-3000000-DHRUV BHASIN,,,net_banking_transfer,3000000
61b7085cd8beac1599eb79d1,50200023535069,3157261.8,60ec41ba55c00300382672d9,HDFC,direct expenses,5eecc6d6449e4f7cfb1c2708,2021-10-01T00:00:00.000Z,POS 514834XXXXXX9486 RAZ*KNOWLARITY,,,debit_card,-2475.52
61b7085dd8beac1599eb79d9,50200023535069,2357261.8,60ec41ba55c00300382672d9,HDFC,Tax,5eecc6d6449e4f7cfb1c2708,2021-10-01T00:00:00.000Z,051030801102111455- CBDT TAX,,,Other,-800000
61b7085ed8beac1599eb79e7,50200023535069,1837261.8,60ec41ba55c00300382672d9,HDFC,Tax,5eecc6d6449e4f7cfb1c2708,2021-10-01T00:00:00.000Z,051030801102111542- CBDT TAX,,,Other,-520000
61b7085fd8beac1599eb79ec,50200023535069,1520632.8,60ec41ba55c00300382672d9,HDFC,direct expenses,5eecc6d6449e4f7cfb1c2708,2021-10-01T00:00:00.000Z,02711600008220-TPT-316629-VARUN SINGH,,,net_banking_transfer,-316629
61b70860d8beac1599eb79f2,50200023535069,1518480.1,60ec41ba55c00300382672d9,HDFC,direct expenses,5eecc6d6449e4f7cfb1c2708,2021-10-01T00:00:00.000Z,POS 514834XXXXXX9486 SEOPTIMER,,,debit_card,-2152.7
61b70861d8beac1599eb79fc,50200023535069,763480.1,60ec41ba55c00300382672d9,HDFC,SAAS/tech expense,5eecc6d6449e4f7cfb1c2708,2021-10-01T00:00:00.000Z,KQSX24UNAZ7KBNGVCI/PAYUAMAZON,shopping,,Other,-755000
61b70862d8beac1599eb7a03,50200023535069,883483.1,60ec41ba55c00300382672d9,HDFC,Revenue-Mktplace,5eecc6d6449e4f7cfb1c2708,2021-10-01T00:00:00.000Z,NEFT CR-KKBK0000958-SURFBOATS SOLUTIONS,,,net_banking_transfer,120003
61b70863d8beac1599eb7a07,50200023535069,884127.98,60ec41ba55c00300382672d9,HDFC,Revenue-COD,5eecc6d6449e4f7cfb1c2708,2021-10-01T00:00:00.000Z,NEFT CR-ICIC0000155-SHIPROCKET COD CRF I D 3155887-SLICK ORGANICS PVT LTD-CMS2159 446414,insurance,,net_banking_transfer,644.88
61b70864d8beac1599eb7a1f,50200023535069,884391.86,60ec41ba55c00300382672d9,HDFC,Revenue-Mktplace,5eecc6d6449e4f7cfb1c2708,2021-10-01T00:00:00.000Z,NEFT CR-ICIC0000105-ICICI BANK NODAL AC MANASH LIFESTYL-SLICK ORGANICS PRIVATE L IMITED KOLK-ICIJ212740008674,,,net_banking_transfer,263.88
61b70865d8beac1599eb7a23,50200023535069,885327.92,60ec41ba55c00300382672d9,HDFC,Revenue-Mktplace,5eecc6d6449e4f7cfb1c2708,2021-10-01T00:00:00.000Z,NEFT CR-ICIC0000105-ICICI BANK NODAL AC MANASH LIFESTYL-SLICK ORGANICS PRIVATE L IMITED MP M-ICIJ212740008672,,,net_banking_transfer,936.06
61b70866d8beac1599eb7a27,50200023535069,886922.95,60ec41ba55c00300382672d9,HDFC,Revenue-Mktplace,5eecc6d6449e4f7cfb1c2708,2021-10-01T00:00:00.000Z,NEFT CR-ICIC0000105-ICICI BANK NODAL AC MANASH LIFESTYL-SLICK ORGANICS PRIVATE L IMITED MP G-ICIJ212740008808,,,net_banking_transfer,1595.03
61b70867d8beac1599eb7a2e,50200023535069,887449.27,60ec41ba55c00300382672d9,HDFC,Revenue-Mktplace,5eecc6d6449e4f7cfb1c2708,2021-10-01T00:00:00.000Z,NEFT CR-ICIC0000105-ICICI BANK NODAL AC MANASH LIFESTYL-SLICK ORGANICS PRIVATE L IMITED BANG-ICIJ212740008676,,,net_banking_transfer,526.32
61b70868d8beac1599eb7a32,50200023535069,899880.97,60ec41ba55c00300382672d9,HDFC,Revenue-PG-split enabled,5eecc6d6449e4f7cfb1c2708,2021-10-01T00:00:00.000Z,NEFT CR-UTIB0001506-RAZORPAY SOFTWARE PR IVATE LIMITED-SLICKORGANICSPVTLITD-AXISC N0095241782,insurance,,net_banking_transfer,12431.7
61b70869d8beac1599eb7a37,50200023535069,779880.97,60ec41ba55c00300382672d9,HDFC,direct expenses,5eecc6d6449e4f7cfb1c2708,2021-10-01T00:00:00.000Z,"NEFT DR-PYTM0123456-PAYTM-NETBANK, MUM-N 274211657847866-120000",ewallet,,net_banking_transfer,-120000
61b7086ad8beac1599eb7a3e,50200023535069,697380.97,60ec41ba55c00300382672d9,HDFC,direct expenses,5eecc6d6449e4f7cfb1c2708,2021-10-01T00:00:00.000Z,"NEFT DR-KKBK0005289-HILL GROOVE CONSULTI NG LLP-NETBANK, MUM-N274211657849874-825 00",,,net_banking_transfer,-82500
61b7086bd8beac1599eb7a45,50200023535069,713881.92,60ec41ba55c00300382672d9,HDFC,Revenue-PG-non-split,5eecc6d6449e4f7cfb1c2708,2021-10-02T00:00:00.000Z,IMPS-127505644615-PAYTM PAYMENTS SERVI-H DFC-XXXXXXXXXX0008-ALL202110022168200003 30830668628,ewallet,,net_banking_transfer,16500.95
61b7086cd8beac1599eb7a56,50200023535069,716247.22,60ec41ba55c00300382672d9,HDFC,Transfer in/Revenue-other,5eecc6d6449e4f7cfb1c2708,2021-10-02T00:00:00.000Z,50200050675669-TPT-REMITTANCE OGSEP21-HO UZ OF NATURE PVT LTD,,,net_banking_transfer,2365.3
61b7086dd8beac1599eb7a64,50200023535069,666247.22,60ec41ba55c00300382672d9,HDFC,direct expenses,5eecc6d6449e4f7cfb1c2708,2021-10-02T00:00:00.000Z,POS 514834XXXXXX9486 FLIPKART,shopping,,debit_card,-50000
61b7086ed8beac1599eb7a71,50200023535069,704642.84,60ec41ba55c00300382672d9,HDFC,Revenue-PG-non-split,5eecc6d6449e4f7cfb1c2708,2021-10-03T00:00:00.000Z,IMPS-127605112838-PAYTM PAYMENTS SERVI-H,ewallet,,net_banking_transfer,38395.62
61b7086fd8beac1599eb7a7e,50200023535069,704969.67,60ec41ba55c00300382672d9,HDFC,Transfer in/Revenue-other,5eecc6d6449e4f7cfb1c2708,2021-10-04T00:00:00.000Z,NEFT CR-ICIC0SF0002-ICICI BANK NODAL A-C -SLICK ORGANICS-25134619171DC,insurance,,net_banking_transfer,326.83
61b70870d8beac1599eb7a8d,50200023535069,726286,60ec41ba55c00300382672d9,HDFC,Revenue-PG-non-split,5eecc6d6449e4f7cfb1c2708,2021-10-04T00:00:00.000Z,IMPS-127704436342-PAYTM PAYMENTS SERVI-H DFC-XXXXXXXXXX0008-ALL202110042168200003 30830668628,ewallet,,net_banking_transfer,21316.33
61b70871d8beac1599eb7a9a,50200023535069,510286,60ec41ba55c00300382672d9,HDFC,direct expenses,5eecc6d6449e4f7cfb1c2708,2021-10-04T00:00:00.000Z,"NEFT DR-UTIB0000514-NATS ASSOCIATES-NETB ANK, MUM-N277211658941269-216000",,,net_banking_transfer,-216000
61b70871d8beac1599eb7aa2,50200023535069,540285.75,60ec41ba55c00300382672d9,HDFC,Revenue-Mktplace,5eecc6d6449e4f7cfb1c2708,2021-10-04T00:00:00.000Z,NEFT CR-DEUT0797BGL-FLIPKART INTERNET PR IVATE LIMITED-SLICK ORGANICS PVT LTD-127 700142GN00112,shopping,,net_banking_transfer,29999.75
61b70872d8beac1599eb7aa7,50200023535069,565628.27,60ec41ba55c00300382672d9,HDFC,Revenue-PG-split enabled,5eecc6d6449e4f7cfb1c2708,2021-10-04T00:00:00.000Z,NEFT CR-UTIB0001506-RAZORPAY SOFTWARE PR IVATE LIMITED-SLICKORGANICSPVTLITD-AXISC N0095674915,insurance,,net_banking_transfer,25342.52
61b70873d8beac1599eb7ab5,50200023535069,65628.27,60ec41ba55c00300382672d9,HDFC,direct expenses,5eecc6d6449e4f7cfb1c2708,2021-10-04T00:00:00.000Z,"NEFT DR-ICIC0000369-BO INTERNATIONAL-NET BANK, MUM-N277211659056776-500000",,,net_banking_transfer,-500000
61b70874d8beac1599eb7aba,50200023535069,67834.36,60ec41ba55c00300382672d9,HDFC,Transfer in/Revenue-other,5eecc6d6449e4f7cfb1c2708,2021-10-04T00:00:00.000Z,FT - C76365041021034808 - - 50200050045 240 - ZOOBOP ME WORKS PRIVATE LIMITED,,,Other,2206.09
61b70875d8beac1599eb7ac1,50200023535069,68866.84,60ec41ba55c00300382672d9,HDFC,Transfer in/Revenue-other,5eecc6d6449e4f7cfb1c2708,2021-10-04T00:00:00.000Z,ZOOBOP ME WORK-ARATA,,,Other,1032.48
61b70876d8beac1599eb7aca,50200023535069,72372.96,60ec41ba55c00300382672d9,HDFC,Revenue-PG-non-split,5eecc6d6449e4f7cfb1c2708,2021-10-04T00:00:00.000Z,NEFT CR-SCBL0036001-STRIPE INDIA PRIVATE -SLICK ORGANICS PRIVATE LIMITED-SSG17413 Q0411565,insurance,,net_banking_transfer,3506.12
61b70877d8beac1599eb7ad2,50200023535069,572372.96,60ec41ba55c00300382672d9,HDFC,Internal Transfers,5eecc6d6449e4f7cfb1c2708,2021-10-04T00:00:00.000Z,IB FUNDS TRANSFER CR-50200035187206 -SL ICK ORGANICS PVT LTD,insurance,,Other,500000
61b70878d8beac1599eb7ada,50200023535069,347372.96,60ec41ba55c00300382672d9,HDFC,direct expenses,5eecc6d6449e4f7cfb1c2708,2021-10-04T00:00:00.000Z,"NEFT DR-SCBL0036025-DHRUV MADHOK-NETBANK , MUM-N277211659625770-225000",,,net_banking_transfer,-225000
61b70879d8beac1599eb7ade,50200023535069,290372.96,60ec41ba55c00300382672d9,HDFC,direct expenses,5eecc6d6449e4f7cfb1c2708,2021-10-04T00:00:00.000Z,"NEFT DR-ICIC0002451-SOUTH COURT CONDOMIN IUM ASSOCIATION-NETBANK, MUM-N2772116596 29147-57000",,,net_banking_transfer,-57000
61b7087ad8beac1599eb7ae5,50200023535069,291096.88,60ec41ba55c00300382672d9,HDFC,Revenue-PG-non-split,5eecc6d6449e4f7cfb1c2708,2021-10-04T00:00:00.000Z,NEFT CR-IDFB0010204-SEZZLE PAYMENTS PRIV ATE LIMITED-SLICK ORGANICS PRIVATE LIMIT ED-IDFBH21277172643,insurance,,net_banking_transfer,723.92
61b7087bd8beac1599eb7aef,50200023535069,291447.26,60ec41ba55c00300382672d9,HDFC,Revenue-Mktplace,5eecc6d6449e4f7cfb1c2708,2021-10-04T00:00:00.000Z,NEFT CR-ICIC0000105-MANASH LIFETYLE PVT,,,net_banking_transfer,350.38
61b7087cd8beac1599eb7af3,50200023535069,293656.55,60ec41ba55c00300382672d9,HDFC,Revenue-Mktplace,5eecc6d6449e4f7cfb1c2708,2021-10-04T00:00:00.000Z,NEFT CR-ICIC0000105-MANASH LIFETYLE PVT LTD-SLICKORGANICSPRIVATELIMITEDBANGALORE -ICIB212770033072,,,net_banking_transfer,2209.29
61b7087dd8beac1599eb7af9,50200023535069,294221.69,60ec41ba55c00300382672d9,HDFC,Revenue-Mktplace,5eecc6d6449e4f7cfb1c2708,2021-10-04T00:00:00.000Z,NEFT CR-ICIC0000105-MANASH LIFETYLE PVT LTD-SLICKORGANICSPRIVATELIMITEDHYD-ICIB2 12770033070,,,net_banking_transfer,565.14
61b7087ed8beac1599eb7b00,50200023535069,294383.65,60ec41ba55c00300382672d9,HDFC,Revenue-Mktplace,5eecc6d6449e4f7cfb1c2708,2021-10-04T00:00:00.000Z,NEFT CR-ICIC0000105-MANASH LIFETYLE PVT LTD-SLICKORGANICSPRIVATELIMITEDMPGGN-ICI B212770033064,,,net_banking_transfer,161.96
61b7087fd8beac1599eb7b05,50200023535069,296434.62,60ec41ba55c00300382672d9,HDFC,Revenue-Mktplace,5eecc6d6449e4f7cfb1c2708,2021-10-04T00:00:00.000Z,NEFT CR-ICIC0000105-MANASH LIFETYLE PVT LTD-SLICKORGANICSPRIVATELIMITEDMPMUM-ICI B212770033066,,,net_banking_transfer,2050.97
61b70880d8beac1599eb7b10,50200023535069,276434.62,60ec41ba55c00300382672d9,HDFC,Marketing Expense,5eecc6d6449e4f7cfb1c2708,2021-10-04T00:00:00.000Z,POS 514834XXXXXX9486 GOOGLE WORKSPACE,,,debit_card,-20000
61b70881d8beac1599eb7b15,50200023535069,302086.03,60ec41ba55c00300382672d9,HDFC,Revenue-PG-split enabled,5eecc6d6449e4f7cfb1c2708,2021-10-04T00:00:00.000Z,NEFT CR-UTIB0001506-RAZORPAY SOFTWARE PR IVATE LIMITED-SLICKORGANICSPVTLITD-AXISC N0095820646,insurance,,net_banking_transfer,25651.41
61b70882d8beac1599eb7b1e,50200023535069,327386.03,60ec41ba55c00300382672d9,HDFC,Revenue-Mktplace,5eecc6d6449e4f7cfb1c2708,2021-10-04T00:00:00.000Z,NEFT CR-SCBL0036001-M/S DREAMPLUG TECHNO -SLICK ORGANICS PRIVATE LIMITEDSLICK-SIN 31436Q0021957,insurance,,net_banking_transfer,25300
61b70883d8beac1599eb7b25,50200023535069,431817.03,60ec41ba55c00300382672d9,HDFC,Revenue-COD,5eecc6d6449e4f7cfb1c2708,2021-10-04T00:00:00.000Z,NEFT CR-KKBK0000958-PICKRR TECHNOLOGIES PVT LTD-SLICKORGANICSPRIVATELIMITED-CMS2 772101668143,insurance,,net_banking_transfer,104431
61b70884d8beac1599eb7b28,50200023535069,425817.03,60ec41ba55c00300382672d9,HDFC,direct expenses,5eecc6d6449e4f7cfb1c2708,2021-10-04T00:00:00.000Z,POS 514834XXXXXX9486 PAYU GURGAON,,,debit_card,-6000
61b70885d8beac1599eb7b30,50200023535069,420817.03,60ec41ba55c00300382672d9,HDFC,direct expenses,5eecc6d6449e4f7cfb1c2708,2021-10-04T00:00:00.000Z,POS 514834XXXXXX9486 SHIPROCKET,,,debit_card,-5000
61b70886d8beac1599eb7b35,50200023535069,420819.03,60ec41ba55c00300382672d9,HDFC,Transfer in/Revenue-other,5eecc6d6449e4f7cfb1c2708,2021-10-04T00:00:00.000Z,CRV POS 514834******9486 GOOGLE ADS,,,refund,2
61b70887d8beac1599eb7b3b,50200023535069,461789.57,60ec41ba55c00300382672d9,HDFC,Revenue-PG-non-split,5eecc6d6449e4f7cfb1c2708,2021-10-05T00:00:00.000Z,IMPS-127805144915-PAYTM PAYMENTS SERVI-H DFC-XXXXXXXXXX0008-ALL202110052168200003 30830668628,ewallet,,net_banking_transfer,40970.54
61b70888d8beac1599eb7b40,50200023535069,530649.39,60ec41ba55c00300382672d9,HDFC,Revenue-Mktplace,5eecc6d6449e4f7cfb1c2708,2021-10-05T00:00:00.000Z,IMPS-127805396709-AMAZON SELLER SERVIC-H,shopping,,net_banking_transfer,68859.82
61b70888d8beac1599eb7b64,50200023535069,683512.4,60ec41ba55c00300382672d9,HDFC,Revenue-Mktplace,5eecc6d6449e4f7cfb1c2708,2021-10-05T00:00:00.000Z,NEFT CR-DEUT0797BGL-AMAZON PAY (INDIA) P RIVATE LIMITED-SLICK ORGANICS PVT LTD-12 7800039GN00179,shopping,,net_banking_transfer,152863.01
61b70889d8beac1599eb7b6b,50200023535069,663512.4,60ec41ba55c00300382672d9,HDFC,direct expenses,5eecc6d6449e4f7cfb1c2708,2021-10-05T00:00:00.000Z,SARVAN KUMAR - CHQ PAID - DEVLI ROAD K,,,chq,-20000
61b7088ad8beac1599eb7b71,50200023535069,652620.4,60ec41ba55c00300382672d9,HDFC,direct expenses,5eecc6d6449e4f7cfb1c2708,2021-10-05T00:00:00.000Z,50200043297657-TPT-10892-AIDC PRODUCTS I NDIA PRIVATE LIMITED,,,net_banking_transfer,-10892
61b7088bd8beac1599eb7b75,50200023535069,669098.51,60ec41ba55c00300382672d9,HDFC,Revenue-PG-split enabled,5eecc6d6449e4f7cfb1c2708,2021-10-05T00:00:00.000Z,NEFT CR-UTIB0001506-RAZORPAY SOFTWARE PR IVATE LIMITED-SLICKORGANICSPVTLITD-AXISC N0096102475,insurance,,net_banking_transfer,16478.11
61b7088cd8beac1599eb7b7c,50200023535069,878530.21,60ec41ba55c00300382672d9,HDFC,Transfer in/Revenue-other,5eecc6d6449e4f7cfb1c2708,2021-10-05T00:00:00.000Z,NEFT CR-KKBK0000958-ARHAM INTERNATIONAL- SLICK ORGANICS PVT LTD-CMS2782101731391,insurance,,net_banking_transfer,209431.7
61b7088dd8beac1599eb7b7e,50200023535069,880584.67,60ec41ba55c00300382672d9,HDFC,Revenue-PG-non-split,5eecc6d6449e4f7cfb1c2708,2021-10-05T00:00:00.000Z,NEFT CR-IDFB0010204-SEZZLE PAYMENTS PRIV ATE LIMITED-SLICK ORGANICS PRIVATE LIMIT ED-IDFBH21278264343,insurance,,net_banking_transfer,2054.46
61b7088ed8beac1599eb7b85,50200023535069,899075.14,60ec41ba55c00300382672d9,HDFC,Revenue-PG-non-split,5eecc6d6449e4f7cfb1c2708,2021-10-06T00:00:00.000Z,IMPS-127904596839-PAYTM PAYMENTS SERVI-H DFC-XXXXXXXXXX0008-ALL202110062168200003 30830668628,ewallet,,net_banking_transfer,18490.47
61b7088fd8beac1599eb7b8d,50200023535069,914719.97,60ec41ba55c00300382672d9,HDFC,Revenue-Mktplace,5eecc6d6449e4f7cfb1c2708,2021-10-06T00:00:00.000Z,NEFT CR-DEUT0797BGL-FLIPKART INTERNET PR IVATE LIMITED-SLICK ORGANICS PVT LTD-127 900626GN00293,shopping,,net_banking_transfer,15644.83
61b70890d8beac1599eb7b90,50200023535069,905388.39,60ec41ba55c00300382672d9,HDFC,direct expenses,5eecc6d6449e4f7cfb1c2708,2021-10-06T00:00:00.000Z,"POS 514834XXXXXX9486 IN *CLEARFORME,",,,debit_card,-9331.58
61b70891d8beac1599eb7b94,50200023535069,805388.39,60ec41ba55c00300382672d9,HDFC,direct expenses,5eecc6d6449e4f7cfb1c2708,2021-10-06T00:00:00.000Z,"NEFT DR-PYTM0123456-PAYTM-NETBANK, MUM-N 279211662931459-100000",ewallet,,net_banking_transfer,-100000
61b70892d8beac1599eb7b9a,50200023535069,550388.39,60ec41ba55c00300382672d9,HDFC,direct expenses,5eecc6d6449e4f7cfb1c2708,2021-10-06T00:00:00.000Z,02711600008220-TPT-255000-VARUN SINGH,,,net_banking_transfer,-255000
61b70893d8beac1599eb7b9f,50200023535069,540388.39,60ec41ba55c00300382672d9,HDFC,Tax,5eecc6d6449e4f7cfb1c2708,2021-10-06T00:00:00.000Z,051030806102128851- CBDT TAX,,,Other,-10000
61b70894d8beac1599eb7ba6,50200023535069,543592.41,60ec41ba55c00300382672d9,HDFC,Revenue-PG-non-split,5eecc6d6449e4f7cfb1c2708,2021-10-06T00:00:00.000Z,NEFT CR-IDFB0010204-SEZZLE PAYMENTS PRIV ATE LIMITED-SLICK ORGANICS PRIVATE LIMIT ED-IDFBH21279324403,insurance,,net_banking_transfer,3204.02
61b70895d8beac1599eb7ba9,50200023535069,546095.83,60ec41ba55c00300382672d9,HDFC,Revenue-PG-split enabled,5eecc6d6449e4f7cfb1c2708,2021-10-06T00:00:00.000Z,NEFT CR-UTIB0001506-RAZORPAY SOFTWARE PR,,,net_banking_transfer,2503.42
61b70896d8beac1599eb7bae,50200023535069,547615.37,60ec41ba55c00300382672d9,HDFC,Revenue-Mktplace,5eecc6d6449e4f7cfb1c2708,2021-10-06T00:00:00.000Z,NEFT CR-ICIC0000105-ICICI BANK NODAL AC MANASH LIFESTYL-SLICK ORGANICS PRIVATE L IMITED MP G-ICIJ212790014930,,,net_banking_transfer,1519.54
61b70897d8beac1599eb7bb3,50200023535069,547801.56,60ec41ba55c00300382672d9,HDFC,Revenue-Mktplace,5eecc6d6449e4f7cfb1c2708,2021-10-06T00:00:00.000Z,NEFT CR-ICIC0000105-ICICI BANK NODAL AC MANASH LIFESTYL-SLICK ORGANICS PRIVATE L IMITED BANG-ICIJ212790013766,,,net_banking_transfer,186.19
61b70898d8beac1599eb7bb6,50200023535069,410301.56,60ec41ba55c00300382672d9,HDFC,Marketing Expense,5eecc6d6449e4f7cfb1c2708,2021-10-06T00:00:00.000Z,POS 514834XXXXXX9486 GOOGLE ADS,,,debit_card,-137500
61b70899d8beac1599eb7bbe,50200023535069,431627.95,60ec41ba55c00300382672d9,HDFC,Revenue-PG-non-split,5eecc6d6449e4f7cfb1c2708,2021-10-07T00:00:00.000Z,IMPS-128004026562-PAYTM PAYMENTS SERVI-H DFC-XXXXXXXXXX0008-ALL202110072168200003 30830668628,ewallet,,net_banking_transfer,21326.39
61b7089ad8beac1599eb7bc2,50200023535069,341047.95,60ec41ba55c00300382672d9,HDFC,direct expenses,5eecc6d6449e4f7cfb1c2708,2021-10-07T00:00:00.000Z,"NEFT DR-ICIC0000542-AVANTIKA SUKHIA-NETB ANK, MUM-N280211664306576-90580",,,net_banking_transfer,-90580
61b7089bd8beac1599eb7bc7,50200023535069,291047.95,60ec41ba55c00300382672d9,HDFC,direct expenses,5eecc6d6449e4f7cfb1c2708,2021-10-07T00:00:00.000Z,"NEFT DR-UTIB0000120-ADNAN ALI-NETBANK, M UM-N280211664332018-50000",,,net_banking_transfer,-50000
61b7089cd8beac1599eb7bce,50200023535069,251047.95,60ec41ba55c00300382672d9,HDFC,direct expenses,5eecc6d6449e4f7cfb1c2708,2021-10-07T00:00:00.000Z,"NEFT DR-ICIC0003374-SIDDHARTH KANOJIA-NE TBANK, MUM-N280211664335440-40000",,,net_banking_transfer,-40000
61b7089dd8beac1599eb7bd2,50200023535069,229547.95,60ec41ba55c00300382672d9,HDFC,direct expenses,5eecc6d6449e4f7cfb1c2708,2021-10-07T00:00:00.000Z,"NEFT DR-SIBL0000555-JAIVEER KUMAR-NETBAN K, MUM-N280211664335581-21500",,,net_banking_transfer,-21500
61b7089ed8beac1599eb7bdd,50200023535069,193547.95,60ec41ba55c00300382672d9,HDFC,direct expenses,5eecc6d6449e4f7cfb1c2708,2021-10-07T00:00:00.000Z,00901610080520-TPT-36000-POOJA KAPIL SHR OTRIYA,,,net_banking_transfer,-36000
61b7089ed8beac1599eb7be0,50200023535069,96881.95,60ec41ba55c00300382672d9,HDFC,direct expenses,5eecc6d6449e4f7cfb1c2708,2021-10-07T00:00:00.000Z,"NEFT DR-ICIC0000021-AKHILESH DIXIT-NETBA NK, MUM-N280211664333511-96666",,,net_banking_transfer,-96666
61b7089fd8beac1599eb7be4,50200023535069,61881.95,60ec41ba55c00300382672d9,HDFC,direct expenses,5eecc6d6449e4f7cfb1c2708,2021-10-07T00:00:00.000Z,50100064106714-TPT-35000-AKSHARANSH BHAT T,,,net_banking_transfer,-35000
61b708a0d8beac1599eb7be8,50200023535069,6381.95,60ec41ba55c00300382672d9,HDFC,direct expenses,5eecc6d6449e4f7cfb1c2708,2021-10-07T00:00:00.000Z,50100293329616-TPT-55500-SADIYA BANO,,,net_banking_transfer,-55500
61b708a1d8beac1599eb7bed,50200023535069,215381.95,60ec41ba55c00300382672d9,HDFC,Internal Transfers,5eecc6d6449e4f7cfb1c2708,2021-10-07T00:00:00.000Z,IB FUNDS TRANSFER CR-50200035187206 -SL ICK ORGANICS PVT LTD,insurance,,Other,209000
61b708a2d8beac1599eb7bf1,50200023535069,200845.95,60ec41ba55c00300382672d9,HDFC,direct expenses,5eecc6d6449e4f7cfb1c2708,2021-10-07T00:00:00.000Z,"NEFT DR-PUNB0151400-BHUWAN CHANDER JOSHI -NETBANK, MUM-N280211664336264-14536",,,net_banking_transfer,-14536
61b708a3d8beac1599eb7bf9,50200023535069,83845.95,60ec41ba55c00300382672d9,HDFC,direct expenses,5eecc6d6449e4f7cfb1c2708,2021-10-07T00:00:00.000Z,"NEFT DR-BARB0VJMATU-ARTISTO DESIGNZ-NETB ANK, MUM-N280211664342608-117000",,,net_banking_transfer,-117000
61b708a4d8beac1599eb7bfb,50200023535069,35245.95,60ec41ba55c00300382672d9,HDFC,direct expenses,5eecc6d6449e4f7cfb1c2708,2021-10-07T00:00:00.000Z,NEFT DR-CNRB0015170-SNEHAL TAYDE-NETBANK,,,net_banking_transfer,-48600
61b708a5d8beac1599eb7c01,50200023535069,20709.95,60ec41ba55c00300382672d9,HDFC,direct expenses,5eecc6d6449e4f7cfb1c2708,2021-10-07T00:00:00.000Z,02711600008220-TPT-14536-VARUN SINGH,,,net_banking_transfer,-14536
61b708a6d8beac1599eb7c08,50200023535069,17532.95,60ec41ba55c00300382672d9,HDFC,direct expenses,5eecc6d6449e4f7cfb1c2708,2021-10-07T00:00:00.000Z,50100097355028-TPT-3177-PALLAVI JUNEJA,,,net_banking_transfer,-3177
61b708a7d8beac1599eb7c18,50200023535069,20431.33,60ec41ba55c00300382672d9,HDFC,Revenue-PG-split enabled,5eecc6d6449e4f7cfb1c2708,2021-10-07T00:00:00.000Z,NEFT CR-UTIB0001506-RAZORPAY SOFTWARE PR IVATE LIMITED-SLICKORGANICSPVTLITD-AXISC N0096496738,insurance,,net_banking_transfer,2898.38
61b708a8d8beac1599eb7c1f,50200023535069,25431.33,60ec41ba55c00300382672d9,HDFC,Internal Transfers,5eecc6d6449e4f7cfb1c2708,2021-10-07T00:00:00.000Z,IB FUNDS TRANSFER CR-50200035187206 -SL ICK ORGANICS PVT LTD,insurance,,Other,5000
61b708a9d8beac1599eb7c23,50200023535069,20431.33,60ec41ba55c00300382672d9,HDFC,direct expenses,5eecc6d6449e4f7cfb1c2708,2021-10-07T00:00:00.000Z,"NEFT DR-PYTM0123456-PAYTM-NETBANK, MUM-N 280211664477556-5000",ewallet,,net_banking_transfer,-5000
61b708aad8beac1599eb7c28,50200023535069,60431.33,60ec41ba55c00300382672d9,HDFC,Internal Transfers,5eecc6d6449e4f7cfb1c2708,2021-10-07T00:00:00.000Z,IB FUNDS TRANSFER CR-50200050976833 -SL ICK ORGANICS PVT LTD,insurance,,Other,40000
61b708abd8beac1599eb7c2c,50200023535069,6441.33,60ec41ba55c00300382672d9,HDFC,SAAS/tech expense,5eecc6d6449e4f7cfb1c2708,2021-10-07T00:00:00.000Z,POS 514834XXXXXX9486 AMAZON,shopping,,debit_card,-53990
61b708acd8beac1599eb7c36,50200023535069,13984.33,60ec41ba55c00300382672d9,HDFC,Transfer in/Revenue-other,5eecc6d6449e4f7cfb1c2708,2021-10-07T00:00:00.000Z,NEFT CR-KKBK0000958-EKANEK NETWORKS PRIV ATE LIMITED-SLICK ORGANICS PVT LTD-KKBK2 12804171550,,,net_banking_transfer,7543
61b708add8beac1599eb7c40,50200023535069,3984.33,60ec41ba55c00300382672d9,HDFC,direct expenses,5eecc6d6449e4f7cfb1c2708,2021-10-07T00:00:00.000Z,"NEFT DR-PYTM0123456-PAYTM-NETBANK, MUM-N 280211664975374-10000",ewallet,,net_banking_transfer,-10000
61b708aed8beac1599eb7c43,50200023535069,2003984.33,60ec41ba55c00300382672d9,HDFC,Investments-New,5eecc6d6449e4f7cfb1c2708,2021-10-07T00:00:00.000Z,02711930004579-TPT-2000000-DHRUV BHASIN,,,net_banking_transfer,2000000
61b708afd8beac1599eb7c48,50200023535069,1886384.33,60ec41ba55c00300382672d9,HDFC,direct expenses,5eecc6d6449e4f7cfb1c2708,2021-10-07T00:00:00.000Z,05892560000649-TPT-117600-DECORPAC INDIA PRIVATE LIMITED,,,net_banking_transfer,-117600
61b708b0d8beac1599eb7c4c,50200023535069,1883026.33,60ec41ba55c00300382672d9,HDFC,SAAS/tech expense,5eecc6d6449e4f7cfb1c2708,2021-10-07T00:00:00.000Z,POS 514834XXXXXX9486 AMAZON,shopping,,debit_card,-3358
61b708b1d8beac1599eb7c54,50200023535069,1882606.33,60ec41ba55c00300382672d9,HDFC,SAAS/tech expense,5eecc6d6449e4f7cfb1c2708,2021-10-07T00:00:00.000Z,POS 514834XXXXXX9486 AMAZON,shopping,,debit_card,-420
61b708b2d8beac1599eb7c5d,50200023535069,1985332.33,60ec41ba55c00300382672d9,HDFC,Revenue-COD,5eecc6d6449e4f7cfb1c2708,2021-10-07T00:00:00.000Z,NEFT CR-KKBK0000958-PICKRR TECHNOLOGIES PVT LTD-SLICKORGANICSPRIVATELIMITED-CMS2 802101952552,insurance,,net_banking_transfer,102726
61b708b3d8beac1599eb7c61,50200023535069,1995106.42,60ec41ba55c00300382672d9,HDFC,Revenue-PG-split enabled,5eecc6d6449e4f7cfb1c2708,2021-10-07T00:00:00.000Z,NEFT CR-UTIB0001506-RAZORPAY SOFTWARE PR IVATE LIMITED-SLICKORGANICSPVTLITD-AXISC N0096619586,insurance,,net_banking_transfer,9774.09
61b708b4d8beac1599eb7c66,50200023535069,1988748.4,60ec41ba55c00300382672d9,HDFC,direct expenses,5eecc6d6449e4f7cfb1c2708,2021-10-07T00:00:00.000Z,POS 514834XXXXXX9486 AMZN MKTP US,,,debit_card,-6358.02
61b708b5d8beac1599eb7c6a,50200023535069,2014138.56,60ec41ba55c00300382672d9,HDFC,Revenue-PG-non-split,5eecc6d6449e4f7cfb1c2708,2021-10-08T00:00:00.000Z,IMPS-128104485586-PAYTM PAYMENTS SERVI-P,ewallet,,net_banking_transfer,25390.16
61b708b6d8beac1599eb7c6f,50200023535069,1992800.56,60ec41ba55c00300382672d9,HDFC,direct expenses,5eecc6d6449e4f7cfb1c2708,2021-10-08T00:00:00.000Z,"NEFT DR-PUNB0307800-PRAKASH JHA-NETBANK, MUM-N281211666383498-21338",,,net_banking_transfer,-21338
61b708b7d8beac1599eb7c76,50200023535069,1971462.56,60ec41ba55c00300382672d9,HDFC,direct expenses,5eecc6d6449e4f7cfb1c2708,2021-10-08T00:00:00.000Z,"NEFT DR-PUNB0482100-RAM BHAVAN YADAV-NET BANK, MUM-N281211666391028-21338",,,net_banking_transfer,-21338
61b708b8d8beac1599eb7c79,50200023535069,1814862.56,60ec41ba55c00300382672d9,HDFC,direct expenses,5eecc6d6449e4f7cfb1c2708,2021-10-08T00:00:00.000Z,"NEFT DR-KKBK0005289-HILL GROOVE CONSULTI NG LLP-NETBANK, MUM-N281211666387222-156 600",,,net_banking_transfer,-156600
61b708b9d8beac1599eb7c7d,50200023535069,1825574.15,60ec41ba55c00300382672d9,HDFC,Revenue-Mktplace,5eecc6d6449e4f7cfb1c2708,2021-10-08T00:00:00.000Z,NEFT CR-DEUT0797BGL-FLIPKART INTERNET PR IVATE LIMITED-SLICK ORGANICS PVT LTD-128 100114GN00300,shopping,,net_banking_transfer,10711.59
61b708bad8beac1599eb7c83,50200023535069,1826895.98,60ec41ba55c00300382672d9,HDFC,Revenue-PG-split enabled,5eecc6d6449e4f7cfb1c2708,2021-10-08T00:00:00.000Z,NEFT CR-UTIB0001506-RAZORPAY SOFTWARE PR IVATE LIMITED-SLICKORGANICSPVTLITD-AXISC N0096715222,insurance,,net_banking_transfer,1321.83
61b708bbd8beac1599eb7c88,50200023535069,1676895.98,60ec41ba55c00300382672d9,HDFC,direct expenses,5eecc6d6449e4f7cfb1c2708,2021-10-08T00:00:00.000Z,"NEFT DR-PYTM0123456-PAYTM-NETBANK, MUM-N 281211666620447-150000",ewallet,,net_banking_transfer,-150000
61b708bcd8beac1599eb7c90,50200023535069,1679151.98,60ec41ba55c00300382672d9,HDFC,Transfer in/Revenue-other,5eecc6d6449e4f7cfb1c2708,2021-10-08T00:00:00.000Z,NEFT CR-KKBK0000958-INNOVATIVE RETAIL CO NCEPTS PRIVATE LTD-SLICK ORGANICS PVT LT D-KKBK212814509128,,,net_banking_transfer,2256
61b708bdd8beac1599eb7c93,50200023535069,1639151.98,60ec41ba55c00300382672d9,HDFC,direct expenses,5eecc6d6449e4f7cfb1c2708,2021-10-08T00:00:00.000Z,"NEFT DR-PYTM0123456-PAYTM-NETBANK, MUM-N 281211666802248-40000",ewallet,,net_banking_transfer,-40000
61b708bed8beac1599eb7c98,50200023535069,1591692.98,60ec41ba55c00300382672d9,HDFC,direct expenses,5eecc6d6449e4f7cfb1c2708,2021-10-08T00:00:00.000Z,"NEFT DR-KKBK0000187-APPLIED LIFE PRIVATE LIMITED-NETBANK, MUM-N281211666927581-4 7459",,,net_banking_transfer,-47459
61b708bfd8beac1599eb7c9c,50200023535069,1592173.06,60ec41ba55c00300382672d9,HDFC,Revenue-Mktplace,5eecc6d6449e4f7cfb1c2708,2021-10-08T00:00:00.000Z,NEFT CR-DEUT0784BBY-TATA UNISTORE LIMITE D-SLICK ORGANICS PVT LTD-128102393GN0036 5,insurance,,net_banking_transfer,480.08
61b708c0d8beac1599eb7ca0,50200023535069,1592917.97,60ec41ba55c00300382672d9,HDFC,Revenue-Mktplace,5eecc6d6449e4f7cfb1c2708,2021-10-08T00:00:00.000Z,NEFT CR-DEUT0784BBY-TATA UNISTORE LTD-NO DAL-SLICK ORGANICS PVT LTD-128102401GN00 576,insurance,,net_banking_transfer,744.91
61b708c1d8beac1599eb7ca8,50200023535069,1622024.94,60ec41ba55c00300382672d9,HDFC,Revenue-PG-non-split,5eecc6d6449e4f7cfb1c2708,2021-10-09T00:00:00.000Z,IMPS-128205965342-PAYTM PAYMENTS SERVI-P,ewallet,,net_banking_transfer,29106.97
61b708c2d8beac1599eb7cae,50200023535069,1612642.2,60ec41ba55c00300382672d9,HDFC,direct expenses,5eecc6d6449e4f7cfb1c2708,2021-10-09T00:00:00.000Z,"POS 514834XXXXXX9486 IN *CLEARFORME,",,,debit_card,-9382.74
61b708c3d8beac1599eb7cb2,50200023535069,1610142.2,60ec41ba55c00300382672d9,HDFC,Marketing Expense,5eecc6d6449e4f7cfb1c2708,2021-10-09T00:00:00.000Z,ME DC SI 514834XXXXXX9486 GOOGLESERVIS,,,Other,-2500
61b708c4d8beac1599eb7cba,50200023535069,1404062.2,60ec41ba55c00300382672d9,HDFC,direct expenses,5eecc6d6449e4f7cfb1c2708,2021-10-09T00:00:00.000Z,05892560000649-TPT-206080-DECORPAC INDIA PRIVATE LIMITED,,,net_banking_transfer,-206080
61b708c5d8beac1599eb7cbf,50200023535069,1317420.2,60ec41ba55c00300382672d9,HDFC,direct expenses,5eecc6d6449e4f7cfb1c2708,2021-10-09T00:00:00.000Z,50100301160692-TPT-86642-TARUN GARG,,,net_banking_transfer,-86642
61b708c6d8beac1599eb7cc9,50200023535069,1242420.2,60ec41ba55c00300382672d9,HDFC,direct expenses,5eecc6d6449e4f7cfb1c2708,2021-10-09T00:00:00.000Z,"NEFT DR-CITI0000002-OMG NETWORK INDIA PR IVATE LIMITED-NETBANK, MUM-N282211668356 390-75000",,,net_banking_transfer,-75000
61b708c7d8beac1599eb7ccc,50200023535069,1159535.2,60ec41ba55c00300382672d9,HDFC,direct expenses,5eecc6d6449e4f7cfb1c2708,2021-10-09T00:00:00.000Z,"NEFT DR-CITI0000002-OMG NETWORK INDIA PR IVATE LIMITED-NETBANK, MUM-N282211668356 701-82885",,,net_banking_transfer,-82885
61b708c8d8beac1599eb7cd1,50200023535069,1157035.2,60ec41ba55c00300382672d9,HDFC,Marketing Expense,5eecc6d6449e4f7cfb1c2708,2021-10-09T00:00:00.000Z,ME DC SI 514834XXXXXX9486 GOOGLESERVIS,,,Other,-2500
61b708c9d8beac1599eb7cd5,50200023535069,1154535.2,60ec41ba55c00300382672d9,HDFC,Marketing Expense,5eecc6d6449e4f7cfb1c2708,2021-10-09T00:00:00.000Z,ME DC SI 514834XXXXXX9486 GOOGLESERVIS,,,Other,-2500
61b708cad8beac1599eb7cdb,50200023535069,1152035.2,60ec41ba55c00300382672d9,HDFC,Marketing Expense,5eecc6d6449e4f7cfb1c2708,2021-10-09T00:00:00.000Z,ME DC SI 514834XXXXXX9486 GOOGLESERVIS,,,Other,-2500
61b708cbd8beac1599eb7ce4,50200023535069,1149535.2,60ec41ba55c00300382672d9,HDFC,Marketing Expense,5eecc6d6449e4f7cfb1c2708,2021-10-09T00:00:00.000Z,ME DC SI 514834XXXXXX9486 GOOGLESERVIS,,,Other,-2500
61b708ccd8beac1599eb7ce7,50200023535069,1147035.2,60ec41ba55c00300382672d9,HDFC,Marketing Expense,5eecc6d6449e4f7cfb1c2708,2021-10-09T00:00:00.000Z,ME DC SI 514834XXXXXX9486 GOOGLESERVIS,,,Other,-2500
61b708cdd8beac1599eb7ceb,50200023535069,1163179.66,60ec41ba55c00300382672d9,HDFC,Revenue-PG-non-split,5eecc6d6449e4f7cfb1c2708,2021-10-10T00:00:00.000Z,IMPS-128304418445-PAYTM PAYMENTS SERVI-P YTM-XXXXXXXXXX0008-ALL202110102168200003 30830668628,ewallet,,net_banking_transfer,16144.46
61b708ced8beac1599eb7cf1,50200023535069,1160679.66,60ec41ba55c00300382672d9,HDFC,Marketing Expense,5eecc6d6449e4f7cfb1c2708,2021-10-10T00:00:00.000Z,ME DC SI 514834XXXXXX9486 GOOGLESERVIS,,,Other,-2500
61b708cfd8beac1599eb7cf6,50200023535069,1158179.66,60ec41ba55c00300382672d9,HDFC,Marketing Expense,5eecc6d6449e4f7cfb1c2708,2021-10-10T00:00:00.000Z,ME DC SI 514834XXXXXX9486 GOOGLESERVIS,,,Other,-2500
61b708d0d8beac1599eb7cfd,50200023535069,1155679.66,60ec41ba55c00300382672d9,HDFC,Marketing Expense,5eecc6d6449e4f7cfb1c2708,2021-10-10T00:00:00.000Z,ME DC SI 514834XXXXXX9486 GOOGLESERVIS,,,Other,-2500
61b708d1d8beac1599eb7d01,50200023535069,1153179.66,60ec41ba55c00300382672d9,HDFC,Marketing Expense,5eecc6d6449e4f7cfb1c2708,2021-10-10T00:00:00.000Z,ME DC SI 514834XXXXXX9486 GOOGLESERVIS,,,Other,-2500
61b708d2d8beac1599eb7d06,50200023535069,1150679.66,60ec41ba55c00300382672d9,HDFC,Marketing Expense,5eecc6d6449e4f7cfb1c2708,2021-10-10T00:00:00.000Z,ME DC SI 514834XXXXXX9486 GOOGLESERVIS,,,Other,-2500
61b708d3d8beac1599eb7d0b,50200023535069,1148179.66,60ec41ba55c00300382672d9,HDFC,Marketing Expense,5eecc6d6449e4f7cfb1c2708,2021-10-10T00:00:00.000Z,ME DC SI 514834XXXXXX9486 GOOGLESERVIS,,,Other,-2500
61b708d4d8beac1599eb7d10,50200023535069,1145679.66,60ec41ba55c00300382672d9,HDFC,Marketing Expense,5eecc6d6449e4f7cfb1c2708,2021-10-11T00:00:00.000Z,ME DC SI 514834XXXXXX9486 GOOGLESERVIS,,,Other,-2500
61b708d5d8beac1599eb7d19,50200023535069,1355111.66,60ec41ba55c00300382672d9,HDFC,Transfer in/Revenue-other,5eecc6d6449e4f7cfb1c2708,2021-10-11T00:00:00.000Z,RTGS CR-SCBL0036001-M/S GRS ENTERPRISES- SILCK ORGANICS PVT LTD-SCBLR120211011000 01092,,,net_banking_transfer,209432
61b708d6d8beac1599eb7d1e,50200023535069,1366295.09,60ec41ba55c00300382672d9,HDFC,Revenue-PG-non-split,5eecc6d6449e4f7cfb1c2708,2021-10-11T00:00:00.000Z,IMPS-128404844644-PAYTM PAYMENTS SERVI-P YTM-XXXXXXXXXX0008-ALL202110112168200003 30830668628,ewallet,,net_banking_transfer,11183.43
61b708d7d8beac1599eb7d23,50200023535069,1363795.09,60ec41ba55c00300382672d9,HDFC,Marketing Expense,5eecc6d6449e4f7cfb1c2708,2021-10-11T00:00:00.000Z,ME DC SI 514834XXXXXX9486 GOOGLESERVIS,,,Other,-2500
61b708d8d8beac1599eb7d2b,50200023535069,1364795.09,60ec41ba55c00300382672d9,HDFC,Internal Transfers,5eecc6d6449e4f7cfb1c2708,2021-10-11T00:00:00.000Z,IB FUNDS TRANSFER CR-50200035187206 -SL ICK ORGANICS PVT LTD,insurance,,Other,1000
61b708d9d8beac1599eb7d32,50200023535069,1364995.09,60ec41ba55c00300382672d9,HDFC,Internal Transfers,5eecc6d6449e4f7cfb1c2708,2021-10-11T00:00:00.000Z,IB FUNDS TRANSFER CR-50200035187206 -SL ICK ORGANICS PVT LTD,insurance,,Other,200
61b708dad8beac1599eb7d39,50200023535069,1372202.6,60ec41ba55c00300382672d9,HDFC,Revenue-PG-split enabled,5eecc6d6449e4f7cfb1c2708,2021-10-11T00:00:00.000Z,NEFT CR-UTIB0001506-RAZORPAY SOFTWARE PR IVATE LIMITED-SLICKORGANICSPVTLITD-AXISC N0097112254,insurance,,net_banking_transfer,7207.51
61b708dbd8beac1599eb7d3d,50200023535069,1369702.6,60ec41ba55c00300382672d9,HDFC,Marketing Expense,5eecc6d6449e4f7cfb1c2708,2021-10-11T00:00:00.000Z,ME DC SI 514834XXXXXX9486 GOOGLESERVIS,,,Other,-2500
61b708dcd8beac1599eb7d42,50200023535069,1382261.39,60ec41ba55c00300382672d9,HDFC,Revenue-Mktplace,5eecc6d6449e4f7cfb1c2708,2021-10-11T00:00:00.000Z,NEFT CR-DEUT0797BGL-FLIPKART INTERNET PR IVATE LIMITED-SLICK ORGANICS PVT LTD-128 400283GN00121,shopping,,net_banking_transfer,12558.79
61b708ddd8beac1599eb7d47,50200023535069,1365597.64,60ec41ba55c00300382672d9,HDFC,SAAS/tech expense,5eecc6d6449e4f7cfb1c2708,2021-10-11T00:00:00.000Z,POS 514834XXXXXX9486 AMAZON SELLER RE,shopping,,debit_card,-16663.75
61b708ded8beac1599eb7d4d,50200023535069,1360597.64,60ec41ba55c00300382672d9,HDFC,Marketing Expense,5eecc6d6449e4f7cfb1c2708,2021-10-11T00:00:00.000Z,ME DC SI 514834XXXXXX9486 GOOGLESERVIS,,,Other,-5000
61b708dfd8beac1599eb7d55,50200023535069,1359153.64,60ec41ba55c00300382672d9,HDFC,direct expenses,5eecc6d6449e4f7cfb1c2708,2021-10-11T00:00:00.000Z,POS 514834XXXXXX9486 PAYU-HTTPS://STO,,,debit_card,-1444
61b708e0d8beac1599eb7d59,50200023535069,1362814.79,60ec41ba55c00300382672d9,HDFC,Revenue-PG-non-split,5eecc6d6449e4f7cfb1c2708,2021-10-11T00:00:00.000Z,NEFT CR-IDFB0010204-SEZZLE PAYMENTS PRIV ATE LIMITED-SLICK ORGANICS PRIVATE LIMIT ED-IDFBH21284671824,insurance,,net_banking_transfer,3661.15
61b708e1d8beac1599eb7d60,50200023535069,1360314.79,60ec41ba55c00300382672d9,HDFC,Marketing Expense,5eecc6d6449e4f7cfb1c2708,2021-10-11T00:00:00.000Z,ME DC SI 514834XXXXXX9486 GOOGLESERVIS,,,Other,-2500
61b708e2d8beac1599eb7d66,50200023535069,1420824.79,60ec41ba55c00300382672d9,HDFC,Revenue-COD,5eecc6d6449e4f7cfb1c2708,2021-10-11T00:00:00.000Z,PICKRR TECHNOL-CODAKHILESHDIXIT85GM,,,Other,60510
61b708e3d8beac1599eb7d70,50200023535069,1421233.81,60ec41ba55c00300382672d9,HDFC,Revenue-Mktplace,5eecc6d6449e4f7cfb1c2708,2021-10-11T00:00:00.000Z,NEFT CR-ICIC0000105-ICICI BANK NODAL AC MANASH LIFESTYL-SLICK ORGANICS PRIVATE L IMITED HYD-ICIJ212840004604,,,net_banking_transfer,409.02
61b708e4d8beac1599eb7d81,50200023535069,1423962.09,60ec41ba55c00300382672d9,HDFC,Revenue-Mktplace,5eecc6d6449e4f7cfb1c2708,2021-10-11T00:00:00.000Z,NEFT CR-ICIC0000105-ICICI BANK NODAL AC MANASH LIFESTYL-SLICK ORGANICS PRIVATE L IMITED MP M-ICIJ212840004602,,,net_banking_transfer,2728.28
61b708e5d8beac1599eb7d95,50200023535069,1425978.6,60ec41ba55c00300382672d9,HDFC,Revenue-Mktplace,5eecc6d6449e4f7cfb1c2708,2021-10-11T00:00:00.000Z,NEFT CR-ICIC0000105-ICICI BANK NODAL AC MANASH LIFESTYL-SLICK ORGANICS PRIVATE L IMITED MP G-ICIJ212840004601,,,net_banking_transfer,2016.51
61b708e6d8beac1599eb7da1,50200023535069,1438556.45,60ec41ba55c00300382672d9,HDFC,Revenue-PG-split enabled,5eecc6d6449e4f7cfb1c2708,2021-10-11T00:00:00.000Z,NEFT CR-UTIB0001506-RAZORPAY SOFTWARE PR IVATE LIMITED-SLICKORGANICSPVTLITD-AXISC N0097236969,insurance,,net_banking_transfer,12577.85
61b708e7d8beac1599eb7dae,50200023535069,1436056.45,60ec41ba55c00300382672d9,HDFC,Marketing Expense,5eecc6d6449e4f7cfb1c2708,2021-10-11T00:00:00.000Z,ME DC SI 514834XXXXXX9486 GOOGLESERVIS,,,Other,-2500
61b708e8d8beac1599eb7dbb,50200023535069,1433556.45,60ec41ba55c00300382672d9,HDFC,Marketing Expense,5eecc6d6449e4f7cfb1c2708,2021-10-11T00:00:00.000Z,ME DC SI 514834XXXXXX9486 GOOGLESERVIS,,,Other,-2500
61b708e9d8beac1599eb7dd1,50200023535069,1428556.45,60ec41ba55c00300382672d9,HDFC,Marketing Expense,5eecc6d6449e4f7cfb1c2708,2021-10-12T00:00:00.000Z,ME DC SI 514834XXXXXX9486 GOOGLESERVIS,,,Other,-5000
61b708ead8beac1599eb7dd7,50200023535069,1450481.81,60ec41ba55c00300382672d9,HDFC,Revenue-PG-non-split,5eecc6d6449e4f7cfb1c2708,2021-10-12T00:00:00.000Z,IMPS-128504520074-PAYTM PAYMENTS SERVI-P YTM-XXXXXXXXXX0008-ALL202110122168200003 30830668628,ewallet,,net_banking_transfer,21925.36
61b708ebd8beac1599eb7ddc,50200023535069,1498482.82,60ec41ba55c00300382672d9,HDFC,Revenue-Mktplace,5eecc6d6449e4f7cfb1c2708,2021-10-12T00:00:00.000Z,IMPS-128505334670-AMAZON SELLER SERVIC-H SBC-XXXXXXXX6004-5WU2EUCH5UAIT8EHSLICK O RGANICS PVT LTD,shopping,,net_banking_transfer,48001.01
61b708ecd8beac1599eb7deb,50200023535069,1668654.47,60ec41ba55c00300382672d9,HDFC,Revenue-Mktplace,5eecc6d6449e4f7cfb1c2708,2021-10-12T00:00:00.000Z,NEFT CR-DEUT0797BGL-AMAZON PAY (INDIA) P,shopping,,net_banking_transfer,170171.65
61b708edd8beac1599eb7df3,50200023535069,1549557.47,60ec41ba55c00300382672d9,HDFC,direct expenses,5eecc6d6449e4f7cfb1c2708,2021-10-12T00:00:00.000Z,"NEFT DR-CITI0000002-OMG NETWORK INDIA PR IVATE LIMITED-NETBANK, MUM-N285211671434 891-119097",,,net_banking_transfer,-119097
61b708eed8beac1599eb7dfb,50200023535069,1552878.43,60ec41ba55c00300382672d9,HDFC,Revenue-PG-split enabled,5eecc6d6449e4f7cfb1c2708,2021-10-12T00:00:00.000Z,NEFT CR-UTIB0001506-RAZORPAY SOFTWARE PR IVATE LIMITED-SLICKORGANICSPVTLITD-AXISC N0097373518,insurance,,net_banking_transfer,3320.96
61b708efd8beac1599eb7e0c,50200023535069,1456758.43,60ec41ba55c00300382672d9,HDFC,direct expenses,5eecc6d6449e4f7cfb1c2708,2021-10-12T00:00:00.000Z,"NEFT DR-DBSS0IN0811-SARANSH KULKARNI-NET BANK, MUM-N285211671571606-96120",,,net_banking_transfer,-96120
61b708f0d8beac1599eb7e13,50200023535069,1454258.43,60ec41ba55c00300382672d9,HDFC,Marketing Expense,5eecc6d6449e4f7cfb1c2708,2021-10-12T00:00:00.000Z,ME DC SI 514834XXXXXX9486 GOOGLESERVIS,,,Other,-2500
61b708f1d8beac1599eb7e18,50200023535069,1368297.79,60ec41ba55c00300382672d9,HDFC,direct expenses,5eecc6d6449e4f7cfb1c2708,2021-10-12T00:00:00.000Z,POS 514834XXXXXX9486 SHOPIFY* 1222790,,,debit_card,-85960.64
61b708f2d8beac1599eb7e1f,50200023535069,1365797.79,60ec41ba55c00300382672d9,HDFC,Marketing Expense,5eecc6d6449e4f7cfb1c2708,2021-10-12T00:00:00.000Z,ME DC SI 514834XXXXXX9486 GOOGLESERVIS,,,Other,-2500
61b708f3d8beac1599eb7e29,50200023535069,1360797.79,60ec41ba55c00300382672d9,HDFC,Marketing Expense,5eecc6d6449e4f7cfb1c2708,2021-10-12T00:00:00.000Z,ME DC SI 514834XXXXXX9486 GOOGLESERVIS,,,Other,-5000
61b708f4d8beac1599eb7e2e,50200023535069,1210797.79,60ec41ba55c00300382672d9,HDFC,direct expenses,5eecc6d6449e4f7cfb1c2708,2021-10-12T00:00:00.000Z,"NEFT DR-KKBK0000180-VEDIC COSMECEUTICALS PVT LTD-NETBANK, MUM-N285211672079590-1 50000",,,net_banking_transfer,-150000
61b708f5d8beac1599eb7e43,50200023535069,1205494.82,60ec41ba55c00300382672d9,HDFC,direct expenses,5eecc6d6449e4f7cfb1c2708,2021-10-12T00:00:00.000Z,POS 514834XXXXXX9486 AMZN MKTP US,,,debit_card,-5302.97
61b708f6d8beac1599eb7e4c,50200023535069,1215181.31,60ec41ba55c00300382672d9,HDFC,Revenue-PG-split enabled,5eecc6d6449e4f7cfb1c2708,2021-10-12T00:00:00.000Z,NEFT CR-UTIB0001506-RAZORPAY SOFTWARE PR IVATE LIMITED-SLICKORGANICSPVTLITD-AXISC N0097505000,insurance,,net_banking_transfer,9686.49
61b708f7d8beac1599eb7e54,50200023535069,1211479.82,60ec41ba55c00300382672d9,HDFC,direct expenses,5eecc6d6449e4f7cfb1c2708,2021-10-12T00:00:00.000Z,POS 514834XXXXXX9486 WWW.FAQPRIME.COM,,,debit_card,-3701.49
61b708f8d8beac1599eb7e5f,50200023535069,1213828.66,60ec41ba55c00300382672d9,HDFC,Revenue-PG-non-split,5eecc6d6449e4f7cfb1c2708,2021-10-12T00:00:00.000Z,NEFT CR-IDFB0010204-SEZZLE PAYMENTS PRIV ATE LIMITED-SLICK ORGANICS PRIVATE LIMIT ED-IDFBH21285804105,insurance,,net_banking_transfer,2348.84
61b708f9d8beac1599eb7e65,50200023535069,1208828.66,60ec41ba55c00300382672d9,HDFC,Marketing Expense,5eecc6d6449e4f7cfb1c2708,2021-10-12T00:00:00.000Z,ME DC SI 514834XXXXXX9486 GOOGLESERVIS,,,Other,-5000
61b708fad8beac1599eb7e6b,50200023535069,1206328.66,60ec41ba55c00300382672d9,HDFC,Marketing Expense,5eecc6d6449e4f7cfb1c2708,2021-10-12T00:00:00.000Z,ME DC SI 514834XXXXXX9486 GOOGLESERVIS,,,Other,-2500
61b708fbd8beac1599eb7e70,50200023535069,1232773.25,60ec41ba55c00300382672d9,HDFC,Revenue-PG-non-split,5eecc6d6449e4f7cfb1c2708,2021-10-13T00:00:00.000Z,IMPS-128604241948-PAYTM PAYMENTS SERVI-P,ewallet,,net_banking_transfer,26444.59
61b708fcd8beac1599eb7e7b,50200023535069,1227773.25,60ec41ba55c00300382672d9,HDFC,Marketing Expense,5eecc6d6449e4f7cfb1c2708,2021-10-13T00:00:00.000Z,ME DC SI 514834XXXXXX9486 GOOGLESERVIS,,,Other,-5000
61b708fdd8beac1599eb7e84,50200023535069,727773.25,60ec41ba55c00300382672d9,HDFC,direct expenses,5eecc6d6449e4f7cfb1c2708,2021-10-13T00:00:00.000Z,"NEFT DR-PYTM0123456-PAYTM-NETBANK, MUM-N 286211673023727-500000",ewallet,,net_banking_transfer,-500000
61b708fed8beac1599eb7e8a,50200023535069,714773.25,60ec41ba55c00300382672d9,HDFC,direct expenses,5eecc6d6449e4f7cfb1c2708,2021-10-13T00:00:00.000Z,"NEFT DR-ICIC0006956-LAKSHAY CARRYING COR PORATION-NETBANK, MUM-N286211673026328-1 3000",,,net_banking_transfer,-13000
61b708ffd8beac1599eb7e8f,50200023535069,712273.25,60ec41ba55c00300382672d9,HDFC,Marketing Expense,5eecc6d6449e4f7cfb1c2708,2021-10-13T00:00:00.000Z,ME DC SI 514834XXXXXX9486 GOOGLESERVIS,,,Other,-2500
61b70900d8beac1599eb7e98,50200023535069,718228.85,60ec41ba55c00300382672d9,HDFC,Revenue-PG-split enabled,5eecc6d6449e4f7cfb1c2708,2021-10-13T00:00:00.000Z,NEFT CR-UTIB0001506-RAZORPAY SOFTWARE PR IVATE LIMITED-SLICKORGANICSPVTLITD-AXISC N0097592087,insurance,,net_banking_transfer,5955.6
61b70901d8beac1599eb7e9e,50200023535069,757235.78,60ec41ba55c00300382672d9,HDFC,Revenue-Mktplace,5eecc6d6449e4f7cfb1c2708,2021-10-13T00:00:00.000Z,NEFT CR-DEUT0797BGL-FLIPKART INTERNET PR IVATE LIMITED-SLICK ORGANICS PVT LTD-128 600730GN00175,shopping,,net_banking_transfer,39006.93
61b70902d8beac1599eb7ea7,50200023535069,503225.78,60ec41ba55c00300382672d9,HDFC,Marketing Expense,5eecc6d6449e4f7cfb1c2708,2021-10-13T00:00:00.000Z,"NEFT DR-CITI0000006-FACEBOOK INDIA ONLIN E SERVICES PVT LTD-NETBANK, MUM-N2862116 73339591-254010",,,net_banking_transfer,-254010
61b70903d8beac1599eb7eab,50200023535069,500725.78,60ec41ba55c00300382672d9,HDFC,Marketing Expense,5eecc6d6449e4f7cfb1c2708,2021-10-13T00:00:00.000Z,ME DC SI 514834XXXXXX9486 GOOGLESERVIS,,,Other,-2500
61b70904d8beac1599eb7eb0,50200023535069,506397.28,60ec41ba55c00300382672d9,HDFC,Revenue-COD,5eecc6d6449e4f7cfb1c2708,2021-10-13T00:00:00.000Z,NEFT CR-ICIC0000155-SHIPROCKET COD CRF I D 3217364-SLICK ORGANICS PVT LTD-CMS2181 546937,insurance,,net_banking_transfer,5671.5
61b70905d8beac1599eb7eb4,50200023535069,506583.47,60ec41ba55c00300382672d9,HDFC,Revenue-Mktplace,5eecc6d6449e4f7cfb1c2708,2021-10-13T00:00:00.000Z,NEFT CR-ICIC0000105-ICICI BANK NODAL AC MANASH LIFESTYL-SLICK ORGANICS PRIVATE L IMITED MP G-ICIJ212860005837,,,net_banking_transfer,186.19
61b70906d8beac1599eb7ebc,50200023535069,507053.33,60ec41ba55c00300382672d9,HDFC,Revenue-Mktplace,5eecc6d6449e4f7cfb1c2708,2021-10-13T00:00:00.000Z,NEFT CR-ICIC0000105-ICICI BANK NODAL AC MANASH LIFESTYL-SLICK ORGANICS PRIVATE L IMITED KOLK-ICIJ212860005839,,,net_banking_transfer,469.86
61b70907d8beac1599eb7ec6,50200023535069,508868.99,60ec41ba55c00300382672d9,HDFC,Transfer in/Revenue-other,5eecc6d6449e4f7cfb1c2708,2021-10-13T00:00:00.000Z,NEFT CR-ICIC0000105-ICICI BANK NODAL AC,,,net_banking_transfer,1815.66
61b70908d8beac1599eb7ec9,50200023535069,509800.62,60ec41ba55c00300382672d9,HDFC,Revenue-Mktplace,5eecc6d6449e4f7cfb1c2708,2021-10-13T00:00:00.000Z,NEFT CR-ICIC0000105-ICICI BANK NODAL AC MANASH LIFESTYL-SLICK ORGANICS PRIVATE L IMITED HYD-ICIJ212860005840,,,net_banking_transfer,931.63
61b70909d8beac1599eb7ece,50200023535069,511661.64,60ec41ba55c00300382672d9,HDFC,Revenue-PG-non-split,5eecc6d6449e4f7cfb1c2708,2021-10-13T00:00:00.000Z,NEFT CR-IDFB0010204-SEZZLE PAYMENTS PRIV ATE LIMITED-SLICK ORGANICS PRIVATE LIMIT ED-IDFBH21286880154,insurance,,net_banking_transfer,1861.02
61b7090ad8beac1599eb7efc,50200023535069,546667.13,60ec41ba55c00300382672d9,HDFC,Transfer in/Revenue-other,5eecc6d6449e4f7cfb1c2708,2021-10-13T00:00:00.000Z,57500000644820-SLICK ORGANICS,insurance,,Other,35005.49
61b7090bd8beac1599eb7f01,50200023535069,581187.13,60ec41ba55c00300382672d9,HDFC,Revenue-Mktplace,5eecc6d6449e4f7cfb1c2708,2021-10-13T00:00:00.000Z,NEFT CR-SCBL0036001-M/S DREAMPLUG TECHNO -SLICK ORGANICS PRIVATE LIMITEDSLICK-SIN 31436Q0023434,insurance,,net_banking_transfer,34520
61b7090cd8beac1599eb7f0a,50200023535069,606855.13,60ec41ba55c00300382672d9,HDFC,Revenue-Mktplace,5eecc6d6449e4f7cfb1c2708,2021-10-13T00:00:00.000Z,NEFT CR-ICIC0SF0002-THREPSI SOLUTIONS PV -SLICK ORGANICS PVT LTD-25225407681DC,insurance,,net_banking_transfer,25668
61b7090dd8beac1599eb7f0f,50200023535069,604355.13,60ec41ba55c00300382672d9,HDFC,Marketing Expense,5eecc6d6449e4f7cfb1c2708,2021-10-13T00:00:00.000Z,ME DC SI 514834XXXXXX9486 GOOGLESERVIS,,,Other,-2500
61b7090ed8beac1599eb7f13,50200023535069,601855.13,60ec41ba55c00300382672d9,HDFC,Marketing Expense,5eecc6d6449e4f7cfb1c2708,2021-10-13T00:00:00.000Z,ME DC SI 514834XXXXXX9486 GOOGLESERVIS,,,Other,-2500
61b7090fd8beac1599eb7f18,50200023535069,607037.17,60ec41ba55c00300382672d9,HDFC,Revenue-PG-non-split,5eecc6d6449e4f7cfb1c2708,2021-10-14T00:00:00.000Z,UPI-PAYTM-PPSL-PAYOUTS@PAYTM-PYTM0123456 -128774971858-ALL202110142168200,ewallet,,upi,5182.04
61b70910d8beac1599eb7f1d,50200023535069,604537.17,60ec41ba55c00300382672d9,HDFC,Marketing Expense,5eecc6d6449e4f7cfb1c2708,2021-10-14T00:00:00.000Z,ME DC SI 514834XXXXXX9486 GOOGLESERVIS,,,Other,-2500
61b70911d8beac1599eb7f27,50200023535069,612809.33,60ec41ba55c00300382672d9,HDFC,Revenue-PG-split enabled,5eecc6d6449e4f7cfb1c2708,2021-10-14T00:00:00.000Z,NEFT CR-UTIB0001506-RAZORPAY SOFTWARE PR IVATE LIMITED-SLICKORGANICSPVTLITD-AXISC N0097787754,insurance,,net_banking_transfer,8272.16
61b70912d8beac1599eb7f2c,50200023535069,614324,60ec41ba55c00300382672d9,HDFC,Revenue-Mktplace,5eecc6d6449e4f7cfb1c2708,2021-10-14T00:00:00.000Z,4060005333-TIMES INTERNET LIMITED NODAL,,,Other,1514.67
61b70913d8beac1599eb7f36,50200023535069,609324,60ec41ba55c00300382672d9,HDFC,Marketing Expense,5eecc6d6449e4f7cfb1c2708,2021-10-14T00:00:00.000Z,ME DC SI 514834XXXXXX9486 GOOGLESERVIS,,,Other,-5000
61b70914d8beac1599eb7f3d,50200023535069,609322,60ec41ba55c00300382672d9,HDFC,Marketing Expense,5eecc6d6449e4f7cfb1c2708,2021-10-14T00:00:00.000Z,ME DC SI 514834XXXXXX9486 GOOGLEPLAY,entertainment,,Other,-2
61b70915d8beac1599eb7f46,50200023535069,603131,60ec41ba55c00300382672d9,HDFC,direct expenses,5eecc6d6449e4f7cfb1c2708,2021-10-14T00:00:00.000Z,02021132035968/ESIC,,,Other,-6191
61b70916d8beac1599eb7f4b,50200023535069,598131,60ec41ba55c00300382672d9,HDFC,Marketing Expense,5eecc6d6449e4f7cfb1c2708,2021-10-14T00:00:00.000Z,ME DC SI 514834XXXXXX9486 GOOGLESERVIS,,,Other,-5000
61b70917d8beac1599eb7f4f,50200023535069,806247,60ec41ba55c00300382672d9,HDFC,Transfer in/Revenue-other,5eecc6d6449e4f7cfb1c2708,2021-10-14T00:00:00.000Z,NEFT CR-CNRB0002811-SHREE SAMARTH ENTERP RISES-SLICK ORGANICS PRIVATE LIMITED-P28 7210132769627,insurance,,net_banking_transfer,208116
61b70918d8beac1599eb7f53,50200023535069,807115.33,60ec41ba55c00300382672d9,HDFC,Revenue-PG-non-split,5eecc6d6449e4f7cfb1c2708,2021-10-14T00:00:00.000Z,NEFT CR-YESB0000001-RZPX PVT LTD NODAL A CCOUNT-SLICKORGANICS-N287210802588088,insurance,,salary,868.33
61b70919d8beac1599eb7f56,50200023535069,807492.5,60ec41ba55c00300382672d9,HDFC,Revenue-Mktplace,5eecc6d6449e4f7cfb1c2708,2021-10-14T00:00:00.000Z,NEFT CR-DEUT0784BBY-TATA UNISTORE LIMITE D-SLICK ORGANICS PVT LTD-128701613GN0031 7,insurance,,net_banking_transfer,377.17
61b7091ad8beac1599eb7f5c,50200023535069,808037.01,60ec41ba55c00300382672d9,HDFC,Revenue-Mktplace,5eecc6d6449e4f7cfb1c2708,2021-10-14T00:00:00.000Z,NEFT CR-DEUT0784BBY-TATA UNISTORE LTD-NO DAL-SLICK ORGANICS PVT LTD-128701624GN00 550,insurance,,net_banking_transfer,544.51
61b7091bd8beac1599eb7f67,50200023535069,898700.01,60ec41ba55c00300382672d9,HDFC,Revenue-COD,5eecc6d6449e4f7cfb1c2708,2021-10-14T00:00:00.000Z,NEFT CR-KKBK0000958-PICKRR TECHNOLOGIES PVT LTD-SLICKORGANICSPRIVATELIMITED-CMS2 872102286269,insurance,,net_banking_transfer,90663
61b7091cd8beac1599eb7f6a,50200023535069,892635.01,60ec41ba55c00300382672d9,HDFC,Salary/Emp/consultant Expense,5eecc6d6449e4f7cfb1c2708,2021-10-14T00:00:00.000Z,1592392962/EPFO,,,Other,-6065
61b7091dd8beac1599eb7f6e,50200023535069,899450.01,60ec41ba55c00300382672d9,HDFC,Revenue-Mktplace,5eecc6d6449e4f7cfb1c2708,2021-10-14T00:00:00.000Z,NEFT CR-KKBK0000958-SURFBOATS SOLUTIONS PVT LTD-SLICK ORGANICS PRIVATE LIMITED-K KBK212876133790,insurance,,net_banking_transfer,6815
61b7091ed8beac1599eb7f75,50200023535069,749450.01,60ec41ba55c00300382672d9,HDFC,direct expenses,5eecc6d6449e4f7cfb1c2708,2021-10-14T00:00:00.000Z,IMPS-128720189400-PAYTM-PYTM-XXXXXXXX383 9-150000,ewallet,,net_banking_transfer,-150000
61b7091fd8beac1599eb7f7a,50200023535069,609450.01,60ec41ba55c00300382672d9,HDFC,direct expenses,5eecc6d6449e4f7cfb1c2708,2021-10-14T00:00:00.000Z,"NEFT DR-SRCB0000281-3D TECHNOPACK PRIVAT E LIMITED-NETBANK, MUM-N287211675592211- 140000",,,net_banking_transfer,-140000
61b70920d8beac1599eb7f81,50200023535069,604450.01,60ec41ba55c00300382672d9,HDFC,Marketing Expense,5eecc6d6449e4f7cfb1c2708,2021-10-14T00:00:00.000Z,ME DC SI 514834XXXXXX9486 GOOGLESERVIS,,,Other,-5000
61b70921d8beac1599eb7f84,50200023535069,601950.01,60ec41ba55c00300382672d9,HDFC,Marketing Expense,5eecc6d6449e4f7cfb1c2708,2021-10-14T00:00:00.000Z,ME DC SI 514834XXXXXX9486 GOOGLESERVIS,,,Other,-2500
61b70922d8beac1599eb7f89,50200023535069,620860.88,60ec41ba55c00300382672d9,HDFC,Revenue-PG-non-split,5eecc6d6449e4f7cfb1c2708,2021-10-15T00:00:00.000Z,IMPS-128805125123-PAYTM PAYMENTS SERVI-P YTM-XXXXXXXXXX0008-ALL202110152168200003 30830668628,ewallet,,net_banking_transfer,18910.87
61b70923d8beac1599eb7f8c,50200023535069,618360.88,60ec41ba55c00300382672d9,HDFC,Marketing Expense,5eecc6d6449e4f7cfb1c2708,2021-10-15T00:00:00.000Z,ME DC SI 514834XXXXXX9486 GOOGLESERVIS,,,Other,-2500
61b70924d8beac1599eb7f90,50200023535069,613360.88,60ec41ba55c00300382672d9,HDFC,Marketing Expense,5eecc6d6449e4f7cfb1c2708,2021-10-15T00:00:00.000Z,ME DC SI 514834XXXXXX9486 GOOGLESERVIS,,,Other,-5000
61b70925d8beac1599eb7f98,50200023535069,610860.88,60ec41ba55c00300382672d9,HDFC,Marketing Expense,5eecc6d6449e4f7cfb1c2708,2021-10-15T00:00:00.000Z,ME DC SI 514834XXXXXX9486 GOOGLESERVIS,,,Other,-2500
61b70926d8beac1599eb7f9e,50200023535069,605860.88,60ec41ba55c00300382672d9,HDFC,Marketing Expense,5eecc6d6449e4f7cfb1c2708,2021-10-15T00:00:00.000Z,ME DC SI 514834XXXXXX9486 GOOGLESERVIS,,,Other,-5000
61b70927d8beac1599eb7fa2,50200023535069,632210.57,60ec41ba55c00300382672d9,HDFC,Revenue-PG-non-split,5eecc6d6449e4f7cfb1c2708,2021-10-16T00:00:00.000Z,IMPS-128904246379-PAYTM PAYMENTS SERVI-P YTM-XXXXXXXXXX0008-ALL202110162168200003 30830668628,ewallet,,net_banking_transfer,26349.69
61b70928d8beac1599eb7fa7,50200023535069,627210.57,60ec41ba55c00300382672d9,HDFC,Marketing Expense,5eecc6d6449e4f7cfb1c2708,2021-10-16T00:00:00.000Z,ME DC SI 514834XXXXXX9486 GOOGLESERVIS,,,Other,-5000
61b70929d8beac1599eb7fac,50200023535069,640555.46,60ec41ba55c00300382672d9,HDFC,Revenue-PG-split enabled,5eecc6d6449e4f7cfb1c2708,2021-10-16T00:00:00.000Z,NEFT CR-UTIB0001506-RAZORPAY SOFTWARE PR IVATE LIMITED-SLICKORGANICSPVTLITD-AXISC N0097970446,insurance,,net_banking_transfer,13344.89
61b7092ad8beac1599eb7fb3,50200023535069,638055.46,60ec41ba55c00300382672d9,HDFC,Marketing Expense,5eecc6d6449e4f7cfb1c2708,2021-10-16T00:00:00.000Z,ME DC SI 514834XXXXXX9486 GOOGLESERVIS,,,Other,-2500
61b7092bd8beac1599eb7fb6,50200023535069,633055.46,60ec41ba55c00300382672d9,HDFC,Marketing Expense,5eecc6d6449e4f7cfb1c2708,2021-10-16T00:00:00.000Z,ME DC SI 514834XXXXXX9486 GOOGLESERVIS,,,Other,-5000
61b7092cd8beac1599eb7fbb,50200023535069,658794.4,60ec41ba55c00300382672d9,HDFC,Revenue-PG-non-split,5eecc6d6449e4f7cfb1c2708,2021-10-17T00:00:00.000Z,IMPS-129005435995-PAYTM PAYMENTS SERVI-P YTM-XXXXXXXXXX0008-ALL202110172168200003 30830668628,ewallet,,net_banking_transfer,25738.94
61b7092dd8beac1599eb7fbe,50200023535069,656294.4,60ec41ba55c00300382672d9,HDFC,Marketing Expense,5eecc6d6449e4f7cfb1c2708,2021-10-17T00:00:00.000Z,ME DC SI 514834XXXXXX9486 GOOGLESERVIS,,,Other,-2500
61b7092ed8beac1599eb7fc2,50200023535069,651294.4,60ec41ba55c00300382672d9,HDFC,Marketing Expense,5eecc6d6449e4f7cfb1c2708,2021-10-17T00:00:00.000Z,ME DC SI 514834XXXXXX9486 GOOGLESERVIS,,,Other,-5000
61b7092fd8beac1599eb7fca,50200023535069,648794.4,60ec41ba55c00300382672d9,HDFC,Marketing Expense,5eecc6d6449e4f7cfb1c2708,2021-10-17T00:00:00.000Z,ME DC SI 514834XXXXXX9486 GOOGLESERVIS,,,Other,-2500
61b70930d8beac1599eb7fd0,50200023535069,646294.4,60ec41ba55c00300382672d9,HDFC,Marketing Expense,5eecc6d6449e4f7cfb1c2708,2021-10-17T00:00:00.000Z,ME DC SI 514834XXXXXX9486 GOOGLESERVIS,,,Other,-2500
61b70931d8beac1599eb7fd4,50200023535069,641294.4,60ec41ba55c00300382672d9,HDFC,Marketing Expense,5eecc6d6449e4f7cfb1c2708,2021-10-17T00:00:00.000Z,ME DC SI 514834XXXXXX9486 GOOGLESERVIS,,,Other,-5000
61b70932d8beac1599eb7fd9,50200023535069,676058.74,60ec41ba55c00300382672d9,HDFC,Revenue-PG-non-split,5eecc6d6449e4f7cfb1c2708,2021-10-18T00:00:00.000Z,IMPS-129104653442-PAYTM PAYMENTS SERVI-P YTM-XXXXXXXXXX0008-ALL202110182168200003 30830668628,ewallet,,net_banking_transfer,34764.34
61b70933d8beac1599eb7fdd,50200023535069,691579.5,60ec41ba55c00300382672d9,HDFC,Revenue-PG-split enabled,5eecc6d6449e4f7cfb1c2708,2021-10-18T00:00:00.000Z,NEFT CR-UTIB0001506-RAZORPAY SOFTWARE PR IVATE LIMITED-SLICKORGANICSPVTLITD-AXISC N0099054007,insurance,,net_banking_transfer,15520.76
61b70934d8beac1599eb7fe5,50200023535069,686579.5,60ec41ba55c00300382672d9,HDFC,Marketing Expense,5eecc6d6449e4f7cfb1c2708,2021-10-18T00:00:00.000Z,ME DC SI 514834XXXXXX9486 GOOGLESERVIS,,,Other,-5000
61b70935d8beac1599eb7fe8,50200023535069,725509.65,60ec41ba55c00300382672d9,HDFC,Revenue-Mktplace,5eecc6d6449e4f7cfb1c2708,2021-10-18T00:00:00.000Z,NEFT CR-DEUT0797BGL-FLIPKART INTERNET PR IVATE LIMITED-SLICK ORGANICS PVT LTD-129 100249GN00038,shopping,,net_banking_transfer,38930.15
61b70936d8beac1599eb7fed,50200023535069,625509.65,60ec41ba55c00300382672d9,HDFC,direct expenses,5eecc6d6449e4f7cfb1c2708,2021-10-18T00:00:00.000Z,IMPS-129111176749-PAYTM-PYTM-XXXXXXXX383 9-100000,ewallet,,net_banking_transfer,-100000
61b70937d8beac1599eb7ff0,50200023535069,635509.65,60ec41ba55c00300382672d9,HDFC,Transfer in/Revenue-other,5eecc6d6449e4f7cfb1c2708,2021-10-18T00:00:00.000Z,NEFT CR-UTIB0003683-ALPHACMA PRIVATE LIM ITED-SLICK ORGANICS PVT LTD-AXIC21291341 5128,,,net_banking_transfer,10000
61b70938d8beac1599eb7fff,50200023535069,2454865.33,60ec41ba55c00300382672d9,HDFC,Revenue-Mktplace,5eecc6d6449e4f7cfb1c2708,2021-10-18T00:00:00.000Z,NEFT CR-HSBC0110004-CLOUDTAIL INDIA PRIV ATE LIMITED-SLICK ORGANICS PRIVATE LIMIT ED-HSBCN21291613013,,,net_banking_transfer,1819355.68
61b70939d8beac1599eb8006,50200023535069,2262409.33,60ec41ba55c00300382672d9,HDFC,direct expenses,5eecc6d6449e4f7cfb1c2708,2021-10-18T00:00:00.000Z,"NEFT DR-INDB0000333-NOASTRIX PRIVATE LIM ITED-NETBANK, MUM-N291211677726753-19245 6",,,net_banking_transfer,-192456
61b7093ad8beac1599eb800f,50200023535069,1704561.33,60ec41ba55c00300382672d9,HDFC,direct expenses,5eecc6d6449e4f7cfb1c2708,2021-10-18T00:00:00.000Z,"NEFT DR-ICIC0000369-BO INTERNATIONAL-NET BANK, MUM-N291211677798100-557848",,,net_banking_transfer,-557848
61b7093bd8beac1599eb8013,50200023535069,704561.33,60ec41ba55c00300382672d9,HDFC,Marketing Expense,5eecc6d6449e4f7cfb1c2708,2021-10-18T00:00:00.000Z,"NEFT DR-CITI0000006-FACEBOOK INDIA ONLIN E SERVICES PVT LTD-NETBANK, MUM-N2912116 77799048-1000000",,,net_banking_transfer,-1000000
61b7093cd8beac1599eb801b,50200023535069,702061.33,60ec41ba55c00300382672d9,HDFC,Marketing Expense,5eecc6d6449e4f7cfb1c2708,2021-10-18T00:00:00.000Z,ME DC SI 514834XXXXXX9486 GOOGLESERVIS,,,Other,-2500
61b7093dd8beac1599eb801f,50200023535069,704465.61,60ec41ba55c00300382672d9,HDFC,Transfer in/Revenue-other,5eecc6d6449e4f7cfb1c2708,2021-10-18T00:00:00.000Z,NEFT CR-ICIC0000105-ICICI BANK NODAL AC,,,net_banking_transfer,2404.28
61b7093ed8beac1599eb8030,50200023535069,710315.78,60ec41ba55c00300382672d9,HDFC,Revenue-Mktplace,5eecc6d6449e4f7cfb1c2708,2021-10-18T00:00:00.000Z,NEFT CR-ICIC0000105-ICICI BANK NODAL AC MANASH LIFESTYL-SLICK ORGANICS PRIVATE L IMITED MP G-ICIJ212910002638,,,net_banking_transfer,5850.17
61b7093fd8beac1599eb8033,50200023535069,710957.15,60ec41ba55c00300382672d9,HDFC,Revenue-Mktplace,5eecc6d6449e4f7cfb1c2708,2021-10-18T00:00:00.000Z,NEFT CR-ICIC0000105-ICICI BANK NODAL AC MANASH LIFESTYL-SLICK ORGANICS PRIVATE L IMITED KOLK-ICIJ212910002640,,,net_banking_transfer,641.37
61b70940d8beac1599eb8038,50200023535069,712889.36,60ec41ba55c00300382672d9,HDFC,Revenue-Mktplace,5eecc6d6449e4f7cfb1c2708,2021-10-18T00:00:00.000Z,NEFT CR-ICIC0000105-ICICI BANK NODAL AC MANASH LIFESTYL-SLICK ORGANICS PRIVATE L IMITED MP M-ICIJ212910002639,,,net_banking_transfer,1932.21
61b70941d8beac1599eb803b,50200023535069,690487.36,60ec41ba55c00300382672d9,HDFC,N-ACH payments,5eecc6d6449e4f7cfb1c2708,2021-10-18T00:00:00.000Z,POS 514834XXXXXX9486 GLOBAL PARACHEM,,,debit_card,-22402
61b70942d8beac1599eb804b,50200023535069,703591.91,60ec41ba55c00300382672d9,HDFC,Revenue-PG-split enabled,5eecc6d6449e4f7cfb1c2708,2021-10-18T00:00:00.000Z,NEFT CR-UTIB0001506-RAZORPAY SOFTWARE PR IVATE LIMITED-SLICKORGANICSPVTLITD-AXISC N0099171024,insurance,,net_banking_transfer,13104.55
61b70943d8beac1599eb8052,50200023535069,704719.42,60ec41ba55c00300382672d9,HDFC,Revenue-PG-non-split,5eecc6d6449e4f7cfb1c2708,2021-10-18T00:00:00.000Z,NEFT CR-IDFB0010204-SEZZLE PAYMENTS PRIV ATE LIMITED-SLICK ORGANICS PRIVATE LIMIT ED-IDFBH21291094904,insurance,,net_banking_transfer,1127.51
61b70944d8beac1599eb805a,50200023535069,705508.92,60ec41ba55c00300382672d9,HDFC,Revenue-PG-non-split,5eecc6d6449e4f7cfb1c2708,2021-10-18T00:00:00.000Z,NEFT CR-IDFB0010204-SEZZLE PAYMENTS PRIV ATE LIMITED-SLICK ORGANICS PRIVATE LIMIT ED-IDFBH21291095173,insurance,,net_banking_transfer,789.5
61b70945d8beac1599eb8060,50200023535069,709345.38,60ec41ba55c00300382672d9,HDFC,Revenue-PG-non-split,5eecc6d6449e4f7cfb1c2708,2021-10-18T00:00:00.000Z,NEFT CR-IDFB0010204-SEZZLE PAYMENTS PRIV ATE LIMITED-SLICK ORGANICS PRIVATE LIMIT ED-IDFBH21291095360,insurance,,net_banking_transfer,3836.46
61b70946d8beac1599eb8065,50200023535069,720589.07,60ec41ba55c00300382672d9,HDFC,Revenue-COD,5eecc6d6449e4f7cfb1c2708,2021-10-18T00:00:00.000Z,NEFT CR-ICIC0000155-SHIPROCKET COD CRF I D 3237760-SLICK ORGANICS PVT LTD-CMS2188 196206,insurance,,net_banking_transfer,11243.69
61b70947d8beac1599eb806a,50200023535069,783301.07,60ec41ba55c00300382672d9,HDFC,Revenue-COD,5eecc6d6449e4f7cfb1c2708,2021-10-18T00:00:00.000Z,NEFT CR-KKBK0000958-PICKRR TECHNOLOGIES PVT LTD-SLICKORGANICSPRIVATELIMITED-CMS2 912102357762,insurance,,net_banking_transfer,62712
61b70948d8beac1599eb8072,50200023535069,670951.07,60ec41ba55c00300382672d9,HDFC,direct expenses,5eecc6d6449e4f7cfb1c2708,2021-10-18T00:00:00.000Z,00918630000430-TPT-112350-UNICOMMERCE ES OLUTIONS PRIVATE LIMITED,,,net_banking_transfer,-112350
61b70949d8beac1599eb8075,50200023535069,570951.07,60ec41ba55c00300382672d9,HDFC,direct expenses,5eecc6d6449e4f7cfb1c2708,2021-10-18T00:00:00.000Z,"NEFT DR-PYTM0123456-PAYTM-NETBANK, MUM-N",ewallet,,net_banking_transfer,-100000
61b7094ad8beac1599eb807a,50200023535069,565951.07,60ec41ba55c00300382672d9,HDFC,Marketing Expense,5eecc6d6449e4f7cfb1c2708,2021-10-18T00:00:00.000Z,ME DC SI 514834XXXXXX9486 GOOGLESERVIS,,,Other,-5000
61b7094bd8beac1599eb807d,50200023535069,599153.26,60ec41ba55c00300382672d9,HDFC,Revenue-PG-non-split,5eecc6d6449e4f7cfb1c2708,2021-10-19T00:00:00.000Z,IMPS-129204966930-PAYTM PAYMENTS SERVI-P YTM-XXXXXXXXXX0008-ALL202110192168200003 30830668628,ewallet,,net_banking_transfer,33202.19
61b7094cd8beac1599eb8081,50200023535069,653192.7,60ec41ba55c00300382672d9,HDFC,Revenue-Mktplace,5eecc6d6449e4f7cfb1c2708,2021-10-19T00:00:00.000Z,IMPS-129205258279-AMAZON SELLER SERVIC-H SBC-XXXXXXXX6004-6LL5BRLSFWO9KNAVSLICK O RGANICS PVT LTD,shopping,,net_banking_transfer,54039.44
61b7094dd8beac1599eb8088,50200023535069,784707.98,60ec41ba55c00300382672d9,HDFC,Revenue-Mktplace,5eecc6d6449e4f7cfb1c2708,2021-10-19T00:00:00.000Z,NEFT CR-DEUT0797BGL-AMAZON PAY (INDIA) P RIVATE LIMITED-SLICK ORGANICS PVT LTD-12 9200073GN00618,shopping,,net_banking_transfer,131515.28
61b7094ed8beac1599eb808d,50200023535069,763385.98,60ec41ba55c00300382672d9,HDFC,direct expenses,5eecc6d6449e4f7cfb1c2708,2021-10-19T00:00:00.000Z,"NEFT DR-ICIC0000021-AKHILESH DIXIT-NETBA NK, MUM-N292211678649372-21322",,,net_banking_transfer,-21322
61b7094fd8beac1599eb8093,50200023535069,774761.95,60ec41ba55c00300382672d9,HDFC,Revenue-COD,5eecc6d6449e4f7cfb1c2708,2021-10-19T00:00:00.000Z,NEFT CR-ICIC0000155-SHIPROCKET COD CRF I D 3254126-SLICK ORGANICS PVT LTD-CMS2189 371419,insurance,,net_banking_transfer,11375.97
61b70950d8beac1599eb809a,50200023535069,772261.95,60ec41ba55c00300382672d9,HDFC,Marketing Expense,5eecc6d6449e4f7cfb1c2708,2021-10-19T00:00:00.000Z,ME DC SI 514834XXXXXX9486 GOOGLESERVIS,,,Other,-2500
61b70951d8beac1599eb809e,50200023535069,769761.95,60ec41ba55c00300382672d9,HDFC,Marketing Expense,5eecc6d6449e4f7cfb1c2708,2021-10-19T00:00:00.000Z,ME DC SI 514834XXXXXX9486 GOOGLESERVIS,,,Other,-2500
61b70952d8beac1599eb80a7,50200023535069,744981.95,60ec41ba55c00300382672d9,HDFC,direct expenses,5eecc6d6449e4f7cfb1c2708,2021-10-19T00:00:00.000Z,POS 514834XXXXXX9486 RAZ*KNOWLARITY,,,debit_card,-24780
61b70953d8beac1599eb80aa,50200023535069,745585.95,60ec41ba55c00300382672d9,HDFC,Revenue-Mktplace,5eecc6d6449e4f7cfb1c2708,2021-10-19T00:00:00.000Z,NEFT CR-ICIC0000105-ICICI BANK NODAL AC MANASH LIFESTYL-SLICK ORGANICS PRIVATE L IMITED HYD-ICIJ212920003503,,,net_banking_transfer,604
61b70954d8beac1599eb80af,50200023535069,746472.88,60ec41ba55c00300382672d9,HDFC,Revenue-Mktplace,5eecc6d6449e4f7cfb1c2708,2021-10-19T00:00:00.000Z,NEFT CR-ICIC0000105-ICICI BANK NODAL AC MANASH LIFESTYL-SLICK ORGANICS PRIVATE L IMITED MP M-ICIJ212920003500,,,net_banking_transfer,886.93
61b70955d8beac1599eb80d1,50200023535069,746659.07,60ec41ba55c00300382672d9,HDFC,Revenue-Mktplace,5eecc6d6449e4f7cfb1c2708,2021-10-19T00:00:00.000Z,NEFT CR-ICIC0000105-ICICI BANK NODAL AC MANASH LIFESTYL-SLICK ORGANICS PRIVATE L IMITED KOLK-ICIJ212920003502,,,net_banking_transfer,186.19
61b70956d8beac1599eb80d4,50200023535069,741659.07,60ec41ba55c00300382672d9,HDFC,Marketing Expense,5eecc6d6449e4f7cfb1c2708,2021-10-19T00:00:00.000Z,ME DC SI 514834XXXXXX9486 GOOGLESERVIS,,,Other,-5000
61b70957d8beac1599eb80db,50200023535069,739159.07,60ec41ba55c00300382672d9,HDFC,Marketing Expense,5eecc6d6449e4f7cfb1c2708,2021-10-19T00:00:00.000Z,ME DC SI 514834XXXXXX9486 GOOGLESERVIS,,,Other,-2500
61b70958d8beac1599eb80e1,50200023535069,785696.04,60ec41ba55c00300382672d9,HDFC,Revenue-PG-non-split,5eecc6d6449e4f7cfb1c2708,2021-10-20T00:00:00.000Z,IMPS-129304170456-PAYTM PAYMENTS SERVI-P YTM-XXXXXXXXXX0008-ALL202110202168200003 30830668628,ewallet,,net_banking_transfer,46536.97
61b70959d8beac1599eb80e6,50200023535069,832080.77,60ec41ba55c00300382672d9,HDFC,Revenue-Mktplace,5eecc6d6449e4f7cfb1c2708,2021-10-20T00:00:00.000Z,NEFT CR-DEUT0797BGL-FLIPKART INTERNET PR IVATE LIMITED-SLICK ORGANICS PVT LTD-129 300141GN00273,shopping,,net_banking_transfer,46384.73
61b7095ad8beac1599eb80ec,50200023535069,826818.86,60ec41ba55c00300382672d9,HDFC,direct expenses,5eecc6d6449e4f7cfb1c2708,2021-10-20T00:00:00.000Z,POS 514834XXXXXX9486 FEEDBACKFIVE,,,debit_card,-5261.91
61b7095bd8beac1599eb80f1,50200023535069,841072.15,60ec41ba55c00300382672d9,HDFC,Revenue-PG-split enabled,5eecc6d6449e4f7cfb1c2708,2021-10-20T00:00:00.000Z,NEFT CR-UTIB0001506-RAZORPAY SOFTWARE PR IVATE LIMITED-SLICKORGANICSPVTLITD-AXISC N0099345754,insurance,,net_banking_transfer,14253.29
61b7095cd8beac1599eb8100,50200023535069,836072.15,60ec41ba55c00300382672d9,HDFC,Marketing Expense,5eecc6d6449e4f7cfb1c2708,2021-10-20T00:00:00.000Z,ME DC SI 514834XXXXXX9486 GOOGLESERVIS,,,Other,-5000
61b7095dd8beac1599eb8110,50200023535069,809261.07,60ec41ba55c00300382672d9,HDFC,direct expenses,5eecc6d6449e4f7cfb1c2708,2021-10-20T00:00:00.000Z,POS 514834XXXXXX9486 AMZN AD TR95V0H3,,,debit_card,-26811.08
61b7095ed8beac1599eb8122,50200023535069,769002.56,60ec41ba55c00300382672d9,HDFC,direct expenses,5eecc6d6449e4f7cfb1c2708,2021-10-20T00:00:00.000Z,POS 514834XXXXXX9486 THE ROCKET SCIEN,,,debit_card,-40258.51
61b7095fd8beac1599eb8137,50200023535069,769746.57,60ec41ba55c00300382672d9,HDFC,Revenue-PG-non-split,5eecc6d6449e4f7cfb1c2708,2021-10-20T00:00:00.000Z,NEFT CR-KKBK0000958-BROKENTUSK TECHNOLOG IES PRIVATE LIMITED-SLICK ORGANICS PRIVA TE LIMITED-KKBK212937356656,,,net_banking_transfer,744.01
61b70960d8beac1599eb813c,50200023535069,770345.05,60ec41ba55c00300382672d9,HDFC,Revenue-PG-non-split,5eecc6d6449e4f7cfb1c2708,2021-10-20T00:00:00.000Z,NEFT CR-IDFB0010204-SEZZLE PAYMENTS PRIV ATE LIMITED-SLICK ORGANICS PRIVATE LIMIT ED-IDFBH21293206672,insurance,,net_banking_transfer,598.48
61b70961d8beac1599eb814a,50200023535069,772631.95,60ec41ba55c00300382672d9,HDFC,Revenue-PG-split enabled,5eecc6d6449e4f7cfb1c2708,2021-10-20T00:00:00.000Z,NEFT CR-UTIB0001506-RAZORPAY SOFTWARE PR IVATE LIMITED-SLICKORGANICSPVTLITD-AXISC N0099455725,insurance,,net_banking_transfer,2286.9
61b70962d8beac1599eb8156,50200023535069,775916.22,60ec41ba55c00300382672d9,HDFC,Revenue-PG-non-split,5eecc6d6449e4f7cfb1c2708,2021-10-20T00:00:00.000Z,NEFT CR-SCBL0036001-STRIPE INDIA PRIVATE -SLICK ORGANICS PRIVATE LIMITED-SSG17413 Q0428771,insurance,,net_banking_transfer,3284.27
61b70963d8beac1599eb815d,50200023535069,778125.42,60ec41ba55c00300382672d9,HDFC,Revenue-COD,5eecc6d6449e4f7cfb1c2708,2021-10-20T00:00:00.000Z,NEFT CR-ICIC0000155-SHIPROCKET COD CRF I D 3266497-SLICK ORGANICS PVT LTD-CMS2192 145277,insurance,,net_banking_transfer,2209.2
61b70964d8beac1599eb816d,50200023535069,773125.42,60ec41ba55c00300382672d9,HDFC,Marketing Expense,5eecc6d6449e4f7cfb1c2708,2021-10-20T00:00:00.000Z,ME DC SI 514834XXXXXX9486 GOOGLESERVIS,,,Other,-5000
61b70965d8beac1599eb8172,50200023535069,770625.42,60ec41ba55c00300382672d9,HDFC,Marketing Expense,5eecc6d6449e4f7cfb1c2708,2021-10-20T00:00:00.000Z,ME DC SI 514834XXXXXX9486 GOOGLESERVIS,,,Other,-2500
61b70966d8beac1599eb817d,50200023535069,776928.72,60ec41ba55c00300382672d9,HDFC,Revenue-PG-non-split,5eecc6d6449e4f7cfb1c2708,2021-10-21T00:00:00.000Z,UPI-PAYTM-PPSL-PAYOUTS@PAYTM-PYTM0123456 -129453733099-ALL202110212168200,ewallet,,upi,6303.3
61b70967d8beac1599eb8182,50200023535069,778483.02,60ec41ba55c00300382672d9,HDFC,Revenue-PG-split enabled,5eecc6d6449e4f7cfb1c2708,2021-10-21T00:00:00.000Z,NEFT CR-UTIB0001506-RAZORPAY SOFTWARE PR IVATE LIMITED-SLICKORGANICSPVTLITD-AXISC N0099538659,insurance,,net_banking_transfer,1554.3
61b70968d8beac1599eb8189,50200023535069,778394.12,60ec41ba55c00300382672d9,HDFC,bank charges,5eecc6d6449e4f7cfb1c2708,2021-10-21T00:00:00.000Z,.DC INTL POS TXN MARKUP+ST 011021 021021 -CDT2129006154227,,,international_transaction_arbitrage,-88.9
61b70969d8beac1599eb8190,50200023535069,709212.04,60ec41ba55c00300382672d9,HDFC,direct expenses,5eecc6d6449e4f7cfb1c2708,2021-10-21T00:00:00.000Z,ADVANCE PAYMENT OF IMPORT BILL,bills,,Other,-69182.08
61b7096ad8beac1599eb8197,50200023535069,745608.7,60ec41ba55c00300382672d9,HDFC,Revenue-PG-non-split,5eecc6d6449e4f7cfb1c2708,2021-10-21T00:00:00.000Z,NEFT CR-KKBK0000958-BROKENTUSK TECHNOLOG IES PRIVATE LIMITED-SLICK ORGANICS PRIVA TE LIMITED-KKBK212947642263,,,net_banking_transfer,36396.66
61b7096bd8beac1599eb81a1,50200023535069,745223.31,60ec41ba55c00300382672d9,HDFC,bank charges,5eecc6d6449e4f7cfb1c2708,2021-10-21T00:00:00.000Z,.DC INTL POS TXN MARKUP+ST 061021 081021 -CDT2129006154227,,,international_transaction_arbitrage,-385.39
61b7096cd8beac1599eb81aa,50200023535069,746580.29,60ec41ba55c00300382672d9,HDFC,Revenue-PG-non-split,5eecc6d6449e4f7cfb1c2708,2021-10-21T00:00:00.000Z,NEFT CR-IDFB0010204-SEZZLE PAYMENTS PRIV ATE LIMITED-SLICK ORGANICS PRIVATE LIMIT ED-IDFBH21294289351,insurance,,net_banking_transfer,1356.98
61b7096dd8beac1599eb81b5,50200023535069,785088.29,60ec41ba55c00300382672d9,HDFC,Revenue-COD,5eecc6d6449e4f7cfb1c2708,2021-10-21T00:00:00.000Z,PICKRR TECHNOL-CODAKHILESHDIXIT85GM,,,Other,38508
61b7096ed8beac1599eb81bf,50200023535069,786011.9,60ec41ba55c00300382672d9,HDFC,Revenue-Mktplace,5eecc6d6449e4f7cfb1c2708,2021-10-21T00:00:00.000Z,NEFT CR-ICIC0000105-ICICI BANK NODAL AC MANASH LIFESTYL-SLICK ORGANICS PRIVATE L IMITED HYD-ICIJ212940002804,,,net_banking_transfer,923.61
61b7096fd8beac1599eb81c4,50200023535069,795462.6,60ec41ba55c00300382672d9,HDFC,Revenue-Mktplace,5eecc6d6449e4f7cfb1c2708,2021-10-21T00:00:00.000Z,NEFT CR-ICIC0000105-ICICI BANK NODAL AC MANASH LIFESTYL-SLICK ORGANICS PRIVATE L IMITED MP G-ICIJ212940002876,,,net_banking_transfer,9450.7
61b70970d8beac1599eb81cc,50200023535069,797708.51,60ec41ba55c00300382672d9,HDFC,Revenue-Mktplace,5eecc6d6449e4f7cfb1c2708,2021-10-21T00:00:00.000Z,NEFT CR-ICIC0000105-ICICI BANK NODAL AC MANASH LIFESTYL-SLICK ORGANICS PRIVATE L IMITED MP M-ICIJ212940002877,,,net_banking_transfer,2245.91
61b70971d8beac1599eb81cf,50200023535069,798350.92,60ec41ba55c00300382672d9,HDFC,Revenue-PG-split enabled,5eecc6d6449e4f7cfb1c2708,2021-10-21T00:00:00.000Z,NEFT CR-UTIB0001506-RAZORPAY SOFTWARE PR,,,net_banking_transfer,642.41
61b70972d8beac1599eb81d4,50200023535069,812262.06,60ec41ba55c00300382672d9,HDFC,Revenue-PG-non-split,5eecc6d6449e4f7cfb1c2708,2021-10-22T00:00:00.000Z,IMPS-129504531387-PAYTM PAYMENTS SERVI-P YTM-XXXXXXXXXX0008-ALL202110222168200003 30830668628,ewallet,,net_banking_transfer,13911.14
61b70973d8beac1599eb81d8,50200023535069,848286.85,60ec41ba55c00300382672d9,HDFC,Revenue-Mktplace,5eecc6d6449e4f7cfb1c2708,2021-10-22T00:00:00.000Z,NEFT CR-DEUT0797BGL-FLIPKART INTERNET PR IVATE LIMITED-SLICK ORGANICS PVT LTD-129 500092GN00283,shopping,,net_banking_transfer,36024.79
61b70974d8beac1599eb81dc,50200023535069,849883.71,60ec41ba55c00300382672d9,HDFC,Revenue-PG-split enabled,5eecc6d6449e4f7cfb1c2708,2021-10-22T00:00:00.000Z,NEFT CR-UTIB0001506-RAZORPAY SOFTWARE PR IVATE LIMITED-SLICKORGANICSPVTLITD-AXISC N0099759355,insurance,,net_banking_transfer,1596.86
61b70975d8beac1599eb81e4,50200023535069,850752.04,60ec41ba55c00300382672d9,HDFC,Revenue-PG-non-split,5eecc6d6449e4f7cfb1c2708,2021-10-22T00:00:00.000Z,NEFT CR-YESB0000001-RZPX PVT LTD NODAL A CCOUNT-SLICKORGANICS-N295210814011451,insurance,,salary,868.33
61b70976d8beac1599eb81eb,50200023535069,825752.04,60ec41ba55c00300382672d9,HDFC,direct expenses,5eecc6d6449e4f7cfb1c2708,2021-10-22T00:00:00.000Z,POS 514834XXXXXX9486 SHIPROCKET,,,debit_card,-25000
61b70977d8beac1599eb81f0,50200023535069,828110.24,60ec41ba55c00300382672d9,HDFC,Revenue-Mktplace,5eecc6d6449e4f7cfb1c2708,2021-10-22T00:00:00.000Z,NEFT CR-DEUT0784BBY-TATA UNISTORE LIMITE D-SLICK ORGANICS PVT LTD-129500633GN0025 0,insurance,,net_banking_transfer,2358.2
61b70978d8beac1599eb81fb,50200023535069,829035.35,60ec41ba55c00300382672d9,HDFC,Revenue-Mktplace,5eecc6d6449e4f7cfb1c2708,2021-10-22T00:00:00.000Z,NEFT CR-DEUT0784BBY-TATA UNISTORE LTD-NO DAL-SLICK ORGANICS PVT LTD-129500644GN00 609,insurance,,net_banking_transfer,925.11
61b70979d8beac1599eb81ff,50200023535069,829501.07,60ec41ba55c00300382672d9,HDFC,Revenue-Mktplace,5eecc6d6449e4f7cfb1c2708,2021-10-22T00:00:00.000Z,NEFT CR-DEUT0784BBY-TATA UNISTORE LTD-NO DAL-SLICK ORGANICS PVT LTD-129500644GN00 433,insurance,,net_banking_transfer,465.72
61b7097ad8beac1599eb8207,50200023535069,865983.97,60ec41ba55c00300382672d9,HDFC,Revenue-PG-non-split,5eecc6d6449e4f7cfb1c2708,2021-10-22T00:00:00.000Z,NEFT CR-KKBK0000958-BROKENTUSK TECHNOLOG IES PRIVATE LIMITED-SLICK ORGANICS PRIVA TE LIMITED-KKBK212957926235,,,net_banking_transfer,36482.9
61b7097bd8beac1599eb822e,50200023535069,866393.72,60ec41ba55c00300382672d9,HDFC,Revenue-Mktplace,5eecc6d6449e4f7cfb1c2708,2021-10-22T00:00:00.000Z,NEFT CR-ICIC0000105-ICICI BANK NODAL AC MANASH LIFESTYL-SLICK ORGANICS PRIVATE L IMITED HYD-ICIJ212950003399,,,net_banking_transfer,409.75
61b7097cd8beac1599eb8234,50200023535069,866803.47,60ec41ba55c00300382672d9,HDFC,Revenue-Mktplace,5eecc6d6449e4f7cfb1c2708,2021-10-22T00:00:00.000Z,NEFT CR-ICIC0000105-ICICI BANK NODAL AC MANASH LIFESTYL-SLICK ORGANICS PRIVATE L IMITED MP G-ICIJ212950003514,,,net_banking_transfer,409.75
61b7097dd8beac1599eb8239,50200023535069,900916.28,60ec41ba55c00300382672d9,HDFC,Transfer in/Revenue-other,5eecc6d6449e4f7cfb1c2708,2021-10-22T00:00:00.000Z,NEFT CR-UTIB0004405-WOOVLY INDIA PRIVATE,,,net_banking_transfer,34112.81
61b7097ed8beac1599eb823e,50200023535069,996987.97,60ec41ba55c00300382672d9,HDFC,Transfer in/Revenue-other,5eecc6d6449e4f7cfb1c2708,2021-10-22T00:00:00.000Z,NEFT CR-UTIB0004405-WOOVLY INDIA PRIVATE LIMITED-SLICK ORGANICS PVT LTD-AXISP002 33762295,insurance,,net_banking_transfer,96071.69
61b7097fd8beac1599eb8248,50200023535069,1011084.63,60ec41ba55c00300382672d9,HDFC,Transfer in/Revenue-other,5eecc6d6449e4f7cfb1c2708,2021-10-22T00:00:00.000Z,NEFT CR-UTIB0004405-WOOVLY INDIA PRIVATE LIMITED-SLICK ORGANICS PVT LTD-AXISP002 33762293,insurance,,net_banking_transfer,14096.66
61b70980d8beac1599eb8257,50200023535069,1047516.07,60ec41ba55c00300382672d9,HDFC,Revenue-PG-non-split,5eecc6d6449e4f7cfb1c2708,2021-10-23T00:00:00.000Z,IMPS-129604631212-PAYTM PAYMENTS SERVI-P YTM-XXXXXXXXXX0008-ALL202110232168200003 30830668628,ewallet,,net_banking_transfer,36431.44
61b70981d8beac1599eb825d,50200023535069,1048066.15,60ec41ba55c00300382672d9,HDFC,Transfer in/Revenue-other,5eecc6d6449e4f7cfb1c2708,2021-10-23T00:00:00.000Z,FT - C78280231021025238 - - 50200050045 240 - ZOOBOP ME WORKS PRIVATE LIMITED,,,Other,550.08
61b70982d8beac1599eb8263,50200023535069,793066.15,60ec41ba55c00300382672d9,HDFC,SAAS/tech expense,5eecc6d6449e4f7cfb1c2708,2021-10-23T00:00:00.000Z,KQSXY44KA5Z2NNGWC4/PAYUAMAZON,shopping,,Other,-255000
61b70983d8beac1599eb8267,50200023535069,810741.61,60ec41ba55c00300382672d9,HDFC,Revenue-PG-non-split,5eecc6d6449e4f7cfb1c2708,2021-10-24T00:00:00.000Z,IMPS-129704740100-PAYTM PAYMENTS SERVI-P YTM-XXXXXXXXXX0008-ALL202110242168200003 30830668628,ewallet,,net_banking_transfer,17675.46
61b70984d8beac1599eb826f,50200023535069,773077.74,60ec41ba55c00300382672d9,HDFC,direct expenses,5eecc6d6449e4f7cfb1c2708,2021-10-25T00:00:00.000Z,POS 514834XXXXXX9486 AMZN AD TR95V0H3,,,debit_card,-37663.87
61b70985d8beac1599eb8272,50200023535069,776901.57,60ec41ba55c00300382672d9,HDFC,Revenue-PG-non-split,5eecc6d6449e4f7cfb1c2708,2021-10-25T00:00:00.000Z,UPI-PAYTM-PPSL-PAYOUTS@PAYTM-PYTM0123456 -129821397379-ALL202110252168200,ewallet,,upi,3823.83
61b70986d8beac1599eb827d,50200023535069,778346.61,60ec41ba55c00300382672d9,HDFC,Transfer in/Revenue-other,5eecc6d6449e4f7cfb1c2708,2021-10-25T00:00:00.000Z,ZOOBOP ME WORK-ARATA,,,Other,1445.04
61b70987d8beac1599eb8283,50200023535069,796752.75,60ec41ba55c00300382672d9,HDFC,Revenue-PG-split enabled,5eecc6d6449e4f7cfb1c2708,2021-10-25T00:00:00.000Z,NEFT CR-UTIB0001506-RAZORPAY SOFTWARE PR IVATE LIMITED-SLICKORGANICSPVTLITD-AXISC N0100227209,insurance,,net_banking_transfer,18406.14
61b70988d8beac1599eb8286,50200023535069,800829.91,60ec41ba55c00300382672d9,HDFC,Revenue-Mktplace,5eecc6d6449e4f7cfb1c2708,2021-10-25T00:00:00.000Z,NEFT CR-DEUT0797BGL-FLIPKART INTERNET PR IVATE LIMITED-SLICK ORGANICS PVT LTD-129 800219GN00246,shopping,,net_banking_transfer,4077.16
61b70989d8beac1599eb828d,50200023535069,836383.88,60ec41ba55c00300382672d9,HDFC,Revenue-Mktplace,5eecc6d6449e4f7cfb1c2708,2021-10-25T00:00:00.000Z,NEFT CR-DEUT0797BGL-FLIPKART INTERNET PR IVATE LIMITED-SLICK ORGANICS PVT LTD-129 800178GN00159,shopping,,net_banking_transfer,35553.97
61b7098ad8beac1599eb8293,50200023535069,839632.38,60ec41ba55c00300382672d9,HDFC,Revenue-PG-non-split,5eecc6d6449e4f7cfb1c2708,2021-10-25T00:00:00.000Z,NEFT CR-SCBL0036001-STRIPE INDIA PRIVATE,,,net_banking_transfer,3248.5
61b7098bd8beac1599eb8298,50200023535069,829632.38,60ec41ba55c00300382672d9,HDFC,direct expenses,5eecc6d6449e4f7cfb1c2708,2021-10-25T00:00:00.000Z,POS 514834XXXXXX9486 RAZ*PURPLLE,,,debit_card,-10000
61b7098cd8beac1599eb82a3,50200023535069,804632.38,60ec41ba55c00300382672d9,HDFC,direct expenses,5eecc6d6449e4f7cfb1c2708,2021-10-25T00:00:00.000Z,POS 514834XXXXXX9486 FLIPKART,shopping,,debit_card,-25000
61b7098dd8beac1599eb82a9,50200023535069,807812.38,60ec41ba55c00300382672d9,HDFC,Transfer in/Revenue-other,5eecc6d6449e4f7cfb1c2708,2021-10-25T00:00:00.000Z,NEFT CR-KKBK0000958-INNOVATIVE RETAIL CO NCEPTS PRIVATE LTD-SLICK ORGANICS PVT LT D-KKBK212988502294,,,net_banking_transfer,3180
61b7098ed8beac1599eb82b1,50200023535069,958777.41,60ec41ba55c00300382672d9,HDFC,Revenue-PG-non-split,5eecc6d6449e4f7cfb1c2708,2021-10-25T00:00:00.000Z,NEFT CR-KKBK0000958-BROKENTUSK TECHNOLOG IES PRIVATE LIMITED-SLICK ORGANICS PRIVA TE LIMITED-KKBK212988513669,,,net_banking_transfer,150965.03
61b7098fd8beac1599eb82b4,50200023535069,995821.11,60ec41ba55c00300382672d9,HDFC,Revenue-PG-non-split,5eecc6d6449e4f7cfb1c2708,2021-10-25T00:00:00.000Z,NEFT CR-KKBK0000958-BROKENTUSK TECHNOLOG IES PRIVATE LIMITED-SLICK ORGANICS PRIVA TE LIMITED-KKBK212988516852,,,net_banking_transfer,37043.7
61b70990d8beac1599eb82b8,50200023535069,1033695.86,60ec41ba55c00300382672d9,HDFC,Revenue-PG-non-split,5eecc6d6449e4f7cfb1c2708,2021-10-25T00:00:00.000Z,NEFT CR-KKBK0000958-BROKENTUSK TECHNOLOG IES PRIVATE LIMITED-SLICK ORGANICS PRIVA TE LIMITED-KKBK212988519321,,,net_banking_transfer,37874.75
61b70991d8beac1599eb82bd,50200023535069,1035329.57,60ec41ba55c00300382672d9,HDFC,Transfer in/Revenue-other,5eecc6d6449e4f7cfb1c2708,2021-10-25T00:00:00.000Z,4060005931-25 10 2021-HDFAZCUR1,,,Other,1633.71
61b70992d8beac1599eb82c0,50200023535069,1036857.02,60ec41ba55c00300382672d9,HDFC,Revenue-PG-split enabled,5eecc6d6449e4f7cfb1c2708,2021-10-25T00:00:00.000Z,NEFT CR-UTIB0001506-RAZORPAY SOFTWARE PR IVATE LIMITED-SLICKORGANICSPVTLITD-AXISC N0100367206,insurance,,net_banking_transfer,1527.45
61b70993d8beac1599eb82c7,50200023535069,1060756.02,60ec41ba55c00300382672d9,HDFC,Revenue-Mktplace,5eecc6d6449e4f7cfb1c2708,2021-10-25T00:00:00.000Z,NEFT CR-SCBL0036001-M/S DREAMPLUG TECHNO -SLICK ORGANICS PRIVATE LIMITEDSLICK-SIN 31436Q0024117,insurance,,net_banking_transfer,23899
61b70994d8beac1599eb82cb,50200023535069,1057117.42,60ec41ba55c00300382672d9,HDFC,direct expenses,5eecc6d6449e4f7cfb1c2708,2021-10-25T00:00:00.000Z,POS 514834XXXXXX9486 FRESHWORKS INC,,,debit_card,-3638.6
61b70995d8beac1599eb82d1,50200023535069,1058874.32,60ec41ba55c00300382672d9,HDFC,Revenue-PG-non-split,5eecc6d6449e4f7cfb1c2708,2021-10-25T00:00:00.000Z,NEFT CR-IDFB0010204-SEZZLE PAYMENTS PRIV ATE LIMITED-SLICK ORGANICS PRIVATE LIMIT ED-IDFBH21298477868,insurance,,net_banking_transfer,1756.9
61b70996d8beac1599eb82d9,50200023535069,1067410.24,60ec41ba55c00300382672d9,HDFC,Revenue-PG-non-split,5eecc6d6449e4f7cfb1c2708,2021-10-26T00:00:00.000Z,UPI-PAYTM-PPSL-PAYOUTS@PAYTM-PYTM0123456 -129963091534-ALL202110262168200,ewallet,,upi,8535.92
61b70997d8beac1599eb82db,50200023535069,1076369.87,60ec41ba55c00300382672d9,HDFC,Revenue-Mktplace,5eecc6d6449e4f7cfb1c2708,2021-10-26T00:00:00.000Z,IMPS-129905160575-AMAZON SELLER SERVIC-H SBC-XXXXXXXX6004-4KN8H1AVYZEDIZ8ZSLICK O RGANICS PVT LTD,shopping,,net_banking_transfer,8959.63
61b70998d8beac1599eb82e3,50200023535069,1078817.06,60ec41ba55c00300382672d9,HDFC,Revenue-PG-split enabled,5eecc6d6449e4f7cfb1c2708,2021-10-26T00:00:00.000Z,NEFT CR-UTIB0001506-RAZORPAY SOFTWARE PR,,,net_banking_transfer,2447.19
61b70999d8beac1599eb82e8,50200023535069,1136528.72,60ec41ba55c00300382672d9,HDFC,Revenue-Mktplace,5eecc6d6449e4f7cfb1c2708,2021-10-26T00:00:00.000Z,NEFT CR-DEUT0797BGL-AMAZON PAY (INDIA) P RIVATE LIMITED-SLICK ORGANICS PVT LTD-12 9900060GN00468,shopping,,net_banking_transfer,57711.66
61b7099ad8beac1599eb82ec,50200023535069,1167471.77,60ec41ba55c00300382672d9,HDFC,Revenue-PG-non-split,5eecc6d6449e4f7cfb1c2708,2021-10-26T00:00:00.000Z,NEFT CR-KKBK0000958-BROKENTUSK TECHNOLOG IES PRIVATE LIMITED-SLICK ORGANICS PRIVA TE LIMITED-KKBK212998791882,,,net_banking_transfer,30943.05
61b7099ad8beac1599eb82f1,50200023535069,1171277.53,60ec41ba55c00300382672d9,HDFC,Revenue-Mktplace,5eecc6d6449e4f7cfb1c2708,2021-10-26T00:00:00.000Z,NEFT CR-ICIC0000105-ICICI BANK NODAL AC MANASH LIFESTYL-SLICK ORGANICS PRIVATE L IMITED MP G-ICIJ212990005996,,,net_banking_transfer,3805.76
61b7099bd8beac1599eb82f4,50200023535069,1171778.17,60ec41ba55c00300382672d9,HDFC,Revenue-Mktplace,5eecc6d6449e4f7cfb1c2708,2021-10-26T00:00:00.000Z,NEFT CR-ICIC0000105-ICICI BANK NODAL AC MANASH LIFESTYL-SLICK ORGANICS PRIVATE L IMITED KOLK-ICIJ212990004044,,,net_banking_transfer,500.64
61b7099cd8beac1599eb82f8,50200023535069,1172193.05,60ec41ba55c00300382672d9,HDFC,Revenue-Mktplace,5eecc6d6449e4f7cfb1c2708,2021-10-26T00:00:00.000Z,NEFT CR-ICIC0000105-ICICI BANK NODAL AC MANASH LIFESTYL-SLICK ORGANICS PRIVATE L IMITED HYD-ICIJ212990004045,,,net_banking_transfer,414.88
61b7099dd8beac1599eb82ff,50200023535069,1176349.57,60ec41ba55c00300382672d9,HDFC,Revenue-PG-non-split,5eecc6d6449e4f7cfb1c2708,2021-10-26T00:00:00.000Z,NEFT CR-IDFB0010204-SEZZLE PAYMENTS PRIV ATE LIMITED-SLICK ORGANICS PRIVATE LIMIT ED-IDFBH21299546973,insurance,,net_banking_transfer,4156.52
61b7099fd8beac1599eb8304,50200023535069,1249902.57,60ec41ba55c00300382672d9,HDFC,Revenue-COD,5eecc6d6449e4f7cfb1c2708,2021-10-26T00:00:00.000Z,NEFT CR-KKBK0000958-PICKRR TECHNOLOGIES PVT LTD-SLICKORGANICSPRIVATELIMITED-CMS2 992102581964,insurance,,net_banking_transfer,73553
61b709a0d8beac1599eb830b,50200023535069,1251050.77,60ec41ba55c00300382672d9,HDFC,Revenue-PG-split enabled,5eecc6d6449e4f7cfb1c2708,2021-10-26T00:00:00.000Z,NEFT CR-UTIB0001506-RAZORPAY SOFTWARE PR IVATE LIMITED-SLICKORGANICSPVTLITD-AXISC N0100589607,insurance,,net_banking_transfer,1148.2
61b709a1d8beac1599eb830e,50200023535069,1261623.35,60ec41ba55c00300382672d9,HDFC,Revenue-PG-non-split,5eecc6d6449e4f7cfb1c2708,2021-10-27T00:00:00.000Z,IMPS-130004221224-PAYTM PAYMENTS SERVI-P YTM-XXXXXXXXXX0008-ALL202110272168200003 30830668628,ewallet,,net_banking_transfer,10572.58
61b709a1d8beac1599eb8316,50200023535069,761623.35,60ec41ba55c00300382672d9,HDFC,Marketing Expense,5eecc6d6449e4f7cfb1c2708,2021-10-27T00:00:00.000Z,"NEFT DR-CITI0000006-FACEBOOK INDIA ONLIN E SERVICES PVT LTD-NETBANK, MUM-N3002116 87657345-500000",,,net_banking_transfer,-500000
61b709a3d8beac1599eb831c,50200023535069,733105.35,60ec41ba55c00300382672d9,HDFC,direct expenses,5eecc6d6449e4f7cfb1c2708,2021-10-27T00:00:00.000Z,NEFT DR-ICIC0000021-AKHILESH DIXIT-NETBA,,,net_banking_transfer,-28518
61b709a4d8beac1599eb8328,50200023535069,663105.35,60ec41ba55c00300382672d9,HDFC,direct expenses,5eecc6d6449e4f7cfb1c2708,2021-10-27T00:00:00.000Z,"NEFT DR-PYTM0123456-PAYTM-NETBANK, MUM-N 300211687654441-70000",ewallet,,net_banking_transfer,-70000
61b709a5d8beac1599eb832d,50200023535069,715035.68,60ec41ba55c00300382672d9,HDFC,Revenue-Mktplace,5eecc6d6449e4f7cfb1c2708,2021-10-27T00:00:00.000Z,NEFT CR-DEUT0797BGL-FLIPKART INTERNET PR IVATE LIMITED-SLICK ORGANICS PVT LTD-130 000182GN00229,shopping,,net_banking_transfer,51930.33
61b709a6d8beac1599eb8331,50200023535069,718665.82,60ec41ba55c00300382672d9,HDFC,Revenue-PG-non-split,5eecc6d6449e4f7cfb1c2708,2021-10-27T00:00:00.000Z,NEFT CR-SCBL0036001-STRIPE INDIA PRIVATE -SLICK ORGANICS PRIVATE LIMITED-SSG17413 Q0438186,insurance,,net_banking_transfer,3630.14
61b709a7d8beac1599eb8337,50200023535069,777099.34,60ec41ba55c00300382672d9,HDFC,Revenue-Mktplace,5eecc6d6449e4f7cfb1c2708,2021-10-27T00:00:00.000Z,NEFT CR-DEUT0797BGL-MYNTRA DESIGNS PRIVA TE LIMITED-SLICK ORGANICS PRIVATE LIMITE D-130000202GN00019,shopping,,net_banking_transfer,58433.52
61b709a8d8beac1599eb833c,50200023535069,815034.17,60ec41ba55c00300382672d9,HDFC,Revenue-Mktplace,5eecc6d6449e4f7cfb1c2708,2021-10-27T00:00:00.000Z,NEFT CR-DEUT0797BGL-FLIPKART INTERNET PR IVATE LIMITED-SLICK ORGANICS PVT LTD-130 000214GN00011,shopping,,net_banking_transfer,37934.83
61b709a9d8beac1599eb8341,50200023535069,840098.53,60ec41ba55c00300382672d9,HDFC,Revenue-Mktplace,5eecc6d6449e4f7cfb1c2708,2021-10-27T00:00:00.000Z,NEFT CR-DEUT0797BGL-MYNTRA DESIGNS PRIVA TE LIMITED-SLICK ORGANICS PRIVATE LIMITE D-130000235GN00005,shopping,,net_banking_transfer,25064.36
61b709a9d8beac1599eb8348,50200023535069,839711.01,60ec41ba55c00300382672d9,HDFC,bank charges,5eecc6d6449e4f7cfb1c2708,2021-10-27T00:00:00.000Z,.DC INTL POS TXN MARKUP+ST 091021 121021 -CDT2129006154227,,,international_transaction_arbitrage,-387.52
61b709aad8beac1599eb8354,50200023535069,839022.8,60ec41ba55c00300382672d9,HDFC,bank charges,5eecc6d6449e4f7cfb1c2708,2021-10-27T00:00:00.000Z,.DC INTL POS TXN MARKUP+ST 111021 121021 -CDT2129006154227,,,international_transaction_arbitrage,-688.21
61b709abd8beac1599eb8359,50200023535069,835472.62,60ec41ba55c00300382672d9,HDFC,bank charges,5eecc6d6449e4f7cfb1c2708,2021-10-27T00:00:00.000Z,.DC INTL POS TXN MARKUP+ST 121021 131021 -CDT2129006154227,,,international_transaction_arbitrage,-3550.18
61b709acd8beac1599eb8365,50200023535069,835319.75,60ec41ba55c00300382672d9,HDFC,bank charges,5eecc6d6449e4f7cfb1c2708,2021-10-27T00:00:00.000Z,.DC INTL POS TXN MARKUP+ST 121021 141021 -CDT2129006154227,,,international_transaction_arbitrage,-152.87
61b709add8beac1599eb836c,50200023535069,838407.75,60ec41ba55c00300382672d9,HDFC,Revenue-COD,5eecc6d6449e4f7cfb1c2708,2021-10-27T00:00:00.000Z,NEFT CR-ICIC0000155-SHIPROCKET COD CRF I D 3299242-SLICK ORGANICS PVT LTD-CMS2201 876706,insurance,,net_banking_transfer,3088
61b709aed8beac1599eb8374,50200023535069,934835.21,60ec41ba55c00300382672d9,HDFC,Revenue-PG-non-split,5eecc6d6449e4f7cfb1c2708,2021-10-27T00:00:00.000Z,NEFT CR-KKBK0000958-BROKENTUSK TECHNOLOG,,,net_banking_transfer,96427.46
61b709afd8beac1599eb837d,50200023535069,936376.73,60ec41ba55c00300382672d9,HDFC,Revenue-Mktplace,5eecc6d6449e4f7cfb1c2708,2021-10-27T00:00:00.000Z,4060005876-TIMES INTERNET LIMITED NODAL,,,Other,1541.52
61b709b0d8beac1599eb8382,50200023535069,938149.68,60ec41ba55c00300382672d9,HDFC,Revenue-PG-split enabled,5eecc6d6449e4f7cfb1c2708,2021-10-27T00:00:00.000Z,NEFT CR-UTIB0001506-RAZORPAY SOFTWARE PR IVATE LIMITED-SLICK ORGANICS PVT LITD-AX ISCN0100777218,insurance,,net_banking_transfer,1772.95
61b709b1d8beac1599eb8391,50200023535069,957334.32,60ec41ba55c00300382672d9,HDFC,Revenue-PG-non-split,5eecc6d6449e4f7cfb1c2708,2021-10-28T00:00:00.000Z,IMPS-130104427986-PAYTM PAYMENTS SERVI-P YTM-XXXXXXXXXX0008-ALL202110282168200003 30830668628,ewallet,,net_banking_transfer,19184.64
61b709b2d8beac1599eb83b1,50200023535069,959376.97,60ec41ba55c00300382672d9,HDFC,Revenue-PG-split enabled,5eecc6d6449e4f7cfb1c2708,2021-10-28T00:00:00.000Z,NEFT CR-UTIB0001506-RAZORPAY SOFTWARE PR IVATE LIMITED-SLICK ORGANICS PVT LITD-AX ISCN0100860201,insurance,,net_banking_transfer,2042.65
61b709b4d8beac1599eb83b8,50200023535069,962329.21,60ec41ba55c00300382672d9,HDFC,Revenue-PG-non-split,5eecc6d6449e4f7cfb1c2708,2021-10-28T00:00:00.000Z,NEFT CR-SCBL0036001-STRIPE INDIA PRIVATE -SLICK ORGANICS PRIVATE LIMITED-SSG17413 Q0439637,insurance,,net_banking_transfer,2952.24
61b709b5d8beac1599eb83be,50200023535069,997196.21,60ec41ba55c00300382672d9,HDFC,Transfer in/Revenue-other,5eecc6d6449e4f7cfb1c2708,2021-10-28T00:00:00.000Z,57500000644820-SLICK ORGANICS,insurance,,Other,34867
61b709b6d8beac1599eb83c5,50200023535069,1029466.93,60ec41ba55c00300382672d9,HDFC,Revenue-PG-non-split,5eecc6d6449e4f7cfb1c2708,2021-10-28T00:00:00.000Z,NEFT CR-KKBK0000958-BROKENTUSK TECHNOLOG IES PRIVATE LIMITED-SLICK ORGANICS PRIVA TE LIMITED-KKBK213019376020,,,net_banking_transfer,32270.72
61b709b7d8beac1599eb83cc,50200023535069,1030508.53,60ec41ba55c00300382672d9,HDFC,Revenue-PG-split enabled,5eecc6d6449e4f7cfb1c2708,2021-10-28T00:00:00.000Z,NEFT CR-UTIB0001506-RAZORPAY SOFTWARE PR IVATE LIMITED-SLICK ORGANICS PVT LITD-AX ISCN0101028105,insurance,,net_banking_transfer,1041.6
61b709b8d8beac1599eb83d2,50200023535069,1030620.23,60ec41ba55c00300382672d9,HDFC,Revenue-PG-non-split,5eecc6d6449e4f7cfb1c2708,2021-10-28T00:00:00.000Z,NEFT CR-IDFB0010204-SEZZLE PAYMENTS PRIV ATE LIMITED-SLICK ORGANICS PRIVATE LIMIT ED-IDFBH21301683548,insurance,,net_banking_transfer,111.7
61b709b9d8beac1599eb83d6,50200023535069,1055620.23,60ec41ba55c00300382672d9,HDFC,Revenue-Mktplace,5eecc6d6449e4f7cfb1c2708,2021-10-28T00:00:00.000Z,CRV POS 514834******9486 FLIPKART,shopping,,refund,25000
61b709bad8beac1599eb83de,50200023535069,1067038.02,60ec41ba55c00300382672d9,HDFC,Revenue-PG-non-split,5eecc6d6449e4f7cfb1c2708,2021-10-29T00:00:00.000Z,IMPS-130204643029-PAYTM PAYMENTS SERVI-P YTM-XXXXXXXXXX0008-ALL202110292168200003 30830668628,ewallet,,net_banking_transfer,11417.79
61b709bbd8beac1599eb83e6,50200023535069,1219255.2,60ec41ba55c00300382672d9,HDFC,Transfer in/Revenue-other,5eecc6d6449e4f7cfb1c2708,2021-10-29T00:00:00.000Z,NEFT CR-UTIB0004405-WOOVLY INDIA PRIVATE LIMITED-SLICK ORGANICS PVT LTD-AXISP002 35082466,insurance,,net_banking_transfer,152217.18
61b709bcd8beac1599eb83ef,50200023535069,1220181.73,60ec41ba55c00300382672d9,HDFC,Revenue-PG-split enabled,5eecc6d6449e4f7cfb1c2708,2021-10-29T00:00:00.000Z,NEFT CR-UTIB0001506-RAZORPAY SOFTWARE PR,,,net_banking_transfer,926.53
61b709bdd8beac1599eb83f5,50200023535069,1020181.73,60ec41ba55c00300382672d9,HDFC,direct expenses,5eecc6d6449e4f7cfb1c2708,2021-10-29T00:00:00.000Z,57500000443889-TPT-200000-WEBKLIPPER TEC HNOLOGIES PRIVATE LIMITED,,,net_banking_transfer,-200000
61b709bed8beac1599eb83fa,50200023535069,982731.87,60ec41ba55c00300382672d9,HDFC,direct expenses,5eecc6d6449e4f7cfb1c2708,2021-10-29T00:00:00.000Z,POS 514834XXXXXX9486 AMZN AD TR95V0H3,,,debit_card,-37449.86
61b709bfd8beac1599eb83fd,50200023535069,982514.54,60ec41ba55c00300382672d9,HDFC,bank charges,5eecc6d6449e4f7cfb1c2708,2021-10-29T00:00:00.000Z,.DC INTL POS TXN MARKUP+ST 191021 211021 -CDT2129006154227,,,international_transaction_arbitrage,-217.33
61b709c0d8beac1599eb8404,50200023535069,981407.23,60ec41ba55c00300382672d9,HDFC,bank charges,5eecc6d6449e4f7cfb1c2708,2021-10-29T00:00:00.000Z,.DC INTL POS TXN MARKUP+ST 201021 211021 -CDT2129006154227,,,international_transaction_arbitrage,-1107.31
61b709c1d8beac1599eb8409,50200023535069,1007611.58,60ec41ba55c00300382672d9,HDFC,Revenue-Mktplace,5eecc6d6449e4f7cfb1c2708,2021-10-29T00:00:00.000Z,NEFT CR-DEUT0797BGL-FLIPKART INTERNET PR IVATE LIMITED-SLICK ORGANICS PVT LTD-130 200181GN00173,shopping,,net_banking_transfer,26204.35
61b709c2d8beac1599eb840e,50200023535069,957611.58,60ec41ba55c00300382672d9,HDFC,Marketing Expense,5eecc6d6449e4f7cfb1c2708,2021-10-29T00:00:00.000Z,POS 514834XXXXXX9486 GOOGLE ADS,,,debit_card,-50000
61b709c3d8beac1599eb8413,50200023535069,882611.58,60ec41ba55c00300382672d9,HDFC,Marketing Expense,5eecc6d6449e4f7cfb1c2708,2021-10-29T00:00:00.000Z,POS 514834XXXXXX9486 GOOGLE ADS,,,debit_card,-75000
61b709c4d8beac1599eb8416,50200023535069,899604.85,60ec41ba55c00300382672d9,HDFC,Revenue-Mktplace,5eecc6d6449e4f7cfb1c2708,2021-10-29T00:00:00.000Z,NEFT CR-DEUT0797BGL-FLIPKART INTERNET PR IVATE LIMITED-SLICK ORGANICS PVT LTD-130 200162GN00264,shopping,,net_banking_transfer,16993.27
61b709c5d8beac1599eb841b,50200023535069,900753.85,60ec41ba55c00300382672d9,HDFC,Revenue-COD,5eecc6d6449e4f7cfb1c2708,2021-10-29T00:00:00.000Z,NEFT CR-ICIC0000155-SHIPROCKET COD CRF I D 3311443-SLICK ORGANICS PVT LTD-CMS2206 484844,insurance,,net_banking_transfer,1149
61b709c6d8beac1599eb8423,50200023535069,902335.45,60ec41ba55c00300382672d9,HDFC,Revenue-Mktplace,5eecc6d6449e4f7cfb1c2708,2021-10-29T00:00:00.000Z,NEFT CR-DEUT0784BBY-TATA UNISTORE LTD-NO DAL-SLICK ORGANICS PVT LTD-130202527GN00 602,insurance,,net_banking_transfer,1581.6
61b709c7d8beac1599eb8429,50200023535069,902469.73,60ec41ba55c00300382672d9,HDFC,Revenue-Mktplace,5eecc6d6449e4f7cfb1c2708,2021-10-29T00:00:00.000Z,NEFT CR-DEUT0784BBY-TATA UNISTORE LIMITE D-SLICK ORGANICS PVT LTD-130202519GN0036 5,insurance,,net_banking_transfer,134.28
61b709c8d8beac1599eb8430,50200023535069,902947.29,60ec41ba55c00300382672d9,HDFC,Revenue-Mktplace,5eecc6d6449e4f7cfb1c2708,2021-10-29T00:00:00.000Z,NEFT CR-DEUT0784BBY-TATA UNISTORE LTD-NO DAL-SLICK ORGANICS PVT LTD-130202527GN00 432,insurance,,net_banking_transfer,477.56
61b709c9d8beac1599eb843d,50200023535069,910836.38,60ec41ba55c00300382672d9,HDFC,Revenue-PG-split enabled,5eecc6d6449e4f7cfb1c2708,2021-10-29T00:00:00.000Z,NEFT CR-UTIB0001506-RAZORPAY SOFTWARE PR IVATE LIMITED-SLICK ORGANICS PVT LITD-AX ISCN0101245365,insurance,,net_banking_transfer,7889.09
61b709cad8beac1599eb8446,50200023535069,911232.21,60ec41ba55c00300382672d9,HDFC,Revenue-PG-non-split,5eecc6d6449e4f7cfb1c2708,2021-10-29T00:00:00.000Z,NEFT CR-IDFB0010204-SEZZLE PAYMENTS PRIV,,,net_banking_transfer,395.83
61b709cbd8beac1599eb844c,50200023535069,656232.21,60ec41ba55c00300382672d9,HDFC,SAAS/tech expense,5eecc6d6449e4f7cfb1c2708,2021-10-29T00:00:00.000Z,KQSXY7UKA57KBNOSDY/PAYUAMAZON,shopping,,Other,-255000
61b709ccd8beac1599eb8452,50200023535069,657329.63,60ec41ba55c00300382672d9,HDFC,Revenue-PG-non-split,5eecc6d6449e4f7cfb1c2708,2021-10-29T00:00:00.000Z,NEFT CR-YESB0000001-RZPX PVT LTD NODAL A CCOUNT-SLICKORGANICS-N302210826132632,insurance,,salary,1097.42
61b709cdd8beac1599eb8457,50200023535069,647329.63,60ec41ba55c00300382672d9,HDFC,Tax,5eecc6d6449e4f7cfb1c2708,2021-10-29T00:00:00.000Z,051030829102134406- CBDT TAX,,,Other,-10000
61b709ced8beac1599eb845c,50200023535069,637329.63,60ec41ba55c00300382672d9,HDFC,Tax,5eecc6d6449e4f7cfb1c2708,2021-10-29T00:00:00.000Z,051030829102134555- CBDT TAX,,,Other,-10000
61b709cfd8beac1599eb8489,50200023535069,638482.16,60ec41ba55c00300382672d9,HDFC,Revenue-PG-non-split,5eecc6d6449e4f7cfb1c2708,2021-10-30T00:00:00.000Z,NEFT CR-IDFB0010204-SEZZLE PAYMENTS PRIV ATE LIMITED-SLICK ORGANICS PRIVATE LIMIT ED-IDFBH21302761900,insurance,,net_banking_transfer,1152.53
61b709d0d8beac1599eb848f,50200023535069,641943.45,60ec41ba55c00300382672d9,HDFC,Revenue-PG-non-split,5eecc6d6449e4f7cfb1c2708,2021-10-30T00:00:00.000Z,UPI-PAYTM-PPSL-PAYOUTS@PAYTM-PYTM0123456 -130333406105-ALL202110302168200,ewallet,,upi,3461.29
61b709d1d8beac1599eb8495,50200023535069,661730.55,60ec41ba55c00300382672d9,HDFC,Revenue-PG-non-split,5eecc6d6449e4f7cfb1c2708,2021-10-30T00:00:00.000Z,NEFT CR-KKBK0000958-BROKENTUSK TECHNOLOG IES PRIVATE LIMITED-SLICK ORGANICS PRIVA TE LIMITED-KKBK213039892251,,,net_banking_transfer,19787.1
61b709d2d8beac1599eb849c,50200023535069,563450.55,60ec41ba55c00300382672d9,HDFC,direct expenses,5eecc6d6449e4f7cfb1c2708,2021-10-30T00:00:00.000Z,"NEFT DR-KKBK0000173-MATRIX PRINTING SOLU TIONS PRIVATE LIMITE-NETBANK, MUM-N30321 1692981698-98280",,,net_banking_transfer,-98280
61b709d3d8beac1599eb84a2,50200023535069,570016.09,60ec41ba55c00300382672d9,HDFC,Revenue-PG-split enabled,5eecc6d6449e4f7cfb1c2708,2021-10-30T00:00:00.000Z,NEFT CR-UTIB0001506-RAZORPAY SOFTWARE PR IVATE LIMITED-SLICK ORGANICS PVT LITD-AX ISCN0101341532,insurance,,net_banking_transfer,6565.54
61b709d4d8beac1599eb84ad,50200023535069,556806.09,60ec41ba55c00300382672d9,HDFC,direct expenses,5eecc6d6449e4f7cfb1c2708,2021-10-30T00:00:00.000Z,50200032200524-TPT-13210-IRA LAW,,,net_banking_transfer,-13210
61b709d5d8beac1599eb84b7,50200023535069,584361.7,60ec41ba55c00300382672d9,HDFC,Revenue-PG-non-split,5eecc6d6449e4f7cfb1c2708,2021-10-30T00:00:00.000Z,NEFT CR-KKBK0000958-BROKENTUSK TECHNOLOG IES PRIVATE LIMITED-SLICK ORGANICS PRIVA TE LIMITED-KKBK213039982960,,,net_banking_transfer,27555.61
61b709d6d8beac1599eb84c9,50200023535069,585052.79,60ec41ba55c00300382672d9,HDFC,Revenue-PG-split enabled,5eecc6d6449e4f7cfb1c2708,2021-10-30T00:00:00.000Z,NEFT CR-UTIB0001506-RAZORPAY SOFTWARE PR IVATE LIMITED-SLICK ORGANICS PVT LITD-AX ISCN0101477557,insurance,,net_banking_transfer,691.09
61b709d7d8beac1599eb84d1,50200023535069,590929.6,60ec41ba55c00300382672d9,HDFC,Revenue-PG-non-split,5eecc6d6449e4f7cfb1c2708,2021-10-31T00:00:00.000Z,UPI-PAYTM-PPSL-PAYOUTS@PAYTM-PYTM0123456 -130480217613-ALL202110312168200,ewallet,,upi,5876.81
61b709d8d8beac1599eb84e5,50200023535069,490929.6,60ec41ba55c00300382672d9,HDFC,direct expenses,5eecc6d6449e4f7cfb1c2708,2021-10-31T00:00:00.000Z,"NEFT DR-PYTM0123456-PAYTM-NETBANK, MUM-N",ewallet,,net_banking_transfer,-100000
61b709d9d8beac1599eb84fc,50200023535069,496056.75,60ec41ba55c00300382672d9,HDFC,Revenue-PG-non-split,5eecc6d6449e4f7cfb1c2708,2021-11-01T00:00:00.000Z,UPI-PAYTM-PPSL-PAYOUTS@PAYTM-PYTM0123456 -130526880234-ALL202111012168200,ewallet,,upi,5127.15
61b709dad8beac1599eb8506,50200023535069,491056.75,60ec41ba55c00300382672d9,HDFC,Marketing Expense,5eecc6d6449e4f7cfb1c2708,2021-11-01T00:00:00.000Z,ME DC SI 514834XXXXXX9486 GOOGLESERVIS,,,Other,-5000
61b709dbd8beac1599eb8515,50200023535069,495887.76,60ec41ba55c00300382672d9,HDFC,Revenue-PG-split enabled,5eecc6d6449e4f7cfb1c2708,2021-11-01T00:00:00.000Z,NEFT CR-UTIB0001506-RAZORPAY SOFTWARE PR IVATE LIMITED-SLICK ORGANICS PVT LITD-AX ISCN0102237016,insurance,,net_banking_transfer,4831.01
61b709dcd8beac1599eb8521,50200023535069,490487.76,60ec41ba55c00300382672d9,HDFC,direct expenses,5eecc6d6449e4f7cfb1c2708,2021-11-01T00:00:00.000Z,50200032200524-TPT-5400-IRA LAW,,,net_banking_transfer,-5400
61b709ddd8beac1599eb852a,50200023535069,488311.6,60ec41ba55c00300382672d9,HDFC,direct expenses,5eecc6d6449e4f7cfb1c2708,2021-11-01T00:00:00.000Z,POS 514834XXXXXX9486 SEOPTIMER,,,debit_card,-2176.16
61b709ded8beac1599eb8539,50200023535069,438311.6,60ec41ba55c00300382672d9,HDFC,direct expenses,5eecc6d6449e4f7cfb1c2708,2021-11-01T00:00:00.000Z,"NEFT DR-YESB0000162-VINAY REDDY-NETBANK, MUM-N305211696156880-50000",,,net_banking_transfer,-50000
61b709dfd8beac1599eb8541,50200023535069,466640.6,60ec41ba55c00300382672d9,HDFC,Revenue-PG-non-split,5eecc6d6449e4f7cfb1c2708,2021-11-01T00:00:00.000Z,NEFT CR-KKBK0000958-BROKENTUSK TECHNOLOG IES PRIVATE LIMITED-SLICK ORGANICS PRIVA TE LIMITED-KKBK213051425379,,,net_banking_transfer,28329
61b709e0d8beac1599eb8552,50200023535069,500341.27,60ec41ba55c00300382672d9,HDFC,Revenue-PG-non-split,5eecc6d6449e4f7cfb1c2708,2021-11-01T00:00:00.000Z,NEFT CR-KKBK0000958-BROKENTUSK TECHNOLOG IES PRIVATE LIMITED-SLICK ORGANICS PRIVA TE LIMITED-KKBK213051428844,,,net_banking_transfer,33700.67
61b709e1d8beac1599eb855b,50200023535069,495341.27,60ec41ba55c00300382672d9,HDFC,Marketing Expense,5eecc6d6449e4f7cfb1c2708,2021-11-01T00:00:00.000Z,ME DC SI 514834XXXXXX9486 GOOGLESERVIS,,,Other,-5000
61b709e2d8beac1599eb8564,50200023535069,496495.36,60ec41ba55c00300382672d9,HDFC,Revenue-PG-non-split,5eecc6d6449e4f7cfb1c2708,2021-11-01T00:00:00.000Z,NEFT CR-IDFB0010204-SEZZLE PAYMENTS PRIV ATE LIMITED-SLICK ORGANICS PRIVATE LIMIT ED-IDFBH21305032083,insurance,,net_banking_transfer,1154.09
61b709e3d8beac1599eb8571,50200023535069,574368.36,60ec41ba55c00300382672d9,HDFC,Revenue-COD,5eecc6d6449e4f7cfb1c2708,2021-11-01T00:00:00.000Z,NEFT CR-KKBK0000958-PICKRR TECHNOLOGIES PVT LTD-SLICKORGANICSPRIVATELIMITED-CMS3 052102925922,insurance,,net_banking_transfer,77873
61b709e4d8beac1599eb857f,50200023535069,577736.54,60ec41ba55c00300382672d9,HDFC,Revenue-Mktplace,5eecc6d6449e4f7cfb1c2708,2021-11-01T00:00:00.000Z,NEFT CR-ICIC0000105-ICICI BANK NODAL AC MANASH LIFESTYL-SLICK ORGANICS PRIVATE L IMITED HYD-ICIJ213050019269,,,net_banking_transfer,3368.18
61b709e5d8beac1599eb8587,50200023535069,578712.17,60ec41ba55c00300382672d9,HDFC,Transfer in/Revenue-other,5eecc6d6449e4f7cfb1c2708,2021-11-01T00:00:00.000Z,NEFT CR-ICIC0000105-ICICI BANK NODAL AC,,,net_banking_transfer,975.63
61b709e6d8beac1599eb8592,50200023535069,578898.36,60ec41ba55c00300382672d9,HDFC,Revenue-Mktplace,5eecc6d6449e4f7cfb1c2708,2021-11-01T00:00:00.000Z,NEFT CR-ICIC0000105-ICICI BANK NODAL AC MANASH LIFESTYL-SLICK ORGANICS PRIVATE L IMITED BANG-ICIJ213050020498,,,net_banking_transfer,186.19
61b709e7d8beac1599eb859a,50200023535069,580351.88,60ec41ba55c00300382672d9,HDFC,Revenue-Mktplace,5eecc6d6449e4f7cfb1c2708,2021-11-01T00:00:00.000Z,NEFT CR-ICIC0000105-ICICI BANK NODAL AC MANASH LIFESTYL-SLICK ORGANICS PRIVATE L IMITED MP M-ICIJ213050019268,,,net_banking_transfer,1453.52
61b709e8d8beac1599eb85a6,50200023535069,582014.33,60ec41ba55c00300382672d9,HDFC,Revenue-Mktplace,5eecc6d6449e4f7cfb1c2708,2021-11-01T00:00:00.000Z,NEFT CR-ICIC0000105-ICICI BANK NODAL AC MANASH LIFESTYL-SLICK ORGANICS PRIVATE L IMITED MP G-ICIJ213050020495,,,net_banking_transfer,1662.45
61b709e9d8beac1599eb85ac,50200023535069,577014.33,60ec41ba55c00300382672d9,HDFC,Marketing Expense,5eecc6d6449e4f7cfb1c2708,2021-11-01T00:00:00.000Z,ME DC SI 514834XXXXXX9486 GOOGLESERVIS,,,Other,-5000
61b709ead8beac1599eb85b4,50200023535069,582006.48,60ec41ba55c00300382672d9,HDFC,Revenue-PG-split enabled,5eecc6d6449e4f7cfb1c2708,2021-11-01T00:00:00.000Z,NEFT CR-UTIB0001506-RAZORPAY SOFTWARE PR IVATE LIMITED-SLICK ORGANICS PVT LITD-AX ISCN0102452166,insurance,,net_banking_transfer,4992.15
61b709ebd8beac1599eb85bb,50200023535069,577006.48,60ec41ba55c00300382672d9,HDFC,Marketing Expense,5eecc6d6449e4f7cfb1c2708,2021-11-02T00:00:00.000Z,ME DC SI 514834XXXXXX9486 GOOGLESERVIS,,,Other,-5000
61b709ecd8beac1599eb85c2,50200023535069,591788.93,60ec41ba55c00300382672d9,HDFC,Revenue-PG-non-split,5eecc6d6449e4f7cfb1c2708,2021-11-02T00:00:00.000Z,IMPS-130604312873-PAYTM PAYMENTS SERVI-P YTM-XXXXXXXXXX0008-ALL202111022168200003 30830668628,ewallet,,net_banking_transfer,14782.45
61b709edd8beac1599eb85ce,50200023535069,656205.26,60ec41ba55c00300382672d9,HDFC,Revenue-Mktplace,5eecc6d6449e4f7cfb1c2708,2021-11-02T00:00:00.000Z,NEFT CR-DEUT0797BGL-AMAZON PAY (INDIA) P RIVATE LIMITED-SLICK ORGANICS PVT LTD-13 0600085GN00495,shopping,,net_banking_transfer,64416.33
61b709eed8beac1599eb85da,50200023535069,658437.06,60ec41ba55c00300382672d9,HDFC,Revenue-PG-split enabled,5eecc6d6449e4f7cfb1c2708,2021-11-02T00:00:00.000Z,NEFT CR-UTIB0001506-RAZORPAY SOFTWARE PR IVATE LIMITED-SLICK ORGANICS PVT LITD-AX ISCN0102652974,insurance,,net_banking_transfer,2231.8
61b709efd8beac1599eb85e6,50200023535069,1268620.52,60ec41ba55c00300382672d9,HDFC,Revenue-Mktplace,5eecc6d6449e4f7cfb1c2708,2021-11-02T00:00:00.000Z,NEFT CR-HSBC0110004-CLOUDTAIL INDIA PRIV ATE LIMITED-SLICK ORGANICS PRIVATE LIMIT ED-HSBCN21306664842,,,net_banking_transfer,610183.46
61b709f0d8beac1599eb85f3,50200023535069,1263620.52,60ec41ba55c00300382672d9,HDFC,Marketing Expense,5eecc6d6449e4f7cfb1c2708,2021-11-02T00:00:00.000Z,ME DC SI 514834XXXXXX9486 GOOGLESERVIS,,,Other,-5000
61b709f1d8beac1599eb85f8,50200023535069,1266549,60ec41ba55c00300382672d9,HDFC,Transfer in/Revenue-other,5eecc6d6449e4f7cfb1c2708,2021-11-02T00:00:00.000Z,50200050675669-TPT-REMITTANCE OGOCT21-HO,,,net_banking_transfer,2928.48
61b709f2d8beac1599eb8603,50200023535069,1296332.59,60ec41ba55c00300382672d9,HDFC,Revenue-PG-non-split,5eecc6d6449e4f7cfb1c2708,2021-11-02T00:00:00.000Z,NEFT CR-KKBK0000958-BROKENTUSK TECHNOLOG IES PRIVATE LIMITED-SLICK ORGANICS PRIVA TE LIMITED-KKBK213061903932,,,net_banking_transfer,29783.59
61b709f3d8beac1599eb860a,50200023535069,1263324.16,60ec41ba55c00300382672d9,HDFC,direct expenses,5eecc6d6449e4f7cfb1c2708,2021-11-02T00:00:00.000Z,POS 514834XXXXXX9486 AMZN AD TR95V0H3,,,debit_card,-33008.43
61b709f4d8beac1599eb8611,50200023535069,1265272.1,60ec41ba55c00300382672d9,HDFC,Revenue-PG-split enabled,5eecc6d6449e4f7cfb1c2708,2021-11-02T00:00:00.000Z,NEFT CR-UTIB0001506-RAZORPAY SOFTWARE PR IVATE LIMITED-SLICK ORGANICS PVT LITD-AX ISCN0102820722,insurance,,net_banking_transfer,1947.94
61b709f5d8beac1599eb8616,50200023535069,1215272.1,60ec41ba55c00300382672d9,HDFC,direct expenses,5eecc6d6449e4f7cfb1c2708,2021-11-02T00:00:00.000Z,IMPS-130618180323-PAYTM-PYTM-XXXXXXXX383 9-50000,ewallet,,net_banking_transfer,-50000
61b709f6d8beac1599eb861b,50200023535069,1218050.52,60ec41ba55c00300382672d9,HDFC,Revenue-PG-non-split,5eecc6d6449e4f7cfb1c2708,2021-11-02T00:00:00.000Z,NEFT CR-IDFB0010204-SEZZLE PAYMENTS PRIV ATE LIMITED-SLICK ORGANICS PRIVATE LIMIT ED-IDFBH21306180453,insurance,,net_banking_transfer,2778.42
61b709f7d8beac1599eb8625,50200023535069,1213050.52,60ec41ba55c00300382672d9,HDFC,Marketing Expense,5eecc6d6449e4f7cfb1c2708,2021-11-02T00:00:00.000Z,ME DC SI 514834XXXXXX9486 GOOGLESERVIS,,,Other,-5000
61b709f8d8beac1599eb862d,50200023535069,1216355.41,60ec41ba55c00300382672d9,HDFC,Transfer in/Revenue-other,5eecc6d6449e4f7cfb1c2708,2021-11-02T00:00:00.000Z,NEFT CR-UTIB0004405-WOOVLY INDIA PRIVATE LIMITED-SLICK ORGANICS PVT LTD-AXISP002 37365853,insurance,,net_banking_transfer,3304.89
61b709f9d8beac1599eb8634,50200023535069,1225433.86,60ec41ba55c00300382672d9,HDFC,Revenue-PG-non-split,5eecc6d6449e4f7cfb1c2708,2021-11-03T00:00:00.000Z,UPI-PAYTM-PPSL-PAYOUTS@PAYTM-PYTM0123456 -130723444251-ALL202111032168200,ewallet,,upi,9078.45
61b709fad8beac1599eb863d,50200023535069,1279013.06,60ec41ba55c00300382672d9,HDFC,Revenue-Mktplace,5eecc6d6449e4f7cfb1c2708,2021-11-03T00:00:00.000Z,NEFT CR-DEUT0797BGL-FLIPKART INTERNET PR IVATE LIMITED-SLICK ORGANICS PVT LTD-130 700161GN00277,shopping,,net_banking_transfer,53579.2
61b709fbd8beac1599eb8641,50200023535069,1319716.38,60ec41ba55c00300382672d9,HDFC,Revenue-Mktplace,5eecc6d6449e4f7cfb1c2708,2021-11-03T00:00:00.000Z,NEFT CR-DEUT0797BGL-FLIPKART INTERNET PR IVATE LIMITED-SLICK ORGANICS PVT LTD-130 700170GN00024,shopping,,net_banking_transfer,40703.32
61b709fcd8beac1599eb864b,50200023535069,1322024.51,60ec41ba55c00300382672d9,HDFC,Revenue-PG-split enabled,5eecc6d6449e4f7cfb1c2708,2021-11-03T00:00:00.000Z,NEFT CR-UTIB0001506-RAZORPAY SOFTWARE PR IVATE LIMITED-SLICK ORGANICS PVT LITD-AX ISCN0102951130,insurance,,net_banking_transfer,2308.13
61b709fdd8beac1599eb8651,50200023535069,1325638.93,60ec41ba55c00300382672d9,HDFC,Transfer in/Revenue-other,5eecc6d6449e4f7cfb1c2708,2021-11-03T00:00:00.000Z,ZOOBOP ME WORK-ARATA,,,Other,3614.42
61b709fed8beac1599eb865a,50200023535069,825638.93,60ec41ba55c00300382672d9,HDFC,Marketing Expense,5eecc6d6449e4f7cfb1c2708,2021-11-03T00:00:00.000Z,NEFT DR-CITI0000006-FACEBOOK INDIA ONLIN,,,net_banking_transfer,-500000
61b709fed8beac1599eb865f,50200023535069,570638.93,60ec41ba55c00300382672d9,HDFC,SAAS/tech expense,5eecc6d6449e4f7cfb1c2708,2021-11-03T00:00:00.000Z,KQSX65UFBJ42DP6XD4/PAYUAMAZON,shopping,,Other,-255000
61b709ffd8beac1599eb8666,50200023535069,571250.12,60ec41ba55c00300382672d9,HDFC,Revenue-PG-non-split,5eecc6d6449e4f7cfb1c2708,2021-11-03T00:00:00.000Z,NEFT CR-YESB0000001-RZPX PVT LTD NODAL A CCOUNT-SLICKORGANICS-N307210835467922,insurance,,salary,611.19
61b70a01d8beac1599eb866c,50200023535069,545330.12,60ec41ba55c00300382672d9,HDFC,direct expenses,5eecc6d6449e4f7cfb1c2708,2021-11-03T00:00:00.000Z,"NEFT DR-ICIC0000874-TRELION BUSINESS SOL UTIONS PVT LTD-NETBANK, MUM-N30721170109 2957-25920",,,net_banking_transfer,-25920
61b70a01d8beac1599eb8676,50200023535069,585382.57,60ec41ba55c00300382672d9,HDFC,Revenue-PG-non-split,5eecc6d6449e4f7cfb1c2708,2021-11-03T00:00:00.000Z,NEFT CR-KKBK0000958-BROKENTUSK TECHNOLOG IES PRIVATE LIMITED-SLICK ORGANICS PRIVA TE LIMITED-KKBK213072239230,,,net_banking_transfer,40052.45
61b70a02d8beac1599eb86ad,50200023535069,586025.87,60ec41ba55c00300382672d9,HDFC,Revenue-COD,5eecc6d6449e4f7cfb1c2708,2021-11-03T00:00:00.000Z,NEFT CR-ICIC0000155-SHIPROCKET COD CRF I D 3332030-SLICK ORGANICS PVT LTD-CMS2218 196865,insurance,,net_banking_transfer,643.3
61b70a03d8beac1599eb86b6,50200023535069,586589.68,60ec41ba55c00300382672d9,HDFC,Revenue-PG-split enabled,5eecc6d6449e4f7cfb1c2708,2021-11-03T00:00:00.000Z,NEFT CR-UTIB0001506-RAZORPAY SOFTWARE PR IVATE LIMITED-SLICK ORGANICS PVT LITD-AX ISCN0103156847,insurance,,net_banking_transfer,563.81
61b70a04d8beac1599eb86bd,50200023535069,587543.34,60ec41ba55c00300382672d9,HDFC,Revenue-Mktplace,5eecc6d6449e4f7cfb1c2708,2021-11-03T00:00:00.000Z,NEFT CR-ICIC0000105-ICICI BANK NODAL AC MANASH LIFESTYL-SLICK ORGANICS PRIVATE L IMITED MP G-ICIJ213070012973,,,net_banking_transfer,953.66
61b70a05d8beac1599eb86c7,50200023535069,587725.86,60ec41ba55c00300382672d9,HDFC,Revenue-Mktplace,5eecc6d6449e4f7cfb1c2708,2021-11-03T00:00:00.000Z,NEFT CR-ICIC0000105-ICICI BANK NODAL AC MANASH LIFESTYL-SLICK ORGANICS PRIVATE L IMITED BANG-ICIJ213070012976,,,net_banking_transfer,182.52
61b70a06d8beac1599eb86cf,50200023535069,588000,60ec41ba55c00300382672d9,HDFC,Revenue-Mktplace,5eecc6d6449e4f7cfb1c2708,2021-11-03T00:00:00.000Z,NEFT CR-ICIC0000105-ICICI BANK NODAL AC MANASH LIFESTYL-SLICK ORGANICS PRIVATE L IMITED KOLK-ICIJ213070012975,,,net_banking_transfer,274.14
61b70a07d8beac1599eb86d3,50200023535069,547989,60ec41ba55c00300382672d9,HDFC,SAAS/tech expense,5eecc6d6449e4f7cfb1c2708,2021-11-03T00:00:00.000Z,POS 514834XXXXXX9486 AMAZON,shopping,,debit_card,-40011
61b70a08d8beac1599eb86db,50200023535069,559172,60ec41ba55c00300382672d9,HDFC,Revenue-Mktplace,5eecc6d6449e4f7cfb1c2708,2021-11-03T00:00:00.000Z,NEFT CR-SCBL0036001-M/S DREAMPLUG TECHNO -SLICK ORGANICS PRIVATE LIMITEDSLICK-SIN 31436Q0024878,insurance,,net_banking_transfer,11183
61b70a09d8beac1599eb86e1,50200023535069,568242.35,60ec41ba55c00300382672d9,HDFC,Revenue-PG-non-split,5eecc6d6449e4f7cfb1c2708,2021-11-04T00:00:00.000Z,UPI-PAYTM-PPSL-PAYOUTS@PAYTM-PYTM0123456 -130872518040-ALL202111042168200,ewallet,,upi,9070.35
61b70a0ad8beac1599eb86e7,50200023535069,557232.92,60ec41ba55c00300382672d9,HDFC,direct expenses,5eecc6d6449e4f7cfb1c2708,2021-11-04T00:00:00.000Z,POS 514834XXXXXX9486 STK*SHUTTERSTOCK,,,debit_card,-11009.43
61b70a0bd8beac1599eb86f0,50200023535069,564887.1,60ec41ba55c00300382672d9,HDFC,Revenue-PG-non-split,5eecc6d6449e4f7cfb1c2708,2021-11-05T00:00:00.000Z,UPI-PAYTM-PPSL-PAYOUTS@PAYTM-PYTM0123456 -130916157204-ALL202111052168200,ewallet,,upi,7654.18
61b70a0cd8beac1599eb86f5,50200023535069,565775.9,60ec41ba55c00300382672d9,HDFC,Revenue-COD,5eecc6d6449e4f7cfb1c2708,2021-11-05T00:00:00.000Z,NEFT CR-ICIC0000155-SHIPROCKET COD CRF I D 3344208-SLICK ORGANICS PVT LTD-CMS2221 405206,insurance,,net_banking_transfer,888.8
61b70a0dd8beac1599eb86fc,50200023535069,579070.55,60ec41ba55c00300382672d9,HDFC,Revenue-PG-non-split,5eecc6d6449e4f7cfb1c2708,2021-11-06T00:00:00.000Z,IMPS-131004987300-PAYTM PAYMENTS SERVI-P YTM-XXXXXXXXXX0008-ALL202111062168200003 30830668628,ewallet,,net_banking_transfer,13294.65
61b70a0ed8beac1599eb8704,50200023535069,586731.94,60ec41ba55c00300382672d9,HDFC,Revenue-PG-split enabled,5eecc6d6449e4f7cfb1c2708,2021-11-06T00:00:00.000Z,NEFT CR-UTIB0001506-RAZORPAY SOFTWARE PR IVATE LIMITED-SLICK ORGANICS PVT LITD-AX ISCN0103502482,insurance,,net_banking_transfer,7661.39
61b70a0fd8beac1599eb870a,50200023535069,579378.81,60ec41ba55c00300382672d9,HDFC,direct expenses,5eecc6d6449e4f7cfb1c2708,2021-11-06T00:00:00.000Z,POS 514834XXXXXX9486 HOTJAR,,,debit_card,-7353.13
61b70a10d8beac1599eb8713,50200023535069,583783.4,60ec41ba55c00300382672d9,HDFC,Revenue-PG-split enabled,5eecc6d6449e4f7cfb1c2708,2021-11-06T00:00:00.000Z,NEFT CR-UTIB0001506-RAZORPAY SOFTWARE PR IVATE LIMITED-SLICK ORGANICS PVT LITD-AX ISCN0103610493,insurance,,net_banking_transfer,4404.59
61b70a11d8beac1599eb8722,50200023535069,546644.17,60ec41ba55c00300382672d9,HDFC,direct expenses,5eecc6d6449e4f7cfb1c2708,2021-11-07T00:00:00.000Z,POS 514834XXXXXX9486 AMZN AD TR95V0H3,,,debit_card,-37139.23
61b70a12d8beac1599eb8729,50200023535069,554120.37,60ec41ba55c00300382672d9,HDFC,Revenue-PG-non-split,5eecc6d6449e4f7cfb1c2708,2021-11-07T00:00:00.000Z,UPI-PAYTM-PPSL-PAYOUTS@PAYTM-PYTM0123456 -131195942423-ALL202111072168200,ewallet,,upi,7476.2
61b70a13d8beac1599eb872e,50200023535069,504120.37,60ec41ba55c00300382672d9,HDFC,direct expenses,5eecc6d6449e4f7cfb1c2708,2021-11-07T00:00:00.000Z,"NEFT DR-UTIB0000120-ADNAN ALI-NETBANK, M UM-N311211704998069-50000",,,net_banking_transfer,-50000
61b70a14d8beac1599eb8734,50200023535069,469120.37,60ec41ba55c00300382672d9,HDFC,direct expenses,5eecc6d6449e4f7cfb1c2708,2021-11-07T00:00:00.000Z,50100064106714-TPT-35000-AKSHARANSH BHAT T,,,net_banking_transfer,-35000
61b70a15d8beac1599eb873b,50200023535069,433120.37,60ec41ba55c00300382672d9,HDFC,direct expenses,5eecc6d6449e4f7cfb1c2708,2021-11-07T00:00:00.000Z,00901610080520-TPT-36000-POOJA KAPIL SHR OTRIYA,,,net_banking_transfer,-36000
61b70a16d8beac1599eb8741,50200023535069,411620.37,60ec41ba55c00300382672d9,HDFC,direct expenses,5eecc6d6449e4f7cfb1c2708,2021-11-07T00:00:00.000Z,"NEFT DR-SIBL0000555-JAIVEER KUMAR-NETBAN K, MUM-N311211705000826-21500",,,net_banking_transfer,-21500
61b70a17d8beac1599eb874d,50200023535069,390120.37,60ec41ba55c00300382672d9,HDFC,direct expenses,5eecc6d6449e4f7cfb1c2708,2021-11-07T00:00:00.000Z,"NEFT DR-PUNB0307800-PRAKASH JHA-NETBANK, MUM-N311211704998455-21500",,,net_banking_transfer,-21500
61b70a18d8beac1599eb8755,50200023535069,368620.37,60ec41ba55c00300382672d9,HDFC,direct expenses,5eecc6d6449e4f7cfb1c2708,2021-11-07T00:00:00.000Z,"NEFT DR-PUNB0482100-RAM BHAVAN YADAV-NET BANK, MUM-N311211705006129-21500",,,net_banking_transfer,-21500
61b70a19d8beac1599eb875b,50200023535069,354084.37,60ec41ba55c00300382672d9,HDFC,direct expenses,5eecc6d6449e4f7cfb1c2708,2021-11-07T00:00:00.000Z,NEFT DR-PUNB0151400-BHUWAN CHANDER JOSHI,,,net_banking_transfer,-14536
61b70a1ad8beac1599eb8764,50200023535069,254084.37,60ec41ba55c00300382672d9,HDFC,direct expenses,5eecc6d6449e4f7cfb1c2708,2021-11-07T00:00:00.000Z,IMPS-131117135387-PAYTM-PYTM-XXXXXXXX383 9-100000,ewallet,,net_banking_transfer,-100000
61b70a1bd8beac1599eb8788,50200023535069,262687.78,60ec41ba55c00300382672d9,HDFC,Revenue-PG-non-split,5eecc6d6449e4f7cfb1c2708,2021-11-08T00:00:00.000Z,UPI-PAYTM-PPSL-PAYOUTS@PAYTM-PYTM0123456 -131236428279-ALL202111082168200,ewallet,,upi,8603.41
61b70a1cd8beac1599eb878f,50200023535069,293473.05,60ec41ba55c00300382672d9,HDFC,Revenue-Mktplace,5eecc6d6449e4f7cfb1c2708,2021-11-08T00:00:00.000Z,NEFT CR-DEUT0797BGL-FLIPKART INTERNET PR IVATE LIMITED-SLICK ORGANICS PVT LTD-131 200183GN00100,shopping,,net_banking_transfer,30785.27
61b70a1dd8beac1599eb87b6,50200023535069,293869.65,60ec41ba55c00300382672d9,HDFC,Revenue-PG-split enabled,5eecc6d6449e4f7cfb1c2708,2021-11-08T00:00:00.000Z,NEFT CR-UTIB0001506-RAZORPAY SOFTWARE PR IVATE LIMITED-SLICK ORGANICS PVT LITD-AX ISCN0103802266,insurance,,net_banking_transfer,396.6
61b70a1ed8beac1599eb87bb,50200023535069,193213.65,60ec41ba55c00300382672d9,HDFC,direct expenses,5eecc6d6449e4f7cfb1c2708,2021-11-08T00:00:00.000Z,"NEFT DR-ICIC0000021-AKHILESH DIXIT-NETBA NK, MUM-N312211705679363-100656",,,net_banking_transfer,-100656
61b70a1fd8beac1599eb87c3,50200023535069,78213.65,60ec41ba55c00300382672d9,HDFC,direct expenses,5eecc6d6449e4f7cfb1c2708,2021-11-08T00:00:00.000Z,IMPS-131213118218-PAYTM-PYTM-XXXXXXXX383 9-115000,ewallet,,net_banking_transfer,-115000
61b70a20d8beac1599eb87c9,50200023535069,63677.65,60ec41ba55c00300382672d9,HDFC,direct expenses,5eecc6d6449e4f7cfb1c2708,2021-11-08T00:00:00.000Z,02711600008220-TPT-14536-VARUN SINGH,,,net_banking_transfer,-14536
61b70a21d8beac1599eb87cf,50200023535069,64387.05,60ec41ba55c00300382672d9,HDFC,Revenue-COD,5eecc6d6449e4f7cfb1c2708,2021-11-08T00:00:00.000Z,NEFT CR-ICIC0000155-SHIPROCKET COD CRF I D 3352389-SLICK ORGANICS PVT LTD-CMS2225 250541,insurance,,net_banking_transfer,709.4
61b70a22d8beac1599eb87d4,50200023535069,69997.52,60ec41ba55c00300382672d9,HDFC,Revenue-PG-non-split,5eecc6d6449e4f7cfb1c2708,2021-11-08T00:00:00.000Z,NEFT CR-IDFB0010204-SEZZLE PAYMENTS PRIV ATE LIMITED-SLICK ORGANICS PRIVATE LIMIT ED-IDFBH21312508217,insurance,,net_banking_transfer,5610.47
61b70a23d8beac1599eb87d9,50200023535069,71168.87,60ec41ba55c00300382672d9,HDFC,Revenue-Mktplace,5eecc6d6449e4f7cfb1c2708,2021-11-08T00:00:00.000Z,NEFT CR-ICIC0000105-ICICI BANK NODAL AC MANASH LIFESTYL-SLICK ORGANICS PRIVATE L IMITED HYD-ICIJ213120003185,,,net_banking_transfer,1171.35
61b70a24d8beac1599eb87e4,50200023535069,71753.08,60ec41ba55c00300382672d9,HDFC,Revenue-Mktplace,5eecc6d6449e4f7cfb1c2708,2021-11-08T00:00:00.000Z,NEFT CR-ICIC0000105-ICICI BANK NODAL AC MANASH LIFESTYL-SLICK ORGANICS PRIVATE L IMITED MP G-ICIJ213120001096,,,net_banking_transfer,584.21
61b70a25d8beac1599eb87e8,50200023535069,72953.47,60ec41ba55c00300382672d9,HDFC,Revenue-PG-split enabled,5eecc6d6449e4f7cfb1c2708,2021-11-08T00:00:00.000Z,NEFT CR-UTIB0001506-RAZORPAY SOFTWARE PR IVATE LIMITED-SLICK ORGANICS PVT LITD-AX ISCN0103930868,insurance,,net_banking_transfer,1200.39
61b70a26d8beac1599eb87f1,50200023535069,197923.47,60ec41ba55c00300382672d9,HDFC,Revenue-COD,5eecc6d6449e4f7cfb1c2708,2021-11-08T00:00:00.000Z,NEFT CR-KKBK0000958-PICKRR TECHNOLOGIES,,,net_banking_transfer,124970
61b70a27d8beac1599eb87f9,50200023535069,383282.04,60ec41ba55c00300382672d9,HDFC,Revenue-PG-non-split,5eecc6d6449e4f7cfb1c2708,2021-11-08T00:00:00.000Z,NEFT CR-KKBK0000958-BROKENTUSK TECHNOLOG IES PRIVATE LIMITED-SLICK ORGANICS PRIVA TE LIMITED-KKBK213123398561,,,net_banking_transfer,185358.57
61b70a28d8beac1599eb8807,50200023535069,390265.06,60ec41ba55c00300382672d9,HDFC,Revenue-PG-non-split,5eecc6d6449e4f7cfb1c2708,2021-11-09T00:00:00.000Z,UPI-PAYTM-PPSL-PAYOUTS@PAYTM-PYTM0123456 -131379052256-ALL202111092168200,ewallet,,upi,6983.02
61b70a29d8beac1599eb8814,50200023535069,624665,60ec41ba55c00300382672d9,HDFC,Revenue-Mktplace,5eecc6d6449e4f7cfb1c2708,2021-11-09T00:00:00.000Z,NEFT CR-HSBC0560002-AMAZON SELLER SERVIC ES PRIVATE LIMI-SLICK ORGANICS PVT L-HSB CN21313858588,shopping,,net_banking_transfer,234399.94
61b70a2ad8beac1599eb8822,50200023535069,752791.81,60ec41ba55c00300382672d9,HDFC,Revenue-Mktplace,5eecc6d6449e4f7cfb1c2708,2021-11-09T00:00:00.000Z,NEFT CR-DEUT0797BGL-AMAZON PAY (INDIA) P RIVATE LIMITED-SLICK ORGANICS PVT LTD-13 1300081GN00275,shopping,,net_banking_transfer,128126.81
61b70a2bd8beac1599eb8828,50200023535069,756396.39,60ec41ba55c00300382672d9,HDFC,Revenue-PG-split enabled,5eecc6d6449e4f7cfb1c2708,2021-11-09T00:00:00.000Z,NEFT CR-UTIB0001506-RAZORPAY SOFTWARE PR IVATE LIMITED-SLICK ORGANICS PVT LITD-AX ISCN0104017193,insurance,,net_banking_transfer,3604.58
61b70a2cd8beac1599eb882f,50200023535069,501396.39,60ec41ba55c00300382672d9,HDFC,SAAS/tech expense,5eecc6d6449e4f7cfb1c2708,2021-11-09T00:00:00.000Z,KQSX65MKAZ5KNNGWC4/PAYUAMAZON,shopping,,Other,-255000
61b70a2dd8beac1599eb8834,50200023535069,476396.39,60ec41ba55c00300382672d9,HDFC,direct expenses,5eecc6d6449e4f7cfb1c2708,2021-11-09T00:00:00.000Z,POS 514834XXXXXX9486 FLIPKART,shopping,,debit_card,-25000
61b70a2ed8beac1599eb883f,50200023535069,367053.49,60ec41ba55c00300382672d9,HDFC,Marketing Expense,5eecc6d6449e4f7cfb1c2708,2021-11-09T00:00:00.000Z,POS 514834XXXXXX9486 GOOGLE ADS,,,debit_card,-109342.9
61b70a2fd8beac1599eb8845,50200023535069,367565.12,60ec41ba55c00300382672d9,HDFC,Revenue-Mktplace,5eecc6d6449e4f7cfb1c2708,2021-11-09T00:00:00.000Z,NEFT CR-ICIC0000105-ICICI BANK NODAL AC MANASH LIFESTYL-SLICK ORGANICS PRIVATE L IMITED KOLK-ICIJ213130004212,,,net_banking_transfer,511.63
61b70a30d8beac1599eb884b,50200023535069,368714.5,60ec41ba55c00300382672d9,HDFC,Revenue-Mktplace,5eecc6d6449e4f7cfb1c2708,2021-11-09T00:00:00.000Z,NEFT CR-ICIC0000105-ICICI BANK NODAL AC MANASH LIFESTYL-SLICK ORGANICS PRIVATE L IMITED MP M-ICIJ213130004211,,,net_banking_transfer,1149.38
61b70a31d8beac1599eb8851,50200023535069,369153.56,60ec41ba55c00300382672d9,HDFC,Revenue-Mktplace,5eecc6d6449e4f7cfb1c2708,2021-11-09T00:00:00.000Z,NEFT CR-ICIC0000105-ICICI BANK NODAL AC MANASH LIFESTYL-SLICK ORGANICS PRIVATE L IMITED BANG-ICIJ213130004214,,,net_banking_transfer,439.06
61b70a32d8beac1599eb8856,50200023535069,373049.3,60ec41ba55c00300382672d9,HDFC,Revenue-PG-non-split,5eecc6d6449e4f7cfb1c2708,2021-11-09T00:00:00.000Z,NEFT CR-IDFB0010204-SEZZLE PAYMENTS PRIV ATE LIMITED-SLICK ORGANICS PRIVATE LIMIT ED-IDFBH21313577731,insurance,,net_banking_transfer,3895.74
61b70a33d8beac1599eb8860,50200023535069,409778.88,60ec41ba55c00300382672d9,HDFC,Revenue-PG-non-split,5eecc6d6449e4f7cfb1c2708,2021-11-09T00:00:00.000Z,NEFT CR-KKBK0000958-BROKENTUSK TECHNOLOG,,,net_banking_transfer,36729.58
61b70a34d8beac1599eb8867,50200023535069,1193336.63,60ec41ba55c00300382672d9,HDFC,Revenue-Mktplace,5eecc6d6449e4f7cfb1c2708,2021-11-09T00:00:00.000Z,NEFT CR-HSBC0110004-CLOUDTAIL INDIA PRIV ATE LIMITED-SLICK ORGANICS PRIVATE LIMIT ED-HSBCN21313984719,,,net_banking_transfer,783557.75
61b70a35d8beac1599eb886c,50200023535069,1194294.12,60ec41ba55c00300382672d9,HDFC,Revenue-PG-split enabled,5eecc6d6449e4f7cfb1c2708,2021-11-09T00:00:00.000Z,NEFT CR-UTIB0001506-RAZORPAY SOFTWARE PR IVATE LIMITED-SLICK ORGANICS PVT LITD-AX ISCN0104122930,insurance,,net_banking_transfer,957.49
61b70a36d8beac1599eb8873,50200023535069,1156842.99,60ec41ba55c00300382672d9,HDFC,SAAS/tech expense,5eecc6d6449e4f7cfb1c2708,2021-11-10T00:00:00.000Z,POS 514834XXXXXX9486 AMAZON.COM,shopping,,debit_card,-37451.13
61b70a37d8beac1599eb8876,50200023535069,1167040.27,60ec41ba55c00300382672d9,HDFC,Revenue-PG-non-split,5eecc6d6449e4f7cfb1c2708,2021-11-10T00:00:00.000Z,IMPS-131404659582-PAYTM PAYMENTS SERVI-P YTM-XXXXXXXXXX0008-ALL202111102168200003 30830668628,ewallet,,net_banking_transfer,10197.28
61b70a38d8beac1599eb8880,50200023535069,667040.27,60ec41ba55c00300382672d9,HDFC,Marketing Expense,5eecc6d6449e4f7cfb1c2708,2021-11-10T00:00:00.000Z,"NEFT DR-CITI0000006-FACEBOOK INDIA ONLIN E SERVICES PVT LTD-NETBANK, MUM-N3142117 08422003-500000",,,net_banking_transfer,-500000
61b70a39d8beac1599eb8886,50200023535069,690539.59,60ec41ba55c00300382672d9,HDFC,Revenue-Mktplace,5eecc6d6449e4f7cfb1c2708,2021-11-10T00:00:00.000Z,NEFT CR-DEUT0797BGL-FLIPKART INTERNET PR IVATE LIMITED-SLICK ORGANICS PVT LTD-131 400461GN00035,shopping,,net_banking_transfer,23499.32
61b70a3ad8beac1599eb888c,50200023535069,700354.11,60ec41ba55c00300382672d9,HDFC,Revenue-Mktplace,5eecc6d6449e4f7cfb1c2708,2021-11-10T00:00:00.000Z,NEFT CR-DEUT0797BGL-FLIPKART INTERNET PR IVATE LIMITED-SLICK ORGANICS PVT LTD-131 400471GN00122,shopping,,net_banking_transfer,9814.52
61b70a3bd8beac1599eb8893,50200023535069,701510.54,60ec41ba55c00300382672d9,HDFC,Revenue-PG-split enabled,5eecc6d6449e4f7cfb1c2708,2021-11-10T00:00:00.000Z,NEFT CR-UTIB0001506-RAZORPAY SOFTWARE PR IVATE LIMITED-SLICK ORGANICS PVT LITD-AX ISCN0104201634,insurance,,net_banking_transfer,1156.43
61b70a3cd8beac1599eb8897,50200023535069,651510.54,60ec41ba55c00300382672d9,HDFC,direct expenses,5eecc6d6449e4f7cfb1c2708,2021-11-10T00:00:00.000Z,"NEFT DR-PYTM0123456-PAYTM-NETBANK, MUM-N 314211708495820-50000",ewallet,,net_banking_transfer,-50000
61b70a3dd8beac1599eb889f,50200023535069,649955.02,60ec41ba55c00300382672d9,HDFC,bank charges,5eecc6d6449e4f7cfb1c2708,2021-11-10T00:00:00.000Z,.DC INTL POS TXN MARKUP+ST 241021 261021 -CDT2130806383839,,,international_transaction_arbitrage,-1555.52
61b70a3ed8beac1599eb88a6,50200023535069,654598.02,60ec41ba55c00300382672d9,HDFC,Transfer in/Revenue-other,5eecc6d6449e4f7cfb1c2708,2021-11-10T00:00:00.000Z,NEFT CR-KKBK0000958-INNOVATIVE RETAIL CO NCEPTS PRIVATE LTD-SLICK ORGANICS PVT LT D-KKBK213143876067,,,net_banking_transfer,4643
61b70a3fd8beac1599eb88aa,50200023535069,687076.08,60ec41ba55c00300382672d9,HDFC,Revenue-PG-non-split,5eecc6d6449e4f7cfb1c2708,2021-11-10T00:00:00.000Z,NEFT CR-KKBK0000958-BROKENTUSK TECHNOLOG,,,net_banking_transfer,32478.06
61b70a40d8beac1599eb88b2,50200023535069,687588.46,60ec41ba55c00300382672d9,HDFC,Revenue-Mktplace,5eecc6d6449e4f7cfb1c2708,2021-11-10T00:00:00.000Z,NEFT CR-ICIC0000105-ICICI BANK NODAL AC MANASH LIFESTYL-SLICK ORGANICS PRIVATE L IMITED HYD-ICIJ213140003687,,,net_banking_transfer,512.38
61b70a41d8beac1599eb88b6,50200023535069,689117.16,60ec41ba55c00300382672d9,HDFC,Revenue-COD,5eecc6d6449e4f7cfb1c2708,2021-11-10T00:00:00.000Z,NEFT CR-ICIC0000155-SHIPROCKET COD CRF I D 3364717-SLICK ORGANICS PVT LTD-CMS2230 093997,insurance,,net_banking_transfer,1528.7
61b70a42d8beac1599eb88bf,50200023535069,689572.6,60ec41ba55c00300382672d9,HDFC,Revenue-Mktplace,5eecc6d6449e4f7cfb1c2708,2021-11-10T00:00:00.000Z,NEFT CR-DEUT0784BBY-TATA UNISTORE LTD-NO DAL-SLICK ORGANICS PVT LTD-131401654GN00 416,insurance,,net_banking_transfer,455.44
61b70a42d8beac1599eb88c3,50200023535069,692087.54,60ec41ba55c00300382672d9,HDFC,Revenue-PG-non-split,5eecc6d6449e4f7cfb1c2708,2021-11-10T00:00:00.000Z,NEFT CR-IDFB0010204-SEZZLE PAYMENTS PRIV ATE LIMITED-SLICK ORGANICS PRIVATE LIMIT ED-IDFBH21314658334,insurance,,net_banking_transfer,2514.94
61b70a43d8beac1599eb88cf,50200023535069,692781.55,60ec41ba55c00300382672d9,HDFC,Revenue-PG-split enabled,5eecc6d6449e4f7cfb1c2708,2021-11-10T00:00:00.000Z,NEFT CR-UTIB0001506-RAZORPAY SOFTWARE PR IVATE LIMITED-SLICK ORGANICS PVT LITD-AX ISCN0104341832,insurance,,net_banking_transfer,694.01
61b70a44d8beac1599eb88d4,50200023535069,693318.22,60ec41ba55c00300382672d9,HDFC,Transfer in/Revenue-other,5eecc6d6449e4f7cfb1c2708,2021-11-10T00:00:00.000Z,4060006520-10 11 2021-HDFAZCUR1,,,Other,536.67
61b70a45d8beac1599eb88d9,50200023535069,681568.5,60ec41ba55c00300382672d9,HDFC,Marketing Expense,5eecc6d6449e4f7cfb1c2708,2021-11-10T00:00:00.000Z,POS 514834XXXXXX9486 GOOGLE ADS,,,debit_card,-11749.72
61b70a46d8beac1599eb88dd,50200023535069,717153.5,60ec41ba55c00300382672d9,HDFC,Revenue-COD,5eecc6d6449e4f7cfb1c2708,2021-11-11T00:00:00.000Z,NEFT CR-KKBK0000958-PICKRR TECHNOLOGIES PVT LTD-SLICKORGANICSPRIVATELIMITED-CMS3 152103452730,insurance,,net_banking_transfer,35585
61b70a47d8beac1599eb88e3,50200023535069,728889.85,60ec41ba55c00300382672d9,HDFC,Revenue-PG-non-split,5eecc6d6449e4f7cfb1c2708,2021-11-11T00:00:00.000Z,IMPS-131504985541-PAYTM PAYMENTS SERVI-P YTM-XXXXXXXXXX0008-ALL202111112168200003 30830668628,ewallet,,net_banking_transfer,11736.35
61b70a48d8beac1599eb88e8,50200023535069,728337.04,60ec41ba55c00300382672d9,HDFC,Marketing Expense,5eecc6d6449e4f7cfb1c2708,2021-11-11T00:00:00.000Z,POS 514834XXXXXX9486 GOOGLE ADS,,,debit_card,-552.81
61b70a49d8beac1599eb88ed,50200023535069,728336.04,60ec41ba55c00300382672d9,HDFC,Marketing Expense,5eecc6d6449e4f7cfb1c2708,2021-11-11T00:00:00.000Z,POS 514834XXXXXX9486 GOOGLE *TEMPORAR,,,debit_card,-1
61b70a4ad8beac1599eb88f3,50200023535069,728337.04,60ec41ba55c00300382672d9,HDFC,Transfer in/Revenue-other,5eecc6d6449e4f7cfb1c2708,2021-11-11T00:00:00.000Z,POS 514834XXXXXX9486 GOOGLE *TEMPORAR,,,debit_card,1
61b70a4bd8beac1599eb88f9,50200023535069,730138.42,60ec41ba55c00300382672d9,HDFC,Revenue-PG-split enabled,5eecc6d6449e4f7cfb1c2708,2021-11-11T00:00:00.000Z,NEFT CR-UTIB0001506-RAZORPAY SOFTWARE PR IVATE LIMITED-SLICK ORGANICS PVT LITD-AX ISCN0104425574,insurance,,net_banking_transfer,1801.38
61b70a4cd8beac1599eb890b,50200023535069,729585.61,60ec41ba55c00300382672d9,HDFC,Marketing Expense,5eecc6d6449e4f7cfb1c2708,2021-11-11T00:00:00.000Z,POS 514834XXXXXX9486 GOOGLE ADS,,,debit_card,-552.81
61b70a4dd8beac1599eb891c,50200023535069,629585.61,60ec41ba55c00300382672d9,HDFC,direct expenses,5eecc6d6449e4f7cfb1c2708,2021-11-11T00:00:00.000Z,"NEFT DR-PYTM0123456-PAYTM-NETBANK, MUM-N",ewallet,,net_banking_transfer,-100000
61b70a4ed8beac1599eb892b,50200023535069,579585.61,60ec41ba55c00300382672d9,HDFC,Marketing Expense,5eecc6d6449e4f7cfb1c2708,2021-11-11T00:00:00.000Z,POS 514834XXXXXX9486 GOOGLE ADS,,,debit_card,-50000
61b70a4fd8beac1599eb8955,50200023535069,545130.61,60ec41ba55c00300382672d9,HDFC,direct expenses,5eecc6d6449e4f7cfb1c2708,2021-11-11T00:00:00.000Z,50200043297657-TPT-34455-AIDC PRODUCTS I NDIA PRIVATE LIMITED,,,net_banking_transfer,-34455
61b70a50d8beac1599eb896c,50200023535069,545642.99,60ec41ba55c00300382672d9,HDFC,Revenue-Mktplace,5eecc6d6449e4f7cfb1c2708,2021-11-11T00:00:00.000Z,NEFT CR-ICIC0000105-ICICI BANK NODAL AC MANASH LIFESTYL-SLICK ORGANICS PRIVATE L IMITED HYD-ICIJ213150004570,,,net_banking_transfer,512.38
61b70a51d8beac1599eb8976,50200023535069,548074.53,60ec41ba55c00300382672d9,HDFC,Revenue-PG-non-split,5eecc6d6449e4f7cfb1c2708,2021-11-11T00:00:00.000Z,NEFT CR-IDFB0010204-SEZZLE PAYMENTS PRIV ATE LIMITED-SLICK ORGANICS PRIVATE LIMIT ED-IDFBH21315787292,insurance,,net_banking_transfer,2431.54
61b70a52d8beac1599eb897f,50200023535069,549013.27,60ec41ba55c00300382672d9,HDFC,Revenue-PG-split enabled,5eecc6d6449e4f7cfb1c2708,2021-11-11T00:00:00.000Z,NEFT CR-UTIB0001506-RAZORPAY SOFTWARE PR IVATE LIMITED-SLICK ORGANICS PVT LITD-AX ISCN0104585806,insurance,,net_banking_transfer,938.74
61b70a53d8beac1599eb898c,50200023535069,511741.51,60ec41ba55c00300382672d9,HDFC,SAAS/tech expense,5eecc6d6449e4f7cfb1c2708,2021-11-12T00:00:00.000Z,POS 514834XXXXXX9486 AMAZON.COM,shopping,,debit_card,-37271.76
61b70a54d8beac1599eb8993,50200023535069,521671.01,60ec41ba55c00300382672d9,HDFC,Revenue-PG-non-split,5eecc6d6449e4f7cfb1c2708,2021-11-12T00:00:00.000Z,UPI-PAYTM-PPSL-PAYOUTS@PAYTM-PYTM0123456 -131605359654-ALL202111122168200,ewallet,,upi,9929.5
61b70a55d8beac1599eb8996,50200023535069,527990.14,60ec41ba55c00300382672d9,HDFC,Revenue-Mktplace,5eecc6d6449e4f7cfb1c2708,2021-11-12T00:00:00.000Z,NEFT CR-DEUT0797BGL-FLIPKART INTERNET PR IVATE LIMITED-SLICK ORGANICS PVT LTD-131 600157GN00076,shopping,,net_banking_transfer,6319.13
61b70a56d8beac1599eb89a3,50200023535069,537780.01,60ec41ba55c00300382672d9,HDFC,Revenue-Mktplace,5eecc6d6449e4f7cfb1c2708,2021-11-12T00:00:00.000Z,NEFT CR-DEUT0797BGL-FLIPKART INTERNET PR IVATE LIMITED-SLICK ORGANICS PVT LTD-131 600190GN00027,shopping,,net_banking_transfer,9789.87
61b70a57d8beac1599eb89a8,50200023535069,538452.93,60ec41ba55c00300382672d9,HDFC,Revenue-PG-split enabled,5eecc6d6449e4f7cfb1c2708,2021-11-12T00:00:00.000Z,NEFT CR-UTIB0001506-RAZORPAY SOFTWARE PR IVATE LIMITED-SLICK ORGANICS PVT LITD-AX ISCN0104654384,insurance,,net_banking_transfer,672.92
61b70a58d8beac1599eb89b0,50200023535069,446452.93,60ec41ba55c00300382672d9,HDFC,direct expenses,5eecc6d6449e4f7cfb1c2708,2021-11-12T00:00:00.000Z,"NEFT DR-KKBK0000173-ONE STOP ADVERTISING -NETBANK, MUM-N316211711695361-92000",,,net_banking_transfer,-92000
61b70a59d8beac1599eb89b9,50200023535069,450868.91,60ec41ba55c00300382672d9,HDFC,Revenue-Mktplace,5eecc6d6449e4f7cfb1c2708,2021-11-12T00:00:00.000Z,4060006499-TIMES INTERNET LIMITED NODAL,,,Other,4415.98
61b70a5ad8beac1599eb89c9,50200023535069,451381.29,60ec41ba55c00300382672d9,HDFC,Revenue-Mktplace,5eecc6d6449e4f7cfb1c2708,2021-11-12T00:00:00.000Z,NEFT CR-ICIC0000105-ICICI BANK NODAL AC MANASH LIFESTYL-SLICK ORGANICS PRIVATE L IMITED MP M-ICIJ213160000236,,,net_banking_transfer,512.38
61b70a5bd8beac1599eb89e5,50200023535069,451726.01,60ec41ba55c00300382672d9,HDFC,Revenue-PG-non-split,5eecc6d6449e4f7cfb1c2708,2021-11-12T00:00:00.000Z,NEFT CR-YESB0000001-RZPX PVT LTD NODAL A,,,salary,344.72
61b70a5cd8beac1599eb89ec,50200023535069,452145.21,60ec41ba55c00300382672d9,HDFC,Revenue-COD,5eecc6d6449e4f7cfb1c2708,2021-11-12T00:00:00.000Z,NEFT CR-ICIC0000155-SHIPROCKET COD CRF I D 3376893-SLICK ORGANICS PVT LTD-CMS2233 624914,insurance,,net_banking_transfer,419.2
61b70a5dd8beac1599eb89f2,50200023535069,520250.9,60ec41ba55c00300382672d9,HDFC,Revenue-PG-non-split,5eecc6d6449e4f7cfb1c2708,2021-11-12T00:00:00.000Z,NEFT CR-KKBK0000958-BROKENTUSK TECHNOLOG IES PRIVATE LIMITED-SLICK ORGANICS PRIVA TE LIMITED-KKBK213164396324,,,net_banking_transfer,68105.69
61b70a5ed8beac1599eb89fb,50200023535069,521126.92,60ec41ba55c00300382672d9,HDFC,Revenue-PG-split enabled,5eecc6d6449e4f7cfb1c2708,2021-11-12T00:00:00.000Z,NEFT CR-UTIB0001506-RAZORPAY SOFTWARE PR IVATE LIMITED-SLICK ORGANICS PVT LITD-AX ISCN0104754234,insurance,,net_banking_transfer,876.02
61b70a5fd8beac1599eb8a00,50200023535069,521670.15,60ec41ba55c00300382672d9,HDFC,Revenue-PG-non-split,5eecc6d6449e4f7cfb1c2708,2021-11-12T00:00:00.000Z,NEFT CR-IDFB0010204-SEZZLE PAYMENTS PRIV ATE LIMITED-SLICK ORGANICS PRIVATE LIMIT ED-IDFBH21316859805,insurance,,net_banking_transfer,543.23
61b70a60d8beac1599eb8a14,50200023535069,725914.15,60ec41ba55c00300382672d9,HDFC,Transfer in/Revenue-other,5eecc6d6449e4f7cfb1c2708,2021-11-12T00:00:00.000Z,RTGS CR-SBIN0041003-CHAYA TRADERS-SLICK ORGANIC-SBINR12021111251622716,travel,,net_banking_transfer,204244
61b70a61d8beac1599eb8a17,50200023535069,722267.67,60ec41ba55c00300382672d9,HDFC,direct expenses,5eecc6d6449e4f7cfb1c2708,2021-11-12T00:00:00.000Z,POS 514834XXXXXX9486 WWW.FAQPRIME.COM,,,debit_card,-3646.48
61b70a62d8beac1599eb8a1f,50200023535069,731468.62,60ec41ba55c00300382672d9,HDFC,Revenue-PG-non-split,5eecc6d6449e4f7cfb1c2708,2021-11-13T00:00:00.000Z,UPI-PAYTM-PPSL-PAYOUTS@PAYTM-PYTM0123456 -131748158387-ALL202111132168200,ewallet,,upi,9200.95
61b70a63d8beac1599eb8a23,50200023535069,695010.46,60ec41ba55c00300382672d9,HDFC,direct expenses,5eecc6d6449e4f7cfb1c2708,2021-11-13T00:00:00.000Z,POS 514834XXXXXX9486 AMZN AD TR95V0H3,,,debit_card,-36458.16
61b70a64d8beac1599eb8a28,50200023535069,704832.97,60ec41ba55c00300382672d9,HDFC,Revenue-PG-non-split,5eecc6d6449e4f7cfb1c2708,2021-11-14T00:00:00.000Z,UPI-PAYTM-PPSL-PAYOUTS@PAYTM-PYTM0123456 -131891538523-ALL202111142168200,ewallet,,upi,9822.51
61b70a65d8beac1599eb8a2e,50200023535069,664954.97,60ec41ba55c00300382672d9,HDFC,direct expenses,5eecc6d6449e4f7cfb1c2708,2021-11-14T00:00:00.000Z,POS 514834XXXXXX9486 PAYU-WWW.CLEARTR,,,debit_card,-39878
61b70a66d8beac1599eb8a39,50200023535069,662954.97,60ec41ba55c00300382672d9,HDFC,direct expenses,5eecc6d6449e4f7cfb1c2708,2021-11-14T00:00:00.000Z,POS 514834XXXXXX9486 AIP*INERGLOBE AV,,,debit_card,-2000
61b70a67d8beac1599eb8a4d,50200023535069,407954.97,60ec41ba55c00300382672d9,HDFC,SAAS/tech expense,5eecc6d6449e4f7cfb1c2708,2021-11-14T00:00:00.000Z,KQSX644LAJ4KLOOVCY/PAYUAMAZON,shopping,,Other,-255000
61b70a68d8beac1599eb8a54,50200023535069,405954.97,60ec41ba55c00300382672d9,HDFC,direct expenses,5eecc6d6449e4f7cfb1c2708,2021-11-14T00:00:00.000Z,POS 514834XXXXXX9486 INTERGLOBE AVIAT,,,debit_card,-2000
61b70a69d8beac1599eb8a64,50200023535069,409689.26,60ec41ba55c00300382672d9,HDFC,Revenue-PG-non-split,5eecc6d6449e4f7cfb1c2708,2021-11-15T00:00:00.000Z,UPI-PAYTM-PPSL-PAYOUTS@PAYTM-PYTM0123456 -131934861518-ALL202111152168200,ewallet,,upi,3734.29
61b70a6ad8beac1599eb8a77,50200023535069,372776.63,60ec41ba55c00300382672d9,HDFC,direct expenses,5eecc6d6449e4f7cfb1c2708,2021-11-15T00:00:00.000Z,POS 514834XXXXXX9486 AMZN AD TR95V0H3,,,debit_card,-36912.63
61b70a6bd8beac1599eb8a7e,50200023535069,368136.63,60ec41ba55c00300382672d9,HDFC,direct expenses,5eecc6d6449e4f7cfb1c2708,2021-11-15T00:00:00.000Z,02021134327391/ESIC,,,Other,-4640
61b70a6cd8beac1599eb8a85,50200023535069,375047.35,60ec41ba55c00300382672d9,HDFC,Revenue-PG-split enabled,5eecc6d6449e4f7cfb1c2708,2021-11-15T00:00:00.000Z,NEFT CR-UTIB0001506-RAZORPAY SOFTWARE PR,,,net_banking_transfer,6910.72
61b70a6dd8beac1599eb8a89,50200023535069,356524.35,60ec41ba55c00300382672d9,HDFC,direct expenses,5eecc6d6449e4f7cfb1c2708,2021-11-15T00:00:00.000Z,"NEFT DR-SBIN0008078-PANDIT PLASTICS-NETB ANK, MUM-N319211713844492-18523",,,net_banking_transfer,-18523
61b70a6ed8beac1599eb8a8d,50200023535069,341524.35,60ec41ba55c00300382672d9,HDFC,direct expenses,5eecc6d6449e4f7cfb1c2708,2021-11-15T00:00:00.000Z,"NEFT DR-ICIC0000021-AKHILESH DIXIT-NETBA NK, MUM-N319211713844948-15000",,,net_banking_transfer,-15000
61b70a6fd8beac1599eb8a94,50200023535069,359890.32,60ec41ba55c00300382672d9,HDFC,Revenue-Mktplace,5eecc6d6449e4f7cfb1c2708,2021-11-15T00:00:00.000Z,NEFT CR-DEUT0797BGL-FLIPKART INTERNET PR IVATE LIMITED-SLICK ORGANICS PVT LTD-131 900153GN00109,shopping,,net_banking_transfer,18365.97
61b70a70d8beac1599eb8a9b,50200023535069,366017.5,60ec41ba55c00300382672d9,HDFC,Revenue-Mktplace,5eecc6d6449e4f7cfb1c2708,2021-11-15T00:00:00.000Z,NEFT CR-DEUT0797BGL-FLIPKART INTERNET PR IVATE LIMITED-SLICK ORGANICS PVT LTD-131 900236GN00291,shopping,,net_banking_transfer,6127.18
61b70a71d8beac1599eb8a9f,50200023535069,137509.5,60ec41ba55c00300382672d9,HDFC,Marketing Expense,5eecc6d6449e4f7cfb1c2708,2021-11-15T00:00:00.000Z,"NEFT DR-CITI0000006-FACEBOOK INDIA ONLIN E SERVICES PVT LTD-NETBANK, MUM-N3192117 14226733-228508",,,net_banking_transfer,-228508
61b70a72d8beac1599eb8aa3,50200023535069,135962.81,60ec41ba55c00300382672d9,HDFC,bank charges,5eecc6d6449e4f7cfb1c2708,2021-11-15T00:00:00.000Z,.DC INTL POS TXN MARKUP+ST 291021 301021 -CDT2130806383839,,,international_transaction_arbitrage,-1546.69
61b70a73d8beac1599eb8aa7,50200023535069,136754.56,60ec41ba55c00300382672d9,HDFC,Revenue-COD,5eecc6d6449e4f7cfb1c2708,2021-11-15T00:00:00.000Z,NEFT CR-ICIC0000155-SHIPROCKET COD CRF I D 3385090-SLICK ORGANICS PVT LTD-CMS2237 921081,insurance,,net_banking_transfer,791.75
61b70a74d8beac1599eb8aae,50200023535069,139378.56,60ec41ba55c00300382672d9,HDFC,Transfer in/Revenue-other,5eecc6d6449e4f7cfb1c2708,2021-11-15T00:00:00.000Z,FT - CR - 50200038726231 - HOUSE OF BEAU TY PRIVATE LIMITED,,,Other,2624
61b70a75d8beac1599eb8ab3,50200023535069,139764.94,60ec41ba55c00300382672d9,HDFC,Revenue-PG-split enabled,5eecc6d6449e4f7cfb1c2708,2021-11-15T00:00:00.000Z,NEFT CR-UTIB0001506-RAZORPAY SOFTWARE PR IVATE LIMITED-SLICK ORGANICS PVT LITD-AX ISCN0105033460,insurance,,net_banking_transfer,386.38
61b70a76d8beac1599eb8abb,50200023535069,155907.94,60ec41ba55c00300382672d9,HDFC,Revenue-Mktplace,5eecc6d6449e4f7cfb1c2708,2021-11-15T00:00:00.000Z,NEFT CR-SCBL0036001-M/S DREAMPLUG TECHNO -SLICK ORGANICS PRIVATE LIMITEDSLICK-SIN 31436Q0025534,insurance,,net_banking_transfer,16143
61b70a77d8beac1599eb8abf,50200023535069,156420.32,60ec41ba55c00300382672d9,HDFC,Revenue-Mktplace,5eecc6d6449e4f7cfb1c2708,2021-11-15T00:00:00.000Z,NEFT CR-ICIC0000105-ICICI BANK NODAL AC MANASH LIFESTYL-SLICK ORGANICS PRIVATE L IMITED HYD-ICIJ213190001628,,,net_banking_transfer,512.38
61b70a78d8beac1599eb8ac2,50200023535069,156639.5,60ec41ba55c00300382672d9,HDFC,Transfer in/Revenue-other,5eecc6d6449e4f7cfb1c2708,2021-11-15T00:00:00.000Z,NEFT CR-ICIC0000105-ICICI BANK NODAL AC,,,net_banking_transfer,219.18
61b70a79d8beac1599eb8ac8,50200023535069,168472.5,60ec41ba55c00300382672d9,HDFC,Revenue-Mktplace,5eecc6d6449e4f7cfb1c2708,2021-11-15T00:00:00.000Z,NEFT CR-KKBK0000958-SURFBOATS SOLUTIONS PVT LTD-SLICK ORGANICS PRIVATE LIMITED-K KBK213194938081,insurance,,net_banking_transfer,11833
61b70a7ad8beac1599eb8acf,50200023535069,198468.37,60ec41ba55c00300382672d9,HDFC,Revenue-PG-non-split,5eecc6d6449e4f7cfb1c2708,2021-11-15T00:00:00.000Z,NEFT CR-KKBK0000958-BROKENTUSK TECHNOLOG IES PRIVATE LIMITED-SLICK ORGANICS PRIVA TE LIMITED-KKBK213194953478,,,net_banking_transfer,29995.87
61b70a7bd8beac1599eb8ad3,50200023535069,238393.37,60ec41ba55c00300382672d9,HDFC,Revenue-COD,5eecc6d6449e4f7cfb1c2708,2021-11-15T00:00:00.000Z,NEFT CR-KKBK0000958-PICKRR TECHNOLOGIES PVT LTD-SLICKORGANICSPRIVATELIMITED-CMS3 192103572972,insurance,,net_banking_transfer,39925
61b70a7cd8beac1599eb8ada,50200023535069,265298.17,60ec41ba55c00300382672d9,HDFC,Revenue-PG-non-split,5eecc6d6449e4f7cfb1c2708,2021-11-15T00:00:00.000Z,NEFT CR-KKBK0000958-BROKENTUSK TECHNOLOG IES PRIVATE LIMITED-SLICK ORGANICS PRIVA TE LIMITED-KKBK213194975068,,,net_banking_transfer,26904.8
61b70a7dd8beac1599eb8adf,50200023535069,258680.17,60ec41ba55c00300382672d9,HDFC,Salary/Emp/consultant Expense,5eecc6d6449e4f7cfb1c2708,2021-11-15T00:00:00.000Z,1623169296/EPFO,,,Other,-6618
61b70a7ed8beac1599eb8ae7,50200023535069,270453.3,60ec41ba55c00300382672d9,HDFC,Revenue-PG-non-split,5eecc6d6449e4f7cfb1c2708,2021-11-16T00:00:00.000Z,UPI-PAYTM-PPSL-PAYOUTS@PAYTM-PYTM0123456 -132076671272-ALL202111162168200,ewallet,,upi,11773.13
61b70a7fd8beac1599eb8aea,50200023535069,398618.38,60ec41ba55c00300382672d9,HDFC,Revenue-Mktplace,5eecc6d6449e4f7cfb1c2708,2021-11-16T00:00:00.000Z,NEFT CR-DEUT0797BGL-AMAZON PAY (INDIA) P RIVATE LIMITED-SLICK ORGANICS PVT LTD-13 2000107GN00047,shopping,,net_banking_transfer,128165.08
61b70a80d8beac1599eb8af2,50200023535069,399871.61,60ec41ba55c00300382672d9,HDFC,Revenue-PG-split enabled,5eecc6d6449e4f7cfb1c2708,2021-11-16T00:00:00.000Z,NEFT CR-UTIB0001506-RAZORPAY SOFTWARE PR IVATE LIMITED-SLICK ORGANICS PVT LITD-AX ISCN0105093707,insurance,,net_banking_transfer,1253.23
61b70a81d8beac1599eb8af6,50200023535069,396233.01,60ec41ba55c00300382672d9,HDFC,direct expenses,5eecc6d6449e4f7cfb1c2708,2021-11-16T00:00:00.000Z,POS 514834XXXXXX9486 FRESHWORKS INC,,,debit_card,-3638.6
61b70a82d8beac1599eb8af9,50200023535069,346233.01,60ec41ba55c00300382672d9,HDFC,Marketing Expense,5eecc6d6449e4f7cfb1c2708,2021-11-16T00:00:00.000Z,POS 514834XXXXXX9486 GOOGLE ADS,,,debit_card,-50000
61b70a83d8beac1599eb8aff,50200023535069,346678.05,60ec41ba55c00300382672d9,HDFC,Transfer in/Revenue-other,5eecc6d6449e4f7cfb1c2708,2021-11-16T00:00:00.000Z,NEFT CR-SBIN0004266-BEWAKOOF BRANDS PRIV ATE LIMITED-SLICK ORGANICS PRIVATE LIMIT ED-SBIN121320036534,,,net_banking_transfer,445.04
61b70a84d8beac1599eb8b04,50200023535069,376982.33,60ec41ba55c00300382672d9,HDFC,Revenue-PG-non-split,5eecc6d6449e4f7cfb1c2708,2021-11-16T00:00:00.000Z,NEFT CR-KKBK0000958-BROKENTUSK TECHNOLOG IES PRIVATE LIMITED-SLICK ORGANICS PRIVA TE LIMITED-KKBK213205228766,,,net_banking_transfer,30304.28
61b70a85d8beac1599eb8b0a,50200023535069,390368.45,60ec41ba55c00300382672d9,HDFC,Transfer in/Revenue-other,5eecc6d6449e4f7cfb1c2708,2021-11-16T00:00:00.000Z,57500000644820-SLICK ORGANICS,insurance,,Other,13386.12
61b70a86d8beac1599eb8b11,50200023535069,426406.79,60ec41ba55c00300382672d9,HDFC,Revenue-PG-non-split,5eecc6d6449e4f7cfb1c2708,2021-11-16T00:00:00.000Z,NEFT CR-KKBK0000958-BROKENTUSK TECHNOLOG,,,net_banking_transfer,36038.34
61b70a87d8beac1599eb8b14,50200023535069,431783.54,60ec41ba55c00300382672d9,HDFC,Revenue-PG-non-split,5eecc6d6449e4f7cfb1c2708,2021-11-16T00:00:00.000Z,NEFT CR-IDFB0010204-SEZZLE PAYMENTS PRIV ATE LIMITED-SLICK ORGANICS PRIVATE LIMIT ED-IDFBH21320139911,insurance,,net_banking_transfer,5376.75
61b70a88d8beac1599eb8b1c,50200023535069,432112.65,60ec41ba55c00300382672d9,HDFC,Revenue-Mktplace,5eecc6d6449e4f7cfb1c2708,2021-11-16T00:00:00.000Z,NEFT CR-ICIC0000105-ICICI BANK NODAL AC MANASH LIFESTYL-SLICK ORGANICS PRIVATE L IMITED MP G-ICIJ213200001716,,,net_banking_transfer,329.11
61b70a89d8beac1599eb8b1f,50200023535069,432625.03,60ec41ba55c00300382672d9,HDFC,Revenue-Mktplace,5eecc6d6449e4f7cfb1c2708,2021-11-16T00:00:00.000Z,NEFT CR-ICIC0000105-ICICI BANK NODAL AC MANASH LIFESTYL-SLICK ORGANICS PRIVATE L IMITED MP M-ICIJ213200001718,,,net_banking_transfer,512.38
61b70a8ad8beac1599eb8b27,50200023535069,1135734.45,60ec41ba55c00300382672d9,HDFC,Revenue-Mktplace,5eecc6d6449e4f7cfb1c2708,2021-11-16T00:00:00.000Z,NEFT CR-KKBK0000958-NYKAA E RETAIL PRIVA TE LIMITED NYKAA-SLICK ORGANICS PVT LTD- KKBK213205279262,insurance,,net_banking_transfer,703109.42
61b70a8bd8beac1599eb8b2b,50200023535069,1098373.51,60ec41ba55c00300382672d9,HDFC,direct expenses,5eecc6d6449e4f7cfb1c2708,2021-11-17T00:00:00.000Z,POS 514834XXXXXX9486 AMZN AD TR95V0H3,,,debit_card,-37360.94
61b70a8cd8beac1599eb8b2e,50200023535069,1110386.84,60ec41ba55c00300382672d9,HDFC,Revenue-PG-non-split,5eecc6d6449e4f7cfb1c2708,2021-11-17T00:00:00.000Z,IMPS-132104880405-PAYTM PAYMENTS SERVI-P YTM-XXXXXXXXXX0008-ALL202111172168200003 30830668628,ewallet,,net_banking_transfer,12013.33
61b70a8dd8beac1599eb8b34,50200023535069,1133942.9,60ec41ba55c00300382672d9,HDFC,Revenue-Mktplace,5eecc6d6449e4f7cfb1c2708,2021-11-17T00:00:00.000Z,NEFT CR-DEUT0797BGL-FLIPKART INTERNET PR IVATE LIMITED-SLICK ORGANICS PVT LTD-132 100547GN00023,shopping,,net_banking_transfer,23556.06
61b70a8ed8beac1599eb8b39,50200023535069,1154668.25,60ec41ba55c00300382672d9,HDFC,Revenue-Mktplace,5eecc6d6449e4f7cfb1c2708,2021-11-17T00:00:00.000Z,NEFT CR-DEUT0797BGL-FLIPKART INTERNET PR IVATE LIMITED-SLICK ORGANICS PVT LTD-132 100555GN00235,shopping,,net_banking_transfer,20725.35
61b70a8fd8beac1599eb8b3f,50200023535069,654668.25,60ec41ba55c00300382672d9,HDFC,Marketing Expense,5eecc6d6449e4f7cfb1c2708,2021-11-17T00:00:00.000Z,"NEFT DR-CITI0000006-FACEBOOK INDIA ONLIN E SERVICES PVT LTD-NETBANK, MUM-N3212117 16809164-500000",,,net_banking_transfer,-500000
61b70a90d8beac1599eb8b44,50200023535069,711419.45,60ec41ba55c00300382672d9,HDFC,Revenue-PG-non-split,5eecc6d6449e4f7cfb1c2708,2021-11-17T00:00:00.000Z,NEFT CR-KKBK0000958-BROKENTUSK TECHNOLOG IES PRIVATE LIMITED-SLICK ORGANICS PRIVA TE LIMITED-KKBK213215493803,,,net_banking_transfer,56751.2
61b70a91d8beac1599eb8b46,50200023535069,726052.45,60ec41ba55c00300382672d9,HDFC,Transfer in/Revenue-other,5eecc6d6449e4f7cfb1c2708,2021-11-17T00:00:00.000Z,50200050241205-TPT-ARATA-NAPSA PRIVATE L IMITED,,,net_banking_transfer,14633
61b70a92d8beac1599eb8b4f,50200023535069,728101.97,60ec41ba55c00300382672d9,HDFC,Transfer in/Revenue-other,5eecc6d6449e4f7cfb1c2708,2021-11-17T00:00:00.000Z,NEFT CR-ICIC0000105-ICICI BANK NODAL AC,,,net_banking_transfer,2049.52
61b70a93d8beac1599eb8b52,50200023535069,729671.64,60ec41ba55c00300382672d9,HDFC,Revenue-PG-non-split,5eecc6d6449e4f7cfb1c2708,2021-11-17T00:00:00.000Z,NEFT CR-IDFB0010204-SEZZLE PAYMENTS PRIV ATE LIMITED-SLICK ORGANICS PRIVATE LIMIT ED-IDFBH21321199471,insurance,,net_banking_transfer,1569.67
61b70a94d8beac1599eb8b5a,50200023535069,756324.64,60ec41ba55c00300382672d9,HDFC,Revenue-COD,5eecc6d6449e4f7cfb1c2708,2021-11-17T00:00:00.000Z,NEFT CR-KKBK0000958-PICKRR TECHNOLOGIES PVT LTD-SLICKORGANICSPRIVATELIMITED-CMS3 212103654690,insurance,,net_banking_transfer,26653
61b70a95d8beac1599eb8b5e,50200023535069,767232.38,60ec41ba55c00300382672d9,HDFC,Revenue-PG-non-split,5eecc6d6449e4f7cfb1c2708,2021-11-18T00:00:00.000Z,UPI-PAYTM-PPSL-PAYOUTS@PAYTM-PYTM0123456 -132262687242-ALL202111182168200,ewallet,,upi,10907.74
61b70a96d8beac1599eb8b61,50200023535069,512232.38,60ec41ba55c00300382672d9,HDFC,SAAS/tech expense,5eecc6d6449e4f7cfb1c2708,2021-11-18T00:00:00.000Z,KQSX64MPAJ7KDPO2DY/PAYUAMAZON,shopping,,Other,-255000
61b70a97d8beac1599eb8b67,50200023535069,519390.64,60ec41ba55c00300382672d9,HDFC,Transfer in/Revenue-other,5eecc6d6449e4f7cfb1c2708,2021-11-18T00:00:00.000Z,FT - C73137181121100501 - - 50200050045 240 - ZOOBOP ME WORKS PRIVATE LIMITED,,,Other,7158.26
61b70a98d8beac1599eb8b6c,50200023535069,494390.64,60ec41ba55c00300382672d9,HDFC,direct expenses,5eecc6d6449e4f7cfb1c2708,2021-11-18T00:00:00.000Z,POS 514834XXXXXX9486 RAZ*PURPLLE,,,debit_card,-25000
61b70a99d8beac1599eb8b72,50200023535069,459655.64,60ec41ba55c00300382672d9,HDFC,direct expenses,5eecc6d6449e4f7cfb1c2708,2021-11-18T00:00:00.000Z,"NEFT DR-YESB0000162-VINAY REDDY-NETBANK, MUM-N322211718380434-34735",,,net_banking_transfer,-34735
61b70a9ad8beac1599eb8b77,50200023535069,896033.89,60ec41ba55c00300382672d9,HDFC,Revenue-Mktplace,5eecc6d6449e4f7cfb1c2708,2021-11-18T00:00:00.000Z,NEFT CR-HSBC0110004-CLOUDTAIL INDIA PRIV ATE LIMITED-SLICK ORGANICS PRIVATE LIMIT ED-HSBCN21322128887,,,net_banking_transfer,436378.25
61b70a9bd8beac1599eb8b79,50200023535069,927139.92,60ec41ba55c00300382672d9,HDFC,Revenue-PG-non-split,5eecc6d6449e4f7cfb1c2708,2021-11-18T00:00:00.000Z,NEFT CR-KKBK0000958-BROKENTUSK TECHNOLOG IES PRIVATE LIMITED-SLICK ORGANICS PRIVA TE LIMITED-KKBK213225709881,,,net_banking_transfer,31106.03
61b70a9cd8beac1599eb8b81,50200023535069,927945.5,60ec41ba55c00300382672d9,HDFC,Revenue-Mktplace,5eecc6d6449e4f7cfb1c2708,2021-11-18T00:00:00.000Z,NEFT CR-ICIC0000105-ICICI BANK NODAL AC MANASH LIFESTYL-SLICK ORGANICS PRIVATE L IMITED MP G-ICIJ213220007112,,,net_banking_transfer,805.58
61b70a9dd8beac1599eb8b85,50200023535069,889698.99,60ec41ba55c00300382672d9,HDFC,direct expenses,5eecc6d6449e4f7cfb1c2708,2021-11-18T00:00:00.000Z,POS 514834XXXXXX9486 AMZN AD TR95V0H3,,,debit_card,-38246.51
61b70a9ed8beac1599eb8b8c,50200023535069,890205.44,60ec41ba55c00300382672d9,HDFC,Revenue-PG-non-split,5eecc6d6449e4f7cfb1c2708,2021-11-18T00:00:00.000Z,NEFT CR-IDFB0010204-SEZZLE PAYMENTS PRIV ATE LIMITED-SLICK ORGANICS PRIVATE LIMIT ED-IDFBH21322268477,insurance,,net_banking_transfer,506.45
61b70a9fd8beac1599eb8b91,50200023535069,897267.63,60ec41ba55c00300382672d9,HDFC,Revenue-PG-non-split,5eecc6d6449e4f7cfb1c2708,2021-11-19T00:00:00.000Z,UPI-PAYTM-PPSL-PAYOUTS@PAYTM-PYTM0123456 -132304804489-ALL202111192168200,ewallet,,upi,7062.19
61b70aa0d8beac1599eb8b94,50200023535069,915875.67,60ec41ba55c00300382672d9,HDFC,Revenue-Mktplace,5eecc6d6449e4f7cfb1c2708,2021-11-19T00:00:00.000Z,NEFT CR-DEUT0797BGL-FLIPKART INTERNET PR,shopping,,net_banking_transfer,18608.04
61b70aa1d8beac1599eb8b9a,50200023535069,825295.67,60ec41ba55c00300382672d9,HDFC,direct expenses,5eecc6d6449e4f7cfb1c2708,2021-11-19T00:00:00.000Z,"NEFT DR-ICIC0000542-AVANTIKA SUKHIA-NETB ANK, MUM-N323211719392637-90580",,,net_banking_transfer,-90580
61b70aa2d8beac1599eb8bac,50200023535069,769795.67,60ec41ba55c00300382672d9,HDFC,direct expenses,5eecc6d6449e4f7cfb1c2708,2021-11-19T00:00:00.000Z,50100293329616-TPT-55500-SADIYA BANO,,,net_banking_transfer,-55500
61b70aa3d8beac1599eb8bb2,50200023535069,658195.67,60ec41ba55c00300382672d9,HDFC,direct expenses,5eecc6d6449e4f7cfb1c2708,2021-11-19T00:00:00.000Z,"NEFT DR-BARB0VJMATU-ARTISTO DESIGNZ-NETB ANK, MUM-N323211719399824-111600",,,net_banking_transfer,-111600
61b70aa4d8beac1599eb8bb9,50200023535069,412176.67,60ec41ba55c00300382672d9,HDFC,direct expenses,5eecc6d6449e4f7cfb1c2708,2021-11-19T00:00:00.000Z,"NEFT DR-KKBK0005289-HILL GROOVE CONSULTI NG LLP-NETBANK, MUM-N323211719393717-246 019",,,net_banking_transfer,-246019
61b70aa5d8beac1599eb8bbb,50200023535069,340176.67,60ec41ba55c00300382672d9,HDFC,direct expenses,5eecc6d6449e4f7cfb1c2708,2021-11-19T00:00:00.000Z,50100301160692-TPT-72000-TARUN GARG,,,net_banking_transfer,-72000
61b70aa6d8beac1599eb8bc6,50200023535069,291576.67,60ec41ba55c00300382672d9,HDFC,direct expenses,5eecc6d6449e4f7cfb1c2708,2021-11-19T00:00:00.000Z,"NEFT DR-CNRB0015170-SNEHAL TAYDE-NETBANK , MUM-N323211719394136-48600",,,net_banking_transfer,-48600
61b70aa7d8beac1599eb8bc9,50200023535069,245230.67,60ec41ba55c00300382672d9,HDFC,direct expenses,5eecc6d6449e4f7cfb1c2708,2021-11-19T00:00:00.000Z,"NEFT DR-KKBK0000187-APPLIED LIFE PRIVATE LIMITED-NETBANK, MUM-N323211719402282-4 6346",,,net_banking_transfer,-46346
61b70aa8d8beac1599eb8bd7,50200023535069,123730.67,60ec41ba55c00300382672d9,HDFC,direct expenses,5eecc6d6449e4f7cfb1c2708,2021-11-19T00:00:00.000Z,"NEFT DR-KKBK0000173-ONE STOP ADVERTISING -NETBANK, MUM-N323211719402402-121500",,,net_banking_transfer,-121500
61b70aa9d8beac1599eb8bdc,50200023535069,3730.67,60ec41ba55c00300382672d9,HDFC,direct expenses,5eecc6d6449e4f7cfb1c2708,2021-11-19T00:00:00.000Z,IMPS-132311128810-PAYTM-PYTM-XXXXXXXX383 9-120000,ewallet,,net_banking_transfer,-120000
61b70aaad8beac1599eb8be1,50200023535069,15729.22,60ec41ba55c00300382672d9,HDFC,Revenue-Mktplace,5eecc6d6449e4f7cfb1c2708,2021-11-19T00:00:00.000Z,NEFT CR-DEUT0797BGL-FLIPKART INTERNET PR IVATE LIMITED-SLICK ORGANICS PVT LTD-132 300486GN00099,shopping,,net_banking_transfer,11998.55
61b70aabd8beac1599eb8be7,50200023535069,25729.22,60ec41ba55c00300382672d9,HDFC,Internal Transfers,5eecc6d6449e4f7cfb1c2708,2021-11-19T00:00:00.000Z,IB FUNDS TRANSFER CR-50200050976833 -SL ICK ORGANICS PVT LTD,insurance,,Other,10000
61b70aacd8beac1599eb8bed,50200023535069,33919.17,60ec41ba55c00300382672d9,HDFC,Revenue-PG-non-split,5eecc6d6449e4f7cfb1c2708,2021-11-20T00:00:00.000Z,UPI-PAYTM-PPSL-PAYOUTS@PAYTM-PYTM0123456 -132448100447-ALL202111202168200,ewallet,,upi,8189.95
61b70aadd8beac1599eb8bf2,50200023535069,13919.17,60ec41ba55c00300382672d9,HDFC,Marketing Expense,5eecc6d6449e4f7cfb1c2708,2021-11-20T00:00:00.000Z,POS 514834XXXXXX9486 GOOGLE ADS,,,debit_card,-20000
61b70aaed8beac1599eb8bfb,50200023535069,8722.67,60ec41ba55c00300382672d9,HDFC,direct expenses,5eecc6d6449e4f7cfb1c2708,2021-11-20T00:00:00.000Z,POS 514834XXXXXX9486 FEEDBACKFIVE,,,debit_card,-5196.5
61b70aafd8beac1599eb8bfd,50200023535069,10037.69,60ec41ba55c00300382672d9,HDFC,Transfer in/Revenue-other,5eecc6d6449e4f7cfb1c2708,2021-11-20T00:00:00.000Z,NEFT CR-ICIC0000105-ICICI BANK NODAL AC,,,net_banking_transfer,1315.02
61b70ab0d8beac1599eb8c06,50200023535069,11036.02,60ec41ba55c00300382672d9,HDFC,Revenue-Mktplace,5eecc6d6449e4f7cfb1c2708,2021-11-20T00:00:00.000Z,NEFT CR-ICIC0000105-ICICI BANK NODAL AC MANASH LIFESTYL-SLICK ORGANICS PRIVATE L IMITED MP M-ICIJ213240006782,,,net_banking_transfer,998.33
61b70ab1d8beac1599eb8c09,50200023535069,11401.05,60ec41ba55c00300382672d9,HDFC,Revenue-Mktplace,5eecc6d6449e4f7cfb1c2708,2021-11-20T00:00:00.000Z,NEFT CR-ICIC0000105-ICICI BANK NODAL AC MANASH LIFESTYL-SLICK ORGANICS PRIVATE L IMITED BANG-ICIJ213240006786,,,net_banking_transfer,365.03
61b70ab2d8beac1599eb8c10,50200023535069,12213.23,60ec41ba55c00300382672d9,HDFC,Revenue-Mktplace,5eecc6d6449e4f7cfb1c2708,2021-11-20T00:00:00.000Z,NEFT CR-ICIC0000105-ICICI BANK NODAL AC MANASH LIFESTYL-SLICK ORGANICS PRIVATE L IMITED MP G-ICIJ213240006780,,,net_banking_transfer,812.18
61b70ab3d8beac1599eb8c15,50200023535069,45203.87,60ec41ba55c00300382672d9,HDFC,Revenue-PG-non-split,5eecc6d6449e4f7cfb1c2708,2021-11-20T00:00:00.000Z,NEFT CR-KKBK0000958-BROKENTUSK TECHNOLOG IES PRIVATE LIMITED-SLICK ORGANICS PRIVA TE LIMITED-KKBK213246176409,,,net_banking_transfer,32990.64
61b70ab4d8beac1599eb8c19,50200023535069,79557.66,60ec41ba55c00300382672d9,HDFC,Revenue-PG-non-split,5eecc6d6449e4f7cfb1c2708,2021-11-20T00:00:00.000Z,NEFT CR-KKBK0000958-BROKENTUSK TECHNOLOG IES PRIVATE LIMITED-SLICK ORGANICS PRIVA TE LIMITED-KKBK213246176689,,,net_banking_transfer,34353.79
61b70ab5d8beac1599eb8c1e,50200023535069,105533.27,60ec41ba55c00300382672d9,HDFC,Revenue-PG-non-split,5eecc6d6449e4f7cfb1c2708,2021-11-21T00:00:00.000Z,IMPS-132504732571-PAYTM PAYMENTS SERVI-P YTM-XXXXXXXXXX0008-ALL202111212168200003 30830668628,ewallet,,net_banking_transfer,25975.61
61b70ab6d8beac1599eb8c24,50200023535069,65871.28,60ec41ba55c00300382672d9,HDFC,direct expenses,5eecc6d6449e4f7cfb1c2708,2021-11-21T00:00:00.000Z,POS 514834XXXXXX9486 THE ROCKET SCIEN,,,debit_card,-39661.99
61b70ab7d8beac1599eb8c28,50200023535069,74716.83,60ec41ba55c00300382672d9,HDFC,Revenue-PG-non-split,5eecc6d6449e4f7cfb1c2708,2021-11-22T00:00:00.000Z,UPI-PAYTM-PPSL-PAYOUTS@PAYTM-PYTM0123456 -132634526391-ALL202111222168200,ewallet,,upi,8845.55
61b70ab8d8beac1599eb8c30,50200023535069,86973.25,60ec41ba55c00300382672d9,HDFC,Revenue-Mktplace,5eecc6d6449e4f7cfb1c2708,2021-11-22T00:00:00.000Z,NEFT CR-DEUT0797BGL-FLIPKART INTERNET PR IVATE LIMITED-SLICK ORGANICS PVT LTD-132 600155GN00014,shopping,,net_banking_transfer,12256.42
61b70ab9d8beac1599eb8c36,50200023535069,97522.86,60ec41ba55c00300382672d9,HDFC,Revenue-Mktplace,5eecc6d6449e4f7cfb1c2708,2021-11-22T00:00:00.000Z,NEFT CR-DEUT0797BGL-FLIPKART INTERNET PR IVATE LIMITED-SLICK ORGANICS PVT LTD-132 600166GN00105,shopping,,net_banking_transfer,10549.61
61b70abad8beac1599eb8c3d,50200023535069,2597522.86,60ec41ba55c00300382672d9,HDFC,Internal Transfers,5eecc6d6449e4f7cfb1c2708,2021-11-22T00:00:00.000Z,IB FUNDS TRANSFER CR-50200035187206 -SL ICK ORGANICS PVT LTD,insurance,,Other,2500000
61b70abbd8beac1599eb8c40,50200023535069,2097522.86,60ec41ba55c00300382672d9,HDFC,Marketing Expense,5eecc6d6449e4f7cfb1c2708,2021-11-22T00:00:00.000Z,NEFT DR-CITI0000006-FACEBOOK INDIA ONLIN,,,net_banking_transfer,-500000
61b70abcd8beac1599eb8c47,50200023535069,1985742.86,60ec41ba55c00300382672d9,HDFC,direct expenses,5eecc6d6449e4f7cfb1c2708,2021-11-22T00:00:00.000Z,"NEFT DR-DBSS0IN0811-SARANSH KULKARNI-NET BANK, MUM-N326211721287862-111780",,,net_banking_transfer,-111780
61b70abdd8beac1599eb8c4d,50200023535069,1485742.86,60ec41ba55c00300382672d9,HDFC,direct expenses,5eecc6d6449e4f7cfb1c2708,2021-11-22T00:00:00.000Z,"NEFT DR-YESB0000551-VISTTA COSMETICS-NET BANK, MUM-N326211721306703-500000",,,net_banking_transfer,-500000
61b70abed8beac1599eb8c50,50200023535069,1422742.86,60ec41ba55c00300382672d9,HDFC,direct expenses,5eecc6d6449e4f7cfb1c2708,2021-11-22T00:00:00.000Z,"NEFT DR-UBIN0531855-MOHANISH KOTHARI-NET BANK, MUM-N326211721288766-63000",,,net_banking_transfer,-63000
61b70abfd8beac1599eb8c56,50200023535069,1322742.86,60ec41ba55c00300382672d9,HDFC,direct expenses,5eecc6d6449e4f7cfb1c2708,2021-11-22T00:00:00.000Z,"NEFT DR-PYTM0123456-PAYTM-NETBANK, MUM-N 326211721288797-100000",ewallet,,net_banking_transfer,-100000
61b70ac0d8beac1599eb8c5b,50200023535069,1301354.86,60ec41ba55c00300382672d9,HDFC,direct expenses,5eecc6d6449e4f7cfb1c2708,2021-11-22T00:00:00.000Z,"NEFT DR-ICIC0000021-AKHILESH DIXIT-NETBA NK, MUM-N326211721310076-21388",,,net_banking_transfer,-21388
61b70ac1d8beac1599eb8c60,50200023535069,1201354.86,60ec41ba55c00300382672d9,HDFC,direct expenses,5eecc6d6449e4f7cfb1c2708,2021-11-22T00:00:00.000Z,"NEFT DR-INDB0000333-NOASTRIX PRIVATE LIM ITED-NETBANK, MUM-N326211721310218-10000 0",,,net_banking_transfer,-100000
61b70ac2d8beac1599eb8c66,50200023535069,1101354.86,60ec41ba55c00300382672d9,HDFC,agency/vendor expense,5eecc6d6449e4f7cfb1c2708,2021-11-22T00:00:00.000Z,"NEFT DR-KKBK0000298-ADMITAD MEDIA PRIVAT E LIMITED-NETBANK, MUM-N326211721315369- 100000",loans,lender_transaction,net_banking_transfer,-100000
61b70ac3d8beac1599eb8c75,50200023535069,985354.86,60ec41ba55c00300382672d9,HDFC,direct expenses,5eecc6d6449e4f7cfb1c2708,2021-11-22T00:00:00.000Z,"NEFT DR-UTIB0000514-NATS ASSOCIATES-NETB ANK, MUM-N326211721425917-116000",,,net_banking_transfer,-116000
61b70ac4d8beac1599eb8c7f,50200023535069,385354.86,60ec41ba55c00300382672d9,HDFC,direct expenses,5eecc6d6449e4f7cfb1c2708,2021-11-22T00:00:00.000Z,"NEFT DR-PYTM0123456-PAYTM-NETBANK, MUM-N 326211721480729-600000",ewallet,,net_banking_transfer,-600000
61b70ac5d8beac1599eb8c90,50200023535069,385264.97,60ec41ba55c00300382672d9,HDFC,bank charges,5eecc6d6449e4f7cfb1c2708,2021-11-22T00:00:00.000Z,.DC INTL POS TXN MARKUP+ST 011121 021121 -CDT2130806383839,,,international_transaction_arbitrage,-89.89
61b70ac6d8beac1599eb8c9f,50200023535069,35264.97,60ec41ba55c00300382672d9,HDFC,direct expenses,5eecc6d6449e4f7cfb1c2708,2021-11-22T00:00:00.000Z,"NEFT DR-KKBK0000180-VEDIC COSMECEUTICALS PVT LTD-NETBANK, MUM-N326211721486211-3 50000",,,net_banking_transfer,-350000
61b70ac7d8beac1599eb8cb0,50200023535069,1035264.97,60ec41ba55c00300382672d9,HDFC,Internal Transfers,5eecc6d6449e4f7cfb1c2708,2021-11-22T00:00:00.000Z,IB FUNDS TRANSFER CR-50200035187206 -SL ICK ORGANICS PVT LTD,insurance,,Other,1000000
61b70ac9d8beac1599eb8cba,50200023535069,810264.97,60ec41ba55c00300382672d9,HDFC,direct expenses,5eecc6d6449e4f7cfb1c2708,2021-11-22T00:00:00.000Z,"NEFT DR-SCBL0036025-DHRUV MADHOK-NETBANK , MUM-N326211721564823-225000",,,net_banking_transfer,-225000
61b70acad8beac1599eb8cc3,50200023535069,585264.97,60ec41ba55c00300382672d9,HDFC,direct expenses,5eecc6d6449e4f7cfb1c2708,2021-11-22T00:00:00.000Z,02711930004579-TPT-225000-DHRUV BHASIN,,,net_banking_transfer,-225000
61b70acbd8beac1599eb8cea,50200023535069,534864.97,60ec41ba55c00300382672d9,HDFC,direct expenses,5eecc6d6449e4f7cfb1c2708,2021-11-22T00:00:00.000Z,NEFT DR-KKBK0000173-MATRIX PRINTING SOLU,,,net_banking_transfer,-50400
61b70accd8beac1599eb8cf7,50200023535069,434864.97,60ec41ba55c00300382672d9,HDFC,direct expenses,5eecc6d6449e4f7cfb1c2708,2021-11-22T00:00:00.000Z,"NEFT DR-PYTM0123456-PAYTM-NETBANK, MUM-N 326211721590969-100000",ewallet,,net_banking_transfer,-100000
61b70acdd8beac1599eb8cfd,50200023535069,934864.97,60ec41ba55c00300382672d9,HDFC,Internal Transfers,5eecc6d6449e4f7cfb1c2708,2021-11-22T00:00:00.000Z,IB FUNDS TRANSFER CR-50200035187206 -SL ICK ORGANICS PVT LTD,insurance,,Other,500000
61b70aced8beac1599eb8d07,50200023535069,481031.97,60ec41ba55c00300382672d9,HDFC,direct expenses,5eecc6d6449e4f7cfb1c2708,2021-11-22T00:00:00.000Z,"NEFT DR-ICIC0006235-GLANCE GETVANTAGE ES CROW ACCOUNT 2-NETBANK, MUM-N32621172169 1201-453833",,,net_banking_transfer,-453833
61b70acfd8beac1599eb8d0e,50200023535069,103591.97,60ec41ba55c00300382672d9,HDFC,direct expenses,5eecc6d6449e4f7cfb1c2708,2021-11-22T00:00:00.000Z,05892560000649-TPT-377440-DECORPAC INDIA PRIVATE LIMITED,,,net_banking_transfer,-377440
61b70ad0d8beac1599eb8d14,50200023535069,95142.97,60ec41ba55c00300382672d9,HDFC,direct expenses,5eecc6d6449e4f7cfb1c2708,2021-11-22T00:00:00.000Z,"NEFT DR-ICIC0000399-RAPIDMILE BUSINESS S OLUTIONS PRIVATE LIM-NETBANK, MUM-N32621 1721727762-8449",loans,lender_transaction,net_banking_transfer,-8449
61b70ad1d8beac1599eb8d1b,50200023535069,70013.97,60ec41ba55c00300382672d9,HDFC,direct expenses,5eecc6d6449e4f7cfb1c2708,2021-11-22T00:00:00.000Z,00918630000430-TPT-25129-UNICOMMERCE ESO LUTIONS PRIVATE LIMITED,,,net_banking_transfer,-25129
61b70ad2d8beac1599eb8d23,50200023535069,68650.71,60ec41ba55c00300382672d9,HDFC,bank charges,5eecc6d6449e4f7cfb1c2708,2021-11-22T00:00:00.000Z,.DC INTL POS TXN MARKUP+ST 021121 041121 -CDT2130806383839,,,international_transaction_arbitrage,-1363.26
61b70ad3d8beac1599eb8d2b,50200023535069,74638.71,60ec41ba55c00300382672d9,HDFC,Transfer in/Revenue-other,5eecc6d6449e4f7cfb1c2708,2021-11-22T00:00:00.000Z,NEFT CR-KKBK0000958-INNOVATIVE RETAIL CO NCEPTS PRIVATE LTD-SLICK ORGANICS PVT LT D-KKBK213266525092,,,net_banking_transfer,5988
61b70ad4d8beac1599eb8d34,50200023535069,74184.02,60ec41ba55c00300382672d9,HDFC,bank charges,5eecc6d6449e4f7cfb1c2708,2021-11-22T00:00:00.000Z,.DC INTL POS TXN MARKUP+ST 041121 051121 -CDT2130806383839,,,international_transaction_arbitrage,-454.69
61b70ad5d8beac1599eb8d3c,50200023535069,76692.42,60ec41ba55c00300382672d9,HDFC,Revenue-COD,5eecc6d6449e4f7cfb1c2708,2021-11-22T00:00:00.000Z,NEFT CR-ICIC0000155-SHIPROCKET COD CRF I D 3409662-SLICK ORGANICS PVT LTD-CMS2249 124952,insurance,,net_banking_transfer,2508.4
61b70ad6d8beac1599eb8d43,50200023535069,77284.31,60ec41ba55c00300382672d9,HDFC,Revenue-PG-non-split,5eecc6d6449e4f7cfb1c2708,2021-11-22T00:00:00.000Z,NEFT CR-IDFB0010204-SEZZLE PAYMENTS PRIV ATE LIMITED-SLICK ORGANICS PRIVATE LIMIT ED-IDFBH21326464484,insurance,,net_banking_transfer,591.89
61b70ad7d8beac1599eb8d49,50200023535069,78906.41,60ec41ba55c00300382672d9,HDFC,Revenue-COD,5eecc6d6449e4f7cfb1c2708,2021-11-22T00:00:00.000Z,NEFT CR-ICIC0000155-SHIPROCKET COD CRF I D 3417880-SLICK ORGANICS PVT LTD-CMS2249 353805,insurance,,net_banking_transfer,1622.1
61b70ad8d8beac1599eb8d54,50200023535069,156295.53,60ec41ba55c00300382672d9,HDFC,Revenue-PG-non-split,5eecc6d6449e4f7cfb1c2708,2021-11-22T00:00:00.000Z,NEFT CR-KKBK0000958-BROKENTUSK TECHNOLOG,,,net_banking_transfer,77389.12
61b70ad9d8beac1599eb8d5c,50200023535069,249127.53,60ec41ba55c00300382672d9,HDFC,Revenue-COD,5eecc6d6449e4f7cfb1c2708,2021-11-22T00:00:00.000Z,NEFT CR-KKBK0000958-PICKRR TECHNOLOGIES PVT LTD-SLICKORGANICSPRIVATELIMITED-CMS3 262103750043,insurance,,net_banking_transfer,92832
61b70adad8beac1599eb8d61,50200023535069,1249127.53,60ec41ba55c00300382672d9,HDFC,Internal Transfers,5eecc6d6449e4f7cfb1c2708,2021-11-22T00:00:00.000Z,IB FUNDS TRANSFER CR-50200035187206 -SL ICK ORGANICS PVT LTD,insurance,,Other,1000000
61b70adbd8beac1599eb8d66,50200023535069,1267763.85,60ec41ba55c00300382672d9,HDFC,Revenue-PG-non-split,5eecc6d6449e4f7cfb1c2708,2021-11-23T00:00:00.000Z,IMPS-132704170455-PAYTM PAYMENTS SERVI-P YTM-XXXXXXXXXX0008-ALL202111232168200003 30830668628,ewallet,,net_banking_transfer,18636.32
61b70adcd8beac1599eb8d6b,50200023535069,1232763.85,60ec41ba55c00300382672d9,HDFC,Tax,5eecc6d6449e4f7cfb1c2708,2021-11-23T00:00:00.000Z,GST/BANK REFERENCE NO: R2132730749051/CI N NO: HDFC21110700241594,,,Other,-35000
61b70addd8beac1599eb8d71,50200023535069,1383415.19,60ec41ba55c00300382672d9,HDFC,Revenue-Mktplace,5eecc6d6449e4f7cfb1c2708,2021-11-23T00:00:00.000Z,NEFT CR-DEUT0797BGL-AMAZON PAY (INDIA) P RIVATE LIMITED-SLICK ORGANICS PVT LTD-13 2700111GN00101,shopping,,net_banking_transfer,150651.34
61b70aded8beac1599eb8d76,50200023535069,1333415.19,60ec41ba55c00300382672d9,HDFC,Marketing Expense,5eecc6d6449e4f7cfb1c2708,2021-11-23T00:00:00.000Z,POS 514834XXXXXX9486 GOOGLE ADS,,,debit_card,-50000
61b70adfd8beac1599eb8d7d,50200023535069,4333415.19,60ec41ba55c00300382672d9,HDFC,Internal Transfers,5eecc6d6449e4f7cfb1c2708,2021-11-23T00:00:00.000Z,IB FUNDS TRANSFER CR-50200035187206 -SL ICK ORGANICS PVT LTD,insurance,,Other,3000000
61b70ae0d8beac1599eb8d85,50200023535069,1093415.19,60ec41ba55c00300382672d9,HDFC,direct expenses,5eecc6d6449e4f7cfb1c2708,2021-11-23T00:00:00.000Z,"NEFT DR-UTIB0000371-TAPASEE PANNU-NETBAN K, MUM-N327211722686111-3240000",,,net_banking_transfer,-3240000
61b70ae1d8beac1599eb8d89,50200023535069,993415.19,60ec41ba55c00300382672d9,HDFC,direct expenses,5eecc6d6449e4f7cfb1c2708,2021-11-23T00:00:00.000Z,"NEFT DR-INDB0000148-ACQUISORY INDIA CONS ULTING PVT LTD-NETBANK, MUM-N32721172269 8881-100000",,,net_banking_transfer,-100000
61b70ae2d8beac1599eb8d8f,50200023535069,980415.19,60ec41ba55c00300382672d9,HDFC,direct expenses,5eecc6d6449e4f7cfb1c2708,2021-11-23T00:00:00.000Z,"NEFT DR-ICIC0006956-LAKSHAY CARRYING COR PORATION-NETBANK, MUM-N327211722709998-1 3000",,,net_banking_transfer,-13000
61b70ae3d8beac1599eb8d96,50200023535069,980252.81,60ec41ba55c00300382672d9,HDFC,direct expenses,5eecc6d6449e4f7cfb1c2708,2021-11-23T00:00:00.000Z,POS 514834XXXXXX9486 AMZN AD TJQHL75V,,,debit_card,-162.38
61b70ae4d8beac1599eb8d9b,50200023535069,480252.81,60ec41ba55c00300382672d9,HDFC,direct expenses,5eecc6d6449e4f7cfb1c2708,2021-11-23T00:00:00.000Z,"NEFT DR-ICIC0000369-BO INTERNATIONAL-NET BANK, MUM-N327211722782155-500000",,,net_banking_transfer,-500000
61b70ae5d8beac1599eb8da1,50200023535069,386094.81,60ec41ba55c00300382672d9,HDFC,direct expenses,5eecc6d6449e4f7cfb1c2708,2021-11-23T00:00:00.000Z,NEFT DR-CITI0000002-OMG NETWORK INDIA PR,,,net_banking_transfer,-94158
61b70ae6d8beac1599eb8da6,50200023535069,186094.81,60ec41ba55c00300382672d9,HDFC,direct expenses,5eecc6d6449e4f7cfb1c2708,2021-11-23T00:00:00.000Z,"NEFT DR-PUNB0642000-UFLEX LIMITED-NETBAN K, MUM-N327211722829058-200000",loans,lender_transaction,net_banking_transfer,-200000
61b70ae7d8beac1599eb8dad,50200023535069,1186094.81,60ec41ba55c00300382672d9,HDFC,Internal Transfers,5eecc6d6449e4f7cfb1c2708,2021-11-23T00:00:00.000Z,IB FUNDS TRANSFER CR-50200035187206 -SL ICK ORGANICS PVT LTD,insurance,,Other,1000000
61b70ae8d8beac1599eb8db2,50200023535069,1051257.81,60ec41ba55c00300382672d9,HDFC,direct expenses,5eecc6d6449e4f7cfb1c2708,2021-11-23T00:00:00.000Z,"NEFT DR-PUNB0100110-KRAUTER HEALTHCARE L TD-NETBANK, MUM-N327211722878097-134837",,,net_banking_transfer,-134837
61b70ae9d8beac1599eb8db8,50200023535069,411011.81,60ec41ba55c00300382672d9,HDFC,direct expenses,5eecc6d6449e4f7cfb1c2708,2021-11-23T00:00:00.000Z,"NEFT DR-PUNB0100110-KRAUTER HEALTHCARE L TD-NETBANK, MUM-N327211722883747-640246",,,net_banking_transfer,-640246
61b70aead8beac1599eb8dbd,50200023535069,1411011.81,60ec41ba55c00300382672d9,HDFC,Internal Transfers,5eecc6d6449e4f7cfb1c2708,2021-11-23T00:00:00.000Z,IB FUNDS TRANSFER CR-50200035187206 -SL ICK ORGANICS PVT LTD,insurance,,Other,1000000
61b70aebd8beac1599eb8dcc,50200023535069,1876151.58,60ec41ba55c00300382672d9,HDFC,Revenue-Mktplace,5eecc6d6449e4f7cfb1c2708,2021-11-23T00:00:00.000Z,NEFT CR-HSBC0110004-CLOUDTAIL INDIA PRIV ATE LIMITED-SLICK ORGANICS PRIVATE LIMIT ED-HSBCN21327708930,,,net_banking_transfer,465139.77
61b70aecd8beac1599eb8dd3,50200023535069,1839101.03,60ec41ba55c00300382672d9,HDFC,direct expenses,5eecc6d6449e4f7cfb1c2708,2021-11-23T00:00:00.000Z,POS 514834XXXXXX9486 AMZN AD TR95V0H3,,,debit_card,-37050.55
61b70aedd8beac1599eb8dd8,50200023535069,1873997.33,60ec41ba55c00300382672d9,HDFC,Revenue-PG-non-split,5eecc6d6449e4f7cfb1c2708,2021-11-23T00:00:00.000Z,NEFT CR-KKBK0000958-BROKENTUSK TECHNOLOG IES PRIVATE LIMITED-SLICK ORGANICS PRIVA TE LIMITED-KKBK213276803864,,,net_banking_transfer,34896.3
61b70aeed8beac1599eb8dde,50200023535069,1874016.39,60ec41ba55c00300382672d9,HDFC,Revenue-Mktplace,5eecc6d6449e4f7cfb1c2708,2021-11-23T00:00:00.000Z,NEFT CR-ICIC0000105-MANASH LIFESTYLE PRI VATE LIMITED NO-SLICK ORGANICS PRIVATE L IMITED MP G-ICIJ213270005765,shopping,,net_banking_transfer,19.06
61b70aefd8beac1599eb8de3,50200023535069,1874323.52,60ec41ba55c00300382672d9,HDFC,Revenue-Mktplace,5eecc6d6449e4f7cfb1c2708,2021-11-23T00:00:00.000Z,NEFT CR-ICIC0000105-MANASH LIFESTYLE PRI VATE LIMITED NO-SLICK ORGANICS PRIVATE L IMITED BANG-ICIJ213270005772,shopping,,net_banking_transfer,307.13
61b70af0d8beac1599eb8de9,50200023535069,1874835.9,60ec41ba55c00300382672d9,HDFC,Revenue-Mktplace,5eecc6d6449e4f7cfb1c2708,2021-11-23T00:00:00.000Z,NEFT CR-ICIC0000105-MANASH LIFESTYLE PRI VATE LIMITED NO-SLICK ORGANICS PRIVATE L IMITED HYD-ICIJ213270005770,shopping,,net_banking_transfer,512.38
61b70af1d8beac1599eb8df5,50200023535069,1877240.91,60ec41ba55c00300382672d9,HDFC,Revenue-Mktplace,5eecc6d6449e4f7cfb1c2708,2021-11-23T00:00:00.000Z,NEFT CR-ICIC0000105-MANASH LIFESTYLE PRI VATE LIMITED NO-SLICK ORGANICS PRIVATE L IMITED MP M-ICIJ213270005767,shopping,,net_banking_transfer,2405.01
61b70af2d8beac1599eb8dfa,50200023535069,1877671.91,60ec41ba55c00300382672d9,HDFC,Revenue-Mktplace,5eecc6d6449e4f7cfb1c2708,2021-11-23T00:00:00.000Z,NEFT CR-ICIC0000105-MANASH LIFESTYLE PRI,shopping,,net_banking_transfer,431
61b70af3d8beac1599eb8e00,50200023535069,1885871.48,60ec41ba55c00300382672d9,HDFC,Revenue-PG-non-split,5eecc6d6449e4f7cfb1c2708,2021-11-23T00:00:00.000Z,NEFT CR-IDFB0010204-SEZZLE PAYMENTS PRIV ATE LIMITED-SLICK ORGANICS PRIVATE LIMIT ED-IDFBH21327528740,insurance,,net_banking_transfer,8199.57
61b70af4d8beac1599eb8e06,50200023535069,2368707.76,60ec41ba55c00300382672d9,HDFC,Revenue-Mktplace,5eecc6d6449e4f7cfb1c2708,2021-11-23T00:00:00.000Z,NEFT CR-KKBK0000958-NYKAA E RETAIL PRIVA TE LIMITED NYKAA-SLICK ORGANICS PVT LTD- KKBK213276820061,insurance,,net_banking_transfer,482836.28
61b70af5d8beac1599eb8e0c,50200023535069,4001428.76,60ec41ba55c00300382672d9,HDFC,Revenue-Mktplace,5eecc6d6449e4f7cfb1c2708,2021-11-23T00:00:00.000Z,NEFT CR-KKBK0000958-NYKAA E RETAIL PRIVA TE LIMITED NYKAA-SLICK ORGANICS PVT LTD- KKBK213276820253,insurance,,net_banking_transfer,1632721
61b70af6d8beac1599eb8e18,50200023535069,4004854.38,60ec41ba55c00300382672d9,HDFC,Revenue-PG-non-split,5eecc6d6449e4f7cfb1c2708,2021-11-24T00:00:00.000Z,UPI-PAYTM-PPSL-PAYOUTS@PAYTM-PYTM0123456 -132822059357-ALL202111242168200,ewallet,,upi,3425.62
61b70af7d8beac1599eb8e1b,50200023535069,3604854.38,60ec41ba55c00300382672d9,HDFC,direct expenses,5eecc6d6449e4f7cfb1c2708,2021-11-24T00:00:00.000Z,"NEFT DR-PYTM0123456-PAYTM-NETBANK, MUM-N 328211723983738-400000",ewallet,,net_banking_transfer,-400000
61b70af8d8beac1599eb8e23,50200023535069,3074854.38,60ec41ba55c00300382672d9,HDFC,direct expenses,5eecc6d6449e4f7cfb1c2708,2021-11-24T00:00:00.000Z,"NEFT DR-PUNB0100110-KRAUTER HEALTHCARE L TD-NETBANK, MUM-N328211724019152-530000",,,net_banking_transfer,-530000
61b70af9d8beac1599eb8e27,50200023535069,2724854.38,60ec41ba55c00300382672d9,HDFC,direct expenses,5eecc6d6449e4f7cfb1c2708,2021-11-24T00:00:00.000Z,57500000443889-TPT-350000-WEBKLIPPER TEC HNOLOGIES PRIVATE LIMITED,,,net_banking_transfer,-350000
61b70afad8beac1599eb8e2b,50200023535069,2616854.38,60ec41ba55c00300382672d9,HDFC,direct expenses,5eecc6d6449e4f7cfb1c2708,2021-11-24T00:00:00.000Z,"NEFT DR-SCBL0036031-PR PUNDIT PUBLIC REL ATIONS PRIVATE LIMIT-NETBANK, MUM-N32821 1724027577-108000",insurance,,net_banking_transfer,-108000
61b70afbd8beac1599eb8e32,50200023535069,2557590.38,60ec41ba55c00300382672d9,HDFC,agency/vendor expense,5eecc6d6449e4f7cfb1c2708,2021-11-24T00:00:00.000Z,"NEFT DR-IDFB0021001-CLIKCONIK DIGITAL ME DIA PRIVATE LIMITED-NETBANK, MUM-N328211 724035694-59264",,,net_banking_transfer,-59264
61b70afcd8beac1599eb8e37,50200023535069,2522083.38,60ec41ba55c00300382672d9,HDFC,direct expenses,5eecc6d6449e4f7cfb1c2708,2021-11-24T00:00:00.000Z,"NEFT DR-ICIC0003374-SIDDHARTH KANOJIA-NE TBANK, MUM-N328211724023355-35507",,,net_banking_transfer,-35507
61b70afdd8beac1599eb8e3d,50200023535069,2323625.38,60ec41ba55c00300382672d9,HDFC,direct expenses,5eecc6d6449e4f7cfb1c2708,2021-11-24T00:00:00.000Z,"NEFT DR-SRCB0000281-3D TECHNOPACK PRIVAT E LIMITED-NETBANK, MUM-N328211724049153- 198458",,,net_banking_transfer,-198458
61b70afed8beac1599eb8e43,50200023535069,2382889.38,60ec41ba55c00300382672d9,HDFC,Adjustments/Reversal,5eecc6d6449e4f7cfb1c2708,2021-11-24T00:00:00.000Z,NEFT RETURN-ACCOUNT CLOSED-CLIKCONIK DIG ITAL MEDIA PRIVATE LIMITED-RETNH21328565 444,,neft_return,refund,59264
61b70affd8beac1599eb8e48,50200023535069,2395629.2,60ec41ba55c00300382672d9,HDFC,Revenue-Mktplace,5eecc6d6449e4f7cfb1c2708,2021-11-24T00:00:00.000Z,NEFT CR-HSBC0400002-AMAZON SERVICES LLC-,shopping,,net_banking_transfer,12739.82
61b70b00d8beac1599eb8e4f,50200023535069,2295629.2,60ec41ba55c00300382672d9,HDFC,direct expenses,5eecc6d6449e4f7cfb1c2708,2021-11-24T00:00:00.000Z,"NEFT DR-PYTM0123456-PAYTM-NETBANK, MUM-N 328211724196869-1000000",ewallet,,net_banking_transfer,-100000
61b70b01d8beac1599eb8e52,50200023535069,2318505.76,60ec41ba55c00300382672d9,HDFC,Revenue-Mktplace,5eecc6d6449e4f7cfb1c2708,2021-11-24T00:00:00.000Z,NEFT CR-DEUT0797BGL-FLIPKART INTERNET PR IVATE LIMITED-SLICK ORGANICS PVT LTD-132 800822GN00091,shopping,,net_banking_transfer,22876.56
61b70b02d8beac1599eb8e59,50200023535069,2346740.18,60ec41ba55c00300382672d9,HDFC,Revenue-Mktplace,5eecc6d6449e4f7cfb1c2708,2021-11-24T00:00:00.000Z,NEFT CR-DEUT0797BGL-FLIPKART INTERNET PR IVATE LIMITED-SLICK ORGANICS PVT LTD-132 800826GN00050,shopping,,net_banking_transfer,28234.42
61b70b03d8beac1599eb8e5e,50200023535069,3891352.43,60ec41ba55c00300382672d9,HDFC,Revenue-Mktplace,5eecc6d6449e4f7cfb1c2708,2021-11-24T00:00:00.000Z,NEFT CR-HSBC0110004-CLOUDTAIL INDIA PRIV ATE LIMITED-SLICK ORGANICS PRIVATE LIMIT ED-HSBCN21328859316,,,net_banking_transfer,1544612.25
61b70b04d8beac1599eb8e62,50200023535069,3927042.85,60ec41ba55c00300382672d9,HDFC,Revenue-UPI,5eecc6d6449e4f7cfb1c2708,2021-11-24T00:00:00.000Z,UPI-GOKWIK-GOKWIK@YESBANK-YESB0000340-13 2821224132-PAYOUT FOR NOVEMBE,,,upi,35690.42
61b70b05d8beac1599eb8e69,50200023535069,3927808.3,60ec41ba55c00300382672d9,HDFC,Revenue-PG-non-split,5eecc6d6449e4f7cfb1c2708,2021-11-24T00:00:00.000Z,NEFT CR-KKBK0000958-BROKENTUSK TECHNOLOG IES PRIVATE LIMITED-SLICK ORGANICS PRIVA TE LIMITED-KKBK213287011573,,,net_banking_transfer,765.45
61b70b06d8beac1599eb8e6e,50200023535069,3928064.12,60ec41ba55c00300382672d9,HDFC,Revenue-Mktplace,5eecc6d6449e4f7cfb1c2708,2021-11-24T00:00:00.000Z,NEFT CR-ICIC0000105-MANASH LIFESTYLE PRI VATE LIMITED NO-SLICK ORGANICS PRIVATE L IMITED HYD-ICIJ213280001297,shopping,,net_banking_transfer,255.82
61b70b07d8beac1599eb8e73,50200023535069,3928942.26,60ec41ba55c00300382672d9,HDFC,Revenue-Mktplace,5eecc6d6449e4f7cfb1c2708,2021-11-24T00:00:00.000Z,NEFT CR-ICIC0000105-MANASH LIFESTYLE PRI VATE LIMITED NO-SLICK ORGANICS PRIVATE L IMITED MP G-ICIJ213280001294,shopping,,net_banking_transfer,878.14
61b70b08d8beac1599eb8e77,50200023535069,3930836.34,60ec41ba55c00300382672d9,HDFC,Revenue-Mktplace,5eecc6d6449e4f7cfb1c2708,2021-11-24T00:00:00.000Z,NEFT CR-ICIC0000105-MANASH LIFESTYLE PRI VATE LIMITED NO-SLICK ORGANICS PRIVATE L IMITED MP M-ICIJ213280001296,shopping,,net_banking_transfer,1894.08
61b70b09d8beac1599eb8e7c,50200023535069,3934248.69,60ec41ba55c00300382672d9,HDFC,Transfer in/Revenue-other,5eecc6d6449e4f7cfb1c2708,2021-11-24T00:00:00.000Z,4060007285-24 11 2021-HDFAZCUR1,,,Other,3412.35
61b70b0ad8beac1599eb8e83,50200023535069,2934248.69,60ec41ba55c00300382672d9,HDFC,direct expenses,5eecc6d6449e4f7cfb1c2708,2021-11-24T00:00:00.000Z,"NEFT DR-PYTM0123456-PAYTM-NETBANK, MUM-N 328211724770055-1000000",ewallet,,net_banking_transfer,-1000000
61b70b0bd8beac1599eb8e86,50200023535069,2634248.69,60ec41ba55c00300382672d9,HDFC,direct expenses,5eecc6d6449e4f7cfb1c2708,2021-11-24T00:00:00.000Z,"NEFT DR-YESB0000162-VINAY REDDY-NETBANK,",,,net_banking_transfer,-300000
61b70b0cd8beac1599eb8e8d,50200023535069,2636969.94,60ec41ba55c00300382672d9,HDFC,Revenue-PG-non-split,5eecc6d6449e4f7cfb1c2708,2021-11-24T00:00:00.000Z,NEFT CR-IDFB0010204-SEZZLE PAYMENTS PRIV ATE LIMITED-SLICK ORGANICS PRIVATE LIMIT ED-IDFBH21328598950,insurance,,net_banking_transfer,2721.25
61b70b0dd8beac1599eb8e91,50200023535069,2505955.94,60ec41ba55c00300382672d9,HDFC,direct expenses,5eecc6d6449e4f7cfb1c2708,2021-11-24T00:00:00.000Z,00921000075586-TPT-131014-ROET BINDRA,,,net_banking_transfer,-131014
61b70b0ed8beac1599eb8e96,50200023535069,2530420.94,60ec41ba55c00300382672d9,HDFC,Revenue-Mktplace,5eecc6d6449e4f7cfb1c2708,2021-11-24T00:00:00.000Z,NEFT CR-SCBL0036001-M/S DREAMPLUG TECHNO -SLICK ORGANICS PRIVATE LIMITEDSLICK-SIN 31436Q0026135,insurance,,net_banking_transfer,24465
61b70b0fd8beac1599eb8e9c,50200023535069,2493412.1,60ec41ba55c00300382672d9,HDFC,direct expenses,5eecc6d6449e4f7cfb1c2708,2021-11-25T00:00:00.000Z,POS 514834XXXXXX9486 AMZN AD TR95V0H3,,,debit_card,-37008.84
61b70b10d8beac1599eb8ea2,50200023535069,2506180.31,60ec41ba55c00300382672d9,HDFC,Revenue-PG-non-split,5eecc6d6449e4f7cfb1c2708,2021-11-25T00:00:00.000Z,UPI-PAYTM-PPSL-PAYOUTS@PAYTM-PYTM0123456 -132967392114-ALL202111252168200,ewallet,,upi,12768.21
61b70b11d8beac1599eb8ea7,50200023535069,2006180.31,60ec41ba55c00300382672d9,HDFC,direct expenses,5eecc6d6449e4f7cfb1c2708,2021-11-25T00:00:00.000Z,"NEFT DR-SRCB0000281-3D TECHNOPACK PRIVAT E LIMITED-NETBANK, MUM-N329211725215034- 500000",,,net_banking_transfer,-500000
61b70b12d8beac1599eb8eab,50200023535069,2007494.35,60ec41ba55c00300382672d9,HDFC,Revenue-PG-split enabled,5eecc6d6449e4f7cfb1c2708,2021-11-25T00:00:00.000Z,NEFT CR-UTIB0001506-RAZORPAY SOFTWARE PR IVATE LIMITED-SLICK ORGANICS PVT LITD-AX ISCN0106735367,insurance,,net_banking_transfer,1314.04
61b70b13d8beac1599eb8eb0,50200023535069,1982494.35,60ec41ba55c00300382672d9,HDFC,direct expenses,5eecc6d6449e4f7cfb1c2708,2021-11-25T00:00:00.000Z,POS 514834XXXXXX9486 FLIPKART,shopping,,debit_card,-25000
61b70b14d8beac1599eb8ec0,50200023535069,1836764.35,60ec41ba55c00300382672d9,HDFC,direct expenses,5eecc6d6449e4f7cfb1c2708,2021-11-25T00:00:00.000Z,"NEFT DR-KKBK0000180-VEDIC COSMECEUTICALS PVT LTD-NETBANK, MUM-N329211725453326-1 45730",,,net_banking_transfer,-145730
61b70b15d8beac1599eb8ec5,50200023535069,1838297.06,60ec41ba55c00300382672d9,HDFC,Revenue-Mktplace,5eecc6d6449e4f7cfb1c2708,2021-11-25T00:00:00.000Z,NEFT CR-ICIC0000105-MANASH LIFESTYLE PRI VATE LIMITED NO-SLICK ORGANICS PRIVATE L IMITED MP G-ICIJ213290002256,shopping,,net_banking_transfer,1532.71
61b70b16d8beac1599eb8ecb,50200023535069,1838552.88,60ec41ba55c00300382672d9,HDFC,Revenue-Mktplace,5eecc6d6449e4f7cfb1c2708,2021-11-25T00:00:00.000Z,NEFT CR-ICIC0000105-MANASH LIFESTYLE PRI VATE LIMITED NO-SLICK ORGANICS PRIVATE L IMITED BANG-ICIJ213290000295,shopping,,net_banking_transfer,255.82
61b70b17d8beac1599eb8ed0,50200023535069,4434716.49,60ec41ba55c00300382672d9,HDFC,Revenue-Mktplace,5eecc6d6449e4f7cfb1c2708,2021-11-25T00:00:00.000Z,NEFT CR-HSBC0110004-CLOUDTAIL INDIA PRIV ATE LIMITED-SLICK ORGANICS PRIVATE LIMIT ED-HSBCN21329058777,,,net_banking_transfer,2596163.61
61b70b18d8beac1599eb8ed4,50200023535069,3934716.49,60ec41ba55c00300382672d9,HDFC,direct expenses,5eecc6d6449e4f7cfb1c2708,2021-11-25T00:00:00.000Z,"NEFT DR-YESB0000551-VISTTA COSMETICS-NET BANK, MUM-N329211725697761-500000",,,net_banking_transfer,-500000
61b70b19d8beac1599eb8eda,50200023535069,3827866.49,60ec41ba55c00300382672d9,HDFC,direct expenses,5eecc6d6449e4f7cfb1c2708,2021-11-25T00:00:00.000Z,NEFT DR-IDFB0021001-CLICKONIK DIGITAL ME,insurance,,net_banking_transfer,-106850
61b70b1ad8beac1599eb8ee0,50200023535069,3853485.15,60ec41ba55c00300382672d9,HDFC,Revenue-UPI,5eecc6d6449e4f7cfb1c2708,2021-11-25T00:00:00.000Z,UPI-GOKWIK-GOKWIK@YESBANK-YESB0000340-13 2922645861-PAYOUT FOR NOVEMBE,,,upi,25618.66
61b70b1bd8beac1599eb8ee6,50200023535069,3854940.88,60ec41ba55c00300382672d9,HDFC,Revenue-PG-non-split,5eecc6d6449e4f7cfb1c2708,2021-11-25T00:00:00.000Z,NEFT CR-IDFB0010204-SEZZLE PAYMENTS PRIV ATE LIMITED-SLICK ORGANICS PRIVATE LIMIT ED-IDFBH21329689511,insurance,,net_banking_transfer,1455.73
61b70b1cd8beac1599eb8eec,50200023535069,3855113.4,60ec41ba55c00300382672d9,HDFC,Revenue-PG-split enabled,5eecc6d6449e4f7cfb1c2708,2021-11-25T00:00:00.000Z,NEFT CR-UTIB0001506-RAZORPAY SOFTWARE PR IVATE LIMITED-SLICK ORGANICS PVT LITD-AX ISCN0106858177,insurance,,net_banking_transfer,172.52
61b70b1dd8beac1599eb8ef1,50200023535069,3860105.17,60ec41ba55c00300382672d9,HDFC,Revenue-PG-non-split,5eecc6d6449e4f7cfb1c2708,2021-11-26T00:00:00.000Z,UPI-PAYTM-PPSL-PAYOUTS@PAYTM-PYTM0123456 -133011840999-ALL202111262168200,ewallet,,upi,4991.77
61b70b1ed8beac1599eb8efa,50200023535069,3873866.01,60ec41ba55c00300382672d9,HDFC,Revenue-Mktplace,5eecc6d6449e4f7cfb1c2708,2021-11-26T00:00:00.000Z,NEFT CR-DEUT0797BGL-FLIPKART INTERNET PR IVATE LIMITED-SLICK ORGANICS PVT LTD-133 000193GN00265,shopping,,net_banking_transfer,13760.84
61b70b1fd8beac1599eb8efd,50200023535069,3874614.89,60ec41ba55c00300382672d9,HDFC,Revenue-Mktplace,5eecc6d6449e4f7cfb1c2708,2021-11-26T00:00:00.000Z,NEFT CR-DEUT0797BGL-FLIPKART INTERNET PR IVATE LIMITED-SLICK ORGANICS PVT LTD-133 000226GN00016,shopping,,net_banking_transfer,748.88
61b70b20d8beac1599eb8f04,50200023535069,3875620.7,60ec41ba55c00300382672d9,HDFC,Revenue-PG-split enabled,5eecc6d6449e4f7cfb1c2708,2021-11-26T00:00:00.000Z,NEFT CR-UTIB0001506-RAZORPAY SOFTWARE PR IVATE LIMITED-SLICK ORGANICS PVT LITD-AX ISCN0106929669,insurance,,net_banking_transfer,1005.81
61b70b21d8beac1599eb8f08,50200023535069,3275620.7,60ec41ba55c00300382672d9,HDFC,direct expenses,5eecc6d6449e4f7cfb1c2708,2021-11-26T00:00:00.000Z,"NEFT DR-SRCB0000281-3D TECHNOPACK PRIVAT E LIMITED-NETBANK, MUM-N330211726555721- 600000",,,net_banking_transfer,-600000
61b70b22d8beac1599eb8f0e,50200023535069,3269956.7,60ec41ba55c00300382672d9,HDFC,direct expenses,5eecc6d6449e4f7cfb1c2708,2021-11-26T00:00:00.000Z,50200043297657-TPT-5664-AIDC PRODUCTS IN DIA PRIVATE LIMITED,,,net_banking_transfer,-5664
61b70b23d8beac1599eb8f15,50200023535069,3259956.7,60ec41ba55c00300382672d9,HDFC,direct expenses,5eecc6d6449e4f7cfb1c2708,2021-11-26T00:00:00.000Z,"NEFT DR-ICIC0006956-LAKSHAY CARRYING COR PORATION-NETBANK, MUM-N330211726542483-1 0000",,,net_banking_transfer,-10000
61b70b24d8beac1599eb8f19,50200023535069,3268918.41,60ec41ba55c00300382672d9,HDFC,Revenue-Mktplace,5eecc6d6449e4f7cfb1c2708,2021-11-26T00:00:00.000Z,4060007179-TIMES INTERNET LIMITED NODAL,,,Other,8961.71
61b70b25d8beac1599eb8f1f,50200023535069,3269395.18,60ec41ba55c00300382672d9,HDFC,Transfer in/Revenue-other,5eecc6d6449e4f7cfb1c2708,2021-11-26T00:00:00.000Z,NEFT CR-ICIC0SF0002-ICICI BANK NODAL A-C,,,net_banking_transfer,476.77
61b70b26d8beac1599eb8f23,50200023535069,3260395.18,60ec41ba55c00300382672d9,HDFC,direct expenses,5eecc6d6449e4f7cfb1c2708,2021-11-26T00:00:00.000Z,"NEFT DR-ICIC0000021-AKHILESH DIXIT-NETBA NK, MUM-N330211726782892-9000",,,net_banking_transfer,-9000
61b70b27d8beac1599eb8f29,50200023535069,2923395.18,60ec41ba55c00300382672d9,HDFC,Tax,5eecc6d6449e4f7cfb1c2708,2021-11-26T00:00:00.000Z,051030826112115936- CBDT TAX,,,Other,-337000
61b70b28d8beac1599eb8f2f,50200023535069,2924478.56,60ec41ba55c00300382672d9,HDFC,Revenue-Mktplace,5eecc6d6449e4f7cfb1c2708,2021-11-26T00:00:00.000Z,NEFT CR-ICIC0000105-MANASH LIFESTYLE PRI VATE LIMITED NO-SLICK ORGANICS PRIVATE L IMITED MP G-ICIJ213300004529,shopping,,net_banking_transfer,1083.38
61b70b29d8beac1599eb8f32,50200023535069,2918225.67,60ec41ba55c00300382672d9,HDFC,direct expenses,5eecc6d6449e4f7cfb1c2708,2021-11-26T00:00:00.000Z,POS 514834XXXXXX9486 AMZN AD TJQHL75V,,,debit_card,-6252.89
61b70b2ad8beac1599eb8f39,50200023535069,2954701.67,60ec41ba55c00300382672d9,HDFC,Revenue-UPI,5eecc6d6449e4f7cfb1c2708,2021-11-26T00:00:00.000Z,UPI-GOKWIK-GOKWIK@YESBANK-YESB0000340-13 3024203614-PAYOUT FOR NOVEMBE,,,upi,36476
61b70b2bd8beac1599eb8f3c,50200023535069,2454701.67,60ec41ba55c00300382672d9,HDFC,direct expenses,5eecc6d6449e4f7cfb1c2708,2021-11-26T00:00:00.000Z,"NEFT DR-PYTM0123456-PAYTM-NETBANK, MUM-N 330211727344301-500000",ewallet,,net_banking_transfer,-500000
61b70b2cd8beac1599eb8f41,50200023535069,1351999.67,60ec41ba55c00300382672d9,HDFC,direct expenses,5eecc6d6449e4f7cfb1c2708,2021-11-26T00:00:00.000Z,05892560000649-TPT-1102702-DECORPAC INDI A PRIVATE LIMITED,,,net_banking_transfer,-1102702
61b70b2dd8beac1599eb8f49,50200023535069,1413696.67,60ec41ba55c00300382672d9,HDFC,Revenue-COD,5eecc6d6449e4f7cfb1c2708,2021-11-26T00:00:00.000Z,NEFT CR-KKBK0000958-PICKRR TECHNOLOGIES PVT LTD-SLICKORGANICSPRIVATELIMITED-CMS3 302103869267,insurance,,net_banking_transfer,61697
61b70b2ed8beac1599eb8f4d,50200023535069,1158696.67,60ec41ba55c00300382672d9,HDFC,SAAS/tech expense,5eecc6d6449e4f7cfb1c2708,2021-11-26T00:00:00.000Z,KQSX454NAR42FOWXCI/PAYUAMAZON,shopping,,Other,-255000
61b70b2fd8beac1599eb8f53,50200023535069,1229668.03,60ec41ba55c00300382672d9,HDFC,Revenue-PG-non-split,5eecc6d6449e4f7cfb1c2708,2021-11-27T00:00:00.000Z,IMPS-133104799330-PAYTM PAYMENTS SERVI-P YTM-XXXXXXXXXX0008-ALL202111272168200003 30830668628,ewallet,,net_banking_transfer,70971.36
61b70b30d8beac1599eb8f58,50200023535069,1409267.72,60ec41ba55c00300382672d9,HDFC,Revenue-UPI,5eecc6d6449e4f7cfb1c2708,2021-11-27T00:00:00.000Z,UPI-GOKWIK-GOKWIK@YESBANK-YESB0000340-13 3125475274-PAYOUT FOR NOVEMBE,,,upi,179599.69
61b70b31d8beac1599eb8f5f,50200023535069,1371765.97,60ec41ba55c00300382672d9,HDFC,direct expenses,5eecc6d6449e4f7cfb1c2708,2021-11-28T00:00:00.000Z,POS 514834XXXXXX9486 AMZN AD TR95V0H3,,,debit_card,-37501.75
61b70b32d8beac1599eb8f6e,50200023535069,1353770.91,60ec41ba55c00300382672d9,HDFC,direct expenses,5eecc6d6449e4f7cfb1c2708,2021-11-28T00:00:00.000Z,POS 514834XXXXXX9486 AMZN AD TJQHL75V,,,debit_card,-17995.06
61b70b33d8beac1599eb8f74,50200023535069,1367909.8,60ec41ba55c00300382672d9,HDFC,Revenue-PG-non-split,5eecc6d6449e4f7cfb1c2708,2021-11-28T00:00:00.000Z,IMPS-133204920803-PAYTM PAYMENTS SERVI-P YTM-XXXXXXXXXX0008-ALL202111282168200003 30830668628,ewallet,,net_banking_transfer,14138.89
61b70b34d8beac1599eb8f7b,50200023535069,1267909.8,60ec41ba55c00300382672d9,HDFC,direct expenses,5eecc6d6449e4f7cfb1c2708,2021-11-28T00:00:00.000Z,"NEFT DR-SCBL0036025-DHRUV MADHOK-NETBANK , MUM-N332211728378821-100000",,,net_banking_transfer,-100000
61b70b35d8beac1599eb8f7e,50200023535069,1167909.8,60ec41ba55c00300382672d9,HDFC,direct expenses,5eecc6d6449e4f7cfb1c2708,2021-11-28T00:00:00.000Z,"NEFT DR-UTIB0000514-NATS ASSOCIATES-NETB ANK, MUM-N332211728380102-100000",,,net_banking_transfer,-100000
61b70b36d8beac1599eb8f8b,50200023535069,942909.8,60ec41ba55c00300382672d9,HDFC,direct expenses,5eecc6d6449e4f7cfb1c2708,2021-11-28T00:00:00.000Z,02711930004579-TPT-225000-DHRUV BHASIN,,,net_banking_transfer,-225000
61b70b37d8beac1599eb8f90,50200023535069,981634.39,60ec41ba55c00300382672d9,HDFC,Revenue-UPI,5eecc6d6449e4f7cfb1c2708,2021-11-28T00:00:00.000Z,UPI-GOKWIK-GOKWIK@YESBANK-YESB0000340-13 3226747894-PAYOUT FOR NOVEMBE,,,upi,38724.59
61b70b38d8beac1599eb8f96,50200023535069,995468.45,60ec41ba55c00300382672d9,HDFC,Revenue-PG-non-split,5eecc6d6449e4f7cfb1c2708,2021-11-29T00:00:00.000Z,IMPS-133304978977-PAYTM PAYMENTS SERVI-P YTM-XXXXXXXXXX0008-ALL202111292168200003 30830668628,ewallet,,net_banking_transfer,13834.06
61b70b39d8beac1599eb8fa2,50200023535069,1009043.64,60ec41ba55c00300382672d9,HDFC,Revenue-Mktplace,5eecc6d6449e4f7cfb1c2708,2021-11-29T00:00:00.000Z,NEFT CR-DEUT0797BGL-FLIPKART INTERNET PR IVATE LIMITED-SLICK ORGANICS PVT LTD-133 300156GN00115,shopping,,net_banking_transfer,13575.19
61b70b3ad8beac1599eb8fa9,50200023535069,1018781.33,60ec41ba55c00300382672d9,HDFC,Revenue-Mktplace,5eecc6d6449e4f7cfb1c2708,2021-11-29T00:00:00.000Z,NEFT CR-DEUT0797BGL-FLIPKART INTERNET PR IVATE LIMITED-SLICK ORGANICS PVT LTD-133 300165GN00251,shopping,,net_banking_transfer,9737.69
61b70b3bd8beac1599eb8fad,50200023535069,553244.33,60ec41ba55c00300382672d9,HDFC,direct expenses,5eecc6d6449e4f7cfb1c2708,2021-11-29T00:00:00.000Z,"NEFT DR-KKBK0000180-VEDIC COSMECEUTICALS PVT LTD-NETBANK, MUM-N333211728615968-4 65538",,,net_banking_transfer,-465537
61b70b3cd8beac1599eb8fc2,50200023535069,555263.17,60ec41ba55c00300382672d9,HDFC,Transfer in/Revenue-other,5eecc6d6449e4f7cfb1c2708,2021-11-29T00:00:00.000Z,NEFT CR-UTIB0004405-WOOVLY INDIA PRIVATE LIMITED-SLICK ORGANICS PVT LTD-AXISP002 42544931,insurance,,net_banking_transfer,2018.84
61b70b3dd8beac1599eb8fd2,50200023535069,559783.66,60ec41ba55c00300382672d9,HDFC,Revenue-PG-split enabled,5eecc6d6449e4f7cfb1c2708,2021-11-29T00:00:00.000Z,NEFT CR-UTIB0001506-RAZORPAY SOFTWARE PR IVATE LIMITED-SLICK ORGANICS PVT LITD-AX ISCN0107298022,insurance,,net_banking_transfer,4520.49
61b70b3ed8beac1599eb8fe1,50200023535069,1559783.66,60ec41ba55c00300382672d9,HDFC,Internal Transfers,5eecc6d6449e4f7cfb1c2708,2021-11-29T00:00:00.000Z,IB FUNDS TRANSFER CR-50200035187206 -SL ICK ORGANICS PVT LTD,insurance,,Other,1000000
61b70b3fd8beac1599eb8ff0,50200023535069,559783.66,60ec41ba55c00300382672d9,HDFC,Marketing Expense,5eecc6d6449e4f7cfb1c2708,2021-11-29T00:00:00.000Z,"NEFT DR-CITI0000006-FACEBOOK INDIA ONLIN E SERVICES PVT LTD-NETBANK, MUM-N3332117 28663185-1000000",,,net_banking_transfer,-1000000
61b70b40d8beac1599eb901b,50200023535069,558249.81,60ec41ba55c00300382672d9,HDFC,bank charges,5eecc6d6449e4f7cfb1c2708,2021-11-29T00:00:00.000Z,.DC INTL POS TXN MARKUP+ST 071121 081121 -CDT2130806383839,,,international_transaction_arbitrage,-1533.85
61b70b41d8beac1599eb9026,50200023535069,557946.13,60ec41ba55c00300382672d9,HDFC,bank charges,5eecc6d6449e4f7cfb1c2708,2021-11-29T00:00:00.000Z,.DC INTL POS TXN MARKUP+ST 061121 091121 -CDT2130806383839,,,international_transaction_arbitrage,-303.68
61b70b42d8beac1599eb902f,50200023535069,560775.74,60ec41ba55c00300382672d9,HDFC,Revenue-PG-non-split,5eecc6d6449e4f7cfb1c2708,2021-11-29T00:00:00.000Z,NEFT CR-SCBL0036001-STRIPE INDIA PRIVATE,,,net_banking_transfer,2829.61
61b70b43d8beac1599eb903c,50200023535069,559229.01,60ec41ba55c00300382672d9,HDFC,bank charges,5eecc6d6449e4f7cfb1c2708,2021-11-29T00:00:00.000Z,.DC INTL POS TXN MARKUP+ST 091121 111121 -CDT2130806383839,,,international_transaction_arbitrage,-1546.73
61b70b44d8beac1599eb9042,50200023535069,557689.68,60ec41ba55c00300382672d9,HDFC,bank charges,5eecc6d6449e4f7cfb1c2708,2021-11-29T00:00:00.000Z,.DC INTL POS TXN MARKUP+ST 111121 131121 -CDT2130806383839,,,international_transaction_arbitrage,-1539.33
61b70b45d8beac1599eb9047,50200023535069,591675.34,60ec41ba55c00300382672d9,HDFC,Revenue-UPI,5eecc6d6449e4f7cfb1c2708,2021-11-29T00:00:00.000Z,UPI-GOKWIK-GOKWIK@YESBANK-YESB0000340-13 3328046000-PAYOUT FOR NOVEMBE,,,upi,33985.66
61b70b46d8beac1599eb9051,50200023535069,590132.33,60ec41ba55c00300382672d9,HDFC,bank charges,5eecc6d6449e4f7cfb1c2708,2021-11-29T00:00:00.000Z,.DC INTL POS TXN MARKUP+ST 161121 181121 -CDT2130806383839,,,international_transaction_arbitrage,-1543.01
61b70b47d8beac1599eb9058,50200023535069,590643.97,60ec41ba55c00300382672d9,HDFC,Revenue-Mktplace,5eecc6d6449e4f7cfb1c2708,2021-11-29T00:00:00.000Z,NEFT CR-ICIC0000105-MANASH LIFESTYLE PRI VATE LIMITED NO-SLICK ORGANICS PRIVATE L IMITED HYD-ICIJ213330001191,shopping,,net_banking_transfer,511.64
61b70b48d8beac1599eb905e,50200023535069,598177.83,60ec41ba55c00300382672d9,HDFC,Revenue-Mktplace,5eecc6d6449e4f7cfb1c2708,2021-11-29T00:00:00.000Z,NEFT CR-ICIC0000105-MANASH LIFESTYLE PRI VATE LIMITED NO-SLICK ORGANICS PRIVATE L IMITED MP M-ICIJ213330003187,shopping,,net_banking_transfer,7533.86
61b70b49d8beac1599eb9065,50200023535069,598726.11,60ec41ba55c00300382672d9,HDFC,Revenue-Mktplace,5eecc6d6449e4f7cfb1c2708,2021-11-29T00:00:00.000Z,NEFT CR-ICIC0000105-MANASH LIFESTYLE PRI VATE LIMITED NO-SLICK ORGANICS PRIVATE L IMITED MP G-ICIJ213330001189,shopping,,net_banking_transfer,548.28
61b70b4ad8beac1599eb906c,50200023535069,598984.47,60ec41ba55c00300382672d9,HDFC,Revenue-PG-non-split,5eecc6d6449e4f7cfb1c2708,2021-11-29T00:00:00.000Z,NEFT CR-IDFB0010204-SEZZLE PAYMENTS PRIV ATE LIMITED-SLICK ORGANICS PRIVATE LIMIT ED-IDFBH21333926506,insurance,,net_banking_transfer,258.36
61b70b4bd8beac1599eb9073,50200023535069,600268.64,60ec41ba55c00300382672d9,HDFC,Revenue-PG-split enabled,5eecc6d6449e4f7cfb1c2708,2021-11-29T00:00:00.000Z,NEFT CR-UTIB0001506-RAZORPAY SOFTWARE PR IVATE LIMITED-SLICK ORGANICS PVT LITD-AX ISCN0107503525,insurance,,net_banking_transfer,1284.17
61b70b4cd8beac1599eb9079,50200023535069,576208.82,60ec41ba55c00300382672d9,HDFC,direct expenses,5eecc6d6449e4f7cfb1c2708,2021-11-30T00:00:00.000Z,POS 514834XXXXXX9486 AMZN AD TJQHL75V,,,debit_card,-24059.82
61b70b4dd8beac1599eb9082,50200023535069,538824.56,60ec41ba55c00300382672d9,HDFC,direct expenses,5eecc6d6449e4f7cfb1c2708,2021-11-30T00:00:00.000Z,POS 514834XXXXXX9486 AMZN AD TR95V0H3,,,debit_card,-37384.26
61b70b4ed8beac1599eb908b,50200023535069,555241.85,60ec41ba55c00300382672d9,HDFC,Revenue-PG-non-split,5eecc6d6449e4f7cfb1c2708,2021-11-30T00:00:00.000Z,IMPS-133404088127-PAYTM PAYMENTS SERVI-P YTM-XXXXXXXXXX0008-ALL202111302168200003 30830668628,ewallet,,net_banking_transfer,16417.29
61b70b4fd8beac1599eb9091,50200023535069,599615.72,60ec41ba55c00300382672d9,HDFC,Revenue-Mktplace,5eecc6d6449e4f7cfb1c2708,2021-11-30T00:00:00.000Z,IMPS-133405089138-AMAZON SELLER SERVIC-H SBC-XXXXXXXX6004-KWHLP1IMV7SJ91UHSLICK O RGANICS PVT LTD,shopping,,net_banking_transfer,44373.87
61b70b50d8beac1599eb909d,50200023535069,702766.23,60ec41ba55c00300382672d9,HDFC,Revenue-Mktplace,5eecc6d6449e4f7cfb1c2708,2021-11-30T00:00:00.000Z,NEFT CR-DEUT0797BGL-AMAZON PAY (INDIA) P,shopping,,net_banking_transfer,103150.51
61b70b51d8beac1599eb90a2,50200023535069,703256.53,60ec41ba55c00300382672d9,HDFC,Revenue-PG-split enabled,5eecc6d6449e4f7cfb1c2708,2021-11-30T00:00:00.000Z,NEFT CR-UTIB0001506-RAZORPAY SOFTWARE PR IVATE LIMITED-SLICK ORGANICS PVT LITD-AX ISCN0107595183,insurance,,net_banking_transfer,490.3
61b70b52d8beac1599eb90a6,50200023535069,264976.53,60ec41ba55c00300382672d9,HDFC,Tax,5eecc6d6449e4f7cfb1c2708,2021-11-30T00:00:00.000Z,051030830112120020- CBDT TAX,,,Other,-438280
61b70b53d8beac1599eb90ac,50200023535069,320330.21,60ec41ba55c00300382672d9,HDFC,Revenue-UPI,5eecc6d6449e4f7cfb1c2708,2021-11-30T00:00:00.000Z,UPI-GOKWIK-GOKWIK@YESBANK-YESB0000340-13 3429419577-PAYOUT FOR NOVEMBE,,,upi,55353.68
61b70b54d8beac1599eb90b0,50200023535069,322588.61,60ec41ba55c00300382672d9,HDFC,Revenue-Mktplace,5eecc6d6449e4f7cfb1c2708,2021-11-30T00:00:00.000Z,NEFT CR-ICIC0000105-MANASH LIFESTYLE PRI VATE LIMITED NO-SLICK ORGANICS PRIVATE L IMITED MP G-ICIJ213340011453,shopping,,net_banking_transfer,2258.4
61b70b55d8beac1599eb90bd,50200023535069,324291.37,60ec41ba55c00300382672d9,HDFC,Revenue-Mktplace,5eecc6d6449e4f7cfb1c2708,2021-11-30T00:00:00.000Z,NEFT CR-ICIC0000105-MANASH LIFESTYLE PRI VATE LIMITED NO-SLICK ORGANICS PRIVATE L IMITED MP M-ICIJ213340012015,shopping,,net_banking_transfer,1702.76
61b70b56d8beac1599eb90c3,50200023535069,322711.78,60ec41ba55c00300382672d9,HDFC,bank charges,5eecc6d6449e4f7cfb1c2708,2021-11-30T00:00:00.000Z,.DC INTL POS TXN MARKUP+ST 181121 201121 -CDT2130806383839,,,international_transaction_arbitrage,-1579.59
61b70b57d8beac1599eb90c8,50200023535069,322682.28,60ec41ba55c00300382672d9,HDFC,direct expenses,5eecc6d6449e4f7cfb1c2708,2021-11-30T00:00:00.000Z,.POS DECCHG 20/11/21 CARDEND 9486 201121 -CDT2133406751686,,,bank_charge,-29.5
61b70b58d8beac1599eb90cf,50200023535069,322758.29,60ec41ba55c00300382672d9,HDFC,Revenue-PG-split enabled,5eecc6d6449e4f7cfb1c2708,2021-11-30T00:00:00.000Z,NEFT CR-UTIB0001506-RAZORPAY SOFTWARE PR IVATE LIMITED-SLICK ORGANICS PVT LITD-AX ISCN0107777967,insurance,,net_banking_transfer,76.01
61b70b59d8beac1599eb90d3,50200023535069,334235.27,60ec41ba55c00300382672d9,HDFC,Revenue-PG-non-split,5eecc6d6449e4f7cfb1c2708,2021-11-30T00:00:00.000Z,NEFT CR-IDFB0010204-SEZZLE PAYMENTS PRIV,,,net_banking_transfer,11476.98
61b70b67d8beac1599eb9108,50200050976833,50000,60ec41a455c0030038267236,HDFC,Transfer in/Revenue-other,5eecc6d6449e4f7cfb1c2708,2020-08-13T00:00:00.000Z,CU1900421994SLICK ORGANICS PVT LTD,investments,,Other,50000
61b70b68d8beac1599eb910c,50200050976833,50001.03,60ec41a455c0030038267236,HDFC,Revenue-PG-non-split,5eecc6d6449e4f7cfb1c2708,2020-09-01T00:00:00.000Z,NEFT CR-CITI0100000-PAYPAL PAYMENTS PL I NR FBO CUR AC-SLICK ORGANICS PRIVATE LIM ITED-CITIN20123485668,,,net_banking_transfer,1.03
61b70b69d8beac1599eb9113,50200050976833,50002.21,60ec41a455c0030038267236,HDFC,Revenue-PG-non-split,5eecc6d6449e4f7cfb1c2708,2020-09-01T00:00:00.000Z,NEFT CR-CITI0100000-PAYPAL PAYMENTS PL I NR FBO CUR AC-SLICK ORGANICS PRIVATE LIM ITED-CITIN20123484327,,,net_banking_transfer,1.18
61b70b6ad8beac1599eb9117,50200050976833,55002.21,60ec41a455c0030038267236,HDFC,Internal Transfers,5eecc6d6449e4f7cfb1c2708,2020-09-01T00:00:00.000Z,IB FUNDS TRANSFER CR-50200023535069 -SL ICK ORGANICS PVT LTD,investments,,Other,5000
61b70b6bd8beac1599eb911c,50200050976833,58118.87,60ec41a455c0030038267236,HDFC,Revenue-PG-non-split,5eecc6d6449e4f7cfb1c2708,2020-09-04T00:00:00.000Z,NEFT CR-CITI0100000-PAYPAL PAYMENTS PL-N ODAL A/C-SLICK ORGANICS PRIVATE LIMITED- CITIN20125744704,investments,,net_banking_transfer,3116.66
61b70b6cd8beac1599eb9123,50200050976833,60235.6,60ec41a455c0030038267236,HDFC,Revenue-PG-non-split,5eecc6d6449e4f7cfb1c2708,2020-09-05T00:00:00.000Z,NEFT CR-CITI0100000-PAYPAL PAYMENTS PL-N ODAL A/C-SLICK ORGANICS PRIVATE LIMITED- CITIN20126498105,investments,,net_banking_transfer,2116.73
61b70b6dd8beac1599eb9128,50200050976833,61082.22,60ec41a455c0030038267236,HDFC,Revenue-PG-non-split,5eecc6d6449e4f7cfb1c2708,2020-09-08T00:00:00.000Z,NEFT CR-CITI0100000-PAYPAL PAYMENTS PL-N ODAL A/C-SLICK ORGANICS PRIVATE LIMITED- CITIN20128023612,investments,,net_banking_transfer,846.62
61b70b6ed8beac1599eb9131,50200050976833,61928.84,60ec41a455c0030038267236,HDFC,Revenue-PG-non-split,5eecc6d6449e4f7cfb1c2708,2020-09-09T00:00:00.000Z,NEFT CR-CITI0100000-PAYPAL PAYMENTS PL-N ODAL A/C-SLICK ORGANICS PRIVATE LIMITED- CITIN20128705641,investments,,net_banking_transfer,846.62
61b70b6fd8beac1599eb9136,50200050976833,67184.49,60ec41a455c0030038267236,HDFC,Revenue-PG-non-split,5eecc6d6449e4f7cfb1c2708,2020-09-10T00:00:00.000Z,NEFT CR-CITI0100000-PAYPAL PAYMENTS PL-N ODAL A/C-SLICK ORGANICS PRIVATE LIMITED- CITIN20129214882,investments,,net_banking_transfer,5255.65
61b70b70d8beac1599eb913a,50200050976833,68458.86,60ec41a455c0030038267236,HDFC,Revenue-PG-non-split,5eecc6d6449e4f7cfb1c2708,2020-09-11T00:00:00.000Z,NEFT CR-CITI0100000-PAYPAL PAYMENTS PL-N ODAL A/C-SLICK ORGANICS PRIVATE LIMITED- CITIN20129891351,investments,,net_banking_transfer,1274.37
61b70b71d8beac1599eb9140,50200050976833,70547.29,60ec41a455c0030038267236,HDFC,Revenue-PG-non-split,5eecc6d6449e4f7cfb1c2708,2020-09-14T00:00:00.000Z,NEFT CR-CITI0100000-PAYPAL PAYMENTS PL-N,,,net_banking_transfer,2088.43
61b70b72d8beac1599eb9144,50200050976833,71673.74,60ec41a455c0030038267236,HDFC,Revenue-PG-non-split,5eecc6d6449e4f7cfb1c2708,2020-09-14T00:00:00.000Z,NEFT CR-CITI0100000-PAYPAL PAYMENTS PL-N ODAL A/C-SLICK ORGANICS PRIVATE LIMITED- CITIN20130872173,investments,,net_banking_transfer,1126.45
61b70b73d8beac1599eb914a,50200050976833,73965.16,60ec41a455c0030038267236,HDFC,Revenue-PG-non-split,5eecc6d6449e4f7cfb1c2708,2020-09-14T00:00:00.000Z,NEFT CR-CITI0100000-PAYPAL PAYMENTS PL-N ODAL A/C-SLICK ORGANICS PRIVATE LIMITED- CITIN20130871664,investments,,net_banking_transfer,2291.42
61b70b74d8beac1599eb914f,50200050976833,78323.59,60ec41a455c0030038267236,HDFC,Revenue-PG-non-split,5eecc6d6449e4f7cfb1c2708,2020-09-15T00:00:00.000Z,NEFT CR-CITI0100000-PAYPAL PAYMENTS PL-N ODAL A/C-SLICK ORGANICS PRIVATE LIMITED- CITIN20131380837,investments,,net_banking_transfer,4358.43
61b70b75d8beac1599eb9155,50200050976833,81682.5,60ec41a455c0030038267236,HDFC,Revenue-PG-non-split,5eecc6d6449e4f7cfb1c2708,2020-09-16T00:00:00.000Z,NEFT CR-CITI0100000-PAYPAL PAYMENTS PL-N ODAL A/C-SLICK ORGANICS PRIVATE LIMITED- CITIN20131965782,investments,,net_banking_transfer,3358.91
61b70b76d8beac1599eb915b,50200050976833,83554.65,60ec41a455c0030038267236,HDFC,Revenue-PG-non-split,5eecc6d6449e4f7cfb1c2708,2020-09-18T00:00:00.000Z,NEFT CR-CITI0100000-PAYPAL PAYMENTS PL-N ODAL A/C-SLICK ORGANICS PRIVATE LIMITED- CITIN20132895459,investments,,net_banking_transfer,1872.15
61b70b77d8beac1599eb915e,50200050976833,84161.55,60ec41a455c0030038267236,HDFC,Revenue-PG-non-split,5eecc6d6449e4f7cfb1c2708,2020-09-19T00:00:00.000Z,NEFT CR-CITI0100000-PAYPAL PAYMENTS PL-N ODAL A/C-SLICK ORGANICS PRIVATE LIMITED- CITIN20133242845,investments,,net_banking_transfer,606.9
61b70b78d8beac1599eb9169,50200050976833,88889.05,60ec41a455c0030038267236,HDFC,Revenue-PG-non-split,5eecc6d6449e4f7cfb1c2708,2020-09-21T00:00:00.000Z,NEFT CR-CITI0100000-PAYPAL PAYMENTS PL-N ODAL A/C-SLICK ORGANICS PRIVATE LIMITED- CITIN20133674525,investments,,net_banking_transfer,4727.5
61b70b79d8beac1599eb916c,50200050976833,89725.19,60ec41a455c0030038267236,HDFC,Revenue-PG-non-split,5eecc6d6449e4f7cfb1c2708,2020-09-22T00:00:00.000Z,NEFT CR-CITI0100000-PAYPAL PAYMENTS PL-N ODAL A/C-SLICK ORGANICS PRIVATE LIMITED- CITIN20134185614,investments,,net_banking_transfer,836.14
61b70b7ad8beac1599eb9170,50200050976833,91629.57,60ec41a455c0030038267236,HDFC,Revenue-PG-non-split,5eecc6d6449e4f7cfb1c2708,2020-09-23T00:00:00.000Z,NEFT CR-CITI0100000-PAYPAL PAYMENTS PL-N ODAL A/C-SLICK ORGANICS PRIVATE LIMITED- CITIN20134674721,investments,,net_banking_transfer,1904.38
61b70b7bd8beac1599eb9181,50200050976833,100416.63,60ec41a455c0030038267236,HDFC,Revenue-PG-non-split,5eecc6d6449e4f7cfb1c2708,2020-09-23T00:00:00.000Z,NEFT CR-CITI0100000-PAYPAL PAYMENTS PL-O PGSP COLL AC-SLICK ORGANICS PRIVATE LIMI TED-CITIN20134888499,investments,,net_banking_transfer,8787.06
61b70b7cd8beac1599eb9185,50200050976833,120460.58,60ec41a455c0030038267236,HDFC,Revenue-PG-non-split,5eecc6d6449e4f7cfb1c2708,2020-09-24T00:00:00.000Z,NEFT CR-CITI0100000-PAYPAL PAYMENTS PL-N,,,net_banking_transfer,20043.95
61b70b7dd8beac1599eb918c,50200050976833,122759.07,60ec41a455c0030038267236,HDFC,Revenue-PG-non-split,5eecc6d6449e4f7cfb1c2708,2020-09-25T00:00:00.000Z,NEFT CR-CITI0100000-PAYPAL PAYMENTS PL-N ODAL A/C-SLICK ORGANICS PRIVATE LIMITED- CITIN20135634518,investments,,net_banking_transfer,2298.49
61b70b7ed8beac1599eb9190,50200050976833,124927.03,60ec41a455c0030038267236,HDFC,Revenue-PG-non-split,5eecc6d6449e4f7cfb1c2708,2020-09-28T00:00:00.000Z,NEFT CR-CITI0100000-PAYPAL PAYMENTS PL-N ODAL A/C-SLICK ORGANICS PRIVATE LIMITED- CITIN20136626195,investments,,net_banking_transfer,2167.96
61b70b7fd8beac1599eb9194,50200050976833,128243.05,60ec41a455c0030038267236,HDFC,Revenue-PG-non-split,5eecc6d6449e4f7cfb1c2708,2020-09-28T00:00:00.000Z,NEFT CR-CITI0100000-PAYPAL PAYMENTS PL-N ODAL A/C-SLICK ORGANICS PRIVATE LIMITED- CITIN20136653718,investments,,net_banking_transfer,3316.02
61b70b80d8beac1599eb9199,50200050976833,130866.8,60ec41a455c0030038267236,HDFC,Revenue-PG-non-split,5eecc6d6449e4f7cfb1c2708,2020-09-29T00:00:00.000Z,NEFT CR-CITI0100000-PAYPAL PAYMENTS PL-N ODAL A/C-SLICK ORGANICS PRIVATE LIMITED- CITIN20137377323,investments,,net_banking_transfer,2623.75
61b70b81d8beac1599eb91a3,50200050976833,135878.08,60ec41a455c0030038267236,HDFC,Revenue-PG-non-split,5eecc6d6449e4f7cfb1c2708,2020-09-30T00:00:00.000Z,NEFT CR-CITI0100000-PAYPAL PAYMENTS PL-N,,,net_banking_transfer,5011.28
61b70b82d8beac1599eb91ac,50200050976833,136790.2,60ec41a455c0030038267236,HDFC,Revenue-PG-non-split,5eecc6d6449e4f7cfb1c2708,2020-10-01T00:00:00.000Z,NEFT CR-CITI0100000-PAYPAL PAYMENTS PL-N ODAL A/C-SLICK ORGANICS PRIVATE LIMITED- CITIN20140378052,investments,,net_banking_transfer,912.12
61b70b83d8beac1599eb91b2,50200050976833,137397.1,60ec41a455c0030038267236,HDFC,Revenue-PG-non-split,5eecc6d6449e4f7cfb1c2708,2020-10-03T00:00:00.000Z,NEFT CR-CITI0100000-PAYPAL PAYMENTS PL-N ODAL A/C-SLICK ORGANICS PRIVATE LIMITED- CITIN20141664400,investments,,net_banking_transfer,606.9
61b70b84d8beac1599eb91d5,50200050976833,137881.92,60ec41a455c0030038267236,HDFC,Revenue-PG-non-split,5eecc6d6449e4f7cfb1c2708,2020-10-03T00:00:00.000Z,NEFT CR-CITI0100000-PAYPAL PAYMENTS PL-N ODAL A/C-SLICK ORGANICS PRIVATE LIMITED- CITIN20141664661,investments,,net_banking_transfer,484.82
61b70b85d8beac1599eb91db,50200050976833,138400.12,60ec41a455c0030038267236,HDFC,Revenue-PG-non-split,5eecc6d6449e4f7cfb1c2708,2020-10-05T00:00:00.000Z,NEFT CR-CITI0100000-PAYPAL PAYMENTS PL-N ODAL A/C-SLICK ORGANICS PRIVATE LIMITED- CITIN20142540306,investments,,net_banking_transfer,518.2
61b70b86d8beac1599eb91e0,50200050976833,38400.12,60ec41a455c0030038267236,HDFC,Internal Transfers,5eecc6d6449e4f7cfb1c2708,2020-10-07T00:00:00.000Z,IB FUNDS TRANSFER DR-50200023535069 -SL ICK ORGANICS PVT LTD,investments,,net_banking_transfer,-100000
61b70b87d8beac1599eb91f2,50200050976833,40157.88,60ec41a455c0030038267236,HDFC,Revenue-PG-non-split,5eecc6d6449e4f7cfb1c2708,2020-10-07T00:00:00.000Z,NEFT CR-CITI0100000-PAYPAL PAYMENTS PL-N ODAL A/C-SLICK ORGANICS PRIVATE LIMITED- CITIN20144017337,investments,,net_banking_transfer,1757.76
61b70b88d8beac1599eb91f6,50200050976833,44876.4,60ec41a455c0030038267236,HDFC,Revenue-PG-non-split,5eecc6d6449e4f7cfb1c2708,2020-10-08T00:00:00.000Z,NEFT CR-CITI0100000-PAYPAL PAYMENTS PL-N ODAL A/C-SLICK ORGANICS PRIVATE LIMITED- CITIN20144747903,investments,,net_banking_transfer,4718.52
61b70b89d8beac1599eb91fb,50200050976833,49380.68,60ec41a455c0030038267236,HDFC,Revenue-PG-non-split,5eecc6d6449e4f7cfb1c2708,2020-10-09T00:00:00.000Z,NEFT CR-CITI0100000-PAYPAL PAYMENTS PL-N ODAL A/C-SLICK ORGANICS PRIVATE LIMITED- CITIN20145401214,investments,,net_banking_transfer,4504.28
61b70b8ad8beac1599eb9200,50200050976833,29380.68,60ec41a455c0030038267236,HDFC,Internal Transfers,5eecc6d6449e4f7cfb1c2708,2020-10-09T00:00:00.000Z,IB FUNDS TRANSFER DR-50200023535069 -SL ICK ORGANICS PVT LTD,investments,,net_banking_transfer,-20000
61b70b8bd8beac1599eb9209,50200050976833,31121.12,60ec41a455c0030038267236,HDFC,Revenue-PG-non-split,5eecc6d6449e4f7cfb1c2708,2020-10-12T00:00:00.000Z,NEFT CR-CITI0100000-PAYPAL PAYMENTS PL-N ODAL A/C-SLICK ORGANICS PRIVATE LIMITED- CITIN20146545853,investments,,net_banking_transfer,1740.44
61b70b8cd8beac1599eb9210,50200050976833,31409.89,60ec41a455c0030038267236,HDFC,Revenue-PG-non-split,5eecc6d6449e4f7cfb1c2708,2020-10-12T00:00:00.000Z,NEFT CR-CITI0100000-PAYPAL PAYMENTS PL-N,,,net_banking_transfer,288.77
61b70b8dd8beac1599eb9219,50200050976833,35415.29,60ec41a455c0030038267236,HDFC,Revenue-PG-non-split,5eecc6d6449e4f7cfb1c2708,2020-10-12T00:00:00.000Z,NEFT CR-CITI0100000-PAYPAL PAYMENTS PL-N ODAL A/C-SLICK ORGANICS PRIVATE LIMITED- CITIN20146551525,investments,,net_banking_transfer,4005.4
61b70b8ed8beac1599eb921e,50200050976833,37091.4,60ec41a455c0030038267236,HDFC,Revenue-PG-non-split,5eecc6d6449e4f7cfb1c2708,2020-10-13T00:00:00.000Z,NEFT CR-CITI0100000-PAYPAL PAYMENTS PL-N ODAL A/C-SLICK ORGANICS PRIVATE LIMITED- CITIN20147085449,investments,,net_banking_transfer,1676.11
61b70b8fd8beac1599eb9223,50200050976833,40925.22,60ec41a455c0030038267236,HDFC,Revenue-PG-non-split,5eecc6d6449e4f7cfb1c2708,2020-10-14T00:00:00.000Z,NEFT CR-CITI0100000-PAYPAL PAYMENTS PL-N ODAL A/C-SLICK ORGANICS PRIVATE LIMITED- CITIN20147686283,investments,,net_banking_transfer,3833.82
61b70b90d8beac1599eb9228,50200050976833,30925.22,60ec41a455c0030038267236,HDFC,Internal Transfers,5eecc6d6449e4f7cfb1c2708,2020-10-14T00:00:00.000Z,IB FUNDS TRANSFER DR-50200023535069 -SL ICK ORGANICS PVT LTD,investments,,net_banking_transfer,-10000
61b70b91d8beac1599eb924e,50200050976833,39778.48,60ec41a455c0030038267236,HDFC,Revenue-PG-non-split,5eecc6d6449e4f7cfb1c2708,2020-10-15T00:00:00.000Z,NEFT CR-CITI0100000-PAYPAL PAYMENTS PL-N ODAL A/C-SLICK ORGANICS PRIVATE LIMITED- CITIN20148218401,investments,,net_banking_transfer,8853.26
61b70b92d8beac1599eb925e,50200050976833,45349.47,60ec41a455c0030038267236,HDFC,Revenue-PG-non-split,5eecc6d6449e4f7cfb1c2708,2020-10-16T00:00:00.000Z,NEFT CR-CITI0100000-PAYPAL PAYMENTS PL-N ODAL A/C-SLICK ORGANICS PRIVATE LIMITED- CITIN20148808178,investments,,net_banking_transfer,5570.99
61b70b93d8beac1599eb9262,50200050976833,48487.42,60ec41a455c0030038267236,HDFC,Revenue-PG-non-split,5eecc6d6449e4f7cfb1c2708,2020-10-17T00:00:00.000Z,NEFT CR-CITI0100000-PAYPAL PAYMENTS PL-N ODAL A/C-SLICK ORGANICS PRIVATE LIMITED- CITIN20149246113,investments,,net_banking_transfer,3137.95
61b70b94d8beac1599eb9269,50200050976833,54744.86,60ec41a455c0030038267236,HDFC,Revenue-PG-non-split,5eecc6d6449e4f7cfb1c2708,2020-10-19T00:00:00.000Z,NEFT CR-CITI0100000-PAYPAL PAYMENTS PL-N ODAL A/C-SLICK ORGANICS PRIVATE LIMITED- CITIN20149671969,investments,,net_banking_transfer,6257.44
61b70b95d8beac1599eb926d,50200050976833,59062.62,60ec41a455c0030038267236,HDFC,Revenue-PG-non-split,5eecc6d6449e4f7cfb1c2708,2020-10-19T00:00:00.000Z,NEFT CR-CITI0100000-PAYPAL PAYMENTS PL-N ODAL A/C-SLICK ORGANICS PRIVATE LIMITED- CITIN20149672434,investments,,net_banking_transfer,4317.76
61b70b96d8beac1599eb9276,50200050976833,63748.28,60ec41a455c0030038267236,HDFC,Revenue-PG-non-split,5eecc6d6449e4f7cfb1c2708,2020-10-20T00:00:00.000Z,NEFT CR-CITI0100000-PAYPAL PAYMENTS PL-N ODAL A/C-SLICK ORGANICS PRIVATE LIMITED- CITIN20150171952,investments,,net_banking_transfer,4685.66
61b70b97d8beac1599eb927f,50200050976833,40748.28,60ec41a455c0030038267236,HDFC,Internal Transfers,5eecc6d6449e4f7cfb1c2708,2020-10-20T00:00:00.000Z,IB FUNDS TRANSFER DR-50200023535069 -SL,,,net_banking_transfer,-23000
61b70b98d8beac1599eb9283,50200050976833,25748.28,60ec41a455c0030038267236,HDFC,Internal Transfers,5eecc6d6449e4f7cfb1c2708,2020-10-20T00:00:00.000Z,IB FUNDS TRANSFER DR-50200023535069 -SL ICK ORGANICS PVT LTD,investments,,net_banking_transfer,-15000
61b70b99d8beac1599eb9289,50200050976833,27492.85,60ec41a455c0030038267236,HDFC,Revenue-PG-non-split,5eecc6d6449e4f7cfb1c2708,2020-10-21T00:00:00.000Z,NEFT CR-CITI0100000-PAYPAL PAYMENTS PL-N ODAL A/C-SLICK ORGANICS PRIVATE LIMITED- CITIN20150582426,investments,,net_banking_transfer,1744.57
61b70b9ad8beac1599eb928e,50200050976833,30447.39,60ec41a455c0030038267236,HDFC,Revenue-PG-non-split,5eecc6d6449e4f7cfb1c2708,2020-10-22T00:00:00.000Z,NEFT CR-CITI0100000-PAYPAL PAYMENTS PL-N ODAL A/C-SLICK ORGANICS PRIVATE LIMITED- CITIN20151089423,investments,,net_banking_transfer,2954.54
61b70b9bd8beac1599eb9296,50200050976833,36737.78,60ec41a455c0030038267236,HDFC,Revenue-PG-non-split,5eecc6d6449e4f7cfb1c2708,2020-10-23T00:00:00.000Z,NEFT CR-CITI0100000-PAYPAL PAYMENTS PL-N ODAL A/C-SLICK ORGANICS PRIVATE LIMITED- CITIN20151726889,investments,,net_banking_transfer,6290.39
61b70b9cd8beac1599eb929a,50200050976833,38345.32,60ec41a455c0030038267236,HDFC,Revenue-PG-non-split,5eecc6d6449e4f7cfb1c2708,2020-10-26T00:00:00.000Z,NEFT CR-CITI0100000-PAYPAL PAYMENTS PL-N ODAL A/C-SLICK ORGANICS PRIVATE LIMITED- CITIN20152616086,investments,,net_banking_transfer,1607.54
61b70b9dd8beac1599eb929f,50200050976833,42408.32,60ec41a455c0030038267236,HDFC,Revenue-PG-non-split,5eecc6d6449e4f7cfb1c2708,2020-10-26T00:00:00.000Z,NEFT CR-CITI0100000-PAYPAL PAYMENTS PL-N ODAL A/C-SLICK ORGANICS PRIVATE LIMITED- CITIN20152622986,investments,,net_banking_transfer,4063
61b70b9ed8beac1599eb92a3,50200050976833,51917.06,60ec41a455c0030038267236,HDFC,Revenue-PG-non-split,5eecc6d6449e4f7cfb1c2708,2020-10-29T00:00:00.000Z,NEFT CR-CITI0100000-PAYPAL PAYMENTS PL-N ODAL A/C-SLICK ORGANICS PRIVATE LIMITED- CITIN20155050962,investments,,net_banking_transfer,9508.74
61b70b9fd8beac1599eb92a8,50200050976833,54463.28,60ec41a455c0030038267236,HDFC,Revenue-PG-non-split,5eecc6d6449e4f7cfb1c2708,2020-11-02T00:00:00.000Z,NEFT CR-CITI0100000-PAYPAL PAYMENTS PL-N ODAL A/C-SLICK ORGANICS PRIVATE LIMITED- CITIN20157813814,investments,,net_banking_transfer,2546.22
61b70ba0d8beac1599eb92ae,50200050976833,67617.19,60ec41a455c0030038267236,HDFC,Revenue-PG-non-split,5eecc6d6449e4f7cfb1c2708,2020-11-02T00:00:00.000Z,NEFT CR-CITI0100000-PAYPAL PAYMENTS PL-N ODAL A/C-SLICK ORGANICS PRIVATE LIMITED- CITIN20157815369,investments,,net_banking_transfer,13153.91
61b70ba1d8beac1599eb92b5,50200050976833,71691.54,60ec41a455c0030038267236,HDFC,Revenue-PG-non-split,5eecc6d6449e4f7cfb1c2708,2020-11-03T00:00:00.000Z,NEFT CR-CITI0100000-PAYPAL PAYMENTS PL-N ODAL A/C-SLICK ORGANICS PRIVATE LIMITED- CITIN20158600380,investments,,net_banking_transfer,4074.35
61b70ba2d8beac1599eb92b9,50200050976833,50191.54,60ec41a455c0030038267236,HDFC,Internal Transfers,5eecc6d6449e4f7cfb1c2708,2020-11-04T00:00:00.000Z,IB FUNDS TRANSFER DR-50200023535069 -SL ICK ORGANICS PVT LTD,investments,,net_banking_transfer,-21500
61b70ba3d8beac1599eb92bf,50200050976833,52780.11,60ec41a455c0030038267236,HDFC,Revenue-PG-non-split,5eecc6d6449e4f7cfb1c2708,2020-11-04T00:00:00.000Z,NEFT CR-CITI0100000-PAYPAL PAYMENTS PL-N,,,net_banking_transfer,2588.57
61b70ba4d8beac1599eb92c4,50200050976833,53451.21,60ec41a455c0030038267236,HDFC,Revenue-PG-non-split,5eecc6d6449e4f7cfb1c2708,2020-11-05T00:00:00.000Z,NEFT CR-CITI0100000-PAYPAL PAYMENTS PL-N ODAL A/C-SLICK ORGANICS PRIVATE LIMITED- CITIN20159870947,investments,,net_banking_transfer,671.1
61b70ba5d8beac1599eb92e6,50200050976833,57016.44,60ec41a455c0030038267236,HDFC,Revenue-PG-non-split,5eecc6d6449e4f7cfb1c2708,2020-11-06T00:00:00.000Z,NEFT CR-CITI0100000-PAYPAL PAYMENTS PL-N ODAL A/C-SLICK ORGANICS PRIVATE LIMITED- CITIN20160589647,investments,,net_banking_transfer,3565.23
61b70ba6d8beac1599eb92eb,50200050976833,63918.46,60ec41a455c0030038267236,HDFC,Revenue-PG-non-split,5eecc6d6449e4f7cfb1c2708,2020-11-07T00:00:00.000Z,NEFT CR-CITI0100000-PAYPAL PAYMENTS PL-N ODAL A/C-SLICK ORGANICS PRIVATE LIMITED- CITIN20161242241,investments,,net_banking_transfer,6902.02
61b70ba7d8beac1599eb930d,50200050976833,65452.17,60ec41a455c0030038267236,HDFC,Revenue-PG-non-split,5eecc6d6449e4f7cfb1c2708,2020-11-09T00:00:00.000Z,NEFT CR-CITI0100000-PAYPAL PAYMENTS PL-N ODAL A/C-SLICK ORGANICS PRIVATE LIMITED- CITIN20161743626,investments,,net_banking_transfer,1533.71
61b70ba8d8beac1599eb9314,50200050976833,66802.32,60ec41a455c0030038267236,HDFC,Revenue-PG-non-split,5eecc6d6449e4f7cfb1c2708,2020-11-09T00:00:00.000Z,NEFT CR-CITI0100000-PAYPAL PAYMENTS PL-N ODAL A/C-SLICK ORGANICS PRIVATE LIMITED- CITIN20161742858,investments,,net_banking_transfer,1350.15
61b70ba9d8beac1599eb9319,50200050976833,67965.61,60ec41a455c0030038267236,HDFC,Revenue-PG-non-split,5eecc6d6449e4f7cfb1c2708,2020-11-10T00:00:00.000Z,NEFT CR-CITI0100000-PAYPAL PAYMENTS PL-N ODAL A/C-SLICK ORGANICS PRIVATE LIMITED- CITIN20162458362,investments,,net_banking_transfer,1163.29
61b70baad8beac1599eb9321,50200050976833,50965.61,60ec41a455c0030038267236,HDFC,Internal Transfers,5eecc6d6449e4f7cfb1c2708,2020-11-11T00:00:00.000Z,IB FUNDS TRANSFER DR-50200023535069 -SL ICK ORGANICS PVT LTD,investments,,net_banking_transfer,-17000
61b70babd8beac1599eb9346,50200050976833,53014.34,60ec41a455c0030038267236,HDFC,Revenue-PG-non-split,5eecc6d6449e4f7cfb1c2708,2020-11-11T00:00:00.000Z,NEFT CR-CITI0100000-PAYPAL PAYMENTS PL-N ODAL A/C-SLICK ORGANICS PRIVATE LIMITED- CITIN20163056732,investments,,net_banking_transfer,2048.73
61b70bacd8beac1599eb9349,50200050976833,56664.44,60ec41a455c0030038267236,HDFC,Revenue-PG-non-split,5eecc6d6449e4f7cfb1c2708,2020-11-12T00:00:00.000Z,NEFT CR-CITI0100000-PAYPAL PAYMENTS PL-N ODAL A/C-SLICK ORGANICS PRIVATE LIMITED- CITIN20163554867,investments,,net_banking_transfer,3650.1
61b70badd8beac1599eb934f,50200050976833,63251.42,60ec41a455c0030038267236,HDFC,Revenue-PG-non-split,5eecc6d6449e4f7cfb1c2708,2020-11-13T00:00:00.000Z,NEFT CR-CITI0100000-PAYPAL PAYMENTS PL-N ODAL A/C-SLICK ORGANICS PRIVATE LIMITED- CITIN20164267902,investments,,net_banking_transfer,6586.98
61b70baed8beac1599eb935d,50200050976833,13251.42,60ec41a455c0030038267236,HDFC,Internal Transfers,5eecc6d6449e4f7cfb1c2708,2020-11-13T00:00:00.000Z,IB FUNDS TRANSFER DR-50200023535069 -SL,,,net_banking_transfer,-50000
61b70bafd8beac1599eb9363,50200050976833,23365.4,60ec41a455c0030038267236,HDFC,Revenue-PG-non-split,5eecc6d6449e4f7cfb1c2708,2020-11-17T00:00:00.000Z,NEFT CR-CITI0100000-PAYPAL PAYMENTS PL-N ODAL A/C-SLICK ORGANICS PRIVATE LIMITED- CITIN20165107931,investments,,net_banking_transfer,10113.98
61b70bb0d8beac1599eb9368,50200050976833,24186.78,60ec41a455c0030038267236,HDFC,Revenue-PG-non-split,5eecc6d6449e4f7cfb1c2708,2020-11-17T00:00:00.000Z,NEFT CR-CITI0100000-PAYPAL PAYMENTS PL-N ODAL A/C-SLICK ORGANICS PRIVATE LIMITED- CITIN20165109963,investments,,net_banking_transfer,821.38
61b70bb1d8beac1599eb936c,50200050976833,26148.55,60ec41a455c0030038267236,HDFC,Revenue-PG-non-split,5eecc6d6449e4f7cfb1c2708,2020-11-17T00:00:00.000Z,NEFT CR-CITI0100000-PAYPAL PAYMENTS PL-N ODAL A/C-SLICK ORGANICS PRIVATE LIMITED- CITIN20165500247,investments,,net_banking_transfer,1961.77
61b70bb2d8beac1599eb9371,50200050976833,26612.09,60ec41a455c0030038267236,HDFC,Revenue-PG-non-split,5eecc6d6449e4f7cfb1c2708,2020-11-18T00:00:00.000Z,NEFT CR-CITI0100000-PAYPAL PAYMENTS PL-N ODAL A/C-SLICK ORGANICS PRIVATE LIMITED- CITIN20165700383,investments,,net_banking_transfer,463.54
61b70bb3d8beac1599eb937b,50200050976833,28825.55,60ec41a455c0030038267236,HDFC,Revenue-PG-non-split,5eecc6d6449e4f7cfb1c2708,2020-11-19T00:00:00.000Z,NEFT CR-CITI0100000-PAYPAL PAYMENTS PL-N ODAL A/C-SLICK ORGANICS PRIVATE LIMITED- CITIN20166111599,investments,,net_banking_transfer,2213.46
61b70bb4d8beac1599eb93aa,50200050976833,31510.31,60ec41a455c0030038267236,HDFC,Revenue-PG-non-split,5eecc6d6449e4f7cfb1c2708,2020-11-20T00:00:00.000Z,NEFT CR-CITI0100000-PAYPAL PAYMENTS PL-N ODAL A/C-SLICK ORGANICS PRIVATE LIMITED- CITIN20166633017,investments,,net_banking_transfer,2684.76
61b70bb5d8beac1599eb93bc,50200050976833,34929.44,60ec41a455c0030038267236,HDFC,Revenue-PG-non-split,5eecc6d6449e4f7cfb1c2708,2020-11-21T00:00:00.000Z,NEFT CR-CITI0100000-PAYPAL PAYMENTS PL-N ODAL A/C-SLICK ORGANICS PRIVATE LIMITED- CITIN20167072012,investments,,net_banking_transfer,3419.13
61b70bb6d8beac1599eb93cd,50200050976833,36240.13,60ec41a455c0030038267236,HDFC,Revenue-PG-non-split,5eecc6d6449e4f7cfb1c2708,2020-11-23T00:00:00.000Z,NEFT CR-CITI0100000-PAYPAL PAYMENTS PL-O PGSP COLL AC-SLICK ORGANICS PRIVATE LIMI TED-CITIN20167765970,investments,,net_banking_transfer,1310.69
61b70bb7d8beac1599eb93db,50200050976833,41758.81,60ec41a455c0030038267236,HDFC,Revenue-PG-non-split,5eecc6d6449e4f7cfb1c2708,2020-11-25T00:00:00.000Z,NEFT CR-CITI0100000-PAYPAL PAYMENTS PL-N ODAL A/C-SLICK ORGANICS PRIVATE LIMITED- CITIN20168600506,investments,,net_banking_transfer,5518.68
61b70bb8d8beac1599eb93e5,50200050976833,45746.07,60ec41a455c0030038267236,HDFC,Revenue-PG-non-split,5eecc6d6449e4f7cfb1c2708,2020-11-26T00:00:00.000Z,NEFT CR-CITI0100000-PAYPAL PAYMENTS PL-N ODAL A/C-SLICK ORGANICS PRIVATE LIMITED- CITIN20169625676,investments,,net_banking_transfer,3987.26
61b70bb9d8beac1599eb93ec,50200050976833,51780.82,60ec41a455c0030038267236,HDFC,Revenue-PG-non-split,5eecc6d6449e4f7cfb1c2708,2020-11-27T00:00:00.000Z,NEFT CR-CITI0100000-PAYPAL PAYMENTS PL-N,,,net_banking_transfer,6034.75
61b70bbad8beac1599eb93fb,50200050976833,71212.92,60ec41a455c0030038267236,HDFC,Revenue-PG-non-split,5eecc6d6449e4f7cfb1c2708,2020-12-01T00:00:00.000Z,NEFT CR-CITI0100000-PAYPAL PAYMENTS PL-N ODAL A/C-SLICK ORGANICS PRIVATE LIMITED- CITIN20173372831,investments,,net_banking_transfer,19432.1
61b70bbbd8beac1599eb9404,50200050976833,72115.52,60ec41a455c0030038267236,HDFC,Revenue-PG-non-split,5eecc6d6449e4f7cfb1c2708,2020-12-01T00:00:00.000Z,NEFT CR-CITI0100000-PAYPAL PAYMENTS PL-N ODAL A/C-SLICK ORGANICS PRIVATE LIMITED- CITIN20173422950,investments,,net_banking_transfer,902.6
61b70bbcd8beac1599eb9411,50200050976833,50115.52,60ec41a455c0030038267236,HDFC,Internal Transfers,5eecc6d6449e4f7cfb1c2708,2020-12-01T00:00:00.000Z,IB FUNDS TRANSFER DR-50200023535069 -SL ICK ORGANICS PVT LTD,investments,,net_banking_transfer,-22000
61b70bbdd8beac1599eb9419,50200050976833,53042.27,60ec41a455c0030038267236,HDFC,Revenue-PG-non-split,5eecc6d6449e4f7cfb1c2708,2020-12-01T00:00:00.000Z,NEFT CR-CITI0100000-PAYPAL PAYMENTS PL-N ODAL A/C-SLICK ORGANICS PRIVATE LIMITED- CITIN20173696890,investments,,net_banking_transfer,2926.75
61b70bbed8beac1599eb9420,50200050976833,53980.58,60ec41a455c0030038267236,HDFC,Revenue-PG-non-split,5eecc6d6449e4f7cfb1c2708,2020-12-02T00:00:00.000Z,NEFT CR-CITI0100000-PAYPAL PAYMENTS PL-N ODAL A/C-SLICK ORGANICS PRIVATE LIMITED- CITIN20174541098,investments,,net_banking_transfer,938.31
61b70bbfd8beac1599eb942a,50200050976833,55110.58,60ec41a455c0030038267236,HDFC,Revenue-PG-non-split,5eecc6d6449e4f7cfb1c2708,2020-12-03T00:00:00.000Z,NEFT CR-CITI0100000-PAYPAL PAYMENTS PL-N ODAL A/C-SLICK ORGANICS PRIVATE LIMITED- CITIN20175211638,investments,,net_banking_transfer,1130
61b70bc0d8beac1599eb942f,50200050976833,56392.4,60ec41a455c0030038267236,HDFC,Revenue-PG-non-split,5eecc6d6449e4f7cfb1c2708,2020-12-05T00:00:00.000Z,NEFT CR-CITI0100000-PAYPAL PAYMENTS PL-N ODAL A/C-SLICK ORGANICS PRIVATE LIMITED- CITIN20176533877,investments,,net_banking_transfer,1281.82
61b70bc1d8beac1599eb943a,50200050976833,59225.37,60ec41a455c0030038267236,HDFC,Revenue-PG-non-split,5eecc6d6449e4f7cfb1c2708,2020-12-07T00:00:00.000Z,NEFT CR-CITI0100000-PAYPAL PAYMENTS PL-N ODAL A/C-SLICK ORGANICS PRIVATE LIMITED- CITIN20177358845,investments,,net_banking_transfer,2832.97
61b70bc1d8beac1599eb9440,50200050976833,59780.06,60ec41a455c0030038267236,HDFC,Revenue-PG-non-split,5eecc6d6449e4f7cfb1c2708,2020-12-07T00:00:00.000Z,NEFT CR-CITI0100000-PAYPAL PAYMENTS PL-N ODAL A/C-SLICK ORGANICS PRIVATE LIMITED- CITIN20177358619,investments,,net_banking_transfer,554.69
61b70bc2d8beac1599eb9448,50200050976833,61404.92,60ec41a455c0030038267236,HDFC,Revenue-PG-non-split,5eecc6d6449e4f7cfb1c2708,2020-12-08T00:00:00.000Z,NEFT CR-CITI0100000-PAYPAL PAYMENTS PL-N ODAL A/C-SLICK ORGANICS PRIVATE LIMITED- CITIN20178106829,investments,,net_banking_transfer,1624.86
61b70bc4d8beac1599eb945b,50200050976833,63213.39,60ec41a455c0030038267236,HDFC,Revenue-PG-non-split,5eecc6d6449e4f7cfb1c2708,2020-12-09T00:00:00.000Z,NEFT CR-CITI0100000-PAYPAL PAYMENTS PL-N,,,net_banking_transfer,1808.47
61b70bc5d8beac1599eb9461,50200050976833,63922.15,60ec41a455c0030038267236,HDFC,Revenue-PG-non-split,5eecc6d6449e4f7cfb1c2708,2020-12-10T00:00:00.000Z,NEFT CR-CITI0100000-PAYPAL PAYMENTS PL-N ODAL A/C-SLICK ORGANICS PRIVATE LIMITED- CITIN20179839711,investments,,net_banking_transfer,708.76
61b70bc6d8beac1599eb9469,50200050976833,65872.48,60ec41a455c0030038267236,HDFC,Revenue-PG-non-split,5eecc6d6449e4f7cfb1c2708,2020-12-14T00:00:00.000Z,NEFT CR-CITI0100000-PAYPAL PAYMENTS PL-N ODAL A/C-SLICK ORGANICS PRIVATE LIMITED- CITIN20180982934,investments,,net_banking_transfer,1950.33
61b70bc7d8beac1599eb9470,50200050976833,66243.01,60ec41a455c0030038267236,HDFC,Revenue-PG-non-split,5eecc6d6449e4f7cfb1c2708,2020-12-14T00:00:00.000Z,NEFT CR-CITI0100000-PAYPAL PAYMENTS PL-N ODAL A/C-SLICK ORGANICS PRIVATE LIMITED- CITIN20180990408,investments,,net_banking_transfer,370.53
61b70bc7d8beac1599eb9478,50200050976833,67189.11,60ec41a455c0030038267236,HDFC,Revenue-PG-non-split,5eecc6d6449e4f7cfb1c2708,2020-12-14T00:00:00.000Z,NEFT CR-CITI0100000-PAYPAL PAYMENTS PL-N ODAL A/C-SLICK ORGANICS PRIVATE LIMITED- CITIN20180990595,investments,,net_banking_transfer,946.1
61b70bc9d8beac1599eb9484,50200050976833,69789.14,60ec41a455c0030038267236,HDFC,Revenue-PG-non-split,5eecc6d6449e4f7cfb1c2708,2020-12-15T00:00:00.000Z,NEFT CR-CITI0100000-PAYPAL PAYMENTS PL-N ODAL A/C-SLICK ORGANICS PRIVATE LIMITED- CITIN20181691123,investments,,net_banking_transfer,2600.03
61b70bcad8beac1599eb9493,50200050976833,70667.39,60ec41a455c0030038267236,HDFC,Revenue-PG-non-split,5eecc6d6449e4f7cfb1c2708,2020-12-16T00:00:00.000Z,NEFT CR-CITI0100000-PAYPAL PAYMENTS PL-N ODAL A/C-SLICK ORGANICS PRIVATE LIMITED- CITIN20182268488,investments,,net_banking_transfer,878.25
61b70bcbd8beac1599eb949d,50200050976833,75233.54,60ec41a455c0030038267236,HDFC,Revenue-PG-non-split,5eecc6d6449e4f7cfb1c2708,2020-12-17T00:00:00.000Z,NEFT CR-CITI0100000-PAYPAL PAYMENTS PL-O PGSP COLL AC-SLICK ORGANICS PRIVATE LIMI TED-CITIN20182867606,investments,,net_banking_transfer,4566.15
61b70bccd8beac1599eb94a1,50200050976833,76447.54,60ec41a455c0030038267236,HDFC,Revenue-PG-non-split,5eecc6d6449e4f7cfb1c2708,2020-12-19T00:00:00.000Z,NEFT CR-CITI0100000-PAYPAL PAYMENTS PL-N ODAL A/C-SLICK ORGANICS PRIVATE LIMITED- CITIN20183776087,investments,,net_banking_transfer,1214
61b70bcdd8beac1599eb94a6,50200050976833,78121.51,60ec41a455c0030038267236,HDFC,Revenue-PG-non-split,5eecc6d6449e4f7cfb1c2708,2020-12-22T00:00:00.000Z,NEFT CR-CITI0100000-PAYPAL PAYMENTS PL-N ODAL A/C-SLICK ORGANICS PRIVATE LIMITED- CITIN20184764893,investments,,net_banking_transfer,1673.97
61b70bced8beac1599eb94ac,50200050976833,81527.22,60ec41a455c0030038267236,HDFC,Revenue-PG-non-split,5eecc6d6449e4f7cfb1c2708,2020-12-28T00:00:00.000Z,NEFT CR-CITI0100000-PAYPAL PAYMENTS PL-N,,,net_banking_transfer,3405.71
61b70bcfd8beac1599eb94b2,50200050976833,89753.01,60ec41a455c0030038267236,HDFC,Revenue-PG-non-split,5eecc6d6449e4f7cfb1c2708,2020-12-29T00:00:00.000Z,NEFT CR-CITI0100000-PAYPAL PAYMENTS PL-O PGSP COLL AC-SLICK ORGANICS PRIVATE LIMI TED-CITIN20188049026,investments,,net_banking_transfer,8225.79
61b70bd0d8beac1599eb94bc,50200050976833,91747.66,60ec41a455c0030038267236,HDFC,Revenue-PG-non-split,5eecc6d6449e4f7cfb1c2708,2020-12-30T00:00:00.000Z,NEFT CR-CITI0100000-PAYPAL PAYMENTS PL-N ODAL A/C-SLICK ORGANICS PRIVATE LIMITED- CITIN20188854174,investments,,net_banking_transfer,1994.65
61b70bd1d8beac1599eb94c0,50200050976833,96157.14,60ec41a455c0030038267236,HDFC,Revenue-PG-non-split,5eecc6d6449e4f7cfb1c2708,2020-12-31T00:00:00.000Z,NEFT CR-CITI0100000-PAYPAL PAYMENTS PL-N ODAL A/C-SLICK ORGANICS PRIVATE LIMITED- CITIN20190689917,investments,,net_banking_transfer,4409.48
61b70bd2d8beac1599eb94c6,50200050976833,96677.67,60ec41a455c0030038267236,HDFC,Revenue-PG-non-split,5eecc6d6449e4f7cfb1c2708,2021-01-04T00:00:00.000Z,NEFT CR-CITI0100000-PAYPAL PAYMENTS PL-N ODAL A/C-SLICK ORGANICS PRIVATE LIMITED- CITIN21101519609,investments,,net_banking_transfer,520.53
61b70bd3d8beac1599eb94d5,50200050976833,98603.97,60ec41a455c0030038267236,HDFC,Revenue-PG-non-split,5eecc6d6449e4f7cfb1c2708,2021-01-05T00:00:00.000Z,NEFT CR-CITI0100000-PAYPAL PAYMENTS PL-N ODAL A/C-SLICK ORGANICS PRIVATE LIMITED- CITIN21102257549,investments,,net_banking_transfer,1926.3
61b70bd4d8beac1599eb94d8,50200050976833,99120.62,60ec41a455c0030038267236,HDFC,Revenue-PG-non-split,5eecc6d6449e4f7cfb1c2708,2021-01-08T00:00:00.000Z,NEFT CR-CITI0100000-PAYPAL PAYMENTS PL-N ODAL A/C-SLICK ORGANICS PRIVATE LIMITED- CITIN21104651288,investments,,net_banking_transfer,516.65
61b70bd5d8beac1599eb94df,50200050976833,49120.62,60ec41a455c0030038267236,HDFC,Internal Transfers,5eecc6d6449e4f7cfb1c2708,2021-01-08T00:00:00.000Z,IB FUNDS TRANSFER DR-50200023535069 -SL ICK ORGANICS PVT LTD,investments,,net_banking_transfer,-50000
61b70bd6d8beac1599eb94e3,50200050976833,49630.67,60ec41a455c0030038267236,HDFC,Revenue-PG-non-split,5eecc6d6449e4f7cfb1c2708,2021-01-11T00:00:00.000Z,NEFT CR-CITI0100000-PAYPAL PAYMENTS PL-N ODAL A/C-SLICK ORGANICS PRIVATE LIMITED- CITIN21105637035,investments,,net_banking_transfer,510.05
61b70bd7d8beac1599eb94eb,50200050976833,50759.12,60ec41a455c0030038267236,HDFC,Revenue-PG-non-split,5eecc6d6449e4f7cfb1c2708,2021-01-12T00:00:00.000Z,NEFT CR-CITI0100000-PAYPAL PAYMENTS PL-N ODAL A/C-SLICK ORGANICS PRIVATE LIMITED- CITIN21106357890,investments,,net_banking_transfer,1128.45
61b70bd8d8beac1599eb94ef,50200050976833,51197.15,60ec41a455c0030038267236,HDFC,Revenue-PG-non-split,5eecc6d6449e4f7cfb1c2708,2021-01-16T00:00:00.000Z,NEFT CR-CITI0100000-PAYPAL PAYMENTS PL-N ODAL A/C-SLICK ORGANICS PRIVATE LIMITED- CITIN21108300295,investments,,net_banking_transfer,438.03
61b70bd9d8beac1599eb94f4,50200050976833,54907.82,60ec41a455c0030038267236,HDFC,Revenue-PG-non-split,5eecc6d6449e4f7cfb1c2708,2021-01-18T00:00:00.000Z,NEFT CR-CITI0100000-PAYPAL PAYMENTS PL-N,,,net_banking_transfer,3710.67
61b70bdad8beac1599eb94f8,50200050976833,59267.27,60ec41a455c0030038267236,HDFC,Revenue-PG-non-split,5eecc6d6449e4f7cfb1c2708,2021-01-20T00:00:00.000Z,NEFT CR-CITI0100000-PAYPAL PAYMENTS PL-N ODAL A/C-SLICK ORGANICS PRIVATE LIMITED- CITIN21109610681,investments,,net_banking_transfer,4359.45
61b70bdbd8beac1599eb94fc,50200050976833,61177.7,60ec41a455c0030038267236,HDFC,Revenue-PG-non-split,5eecc6d6449e4f7cfb1c2708,2021-01-20T00:00:00.000Z,NEFT CR-CITI0100000-PAYPAL PAYMENTS PL-N ODAL A/C-SLICK ORGANICS PRIVATE LIMITED- CITIN21109713266,investments,,net_banking_transfer,1910.43
61b70bdcd8beac1599eb9503,50200050976833,62306.15,60ec41a455c0030038267236,HDFC,Revenue-PG-non-split,5eecc6d6449e4f7cfb1c2708,2021-01-21T00:00:00.000Z,NEFT CR-CITI0100000-PAYPAL PAYMENTS PL-N ODAL A/C-SLICK ORGANICS PRIVATE LIMITED- CITIN21110126822,investments,,net_banking_transfer,1128.45
61b70bddd8beac1599eb950a,50200050976833,64777.34,60ec41a455c0030038267236,HDFC,Revenue-PG-non-split,5eecc6d6449e4f7cfb1c2708,2021-01-22T00:00:00.000Z,NEFT CR-CITI0100000-PAYPAL PAYMENTS PL-N ODAL A/C-SLICK ORGANICS PRIVATE LIMITED- CITIN21110656753,investments,,net_banking_transfer,2471.19
61b70bded8beac1599eb950e,50200050976833,65781.57,60ec41a455c0030038267236,HDFC,Revenue-PG-non-split,5eecc6d6449e4f7cfb1c2708,2021-01-27T00:00:00.000Z,NEFT CR-CITI0100000-PAYPAL PAYMENTS PL-N ODAL A/C-SLICK ORGANICS PRIVATE LIMITED- CITIN21112332386,investments,,net_banking_transfer,1004.23
61b70bdfd8beac1599eb9513,50200050976833,66985.13,60ec41a455c0030038267236,HDFC,Revenue-PG-non-split,5eecc6d6449e4f7cfb1c2708,2021-01-28T00:00:00.000Z,NEFT CR-CITI0100000-PAYPAL PAYMENTS PL-N ODAL A/C-SLICK ORGANICS PRIVATE LIMITED- CITIN21113221168,investments,,net_banking_transfer,1203.56
61b70be0d8beac1599eb9517,50200050976833,67487.36,60ec41a455c0030038267236,HDFC,Revenue-PG-non-split,5eecc6d6449e4f7cfb1c2708,2021-01-29T00:00:00.000Z,NEFT CR-CITI0100000-PAYPAL PAYMENTS PL-N ODAL A/C-SLICK ORGANICS PRIVATE LIMITED- CITIN21115164820,investments,,net_banking_transfer,502.23
61b70be1d8beac1599eb951e,50200050976833,68025.75,60ec41a455c0030038267236,HDFC,Revenue-PG-non-split,5eecc6d6449e4f7cfb1c2708,2021-01-30T00:00:00.000Z,NEFT CR-CITI0100000-PAYPAL PAYMENTS PL-N ODAL A/C-SLICK ORGANICS PRIVATE LIMITED- CITIN21116222590,investments,,net_banking_transfer,538.39
61b70be2d8beac1599eb9522,50200050976833,69627.37,60ec41a455c0030038267236,HDFC,Revenue-PG-non-split,5eecc6d6449e4f7cfb1c2708,2021-02-06T00:00:00.000Z,NEFT CR-CITI0100000-PAYPAL PAYMENTS PL-N ODAL A/C-SLICK ORGANICS PRIVATE LIMITED- CITIN21121072429,investments,,net_banking_transfer,1601.62
61b70be3d8beac1599eb9527,50200050976833,81920.62,60ec41a455c0030038267236,HDFC,Revenue-PG-non-split,5eecc6d6449e4f7cfb1c2708,2021-02-11T00:00:00.000Z,NEFT CR-CITI0100000-PAYPAL PAYMENTS PL-O PGSP COLL AC-SLICK ORGANICS PRIVATE LIMI TED-CITIN21123904522,investments,,net_banking_transfer,12293.25
61b70be4d8beac1599eb952d,50200050976833,88225.33,60ec41a455c0030038267236,HDFC,Revenue-PG-non-split,5eecc6d6449e4f7cfb1c2708,2021-02-15T00:00:00.000Z,NEFT CR-CITI0100000-PAYPAL PAYMENTS PL-N,,,net_banking_transfer,6304.71
61b70be5d8beac1599eb9531,50200050976833,90447.3,60ec41a455c0030038267236,HDFC,Revenue-PG-non-split,5eecc6d6449e4f7cfb1c2708,2021-02-15T00:00:00.000Z,NEFT CR-CITI0100000-PAYPAL PAYMENTS PL-N ODAL A/C-SLICK ORGANICS PRIVATE LIMITED- CITIN21125166826,investments,,net_banking_transfer,2221.97
61b70be6d8beac1599eb953a,50200050976833,101977.04,60ec41a455c0030038267236,HDFC,Revenue-PG-non-split,5eecc6d6449e4f7cfb1c2708,2021-02-16T00:00:00.000Z,NEFT CR-CITI0100000-PAYPAL PAYMENTS PL-N ODAL A/C-SLICK ORGANICS PRIVATE LIMITED- CITIN21125721922,investments,,net_banking_transfer,11529.74
61b70be7d8beac1599eb9541,50200050976833,49977.04,60ec41a455c0030038267236,HDFC,Internal Transfers,5eecc6d6449e4f7cfb1c2708,2021-02-16T00:00:00.000Z,IB FUNDS TRANSFER DR-50200023535069 -SL,,,net_banking_transfer,-52000
61b70be8d8beac1599eb9544,50200050976833,59799.5,60ec41a455c0030038267236,HDFC,Revenue-PG-non-split,5eecc6d6449e4f7cfb1c2708,2021-04-16T00:00:00.000Z,NEFT CR-CITI0100000-PAYPAL PAYMENTS PL-N ODAL A/C-SLICK ORGANICS PRIVATE LIMITED- CITIN21158413024,investments,,net_banking_transfer,9822.46
61b70be9d8beac1599eb954a,50200050976833,65958.87,60ec41a455c0030038267236,HDFC,Revenue-PG-non-split,5eecc6d6449e4f7cfb1c2708,2021-04-16T00:00:00.000Z,NEFT CR-CITI0100000-PAYPAL PAYMENTS PL-O,,,net_banking_transfer,6159.37
61b70bead8beac1599eb954e,50200050976833,68912.9,60ec41a455c0030038267236,HDFC,Revenue-PG-non-split,5eecc6d6449e4f7cfb1c2708,2021-06-23T00:00:00.000Z,NEFT CR-CITI0100000-PAYPAL PAYMENTS PL-O,,,net_banking_transfer,2954.03
61b70bebd8beac1599eb9551,50200050976833,69206,60ec41a455c0030038267236,HDFC,Revenue-PG-non-split,5eecc6d6449e4f7cfb1c2708,2021-07-07T00:00:00.000Z,NEFT CR-CITI0100000-PAYPAL PAYMENTS PL-O PGSP COLL AC-SLICK ORGANICS PRIVATE LIMI TED-CITIN21200838724,insurance,,net_banking_transfer,293.1
61b70bebd8beac1599eb9557,50200050976833,49206,60ec41a455c0030038267236,HDFC,Internal Transfers,5eecc6d6449e4f7cfb1c2708,2021-07-09T00:00:00.000Z,IB FUNDS TRANSFER DR-50200023535069 -SL ICK ORGANICS PVT LTD,insurance,,net_banking_transfer,-20000
61b70becd8beac1599eb955b,50200050976833,52318.44,60ec41a455c0030038267236,HDFC,Revenue-PG-non-split,5eecc6d6449e4f7cfb1c2708,2021-07-19T00:00:00.000Z,NEFT CR-CITI0100000-PAYPAL PAYMENTS PL-O PGSP COLL AC-SLICK ORGANICS PRIVATE LIMI TED-CITIN21205580997,insurance,,net_banking_transfer,3112.44
61b70beed8beac1599eb9565,50200050976833,70129.97,60ec41a455c0030038267236,HDFC,Revenue-PG-non-split,5eecc6d6449e4f7cfb1c2708,2021-09-07T00:00:00.000Z,NEFT CR-CITI0100000-PAYPAL PAYMENTS PL-O PGSP COLL AC-SLICK ORGANICS PRIVATE LIMI TED-CITIN21233967903,insurance,,net_banking_transfer,2841.61
61b70befd8beac1599eb9569,50200050976833,73470.45,60ec41a455c0030038267236,HDFC,Revenue-PG-non-split,5eecc6d6449e4f7cfb1c2708,2021-09-09T00:00:00.000Z,NEFT CR-CITI0100000-PAYPAL PAYMENTS PL-O PGSP COLL AC-SLICK ORGANICS PRIVATE LIMI TED-CITIN21235428485,insurance,,net_banking_transfer,3340.48
61b70bf0d8beac1599eb9574,50200050976833,50470.45,60ec41a455c0030038267236,HDFC,Internal Transfers,5eecc6d6449e4f7cfb1c2708,2021-09-09T00:00:00.000Z,IB FUNDS TRANSFER DR-50200023535069 -SL,,,net_banking_transfer,-23000
61b70bf1d8beac1599eb9585,50200050976833,3311.53,60ec41a455c0030038267236,HDFC,Internal Transfers,5eecc6d6449e4f7cfb1c2708,2021-11-19T00:00:00.000Z,IB FUNDS TRANSFER DR-50200023535069 -SL ICK ORGANICS PVT LTD,insurance,,net_banking_transfer,-10000
61b70bffd8beac1599eb95c3,50200035187206,13007515.5,60ec419255c00300382671a5,HDFC,Transfer in/Revenue-other,5eecc6d6449e4f7cfb1c2708,2020-05-05T00:00:00.000Z,RTGS CR-RATN0000070-RBL BANK LTD-SLICK O RGANICS PVT LTD-RATNR52020050500726496,investments,,net_banking_transfer,12997838.56
61b70c00d8beac1599eb95c7,50200035187206,10507515.5,60ec419255c00300382671a5,HDFC,Internal Transfers,5eecc6d6449e4f7cfb1c2708,2020-05-06T00:00:00.000Z,IB FUNDS TRANSFER DR-50200023535069 -SL ICK ORGANICS PVT LTD,investments,,net_banking_transfer,-2500000
61b70c01d8beac1599eb95cc,50200035187206,8507515.5,60ec419255c00300382671a5,HDFC,Internal Transfers,5eecc6d6449e4f7cfb1c2708,2020-05-07T00:00:00.000Z,IB FUNDS TRANSFER DR-50200023535069 -SL ICK ORGANICS PVT LTD,investments,,net_banking_transfer,-2000000
61b70c02d8beac1599eb95d0,50200035187206,8057515.5,60ec419255c00300382671a5,HDFC,Internal Transfers,5eecc6d6449e4f7cfb1c2708,2020-05-13T00:00:00.000Z,IB FUNDS TRANSFER DR-50200023535069 -SL ICK ORGANICS PVT LTD,investments,,net_banking_transfer,-450000
61b70c03d8beac1599eb95d7,50200035187206,57515.5,60ec419255c00300382671a5,HDFC,direct expenses,5eecc6d6449e4f7cfb1c2708,2020-05-13T00:00:00.000Z,FD BOOKED - 50300426750615 : SLICK ORGAN ICS PVT LTD,investments,,investment,-8000000
61b70c04d8beac1599eb95e0,50200035187206,-2442484.5,60ec419255c00300382671a5,HDFC,Internal Transfers,5eecc6d6449e4f7cfb1c2708,2020-06-01T00:00:00.000Z,IB FUNDS TRANSFER DR-50200023535069 -SL ICK ORGANICS PVT LTD,investments,,net_banking_transfer,-2500000
61b70c05d8beac1599eb95e4,50200035187206,-2439314.5,60ec419255c00300382671a5,HDFC,Transfer in/Revenue-other,5eecc6d6449e4f7cfb1c2708,2020-06-02T00:00:00.000Z,INT. ON SWCR ON-50300426750615,,,Other,3170
61b70c06d8beac1599eb95e9,50200035187206,3170.5,60ec419255c00300382671a5,HDFC,Loan-in,5eecc6d6449e4f7cfb1c2708,2020-06-02T00:00:00.000Z,SWEEP-IN CREDIT - 50300426750615,,,self_transfer,2442485
61b70c07d8beac1599eb95ee,50200035187206,-26829.5,60ec419255c00300382671a5,HDFC,direct expenses,5eecc6d6449e4f7cfb1c2708,2020-06-02T00:00:00.000Z,"SELF - CHQ PAID - KALKAJI, NEW",,,chq,-30000
61b70c08d8beac1599eb95f2,50200035187206,-26792.5,60ec419255c00300382671a5,HDFC,Transfer in/Revenue-other,5eecc6d6449e4f7cfb1c2708,2020-06-03T00:00:00.000Z,INT. ON SWCR ON-50300426750615,,,Other,37
61b70c09d8beac1599eb95f8,50200035187206,37.5,60ec419255c00300382671a5,HDFC,Loan-in,5eecc6d6449e4f7cfb1c2708,2020-06-03T00:00:00.000Z,SWEEP-IN CREDIT - 50300426750615,,,self_transfer,26830
61b70c0ad8beac1599eb95fe,50200035187206,30037.5,60ec419255c00300382671a5,HDFC,Internal Transfers,5eecc6d6449e4f7cfb1c2708,2020-06-05T00:00:00.000Z,"CASH DEP KALKAJI, NEW",,,cash_deposit,30000
61b70c0bd8beac1599eb9602,50200035187206,-2469962.5,60ec419255c00300382671a5,HDFC,Internal Transfers,5eecc6d6449e4f7cfb1c2708,2020-06-07T00:00:00.000Z,IB FUNDS TRANSFER DR-50200023535069 -SL ICK ORGANICS PVT LTD,investments,,net_banking_transfer,-2500000
61b70c0cd8beac1599eb9613,50200035187206,-2465744.5,60ec419255c00300382671a5,HDFC,Transfer in/Revenue-other,5eecc6d6449e4f7cfb1c2708,2020-06-07T00:00:00.000Z,INT. ON SWCR ON-50300426750615,,,Other,4218
61b70c0dd8beac1599eb9617,50200035187206,4218.5,60ec419255c00300382671a5,HDFC,Loan-in,5eecc6d6449e4f7cfb1c2708,2020-06-07T00:00:00.000Z,SWEEP-IN CREDIT - 50300426750615,,,self_transfer,2469963
61b70c0ed8beac1599eb9622,50200035187206,-1495781.5,60ec419255c00300382671a5,HDFC,Internal Transfers,5eecc6d6449e4f7cfb1c2708,2020-06-18T00:00:00.000Z,IB FUNDS TRANSFER DR-50200023535069 -SL ICK ORGANICS PVT LTD,investments,,net_banking_transfer,-1500000
61b70c0fd8beac1599eb9627,50200035187206,-1490999.5,60ec419255c00300382671a5,HDFC,Transfer in/Revenue-other,5eecc6d6449e4f7cfb1c2708,2020-06-19T00:00:00.000Z,INT. ON SWCR ON-50300426750615,,,Other,4782
61b70c10d8beac1599eb962e,50200035187206,4782.5,60ec419255c00300382671a5,HDFC,Loan-in,5eecc6d6449e4f7cfb1c2708,2020-06-19T00:00:00.000Z,SWEEP-IN CREDIT - 50300426750615,,,self_transfer,1495782
61b70c11d8beac1599eb9637,50200035187206,-95217.5,60ec419255c00300382671a5,HDFC,Internal Transfers,5eecc6d6449e4f7cfb1c2708,2020-07-06T00:00:00.000Z,IB FUNDS TRANSFER DR-50200023535069 -SL ICK ORGANICS PVT LTD,investments,,net_banking_transfer,-100000
61b70c12d8beac1599eb9643,50200035187206,-94690.5,60ec419255c00300382671a5,HDFC,Transfer in/Revenue-other,5eecc6d6449e4f7cfb1c2708,2020-07-07T00:00:00.000Z,INT. ON SWCR ON-50300426750615,,,Other,527
61b70c13d8beac1599eb964a,50200035187206,527.5,60ec419255c00300382671a5,HDFC,Loan-in,5eecc6d6449e4f7cfb1c2708,2020-07-07T00:00:00.000Z,SWEEP-IN CREDIT - 50300426750615,,,self_transfer,95218
61b70c14d8beac1599eb964e,50200035187206,-499472.5,60ec419255c00300382671a5,HDFC,Internal Transfers,5eecc6d6449e4f7cfb1c2708,2020-07-07T00:00:00.000Z,IB FUNDS TRANSFER DR-50200023535069 -SL ICK ORGANICS PVT LTD,investments,,net_banking_transfer,-500000
61b70c15d8beac1599eb9652,50200035187206,-496657.5,60ec419255c00300382671a5,HDFC,Transfer in/Revenue-other,5eecc6d6449e4f7cfb1c2708,2020-07-08T00:00:00.000Z,INT. ON SWCR ON-50300426750615,,,Other,2815
61b70c16d8beac1599eb9657,50200035187206,2815.5,60ec419255c00300382671a5,HDFC,Loan-in,5eecc6d6449e4f7cfb1c2708,2020-07-08T00:00:00.000Z,SWEEP-IN CREDIT - 50300426750615,,,self_transfer,499473
61b70c17d8beac1599eb965b,50200035187206,-497184.5,60ec419255c00300382671a5,HDFC,Internal Transfers,5eecc6d6449e4f7cfb1c2708,2020-07-30T00:00:00.000Z,IB FUNDS TRANSFER DR-50200023535069 -SL ICK ORGANICS PVT LTD,investments,,net_banking_transfer,-500000
61b70c18d8beac1599eb9667,50200035187206,-493211.5,60ec419255c00300382671a5,HDFC,Transfer in/Revenue-other,5eecc6d6449e4f7cfb1c2708,2020-07-31T00:00:00.000Z,INT. ON SWCR ON-50300426750615,,,Other,3973
61b70c19d8beac1599eb9674,50200035187206,3973.5,60ec419255c00300382671a5,HDFC,Loan-in,5eecc6d6449e4f7cfb1c2708,2020-07-31T00:00:00.000Z,SWEEP-IN CREDIT - 50300426750615,,,self_transfer,497185
61b70c1ad8beac1599eb9678,50200035187206,-296026.5,60ec419255c00300382671a5,HDFC,Internal Transfers,5eecc6d6449e4f7cfb1c2708,2020-08-01T00:00:00.000Z,IB FUNDS TRANSFER DR-50200023535069-SLIC K ORGANICS PVT LTD,investments,,net_banking_transfer,-300000
61b70c1bd8beac1599eb967e,50200035187206,-293600.5,60ec419255c00300382671a5,HDFC,Transfer in/Revenue-other,5eecc6d6449e4f7cfb1c2708,2020-08-02T00:00:00.000Z,INT. ON SWCR ON-50300426750615,,,Other,2426
61b70c1cd8beac1599eb9681,50200035187206,2426.5,60ec419255c00300382671a5,HDFC,Loan-in,5eecc6d6449e4f7cfb1c2708,2020-08-02T00:00:00.000Z,SWEEP-IN CREDIT - 50300426750615,,,self_transfer,296027
61b70c1dd8beac1599eb9688,50200035187206,-97573.5,60ec419255c00300382671a5,HDFC,Internal Transfers,5eecc6d6449e4f7cfb1c2708,2020-08-06T00:00:00.000Z,IB FUNDS TRANSFER DR-50200023535069 -SL ICK ORGANICS PVT LTD,investments,,net_banking_transfer,-100000
61b70c1ed8beac1599eb968c,50200035187206,-147573.5,60ec419255c00300382671a5,HDFC,Internal Transfers,5eecc6d6449e4f7cfb1c2708,2020-08-06T00:00:00.000Z,IB FUNDS TRANSFER DR-50200023535069 -SL ICK ORGANICS PVT LTD,investments,,net_banking_transfer,-50000
61b70c1fd8beac1599eb9690,50200035187206,-172573.5,60ec419255c00300382671a5,HDFC,Internal Transfers,5eecc6d6449e4f7cfb1c2708,2020-08-06T00:00:00.000Z,IB FUNDS TRANSFER DR-50200023535069 -SL ICK ORGANICS PVT LTD,investments,,net_banking_transfer,-25000
61b70c20d8beac1599eb9696,50200035187206,-173573.5,60ec419255c00300382671a5,HDFC,Internal Transfers,5eecc6d6449e4f7cfb1c2708,2020-08-06T00:00:00.000Z,IB FUNDS TRANSFER DR-50200023535069 -SL ICK ORGANICS PVT LTD,investments,,net_banking_transfer,-1000
61b70c21d8beac1599eb969b,50200035187206,-174573.5,60ec419255c00300382671a5,HDFC,Internal Transfers,5eecc6d6449e4f7cfb1c2708,2020-08-06T00:00:00.000Z,IB FUNDS TRANSFER DR-50200023535069 -SL ICK ORGANICS PVT LTD,investments,,net_banking_transfer,-1000
61b70c22d8beac1599eb96a3,50200035187206,-175573.5,60ec419255c00300382671a5,HDFC,Internal Transfers,5eecc6d6449e4f7cfb1c2708,2020-08-06T00:00:00.000Z,IB FUNDS TRANSFER DR-50200023535069 -SL ICK ORGANICS PVT LTD,investments,,net_banking_transfer,-1000
61b70c23d8beac1599eb96aa,50200035187206,-176573.5,60ec419255c00300382671a5,HDFC,Internal Transfers,5eecc6d6449e4f7cfb1c2708,2020-08-06T00:00:00.000Z,IB FUNDS TRANSFER DR-50200023535069 -SL ICK ORGANICS PVT LTD,investments,,net_banking_transfer,-1000
61b70c24d8beac1599eb96b2,50200035187206,-176973.5,60ec419255c00300382671a5,HDFC,Internal Transfers,5eecc6d6449e4f7cfb1c2708,2020-08-06T00:00:00.000Z,IB FUNDS TRANSFER DR-50200023535069 -SL ICK ORGANICS PVT LTD,investments,,net_banking_transfer,-400
61b70c25d8beac1599eb96b7,50200035187206,-176123.5,60ec419255c00300382671a5,HDFC,Transfer in/Revenue-other,5eecc6d6449e4f7cfb1c2708,2020-08-07T00:00:00.000Z,INT. ON SWCR ON-50300426750615,,,Other,850
61b70c26d8beac1599eb96bb,50200035187206,-78549.5,60ec419255c00300382671a5,HDFC,Loan-in,5eecc6d6449e4f7cfb1c2708,2020-08-07T00:00:00.000Z,SWEEP-IN CREDIT - 50300426750615,,,self_transfer,97574
61b70c27d8beac1599eb96c1,50200035187206,-78114.5,60ec419255c00300382671a5,HDFC,Transfer in/Revenue-other,5eecc6d6449e4f7cfb1c2708,2020-08-07T00:00:00.000Z,INT. ON SWCR ON-50300426750615,,,Other,435
61b70c28d8beac1599eb96c5,50200035187206,-28114.5,60ec419255c00300382671a5,HDFC,Loan-in,5eecc6d6449e4f7cfb1c2708,2020-08-07T00:00:00.000Z,SWEEP-IN CREDIT - 50300426750615,,,self_transfer,50000
61b70c29d8beac1599eb96cd,50200035187206,-27896.5,60ec419255c00300382671a5,HDFC,Transfer in/Revenue-other,5eecc6d6449e4f7cfb1c2708,2020-08-07T00:00:00.000Z,INT. ON SWCR ON-50300426750615,,,Other,218
61b70c2ad8beac1599eb96d4,50200035187206,-2896.5,60ec419255c00300382671a5,HDFC,Loan-in,5eecc6d6449e4f7cfb1c2708,2020-08-07T00:00:00.000Z,SWEEP-IN CREDIT - 50300426750615,,,self_transfer,25000
61b70c2bd8beac1599eb96d7,50200035187206,-2887.5,60ec419255c00300382671a5,HDFC,Transfer in/Revenue-other,5eecc6d6449e4f7cfb1c2708,2020-08-07T00:00:00.000Z,INT. ON SWCR ON-50300426750615,,,Other,9
61b70c2cd8beac1599eb96e6,50200035187206,-1887.5,60ec419255c00300382671a5,HDFC,Loan-in,5eecc6d6449e4f7cfb1c2708,2020-08-07T00:00:00.000Z,SWEEP-IN CREDIT - 50300426750615,,,self_transfer,1000
61b70c2dd8beac1599eb96f8,50200035187206,-1878.5,60ec419255c00300382671a5,HDFC,Transfer in/Revenue-other,5eecc6d6449e4f7cfb1c2708,2020-08-07T00:00:00.000Z,INT. ON SWCR ON-50300426750615,,,Other,9
61b70c2ed8beac1599eb970b,50200035187206,-878.5,60ec419255c00300382671a5,HDFC,Loan-in,5eecc6d6449e4f7cfb1c2708,2020-08-07T00:00:00.000Z,SWEEP-IN CREDIT - 50300426750615,,,self_transfer,1000
61b70c2fd8beac1599eb9718,50200035187206,-870.5,60ec419255c00300382671a5,HDFC,Transfer in/Revenue-other,5eecc6d6449e4f7cfb1c2708,2020-08-07T00:00:00.000Z,INT. ON SWCR ON-50300426750615,,,Other,8
61b70c30d8beac1599eb9721,50200035187206,8.5,60ec419255c00300382671a5,HDFC,Loan-in,5eecc6d6449e4f7cfb1c2708,2020-08-07T00:00:00.000Z,SWEEP-IN CREDIT - 50300426750615,,,self_transfer,879
61b70c31d8beac1599eb972c,50200035187206,-1574.5,60ec419255c00300382671a5,HDFC,Internal Transfers,5eecc6d6449e4f7cfb1c2708,2020-08-07T00:00:00.000Z,IB FUNDS TRANSFER DR-50200023535069 -SL ICK ORGANICS PVT LTD,investments,,net_banking_transfer,-1583
61b70c32d8beac1599eb9734,50200035187206,-1560.5,60ec419255c00300382671a5,HDFC,Transfer in/Revenue-other,5eecc6d6449e4f7cfb1c2708,2020-08-08T00:00:00.000Z,INT. ON SWCR ON-50300426750615,,,Other,14
61b70c33d8beac1599eb973b,50200035187206,14.5,60ec419255c00300382671a5,HDFC,Loan-in,5eecc6d6449e4f7cfb1c2708,2020-08-08T00:00:00.000Z,SWEEP-IN CREDIT - 50300426750615,,,self_transfer,1575
61b70c34d8beac1599eb974a,50200035187206,-5.5,60ec419255c00300382671a5,HDFC,Internal Transfers,5eecc6d6449e4f7cfb1c2708,2020-08-10T00:00:00.000Z,IB FUNDS TRANSFER DR-50200023535069 -SL ICK ORGANICS PVT LTD,investments,,net_banking_transfer,-20
61b70c35d8beac1599eb974f,50200035187206,0.5,60ec419255c00300382671a5,HDFC,Loan-in,5eecc6d6449e4f7cfb1c2708,2020-08-11T00:00:00.000Z,SWEEP-IN CREDIT - 50300426750615,,,self_transfer,6
61b70c36d8beac1599eb9758,50200035187206,-2.5,60ec419255c00300382671a5,HDFC,Internal Transfers,5eecc6d6449e4f7cfb1c2708,2020-08-11T00:00:00.000Z,IB FUNDS TRANSFER DR-50200023535069 -SL ICK ORGANICS PVT LTD,investments,,net_banking_transfer,-3
61b70c37d8beac1599eb9761,50200035187206,0.5,60ec419255c00300382671a5,HDFC,Loan-in,5eecc6d6449e4f7cfb1c2708,2020-08-12T00:00:00.000Z,SWEEP-IN CREDIT - 50300426750615,,,self_transfer,3
61b70c38d8beac1599eb9768,50200035187206,10000.5,60ec419255c00300382671a5,HDFC,Internal Transfers,5eecc6d6449e4f7cfb1c2708,2020-08-14T00:00:00.000Z,IB FUNDS TRANSFER CR-50200023535069 -SL ICK ORGANICS PVT LTD,investments,,Other,10000
61b70c39d8beac1599eb976f,50200035187206,1010000.5,60ec419255c00300382671a5,HDFC,Transfer in/Revenue-other,5eecc6d6449e4f7cfb1c2708,2020-08-19T00:00:00.000Z,NEFT CR-HSBC0400004-MR ROHAN INAYAT VAZI RALLI-M/S. SLICK ORGANICS PVT LTD-HSBCN2 0232178219,,self_transfer,net_banking_transfer,1000000
61b70c3ad8beac1599eb9776,50200035187206,1007876.5,60ec419255c00300382671a5,HDFC,Tax,5eecc6d6449e4f7cfb1c2708,2020-08-19T00:00:00.000Z,AQB SER CHGS INC GST JAN-MAR2020-MIR2023 195455550,,,Other,-2124
61b70c3ad8beac1599eb977b,50200035187206,507876.5,60ec419255c00300382671a5,HDFC,Internal Transfers,5eecc6d6449e4f7cfb1c2708,2020-09-01T00:00:00.000Z,IB FUNDS TRANSFER DR-50200023535069 -SL ICK ORGANICS PVT LTD,investments,,net_banking_transfer,-500000
61b70c3cd8beac1599eb9785,50200035187206,307876.5,60ec419255c00300382671a5,HDFC,Internal Transfers,5eecc6d6449e4f7cfb1c2708,2020-09-03T00:00:00.000Z,IB FUNDS TRANSFER DR-50200023535069 -SL ICK ORGANICS PVT LTD,investments,,net_banking_transfer,-200000
61b70c3dd8beac1599eb978d,50200035187206,107876.5,60ec419255c00300382671a5,HDFC,Internal Transfers,5eecc6d6449e4f7cfb1c2708,2020-09-15T00:00:00.000Z,IMPS-025913102939-PAYTM-PYTM-XXXXXXXX383 9-200000,ewallet,,net_banking_transfer,-200000
61b70c3ed8beac1599eb9795,50200035187206,2112852.35,60ec419255c00300382671a5,HDFC,Internal Transfers,5eecc6d6449e4f7cfb1c2708,2020-09-15T00:00:00.000Z,FT - CR - 02711930004579 - DHRUV BHASIN,,,Other,2004975.85
61b70c3fd8beac1599eb97a2,50200035187206,1312852.35,60ec419255c00300382671a5,HDFC,direct expenses,5eecc6d6449e4f7cfb1c2708,2020-09-15T00:00:00.000Z,"NEFT DR-PYTM0123456-PAYTM-NETBANK, MUM-N 259201245409306-800000",ewallet,,net_banking_transfer,-800000
61b70c40d8beac1599eb97a9,50200035187206,1112852.35,60ec419255c00300382671a5,HDFC,direct expenses,5eecc6d6449e4f7cfb1c2708,2020-09-15T00:00:00.000Z,IMPS-025915165489-PAYTM-PYTM-XXXXXXXX383 9-200000,ewallet,,net_banking_transfer,-200000
61b70c41d8beac1599eb97b3,50200035187206,912852.35,60ec419255c00300382671a5,HDFC,direct expenses,5eecc6d6449e4f7cfb1c2708,2020-09-15T00:00:00.000Z,IMPS-025915165788-PAYTM-PYTM-XXXXXXXX383 9-200000,ewallet,,net_banking_transfer,-200000
61b70c41d8beac1599eb97b9,50200035187206,712852.35,60ec419255c00300382671a5,HDFC,direct expenses,5eecc6d6449e4f7cfb1c2708,2020-09-15T00:00:00.000Z,IMPS-025915166645-PAYTM-PYTM-XXXXXXXX383 9-200000,ewallet,,net_banking_transfer,-200000
61b70c42d8beac1599eb97c7,50200035187206,1715340.27,60ec419255c00300382671a5,HDFC,Investments-New,5eecc6d6449e4f7cfb1c2708,2020-09-15T00:00:00.000Z,FT - CR - 50100216436008 - DHRUV MADHOK,,,Other,1002487.92
61b70c43d8beac1599eb97cf,50200035187206,2515340.27,60ec419255c00300382671a5,HDFC,Transfer in/Revenue-other,5eecc6d6449e4f7cfb1c2708,2020-09-15T00:00:00.000Z,NEFT CR-PYTM0000001-ARATA-SLICK ORGANICS PVT LTD-PYTMH20259054700,investments,,net_banking_transfer,800000
61b70c44d8beac1599eb97d7,50200035187206,115340.27,60ec419255c00300382671a5,HDFC,Internal Transfers,5eecc6d6449e4f7cfb1c2708,2020-09-16T00:00:00.000Z,IB FUNDS TRANSFER DR-50200023535069 -SL ICK ORGANICS PVT LTD,investments,,net_banking_transfer,-2400000
61b70c45d8beac1599eb97dd,50200035187206,1117828.19,60ec419255c00300382671a5,HDFC,Transfer in/Revenue-other,5eecc6d6449e4f7cfb1c2708,2020-09-16T00:00:00.000Z,NEFT CR-HSBC0400004-MR ROHAN INAYAT VAZI RALLI-M/S. SLICK ORGANICS PVT LTD-HSBCN2 0260912945,,self_transfer,net_banking_transfer,1002487.92
61b70c46d8beac1599eb97e5,50200035187206,417828.19,60ec419255c00300382671a5,HDFC,Internal Transfers,5eecc6d6449e4f7cfb1c2708,2020-09-21T00:00:00.000Z,IB FUNDS TRANSFER DR-50200023535069 -SL ICK ORGANICS PVT LTD,investments,,net_banking_transfer,-700000
61b70c47d8beac1599eb97ea,50200035187206,10420755.16,60ec419255c00300382671a5,HDFC,Transfer in/Revenue-other,5eecc6d6449e4f7cfb1c2708,2020-09-22T00:00:00.000Z,FT - CR - 05421050007790 - NIKHIL KISHOR E VORA,,,Other,10002926.97
61b70c48d8beac1599eb97f0,50200035187206,420755.16,60ec419255c00300382671a5,HDFC,direct expenses,5eecc6d6449e4f7cfb1c2708,2020-09-23T00:00:00.000Z,FD BOOKED - 50300462137427 : SLICK ORGAN ICS PVT LTD,investments,,investment,-10000000
61b70c49d8beac1599eb97f3,50200035187206,920755.16,60ec419255c00300382671a5,HDFC,Transfer in/Revenue-other,5eecc6d6449e4f7cfb1c2708,2020-09-23T00:00:00.000Z,RTGS CR-ICIC0000104-NIMISHA-SLICK ORGANI CS PRIVATE LIMITED-ICICR1202009230067275 4,investments,,net_banking_transfer,500000
61b70c4ad8beac1599eb97ff,50200035187206,1420755.16,60ec419255c00300382671a5,HDFC,Transfer in/Revenue-other,5eecc6d6449e4f7cfb1c2708,2020-09-23T00:00:00.000Z,NEFT CR-ICIC0SF0002-NIMISHA M.NAGARSEKAR /MANISH C NAGARSEKAR-SLICK ORGANICS PRIV ATE LIMITED-2080861484,investments,,net_banking_transfer,500000
61b70c4bd8beac1599eb9803,50200035187206,3923316.22,60ec419255c00300382671a5,HDFC,Transfer in/Revenue-other,5eecc6d6449e4f7cfb1c2708,2020-09-23T00:00:00.000Z,NEFT CR-SBIN0000219-ROHIT REAL ESTATES P RIVATE LTD-SLICK ORGANICS PVT LTD-SBIN52 0267030900,investments,,net_banking_transfer,2502561.06
61b70c4cd8beac1599eb9809,50200035187206,3623316.22,60ec419255c00300382671a5,HDFC,direct expenses,5eecc6d6449e4f7cfb1c2708,2020-09-23T00:00:00.000Z,NEFT DR-ICIC0003430-HASHTAG ORANGE ADVER,,,net_banking_transfer,-300000
61b70c4dd8beac1599eb980e,50200035187206,3923316.22,60ec419255c00300382671a5,HDFC,Internal Transfers,5eecc6d6449e4f7cfb1c2708,2020-09-24T00:00:00.000Z,IB FUNDS TRANSFER CR-50200023535069 -SL ICK ORGANICS PVT LTD,investments,,Other,300000
61b70c4ed8beac1599eb9813,50200035187206,3925804.22,60ec419255c00300382671a5,HDFC,Transfer in/Revenue-other,5eecc6d6449e4f7cfb1c2708,2020-09-24T00:00:00.000Z,NEFT CR-ICIC0SF0002-NIMISHA M.NAGARSEKAR /MANISH C NAGARSEKAR-SLICK ORGANICS PRIV ATE LIMITED-2081338131,investments,,net_banking_transfer,2488
61b70c4fd8beac1599eb981a,50200035187206,4928292.15,60ec419255c00300382671a5,HDFC,Transfer in/Revenue-other,5eecc6d6449e4f7cfb1c2708,2020-09-24T00:00:00.000Z,RTGS CR-KKBK0000958-SWATI MEHRA-SLICK OR GANICS PRIVATE LIMITED-KKBKR520200924007 51438,investments,,net_banking_transfer,1002487.93
61b70c50d8beac1599eb9820,50200035187206,6428365.3,60ec419255c00300382671a5,HDFC,Transfer in/Revenue-other,5eecc6d6449e4f7cfb1c2708,2020-09-24T00:00:00.000Z,00141000070245-FROM PRADYUMNA DALMIA,,,Other,1500073.15
61b70c51d8beac1599eb9825,50200035187206,8928365.3,60ec419255c00300382671a5,HDFC,Transfer in/Revenue-other,5eecc6d6449e4f7cfb1c2708,2020-09-24T00:00:00.000Z,RTGS CR-RATN0000070-GRASSY COMMERCIAL PV T LTD-SLICK ORGANICS PVT LTD-RATNR520200 92400429894,investments,,net_banking_transfer,2500000
61b70c52d8beac1599eb9829,50200035187206,8930926.36,60ec419255c00300382671a5,HDFC,cash/cheque deposit/transfer in,5eecc6d6449e4f7cfb1c2708,2020-09-25T00:00:00.000Z,CHQ DEP MICR 08-MUM CLG - MICR CLG - MUM : GRASSY COMMERCIAL PVT LTD :RBL BANK LT D,,,chq,2561.06
61b70c53d8beac1599eb982c,50200035187206,9933414.36,60ec419255c00300382671a5,HDFC,Transfer in/Revenue-other,5eecc6d6449e4f7cfb1c2708,2020-09-25T00:00:00.000Z,FT - CR - 00081840001218 - CHIRAG JAIN,,,Other,1002488
61b70c54d8beac1599eb983a,50200035187206,9933396.66,60ec419255c00300382671a5,HDFC,direct expenses,5eecc6d6449e4f7cfb1c2708,2020-09-28T00:00:00.000Z,.IMPS P2P 025913102939#15/09/2020 150920 -CDT2026301327187,,,net_banking_transfer,-17.7
61b70c55d8beac1599eb9844,50200035187206,9933378.96,60ec419255c00300382671a5,HDFC,direct expenses,5eecc6d6449e4f7cfb1c2708,2020-09-28T00:00:00.000Z,.IMPS P2P 025915165489#15/09/2020 150920 -CDT2026301327187,,,net_banking_transfer,-17.7
61b70c56d8beac1599eb9849,50200035187206,9933361.26,60ec419255c00300382671a5,HDFC,direct expenses,5eecc6d6449e4f7cfb1c2708,2020-09-28T00:00:00.000Z,.IMPS P2P 025915165788#15/09/2020 150920 -CDT2026301327187,,,net_banking_transfer,-17.7
61b70c57d8beac1599eb984f,50200035187206,9933343.56,60ec419255c00300382671a5,HDFC,direct expenses,5eecc6d6449e4f7cfb1c2708,2020-09-28T00:00:00.000Z,.IMPS P2P 025915166645#15/09/2020 150920,,,net_banking_transfer,-17.7
61b70c58d8beac1599eb9852,50200035187206,8933343.56,60ec419255c00300382671a5,HDFC,Internal Transfers,5eecc6d6449e4f7cfb1c2708,2020-10-01T00:00:00.000Z,IB FUNDS TRANSFER DR-50200023535069 -SL ICK ORGANICS PVT LTD,investments,,net_banking_transfer,-1000000
61b70c59d8beac1599eb9858,50200035187206,7933343.56,60ec419255c00300382671a5,HDFC,Internal Transfers,5eecc6d6449e4f7cfb1c2708,2020-10-03T00:00:00.000Z,IB FUNDS TRANSFER DR-50200023535069 -SL ICK ORGANICS PVT LTD,investments,,net_banking_transfer,-1000000
61b70c5ad8beac1599eb9861,50200035187206,7433343.56,60ec419255c00300382671a5,HDFC,Internal Transfers,5eecc6d6449e4f7cfb1c2708,2020-10-07T00:00:00.000Z,IB FUNDS TRANSFER DR-50200023535069 -SL ICK ORGANICS PVT LTD,investments,,net_banking_transfer,-500000
61b70c5bd8beac1599eb9868,50200035187206,433343.56,60ec419255c00300382671a5,HDFC,direct expenses,5eecc6d6449e4f7cfb1c2708,2020-10-14T00:00:00.000Z,FD BOOKED - 50300467578921 : SLICK ORGAN ICS PVT LTD,investments,,investment,-7000000
61b70c5cd8beac1599eb986e,50200035187206,33343.56,60ec419255c00300382671a5,HDFC,Internal Transfers,5eecc6d6449e4f7cfb1c2708,2020-10-14T00:00:00.000Z,IB FUNDS TRANSFER DR-50200023535069 -SL ICK ORGANICS PVT LTD,investments,,net_banking_transfer,-400000
61b70c5dd8beac1599eb9873,50200035187206,-166656.44,60ec419255c00300382671a5,HDFC,Internal Transfers,5eecc6d6449e4f7cfb1c2708,2020-10-23T00:00:00.000Z,IB FUNDS TRANSFER DR-50200023535069 -SL ICK ORGANICS PVT LTD,investments,,net_banking_transfer,-200000
61b70c5ed8beac1599eb987e,50200035187206,-366656.44,60ec419255c00300382671a5,HDFC,Internal Transfers,5eecc6d6449e4f7cfb1c2708,2020-10-23T00:00:00.000Z,IB FUNDS TRANSFER DR-50200023535069 -SL ICK ORGANICS PVT LTD,investments,,net_banking_transfer,-200000
61b70c5fd8beac1599eb988b,50200035187206,-366595.44,60ec419255c00300382671a5,HDFC,Transfer in/Revenue-other,5eecc6d6449e4f7cfb1c2708,2020-10-24T00:00:00.000Z,INT. ON SWCR ON-50300467578921,,,Other,61
61b70c60d8beac1599eb9893,50200035187206,-199938.44,60ec419255c00300382671a5,HDFC,Loan-in,5eecc6d6449e4f7cfb1c2708,2020-10-24T00:00:00.000Z,SWEEP-IN CREDIT - 50300467578921,,,self_transfer,166657
61b70c61d8beac1599eb9899,50200035187206,-199864.44,60ec419255c00300382671a5,HDFC,Transfer in/Revenue-other,5eecc6d6449e4f7cfb1c2708,2020-10-24T00:00:00.000Z,INT. ON SWCR ON-50300467578921,,,Other,74
61b70c62d8beac1599eb98a1,50200035187206,74.56,60ec419255c00300382671a5,HDFC,Loan-in,5eecc6d6449e4f7cfb1c2708,2020-10-24T00:00:00.000Z,SWEEP-IN CREDIT - 50300467578921,,,self_transfer,199939
61b70c63d8beac1599eb98a8,50200035187206,-999925.44,60ec419255c00300382671a5,HDFC,Internal Transfers,5eecc6d6449e4f7cfb1c2708,2020-11-01T00:00:00.000Z,IB FUNDS TRANSFER DR-50200023535069 -SL ICK ORGANICS PVT LTD,investments,,net_banking_transfer,-1000000
61b70c64d8beac1599eb98ac,50200035187206,-999187.44,60ec419255c00300382671a5,HDFC,Transfer in/Revenue-other,5eecc6d6449e4f7cfb1c2708,2020-11-01T00:00:00.000Z,INT. ON SWCR ON-50300467578921,,,Other,738
61b70c65d8beac1599eb98b1,50200035187206,738.56,60ec419255c00300382671a5,HDFC,Loan-in,5eecc6d6449e4f7cfb1c2708,2020-11-01T00:00:00.000Z,SWEEP-IN CREDIT - 50300467578921,,,self_transfer,999926
61b70c66d8beac1599eb98b7,50200035187206,-999261.44,60ec419255c00300382671a5,HDFC,Internal Transfers,5eecc6d6449e4f7cfb1c2708,2020-11-02T00:00:00.000Z,IB FUNDS TRANSFER DR-50200023535069 -SL ICK ORGANICS PVT LTD,investments,,net_banking_transfer,-1000000
61b70c67d8beac1599eb98ba,50200035187206,-1199261.44,60ec419255c00300382671a5,HDFC,Internal Transfers,5eecc6d6449e4f7cfb1c2708,2020-11-02T00:00:00.000Z,IB FUNDS TRANSFER DR-50200023535069 -SL ICK ORGANICS PVT LTD,investments,,net_banking_transfer,-200000
61b70c68d8beac1599eb98c2,50200035187206,-1299261.44,60ec419255c00300382671a5,HDFC,Internal Transfers,5eecc6d6449e4f7cfb1c2708,2020-11-02T00:00:00.000Z,IB FUNDS TRANSFER DR-50200023535069 -SL ICK ORGANICS PVT LTD,investments,,net_banking_transfer,-100000
61b70c69d8beac1599eb98c7,50200035187206,-1298483.44,60ec419255c00300382671a5,HDFC,Transfer in/Revenue-other,5eecc6d6449e4f7cfb1c2708,2020-11-03T00:00:00.000Z,INT. ON SWCR ON-50300467578921,,,Other,778
61b70c6ad8beac1599eb98cc,50200035187206,-299221.44,60ec419255c00300382671a5,HDFC,Loan-in,5eecc6d6449e4f7cfb1c2708,2020-11-03T00:00:00.000Z,SWEEP-IN CREDIT - 50300467578921,,,self_transfer,999262
61b70c6bd8beac1599eb98d2,50200035187206,-299065.44,60ec419255c00300382671a5,HDFC,Transfer in/Revenue-other,5eecc6d6449e4f7cfb1c2708,2020-11-03T00:00:00.000Z,INT. ON SWCR ON-50300467578921,,,Other,156
61b70c6cd8beac1599eb98d6,50200035187206,-99065.44,60ec419255c00300382671a5,HDFC,Loan-in,5eecc6d6449e4f7cfb1c2708,2020-11-03T00:00:00.000Z,SWEEP-IN CREDIT - 50300467578921,,,self_transfer,200000
61b70c6dd8beac1599eb98dc,50200035187206,-98988.44,60ec419255c00300382671a5,HDFC,Transfer in/Revenue-other,5eecc6d6449e4f7cfb1c2708,2020-11-03T00:00:00.000Z,INT. ON SWCR ON-50300467578921,,,Other,77
61b70c6ed8beac1599eb98e0,50200035187206,77.56,60ec419255c00300382671a5,HDFC,Loan-in,5eecc6d6449e4f7cfb1c2708,2020-11-03T00:00:00.000Z,SWEEP-IN CREDIT - 50300467578921,,,self_transfer,99066
61b70c6fd8beac1599eb98e5,50200035187206,-199922.44,60ec419255c00300382671a5,HDFC,Internal Transfers,5eecc6d6449e4f7cfb1c2708,2020-11-04T00:00:00.000Z,IB FUNDS TRANSFER DR-50200023535069 -SL ICK ORGANICS PVT LTD,investments,,net_banking_transfer,-200000
61b70c70d8beac1599eb98e9,50200035187206,-199750.44,60ec419255c00300382671a5,HDFC,Transfer in/Revenue-other,5eecc6d6449e4f7cfb1c2708,2020-11-05T00:00:00.000Z,INT. ON SWCR ON-50300467578921,,,Other,172
61b70c71d8beac1599eb98ec,50200035187206,172.56,60ec419255c00300382671a5,HDFC,Loan-in,5eecc6d6449e4f7cfb1c2708,2020-11-05T00:00:00.000Z,SWEEP-IN CREDIT - 50300467578921,,,self_transfer,199923
61b70c72d8beac1599eb98f3,50200035187206,-999827.44,60ec419255c00300382671a5,HDFC,Internal Transfers,5eecc6d6449e4f7cfb1c2708,2020-11-05T00:00:00.000Z,IB FUNDS TRANSFER DR-50200023535069 -SL ICK ORGANICS PVT LTD,investments,,net_banking_transfer,-1000000
61b70c73d8beac1599eb98f9,50200035187206,-998924.44,60ec419255c00300382671a5,HDFC,Transfer in/Revenue-other,5eecc6d6449e4f7cfb1c2708,2020-11-06T00:00:00.000Z,INT. ON SWCR ON-50300467578921,,,Other,903
61b70c74d8beac1599eb98fe,50200035187206,-1001713.85,60ec419255c00300382671a5,HDFC,direct expenses,5eecc6d6449e4f7cfb1c2708,2020-11-06T00:00:00.000Z,TDS RECOVERED ON-50300467578921,,,Other,-2789.41
61b70c75d8beac1599eb9903,50200035187206,0.15,60ec419255c00300382671a5,HDFC,Loan-in,5eecc6d6449e4f7cfb1c2708,2020-11-06T00:00:00.000Z,SWEEP-IN CREDIT - 50300467578921,,,self_transfer,1001714
61b70c76d8beac1599eb9908,50200035187206,-999999.85,60ec419255c00300382671a5,HDFC,Internal Transfers,5eecc6d6449e4f7cfb1c2708,2020-11-06T00:00:00.000Z,IB FUNDS TRANSFER DR-50200023535069 -SL ICK ORGANICS PVT LTD,investments,,net_banking_transfer,-1000000
61b70c77d8beac1599eb990d,50200035187206,-1000070.57,60ec419255c00300382671a5,HDFC,direct expenses,5eecc6d6449e4f7cfb1c2708,2020-11-07T00:00:00.000Z,TDS RECOVERED ON-50300467578921,,,Other,-70.72
61b70c78d8beac1599eb9915,50200035187206,-999127.57,60ec419255c00300382671a5,HDFC,Transfer in/Revenue-other,5eecc6d6449e4f7cfb1c2708,2020-11-07T00:00:00.000Z,INT. ON SWCR ON-50300467578921,,,Other,943
61b70c79d8beac1599eb9919,50200035187206,872.43,60ec419255c00300382671a5,HDFC,Loan-in,5eecc6d6449e4f7cfb1c2708,2020-11-07T00:00:00.000Z,SWEEP-IN CREDIT - 50300467578921,,,self_transfer,1000000
61b70c7ad8beac1599eb991e,50200035187206,-299127.57,60ec419255c00300382671a5,HDFC,Internal Transfers,5eecc6d6449e4f7cfb1c2708,2020-11-08T00:00:00.000Z,IB FUNDS TRANSFER DR-50200023535069 -SL ICK ORGANICS PVT LTD,investments,,net_banking_transfer,-300000
61b70c7bd8beac1599eb9921,50200035187206,-299150.52,60ec419255c00300382671a5,HDFC,direct expenses,5eecc6d6449e4f7cfb1c2708,2020-11-08T00:00:00.000Z,TDS RECOVERED ON-50300467578921,,,Other,-22.95
61b70c7cd8beac1599eb9926,50200035187206,-298844.52,60ec419255c00300382671a5,HDFC,Transfer in/Revenue-other,5eecc6d6449e4f7cfb1c2708,2020-11-08T00:00:00.000Z,INT. ON SWCR ON-50300467578921,,,Other,306
61b70c7dd8beac1599eb992e,50200035187206,283.48,60ec419255c00300382671a5,HDFC,Loan-in,5eecc6d6449e4f7cfb1c2708,2020-11-08T00:00:00.000Z,SWEEP-IN CREDIT - 50300467578921,,,self_transfer,299128
61b70c7ed8beac1599eb9932,50200035187206,-1799716.52,60ec419255c00300382671a5,HDFC,Internal Transfers,5eecc6d6449e4f7cfb1c2708,2020-11-12T00:00:00.000Z,IB FUNDS TRANSFER DR-50200023535069 -SL ICK ORGANICS PVT LTD,investments,,net_banking_transfer,-1800000
61b70c7fd8beac1599eb9936,50200035187206,-1799876.95,60ec419255c00300382671a5,HDFC,direct expenses,5eecc6d6449e4f7cfb1c2708,2020-11-13T00:00:00.000Z,TDS RECOVERED ON-50300467578921,,,Other,-160.43
61b70c80d8beac1599eb993d,50200035187206,-1797737.95,60ec419255c00300382671a5,HDFC,Transfer in/Revenue-other,5eecc6d6449e4f7cfb1c2708,2020-11-13T00:00:00.000Z,INT. ON SWCR ON-50300467578921,,,Other,2139
61b70c81d8beac1599eb9946,50200035187206,1979.05,60ec419255c00300382671a5,HDFC,Loan-in,5eecc6d6449e4f7cfb1c2708,2020-11-13T00:00:00.000Z,SWEEP-IN CREDIT - 50300467578921,,,self_transfer,1799717
61b70c82d8beac1599eb994e,50200035187206,-32688.95,60ec419255c00300382671a5,HDFC,Internal Transfers,5eecc6d6449e4f7cfb1c2708,2020-11-13T00:00:00.000Z,IB FUNDS TRANSFER DR-50200023535069 -SL ICK ORGANICS PVT LTD,investments,,net_banking_transfer,-34668
61b70c83d8beac1599eb9955,50200035187206,-232688.95,60ec419255c00300382671a5,HDFC,Internal Transfers,5eecc6d6449e4f7cfb1c2708,2020-11-13T00:00:00.000Z,IB FUNDS TRANSFER DR-50200023535069 -SL,,,net_banking_transfer,-200000
61b70c84d8beac1599eb995a,50200035187206,-332688.95,60ec419255c00300382671a5,HDFC,Internal Transfers,5eecc6d6449e4f7cfb1c2708,2020-11-13T00:00:00.000Z,IB FUNDS TRANSFER DR-50200023535069 -SL ICK ORGANICS PVT LTD,investments,,net_banking_transfer,-100000
61b70c85d8beac1599eb995e,50200035187206,-332691.95,60ec419255c00300382671a5,HDFC,direct expenses,5eecc6d6449e4f7cfb1c2708,2020-11-14T00:00:00.000Z,TDS RECOVERED ON-50300467578921,,,Other,-3
61b70c86d8beac1599eb9962,50200035187206,-332651.95,60ec419255c00300382671a5,HDFC,Transfer in/Revenue-other,5eecc6d6449e4f7cfb1c2708,2020-11-14T00:00:00.000Z,INT. ON SWCR ON-50300467578921,,,Other,40
61b70c87d8beac1599eb996d,50200035187206,-299962.95,60ec419255c00300382671a5,HDFC,Loan-in,5eecc6d6449e4f7cfb1c2708,2020-11-14T00:00:00.000Z,SWEEP-IN CREDIT - 50300467578921,,,self_transfer,32689
61b70c88d8beac1599eb9972,50200035187206,-299963.1,60ec419255c00300382671a5,HDFC,direct expenses,5eecc6d6449e4f7cfb1c2708,2020-11-14T00:00:00.000Z,TDS RECOVERED ON-50300467578921,,,Other,-0.15
61b70c88d8beac1599eb9977,50200035187206,-299961.1,60ec419255c00300382671a5,HDFC,Transfer in/Revenue-other,5eecc6d6449e4f7cfb1c2708,2020-11-14T00:00:00.000Z,INT. ON SWCR ON-50300467578921,,,Other,2
61b70c89d8beac1599eb997d,50200035187206,-297982.1,60ec419255c00300382671a5,HDFC,Loan-in,5eecc6d6449e4f7cfb1c2708,2020-11-14T00:00:00.000Z,SWEEP-IN CREDIT - 50300467578921,,,self_transfer,1979
61b70c8ad8beac1599eb99c1,50200035187206,-298023.5,60ec419255c00300382671a5,HDFC,direct expenses,5eecc6d6449e4f7cfb1c2708,2020-11-14T00:00:00.000Z,TDS RECOVERED ON-50300462137427,,,Other,-41.4
61b70c8bd8beac1599eb99c7,50200035187206,-297471.5,60ec419255c00300382671a5,HDFC,Transfer in/Revenue-other,5eecc6d6449e4f7cfb1c2708,2020-11-14T00:00:00.000Z,INT. ON SWCR ON-50300462137427,,,Other,552
61b70c8cd8beac1599eb99e4,50200035187206,-99450.5,60ec419255c00300382671a5,HDFC,Loan-in,5eecc6d6449e4f7cfb1c2708,2020-11-14T00:00:00.000Z,SWEEP-IN CREDIT - 50300462137427,,,self_transfer,198021
61b70c8dd8beac1599eb99ed,50200035187206,-99471.28,60ec419255c00300382671a5,HDFC,direct expenses,5eecc6d6449e4f7cfb1c2708,2020-11-14T00:00:00.000Z,TDS RECOVERED ON-50300462137427,,,Other,-20.78
61b70c8ed8beac1599eb99f0,50200035187206,-99194.28,60ec419255c00300382671a5,HDFC,Transfer in/Revenue-other,5eecc6d6449e4f7cfb1c2708,2020-11-14T00:00:00.000Z,INT. ON SWCR ON-50300462137427,,,Other,277
61b70c8fd8beac1599eb99f3,50200035187206,256.72,60ec419255c00300382671a5,HDFC,Loan-in,5eecc6d6449e4f7cfb1c2708,2020-11-14T00:00:00.000Z,SWEEP-IN CREDIT - 50300462137427,,,self_transfer,99451
61b70c90d8beac1599eb99fd,50200035187206,-2702271.28,60ec419255c00300382671a5,HDFC,Internal Transfers,5eecc6d6449e4f7cfb1c2708,2020-12-01T00:00:00.000Z,IB FUNDS TRANSFER DR-50200023535069 -SL ICK ORGANICS PVT LTD,investments,,net_banking_transfer,-2702528
61b70c91d8beac1599eb9a00,50200035187206,4798094.59,60ec419255c00300382671a5,HDFC,Transfer in/Revenue-other,5eecc6d6449e4f7cfb1c2708,2020-12-01T00:00:00.000Z,RTGS CR-RATN0000070-RBL BANK LTD-SLICK O RGANICSPRIVATE LIMITED-RATNR52020120100 520683,investments,,net_banking_transfer,7500365.87
61b70c92d8beac1599eb9a07,50200035187206,4298094.59,60ec419255c00300382671a5,HDFC,Internal Transfers,5eecc6d6449e4f7cfb1c2708,2020-12-03T00:00:00.000Z,IB FUNDS TRANSFER DR-50200023535069 -SL ICK ORGANICS PVT LTD,investments,,net_banking_transfer,-500000
61b70c93d8beac1599eb9a0d,50200035187206,4000000.59,60ec419255c00300382671a5,HDFC,Internal Transfers,5eecc6d6449e4f7cfb1c2708,2020-12-05T00:00:00.000Z,IB FUNDS TRANSFER DR-50200023535069 -SL ICK ORGANICS PVT LTD,investments,,net_banking_transfer,-298094
61b70c94d8beac1599eb9a11,50200035187206,3000000.59,60ec419255c00300382671a5,HDFC,Internal Transfers,5eecc6d6449e4f7cfb1c2708,2020-12-07T00:00:00.000Z,IB FUNDS TRANSFER DR-50200023535069 -SL ICK ORGANICS PVT LTD,investments,,net_banking_transfer,-1000000
61b70c95d8beac1599eb9a17,50200035187206,2800000.59,60ec419255c00300382671a5,HDFC,direct expenses,5eecc6d6449e4f7cfb1c2708,2020-12-11T00:00:00.000Z,02711600008220-TPT-CC-VARUN SINGH,,,net_banking_transfer,-200000
61b70c96d8beac1599eb9a1f,50200035187206,3000000.59,60ec419255c00300382671a5,HDFC,Internal Transfers,5eecc6d6449e4f7cfb1c2708,2020-12-11T00:00:00.000Z,IB FUNDS TRANSFER CR-50200023535069 -SL ICK ORGANICS PVT LTD,investments,,Other,200000
61b70c97d8beac1599eb9a23,50200035187206,2000000.59,60ec419255c00300382671a5,HDFC,Internal Transfers,5eecc6d6449e4f7cfb1c2708,2020-12-13T00:00:00.000Z,IB FUNDS TRANSFER DR-50200023535069 -SL ICK ORGANICS PVT LTD,investments,,net_banking_transfer,-1000000
61b70c98d8beac1599eb9a29,50200035187206,5000000.59,60ec419255c00300382671a5,HDFC,Investments-New,5eecc6d6449e4f7cfb1c2708,2020-12-14T00:00:00.000Z,FT - CR - 02711930004579 - DHRUV BHASIN,,,Other,3000000
61b70c99d8beac1599eb9a2e,50200035187206,4500000.59,60ec419255c00300382671a5,HDFC,Internal Transfers,5eecc6d6449e4f7cfb1c2708,2020-12-15T00:00:00.000Z,IB FUNDS TRANSFER DR-50200023535069 -SL,,,net_banking_transfer,-500000
61b70c9ad8beac1599eb9a35,50200035187206,4470000.59,60ec419255c00300382671a5,HDFC,direct expenses,5eecc6d6449e4f7cfb1c2708,2020-12-15T00:00:00.000Z,IRTT00702035460/FCGPR122067007 : MISC CO MMISSION INC TRADE FINANCE,loans,lender_transaction,Other,-30000
61b70c9bd8beac1599eb9a3b,50200035187206,4467300.59,60ec419255c00300382671a5,HDFC,Tax,5eecc6d6449e4f7cfb1c2708,2020-12-16T00:00:00.000Z,CGST-MISC COMMISSION INC TRADE FINANCE-C DT2035102341389,loans,lender_transaction,Other,-2700
61b70c9cd8beac1599eb9a40,50200035187206,4464600.59,60ec419255c00300382671a5,HDFC,Tax,5eecc6d6449e4f7cfb1c2708,2020-12-16T00:00:00.000Z,SGST-MISC COMMISSION INC TRADE FINANCE-C DT2035102341389,loans,lender_transaction,Other,-2700
61b70c9dd8beac1599eb9a51,50200035187206,4455019.27,60ec419255c00300382671a5,HDFC,direct expenses,5eecc6d6449e4f7cfb1c2708,2020-12-23T00:00:00.000Z,TAX RECOVERY FOR TD A/C 50300462137427 : DEPOSIT NO.1 50300462137427,,,Other,-9581.32
61b70c9ed8beac1599eb9a56,50200035187206,4582875.27,60ec419255c00300382671a5,HDFC,interest income,5eecc6d6449e4f7cfb1c2708,2020-12-23T00:00:00.000Z,QUARTERLY INTEREST CREDIT 50300462137427,,,Other,127856
61b70c9fd8beac1599eb9a5c,50200035187206,4482875.27,60ec419255c00300382671a5,HDFC,direct expenses,5eecc6d6449e4f7cfb1c2708,2020-12-25T00:00:00.000Z,"NEFT DR-ORBC0101001-KRAUTER HEALTHCARE L TD-NETBANK, MUM-N360201351528589-ABC",,,net_banking_transfer,-100000
61b70ca0d8beac1599eb9a60,50200035187206,4582875.27,60ec419255c00300382671a5,HDFC,Internal Transfers,5eecc6d6449e4f7cfb1c2708,2020-12-26T00:00:00.000Z,IB FUNDS TRANSFER CR-50200023535069 -SL ICK ORGANICS PVT LTD,investments,,Other,100000
61b70ca1d8beac1599eb9a65,50200035187206,4512035.27,60ec419255c00300382671a5,HDFC,direct expenses,5eecc6d6449e4f7cfb1c2708,2021-01-05T00:00:00.000Z,GLBFOKG6IVG00A/RAZPCREDCLUB,bills,,Other,-70840
61b70ca2d8beac1599eb9a6b,50200035187206,4582875.27,60ec419255c00300382671a5,HDFC,Internal Transfers,5eecc6d6449e4f7cfb1c2708,2021-01-07T00:00:00.000Z,IB FUNDS TRANSFER CR-50200023535069 -SL ICK ORGANICS PVT LTD,investments,,Other,70840
61b70ca3d8beac1599eb9a77,50200035187206,3582875.27,60ec419255c00300382671a5,HDFC,Internal Transfers,5eecc6d6449e4f7cfb1c2708,2021-01-11T00:00:00.000Z,IB FUNDS TRANSFER DR-50200023535069 -SL ICK ORGANICS PVT LTD,investments,,net_banking_transfer,-1000000
61b70ca4d8beac1599eb9a89,50200035187206,5082948.27,60ec419255c00300382671a5,HDFC,cash/cheque deposit/transfer in,5eecc6d6449e4f7cfb1c2708,2021-01-15T00:00:00.000Z,CHQ DEP - TRANSFER OW 1 - NOIDA WBO,,,chq,1500073
61b70ca5d8beac1599eb9a9d,50200035187206,4647948.27,60ec419255c00300382671a5,HDFC,Internal Transfers,5eecc6d6449e4f7cfb1c2708,2021-01-19T00:00:00.000Z,IB FUNDS TRANSFER DR-50200023535069 -SL ICK ORGANICS PVT LTD,investments,,net_banking_transfer,-435000
61b70ca6d8beac1599eb9aaa,50200035187206,4577948.27,60ec419255c00300382671a5,HDFC,direct expenses,5eecc6d6449e4f7cfb1c2708,2021-02-10T00:00:00.000Z,"NEFT DR-YESB0000162-VINAY REDDY-NETBANK, MUM-N041211402075177-ADV",,,net_banking_transfer,-70000
61b70ca7d8beac1599eb9ab7,50200035187206,4647948.27,60ec419255c00300382671a5,HDFC,Internal Transfers,5eecc6d6449e4f7cfb1c2708,2021-02-10T00:00:00.000Z,IB FUNDS TRANSFER CR-50200023535069 -SL ICK ORGANICS PVT LTD,investments,,Other,70000
61b70ca8d8beac1599eb9ac5,50200035187206,147948.27,60ec419255c00300382671a5,HDFC,direct expenses,5eecc6d6449e4f7cfb1c2708,2021-02-22T00:00:00.000Z,FD BOOKED - 50300498261567 : SLICK ORGAN ICS PVT LTD,investments,,investment,-4500000
61b70ca9d8beac1599eb9ad1,50200035187206,156226.44,60ec419255c00300382671a5,HDFC,Revenue-PG-non-split,5eecc6d6449e4f7cfb1c2708,2021-03-01T00:00:00.000Z,NEFT CR-IDFB0010204-SEZZLE PAYMENTS PRIV,,,net_banking_transfer,8278.17
61b70caad8beac1599eb9ad8,50200035187206,158533.02,60ec419255c00300382671a5,HDFC,Revenue-PG-non-split,5eecc6d6449e4f7cfb1c2708,2021-03-02T00:00:00.000Z,NEFT CR-IDFB0010204-SEZZLE PAYMENTS PRIV ATE LIMITED-SLICK ORGANICS PRIVATE LIMIT ED-IDFBH21061430813,investments,,net_banking_transfer,2306.58
61b70cabd8beac1599eb9ae0,50200035187206,149025.8,60ec419255c00300382671a5,HDFC,direct expenses,5eecc6d6449e4f7cfb1c2708,2021-03-23T00:00:00.000Z,TAX RECOVERY FOR TD A/C 50300462137427 : DEPOSIT NO.1 50300462137427,,,Other,-9507.22
61b70cacd8beac1599eb9aea,50200035187206,275788.8,60ec419255c00300382671a5,HDFC,interest income,5eecc6d6449e4f7cfb1c2708,2021-03-23T00:00:00.000Z,QUARTERLY INTEREST CREDIT 50300462137427,,,Other,126763
61b70cadd8beac1599eb9aee,50200035187206,274837.8,60ec419255c00300382671a5,HDFC,direct expenses,5eecc6d6449e4f7cfb1c2708,2021-04-01T00:00:00.000Z,TAX RECOVERY FOR TD A/C 50300462137427,,,Other,-951
61b70caed8beac1599eb9b01,50200035187206,49837.8,60ec419255c00300382671a5,HDFC,Internal Transfers,5eecc6d6449e4f7cfb1c2708,2021-04-09T00:00:00.000Z,IB FUNDS TRANSFER DR-50200023535069 -SL ICK ORGANICS PVT LTD,investments,,net_banking_transfer,-225000
61b70cafd8beac1599eb9b08,50200035187206,-750162.2,60ec419255c00300382671a5,HDFC,Internal Transfers,5eecc6d6449e4f7cfb1c2708,2021-04-20T00:00:00.000Z,IB FUNDS TRANSFER DR-50200023535069 -SL ICK ORGANICS PVT LTD,investments,,net_banking_transfer,-800000
61b70cb0d8beac1599eb9b0f,50200035187206,-748120.85,60ec419255c00300382671a5,HDFC,Transfer in/Revenue-other,5eecc6d6449e4f7cfb1c2708,2021-04-21T00:00:00.000Z,INT. ON SWCR ON-50300498261567,,,Other,2041.35
61b70cb1d8beac1599eb9b15,50200035187206,2042.15,60ec419255c00300382671a5,HDFC,Loan-in,5eecc6d6449e4f7cfb1c2708,2021-04-21T00:00:00.000Z,SWEEP-IN CREDIT - 50300498261567,,,self_transfer,750163
61b70cb4d8beac1599eb9b2b,50200035187206,2042.15,60ec419255c00300382671a5,HDFC,Transfer in/Revenue-other,5eecc6d6449e4f7cfb1c2708,2021-04-21T00:00:00.000Z,INT. ON SWCR ON-50300498261567,,,Other,2041.35
61b70cb5d8beac1599eb9b34,50200035187206,0.8,60ec419255c00300382671a5,HDFC,Loan-in,5eecc6d6449e4f7cfb1c2708,2021-04-21T00:00:00.000Z,SWEEP-IN CREDIT - 50300498261567,,,self_transfer,750163
61b70cb6d8beac1599eb9b3b,50200035187206,-97957.85,60ec419255c00300382671a5,HDFC,Internal Transfers,5eecc6d6449e4f7cfb1c2708,2021-05-06T00:00:00.000Z,IB FUNDS TRANSFER DR-50200023535069 -SL ICK ORGANICS PVT LTD,investments,,net_banking_transfer,-100000
61b70cb7d8beac1599eb9b40,50200035187206,-197957.85,60ec419255c00300382671a5,HDFC,Internal Transfers,5eecc6d6449e4f7cfb1c2708,2021-05-06T00:00:00.000Z,IB FUNDS TRANSFER DR-50200023535069 -SL ICK ORGANICS PVT LTD,investments,,net_banking_transfer,-100000
61b70cb8d8beac1599eb9b47,50200035187206,-99647.24,60ec419255c00300382671a5,HDFC,Transfer in/Revenue-other,5eecc6d6449e4f7cfb1c2708,2021-05-07T00:00:00.000Z,INT. ON SWCR ON-50300498261567,,,Other,352.61
61b70cb9d8beac1599eb9b50,50200035187206,-99999.85,60ec419255c00300382671a5,HDFC,Loan-in,5eecc6d6449e4f7cfb1c2708,2021-05-07T00:00:00.000Z,SWEEP-IN CREDIT - 50300498261567,,,self_transfer,97958
61b70cbad8beac1599eb9b56,50200035187206,-99288.31,60ec419255c00300382671a5,HDFC,Transfer in/Revenue-other,5eecc6d6449e4f7cfb1c2708,2021-05-07T00:00:00.000Z,INT. ON SWCR ON-50300498261567,,,Other,358.93
61b70cbbd8beac1599eb9b5e,50200035187206,359.69,60ec419255c00300382671a5,HDFC,Loan-in,5eecc6d6449e4f7cfb1c2708,2021-05-07T00:00:00.000Z,SWEEP-IN CREDIT - 50300498261567,,,self_transfer,99648
61b70cbcd8beac1599eb9b68,50200035187206,-999640.31,60ec419255c00300382671a5,HDFC,Internal Transfers,5eecc6d6449e4f7cfb1c2708,2021-05-07T00:00:00.000Z,IB FUNDS TRANSFER DR-50200023535069 -SL ICK ORGANICS PVT LTD,investments,,net_banking_transfer,-1000000
61b70cbdd8beac1599eb9b73,50200035187206,-1999640.31,60ec419255c00300382671a5,HDFC,Internal Transfers,5eecc6d6449e4f7cfb1c2708,2021-05-07T00:00:00.000Z,IB FUNDS TRANSFER DR-50200023535069 -SL ICK ORGANICS PVT LTD,investments,,net_banking_transfer,-1000000
61b70cbed8beac1599eb9b7b,50200035187206,-996348.28,60ec419255c00300382671a5,HDFC,Transfer in/Revenue-other,5eecc6d6449e4f7cfb1c2708,2021-05-08T00:00:00.000Z,INT. ON SWCR ON-50300498261567,,,Other,3651.03
61b70cbfd8beac1599eb9b85,50200035187206,-999999.31,60ec419255c00300382671a5,HDFC,Loan-in,5eecc6d6449e4f7cfb1c2708,2021-05-08T00:00:00.000Z,SWEEP-IN CREDIT - 50300498261567,,,self_transfer,999641
61b70cc0d8beac1599eb9b92,50200035187206,-992708.93,60ec419255c00300382671a5,HDFC,Transfer in/Revenue-other,5eecc6d6449e4f7cfb1c2708,2021-05-08T00:00:00.000Z,INT. ON SWCR ON-50300498261567,,,Other,3639.35
61b70cc1d8beac1599eb9b95,50200035187206,3640.07,60ec419255c00300382671a5,HDFC,Loan-in,5eecc6d6449e4f7cfb1c2708,2021-05-08T00:00:00.000Z,SWEEP-IN CREDIT - 50300498261567,,,self_transfer,996349
61b70cc2d8beac1599eb9b9a,50200035187206,-1496359.93,60ec419255c00300382671a5,HDFC,Internal Transfers,5eecc6d6449e4f7cfb1c2708,2021-05-12T00:00:00.000Z,IB FUNDS TRANSFER DR-50200023535069 -SL ICK ORGANICS PVT LTD,investments,,net_banking_transfer,-1500000
61b70cc3d8beac1599eb9ba4,50200035187206,-1490484.64,60ec419255c00300382671a5,HDFC,Transfer in/Revenue-other,5eecc6d6449e4f7cfb1c2708,2021-05-13T00:00:00.000Z,INT. ON SWCR ON-50300498261567,,,Other,5875.29
61b70cc4d8beac1599eb9ba7,50200035187206,5875.36,60ec419255c00300382671a5,HDFC,Loan-in,5eecc6d6449e4f7cfb1c2708,2021-05-13T00:00:00.000Z,SWEEP-IN CREDIT - 50300498261567,,,self_transfer,1496360
61b70cc5d8beac1599eb9bac,50200035187206,-1694124.64,60ec419255c00300382671a5,HDFC,Internal Transfers,5eecc6d6449e4f7cfb1c2708,2021-05-13T00:00:00.000Z,IB FUNDS TRANSFER DR-50200023535069 -SL ICK ORGANICS PVT LTD,investments,,net_banking_transfer,-1700000
61b70cc6d8beac1599eb9bb2,50200035187206,-1634005.72,60ec419255c00300382671a5,HDFC,Transfer in/Revenue-other,5eecc6d6449e4f7cfb1c2708,2021-05-14T00:00:00.000Z,INT. ON SWCR ON-50300498261567,,,Other,237.92
61b70cc7d8beac1599eb9bb9,50200035187206,-1634243.64,60ec419255c00300382671a5,HDFC,Loan-in,5eecc6d6449e4f7cfb1c2708,2021-05-14T00:00:00.000Z,SWEEP-IN CREDIT - 50300498261567,,,self_transfer,59881
61b70cc8d8beac1599eb9bbe,50200035187206,-1641650.72,60ec419255c00300382671a5,HDFC,direct expenses,5eecc6d6449e4f7cfb1c2708,2021-05-14T00:00:00.000Z,INT. ON SWCR ON-50300462137427,,,Other,-7645
61b70cc9d8beac1599eb9bc5,50200035187206,0.28,60ec419255c00300382671a5,HDFC,Loan-in,5eecc6d6449e4f7cfb1c2708,2021-05-14T00:00:00.000Z,SWEEP-IN CREDIT - 50300462137427,,,self_transfer,1641651
61b70ccad8beac1599eb9bca,50200035187206,-999999.72,60ec419255c00300382671a5,HDFC,Internal Transfers,5eecc6d6449e4f7cfb1c2708,2021-05-14T00:00:00.000Z,IB FUNDS TRANSFER DR-50200023535069 -SL ICK ORGANICS PVT LTD,investments,,net_banking_transfer,-1000000
61b70ccbd8beac1599eb9bce,50200035187206,-1004584.72,60ec419255c00300382671a5,HDFC,direct expenses,5eecc6d6449e4f7cfb1c2708,2021-05-14T00:00:00.000Z,INT. ON SWCR ON-50300462137427,,,Other,-4585
61b70cccd8beac1599eb9bd3,50200035187206,0.28,60ec419255c00300382671a5,HDFC,Loan-in,5eecc6d6449e4f7cfb1c2708,2021-05-14T00:00:00.000Z,SWEEP-IN CREDIT - 50300462137427,,,self_transfer,1004585
61b70ccdd8beac1599eb9bdb,50200035187206,-99999.72,60ec419255c00300382671a5,HDFC,Internal Transfers,5eecc6d6449e4f7cfb1c2708,2021-05-17T00:00:00.000Z,IB FUNDS TRANSFER DR-50200023535069 -SL ICK ORGANICS PVT LTD,investments,,net_banking_transfer,-100000
61b70cced8beac1599eb9bde,50200035187206,1.28,60ec419255c00300382671a5,HDFC,direct expenses,5eecc6d6449e4f7cfb1c2708,2021-05-18T00:00:00.000Z,INT. ON SWCR ON-50300462137427,,,Other,-430
61b70ccfd8beac1599eb9be3,50200035187206,431.28,60ec419255c00300382671a5,HDFC,Loan-in,5eecc6d6449e4f7cfb1c2708,2021-05-18T00:00:00.000Z,SWEEP-IN CREDIT - 50300462137427,,,self_transfer,100431
61b70cd0d8beac1599eb9be9,50200035187206,-99998.72,60ec419255c00300382671a5,HDFC,Internal Transfers,5eecc6d6449e4f7cfb1c2708,2021-05-20T00:00:00.000Z,IB FUNDS TRANSFER DR-50200023535069 -SL ICK ORGANICS PVT LTD,investments,,net_banking_transfer,-100000
61b70cd1d8beac1599eb9bef,50200035187206,0.28,60ec419255c00300382671a5,HDFC,direct expenses,5eecc6d6449e4f7cfb1c2708,2021-05-21T00:00:00.000Z,INT. ON SWCR ON-50300462137427,,,Other,-403
61b70cd2d8beac1599eb9bf3,50200035187206,403.28,60ec419255c00300382671a5,HDFC,Loan-in,5eecc6d6449e4f7cfb1c2708,2021-05-21T00:00:00.000Z,SWEEP-IN CREDIT - 50300462137427,,,self_transfer,100402
61b70cd3d8beac1599eb9bfa,50200035187206,-399999.72,60ec419255c00300382671a5,HDFC,Internal Transfers,5eecc6d6449e4f7cfb1c2708,2021-06-07T00:00:00.000Z,IB FUNDS TRANSFER DR-50200023535069 -SL ICK ORGANICS PVT LTD,investments,,net_banking_transfer,-400000
61b70cd4d8beac1599eb9c01,50200035187206,-599999.72,60ec419255c00300382671a5,HDFC,Internal Transfers,5eecc6d6449e4f7cfb1c2708,2021-06-07T00:00:00.000Z,IB FUNDS TRANSFER DR-50200023535069 -SL ICK ORGANICS PVT LTD,investments,,net_banking_transfer,-200000
61b70cd5d8beac1599eb9c03,50200035187206,-799999.72,60ec419255c00300382671a5,HDFC,Internal Transfers,5eecc6d6449e4f7cfb1c2708,2021-06-07T00:00:00.000Z,IB FUNDS TRANSFER DR-50200023535069 -SL ICK ORGANICS PVT LTD,investments,,net_banking_transfer,-200000
61b70cd6d8beac1599eb9c09,50200035187206,-800933.72,60ec419255c00300382671a5,HDFC,direct expenses,5eecc6d6449e4f7cfb1c2708,2021-06-08T00:00:00.000Z,INT. ON SWCR ON-50300462137427,,,Other,-934
61b70cd7d8beac1599eb9c12,50200035187206,-399999.72,60ec419255c00300382671a5,HDFC,Loan-in,5eecc6d6449e4f7cfb1c2708,2021-06-08T00:00:00.000Z,SWEEP-IN CREDIT - 50300462137427,,,self_transfer,400934
61b70cd7d8beac1599eb9c16,50200035187206,-199998.72,60ec419255c00300382671a5,HDFC,direct expenses,5eecc6d6449e4f7cfb1c2708,2021-06-08T00:00:00.000Z,INT. ON SWCR ON-50300462137427,,,Other,-467
61b70cd8d8beac1599eb9c1d,50200035187206,-199531.72,60ec419255c00300382671a5,HDFC,Loan-in,5eecc6d6449e4f7cfb1c2708,2021-06-08T00:00:00.000Z,SWEEP-IN CREDIT - 50300462137427,,,self_transfer,200468
61b70cd9d8beac1599eb9c24,50200035187206,-200465.72,60ec419255c00300382671a5,HDFC,direct expenses,5eecc6d6449e4f7cfb1c2708,2021-06-08T00:00:00.000Z,INT. ON SWCR ON-50300462137427,,,Other,-467
61b70cdad8beac1599eb9c29,50200035187206,0.28,60ec419255c00300382671a5,HDFC,Loan-in,5eecc6d6449e4f7cfb1c2708,2021-06-08T00:00:00.000Z,SWEEP-IN CREDIT - 50300462137427,,,self_transfer,200466
61b70cdbd8beac1599eb9c31,50200035187206,-3999999.72,60ec419255c00300382671a5,HDFC,Internal Transfers,5eecc6d6449e4f7cfb1c2708,2021-06-11T00:00:00.000Z,IB FUNDS TRANSFER DR-50200023535069 -SL ICK ORGANICS PVT LTD,investments,,net_banking_transfer,-4000000
61b70cdcd8beac1599eb9c34,50200035187206,-4999999.72,60ec419255c00300382671a5,HDFC,Internal Transfers,5eecc6d6449e4f7cfb1c2708,2021-06-11T00:00:00.000Z,IB FUNDS TRANSFER DR-50200023535069 -SL ICK ORGANICS PVT LTD,investments,,net_banking_transfer,-1000000
61b70cddd8beac1599eb9c3a,50200035187206,-999997.72,60ec419255c00300382671a5,HDFC,direct expenses,5eecc6d6449e4f7cfb1c2708,2021-06-12T00:00:00.000Z,INT. ON SWCR ON-50300462137427,,,Other,-7837
61b70cded8beac1599eb9c41,50200035187206,-992160.72,60ec419255c00300382671a5,HDFC,Loan-in,5eecc6d6449e4f7cfb1c2708,2021-06-12T00:00:00.000Z,SWEEP-IN CREDIT - 50300462137427,,,self_transfer,4007839
61b70cdfd8beac1599eb9c44,50200035187206,1.28,60ec419255c00300382671a5,HDFC,direct expenses,5eecc6d6449e4f7cfb1c2708,2021-06-12T00:00:00.000Z,INT. ON SWCR ON-50300462137427,,,Other,-1959
61b70ce0d8beac1599eb9c4b,50200035187206,1960.28,60ec419255c00300382671a5,HDFC,Loan-in,5eecc6d6449e4f7cfb1c2708,2021-06-12T00:00:00.000Z,SWEEP-IN CREDIT - 50300462137427,,,self_transfer,1001958
61b70ce1d8beac1599eb9c51,50200035187206,13945.28,60ec419255c00300382671a5,HDFC,interest income,5eecc6d6449e4f7cfb1c2708,2021-06-23T00:00:00.000Z,QUARTERLY INTEREST CREDIT 50300462137427,,,Other,13944
61b70ce2d8beac1599eb9c56,50200035187206,-86054.72,60ec419255c00300382671a5,HDFC,Internal Transfers,5eecc6d6449e4f7cfb1c2708,2021-07-07T00:00:00.000Z,IB FUNDS TRANSFER DR-50200023535069 -SL ICK ORGANICS PVT LTD,,,,-100000
61b70ce3d8beac1599eb9c5b,50200035187206,-87178.72,60ec419255c00300382671a5,HDFC,direct expenses,5eecc6d6449e4f7cfb1c2708,2021-07-08T00:00:00.000Z,INT. ON SWCR ON-50300462137427,,,,-1124
61b70ce4d8beac1599eb9c61,50200035187206,2.28,60ec419255c00300382671a5,HDFC,Loan-in,5eecc6d6449e4f7cfb1c2708,2021-07-08T00:00:00.000Z,SWEEP-IN CREDIT - 50300462137427,,,,87181
61b70ce5d8beac1599eb9c72,50200035187206,-924997.72,60ec419255c00300382671a5,HDFC,Internal Transfers,5eecc6d6449e4f7cfb1c2708,2021-07-09T00:00:00.000Z,IB FUNDS TRANSFER DR-50200023535069 -SL ICK ORGANICS PVT LTD,,,,-925000
61b70ce6d8beac1599eb9c79,50200035187206,-929997.72,60ec419255c00300382671a5,HDFC,Internal Transfers,5eecc6d6449e4f7cfb1c2708,2021-07-09T00:00:00.000Z,IB FUNDS TRANSFER DR-50200023535069 -SL ICK ORGANICS PVT LTD,insurance,,net_banking_transfer,-5000
61b70ce7d8beac1599eb9c7e,50200035187206,-942056.72,60ec419255c00300382671a5,HDFC,direct expenses,5eecc6d6449e4f7cfb1c2708,2021-07-10T00:00:00.000Z,INT. ON SWCR ON-50300462137427,,,,-12059
61b70ce8d8beac1599eb9c84,50200035187206,6904.28,60ec419255c00300382671a5,HDFC,Loan-in,5eecc6d6449e4f7cfb1c2708,2021-07-10T00:00:00.000Z,SWEEP-IN CREDIT - 50300462137427,,,,948961
61b70ce9d8beac1599eb9c89,50200035187206,-3095.72,60ec419255c00300382671a5,HDFC,Internal Transfers,5eecc6d6449e4f7cfb1c2708,2021-07-10T00:00:00.000Z,IB FUNDS TRANSFER DR-50200023535069 -SL ICK ORGANICS PVT LTD,insurance,,net_banking_transfer,-10000
61b70cebd8beac1599eb9c99,50200035187206,-3134.72,60ec419255c00300382671a5,HDFC,direct expenses,5eecc6d6449e4f7cfb1c2708,2021-07-11T00:00:00.000Z,INT. ON SWCR ON-50300462137427,,,,-39
61b70cecd8beac1599eb9ca0,50200035187206,1.28,60ec419255c00300382671a5,HDFC,Loan-in,5eecc6d6449e4f7cfb1c2708,2021-07-11T00:00:00.000Z,SWEEP-IN CREDIT - 50300462137427,,,,3136
61b70ceed8beac1599eb9cab,50200035187206,5000001.28,60ec419255c00300382671a5,HDFC,Investments-New,5eecc6d6449e4f7cfb1c2708,2021-07-16T00:00:00.000Z,02711010000972-TPT-2500000-UDAY BHASIN,,,net_banking_transfer,2500000
61b70cefd8beac1599eb9cb6,50200035187206,5503397.28,60ec419255c00300382671a5,HDFC,Transfer in/Revenue-other,5eecc6d6449e4f7cfb1c2708,2021-07-17T00:00:00.000Z,01071000188407-TPT-ARATA SHARES 1ST HALF PAYMENT-JANNAT GILL,,,net_banking_transfer,503396
61b70cf1d8beac1599eb9cbf,50200035187206,6003397.28,60ec419255c00300382671a5,HDFC,Transfer in/Revenue-other,5eecc6d6449e4f7cfb1c2708,2021-07-18T00:00:00.000Z,01071000188407-TPT-ARATA SHARES 2ND HALF PAYMENT-JANNAT GILL,,,net_banking_transfer,500000
61b70cf3d8beac1599eb9cc8,50200035187206,12004841.28,60ec419255c00300382671a5,HDFC,Transfer in/Revenue-other,5eecc6d6449e4f7cfb1c2708,2021-07-20T00:00:00.000Z,RTGS CR-KKBK0000958-BEELINE IMPEX PRIVAT E LIMITED-SLICK ORGANICS PRIVATE LIMITED -KKBKR22021072002007152,,,,2499024
61b70cf5d8beac1599eb9cd8,50200035187206,18504841.28,60ec419255c00300382671a5,HDFC,Transfer in/Revenue-other,5eecc6d6449e4f7cfb1c2708,2021-07-22T00:00:00.000Z,FT - CR - 50100056196924 - SEEMA KEDIA,,,Other,1500000
61b70cf6d8beac1599eb9cde,50200035187206,17504841.28,60ec419255c00300382671a5,HDFC,Internal Transfers,5eecc6d6449e4f7cfb1c2708,2021-07-25T00:00:00.000Z,IB FUNDS TRANSFER DR-50200023535069 -SL ICK ORGANICS PVT LTD,insurance,,net_banking_transfer,-1000000
61b70cf7d8beac1599eb9ce4,50200035187206,16004841.28,60ec419255c00300382671a5,HDFC,Internal Transfers,5eecc6d6449e4f7cfb1c2708,2021-07-28T00:00:00.000Z,IB FUNDS TRANSFER DR-50200023535069 -SL ICK ORGANICS PVT LTD,insurance,,net_banking_transfer,-1500000
61b70cf9d8beac1599eb9cef,50200035187206,-495158.72,60ec419255c00300382671a5,HDFC,Internal Transfers,5eecc6d6449e4f7cfb1c2708,2021-09-01T00:00:00.000Z,IB FUNDS TRANSFER DR-50200023535069 -SL ICK ORGANICS PVT LTD,insurance,,net_banking_transfer,-1000000
61b70cfad8beac1599eb9cf4,50200035187206,-995158.72,60ec419255c00300382671a5,HDFC,Internal Transfers,5eecc6d6449e4f7cfb1c2708,2021-09-01T00:00:00.000Z,IB FUNDS TRANSFER DR-50200023535069 -SL ICK ORGANICS PVT LTD,insurance,,net_banking_transfer,-500000
61b70cfbd8beac1599eb9cfc,50200035187206,-1495158.72,60ec419255c00300382671a5,HDFC,Internal Transfers,5eecc6d6449e4f7cfb1c2708,2021-09-01T00:00:00.000Z,IB FUNDS TRANSFER DR-50200023535069 -SL ICK ORGANICS PVT LTD,insurance,,net_banking_transfer,-500000
61b70cfcd8beac1599eb9d03,50200035187206,-1494236.72,60ec419255c00300382671a5,HDFC,Transfer in/Revenue-other,5eecc6d6449e4f7cfb1c2708,2021-09-02T00:00:00.000Z,INT. ON SWCR ON-50300537849841,,,Other,922
61b70cfdd8beac1599eb9d07,50200035187206,-999077.72,60ec419255c00300382671a5,HDFC,Loan-in,5eecc6d6449e4f7cfb1c2708,2021-09-02T00:00:00.000Z,SWEEP-IN CREDIT - 50300537849841,,,self_transfer,495159
61b70cfed8beac1599eb9d12,50200035187206,-998145.72,60ec419255c00300382671a5,HDFC,Transfer in/Revenue-other,5eecc6d6449e4f7cfb1c2708,2021-09-02T00:00:00.000Z,INT. ON SWCR ON-50300537849841,,,,932
61b70d00d8beac1599eb9d17,50200035187206,-498145.72,60ec419255c00300382671a5,HDFC,Loan-in,5eecc6d6449e4f7cfb1c2708,2021-09-02T00:00:00.000Z,SWEEP-IN CREDIT - 50300537849841,,,,500000
61b70d00d8beac1599eb9d20,50200035187206,-497217.72,60ec419255c00300382671a5,HDFC,Transfer in/Revenue-other,5eecc6d6449e4f7cfb1c2708,2021-09-02T00:00:00.000Z,INT. ON SWCR ON-50300537849841,,,Other,928
61b70d01d8beac1599eb9d25,50200035187206,928.28,60ec419255c00300382671a5,HDFC,Loan-in,5eecc6d6449e4f7cfb1c2708,2021-09-02T00:00:00.000Z,SWEEP-IN CREDIT - 50300537849841,,,self_transfer,498146
61b70d02d8beac1599eb9d2c,50200035187206,-499071.72,60ec419255c00300382671a5,HDFC,Internal Transfers,5eecc6d6449e4f7cfb1c2708,2021-09-02T00:00:00.000Z,IB FUNDS TRANSFER DR-50200023535069 -SL ICK ORGANICS PVT LTD,insurance,,net_banking_transfer,-500000
61b70d03d8beac1599eb9d32,50200035187206,-498114.72,60ec419255c00300382671a5,HDFC,Transfer in/Revenue-other,5eecc6d6449e4f7cfb1c2708,2021-09-03T00:00:00.000Z,INT. ON SWCR ON-50300537849841,,,,957
61b70d04d8beac1599eb9d37,50200035187206,957.28,60ec419255c00300382671a5,HDFC,Loan-in,5eecc6d6449e4f7cfb1c2708,2021-09-03T00:00:00.000Z,SWEEP-IN CREDIT - 50300537849841,,,,499072
61b70d05d8beac1599eb9d3b,50200035187206,-999042.72,60ec419255c00300382671a5,HDFC,Internal Transfers,5eecc6d6449e4f7cfb1c2708,2021-09-04T00:00:00.000Z,IB FUNDS TRANSFER DR-50200023535069 -SL ICK ORGANICS PVT LTD,insurance,,net_banking_transfer,-1000000
61b70d06d8beac1599eb9d41,50200035187206,-1499042.72,60ec419255c00300382671a5,HDFC,Internal Transfers,5eecc6d6449e4f7cfb1c2708,2021-09-04T00:00:00.000Z,IB FUNDS TRANSFER DR-50200023535069 -SL ICK ORGANICS PVT LTD,insurance,,net_banking_transfer,-500000
61b70d07d8beac1599eb9d45,50200035187206,-1497017.72,60ec419255c00300382671a5,HDFC,Transfer in/Revenue-other,5eecc6d6449e4f7cfb1c2708,2021-09-05T00:00:00.000Z,INT. ON SWCR ON-50300537849841,,,Other,2025
61b70d08d8beac1599eb9d4e,50200035187206,-497974.72,60ec419255c00300382671a5,HDFC,Loan-in,5eecc6d6449e4f7cfb1c2708,2021-09-05T00:00:00.000Z,SWEEP-IN CREDIT - 50300537849841,,,self_transfer,999043
61b70d09d8beac1599eb9d52,50200035187206,-496964.72,60ec419255c00300382671a5,HDFC,Transfer in/Revenue-other,5eecc6d6449e4f7cfb1c2708,2021-09-05T00:00:00.000Z,INT. ON SWCR ON-50300537849841,,,,1010
61b70d0ad8beac1599eb9d59,50200035187206,1010.28,60ec419255c00300382671a5,HDFC,Loan-in,5eecc6d6449e4f7cfb1c2708,2021-09-05T00:00:00.000Z,SWEEP-IN CREDIT - 50300537849841,,,,497975
61b70d0bd8beac1599eb9d5d,50200035187206,-198989.72,60ec419255c00300382671a5,HDFC,Internal Transfers,5eecc6d6449e4f7cfb1c2708,2021-09-06T00:00:00.000Z,IB FUNDS TRANSFER DR-50200023535069 -SL ICK ORGANICS PVT LTD,insurance,,net_banking_transfer,-200000
61b70d0cd8beac1599eb9d63,50200035187206,-198564.72,60ec419255c00300382671a5,HDFC,Transfer in/Revenue-other,5eecc6d6449e4f7cfb1c2708,2021-09-07T00:00:00.000Z,INT. ON SWCR ON-50300537849841,,,Other,425
61b70d0dd8beac1599eb9d6a,50200035187206,425.28,60ec419255c00300382671a5,HDFC,Loan-in,5eecc6d6449e4f7cfb1c2708,2021-09-07T00:00:00.000Z,SWEEP-IN CREDIT - 50300537849841,,,self_transfer,198990
61b70d0fd8beac1599eb9d73,50200035187206,-1499574.72,60ec419255c00300382671a5,HDFC,Internal Transfers,5eecc6d6449e4f7cfb1c2708,2021-09-07T00:00:00.000Z,IB FUNDS TRANSFER DR-50200023535069 -SL ICK ORGANICS PVT LTD,insurance,,net_banking_transfer,-500000
61b70d10d8beac1599eb9d7a,50200035187206,-1999574.72,60ec419255c00300382671a5,HDFC,Internal Transfers,5eecc6d6449e4f7cfb1c2708,2021-09-07T00:00:00.000Z,IB FUNDS TRANSFER DR-50200023535069 -SL ICK ORGANICS PVT LTD,insurance,,net_banking_transfer,-500000
61b70d11d8beac1599eb9d7f,50200035187206,-1997383.72,60ec419255c00300382671a5,HDFC,Transfer in/Revenue-other,5eecc6d6449e4f7cfb1c2708,2021-09-08T00:00:00.000Z,INT. ON SWCR ON-50300537849841,,,,2191
61b70d12d8beac1599eb9d88,50200035187206,-997808.72,60ec419255c00300382671a5,HDFC,Loan-in,5eecc6d6449e4f7cfb1c2708,2021-09-08T00:00:00.000Z,SWEEP-IN CREDIT - 50300537849841,,,,999575
61b70d13d8beac1599eb9d8d,50200035187206,-996712.72,60ec419255c00300382671a5,HDFC,Transfer in/Revenue-other,5eecc6d6449e4f7cfb1c2708,2021-09-08T00:00:00.000Z,INT. ON SWCR ON-50300537849841,,,,1096
61b70d14d8beac1599eb9d94,50200035187206,-496712.72,60ec419255c00300382671a5,HDFC,Loan-in,5eecc6d6449e4f7cfb1c2708,2021-09-08T00:00:00.000Z,SWEEP-IN CREDIT - 50300537849841,,,,500000
61b70d15d8beac1599eb9d98,50200035187206,-495623.72,60ec419255c00300382671a5,HDFC,Transfer in/Revenue-other,5eecc6d6449e4f7cfb1c2708,2021-09-08T00:00:00.000Z,INT. ON SWCR ON-50300537849841,,,,1089
61b70d16d8beac1599eb9d9e,50200035187206,1089.28,60ec419255c00300382671a5,HDFC,Loan-in,5eecc6d6449e4f7cfb1c2708,2021-09-08T00:00:00.000Z,SWEEP-IN CREDIT - 50300537849841,,,,496713
61b70d18d8beac1599eb9da9,50200035187206,-1098910.72,60ec419255c00300382671a5,HDFC,Internal Transfers,5eecc6d6449e4f7cfb1c2708,2021-09-09T00:00:00.000Z,IB FUNDS TRANSFER DR-50200023535069 -SL ICK ORGANICS PVT LTD,insurance,,net_banking_transfer,-100000
61b70d19d8beac1599eb9db0,50200035187206,-1096611.72,60ec419255c00300382671a5,HDFC,Transfer in/Revenue-other,5eecc6d6449e4f7cfb1c2708,2021-09-10T00:00:00.000Z,INT. ON SWCR ON-50300537849841,,,Other,2299
61b70d1ad8beac1599eb9db9,50200035187206,-97700.72,60ec419255c00300382671a5,HDFC,Loan-in,5eecc6d6449e4f7cfb1c2708,2021-09-10T00:00:00.000Z,SWEEP-IN CREDIT - 50300537849841,,,self_transfer,998911
61b70d1bd8beac1599eb9dbe,50200035187206,-97475.72,60ec419255c00300382671a5,HDFC,Transfer in/Revenue-other,5eecc6d6449e4f7cfb1c2708,2021-09-10T00:00:00.000Z,INT. ON SWCR ON-50300537849841,,,Other,225
61b70d1cd8beac1599eb9dcf,50200035187206,225.28,60ec419255c00300382671a5,HDFC,Loan-in,5eecc6d6449e4f7cfb1c2708,2021-09-10T00:00:00.000Z,SWEEP-IN CREDIT - 50300537849841,,,self_transfer,97701
61b70d1dd8beac1599eb9de7,50200035187206,-299774.72,60ec419255c00300382671a5,HDFC,Internal Transfers,5eecc6d6449e4f7cfb1c2708,2021-09-10T00:00:00.000Z,IB FUNDS TRANSFER DR-50200023535069 -SL ICK ORGANICS PVT LTD,insurance,,net_banking_transfer,-300000
61b70d1ed8beac1599eb9e02,50200035187206,-299068.72,60ec419255c00300382671a5,HDFC,Transfer in/Revenue-other,5eecc6d6449e4f7cfb1c2708,2021-09-11T00:00:00.000Z,INT. ON SWCR ON-50300537849841,,,Other,706
61b70d1fd8beac1599eb9e0f,50200035187206,706.28,60ec419255c00300382671a5,HDFC,Loan-in,5eecc6d6449e4f7cfb1c2708,2021-09-11T00:00:00.000Z,SWEEP-IN CREDIT - 50300537849841,,,self_transfer,299775
61b70d20d8beac1599eb9e1a,50200035187206,766.28,60ec419255c00300382671a5,HDFC,interest income,5eecc6d6449e4f7cfb1c2708,2021-09-23T00:00:00.000Z,QUARTERLY INTEREST CREDIT 50300462137427,,,Other,60
61b70d21d8beac1599eb9e27,50200035187206,-718173.72,60ec419255c00300382671a5,HDFC,Internal Transfers,5eecc6d6449e4f7cfb1c2708,2021-09-24T00:00:00.000Z,IB FUNDS TRANSFER DR-50200023535069 -SL ICK ORGANICS PVT LTD,insurance,,net_banking_transfer,-718940
61b70d22d8beac1599eb9e31,50200035187206,-715930.72,60ec419255c00300382671a5,HDFC,Transfer in/Revenue-other,5eecc6d6449e4f7cfb1c2708,2021-09-25T00:00:00.000Z,INT. ON SWCR ON-50300537849841,,,,2243
61b70d23d8beac1599eb9e3a,50200035187206,2243.28,60ec419255c00300382671a5,HDFC,Loan-in,5eecc6d6449e4f7cfb1c2708,2021-09-25T00:00:00.000Z,SWEEP-IN CREDIT - 50300537849841,,,,718174
61b70d24d8beac1599eb9e49,50200035187206,-497756.72,60ec419255c00300382671a5,HDFC,Internal Transfers,5eecc6d6449e4f7cfb1c2708,2021-09-29T00:00:00.000Z,IB FUNDS TRANSFER DR-50200023535069 -SL ICK ORGANICS PVT LTD,insurance,,net_banking_transfer,-500000
61b70d25d8beac1599eb9e50,50200035187206,-496065.72,60ec419255c00300382671a5,HDFC,Transfer in/Revenue-other,5eecc6d6449e4f7cfb1c2708,2021-09-30T00:00:00.000Z,INT. ON SWCR ON-50300537849841,,,,1691
61b70d26d8beac1599eb9e5b,50200035187206,1691.28,60ec419255c00300382671a5,HDFC,Loan-in,5eecc6d6449e4f7cfb1c2708,2021-09-30T00:00:00.000Z,SWEEP-IN CREDIT - 50300537849841,,,,497757
61b70d27d8beac1599eb9e62,50200035187206,-998308.72,60ec419255c00300382671a5,HDFC,Internal Transfers,5eecc6d6449e4f7cfb1c2708,2021-10-01T00:00:00.000Z,IB FUNDS TRANSFER DR-50200023535069 -SL ICK ORGANICS PVT LTD,insurance,,net_banking_transfer,-1000000
61b70d28d8beac1599eb9e85,50200035187206,-994807.72,60ec419255c00300382671a5,HDFC,Transfer in/Revenue-other,5eecc6d6449e4f7cfb1c2708,2021-10-02T00:00:00.000Z,INT. ON SWCR ON-50300537849841,,,,3501
61b70d29d8beac1599eb9e8e,50200035187206,3501.28,60ec419255c00300382671a5,HDFC,Loan-in,5eecc6d6449e4f7cfb1c2708,2021-10-02T00:00:00.000Z,SWEEP-IN CREDIT - 50300537849841,,,,998309
61b70d2ad8beac1599eb9e95,50200035187206,-496498.72,60ec419255c00300382671a5,HDFC,Internal Transfers,5eecc6d6449e4f7cfb1c2708,2021-10-04T00:00:00.000Z,IB FUNDS TRANSFER DR-50200023535069 -SL ICK ORGANICS PVT LTD,insurance,,net_banking_transfer,-500000
61b70d2bd8beac1599eb9e9d,50200035187206,-494675.72,60ec419255c00300382671a5,HDFC,Transfer in/Revenue-other,5eecc6d6449e4f7cfb1c2708,2021-10-05T00:00:00.000Z,INT. ON SWCR ON-50300537849841,,,,1823
61b70d2cd8beac1599eb9ea2,50200035187206,1823.28,60ec419255c00300382671a5,HDFC,Loan-in,5eecc6d6449e4f7cfb1c2708,2021-10-05T00:00:00.000Z,SWEEP-IN CREDIT - 50300537849841,,,,496499
61b70d2dd8beac1599eb9eb4,50200035187206,-207176.72,60ec419255c00300382671a5,HDFC,Internal Transfers,5eecc6d6449e4f7cfb1c2708,2021-10-07T00:00:00.000Z,IB FUNDS TRANSFER DR-50200023535069 -SL ICK ORGANICS PVT LTD,insurance,,net_banking_transfer,-209000
61b70d2fd8beac1599eb9ec1,50200035187206,-211381.72,60ec419255c00300382671a5,HDFC,Transfer in/Revenue-other,5eecc6d6449e4f7cfb1c2708,2021-10-08T00:00:00.000Z,INT. ON SWCR ON-50300537849841,,,,795
61b70d30d8beac1599eb9ecf,50200035187206,-4204.72,60ec419255c00300382671a5,HDFC,Loan-in,5eecc6d6449e4f7cfb1c2708,2021-10-08T00:00:00.000Z,SWEEP-IN CREDIT - 50300537849841,,,,207177
61b70d31d8beac1599eb9edc,50200035187206,-4200.72,60ec419255c00300382671a5,HDFC,Transfer in/Revenue-other,5eecc6d6449e4f7cfb1c2708,2021-10-08T00:00:00.000Z,INT. ON SWCR ON-50300537849841,,,,4
61b70d32d8beac1599eb9ef2,50200035187206,-3176.72,60ec419255c00300382671a5,HDFC,Loan-in,5eecc6d6449e4f7cfb1c2708,2021-10-08T00:00:00.000Z,SWEEP-IN CREDIT - 50300537849841,,,,1024
61b70d33d8beac1599eb9eff,50200035187206,-3210.72,60ec419255c00300382671a5,HDFC,direct expenses,5eecc6d6449e4f7cfb1c2708,2021-10-08T00:00:00.000Z,INT. ON SWCR ON-50300462137427,,,,-34
61b70d34d8beac1599eb9f05,50200035187206,0.28,60ec419255c00300382671a5,HDFC,Loan-in,5eecc6d6449e4f7cfb1c2708,2021-10-08T00:00:00.000Z,SWEEP-IN CREDIT - 50300462137427,,,,3211
61b70d35d8beac1599eb9f13,50200035187206,-999.72,60ec419255c00300382671a5,HDFC,Internal Transfers,5eecc6d6449e4f7cfb1c2708,2021-10-11T00:00:00.000Z,IB FUNDS TRANSFER DR-50200023535069 -SL ICK ORGANICS PVT LTD,insurance,,net_banking_transfer,-1000
61b70d36d8beac1599eb9f1c,50200035187206,-1199.72,60ec419255c00300382671a5,HDFC,Internal Transfers,5eecc6d6449e4f7cfb1c2708,2021-10-11T00:00:00.000Z,IB FUNDS TRANSFER DR-50200023535069 -SL ICK ORGANICS PVT LTD,insurance,,net_banking_transfer,-200
61b70d37d8beac1599eb9f25,50200035187206,-1211.72,60ec419255c00300382671a5,HDFC,direct expenses,5eecc6d6449e4f7cfb1c2708,2021-10-12T00:00:00.000Z,INT. ON SWCR ON-50300462137427,,,,-12
61b70d38d8beac1599eb9f31,50200035187206,-199.72,60ec419255c00300382671a5,HDFC,Loan-in,5eecc6d6449e4f7cfb1c2708,2021-10-12T00:00:00.000Z,SWEEP-IN CREDIT - 50300462137427,,,,1012
61b70d39d8beac1599eb9f38,50200035187206,-201.72,60ec419255c00300382671a5,HDFC,direct expenses,5eecc6d6449e4f7cfb1c2708,2021-10-12T00:00:00.000Z,INT. ON SWCR ON-50300462137427,,,,-2
61b70d3ad8beac1599eb9f44,50200035187206,1.28,60ec419255c00300382671a5,HDFC,Loan-in,5eecc6d6449e4f7cfb1c2708,2021-10-12T00:00:00.000Z,SWEEP-IN CREDIT - 50300462137427,,,,203
61b70d3dd8beac1599eb9f55,50200035187206,67504035.82,60ec419255c00300382671a5,HDFC,Internal Transfers,5eecc6d6449e4f7cfb1c2708,2021-11-22T00:00:00.000Z,IB FUNDS TRANSFER DR-50200023535069 -SL ICK ORGANICS PVT LTD,insurance,,net_banking_transfer,-2500000
61b70d3ed8beac1599eb9f5b,50200035187206,66504035.82,60ec419255c00300382671a5,HDFC,Internal Transfers,5eecc6d6449e4f7cfb1c2708,2021-11-22T00:00:00.000Z,IB FUNDS TRANSFER DR-50200023535069 -SL ICK ORGANICS PVT LTD,insurance,,net_banking_transfer,-1000000
61b70d3fd8beac1599eb9f63,50200035187206,66004035.82,60ec419255c00300382671a5,HDFC,Internal Transfers,5eecc6d6449e4f7cfb1c2708,2021-11-22T00:00:00.000Z,IB FUNDS TRANSFER DR-50200023535069 -SL ICK ORGANICS PVT LTD,insurance,,net_banking_transfer,-500000
61b70d40d8beac1599eb9f75,50200035187206,65004035.82,60ec419255c00300382671a5,HDFC,Internal Transfers,5eecc6d6449e4f7cfb1c2708,2021-11-22T00:00:00.000Z,IB FUNDS TRANSFER DR-50200023535069 -SL ICK ORGANICS PVT LTD,insurance,,net_banking_transfer,-1000000
61b70d41d8beac1599eb9f7b,50200035187206,62004035.82,60ec419255c00300382671a5,HDFC,Internal Transfers,5eecc6d6449e4f7cfb1c2708,2021-11-23T00:00:00.000Z,IB FUNDS TRANSFER DR-50200023535069 -SL ICK ORGANICS PVT LTD,insurance,,net_banking_transfer,-3000000
61b70d43d8beac1599eb9f85,50200035187206,60004035.82,60ec419255c00300382671a5,HDFC,Internal Transfers,5eecc6d6449e4f7cfb1c2708,2021-11-23T00:00:00.000Z,IB FUNDS TRANSFER DR-50200023535069 -SL ICK ORGANICS PVT LTD,insurance,,net_banking_transfer,-1000000
61b70d44d8beac1599eb9f8b,50200035187206,44004035.82,60ec419255c00300382671a5,HDFC,direct expenses,5eecc6d6449e4f7cfb1c2708,2021-11-26T00:00:00.000Z,FD BOOKED - 50300571891040 : SLICK ORGAN ICS PVT LTD,insurance,,investment,-16000000
61b70d45d8beac1599eb9f92,50200035187206,43004035.82,60ec419255c00300382671a5,HDFC,Internal Transfers,5eecc6d6449e4f7cfb1c2708,2021-11-29T00:00:00.000Z,IB FUNDS TRANSFER DR-50200023535069 -SL ICK ORGANICS PVT LTD,insurance,,net_banking_transfer,-1000000
61fa3404d8beac15990e608f,50200023535069,346400.38,60ec41ba55c00300382672d9,HDFC,Revenue-PG-non-split,5eecc6d6449e4f7cfb1c2708,2021-12-01T00:00:00.000Z,UPI-PAYTM-PPSL-PAYOUTS@PAYTM-PYTM0123456 -133535426913-ALL202112012168200,ewallet,,upi,12165.11
61fa3404d8beac15990e6092,50200023535069,121400.38,60ec41ba55c00300382672d9,HDFC,direct expenses,5eecc6d6449e4f7cfb1c2708,2021-12-01T00:00:00.000Z,"NEFT DR-SCBL0036025-DHRUV MADHOK-NETBANK , MUM-N335211732643971-225000",,,net_banking_transfer,-225000
61fa3404d8beac15990e6094,50200023535069,2121400.38,60ec41ba55c00300382672d9,HDFC,Internal Transfers,5eecc6d6449e4f7cfb1c2708,2021-12-01T00:00:00.000Z,IB FUNDS TRANSFER CR-50200035187206 -SL ICK ORGANICS PVT LTD,insurance,,Other,2000000
61fa3404d8beac15990e6096,50200023535069,1896400.38,60ec41ba55c00300382672d9,HDFC,direct expenses,5eecc6d6449e4f7cfb1c2708,2021-12-01T00:00:00.000Z,02711930004579-TPT-225000-DHRUV BHASIN,,,net_banking_transfer,-225000
61fa3404d8beac15990e6098,50200023535069,983386.38,60ec41ba55c00300382672d9,HDFC,direct expenses,5eecc6d6449e4f7cfb1c2708,2021-12-01T00:00:00.000Z,02711600008220-TPT-913014-VARUN SINGH,,,net_banking_transfer,-913014
61fa3404d8beac15990e609a,50200023535069,883386.38,60ec41ba55c00300382672d9,HDFC,direct expenses,5eecc6d6449e4f7cfb1c2708,2021-12-01T00:00:00.000Z,"NEFT DR-PYTM0123456-PAYTM-NETBANK, MUM-N 335211732774639-100000",ewallet,,net_banking_transfer,-100000
61fa3404d8beac15990e609c,50200023535069,909214.49,60ec41ba55c00300382672d9,HDFC,Revenue-Mktplace,5eecc6d6449e4f7cfb1c2708,2021-12-01T00:00:00.000Z,NEFT CR-DEUT0797BGL-FLIPKART INTERNET PR IVATE LIMITED-SLICK ORGANICS PVT LTD-133 500277GN00011,shopping,,net_banking_transfer,25828.11
61fa3404d8beac15990e609f,50200023535069,909443.43,60ec41ba55c00300382672d9,HDFC,Revenue-PG-split enabled,5eecc6d6449e4f7cfb1c2708,2021-12-01T00:00:00.000Z,NEFT CR-UTIB0001506-RAZORPAY SOFTWARE PR IVATE LIMITED-SLICK ORGANICS PVT LITD-AX ISCN0107942095,insurance,,net_banking_transfer,228.94
61fa3404d8beac15990e60a1,50200023535069,924964.6,60ec41ba55c00300382672d9,HDFC,Revenue-Mktplace,5eecc6d6449e4f7cfb1c2708,2021-12-01T00:00:00.000Z,NEFT CR-DEUT0797BGL-FLIPKART INTERNET PR IVATE LIMITED-SLICK ORGANICS PVT LTD-133 500301GN00300,shopping,,net_banking_transfer,15521.17
61fa3404d8beac15990e60a3,50200023535069,904964.6,60ec41ba55c00300382672d9,HDFC,direct expenses,5eecc6d6449e4f7cfb1c2708,2021-12-01T00:00:00.000Z,SARVAN KUMAR - CHQ PAID - DEVLI ROAD K,,,chq,-20000
61fa3404d8beac15990e60a5,50200023535069,804964.6,60ec41ba55c00300382672d9,HDFC,Marketing Expense,5eecc6d6449e4f7cfb1c2708,2021-12-01T00:00:00.000Z,POS 514834XXXXXX9486 GOOGLE ADS,,,debit_card,-100000
61fa3404d8beac15990e60a7,50200023535069,802783.54,60ec41ba55c00300382672d9,HDFC,direct expenses,5eecc6d6449e4f7cfb1c2708,2021-12-01T00:00:00.000Z,POS 514834XXXXXX9486 SEOPTIMER,,,debit_card,-2181.06
61fa3404d8beac15990e60a9,50200023535069,834570.42,60ec41ba55c00300382672d9,HDFC,Revenue-UPI,5eecc6d6449e4f7cfb1c2708,2021-12-01T00:00:00.000Z,UPI-GOKWIK-GOKWIK@YESBANK-YESB0000340-13 3531074319-PAYOUT FOR NOVEMBE,,,upi,31786.88
61fa3404d8beac15990e60ab,50200023535069,836156.08,60ec41ba55c00300382672d9,HDFC,Transfer in/Revenue-other,5eecc6d6449e4f7cfb1c2708,2021-12-01T00:00:00.000Z,50200050675669-TPT-REMITTANCE OG NOV21-H OUZ OF NATURE PVT LTD,,,net_banking_transfer,1585.66
61fa3404d8beac15990e60ad,50200023535069,836305.48,60ec41ba55c00300382672d9,HDFC,Revenue-PG-split enabled,5eecc6d6449e4f7cfb1c2708,2021-12-01T00:00:00.000Z,NEFT CR-UTIB0001506-RAZORPAY SOFTWARE PR IVATE LIMITED-SLICK ORGANICS PVT LITD-AX ISCN0108167678,insurance,,net_banking_transfer,149.4
61fa3404d8beac15990e60af,50200023535069,837449.69,60ec41ba55c00300382672d9,HDFC,Revenue-Mktplace,5eecc6d6449e4f7cfb1c2708,2021-12-01T00:00:00.000Z,NEFT CR-ICIC0000105-MANASH LIFESTYLE PRI,shopping,,net_banking_transfer,1144.21
61fa3404d8beac15990e60b1,50200023535069,837961.33,60ec41ba55c00300382672d9,HDFC,Revenue-Mktplace,5eecc6d6449e4f7cfb1c2708,2021-12-01T00:00:00.000Z,NEFT CR-ICIC0000105-MANASH LIFESTYLE PRI VATE LIMITED NO-SLICK ORGANICS PRIVATE L IMITED HYD-ICIJ213350006444,shopping,,net_banking_transfer,511.64
61fa3404d8beac15990e60b3,50200023535069,838520.6,60ec41ba55c00300382672d9,HDFC,Revenue-Mktplace,5eecc6d6449e4f7cfb1c2708,2021-12-01T00:00:00.000Z,NEFT CR-ICIC0000105-MANASH LIFESTYLE PRI VATE LIMITED NO-SLICK ORGANICS PRIVATE L IMITED MP G-ICIJ213350006442,shopping,,net_banking_transfer,559.27
61fa3404d8beac15990e60b5,50200023535069,846731.6,60ec41ba55c00300382672d9,HDFC,Revenue-COD,5eecc6d6449e4f7cfb1c2708,2021-12-01T00:00:00.000Z,NEFT CR-KKBK0000958-PICKRR TECHNOLOGIES PVT LTD-SLICKORGANICSPRIVATELIMITED-CMS3 352104007941,insurance,,net_banking_transfer,8211
61fa3404d8beac15990e60b7,50200023535069,346731.6,60ec41ba55c00300382672d9,HDFC,direct expenses,5eecc6d6449e4f7cfb1c2708,2021-12-01T00:00:00.000Z,"NEFT DR-KKBK0000180-VEDIC COSMECEUTICALS PVT LTD-NETBANK, MUM-N335211734123738-5 00000",,,net_banking_transfer,-500000
61fa3404d8beac15990e60b9,50200023535069,146731.6,60ec41ba55c00300382672d9,HDFC,direct expenses,5eecc6d6449e4f7cfb1c2708,2021-12-01T00:00:00.000Z,IMPS-133518123650-PAYTM-PYTM-XXXXXXXX383 9-200000,ewallet,,net_banking_transfer,-200000
61fa3404d8beac15990e60bb,50200023535069,148298.55,60ec41ba55c00300382672d9,HDFC,Revenue-PG-non-split,5eecc6d6449e4f7cfb1c2708,2021-12-01T00:00:00.000Z,NEFT CR-IDFB0010204-SEZZLE PAYMENTS PRIV ATE LIMITED-SLICK ORGANICS PRIVATE LIMIT ED-IDFBH21335127360,insurance,,net_banking_transfer,1566.95
61fa3404d8beac15990e60bd,50200023535069,163752.47,60ec41ba55c00300382672d9,HDFC,Revenue-PG-non-split,5eecc6d6449e4f7cfb1c2708,2021-12-02T00:00:00.000Z,IMPS-133604482529-PAYTM PAYMENTS SERVI-P YTM-XXXXXXXXXX0008-ALL202112022168200003 30830668628,ewallet,,net_banking_transfer,15453.92
61fa3404d8beac15990e60bf,50200023535069,141898.17,60ec41ba55c00300382672d9,HDFC,direct expenses,5eecc6d6449e4f7cfb1c2708,2021-12-02T00:00:00.000Z,POS 514834XXXXXX9486 AMZN AD TJQHL75V,,,debit_card,-21854.3
61fa3404d8beac15990e60c1,50200023535069,142157.66,60ec41ba55c00300382672d9,HDFC,Revenue-PG-split enabled,5eecc6d6449e4f7cfb1c2708,2021-12-02T00:00:00.000Z,NEFT CR-UTIB0001506-RAZORPAY SOFTWARE PR IVATE LIMITED-SLICK ORGANICS PVT LITD-AX ISCN0108386765,insurance,,net_banking_transfer,259.49
61fa3404d8beac15990e60c3,50200023535069,125544.66,60ec41ba55c00300382672d9,HDFC,direct expenses,5eecc6d6449e4f7cfb1c2708,2021-12-02T00:00:00.000Z,"NEFT DR-ICIC0000021-AKHILESH DIXIT-NETBA NK, MUM-N336211735013970-16613",,,net_banking_transfer,-16613
61fa3404d8beac15990e60c5,50200023535069,125807.82,60ec41ba55c00300382672d9,HDFC,Revenue-Mktplace,5eecc6d6449e4f7cfb1c2708,2021-12-02T00:00:00.000Z,NEFT CR-ICIC0000105-MANASH LIFESTYLE PRI VATE LIMITED NO-SLICK ORGANICS PRIVATE L IMITED BANG-ICIJ213360002451,shopping,,net_banking_transfer,263.16
61fa3404d8beac15990e60c7,50200023535069,126257.14,60ec41ba55c00300382672d9,HDFC,Revenue-Mktplace,5eecc6d6449e4f7cfb1c2708,2021-12-02T00:00:00.000Z,NEFT CR-ICIC0000105-MANASH LIFESTYLE PRI,shopping,,net_banking_transfer,449.32
61fa3404d8beac15990e60c9,50200023535069,127131.62,60ec41ba55c00300382672d9,HDFC,Revenue-Mktplace,5eecc6d6449e4f7cfb1c2708,2021-12-02T00:00:00.000Z,NEFT CR-ICIC0000105-MANASH LIFESTYLE PRI VATE LIMITED NO-SLICK ORGANICS PRIVATE L IMITED MP M-ICIJ213360004363,shopping,,net_banking_transfer,874.48
61fa3404d8beac15990e60cb,50200023535069,127438.75,60ec41ba55c00300382672d9,HDFC,Revenue-Mktplace,5eecc6d6449e4f7cfb1c2708,2021-12-02T00:00:00.000Z,NEFT CR-ICIC0000105-MANASH LIFESTYLE PRI VATE LIMITED NO-SLICK ORGANICS PRIVATE L IMITED KOLK-ICIJ213360004364,shopping,,net_banking_transfer,307.13
61fa3404d8beac15990e60cd,50200023535069,152612.53,60ec41ba55c00300382672d9,HDFC,Revenue-UPI,5eecc6d6449e4f7cfb1c2708,2021-12-02T00:00:00.000Z,UPI-GOKWIK-GOKWIK@YESBANK-YESB0000340-13 3632592188-PAYOUT FOR DECEMBE,,,upi,25173.78
61fa3404d8beac15990e60cf,50200023535069,123507.36,60ec41ba55c00300382672d9,HDFC,direct expenses,5eecc6d6449e4f7cfb1c2708,2021-12-02T00:00:00.000Z,POS 514834XXXXXX9486 AMZN AD TR95V0H3,,,debit_card,-29105.17
61fa3404d8beac15990e60d1,50200023535069,1123507.36,60ec41ba55c00300382672d9,HDFC,Internal Transfers,5eecc6d6449e4f7cfb1c2708,2021-12-02T00:00:00.000Z,IB FUNDS TRANSFER CR-50200035187206 -SL ICK ORGANICS PVT LTD,insurance,,Other,1000000
61fa3404d8beac15990e60d3,50200023535069,23507.36,60ec41ba55c00300382672d9,HDFC,direct expenses,5eecc6d6449e4f7cfb1c2708,2021-12-02T00:00:00.000Z,"NEFT DR-PYTM0123456-PAYTM-NETBANK, MUM-N 336211735598226-1100000",ewallet,,net_banking_transfer,-1100000
61fa3404d8beac15990e60d5,50200023535069,23686.13,60ec41ba55c00300382672d9,HDFC,Revenue-PG-split enabled,5eecc6d6449e4f7cfb1c2708,2021-12-02T00:00:00.000Z,NEFT CR-UTIB0001506-RAZORPAY SOFTWARE PR IVATE LIMITED-SLICK ORGANICS PVT LITD-AX ISCN0108558150,insurance,,net_banking_transfer,178.77
61fa3404d8beac15990e60d7,50200023535069,42276.13,60ec41ba55c00300382672d9,HDFC,Revenue-PG-non-split,5eecc6d6449e4f7cfb1c2708,2021-12-03T00:00:00.000Z,IMPS-133704666153-PAYTM PAYMENTS SERVI-P YTM-XXXXXXXXXX0008-ALL202112032168200003 30830668628,ewallet,,net_banking_transfer,18590
61fa3404d8beac15990e60d9,50200023535069,54196.89,60ec41ba55c00300382672d9,HDFC,Revenue-Mktplace,5eecc6d6449e4f7cfb1c2708,2021-12-03T00:00:00.000Z,NEFT CR-DEUT0797BGL-FLIPKART INTERNET PR IVATE LIMITED-SLICK ORGANICS PVT LTD-133 700233GN00240,shopping,,net_banking_transfer,11920.76
61fa3404d8beac15990e60db,50200023535069,54220.88,60ec41ba55c00300382672d9,HDFC,Revenue-PG-split enabled,5eecc6d6449e4f7cfb1c2708,2021-12-03T00:00:00.000Z,NEFT CR-UTIB0001506-RAZORPAY SOFTWARE PR IVATE LIMITED-SLICK ORGANICS PVT LITD-AX ISCN0108669163,insurance,,net_banking_transfer,23.99
61fa3404d8beac15990e60dd,50200023535069,1054220.88,60ec41ba55c00300382672d9,HDFC,Internal Transfers,5eecc6d6449e4f7cfb1c2708,2021-12-03T00:00:00.000Z,IB FUNDS TRANSFER CR-50200035187206 -SL ICK ORGANICS PVT LTD,insurance,,Other,1000000
61fa3404d8beac15990e60df,50200023535069,854220.88,60ec41ba55c00300382672d9,HDFC,direct expenses,5eecc6d6449e4f7cfb1c2708,2021-12-03T00:00:00.000Z,IMPS-133710191478-PAYTM-PYTM-XXXXXXXX383 9-20000,ewallet,,net_banking_transfer,-200000
61fa3404d8beac15990e60e1,50200023535069,654220.88,60ec41ba55c00300382672d9,HDFC,direct expenses,5eecc6d6449e4f7cfb1c2708,2021-12-03T00:00:00.000Z,IMPS-133710196408-PAYTM-PYTM-XXXXXXXX383,ewallet,,net_banking_transfer,-200000
61fa3404d8beac15990e60e3,50200023535069,427249.88,60ec41ba55c00300382672d9,HDFC,N-ACH payments,5eecc6d6449e4f7cfb1c2708,2021-12-03T00:00:00.000Z,ACH D- CTRAZORPAY-GETVANTAGEISXMMGUICGQF,loans,lender_transaction,auto_debit_payment,-226971
61fa3404d8beac15990e60e5,50200023535069,386259.88,60ec41ba55c00300382672d9,HDFC,direct expenses,5eecc6d6449e4f7cfb1c2708,2021-12-03T00:00:00.000Z,"NEFT DR-YESB0000162-VINAY REDDY-NETBANK, MUM-N337211736414028-40990",,,net_banking_transfer,-40990
61fa3404d8beac15990e60e7,50200023535069,398955.56,60ec41ba55c00300382672d9,HDFC,Revenue-COD,5eecc6d6449e4f7cfb1c2708,2021-12-03T00:00:00.000Z,NEFT CR-ICIC0000155-SHIPROCKET COD CRF I D 3475212-SLICK ORGANICS PVT LTD-CMS2270 070973,insurance,,net_banking_transfer,12695.68
61fa3404d8beac15990e60e9,50200023535069,143955.56,60ec41ba55c00300382672d9,HDFC,SAAS/tech expense,5eecc6d6449e4f7cfb1c2708,2021-12-03T00:00:00.000Z,KQSX44UPBN62DP6TCM/PAYUAMAZON,shopping,,Other,-255000
61fa3404d8beac15990e60eb,50200023535069,170860.18,60ec41ba55c00300382672d9,HDFC,Revenue-UPI,5eecc6d6449e4f7cfb1c2708,2021-12-03T00:00:00.000Z,UPI-GOKWIK-GOKWIK@YESBANK-YESB0000340-13 3734113093-PAYOUT FOR DECEMBE,,,upi,26904.62
61fa3404d8beac15990e60ed,50200023535069,171667.96,60ec41ba55c00300382672d9,HDFC,Revenue-Mktplace,5eecc6d6449e4f7cfb1c2708,2021-12-03T00:00:00.000Z,NEFT CR-ICIC0000105-MANASH LIFESTYLE PRI VATE LIMITED NO-SLICK ORGANICS PRIVATE L IMITED KOLK-ICIJ213370007063,shopping,,net_banking_transfer,807.78
61fa3404d8beac15990e60ef,50200023535069,173507.81,60ec41ba55c00300382672d9,HDFC,Revenue-Mktplace,5eecc6d6449e4f7cfb1c2708,2021-12-03T00:00:00.000Z,NEFT CR-ICIC0000105-MANASH LIFESTYLE PRI VATE LIMITED NO-SLICK ORGANICS PRIVATE L IMITED MP M-ICIJ213370005297,shopping,,net_banking_transfer,1839.85
61fa3404d8beac15990e60f1,50200023535069,173564.24,60ec41ba55c00300382672d9,HDFC,Revenue-PG-split enabled,5eecc6d6449e4f7cfb1c2708,2021-12-03T00:00:00.000Z,NEFT CR-UTIB0001506-RAZORPAY SOFTWARE PR IVATE LIMITED-SLICK ORGANICS PVT LITD-AX ISCN0108813356,insurance,,net_banking_transfer,56.43
61fa3404d8beac15990e60f3,50200023535069,196595.24,60ec41ba55c00300382672d9,HDFC,Revenue-Mktplace,5eecc6d6449e4f7cfb1c2708,2021-12-03T00:00:00.000Z,NEFT CR-SCBL0036001-M/S DREAMPLUG TECHNO -SLICK ORGANICS PRIVATE LIMITEDSLICK-SIN 31436Q0026957,insurance,,net_banking_transfer,23031
61fa3404d8beac15990e60f5,50200023535069,204303.67,60ec41ba55c00300382672d9,HDFC,Revenue-PG-non-split,5eecc6d6449e4f7cfb1c2708,2021-12-04T00:00:00.000Z,UPI-PAYTM-PPSL-PAYOUTS@PAYTM-PYTM0123456 -133880926108-ALL202112042168200,ewallet,,upi,7708.43
61fa3404d8beac15990e60f7,50200023535069,204443.1,60ec41ba55c00300382672d9,HDFC,Revenue-PG-split enabled,5eecc6d6449e4f7cfb1c2708,2021-12-04T00:00:00.000Z,NEFT CR-UTIB0001506-RAZORPAY SOFTWARE PR IVATE LIMITED-SLICK ORGANICS PVT LITD-AX ISCN0108906165,insurance,,net_banking_transfer,139.43
61fa3404d8beac15990e60f9,50200023535069,1204443.1,60ec41ba55c00300382672d9,HDFC,Internal Transfers,5eecc6d6449e4f7cfb1c2708,2021-12-04T00:00:00.000Z,IB FUNDS TRANSFER CR-50200035187206 -SL ICK ORGANICS PVT LTD,insurance,,Other,1000000
61fa3404d8beac15990e60fb,50200023535069,704443.1,60ec41ba55c00300382672d9,HDFC,direct expenses,5eecc6d6449e4f7cfb1c2708,2021-12-04T00:00:00.000Z,NEFT DR-YESB0000551-VISTTA COSMETICS-NET,,,net_banking_transfer,-500000
61fa3404d8beac15990e60fd,50200023535069,683203.1,60ec41ba55c00300382672d9,HDFC,direct expenses,5eecc6d6449e4f7cfb1c2708,2021-12-04T00:00:00.000Z,643191366/CSHFREINSTASPACES,,,Other,-21240
61fa3404d8beac15990e60ff,50200023535069,654883.1,60ec41ba55c00300382672d9,HDFC,direct expenses,5eecc6d6449e4f7cfb1c2708,2021-12-04T00:00:00.000Z,643200922/CSHFREINSTASPACES,,,Other,-28320
61fa3404d8beac15990e6101,50200023535069,637183.1,60ec41ba55c00300382672d9,HDFC,direct expenses,5eecc6d6449e4f7cfb1c2708,2021-12-04T00:00:00.000Z,643205429/CSHFREINSTASPACES,,,Other,-17700
61fa3404d8beac15990e6103,50200023535069,619483.1,60ec41ba55c00300382672d9,HDFC,direct expenses,5eecc6d6449e4f7cfb1c2708,2021-12-04T00:00:00.000Z,643211715/CSHFREINSTASPACES,,,Other,-17700
61fa3404d8beac15990e6105,50200023535069,643111.02,60ec41ba55c00300382672d9,HDFC,Revenue-UPI,5eecc6d6449e4f7cfb1c2708,2021-12-04T00:00:00.000Z,UPI-GOKWIK-GOKWIK@YESBANK-YESB0000340-13 3835670158-PAYOUT FOR DECEMBE,,,upi,23627.92
61fa3404d8beac15990e6107,50200023535069,645991.74,60ec41ba55c00300382672d9,HDFC,Transfer in/Revenue-other,5eecc6d6449e4f7cfb1c2708,2021-12-04T00:00:00.000Z,ZOOBOP ME WORK-ARATA,,,Other,2880.72
61fa3404d8beac15990e6109,50200023535069,649739.74,60ec41ba55c00300382672d9,HDFC,Transfer in/Revenue-other,5eecc6d6449e4f7cfb1c2708,2021-12-04T00:00:00.000Z,NEFT CR-KKBK0000958-INNOVATIVE RETAIL CO NCEPTS PRIVATE LTD-SLICK ORGANICS PVT LT D-KKBK213389734939,,,net_banking_transfer,3748
61fa3404d8beac15990e610b,50200023535069,658179.34,60ec41ba55c00300382672d9,HDFC,Transfer in/Revenue-other,5eecc6d6449e4f7cfb1c2708,2021-12-04T00:00:00.000Z,NEFT CR-KKBK0000958-INNOVATIVE RETAIL CO NCEPTS PRIVATE LTD-SLICK ORGANICS PVT LT D-KKBK213389734932,,,net_banking_transfer,8439.6
61fa3404d8beac15990e610d,50200023535069,676078.34,60ec41ba55c00300382672d9,HDFC,Transfer in/Revenue-other,5eecc6d6449e4f7cfb1c2708,2021-12-04T00:00:00.000Z,NEFT CR-KKBK0000958-INNOVATIVE RETAIL CO NCEPTS PRIVATE LTD-SLICK ORGANICS PVT LT D-KKBK213389735042,,,net_banking_transfer,17899
61fa3404d8beac15990e610f,50200023535069,679997.34,60ec41ba55c00300382672d9,HDFC,Revenue-COD,5eecc6d6449e4f7cfb1c2708,2021-12-04T00:00:00.000Z,NEFT CR-KKBK0000958-PICKRR TECHNOLOGIES PVT LTD-SLICKORGANICSPRIVATELIMITED-CMS3 382104152732,insurance,,net_banking_transfer,3919
61fa3404d8beac15990e6111,50200023535069,680071.42,60ec41ba55c00300382672d9,HDFC,Revenue-PG-split enabled,5eecc6d6449e4f7cfb1c2708,2021-12-04T00:00:00.000Z,NEFT CR-UTIB0001506-RAZORPAY SOFTWARE PR IVATE LIMITED-SLICK ORGANICS PVT LITD-AX ISCN0109040970,insurance,,net_banking_transfer,74.08
61fa3405d8beac15990e6113,50200023535069,693309.32,60ec41ba55c00300382672d9,HDFC,Revenue-PG-non-split,5eecc6d6449e4f7cfb1c2708,2021-12-05T00:00:00.000Z,IMPS-133904091118-PAYTM PAYMENTS SERVI-P YTM-XXXXXXXXXX0008-ALL202112052168200003 30830668628,ewallet,,net_banking_transfer,13237.9
61fa3405d8beac15990e6115,50200023535069,727240.19,60ec41ba55c00300382672d9,HDFC,Revenue-UPI,5eecc6d6449e4f7cfb1c2708,2021-12-05T00:00:00.000Z,UPI-GOKWIK-GOKWIK@YESBANK-YESB0000340-13 3937111156-PAYOUT FOR DECEMBE,,,upi,33930.87
61fa3405d8beac15990e6117,50200023535069,737789.2,60ec41ba55c00300382672d9,HDFC,Revenue-PG-non-split,5eecc6d6449e4f7cfb1c2708,2021-12-06T00:00:00.000Z,UPI-PAYTM-PPSL-PAYOUTS@PAYTM-PYTM0123456 -134080194426-ALL202112062168200,ewallet,,upi,10549.01
61fa3405d8beac15990e6119,50200023535069,752130.91,60ec41ba55c00300382672d9,HDFC,Revenue-Mktplace,5eecc6d6449e4f7cfb1c2708,2021-12-06T00:00:00.000Z,NEFT CR-DEUT0797BGL-FLIPKART INTERNET PR,shopping,,net_banking_transfer,14341.71
61fa3405d8beac15990e611b,50200023535069,602130.91,60ec41ba55c00300382672d9,HDFC,direct expenses,5eecc6d6449e4f7cfb1c2708,2021-12-06T00:00:00.000Z,"NEFT DR-INDB0000148-ACQUISORY INDIA CONS ULTING PVT LTD-NETBANK, MUM-N34021174001 5460-150000",,,net_banking_transfer,-150000
61fa3405d8beac15990e611d,50200023535069,602379.41,60ec41ba55c00300382672d9,HDFC,Revenue-Mktplace,5eecc6d6449e4f7cfb1c2708,2021-12-06T00:00:00.000Z,NEFT CR-ICIC0000105-MANASH LIFETYLE PVT LTD-SLICK ORGANICS PRIVATE LIMITED HYD- ICIB213400047662,,,net_banking_transfer,248.5
61fa3405d8beac15990e611f,50200023535069,602983.41,60ec41ba55c00300382672d9,HDFC,Revenue-Mktplace,5eecc6d6449e4f7cfb1c2708,2021-12-06T00:00:00.000Z,NEFT CR-ICIC0000105-MANASH LIFETYLE PVT LTD-SLICK ORGANICS PRIVATE LIMITED MP GG N-ICIB213400049501,,,net_banking_transfer,604
61fa3405d8beac15990e6121,50200023535069,605358.37,60ec41ba55c00300382672d9,HDFC,Revenue-Mktplace,5eecc6d6449e4f7cfb1c2708,2021-12-06T00:00:00.000Z,NEFT CR-ICIC0000105-MANASH LIFETYLE PVT LTD-SLICK ORGANICS PRIVATE LIMITED MP MU M-ICIB213400047657,,,net_banking_transfer,2374.96
61fa3405d8beac15990e6123,50200023535069,605768.12,60ec41ba55c00300382672d9,HDFC,Revenue-Mktplace,5eecc6d6449e4f7cfb1c2708,2021-12-06T00:00:00.000Z,NEFT CR-ICIC0000105-MANASH LIFETYLE PVT LTD-SLICK ORGANICS PRIVATE LIMITED KOLK ATA-ICIB213400047659,,,net_banking_transfer,409.75
61fa3405d8beac15990e6125,50200023535069,605617.51,60ec41ba55c00300382672d9,HDFC,bank charges,5eecc6d6449e4f7cfb1c2708,2021-12-06T00:00:00.000Z,.DC INTL POS TXN MARKUP+ST 121121 211121 -CDT2133806861750,,,international_transaction_arbitrage,-150.61
61fa3405d8beac15990e6127,50200023535069,604111.79,60ec41ba55c00300382672d9,HDFC,bank charges,5eecc6d6449e4f7cfb1c2708,2021-12-06T00:00:00.000Z,.DC INTL POS TXN MARKUP+ST 131121 211121 -CDT2133806861750,,,international_transaction_arbitrage,-1505.72
61fa3405d8beac15990e6129,50200023535069,602587.31,60ec41ba55c00300382672d9,HDFC,bank charges,5eecc6d6449e4f7cfb1c2708,2021-12-06T00:00:00.000Z,.DC INTL POS TXN MARKUP+ST 151121 211121 -CDT2133806861750,,,international_transaction_arbitrage,-1524.48
61fa3405d8beac15990e612b,50200023535069,602372.69,60ec41ba55c00300382672d9,HDFC,bank charges,5eecc6d6449e4f7cfb1c2708,2021-12-06T00:00:00.000Z,.DC INTL POS TXN MARKUP+ST 191121 211121 -CDT2133806861750,,,international_transaction_arbitrage,-214.62
61fa3405d8beac15990e612d,50200023535069,602343.19,60ec41ba55c00300382672d9,HDFC,direct expenses,5eecc6d6449e4f7cfb1c2708,2021-12-06T00:00:00.000Z,.POS DECCHG 20/11/21 CARDEND 9486 211121 -CDT2133806861751,,,bank_charge,-29.5
61fa3405d8beac15990e612f,50200023535069,602313.69,60ec41ba55c00300382672d9,HDFC,direct expenses,5eecc6d6449e4f7cfb1c2708,2021-12-06T00:00:00.000Z,.POS DECCHG 20/11/21 CARDEND 9486 211121 -CDT2133806861751,,,bank_charge,-29.5
61fa3405d8beac15990e6131,50200023535069,612744.27,60ec41ba55c00300382672d9,HDFC,Revenue-COD,5eecc6d6449e4f7cfb1c2708,2021-12-06T00:00:00.000Z,NEFT CR-ICIC0000155-SHIPROCKET COD CRF I D 3483401-SLICK ORGANICS PVT LTD-CMS2274 150993,insurance,,net_banking_transfer,10430.58
61fa3405d8beac15990e6133,50200023535069,613295.48,60ec41ba55c00300382672d9,HDFC,Revenue-PG-split enabled,5eecc6d6449e4f7cfb1c2708,2021-12-06T00:00:00.000Z,NEFT CR-UTIB0001506-RAZORPAY SOFTWARE PR,,,net_banking_transfer,551.21
61fa3405d8beac15990e6135,50200023535069,613910.57,60ec41ba55c00300382672d9,HDFC,Revenue-PG-non-split,5eecc6d6449e4f7cfb1c2708,2021-12-06T00:00:00.000Z,NEFT CR-IDFB0010204-SEZZLE PAYMENTS PRIV ATE LIMITED-SLICK ORGANICS PRIVATE LIMIT ED-IDFBH21340440199,insurance,,net_banking_transfer,615.09
61fa3405d8beac15990e6137,50200023535069,614489.47,60ec41ba55c00300382672d9,HDFC,Revenue-PG-non-split,5eecc6d6449e4f7cfb1c2708,2021-12-06T00:00:00.000Z,NEFT CR-IDFB0010204-SEZZLE PAYMENTS PRIV ATE LIMITED-SLICK ORGANICS PRIVATE LIMIT ED-IDFBH21340440656,insurance,,net_banking_transfer,578.9
61fa3405d8beac15990e6139,50200023535069,541163.47,60ec41ba55c00300382672d9,HDFC,direct expenses,5eecc6d6449e4f7cfb1c2708,2021-12-06T00:00:00.000Z,"NEFT DR-KKBK0005289-HILL GROOVE CONSULTI NG LLP-NETBANK, MUM-N340211741334330-733 26",,,net_banking_transfer,-73326
61fa3405d8beac15990e613b,50200023535069,551484.85,60ec41ba55c00300382672d9,HDFC,Revenue-PG-non-split,5eecc6d6449e4f7cfb1c2708,2021-12-07T00:00:00.000Z,UPI-PAYTM-PPSL-PAYOUTS@PAYTM-PYTM0123456 -134128307900-ALL202112072168200,ewallet,,upi,10321.38
61fa3405d8beac15990e613d,50200023535069,590107.57,60ec41ba55c00300382672d9,HDFC,Revenue-Mktplace,5eecc6d6449e4f7cfb1c2708,2021-12-07T00:00:00.000Z,IMPS-134105208652-AMAZON SELLER SERVIC-H SBC-XXXXXXXX6004-46KXTSBTD3F9IA3RSLICK O RGANICS PVT LTD,shopping,,net_banking_transfer,38622.72
61fa3405d8beac15990e613f,50200023535069,721195.18,60ec41ba55c00300382672d9,HDFC,Revenue-Mktplace,5eecc6d6449e4f7cfb1c2708,2021-12-07T00:00:00.000Z,NEFT CR-DEUT0797BGL-AMAZON PAY (INDIA) P RIVATE LIMITED-SLICK ORGANICS PVT LTD-13 4100100GN00490,shopping,,net_banking_transfer,131087.61
61fa3405d8beac15990e6141,50200023535069,624529.18,60ec41ba55c00300382672d9,HDFC,direct expenses,5eecc6d6449e4f7cfb1c2708,2021-12-07T00:00:00.000Z,"NEFT DR-ICIC0000021-AKHILESH DIXIT-NETBA NK, MUM-N341211741606488-96666",,,net_banking_transfer,-96666
61fa3405d8beac15990e6143,50200023535069,533949.18,60ec41ba55c00300382672d9,HDFC,direct expenses,5eecc6d6449e4f7cfb1c2708,2021-12-07T00:00:00.000Z,"NEFT DR-ICIC0000542-AVANTIKA SUKHIA-NETB ANK, MUM-N341211741596738-90580",,,net_banking_transfer,-90580
61fa3405d8beac15990e6145,50200023535069,483949.18,60ec41ba55c00300382672d9,HDFC,direct expenses,5eecc6d6449e4f7cfb1c2708,2021-12-07T00:00:00.000Z,"NEFT DR-UTIB0000120-ADNAN ALI-NETBANK, M UM-N341211741605225-50000",,,net_banking_transfer,-50000
61fa3405d8beac15990e6147,50200023535069,462449.18,60ec41ba55c00300382672d9,HDFC,direct expenses,5eecc6d6449e4f7cfb1c2708,2021-12-07T00:00:00.000Z,"NEFT DR-SIBL0000555-JAIVEER KUMAR-NETBAN K, MUM-N341211741606719-21500",,,net_banking_transfer,-21500
61fa3405d8beac15990e6149,50200023535069,440949.18,60ec41ba55c00300382672d9,HDFC,direct expenses,5eecc6d6449e4f7cfb1c2708,2021-12-07T00:00:00.000Z,"NEFT DR-PUNB0307800-PRAKASH JHA-NETBANK, MUM-N341211741617605-21500",,,net_banking_transfer,-21500
61fa3405d8beac15990e614b,50200023535069,419449.18,60ec41ba55c00300382672d9,HDFC,direct expenses,5eecc6d6449e4f7cfb1c2708,2021-12-07T00:00:00.000Z,"NEFT DR-PUNB0482100-RAM BHAVAN YADAV-NET BANK, MUM-N341211741597075-21500",,,net_banking_transfer,-21500
61fa3405d8beac15990e614d,50200023535069,363949.18,60ec41ba55c00300382672d9,HDFC,direct expenses,5eecc6d6449e4f7cfb1c2708,2021-12-07T00:00:00.000Z,50100293329616-TPT-55500-SADIYA BANO,,,net_banking_transfer,-55500
61fa3405d8beac15990e614f,50200023535069,328949.18,60ec41ba55c00300382672d9,HDFC,direct expenses,5eecc6d6449e4f7cfb1c2708,2021-12-07T00:00:00.000Z,50100064106714-TPT-35000-AKSHARANSH BHAT,,,net_banking_transfer,-35000
61fa3405d8beac15990e6152,50200023535069,292949.18,60ec41ba55c00300382672d9,HDFC,direct expenses,5eecc6d6449e4f7cfb1c2708,2021-12-07T00:00:00.000Z,00901610080520-TPT-36000-POOJA KAPIL SHR OTRIYA,,,net_banking_transfer,-36000
61fa3405d8beac15990e6154,50200023535069,274290.18,60ec41ba55c00300382672d9,HDFC,direct expenses,5eecc6d6449e4f7cfb1c2708,2021-12-07T00:00:00.000Z,02711600008220-TPT-18659-VARUN SINGH,,,net_banking_transfer,-18659
61fa3405d8beac15990e6156,50200023535069,255631.18,60ec41ba55c00300382672d9,HDFC,direct expenses,5eecc6d6449e4f7cfb1c2708,2021-12-07T00:00:00.000Z,"NEFT DR-PUNB0151400-BHUWAN CHANDER JOSHI -NETBANK, MUM-N341211741621255-18659",,,net_banking_transfer,-18659
61fa3405d8beac15990e6158,50200023535069,155631.18,60ec41ba55c00300382672d9,HDFC,direct expenses,5eecc6d6449e4f7cfb1c2708,2021-12-07T00:00:00.000Z,"NEFT DR-PYTM0123456-PAYTM-NETBANK, MUM-N 341211741597919-100000",ewallet,,net_banking_transfer,-100000
61fa3405d8beac15990e615a,50200023535069,43031.18,60ec41ba55c00300382672d9,HDFC,direct expenses,5eecc6d6449e4f7cfb1c2708,2021-12-07T00:00:00.000Z,50100093802387-TPT-112600-ISSHANA MAHAJA N,,,net_banking_transfer,-112600
61fa3405d8beac15990e615c,50200023535069,543031.18,60ec41ba55c00300382672d9,HDFC,Internal Transfers,5eecc6d6449e4f7cfb1c2708,2021-12-07T00:00:00.000Z,IB FUNDS TRANSFER CR-50200035187206 -SL ICK ORGANICS PVT LTD,insurance,,Other,500000
61fa3405d8beac15990e615e,50200023535069,543185.59,60ec41ba55c00300382672d9,HDFC,Revenue-PG-split enabled,5eecc6d6449e4f7cfb1c2708,2021-12-07T00:00:00.000Z,NEFT CR-UTIB0001506-RAZORPAY SOFTWARE PR IVATE LIMITED-SLICK ORGANICS PVT LITD-AX ISCN0109558745,insurance,,net_banking_transfer,154.41
61fa3405d8beac15990e6160,50200023535069,543178.89,60ec41ba55c00300382672d9,HDFC,bank charges,5eecc6d6449e4f7cfb1c2708,2021-12-07T00:00:00.000Z,.DC INTL POS TXN MARKUP+ST 231121 241121 -CDT2133806861750,,,international_transaction_arbitrage,-6.7
61fa3405d8beac15990e6162,50200023535069,541648.7,60ec41ba55c00300382672d9,HDFC,bank charges,5eecc6d6449e4f7cfb1c2708,2021-12-07T00:00:00.000Z,.DC INTL POS TXN MARKUP+ST 231121 251121 -CDT2133806861750,,,international_transaction_arbitrage,-1530.19
61fa3405d8beac15990e6164,50200023535069,474148.7,60ec41ba55c00300382672d9,HDFC,direct expenses,5eecc6d6449e4f7cfb1c2708,2021-12-07T00:00:00.000Z,"NEFT DR-BARB0VJMATU-ARTISTO DESIGNZ-NETB ANK, MUM-N341211741821440-67500",,,net_banking_transfer,-67500
61fa3405d8beac15990e6166,50200023535069,425548.7,60ec41ba55c00300382672d9,HDFC,direct expenses,5eecc6d6449e4f7cfb1c2708,2021-12-07T00:00:00.000Z,"NEFT DR-CNRB0015170-SNEHAL TAYDE-NETBANK , MUM-N341211741817693-48600",,,net_banking_transfer,-48600
61fa3405d8beac15990e6168,50200023535069,325548.7,60ec41ba55c00300382672d9,HDFC,agency/vendor expense,5eecc6d6449e4f7cfb1c2708,2021-12-07T00:00:00.000Z,"NEFT DR-KKBK0000298-ADMITAD MEDIA PRIVAT E LIMITED-NETBANK, MUM-N341211741859595- 100000",loans,lender_transaction,net_banking_transfer,-100000
61fa3405d8beac15990e616a,50200023535069,272536.7,60ec41ba55c00300382672d9,HDFC,direct expenses,5eecc6d6449e4f7cfb1c2708,2021-12-07T00:00:00.000Z,"NEFT DR-KKBK0000187-APPLIED LIFE PRIVATE LIMITED-NETBANK, MUM-N341211741875051-5 3012",,,net_banking_transfer,-53012
61fa3405d8beac15990e616c,50200023535069,271008.23,60ec41ba55c00300382672d9,HDFC,bank charges,5eecc6d6449e4f7cfb1c2708,2021-12-07T00:00:00.000Z,.DC INTL POS TXN MARKUP+ST 241121 261121 -CDT2133806861750,,,international_transaction_arbitrage,-1528.47
61fa3405d8beac15990e616e,50200023535069,204048.23,60ec41ba55c00300382672d9,HDFC,direct expenses,5eecc6d6449e4f7cfb1c2708,2021-12-07T00:00:00.000Z,NEFT DR-DBSS0IN0811-SARANSH KULKARNI-NET,,,net_banking_transfer,-66960
61fa3405d8beac15990e6170,50200023535069,704048.23,60ec41ba55c00300382672d9,HDFC,Internal Transfers,5eecc6d6449e4f7cfb1c2708,2021-12-07T00:00:00.000Z,IB FUNDS TRANSFER CR-50200035187206 -SL ICK ORGANICS PVT LTD,insurance,,Other,500000
61fa3405d8beac15990e6172,50200023535069,204048.23,60ec41ba55c00300382672d9,HDFC,direct expenses,5eecc6d6449e4f7cfb1c2708,2021-12-07T00:00:00.000Z,"NEFT DR-PYTM0123456-PAYTM-NETBANK, MUM-N 341211741945852-500000",ewallet,,net_banking_transfer,-500000
61fa3405d8beac15990e6174,50200023535069,203789.98,60ec41ba55c00300382672d9,HDFC,bank charges,5eecc6d6449e4f7cfb1c2708,2021-12-07T00:00:00.000Z,.DC INTL POS TXN MARKUP+ST 261121 281121 -CDT2133806861750,,,international_transaction_arbitrage,-258.25
61fa3405d8beac15990e6176,50200023535069,177239.98,60ec41ba55c00300382672d9,HDFC,direct expenses,5eecc6d6449e4f7cfb1c2708,2021-12-07T00:00:00.000Z,50200043297657-TPT-26550-AIDC PRODUCTS I NDIA PRIVATE LIMITED,,,net_banking_transfer,-26550
61fa3405d8beac15990e6178,50200023535069,176496.79,60ec41ba55c00300382672d9,HDFC,bank charges,5eecc6d6449e4f7cfb1c2708,2021-12-07T00:00:00.000Z,.DC INTL POS TXN MARKUP+ST 271121 291121 -CDT2133806861750,,,international_transaction_arbitrage,-743.19
61fa3405d8beac15990e617a,50200023535069,174947.97,60ec41ba55c00300382672d9,HDFC,bank charges,5eecc6d6449e4f7cfb1c2708,2021-12-07T00:00:00.000Z,.DC INTL POS TXN MARKUP+ST 271121 291121 -CDT2133806861750,,,international_transaction_arbitrage,-1548.82
61fa3405d8beac15990e617c,50200023535069,674947.97,60ec41ba55c00300382672d9,HDFC,Internal Transfers,5eecc6d6449e4f7cfb1c2708,2021-12-07T00:00:00.000Z,IB FUNDS TRANSFER CR-50200035187206 -SL ICK ORGANICS PVT LTD,insurance,,Other,500000
61fa3405d8beac15990e617e,50200023535069,679234.1,60ec41ba55c00300382672d9,HDFC,Revenue-PG-non-split,5eecc6d6449e4f7cfb1c2708,2021-12-07T00:00:00.000Z,NEFT CR-IDFB0010204-SEZZLE PAYMENTS PRIV ATE LIMITED-SLICK ORGANICS PRIVATE LIMIT ED-IDFBH21341516140,insurance,,net_banking_transfer,4286.13
61fa3405d8beac15990e6180,50200023535069,730087.87,60ec41ba55c00300382672d9,HDFC,Revenue-UPI,5eecc6d6449e4f7cfb1c2708,2021-12-07T00:00:00.000Z,UPI-GOKWIK-GOKWIK@YESBANK-YESB0000340-13 4140024957-PAYOUT FOR DECEMBE,,,upi,50853.77
61fa3405d8beac15990e6182,50200023535069,730192.35,60ec41ba55c00300382672d9,HDFC,Revenue-PG-split enabled,5eecc6d6449e4f7cfb1c2708,2021-12-07T00:00:00.000Z,NEFT CR-UTIB0001506-RAZORPAY SOFTWARE PR IVATE LIMITED-SLICK ORGANICS PVT LITD-AX ISCN0109798230,insurance,,net_banking_transfer,104.48
61fa3405d8beac15990e6184,50200023535069,630192.35,60ec41ba55c00300382672d9,HDFC,direct expenses,5eecc6d6449e4f7cfb1c2708,2021-12-07T00:00:00.000Z,"NEFT DR-SCBL0036025-DHRUV MADHOK-NETBANK , MUM-N341211743405550-100000",,,net_banking_transfer,-100000
61fa3405d8beac15990e6187,50200023535069,645370.02,60ec41ba55c00300382672d9,HDFC,Revenue-PG-non-split,5eecc6d6449e4f7cfb1c2708,2021-12-08T00:00:00.000Z,IMPS-134204805943-PAYTM PAYMENTS SERVI-P YTM-XXXXXXXXXX0008-ALL202112082168200003 30830668628,ewallet,,net_banking_transfer,15177.67
61fa3405d8beac15990e6189,50200023535069,669740.83,60ec41ba55c00300382672d9,HDFC,Revenue-Mktplace,5eecc6d6449e4f7cfb1c2708,2021-12-08T00:00:00.000Z,NEFT CR-DEUT0797BGL-FLIPKART INTERNET PR IVATE LIMITED-SLICK ORGANICS PVT LTD-134 201258GN00276,shopping,,net_banking_transfer,24370.81
61fa3405d8beac15990e618b,50200023535069,197240.83,60ec41ba55c00300382672d9,HDFC,direct expenses,5eecc6d6449e4f7cfb1c2708,2021-12-08T00:00:00.000Z,NEFT DR-PUNB0092200-AKANKSHA GUPTA-NETBA,,,net_banking_transfer,-472500
61fa3405d8beac15990e618d,50200023535069,1197240.83,60ec41ba55c00300382672d9,HDFC,Internal Transfers,5eecc6d6449e4f7cfb1c2708,2021-12-08T00:00:00.000Z,IB FUNDS TRANSFER CR-50200035187206 -SL ICK ORGANICS PVT LTD,insurance,,Other,1000000
61fa3405d8beac15990e618f,50200023535069,1197377.5,60ec41ba55c00300382672d9,HDFC,Revenue-PG-split enabled,5eecc6d6449e4f7cfb1c2708,2021-12-08T00:00:00.000Z,NEFT CR-UTIB0001506-RAZORPAY SOFTWARE PR IVATE LIMITED-SLICK ORGANICS PVT LITD-AX ISCN0109908482,insurance,,net_banking_transfer,136.67
61fa3405d8beac15990e6191,50200023535069,997377.5,60ec41ba55c00300382672d9,HDFC,direct expenses,5eecc6d6449e4f7cfb1c2708,2021-12-08T00:00:00.000Z,"NEFT DR-PYTM0123456-PAYTM-NETBANK, MUM-N 342211743763629-200000",ewallet,,net_banking_transfer,-200000
61fa3405d8beac15990e6193,50200023535069,1997377.5,60ec41ba55c00300382672d9,HDFC,Internal Transfers,5eecc6d6449e4f7cfb1c2708,2021-12-08T00:00:00.000Z,IB FUNDS TRANSFER CR-50200035187206 -SL ICK ORGANICS PVT LTD,insurance,,Other,1000000
61fa3405d8beac15990e6195,50200023535069,997377.5,60ec41ba55c00300382672d9,HDFC,Marketing Expense,5eecc6d6449e4f7cfb1c2708,2021-12-08T00:00:00.000Z,"NEFT DR-CITI0000006-FACEBOOK INDIA ONLIN E SERVICES PVT LTD-NETBANK, MUM-N3422117 43876044-1000000",,,net_banking_transfer,-1000000
61fa3405d8beac15990e6197,50200023535069,497377.5,60ec41ba55c00300382672d9,HDFC,direct expenses,5eecc6d6449e4f7cfb1c2708,2021-12-08T00:00:00.000Z,"NEFT DR-KKBK0000180-VEDIC COSMECEUTICALS PVT LTD-NETBANK, MUM-N342211743902452-5 00000",,,net_banking_transfer,-500000
61fa3405d8beac15990e6199,50200023535069,997377.5,60ec41ba55c00300382672d9,HDFC,Internal Transfers,5eecc6d6449e4f7cfb1c2708,2021-12-08T00:00:00.000Z,IB FUNDS TRANSFER CR-50200035187206 -SL ICK ORGANICS PVT LTD,insurance,,Other,500000
61fa3405d8beac15990e619b,50200023535069,1040038.04,60ec41ba55c00300382672d9,HDFC,Revenue-COD,5eecc6d6449e4f7cfb1c2708,2021-12-08T00:00:00.000Z,NEFT CR-ICIC0000155-SHIPROCKET COD CRF I D 3495763-SLICK ORGANICS PVT LTD-CMS2278 100138,insurance,,net_banking_transfer,42660.54
61fa3405d8beac15990e619d,50200023535069,1040301.98,60ec41ba55c00300382672d9,HDFC,Revenue-PG-split enabled,5eecc6d6449e4f7cfb1c2708,2021-12-08T00:00:00.000Z,NEFT CR-UTIB0001506-RAZORPAY SOFTWARE PR IVATE LIMITED-SLICK ORGANICS PVT LITD-AX ISCN0110037398,insurance,,net_banking_transfer,263.94
61fa3405d8beac15990e619f,50200023535069,1140301.98,60ec41ba55c00300382672d9,HDFC,Transfer in/Revenue-other,5eecc6d6449e4f7cfb1c2708,2021-12-08T00:00:00.000Z,IMPS-134220122506-SHREE HARI GS ENTERP-I CIC-XXXXXXXX0137-SILKORGANICS,,,net_banking_transfer,100000
61fa3405d8beac15990e61a1,50200023535069,1140882.98,60ec41ba55c00300382672d9,HDFC,Transfer in/Revenue-other,5eecc6d6449e4f7cfb1c2708,2021-12-08T00:00:00.000Z,IMPS-134220141909-SHREE HARI GS ENTERP-I CIC-XXXXXXXX0137-SILKORGANICS,,,net_banking_transfer,581
61fa3405d8beac15990e61a3,50200023535069,1098799.54,60ec41ba55c00300382672d9,HDFC,direct expenses,5eecc6d6449e4f7cfb1c2708,2021-12-08T00:00:00.000Z,POS 514834XXXXXX9486 AMZN AD TJQHL75V,,,debit_card,-42083.44
61fa3405d8beac15990e61a6,50200023535069,1111611.34,60ec41ba55c00300382672d9,HDFC,Revenue-PG-non-split,5eecc6d6449e4f7cfb1c2708,2021-12-09T00:00:00.000Z,UPI-PAYTM-PPSL-PAYOUTS@PAYTM-PYTM0123456 -134326145782-ALL202112092168200,ewallet,,upi,12811.8
61fa3405d8beac15990e61a8,50200023535069,895611.34,60ec41ba55c00300382672d9,HDFC,direct expenses,5eecc6d6449e4f7cfb1c2708,2021-12-09T00:00:00.000Z,NEFT DR-UTIB0000514-NATS ASSOCIATES-NETB,,,net_banking_transfer,-216000
61fa3405d8beac15990e61aa,50200023535069,895740.7,60ec41ba55c00300382672d9,HDFC,Revenue-PG-split enabled,5eecc6d6449e4f7cfb1c2708,2021-12-09T00:00:00.000Z,NEFT CR-UTIB0001506-RAZORPAY SOFTWARE PR IVATE LIMITED-SLICK ORGANICS PVT LITD-AX ISCN0110119276,insurance,,net_banking_transfer,129.36
61fa3405d8beac15990e61ac,50200023535069,926252.97,60ec41ba55c00300382672d9,HDFC,Revenue-PG-non-split,5eecc6d6449e4f7cfb1c2708,2021-12-09T00:00:00.000Z,NEFT CR-KKBK0000958-BROKENTUSK TECHNOLOG IES PRIVATE LIMITED-SLICK ORGANICS PRIVA TE LIMITED-KKBK213431945398,,,net_banking_transfer,30512.27
61fa3405d8beac15990e61ae,50200023535069,943818.36,60ec41ba55c00300382672d9,HDFC,Revenue-UPI,5eecc6d6449e4f7cfb1c2708,2021-12-09T00:00:00.000Z,UPI-GOKWIK-GOKWIK@YESBANK-YESB0000340-13 4341935838-PAYOUT FOR DECEMBE,,,upi,17565.39
61fa3405d8beac15990e61b0,50200023535069,945133.88,60ec41ba55c00300382672d9,HDFC,Revenue-PG-non-split,5eecc6d6449e4f7cfb1c2708,2021-12-09T00:00:00.000Z,NEFT CR-IDFB0010204-SEZZLE PAYMENTS PRIV ATE LIMITED-SLICK ORGANICS PRIVATE LIMIT ED-IDFBH21343683135,insurance,,net_banking_transfer,1315.52
61fa3405d8beac15990e61b2,50200023535069,985970.55,60ec41ba55c00300382672d9,HDFC,Revenue-PG-non-split,5eecc6d6449e4f7cfb1c2708,2021-12-09T00:00:00.000Z,NEFT CR-KKBK0000958-BROKENTUSK TECHNOLOG IES PRIVATE LIMITED-SLICK ORGANICS PRIVA TE LIMITED-KKBK213432003813,,,net_banking_transfer,40836.67
61fa3405d8beac15990e61b4,50200023535069,987639.11,60ec41ba55c00300382672d9,HDFC,Revenue-PG-split enabled,5eecc6d6449e4f7cfb1c2708,2021-12-09T00:00:00.000Z,NEFT CR-UTIB0001506-RAZORPAY SOFTWARE PR IVATE LIMITED-SLICK ORGANICS PVT LITD-AX ISCN0110237240,insurance,,net_banking_transfer,1668.56
61fa3405d8beac15990e61b6,50200023535069,1039354.35,60ec41ba55c00300382672d9,HDFC,Revenue-PG-non-split,5eecc6d6449e4f7cfb1c2708,2021-12-10T00:00:00.000Z,IMPS-134404172513-PAYTM PAYMENTS SERVI-P YTM-XXXXXXXXXX0008-ALL202112102168200003 30830668628,ewallet,,net_banking_transfer,51715.24
61fa3405d8beac15990e61b8,50200023535069,3039354.35,60ec41ba55c00300382672d9,HDFC,Internal Transfers,5eecc6d6449e4f7cfb1c2708,2021-12-10T00:00:00.000Z,IB FUNDS TRANSFER CR-50200035187206 -SL ICK ORGANICS PVT LTD,insurance,,Other,2000000
61fa3405d8beac15990e61ba,50200023535069,879354.35,60ec41ba55c00300382672d9,HDFC,direct expenses,5eecc6d6449e4f7cfb1c2708,2021-12-10T00:00:00.000Z,"NEFT DR-UTIB0000371-TAPASEE PANNU-NETBAN K, MUM-N344211747293147-2160000",,,net_banking_transfer,-2160000
61fa3405d8beac15990e61bc,50200023535069,903517.63,60ec41ba55c00300382672d9,HDFC,Revenue-Mktplace,5eecc6d6449e4f7cfb1c2708,2021-12-10T00:00:00.000Z,NEFT CR-DEUT0797BGL-FLIPKART INTERNET PR IVATE LIMITED-SLICK ORGANICS PVT LTD-134 400206GN00048,shopping,,net_banking_transfer,24163.28
61fa3405d8beac15990e61be,50200023535069,905292.29,60ec41ba55c00300382672d9,HDFC,Revenue-Mktplace,5eecc6d6449e4f7cfb1c2708,2021-12-10T00:00:00.000Z,NEFT CR-DEUT0797BGL-FLIPKART INTERNET PR IVATE LIMITED-SLICK ORGANICS PVT LTD-134 400211GN00164,shopping,,net_banking_transfer,1774.66
61fa3405d8beac15990e61c0,50200023535069,801570.29,60ec41ba55c00300382672d9,HDFC,direct expenses,5eecc6d6449e4f7cfb1c2708,2021-12-10T00:00:00.000Z,NEFT DR-KKBK0000173-MATRIX PRINTING SOLU,,,net_banking_transfer,-103722
61fa3405d8beac15990e61c2,50200023535069,236084.29,60ec41ba55c00300382672d9,HDFC,direct expenses,5eecc6d6449e4f7cfb1c2708,2021-12-10T00:00:00.000Z,05892560000649-TPT-565486-DECORPAC INDIA PRIVATE LIMITED,,,net_banking_transfer,-565486
61fa3405d8beac15990e61c4,50200023535069,186084.29,60ec41ba55c00300382672d9,HDFC,direct expenses,5eecc6d6449e4f7cfb1c2708,2021-12-10T00:00:00.000Z,POS 514834XXXXXX9486 FLIPKART,shopping,,debit_card,-50000
61fa3405d8beac15990e61c6,50200023535069,205825.29,60ec41ba55c00300382672d9,HDFC,Revenue-Mktplace,5eecc6d6449e4f7cfb1c2708,2021-12-10T00:00:00.000Z,NEFT CR-ICIC0000985-DIGITAL AGE RETAIL P VT LTD-SLICK ORGANICS PVT LTD-CMS2282441 021,,,net_banking_transfer,19741
61fa3405d8beac15990e61c8,50200023535069,254290.27,60ec41ba55c00300382672d9,HDFC,Revenue-COD,5eecc6d6449e4f7cfb1c2708,2021-12-10T00:00:00.000Z,NEFT CR-ICIC0000155-SHIPROCKET COD CRF I D 3507969-SLICK ORGANICS PVT LTD-CMS2282 401887,insurance,,net_banking_transfer,48464.98
61fa3405d8beac15990e61ca,50200023535069,234290.27,60ec41ba55c00300382672d9,HDFC,direct expenses,5eecc6d6449e4f7cfb1c2708,2021-12-10T00:00:00.000Z,"NEFT DR-ICIC0000021-AKHILESH DIXIT-NETBA NK, MUM-N344211747954182-20000",,,net_banking_transfer,-20000
61fa3405d8beac15990e61cc,50200023535069,234288.27,60ec41ba55c00300382672d9,HDFC,Marketing Expense,5eecc6d6449e4f7cfb1c2708,2021-12-10T00:00:00.000Z,ME DC SI 514834XXXXXX9486 GOOGLESERVIS,,,Other,-2
61fa3405d8beac15990e61ce,50200023535069,370704.12,60ec41ba55c00300382672d9,HDFC,Revenue-PG-non-split,5eecc6d6449e4f7cfb1c2708,2021-12-10T00:00:00.000Z,NEFT CR-KKBK0000958-BROKENTUSK TECHNOLOG IES PRIVATE LIMITED-SLICK ORGANICS PRIVA TE LIMITED-KKBK213442261003,,,net_banking_transfer,136415.85
61fa3406d8beac15990e61d1,50200023535069,371030.95,60ec41ba55c00300382672d9,HDFC,Transfer in/Revenue-other,5eecc6d6449e4f7cfb1c2708,2021-12-10T00:00:00.000Z,NEFT CR-YESB0000001-ILUMINAR MEDIA-SLICK ORGANICS PVT. LTD-N344210899654854,,,net_banking_transfer,326.83
61fa3406d8beac15990e61d3,50200023535069,372506.3,60ec41ba55c00300382672d9,HDFC,Revenue-PG-non-split,5eecc6d6449e4f7cfb1c2708,2021-12-10T00:00:00.000Z,NEFT CR-IDFB0010204-SEZZLE PAYMENTS PRIV ATE LIMITED-SLICK ORGANICS PRIVATE LIMIT ED-IDFBH21344762885,insurance,,net_banking_transfer,1475.35
61fa3406d8beac15990e61d5,50200023535069,373313.6,60ec41ba55c00300382672d9,HDFC,Revenue-PG-split enabled,5eecc6d6449e4f7cfb1c2708,2021-12-10T00:00:00.000Z,NEFT CR-UTIB0001506-RAZORPAY SOFTWARE PR IVATE LIMITED-SLICK ORGANICS PVT LITD-AX ISCN0110483590,insurance,,net_banking_transfer,807.3
61fa3406d8beac15990e61d7,50200023535069,307813.6,60ec41ba55c00300382672d9,HDFC,direct expenses,5eecc6d6449e4f7cfb1c2708,2021-12-10T00:00:00.000Z,"NEFT DR-YESB0000236-DELIGHT VACATION PVT LTD-NETBANK, MUM-N344211748906078-65500",,,net_banking_transfer,-65500
61fa3406d8beac15990e61d9,50200023535069,313063.6,60ec41ba55c00300382672d9,HDFC,Revenue-COD,5eecc6d6449e4f7cfb1c2708,2021-12-10T00:00:00.000Z,NEFT CR-KKBK0000958-PICKRR TECHNOLOGIES PVT LTD-SLICKORGANICSPRIVATELIMITED-CMS3 442104555745,insurance,,net_banking_transfer,5250
61fa3406d8beac15990e61db,50200023535069,314061.96,60ec41ba55c00300382672d9,HDFC,Revenue-Mktplace,5eecc6d6449e4f7cfb1c2708,2021-12-10T00:00:00.000Z,NEFT CR-ICIC0000105-MANASH LIFESTYLE PRI,shopping,,net_banking_transfer,998.36
61fa3406d8beac15990e61dd,50200023535069,327962.29,60ec41ba55c00300382672d9,HDFC,Revenue-PG-non-split,5eecc6d6449e4f7cfb1c2708,2021-12-11T00:00:00.000Z,IMPS-134505366790-PAYTM PAYMENTS SERVI-P YTM-XXXXXXXXXX0008-ALL202112112168200003 30830668628,ewallet,,net_banking_transfer,13900.33
61fa3406d8beac15990e61df,50200023535069,1327962.29,60ec41ba55c00300382672d9,HDFC,Internal Transfers,5eecc6d6449e4f7cfb1c2708,2021-12-11T00:00:00.000Z,IB FUNDS TRANSFER CR-50200035187206 -SL ICK ORGANICS PVT LTD,insurance,,Other,1000000
61fa3406d8beac15990e61e1,50200023535069,1127962.29,60ec41ba55c00300382672d9,HDFC,direct expenses,5eecc6d6449e4f7cfb1c2708,2021-12-11T00:00:00.000Z,"NEFT DR-YESB0000551-VISTTA COSMETICS-NET BANK, MUM-N345211749147330-200000",,,net_banking_transfer,-200000
61fa3406d8beac15990e61e3,50200023535069,927962.29,60ec41ba55c00300382672d9,HDFC,direct expenses,5eecc6d6449e4f7cfb1c2708,2021-12-11T00:00:00.000Z,IMPS-134510129815-VISTTA COSMETICS-YESB- XXXXXXXXXXX1450-200000,,,net_banking_transfer,-200000
61fa3406d8beac15990e61e5,50200023535069,855962.29,60ec41ba55c00300382672d9,HDFC,direct expenses,5eecc6d6449e4f7cfb1c2708,2021-12-11T00:00:00.000Z,50100297431252-TPT-72000-KOMALPREET KAUR,,,net_banking_transfer,-72000
61fa3406d8beac15990e61e7,50200023535069,820491.29,60ec41ba55c00300382672d9,HDFC,direct expenses,5eecc6d6449e4f7cfb1c2708,2021-12-11T00:00:00.000Z,02712120000086-TPT-35471-SPOTON LOGISTIC S PVT LTD,,,net_banking_transfer,-35471
61fa3406d8beac15990e61e9,50200023535069,840958.34,60ec41ba55c00300382672d9,HDFC,Revenue-PG-non-split,5eecc6d6449e4f7cfb1c2708,2021-12-12T00:00:00.000Z,IMPS-134604434738-PAYTM PAYMENTS SERVI-P YTM-XXXXXXXXXX0008-ALL202112122168200003 30830668628,ewallet,,net_banking_transfer,20467.05
61fa3406d8beac15990e61eb,50200023535069,640958.34,60ec41ba55c00300382672d9,HDFC,direct expenses,5eecc6d6449e4f7cfb1c2708,2021-12-12T00:00:00.000Z,"NEFT DR-YESB0000551-VISTTA COSMETICS-NET BANK, MUM-N346211749804787-200000",,,net_banking_transfer,-200000
61fa3406d8beac15990e61ed,50200023535069,440958.34,60ec41ba55c00300382672d9,HDFC,direct expenses,5eecc6d6449e4f7cfb1c2708,2021-12-12T00:00:00.000Z,IMPS-134613171706-VISTTA COSMETICS-YESB- XXXXXXXXXXX1450-200000,,,net_banking_transfer,-200000
61fa3406d8beac15990e61ef,50200023535069,468591.43,60ec41ba55c00300382672d9,HDFC,Revenue-PG-non-split,5eecc6d6449e4f7cfb1c2708,2021-12-13T00:00:00.000Z,IMPS-134704532226-PAYTM PAYMENTS SERVI-P YTM-XXXXXXXXXX0008-ALL202112132168200003 30830668628,ewallet,,net_banking_transfer,27633.09
61fa3406d8beac15990e61f1,50200023535069,469369.55,60ec41ba55c00300382672d9,HDFC,Revenue-PG-split enabled,5eecc6d6449e4f7cfb1c2708,2021-12-13T00:00:00.000Z,NEFT CR-UTIB0001506-RAZORPAY SOFTWARE PR IVATE LIMITED-SLICK ORGANICS PVT LITD-AX ISCN0110864709,insurance,,net_banking_transfer,778.12
61fa3406d8beac15990e61f3,50200023535069,269369.55,60ec41ba55c00300382672d9,HDFC,direct expenses,5eecc6d6449e4f7cfb1c2708,2021-12-13T00:00:00.000Z,"NEFT DR-YESB0000551-VISTTA COSMETICS-NET BANK, MUM-N347211750066889-200000",,,net_banking_transfer,-200000
61fa3406d8beac15990e61f5,50200023535069,295560.96,60ec41ba55c00300382672d9,HDFC,Revenue-Mktplace,5eecc6d6449e4f7cfb1c2708,2021-12-13T00:00:00.000Z,NEFT CR-DEUT0797BGL-FLIPKART INTERNET PR,shopping,,net_banking_transfer,26191.41
61fa3406d8beac15990e61f7,50200023535069,318831.63,60ec41ba55c00300382672d9,HDFC,Revenue-Mktplace,5eecc6d6449e4f7cfb1c2708,2021-12-13T00:00:00.000Z,NEFT CR-DEUT0797BGL-FLIPKART INTERNET PR IVATE LIMITED-SLICK ORGANICS PVT LTD-134 700447GN00013,shopping,,net_banking_transfer,23270.67
61fa3406d8beac15990e61f9,50200023535069,302429.63,60ec41ba55c00300382672d9,HDFC,direct expenses,5eecc6d6449e4f7cfb1c2708,2021-12-13T00:00:00.000Z,"NEFT DR-SBIN0008078-PANDIT PLASTICS-NETB ANK, MUM-N347211750320913-16402",,,net_banking_transfer,-16402
61fa3406d8beac15990e61fb,50200023535069,202429.63,60ec41ba55c00300382672d9,HDFC,agency/vendor expense,5eecc6d6449e4f7cfb1c2708,2021-12-13T00:00:00.000Z,"NEFT DR-KKBK0000298-ADMITAD MEDIA PRIVAT E LIMITED-NETBANK, MUM-N347211750309845- 100000",loans,lender_transaction,net_banking_transfer,-100000
61fa3406d8beac15990e61fd,50200023535069,114803.63,60ec41ba55c00300382672d9,HDFC,agency/vendor expense,5eecc6d6449e4f7cfb1c2708,2021-12-13T00:00:00.000Z,"NEFT DR-IDFB0021001-CLICKONIK DIGITAL ME DIA PVT LTD-NETBANK, MUM-N34721175032842 0-87626",insurance,,net_banking_transfer,-87626
61fa3406d8beac15990e61ff,50200023535069,14803.63,60ec41ba55c00300382672d9,HDFC,direct expenses,5eecc6d6449e4f7cfb1c2708,2021-12-13T00:00:00.000Z,"NEFT DR-INDB0000333-NOASTRIX PRIVATE LIM ITED-NETBANK, MUM-N347211750343589-10000 0",,,net_banking_transfer,-100000
61fa3406d8beac15990e6203,50200023535069,1014803.63,60ec41ba55c00300382672d9,HDFC,Internal Transfers,5eecc6d6449e4f7cfb1c2708,2021-12-13T00:00:00.000Z,IB FUNDS TRANSFER CR-50200035187206 -SL ICK ORGANICS PVT LTD,insurance,,Other,1000000
61fa3406d8beac15990e6205,50200023535069,1029786.63,60ec41ba55c00300382672d9,HDFC,Transfer in/Revenue-other,5eecc6d6449e4f7cfb1c2708,2021-12-13T00:00:00.000Z,50200050241205-TPT-ARATA-NAPSA PRIVATE L IMITED,,,net_banking_transfer,14983
61fa3406d8beac15990e6207,50200023535069,674136.63,60ec41ba55c00300382672d9,HDFC,direct expenses,5eecc6d6449e4f7cfb1c2708,2021-12-13T00:00:00.000Z,"NEFT DR-PUNB0100110-KRAUTER HEALTHCARE L TD-NETBANK, MUM-N347211750353443-355650",,,net_banking_transfer,-355650
61fa3406d8beac15990e6209,50200023535069,584916.63,60ec41ba55c00300382672d9,HDFC,direct expenses,5eecc6d6449e4f7cfb1c2708,2021-12-13T00:00:00.000Z,"NEFT DR-CITI0000002-OMG NETWORK INDIA PR IVATE LIMITED-NETBANK, MUM-N347211750421 693-89220",,,net_banking_transfer,-89220
61fa3406d8beac15990e620b,50200023535069,234916.63,60ec41ba55c00300382672d9,HDFC,direct expenses,5eecc6d6449e4f7cfb1c2708,2021-12-13T00:00:00.000Z,57500000443889-TPT-350000-WEBKLIPPER TEC HNOLOGIES PRIVATE LIMITED,,,net_banking_transfer,-350000
61fa3406d8beac15990e620d,50200023535069,78316.63,60ec41ba55c00300382672d9,HDFC,direct expenses,5eecc6d6449e4f7cfb1c2708,2021-12-13T00:00:00.000Z,"NEFT DR-KKBK0005289-HILL GROOVE CONSULTI NG LLP-NETBANK, MUM-N347211750652185-156 600",,,net_banking_transfer,-156600
61fa3406d8beac15990e620f,50200023535069,73654.63,60ec41ba55c00300382672d9,HDFC,direct expenses,5eecc6d6449e4f7cfb1c2708,2021-12-13T00:00:00.000Z,02021137046134/ESIC,,,Other,-4662
61fa3406d8beac15990e6211,50200023535069,67020.63,60ec41ba55c00300382672d9,HDFC,Salary/Emp/consultant Expense,5eecc6d6449e4f7cfb1c2708,2021-12-13T00:00:00.000Z,1649624001/EPFO,,,Other,-6634
61fa3406d8beac15990e6213,50200023535069,68873.29,60ec41ba55c00300382672d9,HDFC,Transfer in/Revenue-other,5eecc6d6449e4f7cfb1c2708,2021-12-13T00:00:00.000Z,4060007940-13 12 2021-HDFAZCUR1,,,Other,1852.66
61fa3406d8beac15990e6215,50200023535069,69178.65,60ec41ba55c00300382672d9,HDFC,Revenue-PG-split enabled,5eecc6d6449e4f7cfb1c2708,2021-12-13T00:00:00.000Z,NEFT CR-UTIB0001506-RAZORPAY SOFTWARE PR,,,net_banking_transfer,305.36
61fa3406d8beac15990e6217,50200023535069,75677.2,60ec41ba55c00300382672d9,HDFC,Revenue-PG-non-split,5eecc6d6449e4f7cfb1c2708,2021-12-13T00:00:00.000Z,NEFT CR-IDFB0010204-SEZZLE PAYMENTS PRIV ATE LIMITED-SLICK ORGANICS PRIVATE LIMIT ED-IDFBH21347909098,insurance,,net_banking_transfer,6498.55
61fa3406d8beac15990e6219,50200023535069,75863.39,60ec41ba55c00300382672d9,HDFC,Revenue-Mktplace,5eecc6d6449e4f7cfb1c2708,2021-12-13T00:00:00.000Z,NEFT CR-ICIC0000105-MANASH LIFESTYLE PRI VATE LIMITED NO-SLICK ORGANICS PRIVATE L IMITED BANG-ICIJ213470006596,shopping,,net_banking_transfer,186.19
61fa3406d8beac15990e621b,50200023535069,76049.58,60ec41ba55c00300382672d9,HDFC,Revenue-Mktplace,5eecc6d6449e4f7cfb1c2708,2021-12-13T00:00:00.000Z,NEFT CR-ICIC0000105-MANASH LIFESTYLE PRI VATE LIMITED NO-SLICK ORGANICS PRIVATE L IMITED MP G-ICIJ213470006592,shopping,,net_banking_transfer,186.19
61fa3406d8beac15990e621d,50200023535069,77688.59,60ec41ba55c00300382672d9,HDFC,Revenue-Mktplace,5eecc6d6449e4f7cfb1c2708,2021-12-13T00:00:00.000Z,NEFT CR-ICIC0000105-MANASH LIFESTYLE PRI VATE LIMITED NO-SLICK ORGANICS PRIVATE L IMITED MP M-ICIJ213470006594,shopping,,net_banking_transfer,1639.01
61fa3406d8beac15990e621f,50200023535069,161866.35,60ec41ba55c00300382672d9,HDFC,Revenue-PG-non-split,5eecc6d6449e4f7cfb1c2708,2021-12-13T00:00:00.000Z,NEFT CR-KKBK0000958-BROKENTUSK TECHNOLOG IES PRIVATE LIMITED-SLICK ORGANICS PRIVA TE LIMITED-KKBK213472888407,,,net_banking_transfer,84177.76
61fa3406d8beac15990e6221,50200023535069,167350.35,60ec41ba55c00300382672d9,HDFC,Transfer in/Revenue-other,5eecc6d6449e4f7cfb1c2708,2021-12-13T00:00:00.000Z,FT - CR - 50200038726231 - HOUSE OF BEAU TY PRIVATE LIMITED,,,Other,5484
61fa3406d8beac15990e6223,50200023535069,190906.84,60ec41ba55c00300382672d9,HDFC,Revenue-PG-non-split,5eecc6d6449e4f7cfb1c2708,2021-12-14T00:00:00.000Z,IMPS-134804790357-PAYTM PAYMENTS SERVI-P YTM-XXXXXXXXXX0008-ALL202112142168200003 30830668628,ewallet,,net_banking_transfer,23556.49
61fa3406d8beac15990e6225,50200023535069,234873.06,60ec41ba55c00300382672d9,HDFC,Revenue-Mktplace,5eecc6d6449e4f7cfb1c2708,2021-12-14T00:00:00.000Z,IMPS-134805080362-AMAZON SELLER SERVIC-H SBC-XXXXXXXX6004-47RFXQFK8J3I7Z63SLICK O RGANICS PVT LTD,shopping,,net_banking_transfer,43966.22
61fa3406d8beac15990e6227,50200023535069,235886.53,60ec41ba55c00300382672d9,HDFC,Revenue-PG-non-split,5eecc6d6449e4f7cfb1c2708,2021-12-14T00:00:00.000Z,NEFT CR-ICIC0000031-PAYTM E COMMERCE PVT LTD-SLICK ORGANICS PVT LTD-CMS228685725 5,ewallet,,net_banking_transfer,1013.47
61fa3406d8beac15990e6229,50200023535069,513305.03,60ec41ba55c00300382672d9,HDFC,Revenue-Mktplace,5eecc6d6449e4f7cfb1c2708,2021-12-14T00:00:00.000Z,NEFT CR-DEUT0797BGL-AMAZON PAY (INDIA) P RIVATE LIMITED-SLICK ORGANICS PVT LTD-13 4800143GN00122,shopping,,net_banking_transfer,277418.5
61fa3406d8beac15990e622b,50200023535069,513544.95,60ec41ba55c00300382672d9,HDFC,Revenue-PG-split enabled,5eecc6d6449e4f7cfb1c2708,2021-12-14T00:00:00.000Z,NEFT CR-UTIB0001506-RAZORPAY SOFTWARE PR,,,net_banking_transfer,239.92
61fa3406d8beac15990e622d,50200023535069,1513544.95,60ec41ba55c00300382672d9,HDFC,Internal Transfers,5eecc6d6449e4f7cfb1c2708,2021-12-14T00:00:00.000Z,IB FUNDS TRANSFER CR-50200035187206 -SL ICK ORGANICS PVT LTD,insurance,,Other,1000000
61fa3406d8beac15990e622f,50200023535069,1333544.95,60ec41ba55c00300382672d9,HDFC,direct expenses,5eecc6d6449e4f7cfb1c2708,2021-12-14T00:00:00.000Z,50200031284040-TPT-180000-BURGEON LAW LL P,,,net_banking_transfer,-180000
61fa3406d8beac15990e6231,50200023535069,1133544.95,60ec41ba55c00300382672d9,HDFC,direct expenses,5eecc6d6449e4f7cfb1c2708,2021-12-14T00:00:00.000Z,"NEFT DR-PUNB0642000-UFLEX LIMITED-NETBAN K, MUM-N348211751870504-200000",loans,lender_transaction,net_banking_transfer,-200000
61fa3406d8beac15990e6233,50200023535069,1633544.95,60ec41ba55c00300382672d9,HDFC,Internal Transfers,5eecc6d6449e4f7cfb1c2708,2021-12-14T00:00:00.000Z,IB FUNDS TRANSFER CR-50200035187206 -SL ICK ORGANICS PVT LTD,insurance,,Other,500000
61fa3406d8beac15990e6235,50200023535069,249956.95,60ec41ba55c00300382672d9,HDFC,direct expenses,5eecc6d6449e4f7cfb1c2708,2021-12-14T00:00:00.000Z,"NEFT DR-UTIB0000740-SUPARI STUDIOS-NETBA NK, MUM-N348211752117020-1383588",,,net_banking_transfer,-1383588
61fa3406d8beac15990e6237,50200023535069,251163.49,60ec41ba55c00300382672d9,HDFC,Revenue-Mktplace,5eecc6d6449e4f7cfb1c2708,2021-12-14T00:00:00.000Z,NEFT CR-ICIC0000105-MANASH LIFETYLE PVT LTD-SLICK ORGANICS PRIVATE LIMITED MP MU M-ICIB213480011909,,,net_banking_transfer,1206.54
61fa3406d8beac15990e6239,50200023535069,251346.01,60ec41ba55c00300382672d9,HDFC,Revenue-Mktplace,5eecc6d6449e4f7cfb1c2708,2021-12-14T00:00:00.000Z,NEFT CR-ICIC0000105-MANASH LIFETYLE PVT LTD-SLICK ORGANICS PRIVATE LIMITED MP GG N-ICIB213480011907,,,net_banking_transfer,182.52
61fa3406d8beac15990e623b,50200023535069,260575.97,60ec41ba55c00300382672d9,HDFC,Revenue-UPI,5eecc6d6449e4f7cfb1c2708,2021-12-14T00:00:00.000Z,UPI-GOKWIK-GOKWIK@YESBANK-YESB0000340-13 4848097570-PAYOUT FOR DECEMBE,,,upi,9229.96
61fa3406d8beac15990e623d,50200023535069,262404.09,60ec41ba55c00300382672d9,HDFC,Revenue-PG-split enabled,5eecc6d6449e4f7cfb1c2708,2021-12-14T00:00:00.000Z,NEFT CR-UTIB0001506-RAZORPAY SOFTWARE PR IVATE LIMITED-SLICK ORGANICS PVT LITD-AX ISCN0111224882,insurance,,net_banking_transfer,1828.12
61fa3406d8beac15990e623f,50200023535069,266575.99,60ec41ba55c00300382672d9,HDFC,Revenue-Mktplace,5eecc6d6449e4f7cfb1c2708,2021-12-14T00:00:00.000Z,4060007885-TIMES INTERNET LIMITED NODAL,,,Other,4171.9
61fa3406d8beac15990e6241,50200023535069,272302.43,60ec41ba55c00300382672d9,HDFC,Revenue-PG-non-split,5eecc6d6449e4f7cfb1c2708,2021-12-14T00:00:00.000Z,NEFT CR-IDFB0010204-SEZZLE PAYMENTS PRIV ATE LIMITED-SLICK ORGANICS PRIVATE LIMIT ED-IDFBH21348983148,insurance,,net_banking_transfer,5726.44
61fa3406d8beac15990e6243,50200023535069,280885.43,60ec41ba55c00300382672d9,HDFC,Revenue-COD,5eecc6d6449e4f7cfb1c2708,2021-12-14T00:00:00.000Z,NEFT CR-KKBK0000958-PICKRR TECHNOLOGIES PVT LTD-SLICKORGANICSPRIVATELIMITED-CMS3 482104645613,insurance,,net_banking_transfer,8583
61fa3406d8beac15990e6245,50200023535069,242899.58,60ec41ba55c00300382672d9,HDFC,SAAS/tech expense,5eecc6d6449e4f7cfb1c2708,2021-12-14T00:00:00.000Z,POS 514834XXXXXX9486 AMAZON.COM,shopping,,debit_card,-37985.85
61fa3406d8beac15990e6247,50200023535069,243876.11,60ec41ba55c00300382672d9,HDFC,Revenue-PG-non-split,5eecc6d6449e4f7cfb1c2708,2021-12-15T00:00:00.000Z,NEFT CR-ICIC0000031-PAYTM E COMMERCE PVT,ewallet,,net_banking_transfer,976.53
61fa3406d8beac15990e6249,50200023535069,281145.38,60ec41ba55c00300382672d9,HDFC,Revenue-Mktplace,5eecc6d6449e4f7cfb1c2708,2021-12-15T00:00:00.000Z,NEFT CR-DEUT0797BGL-FLIPKART INTERNET PR IVATE LIMITED-SLICK ORGANICS PVT LTD-134 900817GN00009,shopping,,net_banking_transfer,37269.27
61fa3406d8beac15990e624b,50200023535069,299637.05,60ec41ba55c00300382672d9,HDFC,Revenue-Mktplace,5eecc6d6449e4f7cfb1c2708,2021-12-15T00:00:00.000Z,NEFT CR-DEUT0797BGL-FLIPKART INTERNET PR IVATE LIMITED-SLICK ORGANICS PVT LTD-134 900906GN00007,shopping,,net_banking_transfer,18491.67
61fa3406d8beac15990e624d,50200023535069,259137.05,60ec41ba55c00300382672d9,HDFC,direct expenses,5eecc6d6449e4f7cfb1c2708,2021-12-15T00:00:00.000Z,05722560002993-TPT-40500-M5 ENTERTAINMEN T PRIVATE LIMITED,,,net_banking_transfer,-40500
61fa3406d8beac15990e6252,50200023535069,259215.56,60ec41ba55c00300382672d9,HDFC,Revenue-PG-split enabled,5eecc6d6449e4f7cfb1c2708,2021-12-15T00:00:00.000Z,NEFT CR-UTIB0001506-RAZORPAY SOFTWARE PR IVATE LIMITED-SLICK ORGANICS PVT LITD-AX ISCN0111297146,insurance,,net_banking_transfer,78.51
61fa3406d8beac15990e6256,50200023535069,257671.59,60ec41ba55c00300382672d9,HDFC,bank charges,5eecc6d6449e4f7cfb1c2708,2021-12-15T00:00:00.000Z,.DC INTL POS TXN MARKUP+ST 291121 011221 -CDT2133806861750,,,international_transaction_arbitrage,-1543.97
61fa3406d8beac15990e6258,50200023535069,256677.92,60ec41ba55c00300382672d9,HDFC,bank charges,5eecc6d6449e4f7cfb1c2708,2021-12-15T00:00:00.000Z,.DC INTL POS TXN MARKUP+ST 291121 011221 -CDT2133806861750,,,international_transaction_arbitrage,-993.67
61fa3406d8beac15990e625a,50200023535069,275770.98,60ec41ba55c00300382672d9,HDFC,Revenue-PG-non-split,5eecc6d6449e4f7cfb1c2708,2021-12-15T00:00:00.000Z,IMPS-134911168809-PAYTM PAYMENTS SERVI-P YTM-XXXXXXXXXX0008-ALL202112152168200003 30830668628,ewallet,,net_banking_transfer,19093.06
61fa3406d8beac15990e625c,50200023535069,1275770.98,60ec41ba55c00300382672d9,HDFC,Internal Transfers,5eecc6d6449e4f7cfb1c2708,2021-12-15T00:00:00.000Z,IB FUNDS TRANSFER CR-50200035187206 -SL ICK ORGANICS PVT LTD,insurance,,Other,1000000
61fa3406d8beac15990e625e,50200023535069,775770.98,60ec41ba55c00300382672d9,HDFC,Marketing Expense,5eecc6d6449e4f7cfb1c2708,2021-12-15T00:00:00.000Z,"NEFT DR-CITI0000006-FACEBOOK INDIA ONLIN E SERVICES PVT LTD-NETBANK, MUM-N3492117 53494713-500000",,,net_banking_transfer,-500000
61fa3406d8beac15990e6260,50200023535069,1275770.98,60ec41ba55c00300382672d9,HDFC,Internal Transfers,5eecc6d6449e4f7cfb1c2708,2021-12-15T00:00:00.000Z,IB FUNDS TRANSFER CR-50200035187206 -SL ICK ORGANICS PVT LTD,insurance,,Other,500000
61fa3406d8beac15990e6263,50200023535069,470592.98,60ec41ba55c00300382672d9,HDFC,Marketing Expense,5eecc6d6449e4f7cfb1c2708,2021-12-15T00:00:00.000Z,"NEFT DR-CITI0000006-FACEBOOK INDIA ONLIN E SERVICES PVT LTD-NETBANK, MUM-N3492117 53502414-805178",,,net_banking_transfer,-805178
61fa3406d8beac15990e6265,50200023535069,139896.98,60ec41ba55c00300382672d9,HDFC,direct expenses,5eecc6d6449e4f7cfb1c2708,2021-12-15T00:00:00.000Z,NEFT DR-KKBK0000180-VEDIC COSMECEUTICALS,,,net_banking_transfer,-330696
61fa3406d8beac15990e6267,50200023535069,639896.98,60ec41ba55c00300382672d9,HDFC,Internal Transfers,5eecc6d6449e4f7cfb1c2708,2021-12-15T00:00:00.000Z,IB FUNDS TRANSFER CR-50200035187206 -SL ICK ORGANICS PVT LTD,insurance,,Other,500000
61fa3406d8beac15990e6269,50200023535069,473671.98,60ec41ba55c00300382672d9,HDFC,direct expenses,5eecc6d6449e4f7cfb1c2708,2021-12-15T00:00:00.000Z,02712120000086-TPT-166225-SPOTON LOGISTI CS PVT LTD,,,net_banking_transfer,-166225
61fa3406d8beac15990e626b,50200023535069,402094.98,60ec41ba55c00300382672d9,HDFC,direct expenses,5eecc6d6449e4f7cfb1c2708,2021-12-15T00:00:00.000Z,"NEFT DR-DEUT0784BBY-DHL EXPRESS INDIA PV T LTD-NETBANK, MUM-N349211753541000-7157 7",,,net_banking_transfer,-71577
61fa3406d8beac15990e626d,50200023535069,157134.98,60ec41ba55c00300382672d9,HDFC,direct expenses,5eecc6d6449e4f7cfb1c2708,2021-12-15T00:00:00.000Z,"NEFT DR-SCBL0036031-PR PUNDIT PUBLIC REL ATIONS PRIVATE LIMIT-NETBANK, MUM-N34921 1753548286-244960",insurance,,net_banking_transfer,-244960
61fa3406d8beac15990e626f,50200023535069,158161.19,60ec41ba55c00300382672d9,HDFC,Revenue-Mktplace,5eecc6d6449e4f7cfb1c2708,2021-12-15T00:00:00.000Z,NEFT CR-ICIC0000105-MANASH LIFETYLE PVT LTD-SLICK ORGANICS PRIVATE LIMITED MP GG N-ICIB213490024451,,,net_banking_transfer,1026.21
61fa3406d8beac15990e6271,50200023535069,159166.15,60ec41ba55c00300382672d9,HDFC,Revenue-Mktplace,5eecc6d6449e4f7cfb1c2708,2021-12-15T00:00:00.000Z,NEFT CR-ICIC0000105-MANASH LIFETYLE PVT LTD-SLICK ORGANICS PRIVATE LIMITED MP MU M-ICIB213490022910,,,net_banking_transfer,1004.96
61fa3406d8beac15990e6273,50200023535069,159575.17,60ec41ba55c00300382672d9,HDFC,Revenue-Mktplace,5eecc6d6449e4f7cfb1c2708,2021-12-15T00:00:00.000Z,NEFT CR-ICIC0000105-MANASH LIFETYLE PVT LTD-SLICK ORGANICS PRIVATE LIMITED BANGA LORE-ICIB213490024454,,,net_banking_transfer,409.02
61fa3406d8beac15990e6275,50200023535069,159970.98,60ec41ba55c00300382672d9,HDFC,Revenue-Mktplace,5eecc6d6449e4f7cfb1c2708,2021-12-15T00:00:00.000Z,NEFT CR-ICIC0000105-MANASH LIFETYLE PVT LTD-SLICK ORGANICS PRIVATE LIMITED KOLKA TA-ICIB213490024453,,,net_banking_transfer,395.81
61fa3406d8beac15990e6277,50200023535069,70697.98,60ec41ba55c00300382672d9,HDFC,direct expenses,5eecc6d6449e4f7cfb1c2708,2021-12-15T00:00:00.000Z,"NEFT DR-SRCB0000281-3D TECHNOPACK PRIVAT E LIMITED-NETBANK, MUM-N349211753780569- 89273",,,net_banking_transfer,-89273
61fa3406d8beac15990e6279,50200023535069,126456.83,60ec41ba55c00300382672d9,HDFC,Revenue-COD,5eecc6d6449e4f7cfb1c2708,2021-12-15T00:00:00.000Z,NEFT CR-ICIC0000155-SHIPROCKET COD CRF I D 3528536-SLICK ORGANICS PVT LTD-CMS2290 062722,insurance,,net_banking_transfer,55758.85
61fa3406d8beac15990e627c,50200023535069,143960.83,60ec41ba55c00300382672d9,HDFC,Revenue-Mktplace,5eecc6d6449e4f7cfb1c2708,2021-12-15T00:00:00.000Z,NEFT CR-SCBL0036001-M/S DREAMPLUG TECHNO,,,net_banking_transfer,17504
61fa3406d8beac15990e627e,50200023535069,181791.36,60ec41ba55c00300382672d9,HDFC,Revenue-UPI,5eecc6d6449e4f7cfb1c2708,2021-12-15T00:00:00.000Z,UPI-GOKWIK-GOKWIK@YESBANK-YESB0000340-13 4949388262-PAYOUT FOR DECEMBE,,,upi,37830.53
61fa3406d8beac15990e6280,50200023535069,201219.36,60ec41ba55c00300382672d9,HDFC,Revenue-Mktplace,5eecc6d6449e4f7cfb1c2708,2021-12-15T00:00:00.000Z,NEFT CR-KKBK0000958-SURFBOATS SOLUTIONS PVT LTD-SLICK ORGANICS PRIVATE LIMITED-K KBK213493357744,insurance,,net_banking_transfer,19428
61fa3406d8beac15990e6282,50200023535069,201423.58,60ec41ba55c00300382672d9,HDFC,Revenue-PG-split enabled,5eecc6d6449e4f7cfb1c2708,2021-12-15T00:00:00.000Z,NEFT CR-UTIB0001506-RAZORPAY SOFTWARE PR IVATE LIMITED-SLICK ORGANICS PVT LITD-AX ISCN0111689679,insurance,,net_banking_transfer,204.22
61fa3406d8beac15990e6284,50200023535069,223161.1,60ec41ba55c00300382672d9,HDFC,Revenue-PG-non-split,5eecc6d6449e4f7cfb1c2708,2021-12-16T00:00:00.000Z,IMPS-135004040130-PAYTM PAYMENTS SERVI-P YTM-XXXXXXXXXX0008-ALL202112162168200003 30830668628,ewallet,,net_banking_transfer,21737.52
61fa3406d8beac15990e6286,50200023535069,219416.08,60ec41ba55c00300382672d9,HDFC,direct expenses,5eecc6d6449e4f7cfb1c2708,2021-12-16T00:00:00.000Z,POS 514834XXXXXX9486 WWW.FAQPRIME.COM,,,debit_card,-3745.02
61fa3406d8beac15990e6288,50200023535069,219798.73,60ec41ba55c00300382672d9,HDFC,Revenue-PG-split enabled,5eecc6d6449e4f7cfb1c2708,2021-12-16T00:00:00.000Z,NEFT CR-UTIB0001506-RAZORPAY SOFTWARE PR IVATE LIMITED-SLICK ORGANICS PVT LITD-AX ISCN0111762291,insurance,,net_banking_transfer,382.65
61fa3406d8beac15990e628b,50200023535069,219708.65,60ec41ba55c00300382672d9,HDFC,bank charges,5eecc6d6449e4f7cfb1c2708,2021-12-16T00:00:00.000Z,.DC INTL POS TXN MARKUP+ST 011221 021221 -CDT2133806861750,,,international_transaction_arbitrage,-90.08
61fa3406d8beac15990e628d,50200023535069,719708.65,60ec41ba55c00300382672d9,HDFC,Internal Transfers,5eecc6d6449e4f7cfb1c2708,2021-12-16T00:00:00.000Z,IB FUNDS TRANSFER CR-50200035187206 -SL ICK ORGANICS PVT LTD,insurance,,Other,500000
61fa3406d8beac15990e628f,50200023535069,449708.65,60ec41ba55c00300382672d9,HDFC,direct expenses,5eecc6d6449e4f7cfb1c2708,2021-12-16T00:00:00.000Z,"NEFT DR-KKBK0000957-CONDE NAST INDIA PVT LTD-NETBANK, MUM-N350211754867770-27000 0",,,net_banking_transfer,-270000
61fa3406d8beac15990e6291,50200023535069,485718.73,60ec41ba55c00300382672d9,HDFC,Revenue-UPI,5eecc6d6449e4f7cfb1c2708,2021-12-16T00:00:00.000Z,UPI-GOKWIK-GOKWIK@YESBANK-YESB0000340-13 5050746035-PAYOUT FOR DECEMBE,,,upi,36010.08
61fa3406d8beac15990e6293,50200023535069,486442.65,60ec41ba55c00300382672d9,HDFC,Revenue-PG-non-split,5eecc6d6449e4f7cfb1c2708,2021-12-16T00:00:00.000Z,NEFT CR-IDFB0010204-SEZZLE PAYMENTS PRIV ATE LIMITED-SLICK ORGANICS PRIVATE LIMIT ED-IDFBH21350112769,insurance,,net_banking_transfer,723.92
61fa3407d8beac15990e6295,50200023535069,487482.77,60ec41ba55c00300382672d9,HDFC,Revenue-Mktplace,5eecc6d6449e4f7cfb1c2708,2021-12-16T00:00:00.000Z,NEFT CR-ICIC0000105-MANASH LIFESTYLE PRI VATE LIMITED NO-SLICK ORGANICS PRIVATE L IMITED MP M-ICIJ213500002165,shopping,,net_banking_transfer,1040.12
61fa3407d8beac15990e6297,50200023535069,487679.95,60ec41ba55c00300382672d9,HDFC,Revenue-Mktplace,5eecc6d6449e4f7cfb1c2708,2021-12-16T00:00:00.000Z,NEFT CR-ICIC0000105-MANASH LIFESTYLE PRI,shopping,,net_banking_transfer,197.18
61fa3407d8beac15990e6299,50200023535069,488064.04,60ec41ba55c00300382672d9,HDFC,Revenue-Mktplace,5eecc6d6449e4f7cfb1c2708,2021-12-16T00:00:00.000Z,NEFT CR-ICIC0000105-MANASH LIFESTYLE PRI VATE LIMITED NO-SLICK ORGANICS PRIVATE L IMITED BANG-ICIJ213500002167,shopping,,net_banking_transfer,384.09
61fa3407d8beac15990e629b,50200023535069,488217.91,60ec41ba55c00300382672d9,HDFC,Revenue-PG-split enabled,5eecc6d6449e4f7cfb1c2708,2021-12-16T00:00:00.000Z,NEFT CR-UTIB0001506-RAZORPAY SOFTWARE PR IVATE LIMITED-SLICK ORGANICS PVT LITD-AX ISCN0111892956,insurance,,net_banking_transfer,153.87
61fa3407d8beac15990e629d,50200023535069,488983.36,60ec41ba55c00300382672d9,HDFC,Revenue-PG-non-split,5eecc6d6449e4f7cfb1c2708,2021-12-16T00:00:00.000Z,NEFT CR-KKBK0000958-BROKENTUSK TECHNOLOG IES PRIVATE LIMITED-SLICK ORGANICS PRIVA TE LIMITED-KKBK213503708042,,,net_banking_transfer,765.45
61fa3407d8beac15990e629f,50200023535069,541139.36,60ec41ba55c00300382672d9,HDFC,Transfer in/Revenue-other,5eecc6d6449e4f7cfb1c2708,2021-12-16T00:00:00.000Z,NEFT CR-ICIC0000021-HANDY HOME SOLUTIONS PRIVATE LIMITED-SLICK ORGANICS PRIVATE LIMITED-CMS2292660678,,,net_banking_transfer,52156
61fa3407d8beac15990e62a1,50200023535069,502629.08,60ec41ba55c00300382672d9,HDFC,SAAS/tech expense,5eecc6d6449e4f7cfb1c2708,2021-12-16T00:00:00.000Z,POS 514834XXXXXX9486 AMAZON.COM,shopping,,debit_card,-38510.28
61fa3407d8beac15990e62a3,50200023535069,518789.35,60ec41ba55c00300382672d9,HDFC,Revenue-PG-non-split,5eecc6d6449e4f7cfb1c2708,2021-12-17T00:00:00.000Z,IMPS-135105031281-PAYTM PAYMENTS SERVI-P YTM-XXXXXXXXXX0008-ALL202112172168200003 30830668628,ewallet,,net_banking_transfer,16160.27
61fa3407d8beac15990e62a5,50200023535069,537210.06,60ec41ba55c00300382672d9,HDFC,Revenue-Mktplace,5eecc6d6449e4f7cfb1c2708,2021-12-17T00:00:00.000Z,NEFT CR-DEUT0797BGL-FLIPKART INTERNET PR IVATE LIMITED-SLICK ORGANICS PVT LTD-135 100203GN00067,shopping,,net_banking_transfer,18420.71
61fa3407d8beac15990e62a7,50200023535069,554920.13,60ec41ba55c00300382672d9,HDFC,Revenue-Mktplace,5eecc6d6449e4f7cfb1c2708,2021-12-17T00:00:00.000Z,NEFT CR-DEUT0797BGL-FLIPKART INTERNET PR IVATE LIMITED-SLICK ORGANICS PVT LTD-135 100267GN00072,shopping,,net_banking_transfer,17710.07
61fa3407d8beac15990e62a9,50200023535069,555210.29,60ec41ba55c00300382672d9,HDFC,Revenue-PG-split enabled,5eecc6d6449e4f7cfb1c2708,2021-12-17T00:00:00.000Z,NEFT CR-UTIB0001506-RAZORPAY SOFTWARE PR IVATE LIMITED-SLICK ORGANICS PVT LITD-AX ISCN0112413931,insurance,,net_banking_transfer,290.16
61fa3407d8beac15990e62ab,50200023535069,545210.29,60ec41ba55c00300382672d9,HDFC,direct expenses,5eecc6d6449e4f7cfb1c2708,2021-12-17T00:00:00.000Z,"NEFT DR-ICIC0000021-AKHILESH DIXIT-NETBA NK, MUM-N351211756150384-10000",,,net_banking_transfer,-10000
61fa3407d8beac15990e62ad,50200023535069,544307.71,60ec41ba55c00300382672d9,HDFC,bank charges,5eecc6d6449e4f7cfb1c2708,2021-12-17T00:00:00.000Z,.DC INTL POS TXN MARKUP+ST 021221 031221 -CDT2133806861750,,,international_transaction_arbitrage,-902.58
61fa3407d8beac15990e62af,50200023535069,574132.37,60ec41ba55c00300382672d9,HDFC,Revenue-COD,5eecc6d6449e4f7cfb1c2708,2021-12-17T00:00:00.000Z,NEFT CR-ICIC0000155-SHIPROCKET COD CRF I,,,net_banking_transfer,29824.66
61fa3407d8beac15990e62b1,50200023535069,572930.33,60ec41ba55c00300382672d9,HDFC,bank charges,5eecc6d6449e4f7cfb1c2708,2021-12-17T00:00:00.000Z,.DC INTL POS TXN MARKUP+ST 021221 041221 -CDT2133806861750,,,international_transaction_arbitrage,-1202.04
61fa3407d8beac15990e62b3,50200023535069,596848.26,60ec41ba55c00300382672d9,HDFC,Revenue-UPI,5eecc6d6449e4f7cfb1c2708,2021-12-17T00:00:00.000Z,UPI-GOKWIK-GOKWIK@YESBANK-YESB0000340-13 5152418785-PAYOUT FOR DECEMBE,,,upi,23917.93
61fa3407d8beac15990e62b5,50200023535069,597325.82,60ec41ba55c00300382672d9,HDFC,Revenue-Mktplace,5eecc6d6449e4f7cfb1c2708,2021-12-17T00:00:00.000Z,NEFT CR-DEUT0784BBY-TATA UNISTORE LTD-NO DAL-SLICK ORGANICS PVT LTD-135101570GN00 394,insurance,,net_banking_transfer,477.56
61fa3407d8beac15990e62b7,50200023535069,598049.74,60ec41ba55c00300382672d9,HDFC,Revenue-PG-non-split,5eecc6d6449e4f7cfb1c2708,2021-12-17T00:00:00.000Z,NEFT CR-IDFB0010204-SEZZLE PAYMENTS PRIV ATE LIMITED-SLICK ORGANICS PRIVATE LIMIT ED-IDFBH21351190417,insurance,,net_banking_transfer,723.92
61fa3407d8beac15990e62b9,50200023535069,583954.74,60ec41ba55c00300382672d9,HDFC,direct expenses,5eecc6d6449e4f7cfb1c2708,2021-12-17T00:00:00.000Z,00918630000430-TPT-14095-UNICOMMERCE ESO LUTIONS PRIVATE LIMITED,,,net_banking_transfer,-14095
61fa3407d8beac15990e62bc,50200023535069,584139.33,60ec41ba55c00300382672d9,HDFC,Revenue-PG-split enabled,5eecc6d6449e4f7cfb1c2708,2021-12-17T00:00:00.000Z,NEFT CR-UTIB0001506-RAZORPAY SOFTWARE PR IVATE LIMITED-SLICK ORGANICS PVT LITD-AX ISCN0112531075,insurance,,net_banking_transfer,184.59
61fa3407d8beac15990e62be,50200023535069,592819.05,60ec41ba55c00300382672d9,HDFC,Revenue-PG-non-split,5eecc6d6449e4f7cfb1c2708,2021-12-18T00:00:00.000Z,UPI-PAYTM-PPSL-PAYOUTS@PAYTM-PYTM0123456 -135263938680-ALL202112182168200,ewallet,,upi,8679.72
61fa3407d8beac15990e62c0,50200023535069,532269.03,60ec41ba55c00300382672d9,HDFC,direct expenses,5eecc6d6449e4f7cfb1c2708,2021-12-18T00:00:00.000Z,POS 514834XXXXXX9486 AMZ*MARKETING SV,,,debit_card,-60550.02
61fa3407d8beac15990e62c2,50200023535069,532413.96,60ec41ba55c00300382672d9,HDFC,Revenue-PG-split enabled,5eecc6d6449e4f7cfb1c2708,2021-12-18T00:00:00.000Z,NEFT CR-UTIB0001506-RAZORPAY SOFTWARE PR IVATE LIMITED-SLICK ORGANICS PVT LITD-AX ISCN0112591891,insurance,,net_banking_transfer,144.93
61fa3407d8beac15990e62c4,50200023535069,32413.96,60ec41ba55c00300382672d9,HDFC,direct expenses,5eecc6d6449e4f7cfb1c2708,2021-12-18T00:00:00.000Z,"NEFT DR-YESB0000551-VISTTA COSMETICS-NET BANK, MUM-N352211757360616-500000",,,net_banking_transfer,-500000
61fa3407d8beac15990e62c6,50200023535069,32415.96,60ec41ba55c00300382672d9,HDFC,Transfer in/Revenue-other,5eecc6d6449e4f7cfb1c2708,2021-12-18T00:00:00.000Z,POS REF 514834******9486-12/18 GOOGLESER,,,refund,2
61fa3407d8beac15990e62c8,50200023535069,79388.74,60ec41ba55c00300382672d9,HDFC,Revenue-UPI,5eecc6d6449e4f7cfb1c2708,2021-12-18T00:00:00.000Z,UPI-GOKWIK-GOKWIK@YESBANK-YESB0000340-13 5253924702-PAYOUT FOR DECEMBE,,,upi,46972.78
61fa3407d8beac15990e62ca,50200023535069,79570.41,60ec41ba55c00300382672d9,HDFC,Revenue-PG-split enabled,5eecc6d6449e4f7cfb1c2708,2021-12-18T00:00:00.000Z,NEFT CR-UTIB0001506-RAZORPAY SOFTWARE PR IVATE LIMITED-SLICK ORGANICS PVT LITD-AX ISCN0112691869,insurance,,net_banking_transfer,181.67
61fa3407d8beac15990e62cc,50200023535069,112117.77,60ec41ba55c00300382672d9,HDFC,Revenue-UPI,5eecc6d6449e4f7cfb1c2708,2021-12-18T00:00:00.000Z,UPI-GOKWIK-GOKWIK@YESBANK-YESB0000340-13,,,upi,32547.36
61fa3407d8beac15990e62ce,50200023535069,74719.1,60ec41ba55c00300382672d9,HDFC,SAAS/tech expense,5eecc6d6449e4f7cfb1c2708,2021-12-19T00:00:00.000Z,POS 514834XXXXXX9486 AMAZON.COM,shopping,,debit_card,-37398.67
61fa3407d8beac15990e62d0,50200023535069,89817.58,60ec41ba55c00300382672d9,HDFC,Revenue-PG-non-split,5eecc6d6449e4f7cfb1c2708,2021-12-19T00:00:00.000Z,IMPS-135305347561-PAYTM PAYMENTS SERVI-P YTM-XXXXXXXXXX0008-ALL202112192168200003 30830668628,ewallet,,net_banking_transfer,15098.48
61fa3407d8beac15990e62d2,50200023535069,126289.18,60ec41ba55c00300382672d9,HDFC,Revenue-UPI,5eecc6d6449e4f7cfb1c2708,2021-12-19T00:00:00.000Z,UPI-GOKWIK-GOKWIK@YESBANK-YESB0000340-13 5355305789-PAYOUT FOR DECEMBE,,,upi,36471.6
61fa3407d8beac15990e62d4,50200023535069,141922.38,60ec41ba55c00300382672d9,HDFC,Revenue-PG-non-split,5eecc6d6449e4f7cfb1c2708,2021-12-20T00:00:00.000Z,IMPS-135404596688-PAYTM PAYMENTS SERVI-P YTM-XXXXXXXXXX0008-ALL202112202168200003 30830668628,ewallet,,net_banking_transfer,15633.2
61fa3407d8beac15990e62d6,50200023535069,163506.72,60ec41ba55c00300382672d9,HDFC,Revenue-Mktplace,5eecc6d6449e4f7cfb1c2708,2021-12-20T00:00:00.000Z,NEFT CR-DEUT0797BGL-FLIPKART INTERNET PR IVATE LIMITED-SLICK ORGANICS PVT LTD-135 400209GN00241,shopping,,net_banking_transfer,21584.34
61fa3407d8beac15990e62d8,50200023535069,184079.35,60ec41ba55c00300382672d9,HDFC,Revenue-Mktplace,5eecc6d6449e4f7cfb1c2708,2021-12-20T00:00:00.000Z,NEFT CR-DEUT0797BGL-FLIPKART INTERNET PR IVATE LIMITED-SLICK ORGANICS PVT LTD-135 400213GN00248,shopping,,net_banking_transfer,20572.63
61fa3407d8beac15990e62da,50200023535069,1184079.35,60ec41ba55c00300382672d9,HDFC,Internal Transfers,5eecc6d6449e4f7cfb1c2708,2021-12-20T00:00:00.000Z,IB FUNDS TRANSFER CR-50200035187206 -SL ICK ORGANICS PVT LTD,insurance,,Other,1000000
61fa3407d8beac15990e62dc,50200023535069,1187485.04,60ec41ba55c00300382672d9,HDFC,Revenue-PG-split enabled,5eecc6d6449e4f7cfb1c2708,2021-12-20T00:00:00.000Z,NEFT CR-UTIB0001506-RAZORPAY SOFTWARE PR IVATE LIMITED-SLICK ORGANICS PVT LITD-AX ISCN0112793491,insurance,,net_banking_transfer,3405.69
61fa3407d8beac15990e62de,50200023535069,1182162.91,60ec41ba55c00300382672d9,HDFC,direct expenses,5eecc6d6449e4f7cfb1c2708,2021-12-20T00:00:00.000Z,POS 514834XXXXXX9486 ECOMENGINE* FEED,,,debit_card,-5322.13
61fa3407d8beac15990e62e0,50200023535069,856223.91,60ec41ba55c00300382672d9,HDFC,direct expenses,5eecc6d6449e4f7cfb1c2708,2021-12-20T00:00:00.000Z,"NEFT DR-ICIC0000369-BO INTERNATIONAL-NET BANK, MUM-N354211758653914-325939",,,net_banking_transfer,-325939
61fa3407d8beac15990e62e2,50200023535069,756223.91,60ec41ba55c00300382672d9,HDFC,agency/vendor expense,5eecc6d6449e4f7cfb1c2708,2021-12-20T00:00:00.000Z,"NEFT DR-KKBK0000298-ADMITAD MEDIA PRIVAT E LIMITED-NETBANK, MUM-N354211758669937- 100000",loans,lender_transaction,net_banking_transfer,-100000
61fa3407d8beac15990e62e4,50200023535069,645177.91,60ec41ba55c00300382672d9,HDFC,direct expenses,5eecc6d6449e4f7cfb1c2708,2021-12-20T00:00:00.000Z,"NEFT DR-INDB0000333-NOASTRIX PRIVATE LIM ITED-NETBANK, MUM-N354211758665277-11104 6",,,net_banking_transfer,-111046
61fa3407d8beac15990e62e6,50200023535069,604248.91,60ec41ba55c00300382672d9,HDFC,direct expenses,5eecc6d6449e4f7cfb1c2708,2021-12-20T00:00:00.000Z,NEFT DR-IDFB0021001-CLICKONIK DIGITAL ME,insurance,,net_banking_transfer,-40929
61fa3407d8beac15990e62e8,50200023535069,563527.13,60ec41ba55c00300382672d9,HDFC,direct expenses,5eecc6d6449e4f7cfb1c2708,2021-12-20T00:00:00.000Z,POS 514834XXXXXX9486 THE ROCKET SCIEN,,,debit_card,-40721.78
61fa3407d8beac15990e62ea,50200023535069,1063527.13,60ec41ba55c00300382672d9,HDFC,Internal Transfers,5eecc6d6449e4f7cfb1c2708,2021-12-20T00:00:00.000Z,IB FUNDS TRANSFER CR-50200035187206 -SL ICK ORGANICS PVT LTD,insurance,,Other,500000
61fa3407d8beac15990e62ec,50200023535069,1053527.13,60ec41ba55c00300382672d9,HDFC,direct expenses,5eecc6d6449e4f7cfb1c2708,2021-12-20T00:00:00.000Z,"NEFT DR-ICIC0000021-AKHILESH DIXIT-NETBA NK, MUM-N354211758928091-10000",,,net_banking_transfer,-10000
61fa3407d8beac15990e62ee,50200023535069,633493.11,60ec41ba55c00300382672d9,HDFC,direct expenses,5eecc6d6449e4f7cfb1c2708,2021-12-20T00:00:00.000Z,FCY OUTWARD REMITTANCE,,,Other,-420034.02
61fa3407d8beac15990e62f0,50200023535069,654922.31,60ec41ba55c00300382672d9,HDFC,Revenue-UPI,5eecc6d6449e4f7cfb1c2708,2021-12-20T00:00:00.000Z,UPI-GOKWIK-GOKWIK@YESBANK-YESB0000340-13 5456650243-PAYOUT FOR DECEMBE,,,upi,21429.2
61fa3407d8beac15990e62f2,50200023535069,616391.22,60ec41ba55c00300382672d9,HDFC,SAAS/tech expense,5eecc6d6449e4f7cfb1c2708,2021-12-20T00:00:00.000Z,POS 514834XXXXXX9486 AMAZON.COM,shopping,,debit_card,-38531.09
61fa3407d8beac15990e62f4,50200023535069,632219.65,60ec41ba55c00300382672d9,HDFC,Revenue-COD,5eecc6d6449e4f7cfb1c2708,2021-12-20T00:00:00.000Z,NEFT CR-ICIC0000155-SHIPROCKET COD CRF I D 3548927-SLICK ORGANICS PVT LTD-CMS2298 885101,insurance,,net_banking_transfer,15828.43
61fa3407d8beac15990e62f6,50200023535069,633272.25,60ec41ba55c00300382672d9,HDFC,Revenue-PG-non-split,5eecc6d6449e4f7cfb1c2708,2021-12-20T00:00:00.000Z,NEFT CR-IDFB0010204-SEZZLE PAYMENTS PRIV ATE LIMITED-SLICK ORGANICS PRIVATE LIMIT ED-IDFBH21354366037,insurance,,net_banking_transfer,1052.6
61fa3407d8beac15990e62f8,50200023535069,635376.33,60ec41ba55c00300382672d9,HDFC,Revenue-PG-non-split,5eecc6d6449e4f7cfb1c2708,2021-12-20T00:00:00.000Z,NEFT CR-IDFB0010204-SEZZLE PAYMENTS PRIV ATE LIMITED-SLICK ORGANICS PRIVATE LIMIT ED-IDFBH21354366322,insurance,,net_banking_transfer,2104.08
61fa3407d8beac15990e62fa,50200023535069,645376.33,60ec41ba55c00300382672d9,HDFC,Transfer in/Revenue-other,5eecc6d6449e4f7cfb1c2708,2021-12-20T00:00:00.000Z,NEFT CR-UTIB0003683-ALPHACMA PRIVATE LIM ITED-SLICK ORGANICS PVT LTD-AXIC21354324 9277,,,net_banking_transfer,10000
61fa3407d8beac15990e62fd,50200023535069,756183.66,60ec41ba55c00300382672d9,HDFC,Revenue-Mktplace,5eecc6d6449e4f7cfb1c2708,2021-12-21T00:00:00.000Z,IMPS-135505266491-AMAZON SELLER SERVIC-H SBC-XXXXXXXX6004-5OCVKWY8100PDFR5SLICK O RGANICS PVT LTD,shopping,,net_banking_transfer,110807.33
61fa3407d8beac15990e62ff,50200023535069,797275.28,60ec41ba55c00300382672d9,HDFC,Revenue-PG-non-split,5eecc6d6449e4f7cfb1c2708,2021-12-21T00:00:00.000Z,NEFT CR-PYTM0123456-PAYTM PAYMENTS SERVI CES LIMITED-SLICK ORGANICS PVT LTD-PYTM2 13554992501,ewallet,,net_banking_transfer,41091.62
61fa3407d8beac15990e6301,50200023535069,1174721.68,60ec41ba55c00300382672d9,HDFC,Revenue-Mktplace,5eecc6d6449e4f7cfb1c2708,2021-12-21T00:00:00.000Z,NEFT CR-DEUT0797BGL-AMAZON PAY (INDIA) P RIVATE LIMITED-SLICK ORGANICS PVT LTD-13 5500148GN00571,shopping,,net_banking_transfer,377446.4
61fa3407d8beac15990e6303,50200023535069,1175085.35,60ec41ba55c00300382672d9,HDFC,Revenue-PG-split enabled,5eecc6d6449e4f7cfb1c2708,2021-12-21T00:00:00.000Z,NEFT CR-UTIB0001506-RAZORPAY SOFTWARE PR,,,net_banking_transfer,363.67
61fa3407d8beac15990e6305,50200023535069,1130085.35,60ec41ba55c00300382672d9,HDFC,Tax,5eecc6d6449e4f7cfb1c2708,2021-12-21T00:00:00.000Z,GST/BANK REFERENCE NO: R2135531333800/CI N NO: HDFC21120700218891,,,Other,-45000
61fa3407d8beac15990e6307,50200023535069,875085.35,60ec41ba55c00300382672d9,HDFC,SAAS/tech expense,5eecc6d6449e4f7cfb1c2708,2021-12-21T00:00:00.000Z,KQSXS5MNAJ42BPWTCY/PAYUAMAZON,shopping,,Other,-255000
61fa3407d8beac15990e6309,50200023535069,873347.31,60ec41ba55c00300382672d9,HDFC,bank charges,5eecc6d6449e4f7cfb1c2708,2021-12-21T00:00:00.000Z,.DC INTL POS TXN MARKUP+ST 081221 101221 -CDT2133806861750,,,international_transaction_arbitrage,-1738.04
61fa3407d8beac15990e630b,50200023535069,873743.12,60ec41ba55c00300382672d9,HDFC,Revenue-Mktplace,5eecc6d6449e4f7cfb1c2708,2021-12-21T00:00:00.000Z,NEFT CR-ICIC0000105-MANASH LIFESTYLE PRI VATE LIMITED NO-SLICK ORGANICS PRIVATE L IMITED KOLK-ICIJ213550004589,shopping,,net_banking_transfer,395.81
61fa3407d8beac15990e630d,50200023535069,832152.12,60ec41ba55c00300382672d9,HDFC,agency/vendor expense,5eecc6d6449e4f7cfb1c2708,2021-12-21T00:00:00.000Z,"NEFT DR-UTIB0003557-INCOSEC LEGAL-NETBAN K, MUM-N355211760387949-41591",,,net_banking_transfer,-41591
61fa3407d8beac15990e630f,50200023535069,782152.12,60ec41ba55c00300382672d9,HDFC,direct expenses,5eecc6d6449e4f7cfb1c2708,2021-12-21T00:00:00.000Z,"NEFT DR-ICIC0002451-SOUTH COURT CONDOMIN IUM ASSOCIATION-NETBANK, MUM-N3552117604 06697-50000",,,net_banking_transfer,-50000
61fa3407d8beac15990e6311,50200023535069,726619.12,60ec41ba55c00300382672d9,HDFC,agency/vendor expense,5eecc6d6449e4f7cfb1c2708,2021-12-21T00:00:00.000Z,"NEFT DR-ICIC0000007-VANSUN MEDIATECH PRI VATE LIMITED-NETBANK, MUM-N3552117604392 69-55533",,,net_banking_transfer,-55533
61fa3407d8beac15990e6313,50200023535069,618619.12,60ec41ba55c00300382672d9,HDFC,direct expenses,5eecc6d6449e4f7cfb1c2708,2021-12-21T00:00:00.000Z,50200060178580-TPT-108000-CITREA GROWTH PARTNERS PRIVATE LIMITED,,,net_banking_transfer,-108000
61fa3407d8beac15990e6315,50200023535069,650204.44,60ec41ba55c00300382672d9,HDFC,Revenue-UPI,5eecc6d6449e4f7cfb1c2708,2021-12-21T00:00:00.000Z,UPI-GOKWIK-GOKWIK@YESBANK-YESB0000340-13 5558111909-PAYOUT FOR DECEMBE,,,upi,31585.32
61fa3407d8beac15990e6317,50200023535069,657180.44,60ec41ba55c00300382672d9,HDFC,Transfer in/Revenue-other,5eecc6d6449e4f7cfb1c2708,2021-12-21T00:00:00.000Z,NEFT CR-KKBK0000958-INNOVATIVE RETAIL CO NCEPTS PRIVATE LTD-SLICK ORGANICS PVT LT D-KKBK213554807315,,,net_banking_transfer,6976
61fa3407d8beac15990e6319,50200023535069,665700.44,60ec41ba55c00300382672d9,HDFC,Transfer in/Revenue-other,5eecc6d6449e4f7cfb1c2708,2021-12-21T00:00:00.000Z,NEFT CR-KKBK0000958-INNOVATIVE RETAIL CO NCEPTS PRIVATE LTD-SLICK ORGANICS PVT LT D-KKBK213554807341,,,net_banking_transfer,8520
61fa3407d8beac15990e631b,50200023535069,679767.44,60ec41ba55c00300382672d9,HDFC,Transfer in/Revenue-other,5eecc6d6449e4f7cfb1c2708,2021-12-21T00:00:00.000Z,NEFT CR-KKBK0000958-INNOVATIVE RETAIL CO NCEPTS PRIVATE LTD-SLICK ORGANICS PVT LT D-KKBK213554807568,,,net_banking_transfer,14067
61fa3407d8beac15990e631d,50200023535069,680154.51,60ec41ba55c00300382672d9,HDFC,Revenue-PG-split enabled,5eecc6d6449e4f7cfb1c2708,2021-12-21T00:00:00.000Z,NEFT CR-UTIB0001506-RAZORPAY SOFTWARE PR,,,net_banking_transfer,387.07
61fa3407d8beac15990e631f,50200023535069,724730.59,60ec41ba55c00300382672d9,HDFC,Transfer in/Revenue-other,5eecc6d6449e4f7cfb1c2708,2021-12-21T00:00:00.000Z,57500000644820-SLICK ORGANICS,insurance,,Other,44576.08
61fa3407d8beac15990e6321,50200023535069,726755.57,60ec41ba55c00300382672d9,HDFC,Revenue-PG-non-split,5eecc6d6449e4f7cfb1c2708,2021-12-21T00:00:00.000Z,NEFT CR-IDFB0010204-SEZZLE PAYMENTS PRIV ATE LIMITED-SLICK ORGANICS PRIVATE LIMIT ED-IDFBH21355443678,insurance,,net_banking_transfer,2024.98
61fa3407d8beac15990e6323,50200023535069,729033.09,60ec41ba55c00300382672d9,HDFC,Revenue-PG-non-split,5eecc6d6449e4f7cfb1c2708,2021-12-22T00:00:00.000Z,UPI-PAYTM-PPSL-PAYOUTS@PAYTM-PYTM0123456 -135660601307-ALL202112222168200,ewallet,,upi,2277.52
61fa3407d8beac15990e6325,50200023535069,752527.35,60ec41ba55c00300382672d9,HDFC,Revenue-Mktplace,5eecc6d6449e4f7cfb1c2708,2021-12-22T00:00:00.000Z,NEFT CR-DEUT0797BGL-FLIPKART INTERNET PR IVATE LIMITED-SLICK ORGANICS PVT LTD-135 600968GN00063,shopping,,net_banking_transfer,23494.26
61fa3407d8beac15990e6327,50200023535069,779183.01,60ec41ba55c00300382672d9,HDFC,Revenue-Mktplace,5eecc6d6449e4f7cfb1c2708,2021-12-22T00:00:00.000Z,NEFT CR-DEUT0797BGL-FLIPKART INTERNET PR IVATE LIMITED-SLICK ORGANICS PVT LTD-135 600978GN00093,shopping,,net_banking_transfer,26655.66
61fa3407d8beac15990e6329,50200023535069,779292.81,60ec41ba55c00300382672d9,HDFC,Revenue-PG-split enabled,5eecc6d6449e4f7cfb1c2708,2021-12-22T00:00:00.000Z,NEFT CR-UTIB0001506-RAZORPAY SOFTWARE PR IVATE LIMITED-SLICK ORGANICS PVT LITD-AX ISCN0113208917,insurance,,net_banking_transfer,109.8
61fa3407d8beac15990e632b,50200023535069,742102.6,60ec41ba55c00300382672d9,HDFC,SAAS/tech expense,5eecc6d6449e4f7cfb1c2708,2021-12-22T00:00:00.000Z,POS 514834XXXXXX9486 AMAZON.COM,shopping,,debit_card,-37190.21
61fa3407d8beac15990e632d,50200023535069,723502.6,60ec41ba55c00300382672d9,HDFC,direct expenses,5eecc6d6449e4f7cfb1c2708,2021-12-22T00:00:00.000Z,"NEFT DR-ICIC0006643-KRISHNA PACKAGING CO MPANY-NETBANK, MUM-N356211761440483-1860 0",,,net_banking_transfer,-18600
61fa3407d8beac15990e632f,50200023535069,805620.98,60ec41ba55c00300382672d9,HDFC,Revenue-Mktplace,5eecc6d6449e4f7cfb1c2708,2021-12-22T00:00:00.000Z,NEFT CR-HSBC0400002-AMAZON SERVICES LLC- SLICK ORGANICS PRIVATE LIMITED-HSBCN2135 6736688,shopping,,net_banking_transfer,82118.38
61fa3407d8beac15990e6331,50200023535069,806865.65,60ec41ba55c00300382672d9,HDFC,Revenue-Mktplace,5eecc6d6449e4f7cfb1c2708,2021-12-22T00:00:00.000Z,NEFT CR-ICIC0000105-MANASH LIFESTYLE PRI VATE LIMITED NO-SLICK ORGANICS PRIVATE L IMITED MP M-ICIJ213560003738,shopping,,net_banking_transfer,1244.67
61fa3407d8beac15990e6333,50200023535069,948550.28,60ec41ba55c00300382672d9,HDFC,Revenue-UPI,5eecc6d6449e4f7cfb1c2708,2021-12-22T00:00:00.000Z,UPI-GOKWIK-GOKWIK@YESBANK-YESB0000340-13 5659657225-PAYOUT FOR DECEMBE,,,upi,141684.63
61fa3407d8beac15990e6335,50200023535069,948711.83,60ec41ba55c00300382672d9,HDFC,Revenue-PG-split enabled,5eecc6d6449e4f7cfb1c2708,2021-12-22T00:00:00.000Z,NEFT CR-UTIB0001506-RAZORPAY SOFTWARE PR IVATE LIMITED-SLICK ORGANICS PVT LITD-AX ISCN0113332501,insurance,,net_banking_transfer,161.55
61fa3407d8beac15990e6337,50200023535069,952039.02,60ec41ba55c00300382672d9,HDFC,Revenue-PG-non-split,5eecc6d6449e4f7cfb1c2708,2021-12-22T00:00:00.000Z,NEFT CR-IDFB0010204-SEZZLE PAYMENTS PRIV,,,net_banking_transfer,3327.19
61fa3407d8beac15990e6339,50200023535069,1024121.67,60ec41ba55c00300382672d9,HDFC,Revenue-COD,5eecc6d6449e4f7cfb1c2708,2021-12-22T00:00:00.000Z,NEFT CR-ICIC0000155-SHIPROCKET COD CRF I D 3561284-SLICK ORGANICS PVT LTD-CMS2302 368410,insurance,,net_banking_transfer,72082.65
61fa3407d8beac15990e633b,50200023535069,1038217.75,60ec41ba55c00300382672d9,HDFC,Revenue-PG-non-split,5eecc6d6449e4f7cfb1c2708,2021-12-23T00:00:00.000Z,IMPS-135704721905-PAYTM PAYMENTS SERVI-P YTM-XXXXXXXXXX0008-ALL202112232168200003 30830668628,ewallet,,net_banking_transfer,14096.08
61fa3407d8beac15990e633d,50200023535069,1038549.03,60ec41ba55c00300382672d9,HDFC,Revenue-PG-split enabled,5eecc6d6449e4f7cfb1c2708,2021-12-23T00:00:00.000Z,NEFT CR-UTIB0001506-RAZORPAY SOFTWARE PR IVATE LIMITED-SLICK ORGANICS PVT LITD-AX ISCN0113399525,insurance,,net_banking_transfer,331.28
61fa3407d8beac15990e633f,50200023535069,1021459.03,60ec41ba55c00300382672d9,HDFC,direct expenses,5eecc6d6449e4f7cfb1c2708,2021-12-23T00:00:00.000Z,"NEFT DR-YESB0000236-DELIGHT VACATION PVT LTD-NETBANK, MUM-N357211762879917-17090",,,net_banking_transfer,-17090
61fa3407d8beac15990e6341,50200023535069,1022376.04,60ec41ba55c00300382672d9,HDFC,Revenue-Mktplace,5eecc6d6449e4f7cfb1c2708,2021-12-23T00:00:00.000Z,NEFT CR-ICIC0000105-MANASH LIFESTYLE PRI VATE LIMITED NO-SLICK ORGANICS PRIVATE L IMITED MP G-ICIJ213570000716,shopping,,net_banking_transfer,917.01
61fa3407d8beac15990e6343,50200023535069,1023721.81,60ec41ba55c00300382672d9,HDFC,Transfer in/Revenue-other,5eecc6d6449e4f7cfb1c2708,2021-12-23T00:00:00.000Z,4060008404-23 12 2021-HDFAZCUR1,,,Other,1345.77
61fa3407d8beac15990e6345,50200023535069,1044877.81,60ec41ba55c00300382672d9,HDFC,Revenue-Mktplace,5eecc6d6449e4f7cfb1c2708,2021-12-23T00:00:00.000Z,NEFT CR-SCBL0036001-M/S DREAMPLUG TECHNO -SLICK ORGANICS PRIVATE LIMITEDSLICK-SIN 31436Q0028593,insurance,,net_banking_transfer,21156
61fa3407d8beac15990e6347,50200023535069,1045282.27,60ec41ba55c00300382672d9,HDFC,Revenue-PG-split enabled,5eecc6d6449e4f7cfb1c2708,2021-12-23T00:00:00.000Z,NEFT CR-UTIB0001506-RAZORPAY SOFTWARE PR IVATE LIMITED-SLICK ORGANICS PVT LITD-AX ISCN0113664196,insurance,,net_banking_transfer,404.46
61fa3407d8beac15990e6349,50200023535069,1082662.26,60ec41ba55c00300382672d9,HDFC,Revenue-UPI,5eecc6d6449e4f7cfb1c2708,2021-12-23T00:00:00.000Z,UPI-GOKWIK-GOKWIK@YESBANK-YESB0000340-13 5761608292-PAYOUT FOR DECEMBE,,,upi,37379.99
61fa3407d8beac15990e634b,50200023535069,1105754.31,60ec41ba55c00300382672d9,HDFC,Revenue-PG-non-split,5eecc6d6449e4f7cfb1c2708,2021-12-24T00:00:00.000Z,IMPS-135804960103-PAYTM PAYMENTS SERVI-P YTM-XXXXXXXXXX0008-ALL202112242168200003 30830668628,ewallet,,net_banking_transfer,23092.05
61fa3407d8beac15990e634d,50200023535069,1105874.71,60ec41ba55c00300382672d9,HDFC,Revenue-PG-split enabled,5eecc6d6449e4f7cfb1c2708,2021-12-24T00:00:00.000Z,NEFT CR-UTIB0001506-RAZORPAY SOFTWARE PR IVATE LIMITED-SLICK ORGANICS PVT LITD-AX ISCN0113723398,insurance,,net_banking_transfer,120.4
61fa3407d8beac15990e634f,50200023535069,1109173.59,60ec41ba55c00300382672d9,HDFC,Revenue-Mktplace,5eecc6d6449e4f7cfb1c2708,2021-12-24T00:00:00.000Z,4060008317-TIMES INTERNET LIMITED NODAL,,,Other,3298.88
61fa3407d8beac15990e6351,50200023535069,1109650.36,60ec41ba55c00300382672d9,HDFC,Transfer in/Revenue-other,5eecc6d6449e4f7cfb1c2708,2021-12-24T00:00:00.000Z,NEFT CR-YESB0000001-ILUMINAR MEDIA-SLICK ORGANICS PVT. LTD-N358210922119572,,,net_banking_transfer,476.77
61fa3407d8beac15990e6353,50200023535069,1108081.54,60ec41ba55c00300382672d9,HDFC,bank charges,5eecc6d6449e4f7cfb1c2708,2021-12-24T00:00:00.000Z,.DC INTL POS TXN MARKUP+ST 141221 161221 -CDT2133806861750,,,international_transaction_arbitrage,-1568.82
61fa3407d8beac15990e6355,50200023535069,1107926.86,60ec41ba55c00300382672d9,HDFC,bank charges,5eecc6d6449e4f7cfb1c2708,2021-12-24T00:00:00.000Z,.DC INTL POS TXN MARKUP+ST 151221 171221 -CDT2133806861750,,,international_transaction_arbitrage,-154.68
61fa3407d8beac15990e6357,50200023535069,1106336.38,60ec41ba55c00300382672d9,HDFC,bank charges,5eecc6d6449e4f7cfb1c2708,2021-12-24T00:00:00.000Z,.DC INTL POS TXN MARKUP+ST 161221 181221 -CDT2133806861750,,,international_transaction_arbitrage,-1590.48
61fa3407d8beac15990e6359,50200023535069,1106721.6,60ec41ba55c00300382672d9,HDFC,Transfer in/Revenue-other,5eecc6d6449e4f7cfb1c2708,2021-12-24T00:00:00.000Z,NEFT CR-ICIC0SF0002-ICICI BANK NODAL A-C -SLICK ORGANICS-25811903201DC,insurance,,net_banking_transfer,385.22
61fa3407d8beac15990e635b,50200023535069,1104220.89,60ec41ba55c00300382672d9,HDFC,bank charges,5eecc6d6449e4f7cfb1c2708,2021-12-24T00:00:00.000Z,.DC INTL POS TXN MARKUP+ST 181221 191221 -CDT2133806861750,,,international_transaction_arbitrage,-2500.71
61fa3407d8beac15990e635d,50200023535069,1135023.64,60ec41ba55c00300382672d9,HDFC,Revenue-UPI,5eecc6d6449e4f7cfb1c2708,2021-12-24T00:00:00.000Z,UPI-GOKWIK-GOKWIK@YESBANK-YESB0000340-13 5863163719-PAYOUT FOR DECEMBE,,,upi,30802.75
61fa3407d8beac15990e635f,50200023535069,1096196.84,60ec41ba55c00300382672d9,HDFC,SAAS/tech expense,5eecc6d6449e4f7cfb1c2708,2021-12-24T00:00:00.000Z,POS 514834XXXXXX9486 AMAZON.COM,shopping,,debit_card,-38826.8
61fa3407d8beac15990e6361,50200023535069,1123100.14,60ec41ba55c00300382672d9,HDFC,Revenue-COD,5eecc6d6449e4f7cfb1c2708,2021-12-24T00:00:00.000Z,NEFT CR-ICIC0000155-SHIPROCKET COD CRF I D 3573498-SLICK ORGANICS PVT LTD-CMS2306 060015,insurance,,net_banking_transfer,26903.3
61fa3407d8beac15990e6363,50200023535069,1124293.85,60ec41ba55c00300382672d9,HDFC,Revenue-PG-non-split,5eecc6d6449e4f7cfb1c2708,2021-12-24T00:00:00.000Z,NEFT CR-IDFB0010204-SEZZLE PAYMENTS PRIV ATE LIMITED-SLICK ORGANICS PRIVATE LIMIT ED-IDFBH21358670827,insurance,,net_banking_transfer,1193.71
61fa3408d8beac15990e6365,50200023535069,1127558.51,60ec41ba55c00300382672d9,HDFC,Revenue-PG-non-split,5eecc6d6449e4f7cfb1c2708,2021-12-24T00:00:00.000Z,NEFT CR-IDFB0010204-SEZZLE PAYMENTS PRIV ATE LIMITED-SLICK ORGANICS PRIVATE LIMIT ED-IDFBH21358671300,insurance,,net_banking_transfer,3264.66
61fa3408d8beac15990e6367,50200023535069,1127985.83,60ec41ba55c00300382672d9,HDFC,Revenue-PG-split enabled,5eecc6d6449e4f7cfb1c2708,2021-12-24T00:00:00.000Z,NEFT CR-UTIB0001506-RAZORPAY SOFTWARE PR IVATE LIMITED-SLICK ORGANICS PVT LITD-AX ISCN0114012674,insurance,,net_banking_transfer,427.32
61fa3408d8beac15990e6369,50200023535069,1068022.2,60ec41ba55c00300382672d9,HDFC,direct expenses,5eecc6d6449e4f7cfb1c2708,2021-12-24T00:00:00.000Z,POS 514834XXXXXX9486 AMZ*MARKETING SV,,,debit_card,-59963.63
61fa3408d8beac15990e636b,50200023535069,1075728.61,60ec41ba55c00300382672d9,HDFC,Revenue-PG-non-split,5eecc6d6449e4f7cfb1c2708,2021-12-25T00:00:00.000Z,IMPS-135904238080-PAYTM PAYMENTS SERVI-P YTM-XXXXXXXXXX0008-ALL202112252168200003 30830668628,ewallet,,net_banking_transfer,7706.41
61fa3408d8beac15990e636d,50200023535069,875728.61,60ec41ba55c00300382672d9,HDFC,direct expenses,5eecc6d6449e4f7cfb1c2708,2021-12-25T00:00:00.000Z,NEFT DR-YESB0000551-VISTTA COSMETICS-NET,,,net_banking_transfer,-200000
61fa3408d8beac15990e636f,50200023535069,675728.61,60ec41ba55c00300382672d9,HDFC,direct expenses,5eecc6d6449e4f7cfb1c2708,2021-12-25T00:00:00.000Z,IMPS-135909175309-VISTTA COSMETICS-YESB- XXXXXXXXXXX1450-200000,,,net_banking_transfer,-200000
61fa3408d8beac15990e6372,50200023535069,729141.64,60ec41ba55c00300382672d9,HDFC,Revenue-UPI,5eecc6d6449e4f7cfb1c2708,2021-12-25T00:00:00.000Z,UPI-GOKWIK-GOKWIK@YESBANK-YESB0000340-13 5964639994-PAYOUT FOR DECEMBE,,,upi,53413.03
61fa3408d8beac15990e6374,50200023535069,740735.04,60ec41ba55c00300382672d9,HDFC,Revenue-PG-non-split,5eecc6d6449e4f7cfb1c2708,2021-12-26T00:00:00.000Z,IMPS-136004453026-PAYTM PAYMENTS SERVI-P YTM-XXXXXXXXXX0008-ALL202112262168200003 30830668628,ewallet,,net_banking_transfer,11593.4
61fa3408d8beac15990e6376,50200023535069,714223.04,60ec41ba55c00300382672d9,HDFC,direct expenses,5eecc6d6449e4f7cfb1c2708,2021-12-26T00:00:00.000Z,"NEFT DR-SCBL0036025-DHRUV MADHOK-NETBANK , MUM-N360211765829394-26512",,,net_banking_transfer,-26512
61fa3408d8beac15990e6378,50200023535069,614223.04,60ec41ba55c00300382672d9,HDFC,direct expenses,5eecc6d6449e4f7cfb1c2708,2021-12-26T00:00:00.000Z,"NEFT DR-YESB0000551-VISTTA COSMETICS-NET BANK, MUM-N360211765833595-100000",,,net_banking_transfer,-100000
61fa3408d8beac15990e637a,50200023535069,638697.91,60ec41ba55c00300382672d9,HDFC,Revenue-UPI,5eecc6d6449e4f7cfb1c2708,2021-12-26T00:00:00.000Z,UPI-GOKWIK-GOKWIK@YESBANK-YESB0000340-13 6066367957-PAYOUT FOR DECEMBE,,,upi,24474.87
61fa3408d8beac15990e637c,50200023535069,600563.6,60ec41ba55c00300382672d9,HDFC,SAAS/tech expense,5eecc6d6449e4f7cfb1c2708,2021-12-26T00:00:00.000Z,POS 514834XXXXXX9486 AMAZON.COM,shopping,,debit_card,-38134.31
61fa3408d8beac15990e637e,50200023535069,610812.63,60ec41ba55c00300382672d9,HDFC,Revenue-PG-non-split,5eecc6d6449e4f7cfb1c2708,2021-12-27T00:00:00.000Z,IMPS-136104700712-PAYTM PAYMENTS SERVI-P YTM-XXXXXXXXXX0008-ALL202112272168200003 30830668628,ewallet,,net_banking_transfer,10249.03
61fa3408d8beac15990e6380,50200023535069,637437.04,60ec41ba55c00300382672d9,HDFC,Revenue-Mktplace,5eecc6d6449e4f7cfb1c2708,2021-12-27T00:00:00.000Z,NEFT CR-DEUT0797BGL-FLIPKART INTERNET PR IVATE LIMITED-SLICK ORGANICS PVT LTD-136 100252GN00270,shopping,,net_banking_transfer,26624.41
61fa3408d8beac15990e6382,50200023535069,650057.36,60ec41ba55c00300382672d9,HDFC,Revenue-Mktplace,5eecc6d6449e4f7cfb1c2708,2021-12-27T00:00:00.000Z,NEFT CR-DEUT0797BGL-FLIPKART INTERNET PR IVATE LIMITED-SLICK ORGANICS PVT LTD-136 100296GN00069,shopping,,net_banking_transfer,12620.32
61fa3408d8beac15990e6384,50200023535069,650377.68,60ec41ba55c00300382672d9,HDFC,Revenue-PG-split enabled,5eecc6d6449e4f7cfb1c2708,2021-12-27T00:00:00.000Z,NEFT CR-UTIB0001506-RAZORPAY SOFTWARE PR IVATE LIMITED-SLICK ORGANICS PVT LITD-AX ISCN0114229495,insurance,,net_banking_transfer,320.32
61fa3408d8beac15990e6386,50200023535069,612327.68,60ec41ba55c00300382672d9,HDFC,direct expenses,5eecc6d6449e4f7cfb1c2708,2021-12-27T00:00:00.000Z,50200016295776-TPT-38050-V KESHRI AND AS SOCIATES,,,net_banking_transfer,-38050
61fa3408d8beac15990e6388,50200023535069,602327.68,60ec41ba55c00300382672d9,HDFC,direct expenses,5eecc6d6449e4f7cfb1c2708,2021-12-27T00:00:00.000Z,"NEFT DR-ICIC0000021-AKHILESH DIXIT-NETBA NK, MUM-N361211766083446-10000",,,net_banking_transfer,-10000
61fa3408d8beac15990e638a,50200023535069,402327.68,60ec41ba55c00300382672d9,HDFC,direct expenses,5eecc6d6449e4f7cfb1c2708,2021-12-27T00:00:00.000Z,NEFT DR-INDB0000148-ACQUISORY INDIA CONS,,,net_banking_transfer,-200000
61fa3408d8beac15990e638c,50200023535069,427694.65,60ec41ba55c00300382672d9,HDFC,Revenue-UPI,5eecc6d6449e4f7cfb1c2708,2021-12-27T00:00:00.000Z,UPI-GOKWIK-GOKWIK@YESBANK-YESB0000340-13 6168025272-PAYOUT FOR DECEMBE,,,upi,25366.97
61fa3408d8beac15990e638e,50200023535069,435006.62,60ec41ba55c00300382672d9,HDFC,Revenue-PG-non-split,5eecc6d6449e4f7cfb1c2708,2021-12-27T00:00:00.000Z,NEFT CR-KKBK0000958-BROKENTUSK TECHNOLOG IES PRIVATE LIMITED-SLICK ORGANICS PRIVA TE LIMITED-KKBK213616086429,,,net_banking_transfer,7311.97
61fa3408d8beac15990e6390,50200023535069,449404.28,60ec41ba55c00300382672d9,HDFC,Revenue-COD,5eecc6d6449e4f7cfb1c2708,2021-12-27T00:00:00.000Z,NEFT CR-ICIC0000155-SHIPROCKET COD CRF I D 3581713-SLICK ORGANICS PVT LTD-CMS2310 361468,insurance,,net_banking_transfer,14397.66
61fa3408d8beac15990e6392,50200023535069,450000.22,60ec41ba55c00300382672d9,HDFC,Revenue-Mktplace,5eecc6d6449e4f7cfb1c2708,2021-12-27T00:00:00.000Z,NEFT CR-ICIC0000105-MANASH LIFETYLE PVT LTD-SLICK ORGANICS PRIVATE LIMITED KOLK ATA-ICIB213610056614,,,net_banking_transfer,595.94
61fa3408d8beac15990e6394,50200023535069,453704.85,60ec41ba55c00300382672d9,HDFC,Revenue-Mktplace,5eecc6d6449e4f7cfb1c2708,2021-12-27T00:00:00.000Z,NEFT CR-ICIC0000105-MANASH LIFETYLE PVT LTD-SLICK ORGANICS PRIVATE LIMITED MP GG N-ICIB213610056613,,,net_banking_transfer,3704.63
61fa3408d8beac15990e6396,50200023535069,455071.93,60ec41ba55c00300382672d9,HDFC,Revenue-Mktplace,5eecc6d6449e4f7cfb1c2708,2021-12-27T00:00:00.000Z,NEFT CR-ICIC0000105-MANASH LIFETYLE PVT LTD-SLICK ORGANICS PRIVATE LIMITED MP MU M-ICIB213610058498,,,net_banking_transfer,1367.08
61fa3408d8beac15990e6398,50200023535069,458412.44,60ec41ba55c00300382672d9,HDFC,Revenue-PG-non-split,5eecc6d6449e4f7cfb1c2708,2021-12-27T00:00:00.000Z,NEFT CR-IDFB0010204-SEZZLE PAYMENTS PRIV ATE LIMITED-SLICK ORGANICS PRIVATE LIMIT ED-IDFBH21361814632,insurance,,net_banking_transfer,3340.51
61fa3408d8beac15990e639a,50200023535069,459395.44,60ec41ba55c00300382672d9,HDFC,Revenue-PG-split enabled,5eecc6d6449e4f7cfb1c2708,2021-12-27T00:00:00.000Z,NEFT CR-UTIB0001506-RAZORPAY SOFTWARE PR IVATE LIMITED-SLICK ORGANICS PVT LITD-AX ISCN0114374992,insurance,,net_banking_transfer,983
61fa3408d8beac15990e639c,50200023535069,479946.84,60ec41ba55c00300382672d9,HDFC,Revenue-PG-non-split,5eecc6d6449e4f7cfb1c2708,2021-12-28T00:00:00.000Z,IMPS-136204062328-PAYTM PAYMENTS SERVI-P YTM-XXXXXXXXXX0008-ALL202112282168200003 30830668628,ewallet,,net_banking_transfer,20551.4
61fa3408d8beac15990e639f,50200023535069,570376.33,60ec41ba55c00300382672d9,HDFC,Revenue-Mktplace,5eecc6d6449e4f7cfb1c2708,2021-12-28T00:00:00.000Z,IMPS-136205205653-AMAZON SELLER SERVIC-H SBC-XXXXXXXX6004-M0RJVW7HUZ500MY6SLICK O RGANICS PVT LTD,shopping,,net_banking_transfer,90429.49
61fa3408d8beac15990e63a1,50200023535069,921654.79,60ec41ba55c00300382672d9,HDFC,Revenue-Mktplace,5eecc6d6449e4f7cfb1c2708,2021-12-28T00:00:00.000Z,NEFT CR-DEUT0797BGL-AMAZON PAY (INDIA) P,shopping,,net_banking_transfer,351278.46
61fa3408d8beac15990e63a3,50200023535069,921722.86,60ec41ba55c00300382672d9,HDFC,Revenue-PG-split enabled,5eecc6d6449e4f7cfb1c2708,2021-12-28T00:00:00.000Z,NEFT CR-UTIB0001506-RAZORPAY SOFTWARE PR IVATE LIMITED-SLICK ORGANICS PVT LITD-AX ISCN0114446419,insurance,,net_banking_transfer,68.07
61fa3408d8beac15990e63a5,50200023535069,921720.86,60ec41ba55c00300382672d9,HDFC,Marketing Expense,5eecc6d6449e4f7cfb1c2708,2021-12-28T00:00:00.000Z,ME DC SI 514834XXXXXX9486 GOOGLESERVIS,,,Other,-2
61fa3408d8beac15990e63a7,50200023535069,883943.31,60ec41ba55c00300382672d9,HDFC,SAAS/tech expense,5eecc6d6449e4f7cfb1c2708,2021-12-28T00:00:00.000Z,POS 514834XXXXXX9486 AMAZON.COM,shopping,,debit_card,-37777.55
61fa3408d8beac15990e63a9,50200023535069,882398.74,60ec41ba55c00300382672d9,HDFC,bank charges,5eecc6d6449e4f7cfb1c2708,2021-12-28T00:00:00.000Z,.DC INTL POS TXN MARKUP+ST 181221 201221 -CDT2133806861750,,,international_transaction_arbitrage,-1544.57
61fa3408d8beac15990e63ab,50200023535069,882178.95,60ec41ba55c00300382672d9,HDFC,bank charges,5eecc6d6449e4f7cfb1c2708,2021-12-28T00:00:00.000Z,.DC INTL POS TXN MARKUP+ST 191221 211221 -CDT2133806861750,,,international_transaction_arbitrage,-219.79
61fa3408d8beac15990e63ae,50200023535069,807762.95,60ec41ba55c00300382672d9,HDFC,direct expenses,5eecc6d6449e4f7cfb1c2708,2021-12-28T00:00:00.000Z,"NEFT DR-KKBK0000218-MONETIZE INFO LLP-NE TBANK, MUM-N362211767785770-74416",,,net_banking_transfer,-74416
61fa3408d8beac15990e63b0,50200023535069,747551.95,60ec41ba55c00300382672d9,HDFC,direct expenses,5eecc6d6449e4f7cfb1c2708,2021-12-28T00:00:00.000Z,"NEFT DR-KKBK0000218-MONETIZE INFO LLP-NE TBANK, MUM-N362211767777575-60211",,,net_banking_transfer,-60211
61fa3408d8beac15990e63b2,50200023535069,679068.95,60ec41ba55c00300382672d9,HDFC,agency/vendor expense,5eecc6d6449e4f7cfb1c2708,2021-12-28T00:00:00.000Z,"NEFT DR-KKBK0000298-ADMITAD MEDIA PRIVAT E LIMITED-NETBANK, MUM-N362211767786630- 68483",loans,lender_transaction,net_banking_transfer,-68483
61fa3408d8beac15990e63b4,50200023535069,463068.95,60ec41ba55c00300382672d9,HDFC,direct expenses,5eecc6d6449e4f7cfb1c2708,2021-12-28T00:00:00.000Z,05722560002993-TPT-216000-M5 ENTERTAINME NT PRIVATE LIMITED,,,net_banking_transfer,-216000
61fa3408d8beac15990e63b6,50200023535069,461477.62,60ec41ba55c00300382672d9,HDFC,bank charges,5eecc6d6449e4f7cfb1c2708,2021-12-28T00:00:00.000Z,.DC INTL POS TXN MARKUP+ST 201221 221221 -CDT2133806861750,,,international_transaction_arbitrage,-1591.33
61fa3408d8beac15990e63b8,50200023535069,459941.66,60ec41ba55c00300382672d9,HDFC,bank charges,5eecc6d6449e4f7cfb1c2708,2021-12-28T00:00:00.000Z,.DC INTL POS TXN MARKUP+ST 221221 231221 -CDT2133806861750,,,international_transaction_arbitrage,-1535.96
61fa3408d8beac15990e63ba,50200023535069,508390.55,60ec41ba55c00300382672d9,HDFC,Revenue-UPI,5eecc6d6449e4f7cfb1c2708,2021-12-28T00:00:00.000Z,UPI-GOKWIK-GOKWIK@YESBANK-YESB0000340-13 6269848910-PAYOUT FOR DECEMBE,,,upi,48448.89
61fa3408d8beac15990e63bc,50200023535069,510444.45,60ec41ba55c00300382672d9,HDFC,Revenue-Mktplace,5eecc6d6449e4f7cfb1c2708,2021-12-28T00:00:00.000Z,NEFT CR-ICIC0000105-MANASH LIFESTYLE PRI VATE LIMITED NO-SLICK ORGANICS PRIVATE L IMITED MP M-ICIJ213620000900,shopping,,net_banking_transfer,2053.9
61fa3408d8beac15990e63be,50200023535069,513880.81,60ec41ba55c00300382672d9,HDFC,Revenue-Mktplace,5eecc6d6449e4f7cfb1c2708,2021-12-28T00:00:00.000Z,NEFT CR-ICIC0000105-MANASH LIFESTYLE PRI,shopping,,net_banking_transfer,3436.36
61fa3408d8beac15990e63c0,50200023535069,514199.06,60ec41ba55c00300382672d9,HDFC,Revenue-PG-split enabled,5eecc6d6449e4f7cfb1c2708,2021-12-28T00:00:00.000Z,NEFT CR-UTIB0001506-RAZORPAY SOFTWARE PR IVATE LIMITED-SLICK ORGANICS PVT LITD-AX ISCN0114567055,insurance,,net_banking_transfer,318.25
61fa3408d8beac15990e63c2,50200023535069,516980.82,60ec41ba55c00300382672d9,HDFC,Revenue-PG-non-split,5eecc6d6449e4f7cfb1c2708,2021-12-28T00:00:00.000Z,NEFT CR-IDFB0010204-SEZZLE PAYMENTS PRIV ATE LIMITED-SLICK ORGANICS PRIVATE LIMIT ED-IDFBH21362886504,insurance,,net_banking_transfer,2781.76
61fa3408d8beac15990e63c4,50200023535069,516990.82,60ec41ba55c00300382672d9,HDFC,Adjustments/Reversal,5eecc6d6449e4f7cfb1c2708,2021-12-28T00:00:00.000Z,IMPS-136220863267-HIVELOOP INTERNET PV-I CIC-XXXXXXXX4872-CREDIT PAYMENT REVERSAL,,,net_banking_transfer,10
61fa3408d8beac15990e63c6,50200023535069,513352.22,60ec41ba55c00300382672d9,HDFC,direct expenses,5eecc6d6449e4f7cfb1c2708,2021-12-28T00:00:00.000Z,POS 514834XXXXXX9486 FRESHWORKS INC,,,debit_card,-3638.6
61fa3408d8beac15990e63c8,50200023535069,519069.79,60ec41ba55c00300382672d9,HDFC,Revenue-PG-non-split,5eecc6d6449e4f7cfb1c2708,2021-12-29T00:00:00.000Z,IMPS-136304347447-PAYTM PAYMENTS SERVI-P YTM-XXXXXXXXXX0008-ALL202112292168200003 30830668628,ewallet,,net_banking_transfer,5717.57
61fa3408d8beac15990e63ca,50200023535069,536998.69,60ec41ba55c00300382672d9,HDFC,Revenue-Mktplace,5eecc6d6449e4f7cfb1c2708,2021-12-29T00:00:00.000Z,NEFT CR-DEUT0797BGL-FLIPKART INTERNET PR IVATE LIMITED-SLICK ORGANICS PVT LTD-136 300174GN00296,shopping,,net_banking_transfer,17928.9
61fa3408d8beac15990e63cc,50200023535069,558238.61,60ec41ba55c00300382672d9,HDFC,Revenue-Mktplace,5eecc6d6449e4f7cfb1c2708,2021-12-29T00:00:00.000Z,NEFT CR-DEUT0797BGL-FLIPKART INTERNET PR IVATE LIMITED-SLICK ORGANICS PVT LTD-136 300189GN00084,shopping,,net_banking_transfer,21239.92
61fa3408d8beac15990e63ce,50200023535069,559693.6,60ec41ba55c00300382672d9,HDFC,Revenue-PG-split enabled,5eecc6d6449e4f7cfb1c2708,2021-12-29T00:00:00.000Z,NEFT CR-UTIB0001506-RAZORPAY SOFTWARE PR IVATE LIMITED-SLICK ORGANICS PVT LITD-AX ISCN0114632347,insurance,,net_banking_transfer,1454.99
61fa3408d8beac15990e63d0,50200023535069,359693.6,60ec41ba55c00300382672d9,HDFC,direct expenses,5eecc6d6449e4f7cfb1c2708,2021-12-29T00:00:00.000Z,"NEFT DR-PUNB0642000-UFLEX LIMITED-NETBAN K, MUM-N363211769226895-200000",loans,lender_transaction,net_banking_transfer,-200000
61fa3408d8beac15990e63d2,50200023535069,1359693.6,60ec41ba55c00300382672d9,HDFC,Internal Transfers,5eecc6d6449e4f7cfb1c2708,2021-12-29T00:00:00.000Z,IB FUNDS TRANSFER CR-50200035187206 -SL ICK ORGANICS PVT LTD,insurance,,Other,1000000
61fa3408d8beac15990e63d4,50200023535069,359693.6,60ec41ba55c00300382672d9,HDFC,Tax,5eecc6d6449e4f7cfb1c2708,2021-12-29T00:00:00.000Z,051030829122128078- CBDT TAX,,,Other,-1000000
61fa3408d8beac15990e63d6,50200023535069,360798.96,60ec41ba55c00300382672d9,HDFC,Revenue-Mktplace,5eecc6d6449e4f7cfb1c2708,2021-12-29T00:00:00.000Z,NEFT CR-ICIC0000105-MANASH LIFESTYLE PRI VATE LIMITED NO-SLICK ORGANICS PRIVATE L IMITED MP G-ICIJ213630002974,shopping,,net_banking_transfer,1105.36
61fa3408d8beac15990e63d8,50200023535069,361358.99,60ec41ba55c00300382672d9,HDFC,Revenue-Mktplace,5eecc6d6449e4f7cfb1c2708,2021-12-29T00:00:00.000Z,NEFT CR-ICIC0000105-MANASH LIFESTYLE PRI,shopping,,net_banking_transfer,560.03
61fa3408d8beac15990e63da,50200023535069,407026.31,60ec41ba55c00300382672d9,HDFC,Revenue-UPI,5eecc6d6449e4f7cfb1c2708,2021-12-29T00:00:00.000Z,UPI-GOKWIK-GOKWIK@YESBANK-YESB0000340-13 6371636635-PAYOUT FOR DECEMBE,,,upi,45667.32
61fa3408d8beac15990e63dc,50200023535069,407519.63,60ec41ba55c00300382672d9,HDFC,Revenue-PG-non-split,5eecc6d6449e4f7cfb1c2708,2021-12-29T00:00:00.000Z,NEFT CR-IDFB0010204-SEZZLE PAYMENTS PRIV ATE LIMITED-SLICK ORGANICS PRIVATE LIMIT ED-IDFBH21363954411,insurance,,net_banking_transfer,493.32
61fa3408d8beac15990e63de,50200023535069,448969.33,60ec41ba55c00300382672d9,HDFC,Revenue-COD,5eecc6d6449e4f7cfb1c2708,2021-12-29T00:00:00.000Z,NEFT CR-ICIC0000155-SHIPROCKET COD CRF I D 3594031-SLICK ORGANICS PVT LTD-CMS2314 203273,insurance,,net_banking_transfer,41449.7
61fa3408d8beac15990e63e0,50200023535069,449356.54,60ec41ba55c00300382672d9,HDFC,Revenue-PG-non-split,5eecc6d6449e4f7cfb1c2708,2021-12-29T00:00:00.000Z,NEFT CR-ICIC0000031-PAYTM E COMMERCE PVT LTD-SLICK ORGANICS PVT LTD-CMS231465724 8,ewallet,,net_banking_transfer,387.21
61fa3408d8beac15990e63e2,50200023535069,462541.57,60ec41ba55c00300382672d9,HDFC,Revenue-PG-non-split,5eecc6d6449e4f7cfb1c2708,2021-12-30T00:00:00.000Z,IMPS-136404609579-PAYTM PAYMENTS SERVI-P YTM-XXXXXXXXXX0008-ALL202112302168200003 30830668628,ewallet,,net_banking_transfer,13185.03
61fa3408d8beac15990e63e4,50200023535069,424715.88,60ec41ba55c00300382672d9,HDFC,SAAS/tech expense,5eecc6d6449e4f7cfb1c2708,2021-12-30T00:00:00.000Z,POS 514834XXXXXX9486 AMAZON.COM,shopping,,debit_card,-37825.69
61fa3408d8beac15990e63e6,50200023535069,425274.97,60ec41ba55c00300382672d9,HDFC,Revenue-PG-split enabled,5eecc6d6449e4f7cfb1c2708,2021-12-30T00:00:00.000Z,NEFT CR-UTIB0001506-RAZORPAY SOFTWARE PR IVATE LIMITED-SLICK ORGANICS PVT LITD-AX ISCN0114834510,insurance,,net_banking_transfer,559.09
61fa3408d8beac15990e63e9,50200023535069,170274.97,60ec41ba55c00300382672d9,HDFC,SAAS/tech expense,5eecc6d6449e4f7cfb1c2708,2021-12-30T00:00:00.000Z,KQSXS4MJBN62NOGXDY/PAYUAMAZON,shopping,,Other,-255000
61fa3408d8beac15990e63eb,50200023535069,170457.49,60ec41ba55c00300382672d9,HDFC,Revenue-Mktplace,5eecc6d6449e4f7cfb1c2708,2021-12-30T00:00:00.000Z,NEFT CR-ICIC0000105-MANASH LIFESTYLE PRI VATE LIMITED NO-SLICK ORGANICS PRIVATE L IMITED MP G-ICIJ213640004298,shopping,,net_banking_transfer,182.52
61fa3408d8beac15990e63ed,50200023535069,170629.74,60ec41ba55c00300382672d9,HDFC,Revenue-Mktplace,5eecc6d6449e4f7cfb1c2708,2021-12-30T00:00:00.000Z,NEFT CR-ICIC0000105-MANASH LIFESTYLE PRI VATE LIMITED NO-SLICK ORGANICS PRIVATE L IMITED BANG-ICIJ213640004300,shopping,,net_banking_transfer,172.25
61fa3408d8beac15990e63ef,50200023535069,670629.74,60ec41ba55c00300382672d9,HDFC,Internal Transfers,5eecc6d6449e4f7cfb1c2708,2021-12-30T00:00:00.000Z,IB FUNDS TRANSFER CR-50200035187206 -SL ICK ORGANICS PVT LTD,insurance,,Other,500000
61fa3408d8beac15990e63f1,50200023535069,170629.74,60ec41ba55c00300382672d9,HDFC,Marketing Expense,5eecc6d6449e4f7cfb1c2708,2021-12-30T00:00:00.000Z,"NEFT DR-CITI0000006-FACEBOOK INDIA ONLIN E SERVICES PVT LTD-NETBANK, MUM-N3642117 71182318-500000",,,net_banking_transfer,-500000
61fa3408d8beac15990e63f3,50200023535069,226839.52,60ec41ba55c00300382672d9,HDFC,Revenue-UPI,5eecc6d6449e4f7cfb1c2708,2021-12-30T00:00:00.000Z,UPI-GOKWIK-GOKWIK@YESBANK-YESB0000340-13,,,upi,56209.78
61fa3408d8beac15990e63f5,50200023535069,226917.07,60ec41ba55c00300382672d9,HDFC,Revenue-PG-split enabled,5eecc6d6449e4f7cfb1c2708,2021-12-30T00:00:00.000Z,NEFT CR-UTIB0001506-RAZORPAY SOFTWARE PR IVATE LIMITED-SLICK ORGANICS PVT LITD-AX ISCN0114963410,insurance,,net_banking_transfer,77.55
61fa3408d8beac15990e63f7,50200023535069,249050.35,60ec41ba55c00300382672d9,HDFC,Revenue-PG-non-split,5eecc6d6449e4f7cfb1c2708,2021-12-31T00:00:00.000Z,IMPS-136504868540-PAYTM PAYMENTS SERVI-P YTM-XXXXXXXXXX0008-ALL202112312168200003 30830668628,ewallet,,net_banking_transfer,22133.28
61fa3408d8beac15990e63f9,50200023535069,249221.94,60ec41ba55c00300382672d9,HDFC,Revenue-PG-split enabled,5eecc6d6449e4f7cfb1c2708,2021-12-31T00:00:00.000Z,NEFT CR-UTIB0001506-RAZORPAY SOFTWARE PR IVATE LIMITED-SLICK ORGANICS PVT LITD-AX ISCN0115037739,insurance,,net_banking_transfer,171.59
61fa3408d8beac15990e63fb,50200023535069,246745.43,60ec41ba55c00300382672d9,HDFC,bank charges,5eecc6d6449e4f7cfb1c2708,2021-12-31T00:00:00.000Z,.DC INTL POS TXN MARKUP+ST 241221 261221 -CDT2133806861750,,,international_transaction_arbitrage,-2476.51
61fa3408d8beac15990e63fd,50200023535069,245141.89,60ec41ba55c00300382672d9,HDFC,bank charges,5eecc6d6449e4f7cfb1c2708,2021-12-31T00:00:00.000Z,.DC INTL POS TXN MARKUP+ST 241221 261221 -CDT2133806861750,,,international_transaction_arbitrage,-1603.54
61fa3408d8beac15990e63ff,50200023535069,286115.49,60ec41ba55c00300382672d9,HDFC,Revenue-UPI,5eecc6d6449e4f7cfb1c2708,2021-12-31T00:00:00.000Z,UPI-GOKWIK-GOKWIK@YESBANK-YESB0000340-13 6575167924-PAYOUT FOR DECEMBE,,,upi,40973.6
61fa3408d8beac15990e6401,50200023535069,319580.62,60ec41ba55c00300382672d9,HDFC,Revenue-COD,5eecc6d6449e4f7cfb1c2708,2021-12-31T00:00:00.000Z,NEFT CR-ICIC0000155-SHIPROCKET COD CRF I D 3606258-SLICK ORGANICS PVT LTD-CMS2318 832756,insurance,,net_banking_transfer,33465.13
61fa3408d8beac15990e6403,50200023535069,320215.09,60ec41ba55c00300382672d9,HDFC,Revenue-PG-non-split,5eecc6d6449e4f7cfb1c2708,2021-12-31T00:00:00.000Z,NEFT CR-IDFB0010204-SEZZLE PAYMENTS PRIV ATE LIMITED-SLICK ORGANICS PRIVATE LIMIT ED-IDFBH21365141346,insurance,,net_banking_transfer,634.47
61fa3408d8beac15990e6405,50200023535069,320271.32,60ec41ba55c00300382672d9,HDFC,Revenue-PG-split enabled,5eecc6d6449e4f7cfb1c2708,2021-12-31T00:00:00.000Z,NEFT CR-UTIB0001506-RAZORPAY SOFTWARE PR IVATE LIMITED-SLICK ORGANICS PVT LITD-AX ISCN0115213162,insurance,,net_banking_transfer,56.23
61fa3408d8beac15990e6407,50200023535069,260141.99,60ec41ba55c00300382672d9,HDFC,direct expenses,5eecc6d6449e4f7cfb1c2708,2021-12-31T00:00:00.000Z,POS 514834XXXXXX9486 AMZ*MARKETING SV,,,debit_card,-60129.33
61fa3408d8beac15990e6409,50200023535069,273912.32,60ec41ba55c00300382672d9,HDFC,Revenue-PG-non-split,5eecc6d6449e4f7cfb1c2708,2022-01-01T00:00:00.000Z,IMPS-200104277431-PAYTM PAYMENTS SERVI-P YTM-XXXXXXXXXX0008-ALL202201012168200003 30830668628,ewallet,,net_banking_transfer,13770.33
61fa3408d8beac15990e640b,50200023535069,273989.14,60ec41ba55c00300382672d9,HDFC,Revenue-PG-split enabled,5eecc6d6449e4f7cfb1c2708,2022-01-01T00:00:00.000Z,NEFT CR-UTIB0001506-RAZORPAY SOFTWARE PR IVATE LIMITED-SLICK ORGANICS PVT LITD-AX ISCN0115343103,insurance,,net_banking_transfer,76.82
61fa3408d8beac15990e640d,50200023535069,271827.19,60ec41ba55c00300382672d9,HDFC,direct expenses,5eecc6d6449e4f7cfb1c2708,2022-01-01T00:00:00.000Z,POS 514834XXXXXX9486 SEOPTIMER,,,debit_card,-2161.95
61fa3408d8beac15990e640f,50200023535069,321904.68,60ec41ba55c00300382672d9,HDFC,Revenue-UPI,5eecc6d6449e4f7cfb1c2708,2022-01-01T00:00:00.000Z,UPI-GOKWIK-GOKWIK@YESBANK-YESB0000340-20 0177633510-PAYOUT FOR DECEMBE,,,upi,50077.49
61fa3408d8beac15990e6411,50200023535069,322049.48,60ec41ba55c00300382672d9,HDFC,Revenue-PG-split enabled,5eecc6d6449e4f7cfb1c2708,2022-01-01T00:00:00.000Z,NEFT CR-UTIB0001506-RAZORPAY SOFTWARE PR IVATE LIMITED-SLICK ORGANICS PVT LITD-AX ISCN0115520010,insurance,,net_banking_transfer,144.8
61fa3408d8beac15990e6413,50200023535069,339102.87,60ec41ba55c00300382672d9,HDFC,Revenue-PG-non-split,5eecc6d6449e4f7cfb1c2708,2022-01-02T00:00:00.000Z,IMPS-200204751007-PAYTM PAYMENTS SERVI-P YTM-XXXXXXXXXX0008-ALL202201022168200003 30830668628,ewallet,,net_banking_transfer,17053.39
61fa3408d8beac15990e6415,50200023535069,330160.4,60ec41ba55c00300382672d9,HDFC,direct expenses,5eecc6d6449e4f7cfb1c2708,2022-01-02T00:00:00.000Z,POS 514834XXXXXX9486 AMZ*MARKETING SV,,,debit_card,-8942.47
61fa3408d8beac15990e6417,50200023535069,351349.67,60ec41ba55c00300382672d9,HDFC,Revenue-PG-non-split,5eecc6d6449e4f7cfb1c2708,2022-01-03T00:00:00.000Z,IMPS-200304174092-PAYTM PAYMENTS SERVI-P YTM-XXXXXXXXXX0008-ALL202201032168200003 30830668628,ewallet,,net_banking_transfer,21189.27
61fa3408d8beac15990e6419,50200023535069,366750.67,60ec41ba55c00300382672d9,HDFC,Transfer in/Revenue-other,5eecc6d6449e4f7cfb1c2708,2022-01-03T00:00:00.000Z,50200050241205-TPT-ARATA-NAPSA PRIVATE L IMITED,,,net_banking_transfer,15401
61fa3408d8beac15990e641b,50200023535069,377944.43,60ec41ba55c00300382672d9,HDFC,Revenue-Mktplace,5eecc6d6449e4f7cfb1c2708,2022-01-03T00:00:00.000Z,NEFT CR-DEUT0797BGL-FLIPKART INTERNET PR IVATE LIMITED-SLICK ORGANICS PVT LTD-200 300254GN00126,shopping,,net_banking_transfer,11193.76
61fa3408d8beac15990e641d,50200023535069,379486.77,60ec41ba55c00300382672d9,HDFC,Transfer in/Revenue-other,5eecc6d6449e4f7cfb1c2708,2022-01-03T00:00:00.000Z,50200050675669-TPT-REMITTANCE OG DEC21-H OUZ OF NATURE PVT LTD,,,net_banking_transfer,1542.34
61fa3408d8beac15990e641f,50200023535069,879486.77,60ec41ba55c00300382672d9,HDFC,Internal Transfers,5eecc6d6449e4f7cfb1c2708,2022-01-03T00:00:00.000Z,IB FUNDS TRANSFER CR-50200035187206 -SL ICK ORGANICS PVT LTD,insurance,,Other,500000
61fa3408d8beac15990e6421,50200023535069,379486.77,60ec41ba55c00300382672d9,HDFC,direct expenses,5eecc6d6449e4f7cfb1c2708,2022-01-03T00:00:00.000Z,NEFT DR-YESB0000551-VISTTA COSMETICS-NET,,,net_banking_transfer,-500000
61fa3408d8beac15990e6424,50200023535069,264486.77,60ec41ba55c00300382672d9,HDFC,direct expenses,5eecc6d6449e4f7cfb1c2708,2022-01-03T00:00:00.000Z,02711600008220-TPT-615000-VARUN SINGH,,,net_banking_transfer,-615000
61fa3408d8beac15990e6426,50200023535069,295718.96,60ec41ba55c00300382672d9,HDFC,Revenue-UPI,5eecc6d6449e4f7cfb1c2708,2022-01-03T00:00:00.000Z,UPI-GOKWIK-GOKWIK@YESBANK-YESB0000340-20 0380983137-PAYOUT FOR DECEMBE,,,upi,31232.19
61fa3408d8beac15990e6428,50200023535069,164704.96,60ec41ba55c00300382672d9,HDFC,direct expenses,5eecc6d6449e4f7cfb1c2708,2022-01-03T00:00:00.000Z,00921000075586-TPT-131014-ROET BINDRA,,,net_banking_transfer,-131014
61fa3408d8beac15990e642a,50200023535069,147517.96,60ec41ba55c00300382672d9,HDFC,direct expenses,5eecc6d6449e4f7cfb1c2708,2022-01-03T00:00:00.000Z,"NEFT DR-KKBK0000180-VEDIC COSMECEUTICALS PVT LTD-NETBANK, MUM-N003221776519289-1 7187",,,net_banking_transfer,-17187
61fa3408d8beac15990e642c,50200023535069,170176.09,60ec41ba55c00300382672d9,HDFC,Revenue-COD,5eecc6d6449e4f7cfb1c2708,2022-01-03T00:00:00.000Z,NEFT CR-ICIC0000155-SHIPROCKET COD CRF I D 3614472-SLICK ORGANICS PVT LTD-CMS2323 018129,insurance,,net_banking_transfer,22658.13
61fa3408d8beac15990e642e,50200023535069,211821.21,60ec41ba55c00300382672d9,HDFC,Revenue-UPI,5eecc6d6449e4f7cfb1c2708,2022-01-03T00:00:00.000Z,UPI-GOKWIK-GOKWIK@YESBANK-YESB0000340-20 0381294610-PAYOUT FOR JANUARY,,,upi,41645.12
61fa3408d8beac15990e6430,50200023535069,210246.27,60ec41ba55c00300382672d9,HDFC,bank charges,5eecc6d6449e4f7cfb1c2708,2022-01-03T00:00:00.000Z,.DC INTL POS TXN MARKUP+ST 261221 281221 -CDT2200207256855,,,international_transaction_arbitrage,-1574.94
61fa3408d8beac15990e6432,50200023535069,208686.06,60ec41ba55c00300382672d9,HDFC,bank charges,5eecc6d6449e4f7cfb1c2708,2022-01-03T00:00:00.000Z,.DC INTL POS TXN MARKUP+ST 281221 291221 -CDT2200207256855,,,international_transaction_arbitrage,-1560.21
61fa3408d8beac15990e6434,50200023535069,210904.16,60ec41ba55c00300382672d9,HDFC,Revenue-Mktplace,5eecc6d6449e4f7cfb1c2708,2022-01-03T00:00:00.000Z,NEFT CR-ICIC0000105-MANASH LIFESTYLE PRI VATE LIMITED NO-SLICK ORGANICS PRIVATE L IMITED MP G-ICIJ220030003357,shopping,,net_banking_transfer,2218.1
61fa3408d8beac15990e6436,50200023535069,211101.34,60ec41ba55c00300382672d9,HDFC,Revenue-Mktplace,5eecc6d6449e4f7cfb1c2708,2022-01-03T00:00:00.000Z,NEFT CR-ICIC0000105-MANASH LIFESTYLE PRI VATE LIMITED NO-SLICK ORGANICS PRIVATE L IMITED BANG-ICIJ220030003361,shopping,,net_banking_transfer,197.18
61fa3409d8beac15990e6438,50200023535069,211536,60ec41ba55c00300382672d9,HDFC,Revenue-Mktplace,5eecc6d6449e4f7cfb1c2708,2022-01-03T00:00:00.000Z,NEFT CR-ICIC0000105-MANASH LIFESTYLE PRI VATE LIMITED NO-SLICK ORGANICS PRIVATE L IMITED MP M-ICIJ220030003359,shopping,,net_banking_transfer,434.66
61fa3409d8beac15990e643a,50200023535069,212404.33,60ec41ba55c00300382672d9,HDFC,Revenue-PG-non-split,5eecc6d6449e4f7cfb1c2708,2022-01-03T00:00:00.000Z,NEFT CR-YESB0000001-RZPX PVT LTD NODAL A CCOUNT-SLICKORGANICS-N003220940352899,insurance,,salary,868.33
61fa3409d8beac15990e643c,50200023535069,213473.81,60ec41ba55c00300382672d9,HDFC,Revenue-PG-split enabled,5eecc6d6449e4f7cfb1c2708,2022-01-03T00:00:00.000Z,NEFT CR-UTIB0001506-RAZORPAY SOFTWARE PR,,,net_banking_transfer,1069.48
61fa3409d8beac15990e643e,50200023535069,713473.81,60ec41ba55c00300382672d9,HDFC,Internal Transfers,5eecc6d6449e4f7cfb1c2708,2022-01-03T00:00:00.000Z,IB FUNDS TRANSFER CR-50200035187206 -SL ICK ORGANICS PVT LTD,insurance,,Other,500000
61fa3409d8beac15990e6440,50200023535069,513473.81,60ec41ba55c00300382672d9,HDFC,direct expenses,5eecc6d6449e4f7cfb1c2708,2022-01-03T00:00:00.000Z,"NEFT DR-SCBL0036025-DHRUV MADHOK-NETBANK , MUM-N003221777387777-200000",,,net_banking_transfer,-200000
61fa3409d8beac15990e6442,50200023535069,313473.81,60ec41ba55c00300382672d9,HDFC,direct expenses,5eecc6d6449e4f7cfb1c2708,2022-01-03T00:00:00.000Z,02711930004579-TPT-200000-DHRUV BHASIN,,,net_banking_transfer,-200000
61fa3409d8beac15990e6444,50200023535069,288473.81,60ec41ba55c00300382672d9,HDFC,direct expenses,5eecc6d6449e4f7cfb1c2708,2022-01-03T00:00:00.000Z,IMPS-200319148043-DHRUV MADHOK-SCBL-XXXX XXX0749-25000,,,net_banking_transfer,-25000
61fa3409d8beac15990e6446,50200023535069,263473.81,60ec41ba55c00300382672d9,HDFC,direct expenses,5eecc6d6449e4f7cfb1c2708,2022-01-03T00:00:00.000Z,02711930004579-TPT-25000-DHRUV BHASIN,,,net_banking_transfer,-25000
61fa3409d8beac15990e6448,50200023535069,226145.05,60ec41ba55c00300382672d9,HDFC,SAAS/tech expense,5eecc6d6449e4f7cfb1c2708,2022-01-04T00:00:00.000Z,POS 514834XXXXXX9486 AMAZON.COM,shopping,,debit_card,-37328.76
61fa3409d8beac15990e644a,50200023535069,240858.61,60ec41ba55c00300382672d9,HDFC,Revenue-PG-non-split,5eecc6d6449e4f7cfb1c2708,2022-01-04T00:00:00.000Z,IMPS-200404903512-PAYTM PAYMENTS SERVI-P YTM-XXXXXXXXXX0008-ALL202201042168200003 30830668628,ewallet,,net_banking_transfer,14713.56
61fa3409d8beac15990e644c,50200023535069,355469.01,60ec41ba55c00300382672d9,HDFC,Revenue-Mktplace,5eecc6d6449e4f7cfb1c2708,2022-01-04T00:00:00.000Z,IMPS-200405224199-AMAZON SELLER SERVIC-H SBC-XXXXXXXX6004-2DZB5D42DN7FFO1ZSLICK O RGANICS PVT LTD,shopping,,net_banking_transfer,114610.4
61fa3409d8beac15990e644e,50200023535069,677779.16,60ec41ba55c00300382672d9,HDFC,Revenue-Mktplace,5eecc6d6449e4f7cfb1c2708,2022-01-04T00:00:00.000Z,NEFT CR-DEUT0797BGL-AMAZON PAY (INDIA) P RIVATE LIMITED-SLICK ORGANICS PVT LTD-20 0400142GN00315,shopping,,net_banking_transfer,322310.15
61fa3409d8beac15990e6450,50200023535069,677945.07,60ec41ba55c00300382672d9,HDFC,Revenue-PG-split enabled,5eecc6d6449e4f7cfb1c2708,2022-01-04T00:00:00.000Z,NEFT CR-UTIB0001506-RAZORPAY SOFTWARE PR IVATE LIMITED-SLICK ORGANICS PVT LITD-AX ISCN0116037460,insurance,,net_banking_transfer,165.91
61fa3409d8beac15990e6452,50200023535069,671311.07,60ec41ba55c00300382672d9,HDFC,Salary/Emp/consultant Expense,5eecc6d6449e4f7cfb1c2708,2022-01-04T00:00:00.000Z,1672396626/EPFO,,,Other,-6634
61fa3409d8beac15990e6454,50200023535069,666649.07,60ec41ba55c00300382672d9,HDFC,direct expenses,5eecc6d6449e4f7cfb1c2708,2022-01-04T00:00:00.000Z,02022100123973/ESIC,,,Other,-4662
61fa3409d8beac15990e6456,50200023535069,588491.43,60ec41ba55c00300382672d9,HDFC,direct expenses,5eecc6d6449e4f7cfb1c2708,2022-01-04T00:00:00.000Z,POS 514834XXXXXX9486 PAYPAL *ENVIRONM,,,debit_card,-78157.64
61fa3409d8beac15990e6458,50200023535069,471254.97,60ec41ba55c00300382672d9,HDFC,direct expenses,5eecc6d6449e4f7cfb1c2708,2022-01-04T00:00:00.000Z,POS 514834XXXXXX9486 PAYPAL *ENVIRONM,,,debit_card,-117236.46
61fa3409d8beac15990e645a,50200023535069,471748.29,60ec41ba55c00300382672d9,HDFC,Revenue-PG-non-split,5eecc6d6449e4f7cfb1c2708,2022-01-04T00:00:00.000Z,NEFT CR-IDFB0010204-SEZZLE PAYMENTS PRIV ATE LIMITED-SLICK ORGANICS PRIVATE LIMIT ED-IDFBH22004384180,insurance,,net_banking_transfer,493.32
61fa3409d8beac15990e645c,50200023535069,472729.99,60ec41ba55c00300382672d9,HDFC,Revenue-PG-non-split,5eecc6d6449e4f7cfb1c2708,2022-01-04T00:00:00.000Z,NEFT CR-IDFB0010204-SEZZLE PAYMENTS PRIV ATE LIMITED-SLICK ORGANICS PRIVATE LIMIT ED-IDFBH22004384292,insurance,,net_banking_transfer,981.7
61fa3409d8beac15990e645e,50200023535069,476315.07,60ec41ba55c00300382672d9,HDFC,Revenue-PG-non-split,5eecc6d6449e4f7cfb1c2708,2022-01-04T00:00:00.000Z,NEFT CR-SCBL0036001-STRIPE INDIA PRIVATE,,,net_banking_transfer,3585.08
61fa3409d8beac15990e6460,50200023535069,477292.6,60ec41ba55c00300382672d9,HDFC,Revenue-PG-split enabled,5eecc6d6449e4f7cfb1c2708,2022-01-04T00:00:00.000Z,NEFT CR-UTIB0001506-RAZORPAY SOFTWARE PR IVATE LIMITED-SLICK ORGANICS PVT LITD-AX ISCN0116273076,insurance,,net_banking_transfer,977.53
61fa3409d8beac15990e6462,50200023535069,522230.58,60ec41ba55c00300382672d9,HDFC,Revenue-UPI,5eecc6d6449e4f7cfb1c2708,2022-01-04T00:00:00.000Z,UPI-GOKWIK-GOKWIK@YESBANK-YESB0000340-20 0483384524-PAYOUT FOR JANUARY,,,upi,44937.98
61fa3409d8beac15990e6464,50200023535069,465574.58,60ec41ba55c00300382672d9,HDFC,direct expenses,5eecc6d6449e4f7cfb1c2708,2022-01-04T00:00:00.000Z,50200029847721-TPT-56656-SPITI CONSULTIN G,,,net_banking_transfer,-56656
61fa3409d8beac15990e6466,50200023535069,404509.58,60ec41ba55c00300382672d9,HDFC,direct expenses,5eecc6d6449e4f7cfb1c2708,2022-01-04T00:00:00.000Z,"NEFT DR-ICIC0006643-KRISHNA PACKAGING CO MPANY-NETBANK, MUM-N004221779476290-6106 5",,,net_banking_transfer,-61065
61fa3409d8beac15990e6468,50200023535069,422779.51,60ec41ba55c00300382672d9,HDFC,Revenue-PG-non-split,5eecc6d6449e4f7cfb1c2708,2022-01-05T00:00:00.000Z,IMPS-200504462723-PAYTM PAYMENTS SERVI-P YTM-XXXXXXXXXX0008-ALL202201052168200003 30830668628,ewallet,,net_banking_transfer,18269.93
61fa3409d8beac15990e646a,50200023535069,432721.43,60ec41ba55c00300382672d9,HDFC,Revenue-Mktplace,5eecc6d6449e4f7cfb1c2708,2022-01-05T00:00:00.000Z,NEFT CR-DEUT0797BGL-FLIPKART INTERNET PR IVATE LIMITED-SLICK ORGANICS PVT LTD-200 501579GN00276,shopping,,net_banking_transfer,9941.92
61fa3409d8beac15990e646c,50200023535069,433187.53,60ec41ba55c00300382672d9,HDFC,Revenue-PG-split enabled,5eecc6d6449e4f7cfb1c2708,2022-01-05T00:00:00.000Z,NEFT CR-UTIB0001506-RAZORPAY SOFTWARE PR IVATE LIMITED-SLICK ORGANICS PVT LITD-AX ISCN0116372147,insurance,,net_banking_transfer,466.1
61fa3409d8beac15990e646e,50200023535069,434771.23,60ec41ba55c00300382672d9,HDFC,Revenue-Mktplace,5eecc6d6449e4f7cfb1c2708,2022-01-05T00:00:00.000Z,NEFT CR-DEUT0797BGL-MYNTRA DESIGNS PRIVA TE LIMITED-SLICK ORGANICS PRIVATE LIMITE D-200502014GN00049,shopping,,net_banking_transfer,1583.7
61fa3409d8beac15990e6470,50200023535069,218771.23,60ec41ba55c00300382672d9,HDFC,direct expenses,5eecc6d6449e4f7cfb1c2708,2022-01-05T00:00:00.000Z,"NEFT DR-UTIB0000514-NATS ASSOCIATES-NETB ANK, MUM-N005221780300148-216000",,,net_banking_transfer,-216000
61fa3409d8beac15990e6472,50200023535069,1718771.23,60ec41ba55c00300382672d9,HDFC,Internal Transfers,5eecc6d6449e4f7cfb1c2708,2022-01-05T00:00:00.000Z,IB FUNDS TRANSFER CR-50200035187206 -SL ICK ORGANICS PVT LTD,insurance,,Other,1500000
61fa3409d8beac15990e6474,50200023535069,169099.23,60ec41ba55c00300382672d9,HDFC,direct expenses,5eecc6d6449e4f7cfb1c2708,2022-01-05T00:00:00.000Z,"NEFT DR-UTIB0000740-SUPARI STUDIOS-NETBA NK, MUM-N005221780320086-1549672",,,net_banking_transfer,-1549672
61fa3409d8beac15990e6476,50200023535069,210341.89,60ec41ba55c00300382672d9,HDFC,Revenue-Mktplace,5eecc6d6449e4f7cfb1c2708,2022-01-05T00:00:00.000Z,NEFT CR-HSBC0400002-AMAZON SERVICES LLC-,shopping,,net_banking_transfer,41242.66
61fa3409d8beac15990e6478,50200023535069,160341.89,60ec41ba55c00300382672d9,HDFC,direct expenses,5eecc6d6449e4f7cfb1c2708,2022-01-05T00:00:00.000Z,"NEFT DR-UTIB0001964-BLUE BELLS EVENTS AN D PROMOTIONS-NETBANK, MUM-N0052217803802 21-50000",,,net_banking_transfer,-50000
61fa3409d8beac15990e647a,50200023535069,203202.97,60ec41ba55c00300382672d9,HDFC,Revenue-UPI,5eecc6d6449e4f7cfb1c2708,2022-01-05T00:00:00.000Z,UPI-GOKWIK-GOKWIK@YESBANK-YESB0000340-20 0585060924-PAYOUT FOR JANUARY,,,upi,42861.08
61fa3409d8beac15990e647c,50200023535069,203204.97,60ec41ba55c00300382672d9,HDFC,Transfer in/Revenue-other,5eecc6d6449e4f7cfb1c2708,2022-01-05T00:00:00.000Z,POS REF 514834******9486-01/05 GOOGLESER,,,refund,2
61fa3409d8beac15990e647e,50200023535069,263456.73,60ec41ba55c00300382672d9,HDFC,Revenue-COD,5eecc6d6449e4f7cfb1c2708,2022-01-05T00:00:00.000Z,NEFT CR-ICIC0000155-SHIPROCKET COD CRF I D 3626826-SLICK ORGANICS PVT LTD-CMS2326 775839,insurance,,net_banking_transfer,60251.76
61fa3409d8beac15990e6480,50200023535069,285069.73,60ec41ba55c00300382672d9,HDFC,Revenue-Mktplace,5eecc6d6449e4f7cfb1c2708,2022-01-05T00:00:00.000Z,NEFT CR-SCBL0036001-M/S DREAMPLUG TECHNO -SLICK ORGANICS PRIVATE LIMITEDSLICK-SIN 31436Q0029527,insurance,,net_banking_transfer,21613
61fa3409d8beac15990e6482,50200023535069,285107.62,60ec41ba55c00300382672d9,HDFC,Revenue-PG-split enabled,5eecc6d6449e4f7cfb1c2708,2022-01-05T00:00:00.000Z,NEFT CR-UTIB0001506-RAZORPAY SOFTWARE PR IVATE LIMITED-SLICK ORGANICS PVT LITD-AX ISCN0116511580,insurance,,net_banking_transfer,37.89
61fa3409d8beac15990e6484,50200023535069,291564.64,60ec41ba55c00300382672d9,HDFC,Revenue-PG-non-split,5eecc6d6449e4f7cfb1c2708,2022-01-06T00:00:00.000Z,IMPS-200604865826-PAYTM PAYMENTS SERVI-P YTM-XXXXXXXXXX0008-ALL202201062168200003 30830668628,ewallet,,net_banking_transfer,6457.02
61fa3409d8beac15990e6486,50200023535069,292137.67,60ec41ba55c00300382672d9,HDFC,Revenue-PG-split enabled,5eecc6d6449e4f7cfb1c2708,2022-01-06T00:00:00.000Z,NEFT CR-UTIB0001506-RAZORPAY SOFTWARE PR IVATE LIMITED-SLICK ORGANICS PVT LITD-AX ISCN0116627985,insurance,,net_banking_transfer,573.03
61fa3409d8beac15990e6488,50200023535069,282452.67,60ec41ba55c00300382672d9,HDFC,direct expenses,5eecc6d6449e4f7cfb1c2708,2022-01-06T00:00:00.000Z,"NEFT DR-SBIN0008078-PANDIT PLASTICS-NETB ANK, MUM-N006221781920637-9685",,,net_banking_transfer,-9685
61fa3409d8beac15990e648a,50200023535069,1282452.67,60ec41ba55c00300382672d9,HDFC,Internal Transfers,5eecc6d6449e4f7cfb1c2708,2022-01-06T00:00:00.000Z,IB FUNDS TRANSFER CR-50200035187206 -SL ICK ORGANICS PVT LTD,insurance,,Other,1000000
61fa3409d8beac15990e648c,50200023535069,282452.67,60ec41ba55c00300382672d9,HDFC,Marketing Expense,5eecc6d6449e4f7cfb1c2708,2022-01-06T00:00:00.000Z,"NEFT DR-CITI0000006-FACEBOOK INDIA ONLIN E SERVICES PVT LTD-NETBANK, MUM-N0062217 81938283-1000000",,,net_banking_transfer,-1000000
61fa3409d8beac15990e648e,50200023535069,782452.67,60ec41ba55c00300382672d9,HDFC,Internal Transfers,5eecc6d6449e4f7cfb1c2708,2022-01-06T00:00:00.000Z,IB FUNDS TRANSFER CR-50200035187206 -SL ICK ORGANICS PVT LTD,insurance,,Other,500000
61fa3409d8beac15990e6490,50200023535069,527452.67,60ec41ba55c00300382672d9,HDFC,SAAS/tech expense,5eecc6d6449e4f7cfb1c2708,2022-01-06T00:00:00.000Z,KQSXQ54PAN42FOWXCE/PAYUAMAZON,shopping,,Other,-255000
61fa3409d8beac15990e6492,50200023535069,477452.67,60ec41ba55c00300382672d9,HDFC,direct expenses,5eecc6d6449e4f7cfb1c2708,2022-01-06T00:00:00.000Z,POS 514834XXXXXX9486 FLIPKART,shopping,,debit_card,-50000
61fa3409d8beac15990e6494,50200023535069,418452.67,60ec41ba55c00300382672d9,HDFC,direct expenses,5eecc6d6449e4f7cfb1c2708,2022-01-06T00:00:00.000Z,POS 514834XXXXXX9486 RAZ*PURPLLE,,,debit_card,-59000
61fa3409d8beac15990e6496,50200023535069,419692.91,60ec41ba55c00300382672d9,HDFC,Revenue-PG-non-split,5eecc6d6449e4f7cfb1c2708,2022-01-06T00:00:00.000Z,NEFT CR-IDFB0010204-SEZZLE PAYMENTS PRIV ATE LIMITED-SLICK ORGANICS PRIVATE LIMIT ED-IDFBH22006541091,insurance,,net_banking_transfer,1240.24
61fa3409d8beac15990e6498,50200023535069,481908.04,60ec41ba55c00300382672d9,HDFC,Revenue-UPI,5eecc6d6449e4f7cfb1c2708,2022-01-06T00:00:00.000Z,UPI-GOKWIK-GOKWIK@YESBANK-YESB0000340-20 0687155352-PAYOUT FOR JANUARY,,,upi,62215.13
61fa3409d8beac15990e649a,50200023535069,482206.24,60ec41ba55c00300382672d9,HDFC,Revenue-PG-split enabled,5eecc6d6449e4f7cfb1c2708,2022-01-06T00:00:00.000Z,NEFT CR-UTIB0001506-RAZORPAY SOFTWARE PR IVATE LIMITED-SLICK ORGANICS PVT LITD-AX ISCN0116766698,insurance,,net_banking_transfer,298.2
61fa3409d8beac15990e649c,50200023535069,489910.91,60ec41ba55c00300382672d9,HDFC,Revenue-PG-non-split,5eecc6d6449e4f7cfb1c2708,2022-01-07T00:00:00.000Z,IMPS-200704560577-PAYTM PAYMENTS SERVI-P YTM-XXXXXXXXXX0008-ALL202201072168200003 30830668628,ewallet,,net_banking_transfer,7704.67
61fa3409d8beac15990e649e,50200023535069,501640.39,60ec41ba55c00300382672d9,HDFC,Revenue-Mktplace,5eecc6d6449e4f7cfb1c2708,2022-01-07T00:00:00.000Z,NEFT CR-DEUT0797BGL-FLIPKART INTERNET PR IVATE LIMITED-SLICK ORGANICS PVT LTD-200 700241GN00272,shopping,,net_banking_transfer,11729.48
61fa3409d8beac15990e64a0,50200023535069,521551.54,60ec41ba55c00300382672d9,HDFC,Revenue-Mktplace,5eecc6d6449e4f7cfb1c2708,2022-01-07T00:00:00.000Z,NEFT CR-DEUT0797BGL-FLIPKART INTERNET PR IVATE LIMITED-SLICK ORGANICS PVT LTD-200 700329GN00194,shopping,,net_banking_transfer,19911.15
61fa3409d8beac15990e64a2,50200023535069,409051.54,60ec41ba55c00300382672d9,HDFC,direct expenses,5eecc6d6449e4f7cfb1c2708,2022-01-07T00:00:00.000Z,50100093802387-TPT-112500-ISSHANA MAHAJA N,,,net_banking_transfer,-112500
61fa3409d8beac15990e64a4,50200023535069,318471.54,60ec41ba55c00300382672d9,HDFC,direct expenses,5eecc6d6449e4f7cfb1c2708,2022-01-07T00:00:00.000Z,"NEFT DR-ICIC0000542-AVANTIKA SUKHIA-NETB ANK, MUM-N007221783472458-90580",,,net_banking_transfer,-90580
61fa3409d8beac15990e64a6,50200023535069,262971.54,60ec41ba55c00300382672d9,HDFC,direct expenses,5eecc6d6449e4f7cfb1c2708,2022-01-07T00:00:00.000Z,50100293329616-TPT-55500-SADIYA BANO,,,net_banking_transfer,-55500
61fa3409d8beac15990e64a8,50200023535069,212971.54,60ec41ba55c00300382672d9,HDFC,direct expenses,5eecc6d6449e4f7cfb1c2708,2022-01-07T00:00:00.000Z,"NEFT DR-UTIB0000120-ADNAN ALI-NETBANK, M UM-N007221783481030-50000",,,net_banking_transfer,-50000
61fa3409d8beac15990e64aa,50200023535069,162971.54,60ec41ba55c00300382672d9,HDFC,direct expenses,5eecc6d6449e4f7cfb1c2708,2022-01-07T00:00:00.000Z,"NEFT DR-ICIC0003851-JITENDER KUMAR-NETBA NK, MUM-N007221783485769-50000",,,net_banking_transfer,-50000
61fa3409d8beac15990e64ac,50200023535069,126971.54,60ec41ba55c00300382672d9,HDFC,direct expenses,5eecc6d6449e4f7cfb1c2708,2022-01-07T00:00:00.000Z,00901610080520-TPT-36000-POOJA KAPIL SHR OTRIYA,,,net_banking_transfer,-36000
61fa3409d8beac15990e64ae,50200023535069,76971.54,60ec41ba55c00300382672d9,HDFC,direct expenses,5eecc6d6449e4f7cfb1c2708,2022-01-07T00:00:00.000Z,50100064106714-TPT-50000-AKSHARANSH BHAT,,,net_banking_transfer,-50000
61fa3409d8beac15990e64b0,50200023535069,55471.54,60ec41ba55c00300382672d9,HDFC,direct expenses,5eecc6d6449e4f7cfb1c2708,2022-01-07T00:00:00.000Z,"NEFT DR-SIBL0000555-JAIVEER KUMAR-NETBAN K, MUM-N007221783476201-21500",,,net_banking_transfer,-21500
61fa3409d8beac15990e64b2,50200023535069,33971.54,60ec41ba55c00300382672d9,HDFC,direct expenses,5eecc6d6449e4f7cfb1c2708,2022-01-07T00:00:00.000Z,"NEFT DR-PUNB0307800-PRAKASH JHA-NETBANK, MUM-N007221783476267-21500",,,net_banking_transfer,-21500
61fa3409d8beac15990e64b4,50200023535069,12471.54,60ec41ba55c00300382672d9,HDFC,direct expenses,5eecc6d6449e4f7cfb1c2708,2022-01-07T00:00:00.000Z,"NEFT DR-PUNB0482100-RAM BHAVAN YADAV-NET BANK, MUM-N007221783476433-21500",,,net_banking_transfer,-21500
61fa3409d8beac15990e64b6,50200023535069,1512471.54,60ec41ba55c00300382672d9,HDFC,Internal Transfers,5eecc6d6449e4f7cfb1c2708,2022-01-07T00:00:00.000Z,IB FUNDS TRANSFER CR-50200035187206 -SL ICK ORGANICS PVT LTD,insurance,,Other,1500000
61fa3409d8beac15990e64b8,50200023535069,1494606.54,60ec41ba55c00300382672d9,HDFC,direct expenses,5eecc6d6449e4f7cfb1c2708,2022-01-07T00:00:00.000Z,"NEFT DR-KKBK0005032-DEEPAK YADAV-NETBANK , MUM-N007221783473950-17865",,,net_banking_transfer,-17865
61fa3409d8beac15990e64ba,50200023535069,1478627.54,60ec41ba55c00300382672d9,HDFC,direct expenses,5eecc6d6449e4f7cfb1c2708,2022-01-07T00:00:00.000Z,"NEFT DR-PUNB0151400-BHUWAN CHANDER JOSHI -NETBANK, MUM-N007221783474059-15979",,,net_banking_transfer,-15979
61fa3409d8beac15990e64bc,50200023535069,1462648.54,60ec41ba55c00300382672d9,HDFC,direct expenses,5eecc6d6449e4f7cfb1c2708,2022-01-07T00:00:00.000Z,02711600008220-TPT-15979-VARUN SINGH,,,net_banking_transfer,-15979
61fa3409d8beac15990e64be,50200023535069,1448021.54,60ec41ba55c00300382672d9,HDFC,direct expenses,5eecc6d6449e4f7cfb1c2708,2022-01-07T00:00:00.000Z,"NEFT DR-PUNB0307800-SANJEEV NIRMANIA-NET BANK, MUM-N007221783474253-14627",,,net_banking_transfer,-14627
61fa3409d8beac15990e64c0,50200023535069,1431668.54,60ec41ba55c00300382672d9,HDFC,N-ACH payments,5eecc6d6449e4f7cfb1c2708,2022-01-07T00:00:00.000Z,"NEFT DR-DBSS0IN0811-SACHIN SINGH-NETBANK , MUM-N007221783474411-16353",,,net_banking_transfer,-16353
61fa3409d8beac15990e64c2,50200023535069,1415689.54,60ec41ba55c00300382672d9,HDFC,direct expenses,5eecc6d6449e4f7cfb1c2708,2022-01-07T00:00:00.000Z,"NEFT DR-BARB0DINARA-MD ARIF RAZA-NETBANK , MUM-N007221783474921-15979",,,net_banking_transfer,-15979
61fa3409d8beac15990e64c4,50200023535069,1415722.44,60ec41ba55c00300382672d9,HDFC,Revenue-PG-split enabled,5eecc6d6449e4f7cfb1c2708,2022-01-07T00:00:00.000Z,NEFT CR-UTIB0001506-RAZORPAY SOFTWARE PR IVATE LIMITED-SLICK ORGANICS PVT LITD-AX ISCN0116865807,insurance,,net_banking_transfer,32.9
61fa3409d8beac15990e64c6,50200023535069,1251922.44,60ec41ba55c00300382672d9,HDFC,direct expenses,5eecc6d6449e4f7cfb1c2708,2022-01-07T00:00:00.000Z,"NEFT DR-BARB0VJMATU-ARTISTO DESIGNZ-NETB ANK, MUM-N007221783537739-163800",,,net_banking_transfer,-163800
61fa3409d8beac15990e64c8,50200023535069,1197144.44,60ec41ba55c00300382672d9,HDFC,direct expenses,5eecc6d6449e4f7cfb1c2708,2022-01-07T00:00:00.000Z,"NEFT DR-KKBK0000187-APPLIED LIFE PRIVATE LIMITED-NETBANK, MUM-N007221783533688-5 4778",,,net_banking_transfer,-54778
61fa3409d8beac15990e64ca,50200023535069,1086984.44,60ec41ba55c00300382672d9,HDFC,direct expenses,5eecc6d6449e4f7cfb1c2708,2022-01-07T00:00:00.000Z,"NEFT DR-DBSS0IN0811-SARANSH KULKARNI-NET BANK, MUM-N007221783524740-110160",,,net_banking_transfer,-110160
61fa3409d8beac15990e64cc,50200023535069,931901.44,60ec41ba55c00300382672d9,HDFC,direct expenses,5eecc6d6449e4f7cfb1c2708,2022-01-07T00:00:00.000Z,"NEFT DR-PUNB0642000-UFLEX LIMITED-NETBAN K, MUM-N007221783534934-155083",loans,lender_transaction,net_banking_transfer,-155083
61fa3409d8beac15990e64ce,50200023535069,1431901.44,60ec41ba55c00300382672d9,HDFC,Internal Transfers,5eecc6d6449e4f7cfb1c2708,2022-01-07T00:00:00.000Z,IB FUNDS TRANSFER CR-50200035187206 -SL,,,Other,500000
61fa3409d8beac15990e64d0,50200023535069,294169.44,60ec41ba55c00300382672d9,HDFC,direct expenses,5eecc6d6449e4f7cfb1c2708,2022-01-07T00:00:00.000Z,"NEFT DR-KKBK0000180-VEDIC COSMECEUTICALS PVT LTD-NETBANK, MUM-N007221783545868-1 137732",,,net_banking_transfer,-1137732
61fa3409d8beac15990e64d2,50200023535069,231169.44,60ec41ba55c00300382672d9,HDFC,direct expenses,5eecc6d6449e4f7cfb1c2708,2022-01-07T00:00:00.000Z,"NEFT DR-UBIN0531855-MOHANISH KOTHARI-NET BANK, MUM-N007221783563818-63000",,,net_banking_transfer,-63000
61fa3409d8beac15990e64d4,50200023535069,225769.44,60ec41ba55c00300382672d9,HDFC,direct expenses,5eecc6d6449e4f7cfb1c2708,2022-01-07T00:00:00.000Z,"NEFT DR-KKBK0000654-NIHARIKA MISHRA-NETB ANK, MUM-N007221783567847-5400",,,net_banking_transfer,-5400
61fa3409d8beac15990e64d6,50200023535069,174469.44,60ec41ba55c00300382672d9,HDFC,direct expenses,5eecc6d6449e4f7cfb1c2708,2022-01-07T00:00:00.000Z,"NEFT DR-KKBK0000654-NIHARIKA MISHRA-NETB ANK, MUM-N007221783564653-51300",,,net_banking_transfer,-51300
61fa3409d8beac15990e64d8,50200023535069,144143.44,60ec41ba55c00300382672d9,HDFC,direct expenses,5eecc6d6449e4f7cfb1c2708,2022-01-07T00:00:00.000Z,"NEFT DR-CITI0000002-OMG NETWORK INDIA PR IVATE LIMITED-NETBANK, MUM-N007221783575 763-30326",,,net_banking_transfer,-30326
61fa3409d8beac15990e64da,50200023535069,644143.44,60ec41ba55c00300382672d9,HDFC,Internal Transfers,5eecc6d6449e4f7cfb1c2708,2022-01-07T00:00:00.000Z,IB FUNDS TRANSFER CR-50200035187206 -SL ICK ORGANICS PVT LTD,insurance,,Other,500000
61fa3409d8beac15990e64dc,50200023535069,536143.44,60ec41ba55c00300382672d9,HDFC,direct expenses,5eecc6d6449e4f7cfb1c2708,2022-01-07T00:00:00.000Z,"NEFT DR-SCBL0036031-PR PUNDIT PUBLIC REL ATIONS PRIVATE LIMIT-NETBANK, MUM-N00722 1783694562-108000",insurance,,net_banking_transfer,-108000
61fa3409d8beac15990e64de,50200023535069,516143.44,60ec41ba55c00300382672d9,HDFC,direct expenses,5eecc6d6449e4f7cfb1c2708,2022-01-07T00:00:00.000Z,"SELF - CHQ PAID - KALKAJI, NEW",,,chq,-20000
61fa3409d8beac15990e64e0,50200023535069,26265.44,60ec41ba55c00300382672d9,HDFC,N-ACH payments,5eecc6d6449e4f7cfb1c2708,2022-01-07T00:00:00.000Z,ACH D- CTRAZORPAY-GETVANTAGEIGO5UVQ06OZK,loans,lender_transaction,auto_debit_payment,-489878
61fa3409d8beac15990e64e2,50200023535069,526265.44,60ec41ba55c00300382672d9,HDFC,Internal Transfers,5eecc6d6449e4f7cfb1c2708,2022-01-07T00:00:00.000Z,IB FUNDS TRANSFER CR-50200035187206 -SL ICK ORGANICS PVT LTD,insurance,,Other,500000
61fa3409d8beac15990e64e4,50200023535069,504765.44,60ec41ba55c00300382672d9,HDFC,direct expenses,5eecc6d6449e4f7cfb1c2708,2022-01-07T00:00:00.000Z,"NEFT DR-BARB0VJGRKA-OM PRASAD PANDEY-NET BANK, MUM-N007221783754122-21500",,,net_banking_transfer,-21500
61fa3409d8beac15990e64e6,50200023535069,398654.44,60ec41ba55c00300382672d9,HDFC,direct expenses,5eecc6d6449e4f7cfb1c2708,2022-01-07T00:00:00.000Z,"NEFT DR-ICIC0000021-AKHILESH DIXIT-NETBA NK, MUM-N007221783765377-106111",,,net_banking_transfer,-106111
61fa3409d8beac15990e64e8,50200023535069,395124.44,60ec41ba55c00300382672d9,HDFC,direct expenses,5eecc6d6449e4f7cfb1c2708,2022-01-07T00:00:00.000Z,50100093802387-TPT-3530-ISSHANA MAHAJAN,,,net_banking_transfer,-3530
61fa3409d8beac15990e64ea,50200023535069,400253.44,60ec41ba55c00300382672d9,HDFC,Transfer in/Revenue-other,5eecc6d6449e4f7cfb1c2708,2022-01-07T00:00:00.000Z,NEFT CR-KKBK0000958-INNOVATIVE RETAIL CO NCEPTS PRIVATE LTD-SLICK ORGANICS PVT LT D-KKBK220079212695,,,net_banking_transfer,5129
61fa3409d8beac15990e64ec,50200023535069,408496.44,60ec41ba55c00300382672d9,HDFC,Transfer in/Revenue-other,5eecc6d6449e4f7cfb1c2708,2022-01-07T00:00:00.000Z,NEFT CR-KKBK0000958-INNOVATIVE RETAIL CO,,,net_banking_transfer,8243
61fa3409d8beac15990e64ee,50200023535069,423989.44,60ec41ba55c00300382672d9,HDFC,Transfer in/Revenue-other,5eecc6d6449e4f7cfb1c2708,2022-01-07T00:00:00.000Z,NEFT CR-KKBK0000958-INNOVATIVE RETAIL CO NCEPTS PRIVATE LTD-SLICK ORGANICS PVT LT D-KKBK220079214042,,,net_banking_transfer,15493
61fa3409d8beac15990e64f0,50200023535069,267389.44,60ec41ba55c00300382672d9,HDFC,direct expenses,5eecc6d6449e4f7cfb1c2708,2022-01-07T00:00:00.000Z,"NEFT DR-KKBK0005289-HILL GROOVE CONSULTI NG LLP-NETBANK, MUM-N007221784042812-156 600",,,net_banking_transfer,-156600
61fa3409d8beac15990e64f2,50200023535069,158042.44,60ec41ba55c00300382672d9,HDFC,direct expenses,5eecc6d6449e4f7cfb1c2708,2022-01-07T00:00:00.000Z,02711600008220-TPT-109347-VARUN SINGH,,,net_banking_transfer,-109347
61fa3409d8beac15990e64f4,50200023535069,658042.44,60ec41ba55c00300382672d9,HDFC,Internal Transfers,5eecc6d6449e4f7cfb1c2708,2022-01-07T00:00:00.000Z,IB FUNDS TRANSFER CR-50200035187206 -SL ICK ORGANICS PVT LTD,insurance,,Other,500000
61fa3409d8beac15990e64f6,50200023535069,558042.44,60ec41ba55c00300382672d9,HDFC,direct expenses,5eecc6d6449e4f7cfb1c2708,2022-01-07T00:00:00.000Z,"NEFT DR-SCBL0036025-DHRUV MADHOK-NETBANK , MUM-N007221784165580-100000",,,net_banking_transfer,-100000
61fa3409d8beac15990e64f8,50200023535069,358042.44,60ec41ba55c00300382672d9,HDFC,direct expenses,5eecc6d6449e4f7cfb1c2708,2022-01-07T00:00:00.000Z,02711930004579-TPT-200000-DHRUV BHASIN,,,net_banking_transfer,-200000
61fa3409d8beac15990e64fa,50200023535069,382530.61,60ec41ba55c00300382672d9,HDFC,Revenue-UPI,5eecc6d6449e4f7cfb1c2708,2022-01-07T00:00:00.000Z,UPI-GOKWIK-GOKWIK@YESBANK-YESB0000340-20 0788913161-PAYOUT FOR JANUARY,,,upi,24488.17
61fa3409d8beac15990e64fc,50200023535069,382531.61,60ec41ba55c00300382672d9,HDFC,Revenue-Mktplace,5eecc6d6449e4f7cfb1c2708,2022-01-07T00:00:00.000Z,NEFT CR-DEUT0797BGL-MYNTRA DESIGNS PRIVA TE LIMITED-SLICK ORGANICS PVT. LTD.-2007 01151GN00009,shopping,,net_banking_transfer,1
61fa3409d8beac15990e64fe,50200023535069,408925.88,60ec41ba55c00300382672d9,HDFC,Revenue-COD,5eecc6d6449e4f7cfb1c2708,2022-01-07T00:00:00.000Z,NEFT CR-ICIC0000155-SHIPROCKET COD CRF I D 3639033-SLICK ORGANICS PVT LTD-CMS2330 899090,insurance,,net_banking_transfer,26394.27
61fa3409d8beac15990e6500,50200023535069,409313,60ec41ba55c00300382672d9,HDFC,Revenue-Mktplace,5eecc6d6449e4f7cfb1c2708,2022-01-07T00:00:00.000Z,NEFT CR-DEUT0784BBY-TATA UNISTORE LIMITE D-SLICK ORGANICS PVT LTD-200702964GN0025 4,insurance,,net_banking_transfer,387.12
61fa3409d8beac15990e6502,50200023535069,409372.05,60ec41ba55c00300382672d9,HDFC,Revenue-PG-split enabled,5eecc6d6449e4f7cfb1c2708,2022-01-07T00:00:00.000Z,NEFT CR-UTIB0001506-RAZORPAY SOFTWARE PR IVATE LIMITED-SLICK ORGANICS PVT LITD-AX ISCN0117004999,insurance,,net_banking_transfer,59.05
61fa340ad8beac15990e6504,50200023535069,410851.05,60ec41ba55c00300382672d9,HDFC,Revenue-COD,5eecc6d6449e4f7cfb1c2708,2022-01-07T00:00:00.000Z,NEFT CR-KKBK0000958-PICKRR TECHNOLOGIES PVT LTD-SLICKORGANICSPRIVATELIMITED-CMS0 072205663089,insurance,,net_banking_transfer,1479
61fa340ad8beac15990e6506,50200023535069,420409.09,60ec41ba55c00300382672d9,HDFC,Revenue-PG-non-split,5eecc6d6449e4f7cfb1c2708,2022-01-08T00:00:00.000Z,IMPS-200804096790-PAYTM PAYMENTS SERVI-P,ewallet,,net_banking_transfer,9558.04
61fa340ad8beac15990e6508,50200023535069,404430.09,60ec41ba55c00300382672d9,HDFC,direct expenses,5eecc6d6449e4f7cfb1c2708,2022-01-08T00:00:00.000Z,"NEFT DR-PUNB0494300-KUNDAN PRASAD-NETBAN K, MUM-N008221785605940-15979",,,net_banking_transfer,-15979
61fa340ad8beac15990e650a,50200023535069,354430.09,60ec41ba55c00300382672d9,HDFC,direct expenses,5eecc6d6449e4f7cfb1c2708,2022-01-08T00:00:00.000Z,"NEFT DR-PUNB0062910-YADAVPACKAGING-NETBA NK, MUM-N008221785590235-50000",,,net_banking_transfer,-50000
61fa340ad8beac15990e650c,50200023535069,305830.09,60ec41ba55c00300382672d9,HDFC,direct expenses,5eecc6d6449e4f7cfb1c2708,2022-01-08T00:00:00.000Z,"NEFT DR-CNRB0015170-SNEHAL TAYDE-NETBANK , MUM-N008221785754627-48600",,,net_banking_transfer,-48600
61fa340ad8beac15990e650e,50200023535069,341594.97,60ec41ba55c00300382672d9,HDFC,Revenue-UPI,5eecc6d6449e4f7cfb1c2708,2022-01-08T00:00:00.000Z,UPI-GOKWIK-GOKWIK@YESBANK-YESB0000340-20 0890893239-PAYOUT FOR JANUARY,,,upi,35764.88
61fa340ad8beac15990e6510,50200023535069,326594.97,60ec41ba55c00300382672d9,HDFC,direct expenses,5eecc6d6449e4f7cfb1c2708,2022-01-08T00:00:00.000Z,"NEFT DR-UBIN0532525-SHABBIR ALI-NETBANK, MUM-N008221786214859-15000",,,net_banking_transfer,-15000
61fa340ad8beac15990e6512,50200023535069,311594.97,60ec41ba55c00300382672d9,HDFC,direct expenses,5eecc6d6449e4f7cfb1c2708,2022-01-08T00:00:00.000Z,"NEFT DR-SBIN0013721-SHIVKUMAR UTTARWAR-N ETBANK, MUM-N008221786221461-15000",,,net_banking_transfer,-15000
61fa340ad8beac15990e6514,50200023535069,203594.97,60ec41ba55c00300382672d9,HDFC,direct expenses,5eecc6d6449e4f7cfb1c2708,2022-01-08T00:00:00.000Z,50200054531492-TPT-108000-ALETA PEOPLE S ERVICES,,,net_banking_transfer,-108000
61fa340ad8beac15990e6516,50200023535069,213572.51,60ec41ba55c00300382672d9,HDFC,Revenue-PG-non-split,5eecc6d6449e4f7cfb1c2708,2022-01-09T00:00:00.000Z,IMPS-200904540786-PAYTM PAYMENTS SERVI-P YTM-XXXXXXXXXX0008-ALL202201092168200003 30830668628,ewallet,,net_banking_transfer,9977.54
61fa340ad8beac15990e6518,50200023535069,204572.51,60ec41ba55c00300382672d9,HDFC,direct expenses,5eecc6d6449e4f7cfb1c2708,2022-01-09T00:00:00.000Z,"NEFT DR-ICIC0004109-ASHRAFI ASSOCIATES-N ETBANK, MUM-N009221786364081-9000",,,net_banking_transfer,-9000
61fa340ad8beac15990e651a,50200023535069,189572.51,60ec41ba55c00300382672d9,HDFC,direct expenses,5eecc6d6449e4f7cfb1c2708,2022-01-09T00:00:00.000Z,"NEFT DR-KKBK0008365-SRIRAJ GUNDA-NETBANK , MUM-N009221786364885-15000",,,net_banking_transfer,-15000
61fa340ad8beac15990e651c,50200023535069,204500.88,60ec41ba55c00300382672d9,HDFC,Revenue-Mktplace,5eecc6d6449e4f7cfb1c2708,2022-01-10T00:00:00.000Z,NEFT CR-DEUT0797BGL-FLIPKART INTERNET PR IVATE LIMITED-SLICK ORGANICS PVT LTD-201 000142GN00117,shopping,,net_banking_transfer,14928.37
61fa340ad8beac15990e651e,50200023535069,217337.07,60ec41ba55c00300382672d9,HDFC,Revenue-PG-non-split,5eecc6d6449e4f7cfb1c2708,2022-01-10T00:00:00.000Z,IMPS-201004947071-PAYTM PAYMENTS SERVI-P YTM-XXXXXXXXXX0008-ALL202201102168200003 30830668628,ewallet,,net_banking_transfer,12836.19
61fa340ad8beac15990e6520,50200023535069,224005.78,60ec41ba55c00300382672d9,HDFC,Revenue-Mktplace,5eecc6d6449e4f7cfb1c2708,2022-01-10T00:00:00.000Z,NEFT CR-DEUT0797BGL-FLIPKART INTERNET PR IVATE LIMITED-SLICK ORGANICS PVT LTD-201 000214GN00195,shopping,,net_banking_transfer,6668.71
61fa340ad8beac15990e6522,50200023535069,251848.24,60ec41ba55c00300382672d9,HDFC,Revenue-Mktplace,5eecc6d6449e4f7cfb1c2708,2022-01-10T00:00:00.000Z,NEFT CR-DEUT0797BGL-MYNTRA DESIGNS PRIVA,shopping,,net_banking_transfer,27842.46
61fa340ad8beac15990e6524,50200023535069,354791.38,60ec41ba55c00300382672d9,HDFC,Revenue-Mktplace,5eecc6d6449e4f7cfb1c2708,2022-01-10T00:00:00.000Z,NEFT CR-DEUT0797BGL-MYNTRA DESIGNS PRIVA TE LIMITED-SLICK ORGANICS PVT. LTD.-2010 00546GN00108,shopping,,net_banking_transfer,102943.14
61fa340ad8beac15990e6526,50200023535069,356003.33,60ec41ba55c00300382672d9,HDFC,Revenue-PG-split enabled,5eecc6d6449e4f7cfb1c2708,2022-01-10T00:00:00.000Z,NEFT CR-UTIB0001506-RAZORPAY SOFTWARE PR IVATE LIMITED-SLICK ORGANICS PVT LITD-AX ISCN0117256159,insurance,,net_banking_transfer,1211.95
61fa340ad8beac15990e6528,50200023535069,392241.42,60ec41ba55c00300382672d9,HDFC,Revenue-UPI,5eecc6d6449e4f7cfb1c2708,2022-01-10T00:00:00.000Z,UPI-GOKWIK-GOKWIK@YESBANK-YESB0000340-20 1093736573-PAYOUT FOR JANUARY,,,upi,36238.09
61fa340ad8beac15990e652a,50200023535069,355047.51,60ec41ba55c00300382672d9,HDFC,SAAS/tech expense,5eecc6d6449e4f7cfb1c2708,2022-01-10T00:00:00.000Z,POS 514834XXXXXX9486 AMAZON.COM,shopping,,debit_card,-37193.91
61fa340ad8beac15990e652c,50200023535069,211047.51,60ec41ba55c00300382672d9,HDFC,direct expenses,5eecc6d6449e4f7cfb1c2708,2022-01-10T00:00:00.000Z,"NEFT DR-ICIC0000024-TAKE MOTO YOHKI INDI A PRIVATE LIMITED-NETBANK, MUM-N01022178 7333305-144000",travel,,net_banking_transfer,-144000
61fa340ad8beac15990e652e,50200023535069,201747.51,60ec41ba55c00300382672d9,HDFC,direct expenses,5eecc6d6449e4f7cfb1c2708,2022-01-10T00:00:00.000Z,"NEFT DR-ICIC0006643-KRISHNA PACKAGING CO MPANY-NETBANK, MUM-N010221787368956-9300",,,net_banking_transfer,-9300
61fa340ad8beac15990e6530,50200023535069,207743.96,60ec41ba55c00300382672d9,HDFC,Revenue-COD,5eecc6d6449e4f7cfb1c2708,2022-01-10T00:00:00.000Z,NEFT CR-ICIC0000155-SHIPROCKET COD CRF I D 3647226-SLICK ORGANICS PVT LTD-CMS2335 775075,insurance,,net_banking_transfer,5996.45
61fa340ad8beac15990e6532,50200023535069,207927.93,60ec41ba55c00300382672d9,HDFC,Revenue-Mktplace,5eecc6d6449e4f7cfb1c2708,2022-01-10T00:00:00.000Z,NEFT CR-ICIC0000105-MANASH LIFESTYLE PRI VATE LIMITED NO-SLICK ORGANICS PRIVATE L IMITED KOLK-ICIJ220100003710,shopping,,net_banking_transfer,183.97
61fa340ad8beac15990e6534,50200023535069,211024.91,60ec41ba55c00300382672d9,HDFC,Revenue-Mktplace,5eecc6d6449e4f7cfb1c2708,2022-01-10T00:00:00.000Z,NEFT CR-ICIC0000105-MANASH LIFESTYLE PRI VATE LIMITED NO-SLICK ORGANICS PRIVATE L IMITED MP M-ICIJ220100003709,shopping,,net_banking_transfer,3096.98
61fa340ad8beac15990e6536,50200023535069,211500.99,60ec41ba55c00300382672d9,HDFC,Transfer in/Revenue-other,5eecc6d6449e4f7cfb1c2708,2022-01-10T00:00:00.000Z,4060008931-10 01 2022-HDFAZCUR1,,,Other,476.08
61fa340ad8beac15990e6538,50200023535069,212029.02,60ec41ba55c00300382672d9,HDFC,Revenue-PG-split enabled,5eecc6d6449e4f7cfb1c2708,2022-01-10T00:00:00.000Z,NEFT CR-UTIB0001506-RAZORPAY SOFTWARE PR IVATE LIMITED-SLICK ORGANICS PVT LITD-AX ISCN0117409684,insurance,,net_banking_transfer,528.03
61fa340ad8beac15990e653a,50200023535069,214200.1,60ec41ba55c00300382672d9,HDFC,Revenue-PG-non-split,5eecc6d6449e4f7cfb1c2708,2022-01-10T00:00:00.000Z,NEFT CR-IDFB0010204-SEZZLE PAYMENTS PRIV,,,net_banking_transfer,2171.08
61fa340ad8beac15990e653c,50200023535069,242740.31,60ec41ba55c00300382672d9,HDFC,Revenue-UPI,5eecc6d6449e4f7cfb1c2708,2022-01-10T00:00:00.000Z,UPI-GOKWIK-GOKWIK@YESBANK-YESB0000340-20 1094456697-PAYOUT FOR JANUARY,,,upi,28540.21
61fa340ad8beac15990e653e,50200023535069,239024.56,60ec41ba55c00300382672d9,HDFC,direct expenses,5eecc6d6449e4f7cfb1c2708,2022-01-10T00:00:00.000Z,POS 514834XXXXXX9486 GUPSHUP INC,,,debit_card,-3715.75
61fa340ad8beac15990e6540,50200023535069,311723.36,60ec41ba55c00300382672d9,HDFC,Revenue-Mktplace,5eecc6d6449e4f7cfb1c2708,2022-01-11T00:00:00.000Z,IMPS-201105011216-AMAZON SELLER SERVIC-H SBC-XXXXXXXX6004-9VIQ1PBSMSKCDOKZSLICK O RGANICS PVT LTD,shopping,,net_banking_transfer,72698.8
61fa340ad8beac15990e6542,50200023535069,342323.27,60ec41ba55c00300382672d9,HDFC,Revenue-PG-non-split,5eecc6d6449e4f7cfb1c2708,2022-01-11T00:00:00.000Z,NEFT CR-PYTM0123456-PAYTM PAYMENTS SERVI CES LIMITED-SLICK ORGANICS PVT LTD-PYTM2 20116554679,ewallet,,net_banking_transfer,30599.91
61fa340ad8beac15990e6544,50200023535069,342708.59,60ec41ba55c00300382672d9,HDFC,Revenue-PG-non-split,5eecc6d6449e4f7cfb1c2708,2022-01-11T00:00:00.000Z,NEFT CR-ICIC0000031-PAYTM E COMMERCE PVT LTD-SLICK ORGANICS PVT LTD-CMS233600485 2,ewallet,,net_banking_transfer,385.32
61fa340ad8beac15990e6546,50200023535069,634338.72,60ec41ba55c00300382672d9,HDFC,Revenue-Mktplace,5eecc6d6449e4f7cfb1c2708,2022-01-11T00:00:00.000Z,NEFT CR-DEUT0797BGL-AMAZON PAY (INDIA) P RIVATE LIMITED-SLICK ORGANICS PVT LTD-20 1100157GN00078,shopping,,net_banking_transfer,291630.13
61fa340ad8beac15990e6548,50200023535069,634513.11,60ec41ba55c00300382672d9,HDFC,Revenue-PG-split enabled,5eecc6d6449e4f7cfb1c2708,2022-01-11T00:00:00.000Z,NEFT CR-UTIB0001506-RAZORPAY SOFTWARE PR IVATE LIMITED-SLICK ORGANICS PVT LITD-AX ISCN0117515859,insurance,,net_banking_transfer,174.39
61fa340ad8beac15990e654a,50200023535069,633394.11,60ec41ba55c00300382672d9,HDFC,direct expenses,5eecc6d6449e4f7cfb1c2708,2022-01-11T00:00:00.000Z,"NEFT DR-ICIC0000171-CHHAVI SINGH-NETBANK , MUM-N011221789194303-1119",,,net_banking_transfer,-1119
61fa340ad8beac15990e654c,50200023535069,618394.11,60ec41ba55c00300382672d9,HDFC,direct expenses,5eecc6d6449e4f7cfb1c2708,2022-01-11T00:00:00.000Z,"NEFT DR-UBIN0550337-STERLING ELECTRONICS AND NETWORKS-NETBANK, MUM-N011221789754 102-15000",,,net_banking_transfer,-15000
61fa340ad8beac15990e654e,50200023535069,608394.11,60ec41ba55c00300382672d9,HDFC,direct expenses,5eecc6d6449e4f7cfb1c2708,2022-01-11T00:00:00.000Z,"NEFT DR-ICIC0000021-AKHILESH DIXIT-NETBA NK, MUM-N011221789766269-10000",,,net_banking_transfer,-10000
61fa340ad8beac15990e6550,50200023535069,608576.63,60ec41ba55c00300382672d9,HDFC,Revenue-Mktplace,5eecc6d6449e4f7cfb1c2708,2022-01-11T00:00:00.000Z,NEFT CR-ICIC0000105-MANASH LIFESTYLE PRI VATE LIMITED NO-SLICK ORGANICS PRIVATE L IMITED MP M-ICIJ220110005805,shopping,,net_banking_transfer,182.52
61fa340ad8beac15990e6553,50200023535069,609859.41,60ec41ba55c00300382672d9,HDFC,Revenue-Mktplace,5eecc6d6449e4f7cfb1c2708,2022-01-11T00:00:00.000Z,NEFT CR-ICIC0000105-MANASH LIFESTYLE PRI VATE LIMITED NO-SLICK ORGANICS PRIVATE L IMITED MP G-ICIJ220110005435,shopping,,net_banking_transfer,1282.78
61fa340ad8beac15990e6555,50200023535069,635451.66,60ec41ba55c00300382672d9,HDFC,Revenue-UPI,5eecc6d6449e4f7cfb1c2708,2022-01-11T00:00:00.000Z,UPI-GOKWIK-GOKWIK@YESBANK-YESB0000340-20,,,upi,25592.25
61fa340ad8beac15990e6557,50200023535069,638574.64,60ec41ba55c00300382672d9,HDFC,Revenue-PG-non-split,5eecc6d6449e4f7cfb1c2708,2022-01-11T00:00:00.000Z,NEFT CR-IDFB0010204-SEZZLE PAYMENTS PRIV ATE LIMITED-SLICK ORGANICS PRIVATE LIMIT ED-IDFBH22011935573,insurance,,net_banking_transfer,3122.98
61fa340ad8beac15990e6559,50200023535069,638750.2,60ec41ba55c00300382672d9,HDFC,Revenue-PG-split enabled,5eecc6d6449e4f7cfb1c2708,2022-01-11T00:00:00.000Z,NEFT CR-UTIB0001506-RAZORPAY SOFTWARE PR IVATE LIMITED-SLICK ORGANICS PVT LITD-AX ISCN0117658849,insurance,,net_banking_transfer,175.56
61fa340ad8beac15990e655b,50200023535069,1138750.2,60ec41ba55c00300382672d9,HDFC,Internal Transfers,5eecc6d6449e4f7cfb1c2708,2022-01-11T00:00:00.000Z,IB FUNDS TRANSFER CR-50200035187206 -SL ICK ORGANICS PVT LTD,insurance,,Other,500000
61fa340ad8beac15990e655d,50200023535069,445194.2,60ec41ba55c00300382672d9,HDFC,direct expenses,5eecc6d6449e4f7cfb1c2708,2022-01-11T00:00:00.000Z,"NEFT DR-ICIC0000369-BO INTERNATIONAL-NET BANK, MUM-N011221790472293-693556",,,net_banking_transfer,-693556
61fa340ad8beac15990e655f,50200023535069,424348.2,60ec41ba55c00300382672d9,HDFC,direct expenses,5eecc6d6449e4f7cfb1c2708,2022-01-11T00:00:00.000Z,"NEFT DR-ICIC0000542-AVANTIKA SUKHIA-NETB ANK, MUM-N011221790485921-20846",,,net_banking_transfer,-20846
61fa340ad8beac15990e6561,50200023535069,924348.2,60ec41ba55c00300382672d9,HDFC,Internal Transfers,5eecc6d6449e4f7cfb1c2708,2022-01-11T00:00:00.000Z,IB FUNDS TRANSFER CR-50200035187206 -SL ICK ORGANICS PVT LTD,insurance,,Other,500000
61fa340ad8beac15990e6563,50200023535069,390648.2,60ec41ba55c00300382672d9,HDFC,direct expenses,5eecc6d6449e4f7cfb1c2708,2022-01-11T00:00:00.000Z,05892560000649-TPT-533700-DECORPAC INDIA PRIVATE LIMITED,,,net_banking_transfer,-533700
61fa340ad8beac15990e6565,50200023535069,293448.2,60ec41ba55c00300382672d9,HDFC,direct expenses,5eecc6d6449e4f7cfb1c2708,2022-01-11T00:00:00.000Z,00918630000430-TPT-97200-UNICOMMERCE ESO LUTIONS PRIVATE LIMITED,,,net_banking_transfer,-97200
61fa340ad8beac15990e6567,50200023535069,305709.73,60ec41ba55c00300382672d9,HDFC,Revenue-PG-non-split,5eecc6d6449e4f7cfb1c2708,2022-01-12T00:00:00.000Z,IMPS-201204896741-PAYTM PAYMENTS SERVI-P YTM-XXXXXXXXXX0008-ALL202201122168200003 30830668628,ewallet,,net_banking_transfer,12261.53
61fa340ad8beac15990e6569,50200023535069,319749.48,60ec41ba55c00300382672d9,HDFC,Revenue-Mktplace,5eecc6d6449e4f7cfb1c2708,2022-01-12T00:00:00.000Z,NEFT CR-DEUT0797BGL-FLIPKART INTERNET PR IVATE LIMITED-SLICK ORGANICS PVT LTD-201 200876GN00256,shopping,,net_banking_transfer,14039.75
61fa340ad8beac15990e656b,50200023535069,330815.52,60ec41ba55c00300382672d9,HDFC,Revenue-Mktplace,5eecc6d6449e4f7cfb1c2708,2022-01-12T00:00:00.000Z,NEFT CR-DEUT0797BGL-FLIPKART INTERNET PR IVATE LIMITED-SLICK ORGANICS PVT LTD-201 201022GN00010,shopping,,net_banking_transfer,11066.04
61fa340ad8beac15990e656d,50200023535069,332061.41,60ec41ba55c00300382672d9,HDFC,Revenue-Mktplace,5eecc6d6449e4f7cfb1c2708,2022-01-12T00:00:00.000Z,NEFT CR-DEUT0797BGL-MYNTRA DESIGNS PRIVA TE LIMITED-SLICK ORGANICS PVT. LTD.-2012 01031GN00097,shopping,,net_banking_transfer,1245.89
61fa340ad8beac15990e656f,50200023535069,335144.11,60ec41ba55c00300382672d9,HDFC,Revenue-Mktplace,5eecc6d6449e4f7cfb1c2708,2022-01-12T00:00:00.000Z,NEFT CR-DEUT0797BGL-MYNTRA DESIGNS PRIVA,shopping,,net_banking_transfer,3082.7
61fa340ad8beac15990e6571,50200023535069,335166.6,60ec41ba55c00300382672d9,HDFC,Revenue-PG-split enabled,5eecc6d6449e4f7cfb1c2708,2022-01-12T00:00:00.000Z,NEFT CR-UTIB0001506-RAZORPAY SOFTWARE PR IVATE LIMITED-SLICK ORGANICS PVT LITD-AX ISCN0117758691,insurance,,net_banking_transfer,22.49
61fa340ad8beac15990e6573,50200023535069,336218.37,60ec41ba55c00300382672d9,HDFC,Revenue-Mktplace,5eecc6d6449e4f7cfb1c2708,2022-01-12T00:00:00.000Z,NEFT CR-DEUT0797BGL-MYNTRA DESIGNS PRIVA TE LIMITED-SLICK ORGANICS PRIVATE LIMITE D-201201083GN00012,shopping,,net_banking_transfer,1051.77
61fa340ad8beac15990e6575,50200023535069,81218.37,60ec41ba55c00300382672d9,HDFC,SAAS/tech expense,5eecc6d6449e4f7cfb1c2708,2022-01-12T00:00:00.000Z,POS 514834XXXXXX9486 AMAZON,shopping,,debit_card,-255000
61fa340ad8beac15990e6577,50200023535069,95879.96,60ec41ba55c00300382672d9,HDFC,Revenue-UPI,5eecc6d6449e4f7cfb1c2708,2022-01-12T00:00:00.000Z,UPI-GOKWIK-GOKWIK@YESBANK-YESB0000340-20 1297839078-PAYOUT FOR JANUARY,,,upi,14661.59
61fa340ad8beac15990e6579,50200023535069,96508.16,60ec41ba55c00300382672d9,HDFC,Revenue-Mktplace,5eecc6d6449e4f7cfb1c2708,2022-01-12T00:00:00.000Z,NEFT CR-ICIC0000105-MANASH LIFESTYLE PRI VATE LIMITED NO-SLICK ORGANICS PRIVATE L IMITED MP M-ICIJ220120006363,shopping,,net_banking_transfer,628.2
61fa340ad8beac15990e657b,50200023535069,98185.3,60ec41ba55c00300382672d9,HDFC,Revenue-Mktplace,5eecc6d6449e4f7cfb1c2708,2022-01-12T00:00:00.000Z,NEFT CR-ICIC0000105-MANASH LIFESTYLE PRI VATE LIMITED NO-SLICK ORGANICS PRIVATE L IMITED MP G-ICIJ220120004242,shopping,,net_banking_transfer,1677.14
61fa340ad8beac15990e657d,50200023535069,98433.8,60ec41ba55c00300382672d9,HDFC,Revenue-Mktplace,5eecc6d6449e4f7cfb1c2708,2022-01-12T00:00:00.000Z,NEFT CR-ICIC0000105-MANASH LIFESTYLE PRI VATE LIMITED NO-SLICK ORGANICS PRIVATE L IMITED BANG-ICIJ220120004244,shopping,,net_banking_transfer,248.5
61fa340ad8beac15990e657f,50200023535069,598433.8,60ec41ba55c00300382672d9,HDFC,Internal Transfers,5eecc6d6449e4f7cfb1c2708,2022-01-12T00:00:00.000Z,IB FUNDS TRANSFER CR-50200035187206 -SL ICK ORGANICS PVT LTD,insurance,,Other,500000
61fa340ad8beac15990e6581,50200023535069,630605.68,60ec41ba55c00300382672d9,HDFC,Revenue-COD,5eecc6d6449e4f7cfb1c2708,2022-01-12T00:00:00.000Z,NEFT CR-ICIC0000155-SHIPROCKET COD CRF I D 3659577-SLICK ORGANICS PVT LTD-CMS2339 423360,insurance,,net_banking_transfer,32171.88
61fa340ad8beac15990e6583,50200023535069,627315.68,60ec41ba55c00300382672d9,HDFC,direct expenses,5eecc6d6449e4f7cfb1c2708,2022-01-12T00:00:00.000Z,"NEFT DR-UBIN0550337-STERLING ELECTRONICS AND NETWORKS-NETBANK, MUM-N012221791978 071-3290",,,net_banking_transfer,-3290
61fa340ad8beac15990e6585,50200023535069,617315.68,60ec41ba55c00300382672d9,HDFC,direct expenses,5eecc6d6449e4f7cfb1c2708,2022-01-12T00:00:00.000Z,"NEFT DR-ICIC0000021-AKHILESH DIXIT-NETBA NK, MUM-N012221792113366-10000",,,net_banking_transfer,-10000
61fa340ad8beac15990e6587,50200023535069,617399.65,60ec41ba55c00300382672d9,HDFC,Revenue-PG-split enabled,5eecc6d6449e4f7cfb1c2708,2022-01-12T00:00:00.000Z,NEFT CR-UTIB0001506-RAZORPAY SOFTWARE PR,,,net_banking_transfer,83.97
61fa340ad8beac15990e6589,50200023535069,628126.45,60ec41ba55c00300382672d9,HDFC,Revenue-PG-non-split,5eecc6d6449e4f7cfb1c2708,2022-01-13T00:00:00.000Z,IMPS-201304540473-PAYTM PAYMENTS SERVI-P YTM-XXXXXXXXXX0008-ALL202201132168200003 30830668628,ewallet,,net_banking_transfer,10726.8
61fa340ad8beac15990e658b,50200023535069,628254.12,60ec41ba55c00300382672d9,HDFC,Revenue-PG-split enabled,5eecc6d6449e4f7cfb1c2708,2022-01-13T00:00:00.000Z,NEFT CR-UTIB0001506-RAZORPAY SOFTWARE PR IVATE LIMITED-SLICK ORGANICS PVT LITD-AX ISCN0117952012,insurance,,net_banking_transfer,127.67
61fa340ad8beac15990e658d,50200023535069,595854.12,60ec41ba55c00300382672d9,HDFC,direct expenses,5eecc6d6449e4f7cfb1c2708,2022-01-13T00:00:00.000Z,50200039330521-TPT-32400-ELITE PUBLICIST,insurance,,net_banking_transfer,-32400
61fa340ad8beac15990e658f,50200023535069,423854.12,60ec41ba55c00300382672d9,HDFC,direct expenses,5eecc6d6449e4f7cfb1c2708,2022-01-13T00:00:00.000Z,50200063349422-TPT-172000-COHORT E-COMME RCE CONSULTING LLP,,,net_banking_transfer,-172000
61fa340ad8beac15990e6591,50200023535069,408194.12,60ec41ba55c00300382672d9,HDFC,agency/vendor expense,5eecc6d6449e4f7cfb1c2708,2022-01-13T00:00:00.000Z,"NEFT DR-UTIB0003557-INCOSEC LEGAL-NETBAN K, MUM-N013221792946163-15660",,,net_banking_transfer,-15660
61fa340ad8beac15990e6593,50200023535069,433952.31,60ec41ba55c00300382672d9,HDFC,Revenue-UPI,5eecc6d6449e4f7cfb1c2708,2022-01-13T00:00:00.000Z,UPI-GOKWIK-GOKWIK@YESBANK-YESB0000340-20 1399513143-PAYOUT FOR JANUARY,,,upi,25758.19
61fa340ad8beac15990e6595,50200023535069,462760.31,60ec41ba55c00300382672d9,HDFC,Revenue-Mktplace,5eecc6d6449e4f7cfb1c2708,2022-01-13T00:00:00.000Z,NEFT CR-SCBL0036001-M/S DREAMPLUG TECHNO -SLICK ORGANICS PRIVATE LIMITEDSLICK-SIN 31436Q0030230,insurance,,net_banking_transfer,28808
61fa340ad8beac15990e6597,50200023535069,476628.14,60ec41ba55c00300382672d9,HDFC,Revenue-PG-split enabled,5eecc6d6449e4f7cfb1c2708,2022-01-13T00:00:00.000Z,NEFT CR-UTIB0001506-RAZORPAY SOFTWARE PR IVATE LIMITED-SLICK ORGANICS PVT LITD-AX ISCN0118052941,insurance,,net_banking_transfer,13867.83
61fa340ad8beac15990e6599,50200023535069,479473.52,60ec41ba55c00300382672d9,HDFC,Revenue-PG-non-split,5eecc6d6449e4f7cfb1c2708,2022-01-13T00:00:00.000Z,NEFT CR-IDFB0010204-SEZZLE PAYMENTS PRIV ATE LIMITED-SLICK ORGANICS PRIVATE LIMIT ED-IDFBH22013117878,insurance,,net_banking_transfer,2845.38
61fa340ad8beac15990e659b,50200023535069,329473.52,60ec41ba55c00300382672d9,HDFC,direct expenses,5eecc6d6449e4f7cfb1c2708,2022-01-13T00:00:00.000Z,"NEFT DR-ICIC0000031-HORA ART CENTRE PRIV ATE LIMITED-NETBANK, MUM-N01322179363392 8-150000",,,net_banking_transfer,-150000
61fa340ad8beac15990e659d,50200023535069,342110.27,60ec41ba55c00300382672d9,HDFC,Revenue-Mktplace,5eecc6d6449e4f7cfb1c2708,2022-01-14T00:00:00.000Z,NEFT CR-DEUT0797BGL-FLIPKART INTERNET PR IVATE LIMITED-SLICK ORGANICS PVT LTD-201 400120GN00028,shopping,,net_banking_transfer,12636.75
61fa340ad8beac15990e659f,50200023535069,400849.95,60ec41ba55c00300382672d9,HDFC,Revenue-PG-non-split,5eecc6d6449e4f7cfb1c2708,2022-01-14T00:00:00.000Z,NEFT CR-PYTM0123456-PAYTM PAYMENTS SERVI,ewallet,,net_banking_transfer,58739.68
61fa340ad8beac15990e65a1,50200023535069,403010.62,60ec41ba55c00300382672d9,HDFC,Revenue-Mktplace,5eecc6d6449e4f7cfb1c2708,2022-01-14T00:00:00.000Z,NEFT CR-DEUT0797BGL-MYNTRA DESIGNS PRIVA TE LIMITED-SLICK ORGANICS PVT. LTD.-2014 00572GN00109,shopping,,net_banking_transfer,2160.67
61fa340ad8beac15990e65a3,50200023535069,405964.48,60ec41ba55c00300382672d9,HDFC,Revenue-Mktplace,5eecc6d6449e4f7cfb1c2708,2022-01-14T00:00:00.000Z,NEFT CR-DEUT0797BGL-MYNTRA DESIGNS PRIVA TE LIMITED-SLICK ORGANICS PVT. LTD.-2014 00573GN00111,shopping,,net_banking_transfer,2953.86
61fa340ad8beac15990e65a5,50200023535069,437577.3,60ec41ba55c00300382672d9,HDFC,Revenue-PG-split enabled,5eecc6d6449e4f7cfb1c2708,2022-01-14T00:00:00.000Z,NEFT CR-UTIB0001506-RAZORPAY SOFTWARE PR IVATE LIMITED-SLICK ORGANICS PVT LITD-AX ISCN0118094847,insurance,,net_banking_transfer,31612.82
61fa340ad8beac15990e65a7,50200023535069,434945.3,60ec41ba55c00300382672d9,HDFC,direct expenses,5eecc6d6449e4f7cfb1c2708,2022-01-14T00:00:00.000Z,"NEFT DR-ICIC0006643-KRISHNA PACKAGING CO MPANY-NETBANK, MUM-N014221794074904-2632",,,net_banking_transfer,-2632
61fa340ad8beac15990e65a9,50200023535069,436552.29,60ec41ba55c00300382672d9,HDFC,Revenue-Mktplace,5eecc6d6449e4f7cfb1c2708,2022-01-14T00:00:00.000Z,4060008891-TIMES INTERNET LIMITED NODAL,,,Other,1606.99
61fa340ad8beac15990e65ab,50200023535069,161552.29,60ec41ba55c00300382672d9,HDFC,direct expenses,5eecc6d6449e4f7cfb1c2708,2022-01-14T00:00:00.000Z,"NEFT DR-PUNB0100110-KRAUTER HEALTHCARE L TD-NETBANK, MUM-N014221794097270-275000",,,net_banking_transfer,-275000
61fa340ad8beac15990e65ad,50200023535069,661552.29,60ec41ba55c00300382672d9,HDFC,Internal Transfers,5eecc6d6449e4f7cfb1c2708,2022-01-14T00:00:00.000Z,IB FUNDS TRANSFER CR-50200035187206 -SL ICK ORGANICS PVT LTD,insurance,,Other,500000
61fa340ad8beac15990e65af,50200023535069,665313.38,60ec41ba55c00300382672d9,HDFC,Revenue-Mktplace,5eecc6d6449e4f7cfb1c2708,2022-01-14T00:00:00.000Z,NEFT CR-ICIC0000105-MANASH LIFESTYLE PRI VATE LIMITED NO-SLICK ORGANICS PRIVATE L IMITED MP G-ICIJ220140004099,shopping,,net_banking_transfer,3761.09
61fa340ad8beac15990e65b1,50200023535069,667076.26,60ec41ba55c00300382672d9,HDFC,Revenue-Mktplace,5eecc6d6449e4f7cfb1c2708,2022-01-14T00:00:00.000Z,NEFT CR-ICIC0000105-MANASH LIFESTYLE PRI VATE LIMITED NO-SLICK ORGANICS PRIVATE L IMITED MP M-ICIJ220140004101,shopping,,net_banking_transfer,1762.88
61fa340ad8beac15990e65b3,50200023535069,667878.02,60ec41ba55c00300382672d9,HDFC,Revenue-Mktplace,5eecc6d6449e4f7cfb1c2708,2022-01-14T00:00:00.000Z,NEFT CR-DEUT0784BBY-TATA UNISTORE LTD-NO DAL-SLICK ORGANICS PVT LTD-201401322GN00 395,insurance,,net_banking_transfer,801.76
61fa340ad8beac15990e65b5,50200023535069,686400.06,60ec41ba55c00300382672d9,HDFC,Revenue-UPI,5eecc6d6449e4f7cfb1c2708,2022-01-14T00:00:00.000Z,UPI-GOKWIK-GOKWIK@YESBANK-YESB0000340-20 1401128196-PAYOUT FOR JANUARY,,,upi,18522.04
61fa340ad8beac15990e65b7,50200023535069,735338.61,60ec41ba55c00300382672d9,HDFC,Revenue-COD,5eecc6d6449e4f7cfb1c2708,2022-01-14T00:00:00.000Z,NEFT CR-ICIC0000155-SHIPROCKET COD CRF I D 3671774-SLICK ORGANICS PVT LTD-CMS2343 500159,insurance,,net_banking_transfer,48938.55
61fa340ad8beac15990e65b9,50200023535069,743004.61,60ec41ba55c00300382672d9,HDFC,Revenue-Mktplace,5eecc6d6449e4f7cfb1c2708,2022-01-14T00:00:00.000Z,NEFT CR-ICIC0000985-DIGITAL AGE RETAIL P,,,net_banking_transfer,7666
61fa340ad8beac15990e65bb,50200023535069,750396.25,60ec41ba55c00300382672d9,HDFC,Transfer in/Revenue-other,5eecc6d6449e4f7cfb1c2708,2022-01-14T00:00:00.000Z,57500000644820-SLICK ORGANICS,insurance,,Other,7391.64
61fa340ad8beac15990e65bd,50200023535069,751874.25,60ec41ba55c00300382672d9,HDFC,Revenue-COD,5eecc6d6449e4f7cfb1c2708,2022-01-14T00:00:00.000Z,NEFT CR-KKBK0000958-PICKRR TECHNOLOGIES PVT LTD-SLICKORGANICSPRIVATELIMITED-CMS0 142206044561,insurance,,net_banking_transfer,1478
61fa340ad8beac15990e65bf,50200023535069,2251874.25,60ec41ba55c00300382672d9,HDFC,Internal Transfers,5eecc6d6449e4f7cfb1c2708,2022-01-14T00:00:00.000Z,IB FUNDS TRANSFER CR-50200035187206 -SL ICK ORGANICS PVT LTD,insurance,,Other,1500000
61fa340ad8beac15990e65c1,50200023535069,2051874.25,60ec41ba55c00300382672d9,HDFC,Marketing Expense,5eecc6d6449e4f7cfb1c2708,2022-01-14T00:00:00.000Z,"NEFT DR-CITI0000006-FACEBOOK INDIA ONLIN E SERVICES PVT LTD-NETBANK, MUM-N0142217 94781461-200000",,,net_banking_transfer,-200000
61fa340ad8beac15990e65c3,50200023535069,1851874.25,60ec41ba55c00300382672d9,HDFC,Marketing Expense,5eecc6d6449e4f7cfb1c2708,2022-01-14T00:00:00.000Z,IMPS-201419154450-FACEBOOK INDIA ONLINE SERVICES PVT LTD-CITI-XXXXX2076-200000,,,net_banking_transfer,-200000
61fa340ad8beac15990e65c5,50200023535069,1864080.59,60ec41ba55c00300382672d9,HDFC,Revenue-PG-non-split,5eecc6d6449e4f7cfb1c2708,2022-01-15T00:00:00.000Z,IMPS-201504548559-PAYTM PAYMENTS SERVI-P YTM-XXXXXXXXXX0008-ALL202201152168200003 30830668628,ewallet,,net_banking_transfer,12206.34
61fa340bd8beac15990e65c7,50200023535069,1264080.59,60ec41ba55c00300382672d9,HDFC,Marketing Expense,5eecc6d6449e4f7cfb1c2708,2022-01-15T00:00:00.000Z,"NEFT DR-CITI0000006-FACEBOOK INDIA ONLIN E SERVICES PVT LTD-NETBANK, MUM-N0152217 94899364-600000",,,net_banking_transfer,-600000
61fa340bd8beac15990e65c9,50200023535069,1178161.02,60ec41ba55c00300382672d9,HDFC,direct expenses,5eecc6d6449e4f7cfb1c2708,2022-01-15T00:00:00.000Z,POS 514834XXXXXX9486 FRESHWORKS INC,,,debit_card,-85919.57
61fa340bd8beac15990e65cb,50200023535069,201838.02,60ec41ba55c00300382672d9,HDFC,Marketing Expense,5eecc6d6449e4f7cfb1c2708,2022-01-15T00:00:00.000Z,"NEFT DR-CITI0000006-FACEBOOK INDIA ONLIN E SERVICES PVT LTD-NETBANK, MUM-N0152217 94904069-976323",,,net_banking_transfer,-976323
61fa340bd8beac15990e65cd,50200023535069,202201.38,60ec41ba55c00300382672d9,HDFC,Revenue-PG-split enabled,5eecc6d6449e4f7cfb1c2708,2022-01-15T00:00:00.000Z,NEFT CR-UTIB0001506-RAZORPAY SOFTWARE PR IVATE LIMITED-SLICK ORGANICS PVT LITD-AX ISCN0118209507,insurance,,net_banking_transfer,363.36
61fa340bd8beac15990e65cf,50200023535069,200639.18,60ec41ba55c00300382672d9,HDFC,bank charges,5eecc6d6449e4f7cfb1c2708,2022-01-15T00:00:00.000Z,.DC INTL POS TXN MARKUP+ST 301221 311221 -CDT2200207256855,,,international_transaction_arbitrage,-1562.2
61fa340bd8beac15990e65d1,50200023535069,700639.18,60ec41ba55c00300382672d9,HDFC,Internal Transfers,5eecc6d6449e4f7cfb1c2708,2022-01-15T00:00:00.000Z,IB FUNDS TRANSFER CR-50200035187206 -SL ICK ORGANICS PVT LTD,insurance,,Other,500000
61fa340bd8beac15990e65d3,50200023535069,439002.18,60ec41ba55c00300382672d9,HDFC,direct expenses,5eecc6d6449e4f7cfb1c2708,2022-01-15T00:00:00.000Z,NEFT DR-KKBK0000180-VEDIC COSMECEUTICALS,,,net_banking_transfer,-261637
61fa340bd8beac15990e65d5,50200023535069,579529.3,60ec41ba55c00300382672d9,HDFC,Revenue-UPI,5eecc6d6449e4f7cfb1c2708,2022-01-15T00:00:00.000Z,UPI-GOKWIK-GOKWIK@YESBANK-YESB0000340-20 1502604303-PAYOUT FOR JANUARY,,,upi,140527.12
61fa340bd8beac15990e65d7,50200023535069,579551.99,60ec41ba55c00300382672d9,HDFC,Revenue-PG-split enabled,5eecc6d6449e4f7cfb1c2708,2022-01-15T00:00:00.000Z,NEFT CR-UTIB0001506-RAZORPAY SOFTWARE PR IVATE LIMITED-SLICK ORGANICS PVT LITD-AX ISCN0118274363,insurance,,net_banking_transfer,22.69
61fa340bd8beac15990e65db,50200023535069,324551.99,60ec41ba55c00300382672d9,HDFC,SAAS/tech expense,5eecc6d6449e4f7cfb1c2708,2022-01-15T00:00:00.000Z,POS 514834XXXXXX9486 AMAZON,shopping,,debit_card,-255000
61fa340bd8beac15990e65dd,50200023535069,333533.02,60ec41ba55c00300382672d9,HDFC,Revenue-PG-non-split,5eecc6d6449e4f7cfb1c2708,2022-01-16T00:00:00.000Z,IMPS-201606980710-PAYTM PAYMENTS SERVI-P YTM-XXXXXXXXXX0008-ALL202201162168200003 30830668628,ewallet,,net_banking_transfer,8981.03
61fa340bd8beac15990e65df,50200023535069,296209.83,60ec41ba55c00300382672d9,HDFC,SAAS/tech expense,5eecc6d6449e4f7cfb1c2708,2022-01-16T00:00:00.000Z,POS 514834XXXXXX9486 AMAZON.COM,shopping,,debit_card,-37323.19
61fa340bd8beac15990e65e1,50200023535069,322586.45,60ec41ba55c00300382672d9,HDFC,Revenue-UPI,5eecc6d6449e4f7cfb1c2708,2022-01-16T00:00:00.000Z,UPI-GOKWIK-GOKWIK@YESBANK-YESB0000340-20 1604197646-PAYOUT FOR JANUARY,,,upi,26376.62
61fa340bd8beac15990e65e3,50200023535069,337020.62,60ec41ba55c00300382672d9,HDFC,Revenue-Mktplace,5eecc6d6449e4f7cfb1c2708,2022-01-17T00:00:00.000Z,NEFT CR-DEUT0797BGL-FLIPKART INTERNET PR IVATE LIMITED-SLICK ORGANICS PVT LTD-201 700105GN00140,shopping,,net_banking_transfer,14434.17
61fa340bd8beac15990e65e5,50200023535069,350046.76,60ec41ba55c00300382672d9,HDFC,Revenue-PG-non-split,5eecc6d6449e4f7cfb1c2708,2022-01-17T00:00:00.000Z,IMPS-201704083045-PAYTM PAYMENTS SERVI-P YTM-XXXXXXXXXX0008-ALL202201172168200003 30830668628,ewallet,,net_banking_transfer,13026.14
61fa340bd8beac15990e65e7,50200023535069,356182.23,60ec41ba55c00300382672d9,HDFC,Revenue-Mktplace,5eecc6d6449e4f7cfb1c2708,2022-01-17T00:00:00.000Z,NEFT CR-DEUT0797BGL-MYNTRA DESIGNS PRIVA TE LIMITED-SLICK ORGANICS PVT. LTD.-2017 00503GN00128,shopping,,net_banking_transfer,6135.47
61fa340bd8beac15990e65e9,50200023535069,356880.43,60ec41ba55c00300382672d9,HDFC,Revenue-Mktplace,5eecc6d6449e4f7cfb1c2708,2022-01-17T00:00:00.000Z,NEFT CR-DEUT0797BGL-MYNTRA DESIGNS PRIVA TE LIMITED-SLICK ORGANICS PVT. LTD.-2017 00534GN00113,shopping,,net_banking_transfer,698.2
61fa340bd8beac15990e65eb,50200023535069,357914.12,60ec41ba55c00300382672d9,HDFC,Revenue-PG-non-split,5eecc6d6449e4f7cfb1c2708,2022-01-17T00:00:00.000Z,NEFT CR-IDFB0010204-SEZZLE PAYMENTS PRIV ATE LIMITED-SLICK ORGANICS PRIVATE LIMIT ED-IDFBH22017308106,insurance,,net_banking_transfer,1033.69
61fa340bd8beac15990e65ed,50200023535069,360156.45,60ec41ba55c00300382672d9,HDFC,Revenue-PG-non-split,5eecc6d6449e4f7cfb1c2708,2022-01-17T00:00:00.000Z,NEFT CR-IDFB0010204-SEZZLE PAYMENTS PRIV ATE LIMITED-SLICK ORGANICS PRIVATE LIMIT ED-IDFBH22017308397,insurance,,net_banking_transfer,2242.33
61fa340bd8beac15990e65ef,50200023535069,363228.73,60ec41ba55c00300382672d9,HDFC,Revenue-PG-non-split,5eecc6d6449e4f7cfb1c2708,2022-01-17T00:00:00.000Z,NEFT CR-IDFB0010204-SEZZLE PAYMENTS PRIV,,,net_banking_transfer,3072.28
61fa340bd8beac15990e65f1,50200023535069,379866.96,60ec41ba55c00300382672d9,HDFC,Revenue-UPI,5eecc6d6449e4f7cfb1c2708,2022-01-17T00:00:00.000Z,UPI-GOKWIK-GOKWIK@YESBANK-YESB0000340-20 1705694469-PAYOUT FOR JANUARY,,,upi,16638.23
61fa340bd8beac15990e65f3,50200023535069,381840.22,60ec41ba55c00300382672d9,HDFC,Revenue-Mktplace,5eecc6d6449e4f7cfb1c2708,2022-01-17T00:00:00.000Z,NEFT CR-ICIC0000105-MANASH LIFESTYLE PRI VATE LIMITED NO-SLICK ORGANICS PRIVATE L IMITED MP M-ICIJ220170002848,shopping,,net_banking_transfer,1973.26
61fa340bd8beac15990e65f5,50200023535069,382088.72,60ec41ba55c00300382672d9,HDFC,Revenue-Mktplace,5eecc6d6449e4f7cfb1c2708,2022-01-17T00:00:00.000Z,NEFT CR-ICIC0000105-MANASH LIFESTYLE PRI VATE LIMITED NO-SLICK ORGANICS PRIVATE L IMITED KOLK-ICIJ220170002850,shopping,,net_banking_transfer,248.5
61fa340bd8beac15990e65f7,50200023535069,382291.96,60ec41ba55c00300382672d9,HDFC,Revenue-PG-split enabled,5eecc6d6449e4f7cfb1c2708,2022-01-17T00:00:00.000Z,NEFT CR-UTIB0001506-RAZORPAY SOFTWARE PR IVATE LIMITED-SLICK ORGANICS PVT LITD-AX ISCN0118422658,insurance,,net_banking_transfer,203.24
61fa340bd8beac15990e65f9,50200023535069,381582.96,60ec41ba55c00300382672d9,HDFC,direct expenses,5eecc6d6449e4f7cfb1c2708,2022-01-17T00:00:00.000Z,"NEFT DR-CNRB0000549-SHABRIN TAJ-NETBANK, MUM-N017221797336164-709",,,net_banking_transfer,-709
61fa340bd8beac15990e65fb,50200023535069,378053.96,60ec41ba55c00300382672d9,HDFC,direct expenses,5eecc6d6449e4f7cfb1c2708,2022-01-17T00:00:00.000Z,02712120000086-TPT-3529-SPOTON LOGISTICS PVT LTD,,,net_banking_transfer,-3529
61fa340bd8beac15990e65fd,50200023535069,395186.22,60ec41ba55c00300382672d9,HDFC,Revenue-PG-non-split,5eecc6d6449e4f7cfb1c2708,2022-01-18T00:00:00.000Z,IMPS-201804537582-PAYTM PAYMENTS SERVI-P YTM-XXXXXXXXXX0008-ALL202201182168200003 30830668628,ewallet,,net_banking_transfer,17132.26
61fa340bd8beac15990e65ff,50200023535069,468213.57,60ec41ba55c00300382672d9,HDFC,Revenue-Mktplace,5eecc6d6449e4f7cfb1c2708,2022-01-18T00:00:00.000Z,IMPS-201805071303-AMAZON SELLER SERVIC-H SBC-XXXXXXXX6004-4R2F9EV67UQLXWM9SLICK O RGANICS PVT LTD,shopping,,net_banking_transfer,73027.35
61fa340bd8beac15990e6601,50200023535069,468414.94,60ec41ba55c00300382672d9,HDFC,Revenue-PG-split enabled,5eecc6d6449e4f7cfb1c2708,2022-01-18T00:00:00.000Z,NEFT CR-UTIB0001506-RAZORPAY SOFTWARE PR IVATE LIMITED-SLICK ORGANICS PVT LITD-AX ISCN0118474553,insurance,,net_banking_transfer,201.37
61fa340bd8beac15990e6603,50200023535069,486180.94,60ec41ba55c00300382672d9,HDFC,Transfer in/Revenue-other,5eecc6d6449e4f7cfb1c2708,2022-01-18T00:00:00.000Z,FT - CR - 50200038726231 - HOUSE OF BEAU TY PRIVATE LIMITED,,,Other,17766
61fa340bd8beac15990e6605,50200023535069,681659.85,60ec41ba55c00300382672d9,HDFC,Revenue-Mktplace,5eecc6d6449e4f7cfb1c2708,2022-01-18T00:00:00.000Z,NEFT CR-DEUT0797BGL-AMAZON PAY (INDIA) P RIVATE LIMITED-SLICK ORGANICS PVT LTD-20 1800146GN00116,shopping,,net_banking_transfer,195478.91
61fa340bd8beac15990e6607,50200023535069,701835.85,60ec41ba55c00300382672d9,HDFC,Transfer in/Revenue-other,5eecc6d6449e4f7cfb1c2708,2022-01-18T00:00:00.000Z,50200050241205-TPT-ARATA-NAPSA PRIVATE L,,,net_banking_transfer,20176
61fa340bd8beac15990e6609,50200023535069,702580.49,60ec41ba55c00300382672d9,HDFC,Revenue-PG-non-split,5eecc6d6449e4f7cfb1c2708,2022-01-18T00:00:00.000Z,NEFT CR-ICIC0000031-PAYTM E COMMERCE PVT LTD-SLICK ORGANICS PVT LTD-CMS234836633 0,ewallet,,net_banking_transfer,744.64
61fa340bd8beac15990e660b,50200023535069,651662.15,60ec41ba55c00300382672d9,HDFC,direct expenses,5eecc6d6449e4f7cfb1c2708,2022-01-18T00:00:00.000Z,POS 514834XXXXXX9486 N J AKERS & CO,,,debit_card,-50918.34
61fa340bd8beac15990e660d,50200023535069,643185.15,60ec41ba55c00300382672d9,HDFC,direct expenses,5eecc6d6449e4f7cfb1c2708,2022-01-18T00:00:00.000Z,"NEFT DR-ICIC0000021-AKHILESH DIXIT-NETBA NK, MUM-N018221798090674-8477",,,net_banking_transfer,-8477
61fa340bd8beac15990e660f,50200023535069,443185.15,60ec41ba55c00300382672d9,HDFC,direct expenses,5eecc6d6449e4f7cfb1c2708,2022-01-18T00:00:00.000Z,"NEFT DR-SCBL0036046-INDOLEADS TECHNOLOGI ES P LTD-NETBANK, MUM-N018221798089976-2 00000",,,net_banking_transfer,-200000
61fa340bd8beac15990e6611,50200023535069,518130.15,60ec41ba55c00300382672d9,HDFC,Investments-New,5eecc6d6449e4f7cfb1c2708,2022-01-18T00:00:00.000Z,50200019889031-TPT-INVOICE PAYMENT-1908 E-VENTURES PRIVATE LIMITED,,,net_banking_transfer,74945
61fa340bd8beac15990e6613,50200023535069,542861.59,60ec41ba55c00300382672d9,HDFC,Revenue-UPI,5eecc6d6449e4f7cfb1c2708,2022-01-18T00:00:00.000Z,UPI-GOKWIK-GOKWIK@YESBANK-YESB0000340-20 1807479625-PAYOUT FOR JANUARY,,,upi,24731.44
61fa340bd8beac15990e6615,50200023535069,544748.37,60ec41ba55c00300382672d9,HDFC,Revenue-Mktplace,5eecc6d6449e4f7cfb1c2708,2022-01-18T00:00:00.000Z,NEFT CR-ICIC0000105-MANASH LIFESTYLE PRI VATE LIMITED NO-SLICK ORGANICS PRIVATE L IMITED MP G-ICIJ220180003275,shopping,,net_banking_transfer,1886.78
61fa340bd8beac15990e6617,50200023535069,545241.69,60ec41ba55c00300382672d9,HDFC,Revenue-PG-non-split,5eecc6d6449e4f7cfb1c2708,2022-01-18T00:00:00.000Z,NEFT CR-IDFB0010204-SEZZLE PAYMENTS PRIV ATE LIMITED-SLICK ORGANICS PRIVATE LIMIT ED-IDFBH22018399973,insurance,,net_banking_transfer,493.32
61fa340bd8beac15990e6619,50200023535069,545363.22,60ec41ba55c00300382672d9,HDFC,Revenue-PG-split enabled,5eecc6d6449e4f7cfb1c2708,2022-01-18T00:00:00.000Z,NEFT CR-UTIB0001506-RAZORPAY SOFTWARE PR IVATE LIMITED-SLICK ORGANICS PVT LITD-AX ISCN0118571526,insurance,,net_banking_transfer,121.53
61fa340bd8beac15990e661b,50200023535069,195363.22,60ec41ba55c00300382672d9,HDFC,direct expenses,5eecc6d6449e4f7cfb1c2708,2022-01-18T00:00:00.000Z,57500000443889-TPT-350000-WEBKLIPPER TEC HNOLOGIES PRIVATE LIMITED,,,net_banking_transfer,-350000
61fa340bd8beac15990e661d,50200023535069,53763.22,60ec41ba55c00300382672d9,HDFC,direct expenses,5eecc6d6449e4f7cfb1c2708,2022-01-18T00:00:00.000Z,"NEFT DR-KKBK0000173-MATRIX PRINTING SOLU TIONS PRIVATE LIMITE-NETBANK, MUM-N01822 1798714326-141600",,,net_banking_transfer,-141600
61fa340bd8beac15990e661f,50200023535069,64947.53,60ec41ba55c00300382672d9,HDFC,Revenue-Mktplace,5eecc6d6449e4f7cfb1c2708,2022-01-19T00:00:00.000Z,NEFT CR-DEUT0797BGL-FLIPKART INTERNET PR IVATE LIMITED-SLICK ORGANICS PVT LTD-201 900128GN00180,shopping,,net_banking_transfer,11184.31
61fa340bd8beac15990e6621,50200023535069,72716.85,60ec41ba55c00300382672d9,HDFC,Revenue-PG-non-split,5eecc6d6449e4f7cfb1c2708,2022-01-19T00:00:00.000Z,IMPS-201904995276-PAYTM PAYMENTS SERVI-P,ewallet,,net_banking_transfer,7769.32
61fa340bd8beac15990e6624,50200023535069,572716.85,60ec41ba55c00300382672d9,HDFC,Internal Transfers,5eecc6d6449e4f7cfb1c2708,2022-01-19T00:00:00.000Z,IB FUNDS TRANSFER CR-50200035187206 -SL ICK ORGANICS PVT LTD,insurance,,Other,500000
61fa340bd8beac15990e6626,50200023535069,437716.85,60ec41ba55c00300382672d9,HDFC,direct expenses,5eecc6d6449e4f7cfb1c2708,2022-01-19T00:00:00.000Z,"NEFT DR-YESB0000551-VISTTA COSMETICS-NET BANK, MUM-N019221798945230-135000",,,net_banking_transfer,-135000
61fa340bd8beac15990e6628,50200023535069,441017.12,60ec41ba55c00300382672d9,HDFC,Revenue-Mktplace,5eecc6d6449e4f7cfb1c2708,2022-01-19T00:00:00.000Z,NEFT CR-DEUT0797BGL-MYNTRA DESIGNS PRIVA TE LIMITED-SLICK ORGANICS PVT. LTD.-2019 01148GN00113,shopping,,net_banking_transfer,3300.27
61fa340bd8beac15990e662a,50200023535069,441937.03,60ec41ba55c00300382672d9,HDFC,Revenue-Mktplace,5eecc6d6449e4f7cfb1c2708,2022-01-19T00:00:00.000Z,NEFT CR-DEUT0797BGL-MYNTRA DESIGNS PRIVA TE LIMITED-SLICK ORGANICS PVT. LTD.-2019 01147GN00116,shopping,,net_banking_transfer,919.91
61fa340bd8beac15990e662c,50200023535069,438280.06,60ec41ba55c00300382672d9,HDFC,direct expenses,5eecc6d6449e4f7cfb1c2708,2022-01-19T00:00:00.000Z,POS 514834XXXXXX9486 WWW.FAQPRIME.COM,,,debit_card,-3656.97
61fa340bd8beac15990e662e,50200023535069,438382.88,60ec41ba55c00300382672d9,HDFC,Revenue-PG-split enabled,5eecc6d6449e4f7cfb1c2708,2022-01-19T00:00:00.000Z,NEFT CR-UTIB0001506-RAZORPAY SOFTWARE PR IVATE LIMITED-SLICK ORGANICS PVT LITD-AX ISCN0118601690,insurance,,net_banking_transfer,102.82
61fa340bd8beac15990e6630,50200023535069,6402.88,60ec41ba55c00300382672d9,HDFC,direct expenses,5eecc6d6449e4f7cfb1c2708,2022-01-19T00:00:00.000Z,"NEFT DR-ICIC0000031-ONE97 COMMUNICATIONS LTD-NETBANK, MUM-N019221798997817-43198 0",ewallet,,net_banking_transfer,-431980
61fa340bd8beac15990e6632,50200023535069,506402.88,60ec41ba55c00300382672d9,HDFC,Internal Transfers,5eecc6d6449e4f7cfb1c2708,2022-01-19T00:00:00.000Z,IB FUNDS TRANSFER CR-50200035187206 -SL ICK ORGANICS PVT LTD,insurance,,Other,500000
61fa340bd8beac15990e6634,50200023535069,557213.83,60ec41ba55c00300382672d9,HDFC,Revenue-Mktplace,5eecc6d6449e4f7cfb1c2708,2022-01-19T00:00:00.000Z,NEFT CR-HSBC0400002-AMAZON SERVICES LLC- SLICK ORGANICS PRIVATE LIMITED-HSBCN2201 9600716,shopping,,net_banking_transfer,50810.95
61fa340bd8beac15990e6636,50200023535069,554730.48,60ec41ba55c00300382672d9,HDFC,bank charges,5eecc6d6449e4f7cfb1c2708,2022-01-19T00:00:00.000Z,.DC INTL POS TXN MARKUP+ST 311221 020122 -CDT2200207256855,,,international_transaction_arbitrage,-2483.35
61fa340bd8beac15990e6638,50200023535069,554641.19,60ec41ba55c00300382672d9,HDFC,bank charges,5eecc6d6449e4f7cfb1c2708,2022-01-19T00:00:00.000Z,.DC INTL POS TXN MARKUP+ST 010122 020122 -CDT2200207256855,,,international_transaction_arbitrage,-89.29
61fa340bd8beac15990e663a,50200023535069,412714.19,60ec41ba55c00300382672d9,HDFC,direct expenses,5eecc6d6449e4f7cfb1c2708,2022-01-19T00:00:00.000Z,00921000075586-TPT-141927-ROET BINDRA,,,net_banking_transfer,-141927
61fa340bd8beac15990e663c,50200023535069,382200.19,60ec41ba55c00300382672d9,HDFC,direct expenses,5eecc6d6449e4f7cfb1c2708,2022-01-19T00:00:00.000Z,"NEFT DR-KKBK0000654-NIHARIKA MISHRA-NETB ANK, MUM-N019221799206147-30514",,,net_banking_transfer,-30514
61fa340bd8beac15990e663e,50200023535069,381830.86,60ec41ba55c00300382672d9,HDFC,bank charges,5eecc6d6449e4f7cfb1c2708,2022-01-19T00:00:00.000Z,.DC INTL POS TXN MARKUP+ST 020122 030122,,,international_transaction_arbitrage,-369.33
61fa340bd8beac15990e6640,50200023535069,380289.17,60ec41ba55c00300382672d9,HDFC,bank charges,5eecc6d6449e4f7cfb1c2708,2022-01-19T00:00:00.000Z,.DC INTL POS TXN MARKUP+ST 030122 050122 -CDT2200207256855,,,international_transaction_arbitrage,-1541.69
61fa340bd8beac15990e6642,50200023535069,380537.67,60ec41ba55c00300382672d9,HDFC,Revenue-Mktplace,5eecc6d6449e4f7cfb1c2708,2022-01-19T00:00:00.000Z,NEFT CR-ICIC0000105-MANASH LIFESTYLE PRI VATE LIMITED NO-SLICK ORGANICS PRIVATE L IMITED BANG-ICIJ220190002550,shopping,,net_banking_transfer,248.5
61fa340bd8beac15990e6644,50200023535069,381195.92,60ec41ba55c00300382672d9,HDFC,Revenue-Mktplace,5eecc6d6449e4f7cfb1c2708,2022-01-19T00:00:00.000Z,NEFT CR-ICIC0000105-MANASH LIFESTYLE PRI VATE LIMITED NO-SLICK ORGANICS PRIVATE L IMITED KOLK-ICIJ220190002549,shopping,,net_banking_transfer,658.25
61fa340bd8beac15990e6646,50200023535069,382952.21,60ec41ba55c00300382672d9,HDFC,Revenue-Mktplace,5eecc6d6449e4f7cfb1c2708,2022-01-19T00:00:00.000Z,NEFT CR-ICIC0000105-MANASH LIFESTYLE PRI VATE LIMITED NO-SLICK ORGANICS PRIVATE L IMITED MP G-ICIJ220190000452,shopping,,net_banking_transfer,1756.29
61fa340bd8beac15990e6648,50200023535069,384034.87,60ec41ba55c00300382672d9,HDFC,Revenue-Mktplace,5eecc6d6449e4f7cfb1c2708,2022-01-19T00:00:00.000Z,NEFT CR-ICIC0000105-MANASH LIFESTYLE PRI VATE LIMITED NO-SLICK ORGANICS PRIVATE L IMITED MP M-ICIJ220190000453,shopping,,net_banking_transfer,1082.66
61fa340bd8beac15990e664a,50200023535069,411089.68,60ec41ba55c00300382672d9,HDFC,Revenue-UPI,5eecc6d6449e4f7cfb1c2708,2022-01-19T00:00:00.000Z,UPI-GOKWIK-GOKWIK@YESBANK-YESB0000340-20 1909156405-PAYOUT FOR JANUARY,,,upi,27054.81
61fa340bd8beac15990e664c,50200023535069,414371.37,60ec41ba55c00300382672d9,HDFC,Revenue-PG-non-split,5eecc6d6449e4f7cfb1c2708,2022-01-19T00:00:00.000Z,NEFT CR-IDFB0010204-SEZZLE PAYMENTS PRIV ATE LIMITED-SLICK ORGANICS PRIVATE LIMIT ED-IDFBH22019466758,insurance,,net_banking_transfer,3281.69
61fa340bd8beac15990e664e,50200023535069,415208.36,60ec41ba55c00300382672d9,HDFC,Revenue-PG-split enabled,5eecc6d6449e4f7cfb1c2708,2022-01-19T00:00:00.000Z,NEFT CR-UTIB0001506-RAZORPAY SOFTWARE PR IVATE LIMITED-SLICK ORGANICS PVT LITD-AX ISCN0118691279,insurance,,net_banking_transfer,836.99
61fa340bd8beac15990e6650,50200023535069,478910.83,60ec41ba55c00300382672d9,HDFC,Revenue-COD,5eecc6d6449e4f7cfb1c2708,2022-01-19T00:00:00.000Z,NEFT CR-ICIC0000155-SHIPROCKET COD CRF I D 3692336-SLICK ORGANICS PVT LTD-CMS2351 775333,insurance,,net_banking_transfer,63702.47
61fa340bd8beac15990e6652,50200023535069,491810.47,60ec41ba55c00300382672d9,HDFC,Revenue-PG-non-split,5eecc6d6449e4f7cfb1c2708,2022-01-20T00:00:00.000Z,IMPS-202004372628-PAYTM PAYMENTS SERVI-P YTM-XXXXXXXXXX0008-ALL202201202168200003 30830668628,ewallet,,net_banking_transfer,12899.64
61fa340bd8beac15990e6654,50200023535069,236810.47,60ec41ba55c00300382672d9,HDFC,SAAS/tech expense,5eecc6d6449e4f7cfb1c2708,2022-01-20T00:00:00.000Z,POS 514834XXXXXX9486 AMAZON,shopping,,debit_card,-255000
61fa340bd8beac15990e6657,50200023535069,1236810.47,60ec41ba55c00300382672d9,HDFC,Internal Transfers,5eecc6d6449e4f7cfb1c2708,2022-01-20T00:00:00.000Z,IB FUNDS TRANSFER CR-50200035187206 -SL ICK ORGANICS PVT LTD,insurance,,Other,1000000
61fa340bd8beac15990e6659,50200023535069,1238628.8,60ec41ba55c00300382672d9,HDFC,Revenue-PG-split enabled,5eecc6d6449e4f7cfb1c2708,2022-01-20T00:00:00.000Z,NEFT CR-UTIB0001506-RAZORPAY SOFTWARE PR,,,net_banking_transfer,1818.33
61fa340bd8beac15990e665b,50200023535069,558478.8,60ec41ba55c00300382672d9,HDFC,Tax,5eecc6d6449e4f7cfb1c2708,2022-01-20T00:00:00.000Z,051030820012210352- CBDT TAX,,,Other,-680150
61fa340bd8beac15990e665d,50200023535069,159853.8,60ec41ba55c00300382672d9,HDFC,Tax,5eecc6d6449e4f7cfb1c2708,2022-01-20T00:00:00.000Z,051030820012210517- CBDT TAX,,,Other,-398625
61fa340bd8beac15990e665f,50200023535069,154644.98,60ec41ba55c00300382672d9,HDFC,direct expenses,5eecc6d6449e4f7cfb1c2708,2022-01-20T00:00:00.000Z,POS 514834XXXXXX9486 ECOMENGINE* FEED,,,debit_card,-5208.82
61fa340bd8beac15990e6661,50200023535069,141244.98,60ec41ba55c00300382672d9,HDFC,direct expenses,5eecc6d6449e4f7cfb1c2708,2022-01-20T00:00:00.000Z,"NEFT DR-ICIC0006956-LAKSHAY CARRYING COR PORATION-NETBANK, MUM-N020221800551845-1 3400",,,net_banking_transfer,-13400
61fa340bd8beac15990e6663,50200023535069,101328.03,60ec41ba55c00300382672d9,HDFC,direct expenses,5eecc6d6449e4f7cfb1c2708,2022-01-20T00:00:00.000Z,POS 514834XXXXXX9486 THE ROCKET SCIEN,,,debit_card,-39916.95
61fa340bd8beac15990e6665,50200023535069,93978.03,60ec41ba55c00300382672d9,HDFC,direct expenses,5eecc6d6449e4f7cfb1c2708,2022-01-20T00:00:00.000Z,"NEFT DR-SNBK0000012-JAY KHATU LOGISTICS- NETBANK, MUM-N020221800693716-7350",,,net_banking_transfer,-7350
61fa340bd8beac15990e6667,50200023535069,116276.63,60ec41ba55c00300382672d9,HDFC,Revenue-UPI,5eecc6d6449e4f7cfb1c2708,2022-01-20T00:00:00.000Z,UPI-GOKWIK-GOKWIK@YESBANK-YESB0000340-20 2010991906-PAYOUT FOR JANUARY,,,upi,22298.6
61fa340bd8beac15990e6669,50200023535069,119163.17,60ec41ba55c00300382672d9,HDFC,Revenue-PG-non-split,5eecc6d6449e4f7cfb1c2708,2022-01-20T00:00:00.000Z,NEFT CR-KKBK0000958-BROKENTUSK TECHNOLOG IES PRIVATE LIMITED-SLICK ORGANICS PRIVA TE LIMITED-KKBK220203364740,,,net_banking_transfer,2886.54
61fa340bd8beac15990e666b,50200023535069,120611,60ec41ba55c00300382672d9,HDFC,Revenue-PG-non-split,5eecc6d6449e4f7cfb1c2708,2022-01-20T00:00:00.000Z,NEFT CR-IDFB0010204-SEZZLE PAYMENTS PRIV ATE LIMITED-SLICK ORGANICS PRIVATE LIMIT ED-IDFBH22020537550,insurance,,net_banking_transfer,1447.83
61fa340bd8beac15990e666d,50200023535069,120682.23,60ec41ba55c00300382672d9,HDFC,Revenue-PG-split enabled,5eecc6d6449e4f7cfb1c2708,2022-01-20T00:00:00.000Z,NEFT CR-UTIB0001506-RAZORPAY SOFTWARE PR IVATE LIMITED-SLICK ORGANICS PVT LITD-AX ISCN0118827609,insurance,,net_banking_transfer,71.23
61fa340bd8beac15990e666f,50200023535069,20443.23,60ec41ba55c00300382672d9,HDFC,Tax,5eecc6d6449e4f7cfb1c2708,2022-01-20T00:00:00.000Z,GST/BANK REFERENCE NO: R2202032022157/CI N NO: HDFC22010700263107,,,Other,-100239
61fa340bd8beac15990e6671,50200023535069,220443.23,60ec41ba55c00300382672d9,HDFC,Internal Transfers,5eecc6d6449e4f7cfb1c2708,2022-01-20T00:00:00.000Z,IB FUNDS TRANSFER CR-50200035187206 -SL ICK ORGANICS PVT LTD,insurance,,Other,200000
61fa340bd8beac15990e6673,50200023535069,229739.36,60ec41ba55c00300382672d9,HDFC,Revenue-Mktplace,5eecc6d6449e4f7cfb1c2708,2022-01-21T00:00:00.000Z,NEFT CR-DEUT0797BGL-FLIPKART INTERNET PR IVATE LIMITED-SLICK ORGANICS PVT LTD-202 100135GN00039,shopping,,net_banking_transfer,9296.13
61fa340bd8beac15990e6675,50200023535069,241774.9,60ec41ba55c00300382672d9,HDFC,Revenue-PG-non-split,5eecc6d6449e4f7cfb1c2708,2022-01-21T00:00:00.000Z,IMPS-202104723957-PAYTM PAYMENTS SERVI-P,ewallet,,net_banking_transfer,12035.54
61fa340bd8beac15990e6677,50200023535069,243935.43,60ec41ba55c00300382672d9,HDFC,Revenue-Mktplace,5eecc6d6449e4f7cfb1c2708,2022-01-21T00:00:00.000Z,NEFT CR-DEUT0797BGL-MYNTRA DESIGNS PRIVA TE LIMITED-SLICK ORGANICS PVT. LTD.-2021 00579GN00128,shopping,,net_banking_transfer,2160.53
61fa340bd8beac15990e6679,50200023535069,244761.53,60ec41ba55c00300382672d9,HDFC,Revenue-Mktplace,5eecc6d6449e4f7cfb1c2708,2022-01-21T00:00:00.000Z,NEFT CR-DEUT0797BGL-MYNTRA DESIGNS PRIVA TE LIMITED-SLICK ORGANICS PVT. LTD.-2021 00578GN00126,shopping,,net_banking_transfer,826.1
61fa340bd8beac15990e667b,50200023535069,245445.68,60ec41ba55c00300382672d9,HDFC,Revenue-PG-split enabled,5eecc6d6449e4f7cfb1c2708,2022-01-21T00:00:00.000Z,NEFT CR-UTIB0001506-RAZORPAY SOFTWARE PR IVATE LIMITED-SLICK ORGANICS PVT LITD-AX ISCN0118876996,insurance,,net_banking_transfer,684.15
61fa340bd8beac15990e667d,50200023535069,21445.68,60ec41ba55c00300382672d9,HDFC,direct expenses,5eecc6d6449e4f7cfb1c2708,2022-01-21T00:00:00.000Z,"NEFT DR-YESB0000162-VINAY REDDY-NETBANK, MUM-N021221801568837-224000",,,net_banking_transfer,-224000
61fa340bd8beac15990e667f,50200023535069,221445.68,60ec41ba55c00300382672d9,HDFC,Internal Transfers,5eecc6d6449e4f7cfb1c2708,2022-01-21T00:00:00.000Z,IB FUNDS TRANSFER CR-50200035187206 -SL ICK ORGANICS PVT LTD,insurance,,Other,200000
61fa340bd8beac15990e6681,50200023535069,221846.56,60ec41ba55c00300382672d9,HDFC,Revenue-Mktplace,5eecc6d6449e4f7cfb1c2708,2022-01-21T00:00:00.000Z,NEFT CR-DEUT0784BBY-TATA UNISTORE LIMITE D-SLICK ORGANICS PVT LTD-202101236GN0022 9,insurance,,net_banking_transfer,400.88
61fa340bd8beac15990e6683,50200023535069,250516.05,60ec41ba55c00300382672d9,HDFC,Revenue-COD,5eecc6d6449e4f7cfb1c2708,2022-01-21T00:00:00.000Z,NEFT CR-ICIC0000155-SHIPROCKET COD CRF I D 3704573-SLICK ORGANICS PVT LTD-CMS2355 602419,insurance,,net_banking_transfer,28669.49
61fa340bd8beac15990e6685,50200023535069,254553.72,60ec41ba55c00300382672d9,HDFC,Revenue-PG-non-split,5eecc6d6449e4f7cfb1c2708,2022-01-21T00:00:00.000Z,NEFT CR-IDFB0010204-SEZZLE PAYMENTS PRIV ATE LIMITED-SLICK ORGANICS PRIVATE LIMIT ED-IDFBH22021634645,insurance,,net_banking_transfer,4037.67
61fa340bd8beac15990e6687,50200023535069,261207.72,60ec41ba55c00300382672d9,HDFC,Transfer in/Revenue-other,5eecc6d6449e4f7cfb1c2708,2022-01-21T00:00:00.000Z,NEFT CR-KKBK0000958-INNOVATIVE RETAIL CO NCEPTS PRIVATE LTD-SLICK ORGANICS PVT LT D-KKBK220213664397,,,net_banking_transfer,6654
61fa340bd8beac15990e6689,50200023535069,266205.72,60ec41ba55c00300382672d9,HDFC,Transfer in/Revenue-other,5eecc6d6449e4f7cfb1c2708,2022-01-21T00:00:00.000Z,NEFT CR-KKBK0000958-INNOVATIVE RETAIL CO NCEPTS PRIVATE LTD-SLICK ORGANICS PVT LT D-KKBK220213668384,,,net_banking_transfer,4998
61fa340bd8beac15990e668b,50200023535069,266446.46,60ec41ba55c00300382672d9,HDFC,Transfer in/Revenue-other,5eecc6d6449e4f7cfb1c2708,2022-01-21T00:00:00.000Z,NEFT CR-YESB0000001-ILLUMINAR MEDIA-SLIC K ORGANICS PVT LTD-N021220973061273,,,net_banking_transfer,240.74
61fa340cd8beac15990e668d,50200023535069,267360.46,60ec41ba55c00300382672d9,HDFC,Revenue-COD,5eecc6d6449e4f7cfb1c2708,2022-01-21T00:00:00.000Z,NEFT CR-KKBK0000958-PICKRR TECHNOLOGIES,,,net_banking_transfer,914
61fa340cd8beac15990e668f,50200023535069,285560.46,60ec41ba55c00300382672d9,HDFC,Revenue-PG-non-split,5eecc6d6449e4f7cfb1c2708,2022-01-22T00:00:00.000Z,IMPS-202204995334-PAYTM PAYMENTS SERVI-P YTM-XXXXXXXXXX0008-ALL202201222168200003 30830668628,ewallet,,net_banking_transfer,18200
61fa340cd8beac15990e6691,50200023535069,-21108.54,60ec41ba55c00300382672d9,HDFC,N-ACH payments,5eecc6d6449e4f7cfb1c2708,2022-01-22T00:00:00.000Z,ACH D- CTRAZORPAY-GETVANTAGEIMP5H1MX4KP2,loans,lender_transaction,auto_debit_payment,-306669
61fa340cd8beac15990e6693,50200023535069,285560.46,60ec41ba55c00300382672d9,HDFC,Revenue-PG-split enabled,5eecc6d6449e4f7cfb1c2708,2022-01-22T00:00:00.000Z,ACH D- CTRAZORPAY-GETVANTAGEIMP5H1MX4KP2,,,Other,306669
61fa340cd8beac15990e6695,50200023535069,248242.86,60ec41ba55c00300382672d9,HDFC,SAAS/tech expense,5eecc6d6449e4f7cfb1c2708,2022-01-22T00:00:00.000Z,POS 514834XXXXXX9486 AMAZON.COM,shopping,,debit_card,-37317.6
61fa340cd8beac15990e6697,50200023535069,273846.77,60ec41ba55c00300382672d9,HDFC,Revenue-UPI,5eecc6d6449e4f7cfb1c2708,2022-01-22T00:00:00.000Z,UPI-GOKWIK-GOKWIK@YESBANK-YESB0000340-20 2215377898-PAYOUT FOR JANUARY,,,upi,25603.91
61fa340cd8beac15990e6699,50200023535069,202894.77,60ec41ba55c00300382672d9,HDFC,direct expenses,5eecc6d6449e4f7cfb1c2708,2022-01-22T00:00:00.000Z,"NEFT DR-KKBK0005289-HILL GROOVE CONSULTI NG LLP-NETBANK, MUM-N022221803399122-709 52",,,net_banking_transfer,-70952
61fa340cd8beac15990e669b,50200023535069,702894.77,60ec41ba55c00300382672d9,HDFC,Internal Transfers,5eecc6d6449e4f7cfb1c2708,2022-01-22T00:00:00.000Z,IB FUNDS TRANSFER CR-50200035187206 -SL ICK ORGANICS PVT LTD,insurance,,Other,500000
61fa340cd8beac15990e669d,50200023535069,682735.77,60ec41ba55c00300382672d9,HDFC,direct expenses,5eecc6d6449e4f7cfb1c2708,2022-01-22T00:00:00.000Z,"NEFT DR-CITI0000002-OMG NETWORK INDIA PR IVATE LIMITED-NETBANK, MUM-N022221803437 236-20159",,,net_banking_transfer,-20159
61fa340cd8beac15990e669f,50200023535069,761069.79,60ec41ba55c00300382672d9,HDFC,Revenue-PG-non-split,5eecc6d6449e4f7cfb1c2708,2022-01-23T00:00:00.000Z,NEFT CR-PYTM0123456-PAYTM PAYMENTS SERVI CES LIMITED-SLICK ORGANICS PVT LTD-PYTM2 20234148928,ewallet,,net_banking_transfer,78334.02
61fa340cd8beac15990e66a1,50200023535069,771894.51,60ec41ba55c00300382672d9,HDFC,Revenue-Mktplace,5eecc6d6449e4f7cfb1c2708,2022-01-24T00:00:00.000Z,NEFT CR-DEUT0797BGL-FLIPKART INTERNET PR IVATE LIMITED-SLICK ORGANICS PVT LTD-202 400129GN00083,shopping,,net_banking_transfer,10824.72
61fa340cd8beac15990e66a3,50200023535069,835630.13,60ec41ba55c00300382672d9,HDFC,Revenue-PG-non-split,5eecc6d6449e4f7cfb1c2708,2022-01-24T00:00:00.000Z,NEFT CR-PYTM0123456-PAYTM PAYMENTS SERVI CES LIMITED-SLICK ORGANICS PVT LTD-PYTM2 20244734085,ewallet,,net_banking_transfer,63735.62
61fa340cd8beac15990e66a5,50200023535069,963106,60ec41ba55c00300382672d9,HDFC,Revenue-UPI,5eecc6d6449e4f7cfb1c2708,2022-01-24T00:00:00.000Z,UPI-GOKWIK-GOKWIK@YESBANK-YESB0000340-20 2418583460-PAYOUT FOR JANUARY,,,upi,127475.87
61fa340cd8beac15990e66a7,50200023535069,967600.12,60ec41ba55c00300382672d9,HDFC,Revenue-Mktplace,5eecc6d6449e4f7cfb1c2708,2022-01-24T00:00:00.000Z,NEFT CR-DEUT0797BGL-FLIPKART INTERNET PR IVATE LIMITED-SLICK ORGANICS PVT LTD-202 400229GN00299,shopping,,net_banking_transfer,4494.12
61fa340cd8beac15990e66a9,50200023535069,970365.12,60ec41ba55c00300382672d9,HDFC,Revenue-PG-split enabled,5eecc6d6449e4f7cfb1c2708,2022-01-24T00:00:00.000Z,NEFT CR-UTIB0001506-RAZORPAY SOFTWARE PR,,,net_banking_transfer,2765
61fa340cd8beac15990e66ab,50200023535069,470365.12,60ec41ba55c00300382672d9,HDFC,direct expenses,5eecc6d6449e4f7cfb1c2708,2022-01-24T00:00:00.000Z,"NEFT DR-YESB0000551-VISTTA COSMETICS-NET BANK, MUM-N024221803864910-500000",,,net_banking_transfer,-500000
61fa340cd8beac15990e66ad,50200023535069,468829.01,60ec41ba55c00300382672d9,HDFC,bank charges,5eecc6d6449e4f7cfb1c2708,2022-01-24T00:00:00.000Z,.DC INTL POS TXN MARKUP+ST 100122 110122 -CDT2200207256855,,,international_transaction_arbitrage,-1536.11
61fa340cd8beac15990e66af,50200023535069,468675.56,60ec41ba55c00300382672d9,HDFC,bank charges,5eecc6d6449e4f7cfb1c2708,2022-01-24T00:00:00.000Z,.DC INTL POS TXN MARKUP+ST 100122 120122 -CDT2200207256855,,,international_transaction_arbitrage,-153.45
61fa340cd8beac15990e66b1,50200023535069,487119.01,60ec41ba55c00300382672d9,HDFC,Revenue-UPI,5eecc6d6449e4f7cfb1c2708,2022-01-24T00:00:00.000Z,UPI-GOKWIK-GOKWIK@YESBANK-YESB0000340-20 2419235176-PAYOUT FOR JANUARY,,,upi,18443.45
61fa340cd8beac15990e66b3,50200023535069,1487119.01,60ec41ba55c00300382672d9,HDFC,Internal Transfers,5eecc6d6449e4f7cfb1c2708,2022-01-24T00:00:00.000Z,IB FUNDS TRANSFER CR-50200035187206 -SL ICK ORGANICS PVT LTD,insurance,,Other,1000000
61fa340cd8beac15990e66b5,50200023535069,1489370.83,60ec41ba55c00300382672d9,HDFC,Revenue-Mktplace,5eecc6d6449e4f7cfb1c2708,2022-01-24T00:00:00.000Z,NEFT CR-ICIC0000105-MANASH LIFESTYLE PRI VATE LIMITED NO-SLICK ORGANICS PRIVATE L IMITED MP M-ICIJ220240000406,shopping,,net_banking_transfer,2251.82
61fa340cd8beac15990e66b7,50200023535069,1491673.98,60ec41ba55c00300382672d9,HDFC,Revenue-Mktplace,5eecc6d6449e4f7cfb1c2708,2022-01-24T00:00:00.000Z,NEFT CR-ICIC0000105-MANASH LIFESTYLE PRI VATE LIMITED NO-SLICK ORGANICS PRIVATE L IMITED MP G-ICIJ220240002406,shopping,,net_banking_transfer,2303.15
61fa340cd8beac15990e66b9,50200023535069,1492083.73,60ec41ba55c00300382672d9,HDFC,Revenue-Mktplace,5eecc6d6449e4f7cfb1c2708,2022-01-24T00:00:00.000Z,NEFT CR-ICIC0000105-MANASH LIFESTYLE PRI VATE LIMITED NO-SLICK ORGANICS PRIVATE L IMITED BANG-ICIJ220240000407,shopping,,net_banking_transfer,409.75
61fa340cd8beac15990e66bb,50200023535069,492083.73,60ec41ba55c00300382672d9,HDFC,Marketing Expense,5eecc6d6449e4f7cfb1c2708,2022-01-24T00:00:00.000Z,"NEFT DR-CITI0000006-FACEBOOK INDIA ONLIN E SERVICES PVT LTD-NETBANK, MUM-N0242218 04242080-1000000",,,net_banking_transfer,-1000000
61fa340cd8beac15990e66bd,50200023535069,163545.73,60ec41ba55c00300382672d9,HDFC,direct expenses,5eecc6d6449e4f7cfb1c2708,2022-01-24T00:00:00.000Z,"NEFT DR-KKBK0004583-PICKRR TECHNOLOGIES PVT LTD-NETBANK, MUM-N024221804274112-32 8538",,,net_banking_transfer,-328538
61fa340cd8beac15990e66bf,50200023535069,162004.28,60ec41ba55c00300382672d9,HDFC,bank charges,5eecc6d6449e4f7cfb1c2708,2022-01-24T00:00:00.000Z,.DC INTL POS TXN MARKUP+ST 160122 170122 -CDT2200207256855,,,international_transaction_arbitrage,-1541.45
61fa340cd8beac15990e66c1,50200023535069,163015.53,60ec41ba55c00300382672d9,HDFC,Revenue-COD,5eecc6d6449e4f7cfb1c2708,2022-01-24T00:00:00.000Z,NEFT CR-ICIC0000155-SHIPROCKET COD CRF I,,,net_banking_transfer,1011.25
61fa340cd8beac15990e66c3,50200023535069,263015.53,60ec41ba55c00300382672d9,HDFC,Internal Transfers,5eecc6d6449e4f7cfb1c2708,2022-01-24T00:00:00.000Z,IB FUNDS TRANSFER CR-50200035187206 -SL ICK ORGANICS PVT LTD,insurance,,Other,100000
61fa340cd8beac15990e66c5,50200023535069,663015.53,60ec41ba55c00300382672d9,HDFC,Internal Transfers,5eecc6d6449e4f7cfb1c2708,2022-01-24T00:00:00.000Z,IB FUNDS TRANSFER CR-50200035187206 -SL ICK ORGANICS PVT LTD,insurance,,Other,400000
61fa340cd8beac15990e66c7,50200023535069,613015.53,60ec41ba55c00300382672d9,HDFC,SAAS/tech expense,5eecc6d6449e4f7cfb1c2708,2022-01-24T00:00:00.000Z,POS 514834XXXXXX9486 AMAZON,shopping,,debit_card,-50000
61fa340cd8beac15990e66c9,50200023535069,669770.78,60ec41ba55c00300382672d9,HDFC,Revenue-PG-non-split,5eecc6d6449e4f7cfb1c2708,2022-01-25T00:00:00.000Z,NEFT CR-PYTM0123456-PAYTM PAYMENTS SERVI CES LIMITED-SLICK ORGANICS PVT LTD-PYTM2 20255373948,ewallet,,net_banking_transfer,56755.25
61fa340cd8beac15990e66cb,50200023535069,730686.71,60ec41ba55c00300382672d9,HDFC,Revenue-Mktplace,5eecc6d6449e4f7cfb1c2708,2022-01-25T00:00:00.000Z,IMPS-202505138095-AMAZON SELLER SERVIC-H SBC-XXXXXXXX6004-6VDT9FLV15DN20DESLICK O RGANICS PVT LTD,shopping,,net_banking_transfer,60915.93
61fa340cd8beac15990e66cd,50200023535069,877381.39,60ec41ba55c00300382672d9,HDFC,Revenue-Mktplace,5eecc6d6449e4f7cfb1c2708,2022-01-25T00:00:00.000Z,NEFT CR-DEUT0797BGL-AMAZON PAY (INDIA) P RIVATE LIMITED-SLICK ORGANICS PVT LTD-20 2500604GN00658,shopping,,net_banking_transfer,146694.68
61fa340cd8beac15990e66cf,50200023535069,838846.39,60ec41ba55c00300382672d9,HDFC,direct expenses,5eecc6d6449e4f7cfb1c2708,2022-01-25T00:00:00.000Z,"NEFT DR-SCBL0036025-DHRUV MADHOK-NETBANK , MUM-N025221805277379-38535",,,net_banking_transfer,-38535
61fa340cd8beac15990e66d1,50200023535069,842703.18,60ec41ba55c00300382672d9,HDFC,Revenue-Mktplace,5eecc6d6449e4f7cfb1c2708,2022-01-25T00:00:00.000Z,NEFT CR-DEUT0797BGL-MYNTRA DESIGNS PRIVA TE LIMITED-SLICK ORGANICS PVT. LTD.-2025 00855GN00127,shopping,,net_banking_transfer,3856.79
61fa340cd8beac15990e66d3,50200023535069,844355.91,60ec41ba55c00300382672d9,HDFC,Revenue-Mktplace,5eecc6d6449e4f7cfb1c2708,2022-01-25T00:00:00.000Z,NEFT CR-DEUT0797BGL-MYNTRA DESIGNS PRIVA TE LIMITED-SLICK ORGANICS PVT. LTD.-2025 00854GN00135,shopping,,net_banking_transfer,1652.73
61fa340cd8beac15990e66d5,50200023535069,662435.91,60ec41ba55c00300382672d9,HDFC,direct expenses,5eecc6d6449e4f7cfb1c2708,2022-01-25T00:00:00.000Z,"NEFT DR-ICIC0000031-HORA ART CENTRE PRIV ATE LIMITED-NETBANK, MUM-N02522180555635 5-181920",,,net_banking_transfer,-181920
61fa340cd8beac15990e66d7,50200023535069,663851.35,60ec41ba55c00300382672d9,HDFC,Revenue-Mktplace,5eecc6d6449e4f7cfb1c2708,2022-01-25T00:00:00.000Z,NEFT CR-ICIC0000105-MANASH LIFESTYLE PRI VATE LIMITED NO-SLICK ORGANICS PRIVATE L IMITED MP G-ICIJ220250002432,shopping,,net_banking_transfer,1415.44
61fa340cd8beac15990e66d9,50200023535069,665540.92,60ec41ba55c00300382672d9,HDFC,Revenue-Mktplace,5eecc6d6449e4f7cfb1c2708,2022-01-25T00:00:00.000Z,NEFT CR-ICIC0000105-MANASH LIFESTYLE PRI VATE LIMITED NO-SLICK ORGANICS PRIVATE L IMITED MP M-ICIJ220250000406,shopping,,net_banking_transfer,1689.57
61fa340cd8beac15990e66db,50200023535069,635396.92,60ec41ba55c00300382672d9,HDFC,direct expenses,5eecc6d6449e4f7cfb1c2708,2022-01-25T00:00:00.000Z,NEFT DR-UTIB0001964-BLUE BELLS EVENTS AN,,,net_banking_transfer,-30144
61fa340cd8beac15990e66dd,50200023535069,632203.92,60ec41ba55c00300382672d9,HDFC,direct expenses,5eecc6d6449e4f7cfb1c2708,2022-01-25T00:00:00.000Z,"NEFT DR-ICIC0000021-AKHILESH DIXIT-NETBA NK, MUM-N025221805656423-3193",,,net_banking_transfer,-3193
61fa340cd8beac15990e66df,50200023535069,485821.92,60ec41ba55c00300382672d9,HDFC,direct expenses,5eecc6d6449e4f7cfb1c2708,2022-01-25T00:00:00.000Z,"NEFT DR-KKBK0000208-SYSCOM PACKAGING COM PANY-NETBANK, MUM-N025221805774528-14638 2",,,net_banking_transfer,-146382
61fa340cd8beac15990e66e1,50200023535069,597435.05,60ec41ba55c00300382672d9,HDFC,Revenue-UPI,5eecc6d6449e4f7cfb1c2708,2022-01-25T00:00:00.000Z,UPI-GOKWIK-GOKWIK@YESBANK-YESB0000340-20 2521411902-PAYOUT FOR JANUARY,,,upi,111613.13
61fa340cd8beac15990e66e3,50200023535069,600034.05,60ec41ba55c00300382672d9,HDFC,Revenue-Mktplace,5eecc6d6449e4f7cfb1c2708,2022-01-25T00:00:00.000Z,NEFT CR-KKBK0000958-SURFBOATS SOLUTIONS PVT LTD-SLICK ORGANICS PRIVATE LIMITED-C MS0252206438620,insurance,,net_banking_transfer,2599
61fa340cd8beac15990e66e5,50200023535069,610540.45,60ec41ba55c00300382672d9,HDFC,Revenue-PG-non-split,5eecc6d6449e4f7cfb1c2708,2022-01-25T00:00:00.000Z,NEFT CR-IDFB0010204-SEZZLE PAYMENTS PRIV ATE LIMITED-SLICK ORGANICS PRIVATE LIMIT ED-IDFBH22025872742,insurance,,net_banking_transfer,10506.4
61fa340cd8beac15990e66e7,50200023535069,614235.14,60ec41ba55c00300382672d9,HDFC,Revenue-PG-split enabled,5eecc6d6449e4f7cfb1c2708,2022-01-25T00:00:00.000Z,NEFT CR-UTIB0001506-RAZORPAY SOFTWARE PR IVATE LIMITED-SLICK ORGANICS PVT LITD-AX ISCN0119428184,insurance,,net_banking_transfer,3694.69
61fa340cd8beac15990e66e9,50200023535069,359235.14,60ec41ba55c00300382672d9,HDFC,SAAS/tech expense,5eecc6d6449e4f7cfb1c2708,2022-01-25T00:00:00.000Z,POS 514834XXXXXX9486 AMAZON,shopping,,debit_card,-255000
61fa340cd8beac15990e66eb,50200023535069,397894.14,60ec41ba55c00300382672d9,HDFC,Revenue-Mktplace,5eecc6d6449e4f7cfb1c2708,2022-01-25T00:00:00.000Z,NEFT CR-ICIC0SF0002-THREPSI SOLUTIONS PV -SLICK ORGANICS PRIVATE LIMITED-26122480 661DC,insurance,,net_banking_transfer,38659
61fa340cd8beac15990e66ed,50200023535069,418284.14,60ec41ba55c00300382672d9,HDFC,Revenue-Mktplace,5eecc6d6449e4f7cfb1c2708,2022-01-25T00:00:00.000Z,NEFT CR-SCBL0036001-M/S DREAMPLUG TECHNO -SLICK ORGANICS PRIVATE LIMITEDSLICK-SIN 31436Q0030910,insurance,,net_banking_transfer,20390
61fa340cd8beac15990e66ef,50200023535069,486052.01,60ec41ba55c00300382672d9,HDFC,Revenue-PG-non-split,5eecc6d6449e4f7cfb1c2708,2022-01-26T00:00:00.000Z,NEFT CR-PYTM0123456-PAYTM PAYMENTS SERVI CES LIMITED-SLICK ORGANICS PVT LTD-PYTM2 20266040967,ewallet,,net_banking_transfer,67767.87
61fa340cd8beac15990e66f1,50200023535069,179383.01,60ec41ba55c00300382672d9,HDFC,N-ACH payments,5eecc6d6449e4f7cfb1c2708,2022-01-26T00:00:00.000Z,ACH D- CTRAZORPAY-GETVANTAGEINXJGOFKC3F7,loans,lender_transaction,auto_debit_payment,-306669
61fa340cd8beac15990e66f3,50200023535069,679383.01,60ec41ba55c00300382672d9,HDFC,Internal Transfers,5eecc6d6449e4f7cfb1c2708,2022-01-26T00:00:00.000Z,IB FUNDS TRANSFER CR-50200035187206 -SL ICK ORGANICS PVT LTD,insurance,,Other,500000
61fa340cd8beac15990e66f5,50200023535069,477754.18,60ec41ba55c00300382672d9,HDFC,direct expenses,5eecc6d6449e4f7cfb1c2708,2022-01-26T00:00:00.000Z,POS 514834XXXXXX9486 SHOPIFY* 1304729,,,debit_card,-201628.83
61fa340cd8beac15990e66f7,50200023535069,475646.21,60ec41ba55c00300382672d9,HDFC,direct expenses,5eecc6d6449e4f7cfb1c2708,2022-01-26T00:00:00.000Z,POS 514834XXXXXX9486 SHOPIFY* 1250497,,,debit_card,-2107.97
61fa340cd8beac15990e66f9,50200023535069,565278,60ec41ba55c00300382672d9,HDFC,Revenue-UPI,5eecc6d6449e4f7cfb1c2708,2022-01-26T00:00:00.000Z,UPI-GOKWIK-GOKWIK@YESBANK-YESB0000340-20 2623566248-PAYOUT FOR JANUARY,,,upi,89631.79
61fa340cd8beac15990e66fb,50200023535069,697239.49,60ec41ba55c00300382672d9,HDFC,Revenue-PG-non-split,5eecc6d6449e4f7cfb1c2708,2022-01-27T00:00:00.000Z,NEFT CR-PYTM0123456-PAYTM PAYMENTS SERVI CES LIMITED-SLICK ORGANICS PVT LTD-PYTM2 20276702197,ewallet,,net_banking_transfer,131961.49
61fa340cd8beac15990e66ff,50200023535069,697668.57,60ec41ba55c00300382672d9,HDFC,Revenue-Mktplace,5eecc6d6449e4f7cfb1c2708,2022-01-27T00:00:00.000Z,NEFT CR-DEUT0797BGL-MYNTRA DESIGNS PRIVA TE LIMITED-SLICK ORGANICS PVT. LTD.-2026 00411GN00101,shopping,,net_banking_transfer,429.08
61fa340cd8beac15990e6701,50200023535069,704220.43,60ec41ba55c00300382672d9,HDFC,Revenue-PG-split enabled,5eecc6d6449e4f7cfb1c2708,2022-01-27T00:00:00.000Z,NEFT CR-UTIB0001506-RAZORPAY SOFTWARE PR IVATE LIMITED-SLICK ORGANICS PVT LITD-AX ISCN0119488124,insurance,,net_banking_transfer,6551.86
61fa340cd8beac15990e6704,50200023535069,701860.43,60ec41ba55c00300382672d9,HDFC,direct expenses,5eecc6d6449e4f7cfb1c2708,2022-01-27T00:00:00.000Z,"NEFT DR-KKBK0000173-MATRIX PRINTING SOLU TIONS PRIVATE LIMITE-NETBANK, MUM-N02722 1807304752-2360",,,net_banking_transfer,-2360
61fa340cd8beac15990e6706,50200023535069,699562.43,60ec41ba55c00300382672d9,HDFC,direct expenses,5eecc6d6449e4f7cfb1c2708,2022-01-27T00:00:00.000Z,"NEFT DR-ICIC0000021-AKHILESH DIXIT-NETBA NK, MUM-N027221807309518-2298",,,net_banking_transfer,-2298
61fa340cd8beac15990e6708,50200023535069,686110.43,60ec41ba55c00300382672d9,HDFC,direct expenses,5eecc6d6449e4f7cfb1c2708,2022-01-27T00:00:00.000Z,"NEFT DR-SBIN0008078-PANDIT PLASTICS-NETB ANK, MUM-N027221807318120-13452",,,net_banking_transfer,-13452
61fa340cd8beac15990e670a,50200023535069,667409.43,60ec41ba55c00300382672d9,HDFC,agency/vendor expense,5eecc6d6449e4f7cfb1c2708,2022-01-27T00:00:00.000Z,"NEFT DR-KKBK0000298-ADMITAD MEDIA PRIVAT E LIMITED-NETBANK, MUM-N027221807318535- 18701",loans,lender_transaction,net_banking_transfer,-18701
61fa340cd8beac15990e670c,50200023535069,587409.43,60ec41ba55c00300382672d9,HDFC,direct expenses,5eecc6d6449e4f7cfb1c2708,2022-01-27T00:00:00.000Z,50100297431252-TPT-80000-KOMALPREET KAUR,,,net_banking_transfer,-80000
61fa340cd8beac15990e670e,50200023535069,574309.43,60ec41ba55c00300382672d9,HDFC,direct expenses,5eecc6d6449e4f7cfb1c2708,2022-01-27T00:00:00.000Z,"NEFT DR-ICIC0006956-LAKSHAY CARRYING COR PORATION-NETBANK, MUM-N027221807333311-1 3100",,,net_banking_transfer,-13100
61fa340cd8beac15990e6710,50200023535069,542445.43,60ec41ba55c00300382672d9,HDFC,direct expenses,5eecc6d6449e4f7cfb1c2708,2022-01-27T00:00:00.000Z,"NEFT DR-KKBK0000218-MONETIZE INFO LLP-NE TBANK, MUM-N027221807342405-31864",,,net_banking_transfer,-31864
61fa340cd8beac15990e6712,50200023535069,542294.4,60ec41ba55c00300382672d9,HDFC,bank charges,5eecc6d6449e4f7cfb1c2708,2022-01-27T00:00:00.000Z,.DC INTL POS TXN MARKUP+ST 180122 200122 -CDT2200207256855,,,international_transaction_arbitrage,-151.03
61fa340cd8beac15990e6714,50200023535069,540191.48,60ec41ba55c00300382672d9,HDFC,bank charges,5eecc6d6449e4f7cfb1c2708,2022-01-27T00:00:00.000Z,.DC INTL POS TXN MARKUP+ST 180122 200122,,,international_transaction_arbitrage,-2102.92
61fa340cd8beac15990e6716,50200023535069,490191.48,60ec41ba55c00300382672d9,HDFC,direct expenses,5eecc6d6449e4f7cfb1c2708,2022-01-27T00:00:00.000Z,50200060178580-TPT-50000-CITREA GROWTH P ARTNERS PRIVATE LIMITED,,,net_banking_transfer,-50000
61fa340cd8beac15990e6718,50200023535069,500302.17,60ec41ba55c00300382672d9,HDFC,Revenue-PG-non-split,5eecc6d6449e4f7cfb1c2708,2022-01-27T00:00:00.000Z,NEFT CR-KKBK0000958-BROKENTUSK TECHNOLOG IES PRIVATE LIMITED-SLICK ORGANICS PRIVA TE LIMITED-KKBK220274817682,,,net_banking_transfer,10110.69
61fa340cd8beac15990e671a,50200023535069,579359.56,60ec41ba55c00300382672d9,HDFC,Revenue-COD,5eecc6d6449e4f7cfb1c2708,2022-01-27T00:00:00.000Z,NEFT CR-ICIC0000155-SHIPROCKET COD CRF I D 3724156-SLICK ORGANICS PVT LTD-CMS2363 695854,insurance,,net_banking_transfer,79057.39
61fa340cd8beac15990e671c,50200023535069,580650.21,60ec41ba55c00300382672d9,HDFC,Revenue-PG-split enabled,5eecc6d6449e4f7cfb1c2708,2022-01-27T00:00:00.000Z,NEFT CR-UTIB0001506-RAZORPAY SOFTWARE PR IVATE LIMITED-SLICK ORGANICS PVT LITD-AX ISCN0119598587,insurance,,net_banking_transfer,1290.65
61fa340cd8beac15990e671e,50200023535069,588908.9,60ec41ba55c00300382672d9,HDFC,Revenue-PG-non-split,5eecc6d6449e4f7cfb1c2708,2022-01-27T00:00:00.000Z,NEFT CR-IDFB0010204-SEZZLE PAYMENTS PRIV ATE LIMITED-SLICK ORGANICS PRIVATE LIMIT ED-IDFBH22027992321,insurance,,net_banking_transfer,8258.69
61fa340cd8beac15990e6720,50200023535069,589179.9,60ec41ba55c00300382672d9,HDFC,Revenue-COD,5eecc6d6449e4f7cfb1c2708,2022-01-27T00:00:00.000Z,NEFT CR-KKBK0000958-PICKRR TECHNOLOGIES PVT LTD-SLICKORGANICSPRIVATELIMITED-CMS0 272206535872,insurance,,net_banking_transfer,271
61fa340cd8beac15990e6722,50200023535069,683382.11,60ec41ba55c00300382672d9,HDFC,Revenue-UPI,5eecc6d6449e4f7cfb1c2708,2022-01-27T00:00:00.000Z,UPI-GOKWIK-GOKWIK@YESBANK-YESB0000340-20 2725212408-PAYOUT FOR JANUARY,,,upi,94202.21
61fa340cd8beac15990e6724,50200023535069,716638.03,60ec41ba55c00300382672d9,HDFC,Revenue-Mktplace,5eecc6d6449e4f7cfb1c2708,2022-01-28T00:00:00.000Z,NEFT CR-DEUT0797BGL-FLIPKART INTERNET PR IVATE LIMITED-SLICK ORGANICS PVT LTD-202 800138GN00133,shopping,,net_banking_transfer,33255.92
61fa340cd8beac15990e6726,50200023535069,755658.77,60ec41ba55c00300382672d9,HDFC,Revenue-Mktplace,5eecc6d6449e4f7cfb1c2708,2022-01-28T00:00:00.000Z,NEFT CR-DEUT0797BGL-FLIPKART INTERNET PR IVATE LIMITED-SLICK ORGANICS PVT LTD-202 800172GN00149,shopping,,net_banking_transfer,39020.74
61fa340cd8beac15990e6728,50200023535069,769686.46,60ec41ba55c00300382672d9,HDFC,Revenue-PG-non-split,5eecc6d6449e4f7cfb1c2708,2022-01-28T00:00:00.000Z,IMPS-202804634219-PAYTM PAYMENTS SERVI-P YTM-XXXXXXXXXX0008-ALL202201282168200003 30830668628,ewallet,,net_banking_transfer,14027.69
61fa340cd8beac15990e672a,50200023535069,770419.64,60ec41ba55c00300382672d9,HDFC,Revenue-Mktplace,5eecc6d6449e4f7cfb1c2708,2022-01-28T00:00:00.000Z,NEFT CR-DEUT0797BGL-MYNTRA DESIGNS PRIVA TE LIMITED-SLICK ORGANICS PVT. LTD.-2028 00633GN00130,shopping,,net_banking_transfer,733.18
61fa340cd8beac15990e672c,50200023535069,771734.67,60ec41ba55c00300382672d9,HDFC,Revenue-Mktplace,5eecc6d6449e4f7cfb1c2708,2022-01-28T00:00:00.000Z,NEFT CR-DEUT0797BGL-MYNTRA DESIGNS PRIVA,shopping,,net_banking_transfer,1315.03
61fa340cd8beac15990e672e,50200023535069,771927.67,60ec41ba55c00300382672d9,HDFC,Revenue-PG-split enabled,5eecc6d6449e4f7cfb1c2708,2022-01-28T00:00:00.000Z,NEFT CR-UTIB0001506-RAZORPAY SOFTWARE PR IVATE LIMITED-SLICK ORGANICS PVT LITD-AX ISCN0119674987,insurance,,net_banking_transfer,193
61fa340cd8beac15990e6730,50200023535069,718052.67,60ec41ba55c00300382672d9,HDFC,agency/vendor expense,5eecc6d6449e4f7cfb1c2708,2022-01-28T00:00:00.000Z,"NEFT DR-ICIC0000007-VANSUN MEDIATECH PRI VATE LIMITED-NETBANK, MUM-N0282218085486 74-53875",,,net_banking_transfer,-53875
61fa340cd8beac15990e6732,50200023535069,675572.67,60ec41ba55c00300382672d9,HDFC,direct expenses,5eecc6d6449e4f7cfb1c2708,2022-01-28T00:00:00.000Z,01341140025669-TPT-42480-SHASHANK GOYAL,,,net_banking_transfer,-42480
61fa340cd8beac15990e6734,50200023535069,643172.67,60ec41ba55c00300382672d9,HDFC,direct expenses,5eecc6d6449e4f7cfb1c2708,2022-01-28T00:00:00.000Z,"NEFT DR-ICIC0000874-TRELION BUSINESS SOL UTIONS PVT LTD-NETBANK, MUM-N02822180856 6851-32400",,,net_banking_transfer,-32400
61fa340cd8beac15990e6736,50200023535069,610772.67,60ec41ba55c00300382672d9,HDFC,direct expenses,5eecc6d6449e4f7cfb1c2708,2022-01-28T00:00:00.000Z,50200039330521-TPT-32400-ELITE PUBLICIST,insurance,,net_banking_transfer,-32400
61fa340cd8beac15990e6738,50200023535069,355772.67,60ec41ba55c00300382672d9,HDFC,SAAS/tech expense,5eecc6d6449e4f7cfb1c2708,2022-01-28T00:00:00.000Z,POS 514834XXXXXX9486 AMAZON,shopping,,debit_card,-255000
61fa340cd8beac15990e673a,50200023535069,303242.67,60ec41ba55c00300382672d9,HDFC,agency/vendor expense,5eecc6d6449e4f7cfb1c2708,2022-01-28T00:00:00.000Z,"NEFT DR-IDFB0021001-CLIKCONIK DIGITAL ME DIA PRIVATE LIMITED-NETBANK, MUM-N028221 809041484-52530",,,net_banking_transfer,-52530
61fa340cd8beac15990e673c,50200023535069,355772.67,60ec41ba55c00300382672d9,HDFC,Adjustments/Reversal,5eecc6d6449e4f7cfb1c2708,2022-01-28T00:00:00.000Z,NEFT RETURN-ACCOUNT CLOSED-CLIKCONIK DIG ITAL MEDIA PRIVATE LIMITED-RETNH22028046 004,,neft_return,refund,52530
61fa340cd8beac15990e673f,50200023535069,487904.19,60ec41ba55c00300382672d9,HDFC,Revenue-UPI,5eecc6d6449e4f7cfb1c2708,2022-01-28T00:00:00.000Z,UPI-GOKWIK-GOKWIK@YESBANK-YESB0000340-20 2826806905-PAYOUT FOR JANUARY,,,upi,132131.52
61fa340cd8beac15990e6741,50200023535069,489353.35,60ec41ba55c00300382672d9,HDFC,Revenue-Mktplace,5eecc6d6449e4f7cfb1c2708,2022-01-28T00:00:00.000Z,NEFT CR-ICIC0000105-MANASH LIFESTYLE PRI VATE LIMITED NO-SLICK ORGANICS PRIVATE L IMITED MP G-ICIJ220280003406,shopping,,net_banking_transfer,1449.16
61fa340cd8beac15990e6743,50200023535069,490617.05,60ec41ba55c00300382672d9,HDFC,Revenue-Mktplace,5eecc6d6449e4f7cfb1c2708,2022-01-28T00:00:00.000Z,NEFT CR-ICIC0000105-MANASH LIFESTYLE PRI VATE LIMITED NO-SLICK ORGANICS PRIVATE L IMITED BANG-ICIJ220280003409,shopping,,net_banking_transfer,1263.7
61fa340cd8beac15990e6745,50200023535069,491215.93,60ec41ba55c00300382672d9,HDFC,Revenue-Mktplace,5eecc6d6449e4f7cfb1c2708,2022-01-28T00:00:00.000Z,NEFT CR-ICIC0000105-MANASH LIFESTYLE PRI VATE LIMITED NO-SLICK ORGANICS PRIVATE L IMITED KOLK-ICIJ220280003408,shopping,,net_banking_transfer,598.88
61fa340cd8beac15990e6747,50200023535069,507717.83,60ec41ba55c00300382672d9,HDFC,Revenue-PG-non-split,5eecc6d6449e4f7cfb1c2708,2022-01-28T00:00:00.000Z,NEFT CR-IDFB0010204-SEZZLE PAYMENTS PRIV,,,net_banking_transfer,16501.9
61fa340cd8beac15990e6749,50200023535069,507789.13,60ec41ba55c00300382672d9,HDFC,Revenue-PG-split enabled,5eecc6d6449e4f7cfb1c2708,2022-01-28T00:00:00.000Z,NEFT CR-UTIB0001506-RAZORPAY SOFTWARE PR IVATE LIMITED-SLICK ORGANICS PVT LITD-AX ISCN0119787394,insurance,,net_banking_transfer,71.3
61fa340cd8beac15990e674b,50200023535069,520830,60ec41ba55c00300382672d9,HDFC,Revenue-PG-non-split,5eecc6d6449e4f7cfb1c2708,2022-01-29T00:00:00.000Z,IMPS-202904878546-PAYTM PAYMENTS SERVI-P YTM-XXXXXXXXXX0008-ALL202201292168200003 30830668628,ewallet,,net_banking_transfer,13040.87
61fa340cd8beac15990e674d,50200023535069,520870.65,60ec41ba55c00300382672d9,HDFC,Revenue-PG-split enabled,5eecc6d6449e4f7cfb1c2708,2022-01-29T00:00:00.000Z,NEFT CR-UTIB0001506-RAZORPAY SOFTWARE PR IVATE LIMITED-SLICK ORGANICS PVT LITD-AX ISCN0119819521,insurance,,net_banking_transfer,40.65
61fa340cd8beac15990e674f,50200023535069,406050.65,60ec41ba55c00300382672d9,HDFC,agency/vendor expense,5eecc6d6449e4f7cfb1c2708,2022-01-29T00:00:00.000Z,"NEFT DR-ICIC0000007-VANSUN MEDIATECH PRI VATE LIMITED-NETBANK, MUM-N0292218102805 21-114820",,,net_banking_transfer,-114820
61fa340cd8beac15990e6751,50200023535069,348050.65,60ec41ba55c00300382672d9,HDFC,direct expenses,5eecc6d6449e4f7cfb1c2708,2022-01-29T00:00:00.000Z,50200060178580-TPT-58000-CITREA GROWTH P ARTNERS PRIVATE LIMITED,,,net_banking_transfer,-58000
61fa340dd8beac15990e6753,50200023535069,347835.52,60ec41ba55c00300382672d9,HDFC,bank charges,5eecc6d6449e4f7cfb1c2708,2022-01-29T00:00:00.000Z,.DC INTL POS TXN MARKUP+ST 190122 210122 -CDT2200207256855,,,international_transaction_arbitrage,-215.13
61fa340dd8beac15990e6755,50200023535069,353085.52,60ec41ba55c00300382672d9,HDFC,Revenue-Mktplace,5eecc6d6449e4f7cfb1c2708,2022-01-29T00:00:00.000Z,NEFT CR-ICIC0000985-DIGITAL AGE RETAIL P VT LTD-SLICK ORGANICS PVT LTD-CMS2366777 079,,,net_banking_transfer,5250
61fa340dd8beac15990e6757,50200023535069,376661.05,60ec41ba55c00300382672d9,HDFC,Revenue-UPI,5eecc6d6449e4f7cfb1c2708,2022-01-29T00:00:00.000Z,UPI-GOKWIK-GOKWIK@YESBANK-YESB0000340-20 2928677493-PAYOUT FOR JANUARY,,,upi,23575.53
61fa340dd8beac15990e6759,50200023535069,377686.05,60ec41ba55c00300382672d9,HDFC,Transfer in/Revenue-other,5eecc6d6449e4f7cfb1c2708,2022-01-29T00:00:00.000Z,SALARY OCTAVOS ENTERPRISE SOLUTIONS PVT LTD,,,salary,1025
61fa340dd8beac15990e675d,50200023535069,379141.43,60ec41ba55c00300382672d9,HDFC,Revenue-PG-split enabled,5eecc6d6449e4f7cfb1c2708,2022-01-29T00:00:00.000Z,NEFT CR-UTIB0001506-RAZORPAY SOFTWARE PR IVATE LIMITED-SLICK ORGANICS PVT LITD-AX ISCN0119915961,insurance,,net_banking_transfer,1455.38
61fa340dd8beac15990e6760,50200023535069,395972.35,60ec41ba55c00300382672d9,HDFC,Revenue-PG-non-split,5eecc6d6449e4f7cfb1c2708,2022-01-30T00:00:00.000Z,IMPS-203004223068-PAYTM PAYMENTS SERVI-P YTM-XXXXXXXXXX0008-ALL202201302168200003 30830668628,ewallet,,net_banking_transfer,16830.92
61fa340dd8beac15990e6762,50200023535069,411294.27,60ec41ba55c00300382672d9,HDFC,Revenue-UPI,5eecc6d6449e4f7cfb1c2708,2022-01-30T00:00:00.000Z,UPI-GOKWIK-GOKWIK@YESBANK-YESB0000340-20,,,upi,15321.92
61fa340dd8beac15990e6764,50200023535069,411115.27,60ec41ba55c00300382672d9,HDFC,SAAS/tech expense,5eecc6d6449e4f7cfb1c2708,2022-01-30T00:00:00.000Z,ME DC SI 514834XXXXXX9486 AMAZON,shopping,,Other,-179
61fa340dd8beac15990e6766,50200023535069,420641.66,60ec41ba55c00300382672d9,HDFC,Revenue-PG-non-split,5eecc6d6449e4f7cfb1c2708,2022-01-31T00:00:00.000Z,IMPS-203104506341-PAYTM PAYMENTS SERVI-P YTM-XXXXXXXXXX0008-ALL202201312168200003 30830668628,ewallet,,net_banking_transfer,9526.39
61fa340dd8beac15990e6768,50200023535069,421258.53,60ec41ba55c00300382672d9,HDFC,Revenue-PG-split enabled,5eecc6d6449e4f7cfb1c2708,2022-01-31T00:00:00.000Z,NEFT CR-UTIB0001506-RAZORPAY SOFTWARE PR IVATE LIMITED-SLICK ORGANICS PVT LITD-AX ISCN0119975592,insurance,,net_banking_transfer,616.87
61fa340dd8beac15990e676a,50200023535069,166258.53,60ec41ba55c00300382672d9,HDFC,SAAS/tech expense,5eecc6d6449e4f7cfb1c2708,2022-01-31T00:00:00.000Z,POS 514834XXXXXX9486 AMAZON,shopping,,debit_card,-255000
61fa340dd8beac15990e676c,50200023535069,666258.53,60ec41ba55c00300382672d9,HDFC,Internal Transfers,5eecc6d6449e4f7cfb1c2708,2022-01-31T00:00:00.000Z,IB FUNDS TRANSFER CR-50200035187206 -SL ICK ORGANICS PVT LTD,insurance,,Other,500000
61fa340dd8beac15990e676e,50200023535069,352606.53,60ec41ba55c00300382672d9,HDFC,direct expenses,5eecc6d6449e4f7cfb1c2708,2022-01-31T00:00:00.000Z,05892560000649-TPT-313652-DECORPAC INDIA PRIVATE LIMITED,,,net_banking_transfer,-313652
61fa340dd8beac15990e6770,50200023535069,359730.53,60ec41ba55c00300382672d9,HDFC,Transfer in/Revenue-other,5eecc6d6449e4f7cfb1c2708,2022-01-31T00:00:00.000Z,IMPS-203115397808-CRAFTING FAVORS-HDFC-X XXXXXXXXX6232-ORDER SO00806,,,net_banking_transfer,7124
61fa340dd8beac15990e6772,50200023535069,359317.53,60ec41ba55c00300382672d9,HDFC,bank charges,5eecc6d6449e4f7cfb1c2708,2022-01-31T00:00:00.000Z,.ACH DEBIT RETURN CHARGES 220122 220122- CDT2203007626431,,ach_bounce_charge,bank_charge,-413
61fa340dd8beac15990e6774,50200023535069,357776.31,60ec41ba55c00300382672d9,HDFC,bank charges,5eecc6d6449e4f7cfb1c2708,2022-01-31T00:00:00.000Z,.DC INTL POS TXN MARKUP+ST 220122 230122 -CDT2200207256855,,,international_transaction_arbitrage,-1541.22
61fa340dd8beac15990e6776,50200023535069,357886.26,60ec41ba55c00300382672d9,HDFC,Revenue-Mktplace,5eecc6d6449e4f7cfb1c2708,2022-01-31T00:00:00.000Z,NEFT CR-ICIC0000105-MANASH LIFESTYLE PRI VATE LIMITED NO-SLICK ORGANICS PRIVATE L IMITED BANG-ICIJ220310005869,shopping,,net_banking_transfer,109.95
61fa340dd8beac15990e6778,50200023535069,358134.76,60ec41ba55c00300382672d9,HDFC,Revenue-Mktplace,5eecc6d6449e4f7cfb1c2708,2022-01-31T00:00:00.000Z,NEFT CR-ICIC0000105-MANASH LIFESTYLE PRI VATE LIMITED NO-SLICK ORGANICS PRIVATE L IMITED KOLK-ICIJ220310007003,shopping,,net_banking_transfer,248.5
61fa340dd8beac15990e677a,50200023535069,358214.57,60ec41ba55c00300382672d9,HDFC,Revenue-PG-split enabled,5eecc6d6449e4f7cfb1c2708,2022-01-31T00:00:00.000Z,NEFT CR-UTIB0001506-RAZORPAY SOFTWARE PR IVATE LIMITED-SLICK ORGANICS PVT LITD-AX ISCN0120169110,insurance,,net_banking_transfer,79.81
61fa340dd8beac15990e677c,50200023535069,384858.09,60ec41ba55c00300382672d9,HDFC,Revenue-UPI,5eecc6d6449e4f7cfb1c2708,2022-01-31T00:00:00.000Z,UPI-GOKWIK-GOKWIK@YESBANK-YESB0000340-20,,,upi,26643.52
6200e214d8beac159936e618,50200035187206,26004035.82,60ec419255c00300382671a5,HDFC,Internal Transfers,5eecc6d6449e4f7cfb1c2708,2021-12-01T00:00:00.000Z,IB FUNDS TRANSFER DR-50200023535069 -SL ICK ORGANICS PVT LTD,insurance,,net_banking_transfer,-2000000
6200e214d8beac159936e61a,50200035187206,16004035.82,60ec419255c00300382671a5,HDFC,direct expenses,5eecc6d6449e4f7cfb1c2708,2021-12-01T00:00:00.000Z,FD BOOKED - 50300573433240 : SLICK ORGAN ICS PVT LTD,insurance,,investment,-10000000
6200e214d8beac159936e61c,50200035187206,1004035.82,60ec419255c00300382671a5,HDFC,direct expenses,5eecc6d6449e4f7cfb1c2708,2021-12-01T00:00:00.000Z,FD BOOKED - 50300573434322 : SLICK ORGAN ICS PVT LTD,insurance,,investment,-15000000
6200e214d8beac159936e61e,50200035187206,4035.82,60ec419255c00300382671a5,HDFC,Internal Transfers,5eecc6d6449e4f7cfb1c2708,2021-12-02T00:00:00.000Z,IB FUNDS TRANSFER DR-50200023535069 -SL ICK ORGANICS PVT LTD,insurance,,net_banking_transfer,-1000000
6200e214d8beac159936e620,50200035187206,-995964.18,60ec419255c00300382671a5,HDFC,Internal Transfers,5eecc6d6449e4f7cfb1c2708,2021-12-03T00:00:00.000Z,IB FUNDS TRANSFER DR-50200023535069 -SL ICK ORGANICS PVT LTD,insurance,,net_banking_transfer,-1000000
6200e214d8beac159936e622,50200035187206,0.82,60ec419255c00300382671a5,HDFC,Loan-in,5eecc6d6449e4f7cfb1c2708,2021-12-04T00:00:00.000Z,SWEEP-IN CREDIT - 50300573433240,,,self_transfer,995965
6200e214d8beac159936e624,50200035187206,-999999.18,60ec419255c00300382671a5,HDFC,Internal Transfers,5eecc6d6449e4f7cfb1c2708,2021-12-04T00:00:00.000Z,IB FUNDS TRANSFER DR-50200023535069 -SL ICK ORGANICS PVT LTD,insurance,,net_banking_transfer,-1000000
6200e214d8beac159936e626,50200035187206,0.82,60ec419255c00300382671a5,HDFC,Loan-in,5eecc6d6449e4f7cfb1c2708,2021-12-05T00:00:00.000Z,SWEEP-IN CREDIT - 50300573433240,,,self_transfer,1000000
6200e214d8beac159936e628,50200035187206,-499999.18,60ec419255c00300382671a5,HDFC,Internal Transfers,5eecc6d6449e4f7cfb1c2708,2021-12-07T00:00:00.000Z,IB FUNDS TRANSFER DR-50200023535069 -SL ICK ORGANICS PVT LTD,insurance,,net_banking_transfer,-500000
6200e214d8beac159936e62a,50200035187206,-999999.18,60ec419255c00300382671a5,HDFC,Internal Transfers,5eecc6d6449e4f7cfb1c2708,2021-12-07T00:00:00.000Z,IB FUNDS TRANSFER DR-50200023535069 -SL ICK ORGANICS PVT LTD,insurance,,net_banking_transfer,-500000
6200e214d8beac159936e62c,50200035187206,-1499999.18,60ec419255c00300382671a5,HDFC,Internal Transfers,5eecc6d6449e4f7cfb1c2708,2021-12-07T00:00:00.000Z,IB FUNDS TRANSFER DR-50200023535069 -SL ICK ORGANICS PVT LTD,insurance,,net_banking_transfer,-500000
6200e214d8beac159936e62e,50200035187206,-999999.18,60ec419255c00300382671a5,HDFC,Loan-in,5eecc6d6449e4f7cfb1c2708,2021-12-08T00:00:00.000Z,SWEEP-IN CREDIT - 50300573433240,,,self_transfer,500000
6200e214d8beac159936e630,50200035187206,-499999.18,60ec419255c00300382671a5,HDFC,Loan-in,5eecc6d6449e4f7cfb1c2708,2021-12-08T00:00:00.000Z,SWEEP-IN CREDIT - 50300573433240,,,self_transfer,500000
6200e214d8beac159936e632,50200035187206,0.82,60ec419255c00300382671a5,HDFC,Loan-in,5eecc6d6449e4f7cfb1c2708,2021-12-08T00:00:00.000Z,SWEEP-IN CREDIT - 50300573433240,,,self_transfer,500000
6200e214d8beac159936e634,50200035187206,-999999.18,60ec419255c00300382671a5,HDFC,Internal Transfers,5eecc6d6449e4f7cfb1c2708,2021-12-08T00:00:00.000Z,IB FUNDS TRANSFER DR-50200023535069 -SL ICK ORGANICS PVT LTD,insurance,,net_banking_transfer,-1000000
6200e214d8beac159936e636,50200035187206,-1999999.18,60ec419255c00300382671a5,HDFC,Internal Transfers,5eecc6d6449e4f7cfb1c2708,2021-12-08T00:00:00.000Z,IB FUNDS TRANSFER DR-50200023535069 -SL ICK ORGANICS PVT LTD,insurance,,net_banking_transfer,-1000000
6200e214d8beac159936e638,50200035187206,-2499999.18,60ec419255c00300382671a5,HDFC,Internal Transfers,5eecc6d6449e4f7cfb1c2708,2021-12-08T00:00:00.000Z,IB FUNDS TRANSFER DR-50200023535069 -SL ICK ORGANICS PVT LTD,insurance,,net_banking_transfer,-500000
6200e214d8beac159936e63a,50200035187206,-2499711.18,60ec419255c00300382671a5,HDFC,Transfer in/Revenue-other,5eecc6d6449e4f7cfb1c2708,2021-12-09T00:00:00.000Z,INT. ON SWCR ON-50300573433240,,,Other,288
6200e214d8beac159936e63c,50200035187206,-1499711.18,60ec419255c00300382671a5,HDFC,Loan-in,5eecc6d6449e4f7cfb1c2708,2021-12-09T00:00:00.000Z,SWEEP-IN CREDIT - 50300573433240,,,self_transfer,1000000
6200e214d8beac159936e63e,50200035187206,-1499423.18,60ec419255c00300382671a5,HDFC,Transfer in/Revenue-other,5eecc6d6449e4f7cfb1c2708,2021-12-09T00:00:00.000Z,INT. ON SWCR ON-50300573433240,,,,288
6200e214d8beac159936e640,50200035187206,-499423.18,60ec419255c00300382671a5,HDFC,Loan-in,5eecc6d6449e4f7cfb1c2708,2021-12-09T00:00:00.000Z,SWEEP-IN CREDIT - 50300573433240,,,,1000000
6200e214d8beac159936e642,50200035187206,-499279.18,60ec419255c00300382671a5,HDFC,Transfer in/Revenue-other,5eecc6d6449e4f7cfb1c2708,2021-12-09T00:00:00.000Z,INT. ON SWCR ON-50300573433240,,,,144
6200e214d8beac159936e644,50200035187206,144.82,60ec419255c00300382671a5,HDFC,Loan-in,5eecc6d6449e4f7cfb1c2708,2021-12-09T00:00:00.000Z,SWEEP-IN CREDIT - 50300573433240,,,,499424
6200e214d8beac159936e646,50200035187206,-1999855.18,60ec419255c00300382671a5,HDFC,Internal Transfers,5eecc6d6449e4f7cfb1c2708,2021-12-10T00:00:00.000Z,IB FUNDS TRANSFER DR-50200023535069 -SL ICK ORGANICS PVT LTD,insurance,,net_banking_transfer,-2000000
6200e214d8beac159936e648,50200035187206,-1999115.18,60ec419255c00300382671a5,HDFC,Transfer in/Revenue-other,5eecc6d6449e4f7cfb1c2708,2021-12-11T00:00:00.000Z,INT. ON SWCR ON-50300573433240,,,,740
6200e214d8beac159936e64a,50200035187206,740.82,60ec419255c00300382671a5,HDFC,Loan-in,5eecc6d6449e4f7cfb1c2708,2021-12-11T00:00:00.000Z,SWEEP-IN CREDIT - 50300573433240,,,,1999856
6200e214d8beac159936e64c,50200035187206,-999259.18,60ec419255c00300382671a5,HDFC,Internal Transfers,5eecc6d6449e4f7cfb1c2708,2021-12-11T00:00:00.000Z,IB FUNDS TRANSFER DR-50200023535069 -SL ICK ORGANICS PVT LTD,insurance,,net_banking_transfer,-1000000
6200e214d8beac159936e64e,50200035187206,-998848.18,60ec419255c00300382671a5,HDFC,Transfer in/Revenue-other,5eecc6d6449e4f7cfb1c2708,2021-12-12T00:00:00.000Z,INT. ON SWCR ON-50300573433240,,,,411
6200e214d8beac159936e650,50200035187206,411.82,60ec419255c00300382671a5,HDFC,Loan-in,5eecc6d6449e4f7cfb1c2708,2021-12-12T00:00:00.000Z,SWEEP-IN CREDIT - 50300573433240,,,,999260
6200e214d8beac159936e652,50200035187206,-999588.18,60ec419255c00300382671a5,HDFC,Internal Transfers,5eecc6d6449e4f7cfb1c2708,2021-12-13T00:00:00.000Z,IB FUNDS TRANSFER DR-50200023535069 -SL ICK ORGANICS PVT LTD,insurance,,net_banking_transfer,-1000000
6200e214d8beac159936e654,50200035187206,-999095.18,60ec419255c00300382671a5,HDFC,Transfer in/Revenue-other,5eecc6d6449e4f7cfb1c2708,2021-12-14T00:00:00.000Z,INT. ON SWCR ON-50300573433240,,,,493
6200e214d8beac159936e656,50200035187206,493.82,60ec419255c00300382671a5,HDFC,Loan-in,5eecc6d6449e4f7cfb1c2708,2021-12-14T00:00:00.000Z,SWEEP-IN CREDIT - 50300573433240,,,,999589
6200e214d8beac159936e658,50200035187206,-999506.18,60ec419255c00300382671a5,HDFC,Internal Transfers,5eecc6d6449e4f7cfb1c2708,2021-12-14T00:00:00.000Z,IB FUNDS TRANSFER DR-50200023535069 -SL ICK ORGANICS PVT LTD,insurance,,net_banking_transfer,-1000000
6200e214d8beac159936e65a,50200035187206,-1499506.18,60ec419255c00300382671a5,HDFC,Internal Transfers,5eecc6d6449e4f7cfb1c2708,2021-12-14T00:00:00.000Z,IB FUNDS TRANSFER DR-50200023535069 -SL ICK ORGANICS PVT LTD,insurance,,net_banking_transfer,-500000
6200e214d8beac159936e65c,50200035187206,-1499503.18,60ec419255c00300382671a5,HDFC,Transfer in/Revenue-other,5eecc6d6449e4f7cfb1c2708,2021-12-15T00:00:00.000Z,INT. ON SWCR ON-50300573433240,,,,3
6200e214d8beac159936e65e,50200035187206,-1493597.18,60ec419255c00300382671a5,HDFC,Loan-in,5eecc6d6449e4f7cfb1c2708,2021-12-15T00:00:00.000Z,SWEEP-IN CREDIT - 50300573433240,,,,5906
6200e214d8beac159936e660,50200035187206,-1493066.18,60ec419255c00300382671a5,HDFC,Transfer in/Revenue-other,5eecc6d6449e4f7cfb1c2708,2021-12-15T00:00:00.000Z,INT. ON SWCR ON-50300573434322,,,Other,531
6200e214d8beac159936e662,50200035187206,-499465.18,60ec419255c00300382671a5,HDFC,Loan-in,5eecc6d6449e4f7cfb1c2708,2021-12-15T00:00:00.000Z,SWEEP-IN CREDIT - 50300573434322,,,self_transfer,993601
6200e214d8beac159936e664,50200035187206,-499198.18,60ec419255c00300382671a5,HDFC,Transfer in/Revenue-other,5eecc6d6449e4f7cfb1c2708,2021-12-15T00:00:00.000Z,INT. ON SWCR ON-50300573434322,,,,267
6200e214d8beac159936e666,50200035187206,267.82,60ec419255c00300382671a5,HDFC,Loan-in,5eecc6d6449e4f7cfb1c2708,2021-12-15T00:00:00.000Z,SWEEP-IN CREDIT - 50300573434322,,,,499466
6200e214d8beac159936e668,50200035187206,-999732.18,60ec419255c00300382671a5,HDFC,Internal Transfers,5eecc6d6449e4f7cfb1c2708,2021-12-15T00:00:00.000Z,IB FUNDS TRANSFER DR-50200023535069 -SL ICK ORGANICS PVT LTD,insurance,,net_banking_transfer,-1000000
6200e214d8beac159936e66a,50200035187206,-1499732.18,60ec419255c00300382671a5,HDFC,Internal Transfers,5eecc6d6449e4f7cfb1c2708,2021-12-15T00:00:00.000Z,IB FUNDS TRANSFER DR-50200023535069 -SL ICK ORGANICS PVT LTD,insurance,,net_banking_transfer,-500000
6200e214d8beac159936e66e,50200035187206,-1999157.18,60ec419255c00300382671a5,HDFC,Transfer in/Revenue-other,5eecc6d6449e4f7cfb1c2708,2021-12-16T00:00:00.000Z,INT. ON SWCR ON-50300573434322,,,,575
6200e214d8beac159936e670,50200035187206,-999424.18,60ec419255c00300382671a5,HDFC,Loan-in,5eecc6d6449e4f7cfb1c2708,2021-12-16T00:00:00.000Z,SWEEP-IN CREDIT - 50300573434322,,,,999733
6200e214d8beac159936e672,50200035187206,-999136.18,60ec419255c00300382671a5,HDFC,Transfer in/Revenue-other,5eecc6d6449e4f7cfb1c2708,2021-12-16T00:00:00.000Z,INT. ON SWCR ON-50300573434322,,,Other,288
6200e214d8beac159936e674,50200035187206,-499136.18,60ec419255c00300382671a5,HDFC,Loan-in,5eecc6d6449e4f7cfb1c2708,2021-12-16T00:00:00.000Z,SWEEP-IN CREDIT - 50300573434322,,,self_transfer,500000
6200e214d8beac159936e676,50200035187206,-498849.18,60ec419255c00300382671a5,HDFC,Transfer in/Revenue-other,5eecc6d6449e4f7cfb1c2708,2021-12-16T00:00:00.000Z,INT. ON SWCR ON-50300573434322,,,Other,287
6200e214d8beac159936e678,50200035187206,287.82,60ec419255c00300382671a5,HDFC,Loan-in,5eecc6d6449e4f7cfb1c2708,2021-12-16T00:00:00.000Z,SWEEP-IN CREDIT - 50300573434322,,,self_transfer,499137
6200e214d8beac159936e67a,50200035187206,-499712.18,60ec419255c00300382671a5,HDFC,Internal Transfers,5eecc6d6449e4f7cfb1c2708,2021-12-16T00:00:00.000Z,IB FUNDS TRANSFER DR-50200023535069 -SL ICK ORGANICS PVT LTD,insurance,,net_banking_transfer,-500000
6200e214d8beac159936e67c,50200035187206,-499404.18,60ec419255c00300382671a5,HDFC,Transfer in/Revenue-other,5eecc6d6449e4f7cfb1c2708,2021-12-17T00:00:00.000Z,INT. ON SWCR ON-50300573434322,,,,308
6200e214d8beac159936e67e,50200035187206,308.82,60ec419255c00300382671a5,HDFC,Loan-in,5eecc6d6449e4f7cfb1c2708,2021-12-17T00:00:00.000Z,SWEEP-IN CREDIT - 50300573434322,,,,499713
6200e214d8beac159936e680,50200035187206,-999691.18,60ec419255c00300382671a5,HDFC,Internal Transfers,5eecc6d6449e4f7cfb1c2708,2021-12-20T00:00:00.000Z,IB FUNDS TRANSFER DR-50200023535069 -SL ICK ORGANICS PVT LTD,insurance,,net_banking_transfer,-1000000
6200e214d8beac159936e682,50200035187206,-1499691.18,60ec419255c00300382671a5,HDFC,Internal Transfers,5eecc6d6449e4f7cfb1c2708,2021-12-20T00:00:00.000Z,IB FUNDS TRANSFER DR-50200023535069 -SL ICK ORGANICS PVT LTD,insurance,,net_banking_transfer,-500000
6200e214d8beac159936e684,50200035187206,-1498910.18,60ec419255c00300382671a5,HDFC,Transfer in/Revenue-other,5eecc6d6449e4f7cfb1c2708,2021-12-21T00:00:00.000Z,INT. ON SWCR ON-50300573434322,,,,781
6200e214d8beac159936e686,50200035187206,-499218.18,60ec419255c00300382671a5,HDFC,Loan-in,5eecc6d6449e4f7cfb1c2708,2021-12-21T00:00:00.000Z,SWEEP-IN CREDIT - 50300573434322,,,,999692
6200e214d8beac159936e688,50200035187206,-498828.18,60ec419255c00300382671a5,HDFC,Transfer in/Revenue-other,5eecc6d6449e4f7cfb1c2708,2021-12-21T00:00:00.000Z,INT. ON SWCR ON-50300573434322,,,,390
6200e214d8beac159936e68a,50200035187206,390.82,60ec419255c00300382671a5,HDFC,Loan-in,5eecc6d6449e4f7cfb1c2708,2021-12-21T00:00:00.000Z,SWEEP-IN CREDIT - 50300573434322,,,,499219
6200e214d8beac159936e68c,50200035187206,391.82,60ec419255c00300382671a5,HDFC,interest income,5eecc6d6449e4f7cfb1c2708,2021-12-23T00:00:00.000Z,QUARTERLY INTEREST CREDIT 50300462137427,,,Other,1
6200e214d8beac159936e68e,50200035187206,-999608.18,60ec419255c00300382671a5,HDFC,Internal Transfers,5eecc6d6449e4f7cfb1c2708,2021-12-29T00:00:00.000Z,IB FUNDS TRANSFER DR-50200023535069 -SL ICK ORGANICS PVT LTD,insurance,,net_banking_transfer,-1000000
6200e214d8beac159936e690,50200035187206,-998458.18,60ec419255c00300382671a5,HDFC,Transfer in/Revenue-other,5eecc6d6449e4f7cfb1c2708,2021-12-30T00:00:00.000Z,INT. ON SWCR ON-50300573434322,,,,1150
6200e214d8beac159936e692,50200035187206,1150.82,60ec419255c00300382671a5,HDFC,Loan-in,5eecc6d6449e4f7cfb1c2708,2021-12-30T00:00:00.000Z,SWEEP-IN CREDIT - 50300573434322,,,,999609
6200e214d8beac159936e694,50200035187206,-498849.18,60ec419255c00300382671a5,HDFC,Internal Transfers,5eecc6d6449e4f7cfb1c2708,2021-12-30T00:00:00.000Z,IB FUNDS TRANSFER DR-50200023535069 -SL ICK ORGANICS PVT LTD,insurance,,net_banking_transfer,-500000
6200e214d8beac159936e696,50200035187206,-498254.18,60ec419255c00300382671a5,HDFC,Transfer in/Revenue-other,5eecc6d6449e4f7cfb1c2708,2021-12-31T00:00:00.000Z,INT. ON SWCR ON-50300573434322,,,,595
6200e214d8beac159936e698,50200035187206,595.82,60ec419255c00300382671a5,HDFC,Loan-in,5eecc6d6449e4f7cfb1c2708,2021-12-31T00:00:00.000Z,SWEEP-IN CREDIT - 50300573434322,,,,498850
6200e214d8beac159936e69a,50200035187206,-499404.18,60ec419255c00300382671a5,HDFC,Internal Transfers,5eecc6d6449e4f7cfb1c2708,2022-01-03T00:00:00.000Z,IB FUNDS TRANSFER DR-50200023535069 -SL ICK ORGANICS PVT LTD,insurance,,net_banking_transfer,-500000
6200e214d8beac159936e69c,50200035187206,-999404.18,60ec419255c00300382671a5,HDFC,Internal Transfers,5eecc6d6449e4f7cfb1c2708,2022-01-03T00:00:00.000Z,IB FUNDS TRANSFER DR-50200023535069 -SL ICK ORGANICS PVT LTD,insurance,,net_banking_transfer,-500000
6200e214d8beac159936e69e,50200035187206,-1499404.18,60ec419255c00300382671a5,HDFC,direct expenses,5eecc6d6449e4f7cfb1c2708,2022-01-03T00:00:00.000Z,IB FUNDS TRANSFER DR-50200023535069 -SL ICK ORGANICS PVT LTD,insurance,,net_banking_transfer,-500000
6200e214d8beac159936e6a0,50200035187206,-1498501.18,60ec419255c00300382671a5,HDFC,Transfer in/Revenue-other,5eecc6d6449e4f7cfb1c2708,2022-01-04T00:00:00.000Z,INT. ON SWCR ON-50300573434322,,,,903
6200e214d8beac159936e6a2,50200035187206,-999096.18,60ec419255c00300382671a5,HDFC,Loan-in,5eecc6d6449e4f7cfb1c2708,2022-01-04T00:00:00.000Z,SWEEP-IN CREDIT - 50300573434322,,,,499405
6200e214d8beac159936e6a4,50200035187206,-998192.18,60ec419255c00300382671a5,HDFC,Transfer in/Revenue-other,5eecc6d6449e4f7cfb1c2708,2022-01-04T00:00:00.000Z,INT. ON SWCR ON-50300573434322,,,Other,904
6200e214d8beac159936e6a6,50200035187206,-498192.18,60ec419255c00300382671a5,HDFC,Loan-in,5eecc6d6449e4f7cfb1c2708,2022-01-04T00:00:00.000Z,SWEEP-IN CREDIT - 50300573434322,,,self_transfer,500000
6200e214d8beac159936e6a8,50200035187206,-497291.18,60ec419255c00300382671a5,HDFC,Transfer in/Revenue-other,5eecc6d6449e4f7cfb1c2708,2022-01-04T00:00:00.000Z,INT. ON SWCR ON-50300573434322,,,Other,901
6200e214d8beac159936e6aa,50200035187206,901.82,60ec419255c00300382671a5,HDFC,Loan-in,5eecc6d6449e4f7cfb1c2708,2022-01-04T00:00:00.000Z,SWEEP-IN CREDIT - 50300573434322,,,self_transfer,498193
6200e214d8beac159936e6ac,50200035187206,-1499098.18,60ec419255c00300382671a5,HDFC,Internal Transfers,5eecc6d6449e4f7cfb1c2708,2022-01-05T00:00:00.000Z,IB FUNDS TRANSFER DR-50200023535069 -SL ICK ORGANICS PVT LTD,insurance,,net_banking_transfer,-1500000
6200e214d8beac159936e6ae,50200035187206,-1496223.18,60ec419255c00300382671a5,HDFC,Transfer in/Revenue-other,5eecc6d6449e4f7cfb1c2708,2022-01-06T00:00:00.000Z,INT. ON SWCR ON-50300573434322,,,Other,2875
6200e214d8beac159936e6b0,50200035187206,2875.82,60ec419255c00300382671a5,HDFC,Loan-in,5eecc6d6449e4f7cfb1c2708,2022-01-06T00:00:00.000Z,SWEEP-IN CREDIT - 50300573434322,,,self_transfer,1499099
6200e214d8beac159936e6b2,50200035187206,-997124.18,60ec419255c00300382671a5,HDFC,Internal Transfers,5eecc6d6449e4f7cfb1c2708,2022-01-06T00:00:00.000Z,IB FUNDS TRANSFER DR-50200023535069 -SL ICK ORGANICS PVT LTD,insurance,,net_banking_transfer,-1000000
6200e214d8beac159936e6b4,50200035187206,-1497124.18,60ec419255c00300382671a5,HDFC,Internal Transfers,5eecc6d6449e4f7cfb1c2708,2022-01-06T00:00:00.000Z,IB FUNDS TRANSFER DR-50200023535069 -SL ICK ORGANICS PVT LTD,insurance,,net_banking_transfer,-500000
6200e214d8beac159936e6b6,50200035187206,-1495157.18,60ec419255c00300382671a5,HDFC,Transfer in/Revenue-other,5eecc6d6449e4f7cfb1c2708,2022-01-07T00:00:00.000Z,INT. ON SWCR ON-50300573434322,,,,1967
6200e214d8beac159936e6b8,50200035187206,-498032.18,60ec419255c00300382671a5,HDFC,Loan-in,5eecc6d6449e4f7cfb1c2708,2022-01-07T00:00:00.000Z,SWEEP-IN CREDIT - 50300573434322,,,,997125
6200e214d8beac159936e6ba,50200035187206,-497050.18,60ec419255c00300382671a5,HDFC,Transfer in/Revenue-other,5eecc6d6449e4f7cfb1c2708,2022-01-07T00:00:00.000Z,INT. ON SWCR ON-50300573434322,,,Other,982
6200e214d8beac159936e6bc,50200035187206,982.82,60ec419255c00300382671a5,HDFC,Loan-in,5eecc6d6449e4f7cfb1c2708,2022-01-07T00:00:00.000Z,SWEEP-IN CREDIT - 50300573434322,,,self_transfer,498033
6200e214d8beac159936e6be,50200035187206,-1499017.18,60ec419255c00300382671a5,HDFC,Internal Transfers,5eecc6d6449e4f7cfb1c2708,2022-01-07T00:00:00.000Z,IB FUNDS TRANSFER DR-50200023535069 -SL ICK ORGANICS PVT LTD,insurance,,net_banking_transfer,-1500000
6200e214d8beac159936e6c4,50200035187206,-2999017.18,60ec419255c00300382671a5,HDFC,Internal Transfers,5eecc6d6449e4f7cfb1c2708,2022-01-07T00:00:00.000Z,IB FUNDS TRANSFER DR-50200023535069 -SL ICK ORGANICS PVT LTD,insurance,,net_banking_transfer,-500000
6200e214d8beac159936e6c6,50200035187206,-3499017.18,60ec419255c00300382671a5,HDFC,Internal Transfers,5eecc6d6449e4f7cfb1c2708,2022-01-07T00:00:00.000Z,IB FUNDS TRANSFER DR-50200023535069 -SL ICK ORGANICS PVT LTD,insurance,,net_banking_transfer,-500000
6200e214d8beac159936e6c8,50200035187206,-3495978.18,60ec419255c00300382671a5,HDFC,Transfer in/Revenue-other,5eecc6d6449e4f7cfb1c2708,2022-01-08T00:00:00.000Z,INT. ON SWCR ON-50300573434322,,,,3039
6200e214d8beac159936e6ca,50200035187206,-1996960.18,60ec419255c00300382671a5,HDFC,Loan-in,5eecc6d6449e4f7cfb1c2708,2022-01-08T00:00:00.000Z,SWEEP-IN CREDIT - 50300573434322,,,,1499018
6200e214d8beac159936e6cc,50200035187206,-1995946.18,60ec419255c00300382671a5,HDFC,Transfer in/Revenue-other,5eecc6d6449e4f7cfb1c2708,2022-01-08T00:00:00.000Z,INT. ON SWCR ON-50300573434322,,,Other,1014
6200e214d8beac159936e6ce,50200035187206,-1495946.18,60ec419255c00300382671a5,HDFC,Loan-in,5eecc6d6449e4f7cfb1c2708,2022-01-08T00:00:00.000Z,SWEEP-IN CREDIT - 50300573434322,,,self_transfer,500000
6200e214d8beac159936e6d0,50200035187206,-995946.18,60ec419255c00300382671a5,HDFC,Loan-in,5eecc6d6449e4f7cfb1c2708,2022-01-08T00:00:00.000Z,SWEEP-IN CREDIT - 50300573434322,,,self_transfer,500000
6200e214d8beac159936e6d2,50200035187206,-994932.18,60ec419255c00300382671a5,HDFC,Transfer in/Revenue-other,5eecc6d6449e4f7cfb1c2708,2022-01-08T00:00:00.000Z,INT. ON SWCR ON-50300573434322,,,Other,1014
6200e214d8beac159936e6d4,50200035187206,-993918.18,60ec419255c00300382671a5,HDFC,Transfer in/Revenue-other,5eecc6d6449e4f7cfb1c2708,2022-01-08T00:00:00.000Z,INT. ON SWCR ON-50300573434322,,,,1014
6200e214d8beac159936e6d6,50200035187206,-493918.18,60ec419255c00300382671a5,HDFC,Loan-in,5eecc6d6449e4f7cfb1c2708,2022-01-08T00:00:00.000Z,SWEEP-IN CREDIT - 50300573434322,,,,500000
6200e214d8beac159936e6d8,50200035187206,-492917.18,60ec419255c00300382671a5,HDFC,Transfer in/Revenue-other,5eecc6d6449e4f7cfb1c2708,2022-01-08T00:00:00.000Z,INT. ON SWCR ON-50300573434322,,,,1001
6200e214d8beac159936e6da,50200035187206,1001.82,60ec419255c00300382671a5,HDFC,Loan-in,5eecc6d6449e4f7cfb1c2708,2022-01-08T00:00:00.000Z,SWEEP-IN CREDIT - 50300573434322,,,,493919
6200e214d8beac159936e6dc,50200035187206,-498998.18,60ec419255c00300382671a5,HDFC,Internal Transfers,5eecc6d6449e4f7cfb1c2708,2022-01-11T00:00:00.000Z,IB FUNDS TRANSFER DR-50200023535069 -SL ICK ORGANICS PVT LTD,insurance,,net_banking_transfer,-500000
6200e214d8beac159936e6de,50200035187206,-998998.18,60ec419255c00300382671a5,HDFC,Internal Transfers,5eecc6d6449e4f7cfb1c2708,2022-01-11T00:00:00.000Z,IB FUNDS TRANSFER DR-50200023535069 -SL ICK ORGANICS PVT LTD,insurance,,net_banking_transfer,-500000
6200e214d8beac159936e6e0,50200035187206,-998939.18,60ec419255c00300382671a5,HDFC,Transfer in/Revenue-other,5eecc6d6449e4f7cfb1c2708,2022-01-12T00:00:00.000Z,INT. ON SWCR ON-50300573434322,,,Other,59
6200e214d8beac159936e6e2,50200035187206,-972751.18,60ec419255c00300382671a5,HDFC,Loan-in,5eecc6d6449e4f7cfb1c2708,2022-01-12T00:00:00.000Z,SWEEP-IN CREDIT - 50300573434322,,,self_transfer,26188
6200e214d8beac159936e6e4,50200035187206,-971637.18,60ec419255c00300382671a5,HDFC,Transfer in/Revenue-other,5eecc6d6449e4f7cfb1c2708,2022-01-12T00:00:00.000Z,INT. ON SWCR ON-50300572637408,,,Other,1114
6200e214d8beac159936e6e6,50200035187206,-498826.18,60ec419255c00300382671a5,HDFC,Loan-in,5eecc6d6449e4f7cfb1c2708,2022-01-12T00:00:00.000Z,SWEEP-IN CREDIT - 50300572637408,,,self_transfer,472811
6200e214d8beac159936e6e8,50200035187206,-497651.18,60ec419255c00300382671a5,HDFC,Transfer in/Revenue-other,5eecc6d6449e4f7cfb1c2708,2022-01-12T00:00:00.000Z,INT. ON SWCR ON-50300572637408,,,,1175
6200e214d8beac159936e6ea,50200035187206,1175.82,60ec419255c00300382671a5,HDFC,Loan-in,5eecc6d6449e4f7cfb1c2708,2022-01-12T00:00:00.000Z,SWEEP-IN CREDIT - 50300572637408,,,,498827
6200e214d8beac159936e6ec,50200035187206,-498824.18,60ec419255c00300382671a5,HDFC,Internal Transfers,5eecc6d6449e4f7cfb1c2708,2022-01-12T00:00:00.000Z,IB FUNDS TRANSFER DR-50200023535069 -SL ICK ORGANICS PVT LTD,insurance,,net_banking_transfer,-500000
6200e214d8beac159936e6ee,50200035187206,-497621.18,60ec419255c00300382671a5,HDFC,Transfer in/Revenue-other,5eecc6d6449e4f7cfb1c2708,2022-01-13T00:00:00.000Z,INT. ON SWCR ON-50300572637408,,,Other,1203
6200e214d8beac159936e6f0,50200035187206,1203.82,60ec419255c00300382671a5,HDFC,Loan-in,5eecc6d6449e4f7cfb1c2708,2022-01-13T00:00:00.000Z,SWEEP-IN CREDIT - 50300572637408,,,self_transfer,498825
6200e214d8beac159936e6f6,50200035187206,-1997539.18,60ec419255c00300382671a5,HDFC,Transfer in/Revenue-other,5eecc6d6449e4f7cfb1c2708,2022-01-15T00:00:00.000Z,INT. ON SWCR ON-50300572637408,,,,1257
6200e214d8beac159936e6f8,50200035187206,-1498742.18,60ec419255c00300382671a5,HDFC,Loan-in,5eecc6d6449e4f7cfb1c2708,2022-01-15T00:00:00.000Z,SWEEP-IN CREDIT - 50300572637408,,,,498797
6200e214d8beac159936e6fa,50200035187206,-1494964.18,60ec419255c00300382671a5,HDFC,Transfer in/Revenue-other,5eecc6d6449e4f7cfb1c2708,2022-01-15T00:00:00.000Z,INT. ON SWCR ON-50300572637408,,,Other,3778
6200e214d8beac159936e6fc,50200035187206,3778.82,60ec419255c00300382671a5,HDFC,Loan-in,5eecc6d6449e4f7cfb1c2708,2022-01-15T00:00:00.000Z,SWEEP-IN CREDIT - 50300572637408,,,self_transfer,1498743
6200e214d8beac159936e6fe,50200035187206,-496221.18,60ec419255c00300382671a5,HDFC,Internal Transfers,5eecc6d6449e4f7cfb1c2708,2022-01-15T00:00:00.000Z,IB FUNDS TRANSFER DR-50200023535069 -SL ICK ORGANICS PVT LTD,insurance,,net_banking_transfer,-500000
6200e214d8beac159936e700,50200035187206,-494943.18,60ec419255c00300382671a5,HDFC,Transfer in/Revenue-other,5eecc6d6449e4f7cfb1c2708,2022-01-16T00:00:00.000Z,INT. ON SWCR ON-50300572637408,,,Other,1278
6200e214d8beac159936e702,50200035187206,1278.82,60ec419255c00300382671a5,HDFC,Loan-in,5eecc6d6449e4f7cfb1c2708,2022-01-16T00:00:00.000Z,SWEEP-IN CREDIT - 50300572637408,,,self_transfer,496222
6200e214d8beac159936e704,50200035187206,-498721.18,60ec419255c00300382671a5,HDFC,Internal Transfers,5eecc6d6449e4f7cfb1c2708,2022-01-19T00:00:00.000Z,IB FUNDS TRANSFER DR-50200023535069 -SL ICK ORGANICS PVT LTD,insurance,,net_banking_transfer,-500000
6200e214d8beac159936e706,50200035187206,-998721.18,60ec419255c00300382671a5,HDFC,Internal Transfers,5eecc6d6449e4f7cfb1c2708,2022-01-19T00:00:00.000Z,IB FUNDS TRANSFER DR-50200023535069 -SL ICK ORGANICS PVT LTD,insurance,,net_banking_transfer,-500000
6200e214d8beac159936e708,50200035187206,-997327.18,60ec419255c00300382671a5,HDFC,Transfer in/Revenue-other,5eecc6d6449e4f7cfb1c2708,2022-01-20T00:00:00.000Z,INT. ON SWCR ON-50300572637408,,,,1394
6200e214d8beac159936e70a,50200035187206,-498605.18,60ec419255c00300382671a5,HDFC,Loan-in,5eecc6d6449e4f7cfb1c2708,2022-01-20T00:00:00.000Z,SWEEP-IN CREDIT - 50300572637408,,,,498722
6200e214d8beac159936e70c,50200035187206,-497212.18,60ec419255c00300382671a5,HDFC,Transfer in/Revenue-other,5eecc6d6449e4f7cfb1c2708,2022-01-20T00:00:00.000Z,INT. ON SWCR ON-50300572637408,,,,1393
6200e214d8beac159936e70e,50200035187206,1393.82,60ec419255c00300382671a5,HDFC,Loan-in,5eecc6d6449e4f7cfb1c2708,2022-01-20T00:00:00.000Z,SWEEP-IN CREDIT - 50300572637408,,,,498606
6200e214d8beac159936e710,50200035187206,-998606.18,60ec419255c00300382671a5,HDFC,Internal Transfers,5eecc6d6449e4f7cfb1c2708,2022-01-20T00:00:00.000Z,IB FUNDS TRANSFER DR-50200023535069 -SL ICK ORGANICS PVT LTD,insurance,,net_banking_transfer,-1000000
6200e214d8beac159936e712,50200035187206,-1198606.18,60ec419255c00300382671a5,HDFC,Internal Transfers,5eecc6d6449e4f7cfb1c2708,2022-01-20T00:00:00.000Z,IB FUNDS TRANSFER DR-50200023535069 -SL ICK ORGANICS PVT LTD,insurance,,net_banking_transfer,-200000
6200e214d8beac159936e714,50200035187206,-1195761.18,60ec419255c00300382671a5,HDFC,Transfer in/Revenue-other,5eecc6d6449e4f7cfb1c2708,2022-01-21T00:00:00.000Z,INT. ON SWCR ON-50300572637408,,,Other,2845
6200e214d8beac159936e716,50200035187206,-197154.18,60ec419255c00300382671a5,HDFC,Loan-in,5eecc6d6449e4f7cfb1c2708,2022-01-21T00:00:00.000Z,SWEEP-IN CREDIT - 50300572637408,,,self_transfer,998607
6200e214d8beac159936e718,50200035187206,-196592.18,60ec419255c00300382671a5,HDFC,Transfer in/Revenue-other,5eecc6d6449e4f7cfb1c2708,2022-01-21T00:00:00.000Z,INT. ON SWCR ON-50300572637408,,,Other,562
6200e214d8beac159936e71a,50200035187206,562.82,60ec419255c00300382671a5,HDFC,Loan-in,5eecc6d6449e4f7cfb1c2708,2022-01-21T00:00:00.000Z,SWEEP-IN CREDIT - 50300572637408,,,self_transfer,197155
6200e214d8beac159936e71c,50200035187206,-199437.18,60ec419255c00300382671a5,HDFC,Internal Transfers,5eecc6d6449e4f7cfb1c2708,2022-01-21T00:00:00.000Z,IB FUNDS TRANSFER DR-50200023535069 -SL ICK ORGANICS PVT LTD,insurance,,net_banking_transfer,-200000
6200e214d8beac159936e71e,50200035187206,-198858.18,60ec419255c00300382671a5,HDFC,Transfer in/Revenue-other,5eecc6d6449e4f7cfb1c2708,2022-01-22T00:00:00.000Z,INT. ON SWCR ON-50300572637408,,,,579
6200e214d8beac159936e720,50200035187206,579.82,60ec419255c00300382671a5,HDFC,Loan-in,5eecc6d6449e4f7cfb1c2708,2022-01-22T00:00:00.000Z,SWEEP-IN CREDIT - 50300572637408,,,,199438
6200e214d8beac159936e724,50200035187206,-497942.18,60ec419255c00300382671a5,HDFC,Transfer in/Revenue-other,5eecc6d6449e4f7cfb1c2708,2022-01-23T00:00:00.000Z,INT. ON SWCR ON-50300572637408,,,,1478
6200e214d8beac159936e726,50200035187206,1478.82,60ec419255c00300382671a5,HDFC,Loan-in,5eecc6d6449e4f7cfb1c2708,2022-01-23T00:00:00.000Z,SWEEP-IN CREDIT - 50300572637408,,,,499421
6200e214d8beac159936e728,50200035187206,-998521.18,60ec419255c00300382671a5,HDFC,Internal Transfers,5eecc6d6449e4f7cfb1c2708,2022-01-24T00:00:00.000Z,IB FUNDS TRANSFER DR-50200023535069 -SL ICK ORGANICS PVT LTD,insurance,,net_banking_transfer,-1000000
6200e214d8beac159936e72a,50200035187206,-1098521.18,60ec419255c00300382671a5,HDFC,Internal Transfers,5eecc6d6449e4f7cfb1c2708,2022-01-24T00:00:00.000Z,IB FUNDS TRANSFER DR-50200023535069 -SL ICK ORGANICS PVT LTD,insurance,,net_banking_transfer,-100000
6200e214d8beac159936e72c,50200035187206,-1498521.18,60ec419255c00300382671a5,HDFC,Internal Transfers,5eecc6d6449e4f7cfb1c2708,2022-01-24T00:00:00.000Z,IB FUNDS TRANSFER DR-50200023535069 -SL ICK ORGANICS PVT LTD,insurance,,net_banking_transfer,-400000
6200e214d8beac159936e72e,50200035187206,-1495457.18,60ec419255c00300382671a5,HDFC,Transfer in/Revenue-other,5eecc6d6449e4f7cfb1c2708,2022-01-25T00:00:00.000Z,INT. ON SWCR ON-50300572637408,,,,3064
6200e214d8beac159936e730,50200035187206,-496935.18,60ec419255c00300382671a5,HDFC,Loan-in,5eecc6d6449e4f7cfb1c2708,2022-01-25T00:00:00.000Z,SWEEP-IN CREDIT - 50300572637408,,,,998522
6200e214d8beac159936e732,50200035187206,-496628.18,60ec419255c00300382671a5,HDFC,Transfer in/Revenue-other,5eecc6d6449e4f7cfb1c2708,2022-01-25T00:00:00.000Z,INT. ON SWCR ON-50300572637408,,,,307
6200e214d8beac159936e734,50200035187206,-396628.18,60ec419255c00300382671a5,HDFC,Loan-in,5eecc6d6449e4f7cfb1c2708,2022-01-25T00:00:00.000Z,SWEEP-IN CREDIT - 50300572637408,,,,100000
6200e214d8beac159936e736,50200035187206,-395411.18,60ec419255c00300382671a5,HDFC,Transfer in/Revenue-other,5eecc6d6449e4f7cfb1c2708,2022-01-25T00:00:00.000Z,INT. ON SWCR ON-50300572637408,,,Other,1217
6200e214d8beac159936e738,50200035187206,1217.82,60ec419255c00300382671a5,HDFC,Loan-in,5eecc6d6449e4f7cfb1c2708,2022-01-25T00:00:00.000Z,SWEEP-IN CREDIT - 50300572637408,,,self_transfer,396629
6200e214d8beac159936e73a,50200035187206,-498782.18,60ec419255c00300382671a5,HDFC,Internal Transfers,5eecc6d6449e4f7cfb1c2708,2022-01-26T00:00:00.000Z,IB FUNDS TRANSFER DR-50200023535069 -SL ICK ORGANICS PVT LTD,insurance,,net_banking_transfer,-500000
6200e214d8beac159936e73c,50200035187206,-497197.18,60ec419255c00300382671a5,HDFC,Transfer in/Revenue-other,5eecc6d6449e4f7cfb1c2708,2022-01-27T00:00:00.000Z,INT. ON SWCR ON-50300572637408,,,Other,1585
6200e214d8beac159936e73e,50200035187206,1585.82,60ec419255c00300382671a5,HDFC,Loan-in,5eecc6d6449e4f7cfb1c2708,2022-01-27T00:00:00.000Z,SWEEP-IN CREDIT - 50300572637408,,,self_transfer,498783
6200e214d8beac159936e740,50200035187206,-498414.18,60ec419255c00300382671a5,HDFC,Internal Transfers,5eecc6d6449e4f7cfb1c2708,2022-01-31T00:00:00.000Z,IB FUNDS TRANSFER DR-50200023535069 -SL ICK ORGANICS PVT LTD,insurance,,net_banking_transfer,-500000
6200e214d8beac159936e742,50200035187206,-496693.18,60ec419255c00300382671a5,HDFC,Transfer in/Revenue-other,5eecc6d6449e4f7cfb1c2708,2022-02-01T00:00:00.000Z,INT. ON SWCR ON-50300572637408,,,Other,1721
6200e214d8beac159936e744,50200035187206,1721.82,60ec419255c00300382671a5,HDFC,Loan-in,5eecc6d6449e4f7cfb1c2708,2022-02-01T00:00:00.000Z,SWEEP-IN CREDIT - 50300572637408,,,self_transfer,498415
6229d5dad8beac15993d34c5,50200023535069,394910.26,60ec41ba55c00300382672d9,HDFC,Revenue-PG-non-split,5eecc6d6449e4f7cfb1c2708,2022-02-01T00:00:00.000Z,IMPS-203204058233-PAYTM PAYMENTS SERVI-P YTM-XXXXXXXXXX0008-ALL202202012168200003 30830668628,ewallet,,net_banking_transfer,10052.17
6229d5dad8beac15993d34c8,50200023535069,433209.45,60ec41ba55c00300382672d9,HDFC,Revenue-Mktplace,5eecc6d6449e4f7cfb1c2708,2022-02-01T00:00:00.000Z,IMPS-203205361714-AMAZON SELLER SERVIC-H SBC-XXXXXXXX6004-2BNRFZD29GLWLEA5SLICK O RGANICS PVT LTD,shopping,,net_banking_transfer,38299.19
6229d5dad8beac15993d34ca,50200023535069,587848.78,60ec41ba55c00300382672d9,HDFC,Revenue-Mktplace,5eecc6d6449e4f7cfb1c2708,2022-02-01T00:00:00.000Z,NEFT CR-DEUT0797BGL-AMAZON PAY (INDIA) P RIVATE LIMITED-SLICK ORGANICS PVT LTD-20 3200174GN00331,shopping,,net_banking_transfer,154639.33
6229d5dad8beac15993d34cd,50200023535069,550394.56,60ec41ba55c00300382672d9,HDFC,SAAS/tech expense,5eecc6d6449e4f7cfb1c2708,2022-02-01T00:00:00.000Z,POS 514834XXXXXX9486 AMAZON.COM,shopping,,debit_card,-37454.22
6229d5dad8beac15993d34cf,50200023535069,550910.23,60ec41ba55c00300382672d9,HDFC,Revenue-Mktplace,5eecc6d6449e4f7cfb1c2708,2022-02-01T00:00:00.000Z,NEFT CR-DEUT0797BGL-MYNTRA DESIGNS PRIVA TE LIMITED-SLICK ORGANICS PVT. LTD.-2032 00428GN00148,shopping,,net_banking_transfer,515.67
6229d5dad8beac15993d34d1,50200023535069,560458.11,60ec41ba55c00300382672d9,HDFC,Revenue-Mktplace,5eecc6d6449e4f7cfb1c2708,2022-02-01T00:00:00.000Z,NEFT CR-DEUT0797BGL-MYNTRA DESIGNS PRIVA TE LIMITED-SLICK ORGANICS PVT. LTD.-2032 00429GN00175,shopping,,net_banking_transfer,9547.88
6229d5dad8beac15993d34d3,50200023535069,560658.49,60ec41ba55c00300382672d9,HDFC,Revenue-PG-split enabled,5eecc6d6449e4f7cfb1c2708,2022-02-01T00:00:00.000Z,NEFT CR-UTIB0001506-RAZORPAY SOFTWARE PR IVATE LIMITED-SLICK ORGANICS PVT LITD-AX ISCN0120447438,insurance,,net_banking_transfer,200.38
6229d5dad8beac15993d34d5,50200023535069,562193.06,60ec41ba55c00300382672d9,HDFC,Revenue-Mktplace,5eecc6d6449e4f7cfb1c2708,2022-02-01T00:00:00.000Z,4060009749-TIMES INTERNET LIMITED NODAL,,,Other,1534.57
6229d5dad8beac15993d34d7,50200023535069,562371.6,60ec41ba55c00300382672d9,HDFC,Revenue-PG-non-split,5eecc6d6449e4f7cfb1c2708,2022-02-01T00:00:00.000Z,NEFT CR-IDFB0010204-SEZZLE PAYMENTS PRIV ATE LIMITED-SLICK ORGANICS PRIVATE LIMIT ED-IDFBH22032358057,insurance,,net_banking_transfer,178.54
6229d5dad8beac15993d34d9,50200023535069,560206.23,60ec41ba55c00300382672d9,HDFC,direct expenses,5eecc6d6449e4f7cfb1c2708,2022-02-01T00:00:00.000Z,POS 514834XXXXXX9486 SEOPTIMER,,,debit_card,-2165.37
6229d5dad8beac15993d34db,50200023535069,501216.23,60ec41ba55c00300382672d9,HDFC,direct expenses,5eecc6d6449e4f7cfb1c2708,2022-02-01T00:00:00.000Z,"NEFT DR-UTIB0000120-ADNAN ALI-NETBANK, M UM-N032221814505672-58990",,,net_banking_transfer,-58990
6229d5dad8beac15993d34dd,50200023535069,285216.23,60ec41ba55c00300382672d9,HDFC,direct expenses,5eecc6d6449e4f7cfb1c2708,2022-02-01T00:00:00.000Z,"NEFT DR-UTIB0000514-NATS ASSOCIATES-NETB ANK, MUM-N032221814522489-216000",,,net_banking_transfer,-216000
6229d5dad8beac15993d34df,50200023535069,60216.23,60ec41ba55c00300382672d9,HDFC,direct expenses,5eecc6d6449e4f7cfb1c2708,2022-02-01T00:00:00.000Z,NEFT DR-SCBL0036025-DHRUV MADHOK-NETBANK,,,net_banking_transfer,-225000
6229d5dad8beac15993d34e1,50200023535069,560216.23,60ec41ba55c00300382672d9,HDFC,Internal Transfers,5eecc6d6449e4f7cfb1c2708,2022-02-01T00:00:00.000Z,IB FUNDS TRANSFER CR-50200035187206 -SL ICK ORGANICS PVT LTD,insurance,,Other,500000
6229d5dad8beac15993d34e3,50200023535069,335216.23,60ec41ba55c00300382672d9,HDFC,direct expenses,5eecc6d6449e4f7cfb1c2708,2022-02-01T00:00:00.000Z,02711930004579-TPT-225000-DHRUV BHASIN,,,net_banking_transfer,-225000
6229d5dad8beac15993d34e5,50200023535069,338353.4,60ec41ba55c00300382672d9,HDFC,Revenue-PG-non-split,5eecc6d6449e4f7cfb1c2708,2022-02-01T00:00:00.000Z,NEFT CR-IDFB0010204-SEZZLE PAYMENTS PRIV ATE LIMITED-SLICK ORGANICS PRIVATE LIMIT ED-IDFBH22032400296,insurance,,net_banking_transfer,3137.17
6229d5dad8beac15993d34e7,50200023535069,338457.74,60ec41ba55c00300382672d9,HDFC,Revenue-PG-split enabled,5eecc6d6449e4f7cfb1c2708,2022-02-01T00:00:00.000Z,NEFT CR-UTIB0001506-RAZORPAY SOFTWARE PR IVATE LIMITED-SLICK ORGANICS PVT LITD-AX ISCN0120661224,insurance,,net_banking_transfer,104.34
6229d5dad8beac15993d34e9,50200023535069,838457.74,60ec41ba55c00300382672d9,HDFC,Internal Transfers,5eecc6d6449e4f7cfb1c2708,2022-02-01T00:00:00.000Z,IB FUNDS TRANSFER CR-50200035187206 -SL ICK ORGANICS PVT LTD,insurance,,Other,500000
6229d5dad8beac15993d34eb,50200023535069,384437.74,60ec41ba55c00300382672d9,HDFC,direct expenses,5eecc6d6449e4f7cfb1c2708,2022-02-01T00:00:00.000Z,02711600008220-TPT-454020-VARUN SINGH,,,net_banking_transfer,-454020
6229d5dad8beac15993d34ed,50200023535069,410250.91,60ec41ba55c00300382672d9,HDFC,Revenue-UPI,5eecc6d6449e4f7cfb1c2708,2022-02-01T00:00:00.000Z,UPI-GOKWIK-GOKWIK@YESBANK-YESB0000340-20 3235307631-PAYOUT FOR JANUARY,,,upi,25813.17
6229d5dad8beac15993d34ef,50200023535069,419960.13,60ec41ba55c00300382672d9,HDFC,Revenue-Mktplace,5eecc6d6449e4f7cfb1c2708,2022-02-02T00:00:00.000Z,NEFT CR-DEUT0797BGL-FLIPKART INTERNET PR IVATE LIMITED-SLICK ORGANICS PVT LTD-203 300133GN00005,shopping,,net_banking_transfer,9709.22
6229d5dad8beac15993d34f1,50200023535069,433990.09,60ec41ba55c00300382672d9,HDFC,Revenue-PG-non-split,5eecc6d6449e4f7cfb1c2708,2022-02-02T00:00:00.000Z,IMPS-203304718141-PAYTM PAYMENTS SERVI-P YTM-XXXXXXXXXX0008-ALL202202022168200003 30830668628,ewallet,,net_banking_transfer,14029.96
6229d5dad8beac15993d34f3,50200023535069,433991.1,60ec41ba55c00300382672d9,HDFC,Transfer in/Revenue-other,5eecc6d6449e4f7cfb1c2708,2022-02-02T00:00:00.000Z,IMPS-203308009734-SIGNZY TECHNOLOGIES-ID FB-XXXXXXX9271-,,,net_banking_transfer,1.01
6229d5dad8beac15993d34f5,50200023535069,434069.14,60ec41ba55c00300382672d9,HDFC,Revenue-Mktplace,5eecc6d6449e4f7cfb1c2708,2022-02-02T00:00:00.000Z,NEFT CR-DEUT0797BGL-MYNTRA DESIGNS PRIVA TE LIMITED-SLICK ORGANICS PVT. LTD.-2033 00939GN00104,shopping,,net_banking_transfer,78.04
6229d5dad8beac15993d34f7,50200023535069,380535.13,60ec41ba55c00300382672d9,HDFC,direct expenses,5eecc6d6449e4f7cfb1c2708,2022-02-02T00:00:00.000Z,POS 514834XXXXXX9486 AMZ*MARKETING SV,,,debit_card,-53534.01
6229d5dad8beac15993d34f9,50200023535069,380854.38,60ec41ba55c00300382672d9,HDFC,Revenue-PG-split enabled,5eecc6d6449e4f7cfb1c2708,2022-02-02T00:00:00.000Z,NEFT CR-UTIB0001506-RAZORPAY SOFTWARE PR IVATE LIMITED-SLICK ORGANICS PVT LITD-AX ISCN0120751842,insurance,,net_banking_transfer,319.25
6229d5dad8beac15993d34fb,50200023535069,91128.38,60ec41ba55c00300382672d9,HDFC,direct expenses,5eecc6d6449e4f7cfb1c2708,2022-02-02T00:00:00.000Z,50200029847721-TPT-289726-SPITI CONSULTI NG,,,net_banking_transfer,-289726
6229d5dad8beac15993d34fd,50200023535069,591128.38,60ec41ba55c00300382672d9,HDFC,Internal Transfers,5eecc6d6449e4f7cfb1c2708,2022-02-02T00:00:00.000Z,IB FUNDS TRANSFER CR-50200035187206 -SL,,,Other,500000
6229d5dad8beac15993d34ff,50200023535069,58148.38,60ec41ba55c00300382672d9,HDFC,Salary/Emp/consultant Expense,5eecc6d6449e4f7cfb1c2708,2022-02-02T00:00:00.000Z,"NEFT DR-ICIC0001340-LUCRIA CONSULTANT PV T LTD-NETBANK, MUM-N033221816034355-5329 80",,,net_banking_transfer,-532980
6229d5dad8beac15993d3501,50200023535069,107567.22,60ec41ba55c00300382672d9,HDFC,Revenue-Mktplace,5eecc6d6449e4f7cfb1c2708,2022-02-02T00:00:00.000Z,NEFT CR-HSBC0400002-AMAZON SERVICES LLC- SLICK ORGANICS PRIVATE LIMITED-HSBCN2203 3232228,shopping,,net_banking_transfer,49418.84
6229d5dad8beac15993d3503,50200023535069,107646.47,60ec41ba55c00300382672d9,HDFC,Revenue-Mktplace,5eecc6d6449e4f7cfb1c2708,2022-02-02T00:00:00.000Z,NEFT CR-DEUT0797BGL-MYNTRA DESIGNS PRIVA TE LIMITED-SLICK ORGANICS PVT. LTD.-2033 01257GN00110,shopping,,net_banking_transfer,79.25
6229d5dad8beac15993d3505,50200023535069,108213.45,60ec41ba55c00300382672d9,HDFC,Revenue-COD,5eecc6d6449e4f7cfb1c2708,2022-02-02T00:00:00.000Z,NEFT CR-ICIC0000155-SHIPROCKET COD CRF I D 3756902-SLICK ORGANICS PVT LTD-CMS2375 653972,insurance,,net_banking_transfer,566.98
6229d5dad8beac15993d3507,50200023535069,109496.45,60ec41ba55c00300382672d9,HDFC,Transfer in/Revenue-other,5eecc6d6449e4f7cfb1c2708,2022-02-02T00:00:00.000Z,50200050675669-TPT-REMITTANCE OG JAN22-H OUZ OF NATURE PVT LTD,,,net_banking_transfer,1283
6229d5dad8beac15993d3509,50200023535069,107493.17,60ec41ba55c00300382672d9,HDFC,SAAS/tech expense,5eecc6d6449e4f7cfb1c2708,2022-02-02T00:00:00.000Z,POS 514834XXXXXX9486 AMAZON.COM,shopping,,debit_card,-2003.28
6229d5dad8beac15993d350b,50200023535069,107894.85,60ec41ba55c00300382672d9,HDFC,Revenue-PG-split enabled,5eecc6d6449e4f7cfb1c2708,2022-02-02T00:00:00.000Z,NEFT CR-UTIB0001506-RAZORPAY SOFTWARE PR IVATE LIMITED-SLICK ORGANICS PVT LITD-AX ISCN0120856158,insurance,,net_banking_transfer,401.68
6229d5dad8beac15993d350d,50200023535069,82894.85,60ec41ba55c00300382672d9,HDFC,direct expenses,5eecc6d6449e4f7cfb1c2708,2022-02-02T00:00:00.000Z,POS 514834XXXXXX9486 FLIPKART,shopping,,debit_card,-25000
6229d5dad8beac15993d350f,50200023535069,83758.69,60ec41ba55c00300382672d9,HDFC,Revenue-PG-non-split,5eecc6d6449e4f7cfb1c2708,2022-02-02T00:00:00.000Z,NEFT CR-IDFB0010204-SEZZLE PAYMENTS PRIV ATE LIMITED-SLICK ORGANICS PRIVATE LIMIT ED-IDFBH22033490710,insurance,,net_banking_transfer,863.84
6229d5dad8beac15993d3511,50200023535069,58758.69,60ec41ba55c00300382672d9,HDFC,direct expenses,5eecc6d6449e4f7cfb1c2708,2022-02-02T00:00:00.000Z,"NEFT DR-ICIC0003851-JITENDER KUMAR-NETBA NK, MUM-N033221817065377-25000",,,net_banking_transfer,-25000
6229d5dad8beac15993d3514,50200023535069,82803.79,60ec41ba55c00300382672d9,HDFC,Revenue-PG-non-split,5eecc6d6449e4f7cfb1c2708,2022-02-03T00:00:00.000Z,IMPS-203404326451-PAYTM PAYMENTS SERVI-P YTM-XXXXXXXXXX0008-ALL202202032168200003 30830668628,ewallet,,net_banking_transfer,24045.1
6229d5dad8beac15993d3516,50200023535069,83201.85,60ec41ba55c00300382672d9,HDFC,Revenue-PG-split enabled,5eecc6d6449e4f7cfb1c2708,2022-02-03T00:00:00.000Z,NEFT CR-UTIB0001506-RAZORPAY SOFTWARE PR IVATE LIMITED-SLICK ORGANICS PVT LITD-AX ISCN0120896065,insurance,,net_banking_transfer,398.06
6229d5dad8beac15993d3518,50200023535069,88136.27,60ec41ba55c00300382672d9,HDFC,Revenue-PG-non-split,5eecc6d6449e4f7cfb1c2708,2022-02-03T00:00:00.000Z,NEFT CR-SCBL0036001-STRIPE INDIA PRIVATE,,,net_banking_transfer,4934.42
6229d5dad8beac15993d351a,50200023535069,38136.27,60ec41ba55c00300382672d9,HDFC,direct expenses,5eecc6d6449e4f7cfb1c2708,2022-02-03T00:00:00.000Z,"NEFT DR-PUNB0062910-YADAVPACKAGING-NETBA NK, MUM-N034221817845007-50000",,,net_banking_transfer,-50000
6229d5dad8beac15993d351c,50200023535069,538136.27,60ec41ba55c00300382672d9,HDFC,Internal Transfers,5eecc6d6449e4f7cfb1c2708,2022-02-03T00:00:00.000Z,IB FUNDS TRANSFER CR-50200035187206 -SL ICK ORGANICS PVT LTD,insurance,,Other,500000
6229d5dad8beac15993d351e,50200023535069,283136.27,60ec41ba55c00300382672d9,HDFC,SAAS/tech expense,5eecc6d6449e4f7cfb1c2708,2022-02-03T00:00:00.000Z,POS 514834XXXXXX9486 AMAZON,shopping,,debit_card,-255000
6229d5dad8beac15993d3520,50200023535069,250736.27,60ec41ba55c00300382672d9,HDFC,direct expenses,5eecc6d6449e4f7cfb1c2708,2022-02-03T00:00:00.000Z,50200039330521-TPT-32400-ELITE PUBLICIST,insurance,,net_banking_transfer,-32400
6229d5dad8beac15993d3522,50200023535069,282976.11,60ec41ba55c00300382672d9,HDFC,Revenue-UPI,5eecc6d6449e4f7cfb1c2708,2022-02-03T00:00:00.000Z,UPI-GOKWIK-GOKWIK@YESBANK-YESB0000340-20 3439546558-PAYOUT FOR FEBRUAR,,,upi,32239.84
6229d5dad8beac15993d3526,50200023535069,284691.04,60ec41ba55c00300382672d9,HDFC,Revenue-PG-non-split,5eecc6d6449e4f7cfb1c2708,2022-02-03T00:00:00.000Z,NEFT CR-IDFB0010204-SEZZLE PAYMENTS PRIV ATE LIMITED-SLICK ORGANICS PRIVATE LIMIT ED-IDFBH22034583189,insurance,,net_banking_transfer,1714.93
6229d5dad8beac15993d3528,50200023535069,284816.87,60ec41ba55c00300382672d9,HDFC,Revenue-PG-split enabled,5eecc6d6449e4f7cfb1c2708,2022-02-03T00:00:00.000Z,NEFT CR-UTIB0001506-RAZORPAY SOFTWARE PR IVATE LIMITED-SLICK ORGANICS PVT LITD-AX ISCN0121000559,insurance,,net_banking_transfer,125.83
6229d5dad8beac15993d352a,50200023535069,308560.51,60ec41ba55c00300382672d9,HDFC,Revenue-UPI,5eecc6d6449e4f7cfb1c2708,2022-02-03T00:00:00.000Z,UPI-GOKWIK-GOKWIK@YESBANK-YESB0000340-20 3440452581-PAYOUT FOR JANUARY,,,upi,23743.64
6229d5dad8beac15993d352c,50200023535069,322009.27,60ec41ba55c00300382672d9,HDFC,Revenue-Mktplace,5eecc6d6449e4f7cfb1c2708,2022-02-04T00:00:00.000Z,NEFT CR-DEUT0797BGL-FLIPKART INTERNET PR IVATE LIMITED-SLICK ORGANICS PVT LTD-203 500123GN00166,shopping,,net_banking_transfer,13448.76
6229d5dad8beac15993d352e,50200023535069,331812.96,60ec41ba55c00300382672d9,HDFC,Revenue-PG-non-split,5eecc6d6449e4f7cfb1c2708,2022-02-04T00:00:00.000Z,IMPS-203504899260-PAYTM PAYMENTS SERVI-P YTM-XXXXXXXXXX0008-ALL202202042168200003 30830668628,ewallet,,net_banking_transfer,9803.69
6229d5dad8beac15993d3530,50200023535069,336289.15,60ec41ba55c00300382672d9,HDFC,Revenue-Mktplace,5eecc6d6449e4f7cfb1c2708,2022-02-04T00:00:00.000Z,NEFT CR-DEUT0797BGL-MYNTRA DESIGNS PRIVA TE LIMITED-SLICK ORGANICS PVT. LTD.-2035 01203GN00167,shopping,,net_banking_transfer,4476.19
6229d5dad8beac15993d3532,50200023535069,340140.13,60ec41ba55c00300382672d9,HDFC,Revenue-Mktplace,5eecc6d6449e4f7cfb1c2708,2022-02-04T00:00:00.000Z,NEFT CR-DEUT0797BGL-MYNTRA DESIGNS PRIVA TE LIMITED-SLICK ORGANICS PVT. LTD.-2035 01202GN00154,shopping,,net_banking_transfer,3850.98
6229d5dad8beac15993d3534,50200023535069,340383.8,60ec41ba55c00300382672d9,HDFC,Revenue-PG-split enabled,5eecc6d6449e4f7cfb1c2708,2022-02-04T00:00:00.000Z,NEFT CR-UTIB0001506-RAZORPAY SOFTWARE PR,,,net_banking_transfer,243.67
6229d5dad8beac15993d3536,50200023535069,246880.8,60ec41ba55c00300382672d9,HDFC,direct expenses,5eecc6d6449e4f7cfb1c2708,2022-02-04T00:00:00.000Z,"NEFT DR-KKBK0000180-VEDIC COSMECEUTICALS PVT LTD-NETBANK, MUM-N035221819229763-9 3503",,,net_banking_transfer,-93503
6229d5dad8beac15993d3538,50200023535069,146880.8,60ec41ba55c00300382672d9,HDFC,direct expenses,5eecc6d6449e4f7cfb1c2708,2022-02-04T00:00:00.000Z,"NEFT DR-KKBK0001393-MASCOT SPINCONTROL I NDIA PVT LTD-NETBANK, MUM-N0352218192325 82-100000",,,net_banking_transfer,-100000
6229d5dad8beac15993d353a,50200023535069,1146880.8,60ec41ba55c00300382672d9,HDFC,Internal Transfers,5eecc6d6449e4f7cfb1c2708,2022-02-04T00:00:00.000Z,IB FUNDS TRANSFER CR-50200035187206 -SL ICK ORGANICS PVT LTD,insurance,,Other,1000000
6229d5dad8beac15993d353c,50200023535069,846880.8,60ec41ba55c00300382672d9,HDFC,direct expenses,5eecc6d6449e4f7cfb1c2708,2022-02-04T00:00:00.000Z,"NEFT DR-YESB0000551-VISTTA COSMETICS-NET BANK, MUM-N035221819234337-300000",,,net_banking_transfer,-300000
6229d5dad8beac15993d353e,50200023535069,496880.8,60ec41ba55c00300382672d9,HDFC,direct expenses,5eecc6d6449e4f7cfb1c2708,2022-02-04T00:00:00.000Z,57500000443889-TPT-350000-WEBKLIPPER TEC HNOLOGIES PRIVATE LIMITED,,,net_banking_transfer,-350000
6229d5dad8beac15993d3540,50200023535069,464480.8,60ec41ba55c00300382672d9,HDFC,direct expenses,5eecc6d6449e4f7cfb1c2708,2022-02-04T00:00:00.000Z,"NEFT DR-UTIB0000540-GROFERS INDIA PRIVAT E LIMITED-NETBANK, MUM-N035221819265344- 32400",groceries,,net_banking_transfer,-32400
6229d5dad8beac15993d3542,50200023535069,455480.8,60ec41ba55c00300382672d9,HDFC,direct expenses,5eecc6d6449e4f7cfb1c2708,2022-02-04T00:00:00.000Z,50100415834335-TPT-9000-NIHARIKA D/O TAR UN KUMAR,,,net_banking_transfer,-9000
6229d5dad8beac15993d3544,50200023535069,494637.8,60ec41ba55c00300382672d9,HDFC,Revenue-Mktplace,5eecc6d6449e4f7cfb1c2708,2022-02-04T00:00:00.000Z,NEFT CR-SCBL0036001-M/S DREAMPLUG TECHNO -SLICK ORGANICS PRIVATE LIMITEDSLICK-SIN 31436Q0031677,insurance,,net_banking_transfer,39157
6229d5dbd8beac15993d3546,50200023535069,549384.79,60ec41ba55c00300382672d9,HDFC,Revenue-UPI,5eecc6d6449e4f7cfb1c2708,2022-02-04T00:00:00.000Z,UPI-GOKWIK-GOKWIK@YESBANK-YESB0000340-20 3541769814-PAYOUT FOR FEBRUAR,,,upi,54746.99
6229d5dbd8beac15993d3548,50200023535069,549819.48,60ec41ba55c00300382672d9,HDFC,Revenue-Mktplace,5eecc6d6449e4f7cfb1c2708,2022-02-04T00:00:00.000Z,NEFT CR-ICIC0000105-MANASH LIFESTYLE PRI VATE LIMITED NO-SLICK ORGANICS PRIVATE L IMITED KOLK-ICIJ220350014558,shopping,,net_banking_transfer,434.69
6229d5dbd8beac15993d354a,50200023535069,550616.99,60ec41ba55c00300382672d9,HDFC,Revenue-Mktplace,5eecc6d6449e4f7cfb1c2708,2022-02-04T00:00:00.000Z,NEFT CR-ICIC0000105-MANASH LIFESTYLE PRI VATE LIMITED NO-SLICK ORGANICS PRIVATE L IMITED MP G-ICIJ220350014557,shopping,,net_banking_transfer,797.51
6229d5dbd8beac15993d354c,50200023535069,551760.51,60ec41ba55c00300382672d9,HDFC,Revenue-Mktplace,5eecc6d6449e4f7cfb1c2708,2022-02-04T00:00:00.000Z,NEFT CR-ICIC0000105-MANASH LIFESTYLE PRI,shopping,,net_banking_transfer,1143.52
6229d5dbd8beac15993d354e,50200023535069,552137.73,60ec41ba55c00300382672d9,HDFC,Revenue-Mktplace,5eecc6d6449e4f7cfb1c2708,2022-02-04T00:00:00.000Z,NEFT CR-DEUT0784BBY-TATA UNISTORE LTD-NO DAL-SLICK ORGANICS PVT LTD-203501807GN00 398,insurance,,net_banking_transfer,377.22
6229d5dbd8beac15993d3550,50200023535069,552229.3,60ec41ba55c00300382672d9,HDFC,Revenue-PG-split enabled,5eecc6d6449e4f7cfb1c2708,2022-02-04T00:00:00.000Z,NEFT CR-UTIB0001506-RAZORPAY SOFTWARE PR IVATE LIMITED-SLICK ORGANICS PVT LITD-AX ISCN0121206300,insurance,,net_banking_transfer,91.57
6229d5dbd8beac15993d3552,50200023535069,721969.03,60ec41ba55c00300382672d9,HDFC,Revenue-COD,5eecc6d6449e4f7cfb1c2708,2022-02-04T00:00:00.000Z,NEFT CR-ICIC0000155-SHIPROCKET COD CRF I D 3769193-SLICK ORGANICS PVT LTD-CMS2379 686108,insurance,,net_banking_transfer,169739.73
6229d5dbd8beac15993d3554,50200023535069,731091.38,60ec41ba55c00300382672d9,HDFC,Revenue-PG-non-split,5eecc6d6449e4f7cfb1c2708,2022-02-05T00:00:00.000Z,IMPS-203604634626-PAYTM PAYMENTS SERVI-P YTM-XXXXXXXXXX0008-ALL202202052168200003 30830668628,ewallet,,net_banking_transfer,9122.35
6229d5dbd8beac15993d3556,50200023535069,731234.34,60ec41ba55c00300382672d9,HDFC,Revenue-PG-split enabled,5eecc6d6449e4f7cfb1c2708,2022-02-05T00:00:00.000Z,NEFT CR-UTIB0001506-RAZORPAY SOFTWARE PR IVATE LIMITED-SLICK ORGANICS PVT LITD-AX ISCN0121248195,insurance,,net_banking_transfer,142.96
6229d5dbd8beac15993d3558,50200023535069,722907.07,60ec41ba55c00300382672d9,HDFC,bank charges,5eecc6d6449e4f7cfb1c2708,2022-02-05T00:00:00.000Z,.DC INTL POS TXN MARKUP+ST 260122 280122 -CDT2203407778480,,,international_transaction_arbitrage,-8327.27
6229d5dbd8beac15993d355a,50200023535069,722820.01,60ec41ba55c00300382672d9,HDFC,bank charges,5eecc6d6449e4f7cfb1c2708,2022-02-05T00:00:00.000Z,.DC INTL POS TXN MARKUP+ST 260122 280122 -CDT2203407778480,,,international_transaction_arbitrage,-87.06
6229d5dbd8beac15993d355c,50200023535069,728677.01,60ec41ba55c00300382672d9,HDFC,Transfer in/Revenue-other,5eecc6d6449e4f7cfb1c2708,2022-02-05T00:00:00.000Z,NEFT CR-KKBK0000958-INNOVATIVE RETAIL CO NCEPTS PRIVATE LTD-SLICK ORGANICS PVT LT D-KKBK220367249444,,,net_banking_transfer,5857
6229d5dbd8beac15993d355e,50200023535069,729585.01,60ec41ba55c00300382672d9,HDFC,Transfer in/Revenue-other,5eecc6d6449e4f7cfb1c2708,2022-02-05T00:00:00.000Z,NEFT CR-KKBK0000958-INNOVATIVE RETAIL CO NCEPTS PRIVATE LTD-SLICK ORGANICS PVT LT D-KKBK220367248978,,,net_banking_transfer,908
6229d5dbd8beac15993d3560,50200023535069,754379.13,60ec41ba55c00300382672d9,HDFC,Revenue-UPI,5eecc6d6449e4f7cfb1c2708,2022-02-05T00:00:00.000Z,UPI-GOKWIK-GOKWIK@YESBANK-YESB0000340-20 3643703311-PAYOUT FOR FEBRUAR,,,upi,24794.12
6229d5dbd8beac15993d3562,50200023535069,754666.07,60ec41ba55c00300382672d9,HDFC,Revenue-PG-split enabled,5eecc6d6449e4f7cfb1c2708,2022-02-05T00:00:00.000Z,NEFT CR-UTIB0001506-RAZORPAY SOFTWARE PR IVATE LIMITED-SLICK ORGANICS PVT LITD-AX ISCN0121325406,insurance,,net_banking_transfer,286.94
6229d5dbd8beac15993d3565,50200023535069,772454.22,60ec41ba55c00300382672d9,HDFC,Revenue-PG-non-split,5eecc6d6449e4f7cfb1c2708,2022-02-06T00:00:00.000Z,IMPS-203704139462-PAYTM PAYMENTS SERVI-P,ewallet,,net_banking_transfer,17788.15
6229d5dbd8beac15993d3567,50200023535069,785066.02,60ec41ba55c00300382672d9,HDFC,Revenue-Mktplace,5eecc6d6449e4f7cfb1c2708,2022-02-07T00:00:00.000Z,NEFT CR-DEUT0797BGL-FLIPKART INTERNET PR IVATE LIMITED-SLICK ORGANICS PVT LTD-203 800134GN00155,shopping,,net_banking_transfer,12611.8
6229d5dbd8beac15993d3569,50200023535069,799497.28,60ec41ba55c00300382672d9,HDFC,Revenue-PG-non-split,5eecc6d6449e4f7cfb1c2708,2022-02-07T00:00:00.000Z,IMPS-203804574510-PAYTM PAYMENTS SERVI-P YTM-XXXXXXXXXX0008-ALL202202072168200003 30830668628,ewallet,,net_banking_transfer,14431.26
6229d5dbd8beac15993d356b,50200023535069,800858.11,60ec41ba55c00300382672d9,HDFC,Revenue-Mktplace,5eecc6d6449e4f7cfb1c2708,2022-02-07T00:00:00.000Z,NEFT CR-DEUT0797BGL-MYNTRA DESIGNS PRIVA TE LIMITED-SLICK ORGANICS PVT. LTD.-2038 00582GN00164,shopping,,net_banking_transfer,1360.83
6229d5dbd8beac15993d356d,50200023535069,817674.71,60ec41ba55c00300382672d9,HDFC,Revenue-Mktplace,5eecc6d6449e4f7cfb1c2708,2022-02-07T00:00:00.000Z,NEFT CR-DEUT0797BGL-MYNTRA DESIGNS PRIVA TE LIMITED-SLICK ORGANICS PVT. LTD.-2038 00581GN00182,shopping,,net_banking_transfer,16816.6
6229d5dbd8beac15993d356f,50200023535069,705174.71,60ec41ba55c00300382672d9,HDFC,direct expenses,5eecc6d6449e4f7cfb1c2708,2022-02-07T00:00:00.000Z,50100093802387-TPT-112500-ISSHANA MAHAJA N,,,net_banking_transfer,-112500
6229d5dbd8beac15993d3571,50200023535069,639464.71,60ec41ba55c00300382672d9,HDFC,direct expenses,5eecc6d6449e4f7cfb1c2708,2022-02-07T00:00:00.000Z,"NEFT DR-ICIC0000021-AKHILESH DIXIT-NETBA NK, MUM-N038221822520004-65710",,,net_banking_transfer,-65710
6229d5dbd8beac15993d3573,50200023535069,583964.71,60ec41ba55c00300382672d9,HDFC,direct expenses,5eecc6d6449e4f7cfb1c2708,2022-02-07T00:00:00.000Z,50100293329616-TPT-55500-SADIYA BANO,,,net_banking_transfer,-55500
6229d5dbd8beac15993d3576,50200023535069,533964.71,60ec41ba55c00300382672d9,HDFC,direct expenses,5eecc6d6449e4f7cfb1c2708,2022-02-07T00:00:00.000Z,"NEFT DR-UTIB0000120-ADNAN ALI-NETBANK, M UM-N038221822524436-50000",,,net_banking_transfer,-50000
6229d5dbd8beac15993d3578,50200023535069,483964.71,60ec41ba55c00300382672d9,HDFC,direct expenses,5eecc6d6449e4f7cfb1c2708,2022-02-07T00:00:00.000Z,"NEFT DR-ICIC0003851-JITENDER KUMAR-NETBA NK, MUM-N038221822504568-50000",,,net_banking_transfer,-50000
6229d5dbd8beac15993d357a,50200023535069,433964.71,60ec41ba55c00300382672d9,HDFC,direct expenses,5eecc6d6449e4f7cfb1c2708,2022-02-07T00:00:00.000Z,50100064106714-TPT-50000-AKSHARANSH BHAT T,,,net_banking_transfer,-50000
6229d5dbd8beac15993d357c,50200023535069,397964.71,60ec41ba55c00300382672d9,HDFC,direct expenses,5eecc6d6449e4f7cfb1c2708,2022-02-07T00:00:00.000Z,00901610080520-TPT-36000-POOJA KAPIL SHR OTRIYA,,,net_banking_transfer,-36000
6229d5dbd8beac15993d357e,50200023535069,378610.71,60ec41ba55c00300382672d9,HDFC,direct expenses,5eecc6d6449e4f7cfb1c2708,2022-02-07T00:00:00.000Z,"NEFT DR-KKBK0008365-SRIRAJ GUNDA-NETBANK , MUM-N038221822541362-19354",,,net_banking_transfer,-19354
6229d5dbd8beac15993d3580,50200023535069,360868.71,60ec41ba55c00300382672d9,HDFC,direct expenses,5eecc6d6449e4f7cfb1c2708,2022-02-07T00:00:00.000Z,"NEFT DR-UTIB0001895-ISHANI CHAKRABARTI-N ETBANK, MUM-N038221822541510-17742",,,net_banking_transfer,-17742
6229d5dbd8beac15993d3582,50200023535069,361114.02,60ec41ba55c00300382672d9,HDFC,Revenue-PG-split enabled,5eecc6d6449e4f7cfb1c2708,2022-02-07T00:00:00.000Z,NEFT CR-UTIB0001506-RAZORPAY SOFTWARE PR,,,net_banking_transfer,245.31
6229d5dbd8beac15993d3584,50200023535069,339614.02,60ec41ba55c00300382672d9,HDFC,direct expenses,5eecc6d6449e4f7cfb1c2708,2022-02-07T00:00:00.000Z,"NEFT DR-SIBL0000555-JAIVEER KUMAR-NETBAN K, MUM-N038221822544286-21500",,,net_banking_transfer,-21500
6229d5dbd8beac15993d3586,50200023535069,318114.02,60ec41ba55c00300382672d9,HDFC,direct expenses,5eecc6d6449e4f7cfb1c2708,2022-02-07T00:00:00.000Z,"NEFT DR-PUNB0482100-RAM BHAVAN YADAV-NET BANK, MUM-N038221822551785-21500",,,net_banking_transfer,-21500
6229d5dbd8beac15993d3588,50200023535069,296614.02,60ec41ba55c00300382672d9,HDFC,direct expenses,5eecc6d6449e4f7cfb1c2708,2022-02-07T00:00:00.000Z,"NEFT DR-BARB0VJGRKA-OM PRASAD PANDEY-NET BANK, MUM-N038221822551965-21500",,,net_banking_transfer,-21500
6229d5dbd8beac15993d358a,50200023535069,278749.02,60ec41ba55c00300382672d9,HDFC,direct expenses,5eecc6d6449e4f7cfb1c2708,2022-02-07T00:00:00.000Z,"NEFT DR-KKBK0005032-DEEPAK YADAV-NETBANK , MUM-N038221822552102-17865",,,net_banking_transfer,-17865
6229d5dbd8beac15993d358c,50200023535069,262770.02,60ec41ba55c00300382672d9,HDFC,direct expenses,5eecc6d6449e4f7cfb1c2708,2022-02-07T00:00:00.000Z,"NEFT DR-PUNB0151400-BHUWAN CHANDER JOSHI -NETBANK, MUM-N038221822552336-15979",,,net_banking_transfer,-15979
6229d5dbd8beac15993d358e,50200023535069,246791.02,60ec41ba55c00300382672d9,HDFC,direct expenses,5eecc6d6449e4f7cfb1c2708,2022-02-07T00:00:00.000Z,"NEFT DR-PUNB0494300-KUNDAN PRASAD-NETBAN K, MUM-N038221822552612-15979",,,net_banking_transfer,-15979
6229d5dbd8beac15993d3590,50200023535069,230812.02,60ec41ba55c00300382672d9,HDFC,direct expenses,5eecc6d6449e4f7cfb1c2708,2022-02-07T00:00:00.000Z,"NEFT DR-BARB0DINARA-MD ARIF RAZA-NETBANK , MUM-N038221822553087-15979",,,net_banking_transfer,-15979
6229d5dbd8beac15993d3592,50200023535069,216185.02,60ec41ba55c00300382672d9,HDFC,direct expenses,5eecc6d6449e4f7cfb1c2708,2022-02-07T00:00:00.000Z,"NEFT DR-PUNB0307800-SANJEEV NIRMANIA-NET BANK, MUM-N038221822553459-14627",,,net_banking_transfer,-14627
6229d5dbd8beac15993d3594,50200023535069,199832.02,60ec41ba55c00300382672d9,HDFC,N-ACH payments,5eecc6d6449e4f7cfb1c2708,2022-02-07T00:00:00.000Z,"NEFT DR-DBSS0IN0811-SACHIN SINGH-NETBANK , MUM-N038221822548564-16353",,,net_banking_transfer,-16353
6229d5dbd8beac15993d3596,50200023535069,183853.02,60ec41ba55c00300382672d9,HDFC,direct expenses,5eecc6d6449e4f7cfb1c2708,2022-02-07T00:00:00.000Z,02711600008220-TPT-15979-VARUN SINGH,,,net_banking_transfer,-15979
6229d5dbd8beac15993d3598,50200023535069,16182.02,60ec41ba55c00300382672d9,HDFC,direct expenses,5eecc6d6449e4f7cfb1c2708,2022-02-07T00:00:00.000Z,"NEFT DR-ICIC0001134-VASU JAIN-NETBANK, M UM-N038221822558268-167671",,,net_banking_transfer,-167671
6229d5dbd8beac15993d359a,50200023535069,-5317.98,60ec41ba55c00300382672d9,HDFC,direct expenses,5eecc6d6449e4f7cfb1c2708,2022-02-07T00:00:00.000Z,"NEFT DR-PUNB0307800-PRAKASH JHA-NETBANK, MUM-N038221822566239-21500",,,net_banking_transfer,-21500
6229d5dbd8beac15993d359c,50200023535069,494682.02,60ec41ba55c00300382672d9,HDFC,Internal Transfers,5eecc6d6449e4f7cfb1c2708,2022-02-07T00:00:00.000Z,IB FUNDS TRANSFER CR-50200035187206 -SL ICK ORGANICS PVT LTD,insurance,,Other,500000
6229d5dbd8beac15993d359e,50200023535069,562476.02,60ec41ba55c00300382672d9,HDFC,Transfer in/Revenue-other,5eecc6d6449e4f7cfb1c2708,2022-02-07T00:00:00.000Z,NEFT CR-ICIC0SF0002-ENRICH HAIR - SKIN S -SLICK ORGANICS PRIVATE LIMITED-26265897 661DC,insurance,,net_banking_transfer,67794
6229d5dbd8beac15993d35a0,50200023535069,307476.02,60ec41ba55c00300382672d9,HDFC,SAAS/tech expense,5eecc6d6449e4f7cfb1c2708,2022-02-07T00:00:00.000Z,POS 514834XXXXXX9486 AMAZON,shopping,,debit_card,-255000
6229d5dbd8beac15993d35a2,50200023535069,305250.02,60ec41ba55c00300382672d9,HDFC,direct expenses,5eecc6d6449e4f7cfb1c2708,2022-02-07T00:00:00.000Z,50100093802387-TPT-2226-ISSHANA MAHAJAN,,,net_banking_transfer,-2226
6229d5dbd8beac15993d35a4,50200023535069,243562.02,60ec41ba55c00300382672d9,HDFC,direct expenses,5eecc6d6449e4f7cfb1c2708,2022-02-07T00:00:00.000Z,NEFT DR-KKBK0000187-APPLIED LIFE PRIVATE,,,net_banking_transfer,-61688
6229d5dbd8beac15993d35a6,50200023535069,79402.02,60ec41ba55c00300382672d9,HDFC,direct expenses,5eecc6d6449e4f7cfb1c2708,2022-02-07T00:00:00.000Z,"NEFT DR-BARB0VJMATU-ARTISTO DESIGNZ-NETB ANK, MUM-N038221822772816-164160",,,net_banking_transfer,-164160
6229d5dbd8beac15993d35a8,50200023535069,49405.02,60ec41ba55c00300382672d9,HDFC,direct expenses,5eecc6d6449e4f7cfb1c2708,2022-02-07T00:00:00.000Z,"NEFT DR-ICIC0001937-SAUMITRA PANDEY-NETB ANK, MUM-N038221822782736-29997",,,net_banking_transfer,-29997
6229d5dbd8beac15993d35aa,50200023535069,549405.02,60ec41ba55c00300382672d9,HDFC,Internal Transfers,5eecc6d6449e4f7cfb1c2708,2022-02-07T00:00:00.000Z,IB FUNDS TRANSFER CR-50200035187206 -SL ICK ORGANICS PVT LTD,insurance,,Other,500000
6229d5dbd8beac15993d35ac,50200023535069,471645.02,60ec41ba55c00300382672d9,HDFC,direct expenses,5eecc6d6449e4f7cfb1c2708,2022-02-07T00:00:00.000Z,"NEFT DR-DBSS0IN0811-SARANSH KULKARNI-NET BANK, MUM-N038221822786510-77760",,,net_banking_transfer,-77760
6229d5dbd8beac15993d35ae,50200023535069,363645.02,60ec41ba55c00300382672d9,HDFC,direct expenses,5eecc6d6449e4f7cfb1c2708,2022-02-07T00:00:00.000Z,50200054531492-TPT-108000-ALETA PEOPLE S ERVICES,,,net_banking_transfer,-108000
6229d5dbd8beac15993d35b0,50200023535069,315045.02,60ec41ba55c00300382672d9,HDFC,direct expenses,5eecc6d6449e4f7cfb1c2708,2022-02-07T00:00:00.000Z,"NEFT DR-CNRB0015170-SNEHAL TAYDE-NETBANK , MUM-N038221822809786-48600",,,net_banking_transfer,-48600
6229d5dbd8beac15993d35b2,50200023535069,1315045.02,60ec41ba55c00300382672d9,HDFC,Internal Transfers,5eecc6d6449e4f7cfb1c2708,2022-02-07T00:00:00.000Z,IB FUNDS TRANSFER CR-50200035187206 -SL ICK ORGANICS PVT LTD,insurance,,Other,1000000
6229d5dbd8beac15993d35b4,50200023535069,1305045.02,60ec41ba55c00300382672d9,HDFC,SAAS/tech expense,5eecc6d6449e4f7cfb1c2708,2022-02-07T00:00:00.000Z,POS 514834XXXXXX9486 PTM*DELHIVERY PR,,,debit_card,-10000
6229d5dbd8beac15993d35b6,50200023535069,1805045.02,60ec41ba55c00300382672d9,HDFC,Internal Transfers,5eecc6d6449e4f7cfb1c2708,2022-02-07T00:00:00.000Z,IB FUNDS TRANSFER CR-50200035187206 -SL ICK ORGANICS PVT LTD,insurance,,Other,500000
6229d5dbd8beac15993d35b8,50200023535069,445045.02,60ec41ba55c00300382672d9,HDFC,Marketing Expense,5eecc6d6449e4f7cfb1c2708,2022-02-07T00:00:00.000Z,"NEFT DR-CITI0000006-FACEBOOK INDIA ONLIN E SERVICES PVT LTD-NETBANK, MUM-N0382218 22884644-1360000",,,net_banking_transfer,-1360000
6229d5dbd8beac15993d35ba,50200023535069,415045.02,60ec41ba55c00300382672d9,HDFC,direct expenses,5eecc6d6449e4f7cfb1c2708,2022-02-07T00:00:00.000Z,"NEFT DR-ICIC0001134-VASU JAIN-NETBANK, M UM-N038221823037220-30000",,,net_banking_transfer,-30000
6229d5dbd8beac15993d35bc,50200023535069,390582.02,60ec41ba55c00300382672d9,HDFC,direct expenses,5eecc6d6449e4f7cfb1c2708,2022-02-07T00:00:00.000Z,"NEFT DR-ICIC0000396-SURABHI SARUP-NETBAN K, MUM-N038221823177236-24463",,,net_banking_transfer,-24463
6229d5dbd8beac15993d35be,50200023535069,391488.77,60ec41ba55c00300382672d9,HDFC,Revenue-Mktplace,5eecc6d6449e4f7cfb1c2708,2022-02-07T00:00:00.000Z,NEFT CR-ICIC0000105-MANASH LIFESTYLE PRI VATE LIMITED NO-SLICK ORGANICS PRIVATE L IMITED MP G-ICIJ220380011949,shopping,,net_banking_transfer,906.75
6229d5dbd8beac15993d35c0,50200023535069,391737.27,60ec41ba55c00300382672d9,HDFC,Revenue-Mktplace,5eecc6d6449e4f7cfb1c2708,2022-02-07T00:00:00.000Z,NEFT CR-ICIC0000105-MANASH LIFESTYLE PRI,shopping,,net_banking_transfer,248.5
6229d5dbd8beac15993d35c2,50200023535069,393404.87,60ec41ba55c00300382672d9,HDFC,Revenue-Mktplace,5eecc6d6449e4f7cfb1c2708,2022-02-07T00:00:00.000Z,NEFT CR-ICIC0000105-MANASH LIFESTYLE PRI VATE LIMITED NO-SLICK ORGANICS PRIVATE L IMITED MP M-ICIJ220380011951,shopping,,net_banking_transfer,1667.6
6229d5dbd8beac15993d35c4,50200023535069,393507.48,60ec41ba55c00300382672d9,HDFC,Revenue-Mktplace,5eecc6d6449e4f7cfb1c2708,2022-02-07T00:00:00.000Z,NEFT CR-ICIC0000105-MANASH LIFESTYLE PRI VATE LIMITED NO-SLICK ORGANICS PRIVATE L IMITED BANG-ICIJ220380011955,shopping,,net_banking_transfer,102.61
6229d5dbd8beac15993d35c7,50200023535069,321507.48,60ec41ba55c00300382672d9,HDFC,direct expenses,5eecc6d6449e4f7cfb1c2708,2022-02-07T00:00:00.000Z,50200063349422-TPT-72000-COHORT E-COMMER CE CONSULTING LLP,,,net_banking_transfer,-72000
6229d5dbd8beac15993d35c9,50200023535069,335303.15,60ec41ba55c00300382672d9,HDFC,Revenue-UPI,5eecc6d6449e4f7cfb1c2708,2022-02-07T00:00:00.000Z,UPI-GOKWIK-GOKWIK@YESBANK-YESB0000340-20 3847826796-PAYOUT FOR FEBRUAR,,,upi,13795.67
6229d5dbd8beac15993d35cc,50200023535069,336750.94,60ec41ba55c00300382672d9,HDFC,Revenue-COD,5eecc6d6449e4f7cfb1c2708,2022-02-07T00:00:00.000Z,NEFT CR-ICIC0000155-SHIPROCKET COD CRF I D 3777013-SLICK ORGANICS PVT LTD-CMS2384 505733,insurance,,net_banking_transfer,1447.79
6229d5dbd8beac15993d35ce,50200023535069,341542.85,60ec41ba55c00300382672d9,HDFC,Revenue-PG-non-split,5eecc6d6449e4f7cfb1c2708,2022-02-07T00:00:00.000Z,NEFT CR-IDFB0010204-SEZZLE PAYMENTS PRIV ATE LIMITED-SLICK ORGANICS PRIVATE LIMIT ED-IDFBH22038842721,insurance,,net_banking_transfer,4791.91
6229d5dbd8beac15993d35d0,50200023535069,343680.34,60ec41ba55c00300382672d9,HDFC,Revenue-PG-non-split,5eecc6d6449e4f7cfb1c2708,2022-02-07T00:00:00.000Z,NEFT CR-IDFB0010204-SEZZLE PAYMENTS PRIV ATE LIMITED-SLICK ORGANICS PRIVATE LIMIT ED-IDFBH22038842824,insurance,,net_banking_transfer,2137.49
6229d5dbd8beac15993d35d2,50200023535069,344259.24,60ec41ba55c00300382672d9,HDFC,Revenue-PG-non-split,5eecc6d6449e4f7cfb1c2708,2022-02-07T00:00:00.000Z,NEFT CR-IDFB0010204-SEZZLE PAYMENTS PRIV ATE LIMITED-SLICK ORGANICS PRIVATE LIMIT ED-IDFBH22038843535,insurance,,net_banking_transfer,578.9
6229d5dbd8beac15993d35d4,50200023535069,345369.16,60ec41ba55c00300382672d9,HDFC,Revenue-PG-split enabled,5eecc6d6449e4f7cfb1c2708,2022-02-07T00:00:00.000Z,NEFT CR-UTIB0001506-RAZORPAY SOFTWARE PR IVATE LIMITED-SLICK ORGANICS PVT LITD-AX ISCN0121439286,insurance,,net_banking_transfer,1109.92
6229d5dbd8beac15993d35d6,50200023535069,245369.16,60ec41ba55c00300382672d9,HDFC,direct expenses,5eecc6d6449e4f7cfb1c2708,2022-02-07T00:00:00.000Z,"NEFT DR-SCBL0036025-DHRUV MADHOK-NETBANK , MUM-N038221824308523-100000",,,net_banking_transfer,-100000
6229d5dbd8beac15993d35d8,50200023535069,45369.16,60ec41ba55c00300382672d9,HDFC,direct expenses,5eecc6d6449e4f7cfb1c2708,2022-02-07T00:00:00.000Z,02711930004579-TPT-200000-DHRUV BHASIN,,,net_banking_transfer,-200000
6229d5dbd8beac15993d35da,50200023535069,545369.16,60ec41ba55c00300382672d9,HDFC,Internal Transfers,5eecc6d6449e4f7cfb1c2708,2022-02-07T00:00:00.000Z,IB FUNDS TRANSFER CR-50200035187206 -SL ICK ORGANICS PVT LTD,insurance,,Other,500000
6229d5dbd8beac15993d35dc,50200023535069,562555.94,60ec41ba55c00300382672d9,HDFC,Revenue-PG-non-split,5eecc6d6449e4f7cfb1c2708,2022-02-08T00:00:00.000Z,IMPS-203904218244-PAYTM PAYMENTS SERVI-P,ewallet,,net_banking_transfer,17186.78
6229d5dbd8beac15993d35de,50200023535069,668059.1,60ec41ba55c00300382672d9,HDFC,Revenue-Mktplace,5eecc6d6449e4f7cfb1c2708,2022-02-08T00:00:00.000Z,IMPS-203905141438-AMAZON SELLER SERVIC-H SBC-XXXXXXXX6004-6ZNXD8938EI5U998SLICK O RGANICS PVT LTD,shopping,,net_banking_transfer,105503.16
6229d5dbd8beac15993d35e1,50200023535069,1094318.18,60ec41ba55c00300382672d9,HDFC,Revenue-Mktplace,5eecc6d6449e4f7cfb1c2708,2022-02-08T00:00:00.000Z,NEFT CR-DEUT0797BGL-AMAZON PAY (INDIA) P RIVATE LIMITED-SLICK ORGANICS PVT LTD-20 3900141GN00207,shopping,,net_banking_transfer,426259.08
6229d5dbd8beac15993d35e3,50200023535069,1094551.66,60ec41ba55c00300382672d9,HDFC,Revenue-PG-split enabled,5eecc6d6449e4f7cfb1c2708,2022-02-08T00:00:00.000Z,NEFT CR-UTIB0001506-RAZORPAY SOFTWARE PR IVATE LIMITED-SLICK ORGANICS PVT LITD-AX ISCN0121494894,insurance,,net_banking_transfer,233.48
6229d5dbd8beac15993d35e5,50200023535069,994551.66,60ec41ba55c00300382672d9,HDFC,Marketing Expense,5eecc6d6449e4f7cfb1c2708,2022-02-08T00:00:00.000Z,POS 514834XXXXXX9486 GOOGLESERVIS,,,debit_card,-100000
6229d5dbd8beac15993d35e8,50200023535069,823981.66,60ec41ba55c00300382672d9,HDFC,direct expenses,5eecc6d6449e4f7cfb1c2708,2022-02-08T00:00:00.000Z,"NEFT DR-KKBK0000180-VEDIC COSMECEUTICALS PVT LTD-NETBANK, MUM-N039221824969099-1 70570",,,net_banking_transfer,-170570
6229d5dbd8beac15993d35ea,50200023535069,853418.02,60ec41ba55c00300382672d9,HDFC,Revenue-UPI,5eecc6d6449e4f7cfb1c2708,2022-02-08T00:00:00.000Z,UPI-GOKWIK-GOKWIK@YESBANK-YESB0000340-20 3950090918-PAYOUT FOR FEBRUAR,,,upi,29436.36
6229d5dbd8beac15993d35ec,50200023535069,856574.13,60ec41ba55c00300382672d9,HDFC,Revenue-PG-non-split,5eecc6d6449e4f7cfb1c2708,2022-02-08T00:00:00.000Z,NEFT CR-IDFB0010204-SEZZLE PAYMENTS PRIV ATE LIMITED-SLICK ORGANICS PRIVATE LIMIT ED-IDFBH22039936005,insurance,,net_banking_transfer,3156.11
6229d5dbd8beac15993d35ee,50200023535069,906140.13,60ec41ba55c00300382672d9,HDFC,Transfer in/Revenue-other,5eecc6d6449e4f7cfb1c2708,2022-02-08T00:00:00.000Z,NEFT CR-UTIB0004405-WOOVLY INDIA PRIVATE LIMITED-SLICK ORGANICS PVT LTD-AXISP002 61704682,insurance,,net_banking_transfer,49566
6229d5dbd8beac15993d35f0,50200023535069,912023.13,60ec41ba55c00300382672d9,HDFC,Transfer in/Revenue-other,5eecc6d6449e4f7cfb1c2708,2022-02-08T00:00:00.000Z,NEFT CR-UTIB0004405-WOOVLY INDIA PRIVATE LIMITED-SLICK ORGANICS PVT LTD-AXISP002 61704696,insurance,,net_banking_transfer,5883
6229d5dbd8beac15993d35f2,50200023535069,927641.13,60ec41ba55c00300382672d9,HDFC,Transfer in/Revenue-other,5eecc6d6449e4f7cfb1c2708,2022-02-08T00:00:00.000Z,NEFT CR-UTIB0004405-WOOVLY INDIA PRIVATE LIMITED-SLICK ORGANICS PVT LTD-AXISP002 61704722,insurance,,net_banking_transfer,15618
6229d5dbd8beac15993d35f4,50200023535069,928462.17,60ec41ba55c00300382672d9,HDFC,Transfer in/Revenue-other,5eecc6d6449e4f7cfb1c2708,2022-02-08T00:00:00.000Z,57500000644820-SLICK ORGANICS,insurance,,Other,821.04
6229d5dbd8beac15993d35f6,50200023535069,931806.07,60ec41ba55c00300382672d9,HDFC,Revenue-PG-split enabled,5eecc6d6449e4f7cfb1c2708,2022-02-08T00:00:00.000Z,NEFT CR-UTIB0001506-RAZORPAY SOFTWARE PR,,,net_banking_transfer,3343.9
6229d5dbd8beac15993d35f8,50200023535069,1483574.07,60ec41ba55c00300382672d9,HDFC,Transfer in/Revenue-other,5eecc6d6449e4f7cfb1c2708,2022-02-08T00:00:00.000Z,00640330000510-SLICK ORGANICS PVT L,insurance,,Other,551768
6229d5dbd8beac15993d35fa,50200023535069,1495184.18,60ec41ba55c00300382672d9,HDFC,Revenue-Mktplace,5eecc6d6449e4f7cfb1c2708,2022-02-09T00:00:00.000Z,NEFT CR-DEUT0797BGL-FLIPKART INTERNET PR IVATE LIMITED-SLICK ORGANICS PVT LTD-204 000121GN00114,shopping,,net_banking_transfer,11610.11
6229d5dbd8beac15993d35fc,50200023535069,1509458.7,60ec41ba55c00300382672d9,HDFC,Revenue-PG-non-split,5eecc6d6449e4f7cfb1c2708,2022-02-09T00:00:00.000Z,IMPS-204004809892-PAYTM PAYMENTS SERVI-P YTM-XXXXXXXXXX0008-ALL202202092168200003 30830668628,ewallet,,net_banking_transfer,14274.52
6229d5dbd8beac15993d35fe,50200023535069,1518929.32,60ec41ba55c00300382672d9,HDFC,Revenue-Mktplace,5eecc6d6449e4f7cfb1c2708,2022-02-09T00:00:00.000Z,NEFT CR-DEUT0797BGL-MYNTRA DESIGNS PRIVA TE LIMITED-SLICK ORGANICS PVT. LTD.-2040 00833GN00201,shopping,,net_banking_transfer,9470.62
6229d5dbd8beac15993d3600,50200023535069,1520288.94,60ec41ba55c00300382672d9,HDFC,Revenue-Mktplace,5eecc6d6449e4f7cfb1c2708,2022-02-09T00:00:00.000Z,NEFT CR-DEUT0797BGL-MYNTRA DESIGNS PRIVA TE LIMITED-SLICK ORGANICS PVT. LTD.-2040 00834GN00182,shopping,,net_banking_transfer,1359.62
6229d5dcd8beac15993d3602,50200023535069,1520482.08,60ec41ba55c00300382672d9,HDFC,Revenue-PG-split enabled,5eecc6d6449e4f7cfb1c2708,2022-02-09T00:00:00.000Z,NEFT CR-UTIB0001506-RAZORPAY SOFTWARE PR IVATE LIMITED-SLICK ORGANICS PVT LITD-AX ISCN0121779159,insurance,,net_banking_transfer,193.14
6229d5dcd8beac15993d3604,50200023535069,1589560.77,60ec41ba55c00300382672d9,HDFC,Revenue-Mktplace,5eecc6d6449e4f7cfb1c2708,2022-02-09T00:00:00.000Z,NEFT CR-KKBK0000958-NYKAA E RETAIL PRIVA TE LIMITED NYKAA-SLICK ORGANICS PVT LTD- KKBK220408159633,insurance,,net_banking_transfer,69078.69
6229d5dcd8beac15993d3606,50200023535069,1611433.02,60ec41ba55c00300382672d9,HDFC,Revenue-UPI,5eecc6d6449e4f7cfb1c2708,2022-02-09T00:00:00.000Z,UPI-GOKWIK-GOKWIK@YESBANK-YESB0000340-20 4052297176-PAYOUT FOR FEBRUAR,,,upi,21872.25
6229d5dcd8beac15993d3608,50200023535069,1611638.17,60ec41ba55c00300382672d9,HDFC,Revenue-PG-split enabled,5eecc6d6449e4f7cfb1c2708,2022-02-09T00:00:00.000Z,NEFT CR-UTIB0001506-RAZORPAY SOFTWARE PR IVATE LIMITED-SLICK ORGANICS PVT LITD-AX ISCN0121870451,insurance,,net_banking_transfer,205.15
6229d5dcd8beac15993d360a,50200023535069,1719064.02,60ec41ba55c00300382672d9,HDFC,Revenue-COD,5eecc6d6449e4f7cfb1c2708,2022-02-09T00:00:00.000Z,NEFT CR-ICIC0000155-SHIPROCKET COD CRF I D 3789307-SLICK ORGANICS PVT LTD-CMS2388 278902,insurance,,net_banking_transfer,107425.85
6229d5dcd8beac15993d360c,50200023535069,1733922.71,60ec41ba55c00300382672d9,HDFC,Revenue-PG-non-split,5eecc6d6449e4f7cfb1c2708,2022-02-10T00:00:00.000Z,IMPS-204104443117-PAYTM PAYMENTS SERVI-P YTM-XXXXXXXXXX0008-ALL202202102168200003 30830668628,ewallet,,net_banking_transfer,14858.69
6229d5dcd8beac15993d360e,50200023535069,1734106.78,60ec41ba55c00300382672d9,HDFC,Revenue-PG-split enabled,5eecc6d6449e4f7cfb1c2708,2022-02-10T00:00:00.000Z,NEFT CR-UTIB0001506-RAZORPAY SOFTWARE PR,,,net_banking_transfer,184.07
6229d5dcd8beac15993d3610,50200023535069,290851.78,60ec41ba55c00300382672d9,HDFC,Marketing Expense,5eecc6d6449e4f7cfb1c2708,2022-02-10T00:00:00.000Z,"NEFT DR-CITI0000006-FACEBOOK INDIA ONLIN E SERVICES PVT LTD-NETBANK, MUM-N0412218 28337036-1443255",,,net_banking_transfer,-1443255
6229d5dcd8beac15993d3612,50200023535069,1790851.78,60ec41ba55c00300382672d9,HDFC,Internal Transfers,5eecc6d6449e4f7cfb1c2708,2022-02-10T00:00:00.000Z,IB FUNDS TRANSFER CR-50200035187206 -SL ICK ORGANICS PVT LTD,insurance,,Other,1500000
6229d5dcd8beac15993d3614,50200023535069,1376216.78,60ec41ba55c00300382672d9,HDFC,direct expenses,5eecc6d6449e4f7cfb1c2708,2022-02-10T00:00:00.000Z,"NEFT DR-PUNB0100110-KRAUTER HEALTHCARE L TD-NETBANK, MUM-N041221828346031-414635",,,net_banking_transfer,-414635
6229d5dcd8beac15993d3616,50200023535069,172255.78,60ec41ba55c00300382672d9,HDFC,direct expenses,5eecc6d6449e4f7cfb1c2708,2022-02-10T00:00:00.000Z,"NEFT DR-SRCB0000281-3D TECHNOPACK PRIVAT E LIMITED-NETBANK, MUM-N041221828333352- 1203961",,,net_banking_transfer,-1203961
6229d5dcd8beac15993d3619,50200023535069,672255.78,60ec41ba55c00300382672d9,HDFC,Internal Transfers,5eecc6d6449e4f7cfb1c2708,2022-02-10T00:00:00.000Z,IB FUNDS TRANSFER CR-50200035187206 -SL ICK ORGANICS PVT LTD,insurance,,Other,500000
6229d5dcd8beac15993d361b,50200023535069,417255.78,60ec41ba55c00300382672d9,HDFC,SAAS/tech expense,5eecc6d6449e4f7cfb1c2708,2022-02-10T00:00:00.000Z,POS 514834XXXXXX9486 AMAZON,shopping,,debit_card,-255000
6229d5dcd8beac15993d361d,50200023535069,375604.78,60ec41ba55c00300382672d9,HDFC,agency/vendor expense,5eecc6d6449e4f7cfb1c2708,2022-02-10T00:00:00.000Z,"NEFT DR-KKBK0000298-ADMITAD MEDIA PRIVAT E LIMITED-NETBANK, MUM-N041221828614309- 41651",loans,lender_transaction,net_banking_transfer,-41651
6229d5dcd8beac15993d361f,50200023535069,376590.7,60ec41ba55c00300382672d9,HDFC,Revenue-Mktplace,5eecc6d6449e4f7cfb1c2708,2022-02-10T00:00:00.000Z,NEFT CR-ICIC0000105-MANASH LIFESTYLE PRI VATE LIMITED NO-SLICK ORGANICS PRIVATE L IMITED MP G-ICIJ220410007499,shopping,,net_banking_transfer,985.92
6229d5dcd8beac15993d3621,50200023535069,379197.28,60ec41ba55c00300382672d9,HDFC,Revenue-Mktplace,5eecc6d6449e4f7cfb1c2708,2022-02-10T00:00:00.000Z,NEFT CR-ICIC0000105-MANASH LIFESTYLE PRI VATE LIMITED NO-SLICK ORGANICS PRIVATE L IMITED MP M-ICIJ220410007501,shopping,,net_banking_transfer,2606.58
6229d5dcd8beac15993d3623,50200023535069,398794.8,60ec41ba55c00300382672d9,HDFC,Revenue-UPI,5eecc6d6449e4f7cfb1c2708,2022-02-10T00:00:00.000Z,UPI-GOKWIK-GOKWIK@YESBANK-YESB0000340-20 4154469247-PAYOUT FOR FEBRUAR,,,upi,19597.52
6229d5dcd8beac15993d3625,50200023535069,399270.38,60ec41ba55c00300382672d9,HDFC,Revenue-PG-split enabled,5eecc6d6449e4f7cfb1c2708,2022-02-10T00:00:00.000Z,NEFT CR-UTIB0001506-RAZORPAY SOFTWARE PR IVATE LIMITED-SLICK ORGANICS PVT LITD-AX ISCN0122055317,insurance,,net_banking_transfer,475.58
6229d5dcd8beac15993d3627,50200023535069,399675.41,60ec41ba55c00300382672d9,HDFC,Transfer in/Revenue-other,5eecc6d6449e4f7cfb1c2708,2022-02-10T00:00:00.000Z,4060010182-10 02 2022-HDFAZCUR1,,,Other,405.03
6229d5dcd8beac15993d3629,50200023535069,399804.44,60ec41ba55c00300382672d9,HDFC,Revenue-PG-non-split,5eecc6d6449e4f7cfb1c2708,2022-02-10T00:00:00.000Z,NEFT CR-IDFB0010204-SEZZLE PAYMENTS PRIV,,,net_banking_transfer,129.03
6229d5dcd8beac15993d362b,50200023535069,410657.04,60ec41ba55c00300382672d9,HDFC,Revenue-Mktplace,5eecc6d6449e4f7cfb1c2708,2022-02-11T00:00:00.000Z,NEFT CR-DEUT0797BGL-FLIPKART INTERNET PR IVATE LIMITED-SLICK ORGANICS PVT LTD-204 200121GN00086,shopping,,net_banking_transfer,10852.6
6229d5dcd8beac15993d362d,50200023535069,424939.58,60ec41ba55c00300382672d9,HDFC,Revenue-PG-non-split,5eecc6d6449e4f7cfb1c2708,2022-02-11T00:00:00.000Z,IMPS-204204998854-PAYTM PAYMENTS SERVI-P YTM-XXXXXXXXXX0008-ALL202202112168200003 30830668628,ewallet,,net_banking_transfer,14282.54
6229d5dcd8beac15993d362f,50200023535069,426362.08,60ec41ba55c00300382672d9,HDFC,Revenue-Mktplace,5eecc6d6449e4f7cfb1c2708,2022-02-11T00:00:00.000Z,NEFT CR-DEUT0797BGL-MYNTRA DESIGNS PRIVA TE LIMITED-SLICK ORGANICS PVT. LTD.-2042 00719GN00143,shopping,,net_banking_transfer,1422.5
6229d5dcd8beac15993d3631,50200023535069,441447.76,60ec41ba55c00300382672d9,HDFC,Revenue-Mktplace,5eecc6d6449e4f7cfb1c2708,2022-02-11T00:00:00.000Z,NEFT CR-DEUT0797BGL-MYNTRA DESIGNS PRIVA TE LIMITED-SLICK ORGANICS PVT. LTD.-2042 00720GN00174,shopping,,net_banking_transfer,15085.68
6229d5dcd8beac15993d3633,50200023535069,443781.7,60ec41ba55c00300382672d9,HDFC,Revenue-PG-split enabled,5eecc6d6449e4f7cfb1c2708,2022-02-11T00:00:00.000Z,NEFT CR-UTIB0001506-RAZORPAY SOFTWARE PR IVATE LIMITED-SLICK ORGANICS PVT LITD-AX ISCN0122101909,insurance,,net_banking_transfer,2333.94
6229d5dcd8beac15993d3635,50200023535069,393781.7,60ec41ba55c00300382672d9,HDFC,Marketing Expense,5eecc6d6449e4f7cfb1c2708,2022-02-11T00:00:00.000Z,POS 514834XXXXXX9486 GOOGLESERVIS,,,debit_card,-50000
6229d5dcd8beac15993d3637,50200023535069,393779.7,60ec41ba55c00300382672d9,HDFC,Marketing Expense,5eecc6d6449e4f7cfb1c2708,2022-02-11T00:00:00.000Z,ME DC SI 514834XXXXXX9486 GOOGLESERVIS,,,Other,-2
6229d5dcd8beac15993d3639,50200023535069,212779.7,60ec41ba55c00300382672d9,HDFC,direct expenses,5eecc6d6449e4f7cfb1c2708,2022-02-11T00:00:00.000Z,"NEFT DR-YESB0000551-VISTTA COSMETICS-NET BANK, MUM-N042221830429526-181000",,,net_banking_transfer,-181000
6229d5dcd8beac15993d363b,50200023535069,160779.7,60ec41ba55c00300382672d9,HDFC,direct expenses,5eecc6d6449e4f7cfb1c2708,2022-02-11T00:00:00.000Z,"NEFT DR-ICIC0000874-TRELION BUSINESS SOL UTIONS PVT LTD-NETBANK, MUM-N04222183046 8156-52000",,,net_banking_transfer,-52000
6229d5dcd8beac15993d363e,50200023535069,196672.57,60ec41ba55c00300382672d9,HDFC,Revenue-UPI,5eecc6d6449e4f7cfb1c2708,2022-02-11T00:00:00.000Z,UPI-GOKWIK-GOKWIK@YESBANK-YESB0000340-20 4256716907-PAYOUT FOR FEBRUAR,,,upi,35892.87
6229d5dcd8beac15993d3640,50200023535069,197800.83,60ec41ba55c00300382672d9,HDFC,Revenue-PG-non-split,5eecc6d6449e4f7cfb1c2708,2022-02-11T00:00:00.000Z,NEFT CR-IDFB0010204-SEZZLE PAYMENTS PRIV ATE LIMITED-SLICK ORGANICS PRIVATE LIMIT ED-IDFBH22042202456,insurance,,net_banking_transfer,1128.26
6229d5dcd8beac15993d3642,50200023535069,199252.29,60ec41ba55c00300382672d9,HDFC,Revenue-PG-non-split,5eecc6d6449e4f7cfb1c2708,2022-02-11T00:00:00.000Z,NEFT CR-YESB0000001-RZPX PVT LTD NODAL A CCOUNT-SLICKORGANICS-N042221012604935,insurance,,salary,1451.46
6229d5dcd8beac15993d3644,50200023535069,199466.67,60ec41ba55c00300382672d9,HDFC,Transfer in/Revenue-other,5eecc6d6449e4f7cfb1c2708,2022-02-11T00:00:00.000Z,NEFT CR-YESB0000001-ILUMINAR MEDIA-SLICK,,,net_banking_transfer,214.38
6229d5dcd8beac15993d3646,50200023535069,282648.27,60ec41ba55c00300382672d9,HDFC,Revenue-COD,5eecc6d6449e4f7cfb1c2708,2022-02-11T00:00:00.000Z,NEFT CR-ICIC0000155-SHIPROCKET COD CRF I D 3801640-SLICK ORGANICS PVT LTD-CMS2392 381305,insurance,,net_banking_transfer,83181.6
6229d5dcd8beac15993d3648,50200023535069,283392.68,60ec41ba55c00300382672d9,HDFC,Revenue-Mktplace,5eecc6d6449e4f7cfb1c2708,2022-02-11T00:00:00.000Z,NEFT CR-DEUT0784BBY-TATA UNISTORE LIMITE D-SLICK ORGANICS PVT LTD-204201574GN0026 9,insurance,,net_banking_transfer,744.41
6229d5dcd8beac15993d364a,50200023535069,283633.49,60ec41ba55c00300382672d9,HDFC,Revenue-PG-split enabled,5eecc6d6449e4f7cfb1c2708,2022-02-11T00:00:00.000Z,NEFT CR-UTIB0001506-RAZORPAY SOFTWARE PR IVATE LIMITED-SLICK ORGANICS PVT LITD-AX ISCN0122188283,insurance,,net_banking_transfer,240.81
6229d5dcd8beac15993d364c,50200023535069,296935.88,60ec41ba55c00300382672d9,HDFC,Revenue-PG-non-split,5eecc6d6449e4f7cfb1c2708,2022-02-12T00:00:00.000Z,IMPS-204308120637-PAYTM PAYMENTS SERVI-P YTM-XXXXXXXXXX0008-ALL202202122168200003 30830668628,ewallet,,net_banking_transfer,13302.39
6229d5dcd8beac15993d364e,50200023535069,317583.11,60ec41ba55c00300382672d9,HDFC,Revenue-UPI,5eecc6d6449e4f7cfb1c2708,2022-02-12T00:00:00.000Z,UPI-GOKWIK-GOKWIK@YESBANK-YESB0000340-20 4358822142-PAYOUT FOR FEBRUAR,,,upi,20647.23
6229d5dcd8beac15993d3650,50200023535069,313884.24,60ec41ba55c00300382672d9,HDFC,direct expenses,5eecc6d6449e4f7cfb1c2708,2022-02-12T00:00:00.000Z,POS 514834XXXXXX9486 WWW.FAQPRIME.COM,,,debit_card,-3698.87
6229d5dcd8beac15993d3652,50200023535069,157284.24,60ec41ba55c00300382672d9,HDFC,direct expenses,5eecc6d6449e4f7cfb1c2708,2022-02-12T00:00:00.000Z,"NEFT DR-KKBK0005289-HILL GROOVE CONSULTI NG LLP-NETBANK, MUM-N043221832232829-156 600",,,net_banking_transfer,-156600
6229d5dcd8beac15993d3655,50200023535069,176320.72,60ec41ba55c00300382672d9,HDFC,Revenue-PG-non-split,5eecc6d6449e4f7cfb1c2708,2022-02-13T00:00:00.000Z,IMPS-204404623324-PAYTM PAYMENTS SERVI-P YTM-XXXXXXXXXX0008-ALL202202132168200003 30830668628,ewallet,,net_banking_transfer,19036.48
6229d5dcd8beac15993d3657,50200023535069,676320.72,60ec41ba55c00300382672d9,HDFC,Internal Transfers,5eecc6d6449e4f7cfb1c2708,2022-02-13T00:00:00.000Z,IB FUNDS TRANSFER CR-50200035187206 -SL ICK ORGANICS PVT LTD,insurance,,Other,500000
6229d5dcd8beac15993d3659,50200023535069,421320.72,60ec41ba55c00300382672d9,HDFC,SAAS/tech expense,5eecc6d6449e4f7cfb1c2708,2022-02-13T00:00:00.000Z,POS 514834XXXXXX9486 AMAZON,shopping,,debit_card,-255000
6229d5dcd8beac15993d365b,50200023535069,446935.83,60ec41ba55c00300382672d9,HDFC,Revenue-UPI,5eecc6d6449e4f7cfb1c2708,2022-02-13T00:00:00.000Z,UPI-GOKWIK-GOKWIK@YESBANK-YESB0000340-20 4460651593-PAYOUT FOR FEBRUAR,,,upi,25615.11
6229d5dcd8beac15993d365d,50200023535069,458712.17,60ec41ba55c00300382672d9,HDFC,Revenue-Mktplace,5eecc6d6449e4f7cfb1c2708,2022-02-14T00:00:00.000Z,NEFT CR-DEUT0797BGL-FLIPKART INTERNET PR IVATE LIMITED-SLICK ORGANICS PVT LTD-204 500135GN00248,shopping,,net_banking_transfer,11776.34
6229d5dcd8beac15993d3660,50200023535069,477774.8,60ec41ba55c00300382672d9,HDFC,Revenue-PG-non-split,5eecc6d6449e4f7cfb1c2708,2022-02-14T00:00:00.000Z,IMPS-204504097032-PAYTM PAYMENTS SERVI-P,ewallet,,net_banking_transfer,19062.63
6229d5dcd8beac15993d3662,50200023535069,439588.9,60ec41ba55c00300382672d9,HDFC,SAAS/tech expense,5eecc6d6449e4f7cfb1c2708,2022-02-14T00:00:00.000Z,POS 514834XXXXXX9486 AMAZON.COM,shopping,,debit_card,-38185.9
6229d5dcd8beac15993d3664,50200023535069,441616.03,60ec41ba55c00300382672d9,HDFC,Revenue-Mktplace,5eecc6d6449e4f7cfb1c2708,2022-02-14T00:00:00.000Z,4060010154-TIMES INTERNET LIMITED NODAL,,,Other,2027.13
6229d5dcd8beac15993d3667,50200023535069,446684.85,60ec41ba55c00300382672d9,HDFC,Revenue-PG-split enabled,5eecc6d6449e4f7cfb1c2708,2022-02-14T00:00:00.000Z,NEFT CR-UTIB0001506-RAZORPAY SOFTWARE PR IVATE LIMITED-SLICK ORGANICS PVT LITD-AX ISCN0122296315,insurance,,net_banking_transfer,5068.82
6229d5dcd8beac15993d3669,50200023535069,448861.74,60ec41ba55c00300382672d9,HDFC,Revenue-Mktplace,5eecc6d6449e4f7cfb1c2708,2022-02-14T00:00:00.000Z,NEFT CR-DEUT0797BGL-MYNTRA DESIGNS PRIVA TE LIMITED-SLICK ORGANICS PVT. LTD.-2045 00762GN00175,shopping,,net_banking_transfer,2176.89
6229d5dcd8beac15993d366b,50200023535069,472506.63,60ec41ba55c00300382672d9,HDFC,Revenue-Mktplace,5eecc6d6449e4f7cfb1c2708,2022-02-14T00:00:00.000Z,NEFT CR-DEUT0797BGL-MYNTRA DESIGNS PRIVA TE LIMITED-SLICK ORGANICS PVT. LTD.-2045 00763GN00188,shopping,,net_banking_transfer,23644.89
6229d5dcd8beac15993d366d,50200023535069,292740.63,60ec41ba55c00300382672d9,HDFC,direct expenses,5eecc6d6449e4f7cfb1c2708,2022-02-14T00:00:00.000Z,"NEFT DR-YESB0000058-SIXTEENBY9 VIDEO WOR KS-NETBANK, MUM-N045221832923033-179766",,,net_banking_transfer,-179766
6229d5dcd8beac15993d366f,50200023535069,823468,60ec41ba55c00300382672d9,HDFC,Revenue-Mktplace,5eecc6d6449e4f7cfb1c2708,2022-02-14T00:00:00.000Z,NEFT CR-DEUT0797BGL-AMAZON PAY (INDIA) P RIVATE LIMITED-SLICK ORGANICS PVT LTD-20 4500837GN00262,shopping,,net_banking_transfer,530727.37
6229d5dcd8beac15993d3671,50200023535069,735573,60ec41ba55c00300382672d9,HDFC,direct expenses,5eecc6d6449e4f7cfb1c2708,2022-02-14T00:00:00.000Z,50200063349422-TPT-87895-COHORT E-COMMER CE CONSULTING LLP,,,net_banking_transfer,-87895
6229d5dcd8beac15993d3673,50200023535069,765374.86,60ec41ba55c00300382672d9,HDFC,Revenue-UPI,5eecc6d6449e4f7cfb1c2708,2022-02-14T00:00:00.000Z,UPI-GOKWIK-GOKWIK@YESBANK-YESB0000340-20 4562577789-PAYOUT FOR FEBRUAR,,,upi,29801.86
6229d5dcd8beac15993d3675,50200023535069,769126.44,60ec41ba55c00300382672d9,HDFC,Revenue-Mktplace,5eecc6d6449e4f7cfb1c2708,2022-02-14T00:00:00.000Z,NEFT CR-ICIC0000105-MANASH LIFESTYLE PRI VATE LIMITED NO-SLICK ORGANICS PRIVATE L IMITED MP M-ICIJ220450009125,shopping,,net_banking_transfer,3751.58
6229d5dcd8beac15993d3677,50200023535069,773778.13,60ec41ba55c00300382672d9,HDFC,Revenue-Mktplace,5eecc6d6449e4f7cfb1c2708,2022-02-14T00:00:00.000Z,NEFT CR-ICIC0000105-MANASH LIFESTYLE PRI VATE LIMITED NO-SLICK ORGANICS PRIVATE L IMITED MP G-ICIJ220450009124,shopping,,net_banking_transfer,4651.69
6229d5dcd8beac15993d3679,50200023535069,775009.06,60ec41ba55c00300382672d9,HDFC,Revenue-PG-non-split,5eecc6d6449e4f7cfb1c2708,2022-02-14T00:00:00.000Z,NEFT CR-IDFB0010204-SEZZLE PAYMENTS PRIV ATE LIMITED-SLICK ORGANICS PRIVATE LIMIT ED-IDFBH22045381353,insurance,,net_banking_transfer,1230.93
6229d5dcd8beac15993d367b,50200023535069,778545.76,60ec41ba55c00300382672d9,HDFC,Revenue-PG-non-split,5eecc6d6449e4f7cfb1c2708,2022-02-14T00:00:00.000Z,NEFT CR-KKBK0000958-BROKENTUSK TECHNOLOG,,,net_banking_transfer,3536.7
6229d5dcd8beac15993d367d,50200023535069,787500.36,60ec41ba55c00300382672d9,HDFC,Revenue-PG-split enabled,5eecc6d6449e4f7cfb1c2708,2022-02-14T00:00:00.000Z,NEFT CR-UTIB0001506-RAZORPAY SOFTWARE PR IVATE LIMITED-SLICK ORGANICS PVT LITD-AX ISCN0122402077,insurance,,net_banking_transfer,8954.6
6229d5dcd8beac15993d367f,50200023535069,804031.67,60ec41ba55c00300382672d9,HDFC,Revenue-UPI,5eecc6d6449e4f7cfb1c2708,2022-02-14T00:00:00.000Z,UPI-GOKWIK-GOKWIK@YESBANK-YESB0000340-20 4563007627-PAYOUT FOR FEBRUAR,,,upi,16531.31
6229d5dcd8beac15993d3681,50200023535069,822287.45,60ec41ba55c00300382672d9,HDFC,Revenue-UPI,5eecc6d6449e4f7cfb1c2708,2022-02-15T00:00:00.000Z,UPI-GOKWIK-GOKWIK@YESBANK-YESB0000340-20 4663508173-PAYOUT FOR JANUARY,,,upi,18255.78
6229d5dcd8beac15993d3683,50200023535069,828258.95,60ec41ba55c00300382672d9,HDFC,Revenue-PG-non-split,5eecc6d6449e4f7cfb1c2708,2022-02-15T00:00:00.000Z,IMPS-204604705233-PAYTM PAYMENTS SERVI-P YTM-XXXXXXXXXX0008-ALL202202152168200003 30830668628,ewallet,,net_banking_transfer,5971.5
6229d5dcd8beac15993d3685,50200023535069,984873.53,60ec41ba55c00300382672d9,HDFC,Revenue-Mktplace,5eecc6d6449e4f7cfb1c2708,2022-02-15T00:00:00.000Z,IMPS-204605106355-AMAZON SELLER SERVIC-H SBC-XXXXXXXX6004-6WS0H42BF9GM0UDYSLICK O RGANICS PVT LTD,shopping,,net_banking_transfer,156614.58
6229d5dcd8beac15993d3687,50200023535069,978239.53,60ec41ba55c00300382672d9,HDFC,Salary/Emp/consultant Expense,5eecc6d6449e4f7cfb1c2708,2022-02-15T00:00:00.000Z,1711147300/EPFO,,,Other,-6634
6229d5dcd8beac15993d368a,50200023535069,973577.53,60ec41ba55c00300382672d9,HDFC,direct expenses,5eecc6d6449e4f7cfb1c2708,2022-02-15T00:00:00.000Z,02022105997359/ESIC,,,Other,-4662
6229d5dcd8beac15993d368c,50200023535069,976365.12,60ec41ba55c00300382672d9,HDFC,Revenue-PG-split enabled,5eecc6d6449e4f7cfb1c2708,2022-02-15T00:00:00.000Z,NEFT CR-UTIB0001506-RAZORPAY SOFTWARE PR IVATE LIMITED-SLICK ORGANICS PVT LITD-AX ISCN0122444590,insurance,,net_banking_transfer,2787.59
6229d5dcd8beac15993d368e,50200023535069,864662.12,60ec41ba55c00300382672d9,HDFC,direct expenses,5eecc6d6449e4f7cfb1c2708,2022-02-15T00:00:00.000Z,00921000075586-TPT-111703-ROET BINDRA,,,net_banking_transfer,-111703
6229d5dcd8beac15993d3690,50200023535069,814662.12,60ec41ba55c00300382672d9,HDFC,Marketing Expense,5eecc6d6449e4f7cfb1c2708,2022-02-15T00:00:00.000Z,POS 514834XXXXXX9486 GOOGLESERVIS,,,debit_card,-50000
6229d5dcd8beac15993d3692,50200023535069,658888.12,60ec41ba55c00300382672d9,HDFC,direct expenses,5eecc6d6449e4f7cfb1c2708,2022-02-15T00:00:00.000Z,02712120000086-TPT-155774-SPOTON LOGISTI CS PVT LTD,,,net_banking_transfer,-155774
6229d5dcd8beac15993d3694,50200023535069,586888.12,60ec41ba55c00300382672d9,HDFC,direct expenses,5eecc6d6449e4f7cfb1c2708,2022-02-15T00:00:00.000Z,"NEFT DR-KKBK0000664-SHRADDHA DINESH SHU KLA-NETBANK, MUM-N046221835251874-72000",,,net_banking_transfer,-72000
6229d5dcd8beac15993d3696,50200023535069,618432.76,60ec41ba55c00300382672d9,HDFC,Revenue-UPI,5eecc6d6449e4f7cfb1c2708,2022-02-15T00:00:00.000Z,UPI-GOKWIK-GOKWIK@YESBANK-YESB0000340-20 4664520209-PAYOUT FOR FEBRUAR,,,upi,31544.64
6229d5dcd8beac15993d3698,50200023535069,628042.87,60ec41ba55c00300382672d9,HDFC,Revenue-PG-non-split,5eecc6d6449e4f7cfb1c2708,2022-02-15T00:00:00.000Z,NEFT CR-IDFB0010204-SEZZLE PAYMENTS PRIV ATE LIMITED-SLICK ORGANICS PRIVATE LIMIT ED-IDFBH22046478587,insurance,,net_banking_transfer,9610.11
6229d5dcd8beac15993d369a,50200023535069,643758.87,60ec41ba55c00300382672d9,HDFC,Revenue-Mktplace,5eecc6d6449e4f7cfb1c2708,2022-02-15T00:00:00.000Z,NEFT CR-SCBL0036001-M/S DREAMPLUG TECHNO,,,net_banking_transfer,15716
6229d5dcd8beac15993d369c,50200023535069,651816.67,60ec41ba55c00300382672d9,HDFC,Revenue-PG-split enabled,5eecc6d6449e4f7cfb1c2708,2022-02-15T00:00:00.000Z,NEFT CR-UTIB0001506-RAZORPAY SOFTWARE PR IVATE LIMITED-SLICK ORGANICS PVT LITD-AX ISCN0122571556,insurance,,net_banking_transfer,8057.8
6229d5dcd8beac15993d369e,50200023535069,659023.94,60ec41ba55c00300382672d9,HDFC,Revenue-Mktplace,5eecc6d6449e4f7cfb1c2708,2022-02-16T00:00:00.000Z,NEFT CR-DEUT0797BGL-FLIPKART INTERNET PR IVATE LIMITED-SLICK ORGANICS PVT LTD-204 700125GN00109,shopping,,net_banking_transfer,7207.27
6229d5dcd8beac15993d36a0,50200023535069,681728.15,60ec41ba55c00300382672d9,HDFC,Revenue-PG-non-split,5eecc6d6449e4f7cfb1c2708,2022-02-16T00:00:00.000Z,IMPS-204704274812-PAYTM PAYMENTS SERVI-P YTM-XXXXXXXXXX0008-ALL202202162168200003 30830668628,ewallet,,net_banking_transfer,22704.21
6229d5dcd8beac15993d36a2,50200023535069,426728.15,60ec41ba55c00300382672d9,HDFC,SAAS/tech expense,5eecc6d6449e4f7cfb1c2708,2022-02-16T00:00:00.000Z,POS 514834XXXXXX9486 AMAZON,shopping,,debit_card,-255000
6229d5dcd8beac15993d36a4,50200023535069,428620.07,60ec41ba55c00300382672d9,HDFC,Revenue-Mktplace,5eecc6d6449e4f7cfb1c2708,2022-02-16T00:00:00.000Z,NEFT CR-DEUT0797BGL-MYNTRA DESIGNS PRIVA TE LIMITED-SLICK ORGANICS PVT. LTD.-2047 00770GN00177,shopping,,net_banking_transfer,1891.92
6229d5dcd8beac15993d36a6,50200023535069,469450.17,60ec41ba55c00300382672d9,HDFC,Revenue-Mktplace,5eecc6d6449e4f7cfb1c2708,2022-02-16T00:00:00.000Z,NEFT CR-DEUT0797BGL-MYNTRA DESIGNS PRIVA TE LIMITED-SLICK ORGANICS PVT. LTD.-2047 00773GN00201,shopping,,net_banking_transfer,40830.1
6229d5dcd8beac15993d36a8,50200023535069,476438.4,60ec41ba55c00300382672d9,HDFC,Revenue-PG-split enabled,5eecc6d6449e4f7cfb1c2708,2022-02-16T00:00:00.000Z,NEFT CR-UTIB0001506-RAZORPAY SOFTWARE PR IVATE LIMITED-SLICK ORGANICS PVT LITD-AX ISCN0122619454,insurance,,net_banking_transfer,6988.23
6229d5dcd8beac15993d36aa,50200023535069,451438.4,60ec41ba55c00300382672d9,HDFC,direct expenses,5eecc6d6449e4f7cfb1c2708,2022-02-16T00:00:00.000Z,50100028597492-TPT-25000-NAMRATA RANDHAW A,,,net_banking_transfer,-25000
6229d5dcd8beac15993d36ac,50200023535069,451840.4,60ec41ba55c00300382672d9,HDFC,Revenue-Mktplace,5eecc6d6449e4f7cfb1c2708,2022-02-16T00:00:00.000Z,NEFT CR-ICIC0000985-DIGITAL AGE RETAIL P VT LTD-SLICK ORGANICS PVT LTD-CMS2396797 627,,,net_banking_transfer,402
6229d5ddd8beac15993d36ae,50200023535069,451014.4,60ec41ba55c00300382672d9,HDFC,direct expenses,5eecc6d6449e4f7cfb1c2708,2022-02-16T00:00:00.000Z,POS 514834XXXXXX9486 SWIPEZ,,,debit_card,-826
6229d5ddd8beac15993d36b2,50200023535069,499277.85,60ec41ba55c00300382672d9,HDFC,Revenue-Mktplace,5eecc6d6449e4f7cfb1c2708,2022-02-16T00:00:00.000Z,NEFT CR-HSBC0400002-AMAZON SERVICES LLC- SLICK ORGANICS PRIVATE LIMITED-HSBCN2204 7518804,shopping,,net_banking_transfer,48263.45
6229d5ddd8beac15993d36b4,50200023535069,199277.85,60ec41ba55c00300382672d9,HDFC,direct expenses,5eecc6d6449e4f7cfb1c2708,2022-02-16T00:00:00.000Z,"NEFT DR-YESB0000551-VISTTA COSMETICS-NET BANK, MUM-N047221836873989-300000",,,net_banking_transfer,-300000
6229d5ddd8beac15993d36b6,50200023535069,229321.22,60ec41ba55c00300382672d9,HDFC,Revenue-UPI,5eecc6d6449e4f7cfb1c2708,2022-02-16T00:00:00.000Z,UPI-GOKWIK-GOKWIK@YESBANK-YESB0000340-20,,,upi,30043.37
6229d5ddd8beac15993d36b8,50200023535069,232302.38,60ec41ba55c00300382672d9,HDFC,Revenue-Mktplace,5eecc6d6449e4f7cfb1c2708,2022-02-16T00:00:00.000Z,NEFT CR-ICIC0000105-MANASH LIFESTYLE PRI VATE LIMITED NO-SLICK ORGANICS PRIVATE L IMITED MP M-ICIJ220470019599,shopping,,net_banking_transfer,2981.16
6229d5ddd8beac15993d36ba,50200023535069,235526.18,60ec41ba55c00300382672d9,HDFC,Revenue-Mktplace,5eecc6d6449e4f7cfb1c2708,2022-02-16T00:00:00.000Z,NEFT CR-ICIC0000105-MANASH LIFESTYLE PRI VATE LIMITED NO-SLICK ORGANICS PRIVATE L IMITED MP G-ICIJ220470019598,shopping,,net_banking_transfer,3223.8
6229d5ddd8beac15993d36bc,50200023535069,236848.65,60ec41ba55c00300382672d9,HDFC,Revenue-PG-non-split,5eecc6d6449e4f7cfb1c2708,2022-02-16T00:00:00.000Z,NEFT CR-IDFB0010204-SEZZLE PAYMENTS PRIV ATE LIMITED-SLICK ORGANICS PRIVATE LIMIT ED-IDFBH22047554508,insurance,,net_banking_transfer,1322.47
6229d5ddd8beac15993d36be,50200023535069,302668.42,60ec41ba55c00300382672d9,HDFC,Revenue-COD,5eecc6d6449e4f7cfb1c2708,2022-02-16T00:00:00.000Z,NEFT CR-ICIC0000155-SHIPROCKET COD CRF I D 3822149-SLICK ORGANICS PVT LTD-CMS2400 255427,insurance,,net_banking_transfer,65819.77
6229d5ddd8beac15993d36c0,50200023535069,323349,60ec41ba55c00300382672d9,HDFC,Revenue-PG-non-split,5eecc6d6449e4f7cfb1c2708,2022-02-17T00:00:00.000Z,IMPS-204804992842-PAYTM PAYMENTS SERVI-P YTM-XXXXXXXXXX0008-ALL202202172168200003 30830668628,ewallet,,net_banking_transfer,20680.58
6229d5ddd8beac15993d36c2,50200023535069,322049,60ec41ba55c00300382672d9,HDFC,Marketing Expense,5eecc6d6449e4f7cfb1c2708,2022-02-17T00:00:00.000Z,ME DC SI 514834XXXXXX9486 GOOGLEPLAY,entertainment,,Other,-1300
6229d5ddd8beac15993d36c4,50200023535069,227473,60ec41ba55c00300382672d9,HDFC,direct expenses,5eecc6d6449e4f7cfb1c2708,2022-02-17T00:00:00.000Z,50200021241300-TPT-94576-AFFLE INDIA LIM ITED,,,net_banking_transfer,-94576
6229d5ddd8beac15993d36c6,50200023535069,235247.98,60ec41ba55c00300382672d9,HDFC,Revenue-PG-split enabled,5eecc6d6449e4f7cfb1c2708,2022-02-17T00:00:00.000Z,NEFT CR-UTIB0001506-RAZORPAY SOFTWARE PR IVATE LIMITED-SLICK ORGANICS PVT LITD-AX ISCN0122818026,insurance,,net_banking_transfer,7774.98
6229d5ddd8beac15993d36c8,50200023535069,735247.98,60ec41ba55c00300382672d9,HDFC,Internal Transfers,5eecc6d6449e4f7cfb1c2708,2022-02-17T00:00:00.000Z,IB FUNDS TRANSFER CR-50200035187206 -SL ICK ORGANICS PVT LTD,insurance,,Other,500000
6229d5ddd8beac15993d36ca,50200023535069,708247.98,60ec41ba55c00300382672d9,HDFC,direct expenses,5eecc6d6449e4f7cfb1c2708,2022-02-17T00:00:00.000Z,"NEFT DR-KKBK0000654-NIHARIKA MISHRA-NETB ANK, MUM-N048221837970618-27000",,,net_banking_transfer,-27000
6229d5ddd8beac15993d36cc,50200023535069,426951.12,60ec41ba55c00300382672d9,HDFC,direct expenses,5eecc6d6449e4f7cfb1c2708,2022-02-17T00:00:00.000Z,POS 514834XXXXXX9486 SHOPIFY* 1331874,,,debit_card,-281296.86
6229d5ddd8beac15993d36cf,50200023535069,412309.12,60ec41ba55c00300382672d9,HDFC,direct expenses,5eecc6d6449e4f7cfb1c2708,2022-02-17T00:00:00.000Z,"NEFT DR-ICIC0000004-ICICI LOMBARD GIC LT D-NETBANK, MUM-N048221837985848-14642",,,net_banking_transfer,-14642
6229d5ddd8beac15993d36d2,50200023535069,395356.12,60ec41ba55c00300382672d9,HDFC,direct expenses,5eecc6d6449e4f7cfb1c2708,2022-02-17T00:00:00.000Z,00918630000430-TPT-16953-UNICOMMERCE ESO LUTIONS PRIVATE LIMITED,,,net_banking_transfer,-16953
6229d5ddd8beac15993d36d4,50200023535069,140356.12,60ec41ba55c00300382672d9,HDFC,SAAS/tech expense,5eecc6d6449e4f7cfb1c2708,2022-02-17T00:00:00.000Z,POS 514834XXXXXX9486 AMAZON,shopping,,debit_card,-255000
6229d5ddd8beac15993d36d6,50200023535069,171282.91,60ec41ba55c00300382672d9,HDFC,Revenue-UPI,5eecc6d6449e4f7cfb1c2708,2022-02-17T00:00:00.000Z,UPI-GOKWIK-GOKWIK@YESBANK-YESB0000340-20 4868979421-PAYOUT FOR FEBRUAR,,,upi,30926.79
6229d5ddd8beac15993d36d8,50200023535069,172595.72,60ec41ba55c00300382672d9,HDFC,Revenue-Mktplace,5eecc6d6449e4f7cfb1c2708,2022-02-17T00:00:00.000Z,NEFT CR-ICIC0000105-MANASH LIFESTYLE PRI VATE LIMITED NO-SLICK ORGANICS PRIVATE L IMITED MP M-ICIJ220480012266,shopping,,net_banking_transfer,1312.81
6229d5ddd8beac15993d36da,50200023535069,172979.81,60ec41ba55c00300382672d9,HDFC,Revenue-Mktplace,5eecc6d6449e4f7cfb1c2708,2022-02-17T00:00:00.000Z,NEFT CR-ICIC0000105-MANASH LIFESTYLE PRI VATE LIMITED NO-SLICK ORGANICS PRIVATE L IMITED BANG-ICIJ220480012268,shopping,,net_banking_transfer,384.09
6229d5ddd8beac15993d36dc,50200023535069,175183.22,60ec41ba55c00300382672d9,HDFC,Revenue-Mktplace,5eecc6d6449e4f7cfb1c2708,2022-02-17T00:00:00.000Z,NEFT CR-ICIC0000105-MANASH LIFESTYLE PRI VATE LIMITED NO-SLICK ORGANICS PRIVATE L IMITED MP G-ICIJ220480012264,shopping,,net_banking_transfer,2203.41
6229d5ddd8beac15993d36de,50200023535069,178306.22,60ec41ba55c00300382672d9,HDFC,Transfer in/Revenue-other,5eecc6d6449e4f7cfb1c2708,2022-02-17T00:00:00.000Z,OCTAVOS ENTERPRISE SOLUTIONS PVT LTD,,,Other,3123
6229d5ddd8beac15993d36e0,50200023535069,178428.53,60ec41ba55c00300382672d9,HDFC,Revenue-PG-split enabled,5eecc6d6449e4f7cfb1c2708,2022-02-17T00:00:00.000Z,NEFT CR-UTIB0001506-RAZORPAY SOFTWARE PR IVATE LIMITED-SLICK ORGANICS PVT LITD-AX ISCN0122926492,insurance,,net_banking_transfer,122.31
6229d5ddd8beac15993d36e2,50200023535069,185490.81,60ec41ba55c00300382672d9,HDFC,Revenue-PG-non-split,5eecc6d6449e4f7cfb1c2708,2022-02-17T00:00:00.000Z,NEFT CR-IDFB0010204-SEZZLE PAYMENTS PRIV ATE LIMITED-SLICK ORGANICS PRIVATE LIMIT ED-IDFBH22048641233,insurance,,net_banking_transfer,7062.28
6229d5ddd8beac15993d36e4,50200023535069,192948.17,60ec41ba55c00300382672d9,HDFC,Revenue-Mktplace,5eecc6d6449e4f7cfb1c2708,2022-02-18T00:00:00.000Z,NEFT CR-DEUT0797BGL-FLIPKART INTERNET PR IVATE LIMITED-SLICK ORGANICS PVT LTD-204 900132GN00045,shopping,,net_banking_transfer,7457.36
6229d5ddd8beac15993d36e6,50200023535069,207195.64,60ec41ba55c00300382672d9,HDFC,Revenue-PG-non-split,5eecc6d6449e4f7cfb1c2708,2022-02-18T00:00:00.000Z,IMPS-204904564978-PAYTM PAYMENTS SERVI-P YTM-XXXXXXXXXX0008-ALL202202182168200003 30830668628,ewallet,,net_banking_transfer,14247.47
6229d5ddd8beac15993d36e8,50200023535069,211055.73,60ec41ba55c00300382672d9,HDFC,Revenue-Mktplace,5eecc6d6449e4f7cfb1c2708,2022-02-18T00:00:00.000Z,NEFT CR-DEUT0797BGL-MYNTRA DESIGNS PRIVA TE LIMITED-SLICK ORGANICS PVT. LTD.-2049 00708GN00184,shopping,,net_banking_transfer,3860.09
6229d5ddd8beac15993d36ea,50200023535069,221395.64,60ec41ba55c00300382672d9,HDFC,Revenue-Mktplace,5eecc6d6449e4f7cfb1c2708,2022-02-18T00:00:00.000Z,NEFT CR-DEUT0797BGL-MYNTRA DESIGNS PRIVA TE LIMITED-SLICK ORGANICS PVT. LTD.-2049 00709GN00202,shopping,,net_banking_transfer,10339.91
6229d5ddd8beac15993d36ec,50200023535069,222044.67,60ec41ba55c00300382672d9,HDFC,Revenue-PG-split enabled,5eecc6d6449e4f7cfb1c2708,2022-02-18T00:00:00.000Z,NEFT CR-UTIB0001506-RAZORPAY SOFTWARE PR,,,net_banking_transfer,649.03
6229d5ddd8beac15993d36ee,50200023535069,222246.56,60ec41ba55c00300382672d9,HDFC,Revenue-PG-non-split,5eecc6d6449e4f7cfb1c2708,2022-02-18T00:00:00.000Z,NEFT CR-YESB0000001-RZPX PVT LTD NODAL A CCOUNT-SLICKORGANICS-N049221024909142,insurance,,salary,201.89
6229d5ddd8beac15993d36f0,50200023535069,242246.56,60ec41ba55c00300382672d9,HDFC,Revenue-UPI,5eecc6d6449e4f7cfb1c2708,2022-02-18T00:00:00.000Z,UPI-JITENDER KUMAR SAGAR-JITENDERSAGAR91 @OKICICI-ICIC0003851-204907991222-UPI,,,upi,20000
6229d5ddd8beac15993d36f2,50200023535069,242404.56,60ec41ba55c00300382672d9,HDFC,Transfer in/Revenue-other,5eecc6d6449e4f7cfb1c2708,2022-02-18T00:00:00.000Z,NEFT CR-YESB0000001-ILUMINAR MEDIA-SLICK ORGANICS-N049221024997299,,,net_banking_transfer,158
6229d5ddd8beac15993d36f4,50200023535069,742404.56,60ec41ba55c00300382672d9,HDFC,Internal Transfers,5eecc6d6449e4f7cfb1c2708,2022-02-18T00:00:00.000Z,IB FUNDS TRANSFER CR-50200035187206 -SL ICK ORGANICS PVT LTD,insurance,,Other,500000
6229d5ddd8beac15993d36f6,50200023535069,790958.13,60ec41ba55c00300382672d9,HDFC,Revenue-UPI,5eecc6d6449e4f7cfb1c2708,2022-02-18T00:00:00.000Z,UPI-GOKWIK-GOKWIK@YESBANK-YESB0000340-20 4971181662-PAYOUT FOR FEBRUAR,,,upi,48553.57
6229d5ddd8beac15993d36f8,50200023535069,802742.8,60ec41ba55c00300382672d9,HDFC,Revenue-COD,5eecc6d6449e4f7cfb1c2708,2022-02-18T00:00:00.000Z,NEFT CR-ICIC0000155-SHIPROCKET COD CRF I D 3842537-SLICK ORGANICS PVT LTD-CMS2404 344347,insurance,,net_banking_transfer,11784.67
6229d5ddd8beac15993d36fa,50200023535069,803922.2,60ec41ba55c00300382672d9,HDFC,Revenue-Mktplace,5eecc6d6449e4f7cfb1c2708,2022-02-18T00:00:00.000Z,NEFT CR-ICIC0000105-MANASH LIFESTYLE PRI VATE LIMITED NO-SLICK ORGANICS PRIVATE L IMITED KOLK-ICIJ220490006084,shopping,,net_banking_transfer,1179.4
6229d5ddd8beac15993d36fc,50200023535069,804921.29,60ec41ba55c00300382672d9,HDFC,Revenue-Mktplace,5eecc6d6449e4f7cfb1c2708,2022-02-18T00:00:00.000Z,NEFT CR-ICIC0000105-MANASH LIFESTYLE PRI VATE LIMITED NO-SLICK ORGANICS PRIVATE L IMITED MP G-ICIJ220490007921,shopping,,net_banking_transfer,999.09
6229d5ddd8beac15993d36fe,50200023535069,808525.46,60ec41ba55c00300382672d9,HDFC,Revenue-PG-split enabled,5eecc6d6449e4f7cfb1c2708,2022-02-18T00:00:00.000Z,NEFT CR-UTIB0001506-RAZORPAY SOFTWARE PR IVATE LIMITED-SLICK ORGANICS PVT LITD-AX ISCN0123083396,insurance,,net_banking_transfer,3604.17
6229d5ddd8beac15993d3700,50200023535069,809718.23,60ec41ba55c00300382672d9,HDFC,Revenue-Mktplace,5eecc6d6449e4f7cfb1c2708,2022-02-18T00:00:00.000Z,NEFT CR-DEUT0784BBY-TATA UNISTORE LTD-NO DAL-SLICK ORGANICS PVT LTD-204901613GN00 347,insurance,,net_banking_transfer,1192.77
6229d5ddd8beac15993d3702,50200023535069,833088.21,60ec41ba55c00300382672d9,HDFC,Revenue-PG-non-split,5eecc6d6449e4f7cfb1c2708,2022-02-19T00:00:00.000Z,IMPS-205004933053-PAYTM PAYMENTS SERVI-P YTM-XXXXXXXXXX0008-ALL202202192168200003 30830668628,ewallet,,net_banking_transfer,23369.98
6229d5ddd8beac15993d3704,50200023535069,499715.58,60ec41ba55c00300382672d9,HDFC,N-ACH payments,5eecc6d6449e4f7cfb1c2708,2022-02-19T00:00:00.000Z,ACH D- CTRAZORPAY-GETVANTAGEIXP5VAY9A2QJ,loans,lender_transaction,auto_debit_payment,-333372.63
6229d5ddd8beac15993d3706,50200023535069,540808.38,60ec41ba55c00300382672d9,HDFC,Revenue-UPI,5eecc6d6449e4f7cfb1c2708,2022-02-19T00:00:00.000Z,UPI-GOKWIK-GOKWIK@YESBANK-YESB0000340-20,,,upi,41092.8
6229d5ddd8beac15993d3708,50200023535069,549336.61,60ec41ba55c00300382672d9,HDFC,Revenue-PG-non-split,5eecc6d6449e4f7cfb1c2708,2022-02-20T00:00:00.000Z,IMPS-205104359851-PAYTM PAYMENTS SERVI-P YTM-XXXXXXXXXX0008-ALL202202202168200003 30830668628,ewallet,,net_banking_transfer,8528.23
6229d5ddd8beac15993d370a,50200023535069,449336.61,60ec41ba55c00300382672d9,HDFC,Marketing Expense,5eecc6d6449e4f7cfb1c2708,2022-02-20T00:00:00.000Z,POS 514834XXXXXX9486 GOOGLESERVIS,,,debit_card,-100000
6229d5ddd8beac15993d370c,50200023535069,399336.61,60ec41ba55c00300382672d9,HDFC,Marketing Expense,5eecc6d6449e4f7cfb1c2708,2022-02-20T00:00:00.000Z,POS 514834XXXXXX9486 GOOGLESERVIS,,,debit_card,-50000
6229d5ddd8beac15993d370e,50200023535069,394105.15,60ec41ba55c00300382672d9,HDFC,direct expenses,5eecc6d6449e4f7cfb1c2708,2022-02-20T00:00:00.000Z,POS 514834XXXXXX9486 ECOMENGINE* FEED,,,debit_card,-5231.46
6229d5ddd8beac15993d3710,50200023535069,350245.73,60ec41ba55c00300382672d9,HDFC,direct expenses,5eecc6d6449e4f7cfb1c2708,2022-02-20T00:00:00.000Z,POS 514834XXXXXX9486 THE ROCKET SCIEN,,,debit_card,-43859.42
6229d5ddd8beac15993d3712,50200023535069,392646.42,60ec41ba55c00300382672d9,HDFC,Revenue-UPI,5eecc6d6449e4f7cfb1c2708,2022-02-20T00:00:00.000Z,UPI-GOKWIK-GOKWIK@YESBANK-YESB0000340-20 5175118150-PAYOUT FOR FEBRUAR,,,upi,42400.69
6229d5ddd8beac15993d3715,50200023535069,414303.01,60ec41ba55c00300382672d9,HDFC,Revenue-PG-non-split,5eecc6d6449e4f7cfb1c2708,2022-02-21T00:00:00.000Z,IMPS-205204756625-PAYTM PAYMENTS SERVI-P YTM-XXXXXXXXXX0008-ALL202202212168200003 30830668628,ewallet,,net_banking_transfer,21656.59
6229d5ddd8beac15993d3717,50200023535069,423213.81,60ec41ba55c00300382672d9,HDFC,Revenue-Mktplace,5eecc6d6449e4f7cfb1c2708,2022-02-21T00:00:00.000Z,NEFT CR-DEUT0797BGL-FLIPKART INTERNET PR IVATE LIMITED-SLICK ORGANICS PVT LTD-205 100571GN00274,shopping,,net_banking_transfer,8910.8
6229d5ddd8beac15993d3719,50200023535069,425107.5,60ec41ba55c00300382672d9,HDFC,Revenue-Mktplace,5eecc6d6449e4f7cfb1c2708,2022-02-21T00:00:00.000Z,NEFT CR-DEUT0797BGL-FLIPKART INTERNET PR IVATE LIMITED-SLICK ORGANICS PVT LTD-205 200100GN00012,shopping,,net_banking_transfer,1893.69
6229d5ddd8beac15993d371b,50200023535069,445483.89,60ec41ba55c00300382672d9,HDFC,Revenue-Mktplace,5eecc6d6449e4f7cfb1c2708,2022-02-21T00:00:00.000Z,NEFT CR-DEUT0797BGL-MYNTRA DESIGNS PRIVA TE LIMITED-SLICK ORGANICS PVT. LTD.-2052 00442GN00200,shopping,,net_banking_transfer,20376.39
6229d5ddd8beac15993d371d,50200023535069,447322.02,60ec41ba55c00300382672d9,HDFC,Revenue-Mktplace,5eecc6d6449e4f7cfb1c2708,2022-02-21T00:00:00.000Z,NEFT CR-DEUT0797BGL-MYNTRA DESIGNS PRIVA TE LIMITED-SLICK ORGANICS PVT. LTD.-2052 00441GN00193,shopping,,net_banking_transfer,1838.13
6229d5ddd8beac15993d371f,50200023535069,448298.43,60ec41ba55c00300382672d9,HDFC,Revenue-PG-split enabled,5eecc6d6449e4f7cfb1c2708,2022-02-21T00:00:00.000Z,NEFT CR-UTIB0001506-RAZORPAY SOFTWARE PR IVATE LIMITED-SLICK ORGANICS PVT LITD-AX ISCN0123184189,insurance,,net_banking_transfer,976.41
6229d5ddd8beac15993d3721,50200023535069,148298.43,60ec41ba55c00300382672d9,HDFC,direct expenses,5eecc6d6449e4f7cfb1c2708,2022-02-21T00:00:00.000Z,"NEFT DR-YESB0000551-VISTTA COSMETICS-NET BANK, MUM-N052221841856772-300000",,,net_banking_transfer,-300000
6229d5ddd8beac15993d3723,50200023535069,72619.43,60ec41ba55c00300382672d9,HDFC,direct expenses,5eecc6d6449e4f7cfb1c2708,2022-02-21T00:00:00.000Z,NEFT DR-KKBK0000180-VEDIC COSMECEUTICALS,,,net_banking_transfer,-75679
6229d5ddd8beac15993d3725,50200023535069,572619.43,60ec41ba55c00300382672d9,HDFC,Internal Transfers,5eecc6d6449e4f7cfb1c2708,2022-02-21T00:00:00.000Z,IB FUNDS TRANSFER CR-50200035187206 -SL ICK ORGANICS PVT LTD,insurance,,Other,500000
6229d5ddd8beac15993d3727,50200023535069,472619.43,60ec41ba55c00300382672d9,HDFC,direct expenses,5eecc6d6449e4f7cfb1c2708,2022-02-21T00:00:00.000Z,"NEFT DR-UTIB0001964-BLUE BELLS EVENTS AN D PROMOTIONS-NETBANK, MUM-N0522218418855 49-100000",,,net_banking_transfer,-100000
6229d5ddd8beac15993d3729,50200023535069,1472619.43,60ec41ba55c00300382672d9,HDFC,Internal Transfers,5eecc6d6449e4f7cfb1c2708,2022-02-21T00:00:00.000Z,IB FUNDS TRANSFER CR-50200035187206 -SL ICK ORGANICS PVT LTD,insurance,,Other,1000000
6229d5ddd8beac15993d372b,50200023535069,1968912.88,60ec41ba55c00300382672d9,HDFC,Revenue-Mktplace,5eecc6d6449e4f7cfb1c2708,2022-02-21T00:00:00.000Z,NEFT CR-DEUT0797BGL-AMAZON PAY (INDIA) P RIVATE LIMITED-SLICK ORGANICS PVT LTD-20 5200652GN00298,shopping,,net_banking_transfer,496293.45
6229d5ddd8beac15993d372d,50200023535069,968912.88,60ec41ba55c00300382672d9,HDFC,Marketing Expense,5eecc6d6449e4f7cfb1c2708,2022-02-21T00:00:00.000Z,"NEFT DR-CITI0000006-FACEBOOK INDIA ONLIN E SERVICES PVT LTD-NETBANK, MUM-N0522218 41902710-1000000",,,net_banking_transfer,-1000000
6229d5ddd8beac15993d372f,50200023535069,968914.88,60ec41ba55c00300382672d9,HDFC,Transfer in/Revenue-other,5eecc6d6449e4f7cfb1c2708,2022-02-21T00:00:00.000Z,POS REF 514834******9486-02/19 GOOGLESER,,,refund,2
6229d5ddd8beac15993d3731,50200023535069,944983.88,60ec41ba55c00300382672d9,HDFC,direct expenses,5eecc6d6449e4f7cfb1c2708,2022-02-21T00:00:00.000Z,50200043297657-TPT-23931-AIDC PRODUCTS I NDIA PRIVATE LIMITED,,,net_banking_transfer,-23931
6229d5ddd8beac15993d3733,50200023535069,972016.19,60ec41ba55c00300382672d9,HDFC,Revenue-UPI,5eecc6d6449e4f7cfb1c2708,2022-02-21T00:00:00.000Z,UPI-GOKWIK-GOKWIK@YESBANK-YESB0000340-20 5277136839-PAYOUT FOR FEBRUAR,,,upi,27032.31
6229d5ddd8beac15993d3735,50200023535069,973524.7,60ec41ba55c00300382672d9,HDFC,Revenue-Mktplace,5eecc6d6449e4f7cfb1c2708,2022-02-21T00:00:00.000Z,NEFT CR-ICIC0000105-MANASH LIFESTYLE PRI VATE LIMITED NO-SLICK ORGANICS PRIVATE L IMITED BANG-ICIJ220520009356,shopping,,net_banking_transfer,1508.51
6229d5ddd8beac15993d3737,50200023535069,974142.62,60ec41ba55c00300382672d9,HDFC,Revenue-Mktplace,5eecc6d6449e4f7cfb1c2708,2022-02-21T00:00:00.000Z,NEFT CR-ICIC0000105-MANASH LIFESTYLE PRI VATE LIMITED NO-SLICK ORGANICS PRIVATE L IMITED KOLK-ICIJ220520010052,shopping,,net_banking_transfer,617.92
6229d5ddd8beac15993d3739,50200023535069,974323.66,60ec41ba55c00300382672d9,HDFC,Revenue-Mktplace,5eecc6d6449e4f7cfb1c2708,2022-02-21T00:00:00.000Z,NEFT CR-ICIC0000105-MANASH LIFESTYLE PRI VATE LIMITED NO-SLICK ORGANICS PRIVATE L IMITED MP G-ICIJ220520010050,shopping,,net_banking_transfer,181.04
6229d5ddd8beac15993d373b,50200023535069,974557.49,60ec41ba55c00300382672d9,HDFC,Revenue-Mktplace,5eecc6d6449e4f7cfb1c2708,2022-02-21T00:00:00.000Z,NEFT CR-ICIC0000105-MANASH LIFESTYLE PRI VATE LIMITED NO-SLICK ORGANICS PRIVATE L IMITED MP M-ICIJ220520009355,shopping,,net_banking_transfer,233.83
6229d5ddd8beac15993d373e,50200023535069,980782.52,60ec41ba55c00300382672d9,HDFC,Revenue-PG-non-split,5eecc6d6449e4f7cfb1c2708,2022-02-21T00:00:00.000Z,NEFT CR-KKBK0000958-BROKENTUSK TECHNOLOG,,,net_banking_transfer,6225.03
6229d5ddd8beac15993d3740,50200023535069,982124.36,60ec41ba55c00300382672d9,HDFC,Revenue-PG-non-split,5eecc6d6449e4f7cfb1c2708,2022-02-21T00:00:00.000Z,NEFT CR-IDFB0010204-SEZZLE PAYMENTS PRIV ATE LIMITED-SLICK ORGANICS PRIVATE LIMIT ED-IDFBH22052878124,insurance,,net_banking_transfer,1341.84
6229d5ddd8beac15993d3742,50200023535069,982631.66,60ec41ba55c00300382672d9,HDFC,Revenue-PG-non-split,5eecc6d6449e4f7cfb1c2708,2022-02-21T00:00:00.000Z,NEFT CR-IDFB0010204-SEZZLE PAYMENTS PRIV ATE LIMITED-SLICK ORGANICS PRIVATE LIMIT ED-IDFBH22052878232,insurance,,net_banking_transfer,507.3
6229d5ddd8beac15993d3744,50200023535069,982697.11,60ec41ba55c00300382672d9,HDFC,Revenue-PG-split enabled,5eecc6d6449e4f7cfb1c2708,2022-02-21T00:00:00.000Z,NEFT CR-UTIB0001506-RAZORPAY SOFTWARE PR IVATE LIMITED-SLICK ORGANICS PVT LITD-AX ISCN0123312422,insurance,,net_banking_transfer,65.45
6229d5ddd8beac15993d3746,50200023535069,986446.11,60ec41ba55c00300382672d9,HDFC,Transfer in/Revenue-other,5eecc6d6449e4f7cfb1c2708,2022-02-21T00:00:00.000Z,NEFT CR-KKBK0000958-INNOVATIVE RETAIL CO NCEPTS PRIVATE LTD-SLICK ORGANICS PVT LT D-KKBK220521985568,,,net_banking_transfer,3749
6229d5ddd8beac15993d3748,50200023535069,994494.11,60ec41ba55c00300382672d9,HDFC,Transfer in/Revenue-other,5eecc6d6449e4f7cfb1c2708,2022-02-21T00:00:00.000Z,NEFT CR-KKBK0000958-INNOVATIVE RETAIL CO NCEPTS PRIVATE LTD-SLICK ORGANICS PVT LT D-KKBK220521985757,,,net_banking_transfer,8048
6229d5ddd8beac15993d374a,50200023535069,1000041.51,60ec41ba55c00300382672d9,HDFC,Revenue-PG-non-split,5eecc6d6449e4f7cfb1c2708,2022-02-22T00:00:00.000Z,IMPS-205305287542-PAYTM PAYMENTS SERVI-P YTM-XXXXXXXXXX0008-ALL202202222168200003 30830668628,ewallet,,net_banking_transfer,5547.4
6229d5ddd8beac15993d374c,50200023535069,1142178.55,60ec41ba55c00300382672d9,HDFC,Revenue-Mktplace,5eecc6d6449e4f7cfb1c2708,2022-02-22T00:00:00.000Z,IMPS-205305107163-AMAZON SELLER SERVIC-H SBC-XXXXXXXX6004-4812Z5Q3ZP073RS5SLICK O RGANICS PVT LTD,shopping,,net_banking_transfer,142137.04
6229d5ddd8beac15993d374e,50200023535069,1042178.55,60ec41ba55c00300382672d9,HDFC,Marketing Expense,5eecc6d6449e4f7cfb1c2708,2022-02-22T00:00:00.000Z,POS 514834XXXXXX9486 GOOGLESERVIS,,,debit_card,-100000
6229d5ddd8beac15993d3750,50200023535069,1043887.6,60ec41ba55c00300382672d9,HDFC,Revenue-PG-split enabled,5eecc6d6449e4f7cfb1c2708,2022-02-22T00:00:00.000Z,NEFT CR-UTIB0001506-RAZORPAY SOFTWARE PR IVATE LIMITED-SLICK ORGANICS PVT LITD-AX ISCN0123374410,insurance,,net_banking_transfer,1709.05
6229d5ddd8beac15993d3753,50200023535069,470022.6,60ec41ba55c00300382672d9,HDFC,direct expenses,5eecc6d6449e4f7cfb1c2708,2022-02-22T00:00:00.000Z,05892560000649-TPT-573865-DECORPAC INDIA PRIVATE LIMITED,,,net_banking_transfer,-573865
6229d5ddd8beac15993d3755,50200023535069,472871.83,60ec41ba55c00300382672d9,HDFC,Revenue-Mktplace,5eecc6d6449e4f7cfb1c2708,2022-02-22T00:00:00.000Z,NEFT CR-ICIC0000105-MANASH LIFESTYLE PRI VATE LIMITED NO-SLICK ORGANICS PRIVATE L IMITED MP G-ICIJ220530006652,shopping,,net_banking_transfer,2849.23
6229d5ddd8beac15993d3757,50200023535069,501409.6,60ec41ba55c00300382672d9,HDFC,Revenue-UPI,5eecc6d6449e4f7cfb1c2708,2022-02-22T00:00:00.000Z,UPI-GOKWIK-GOKWIK@YESBANK-YESB0000340-20,,,upi,28537.77
6229d5ddd8beac15993d3759,50200023535069,503565.07,60ec41ba55c00300382672d9,HDFC,Revenue-PG-non-split,5eecc6d6449e4f7cfb1c2708,2022-02-22T00:00:00.000Z,NEFT CR-IDFB0010204-SEZZLE PAYMENTS PRIV ATE LIMITED-SLICK ORGANICS PRIVATE LIMIT ED-IDFBH22053974767,insurance,,net_banking_transfer,2155.47
6229d5ddd8beac15993d375b,50200023535069,506864.81,60ec41ba55c00300382672d9,HDFC,Revenue-PG-split enabled,5eecc6d6449e4f7cfb1c2708,2022-02-22T00:00:00.000Z,NEFT CR-UTIB0001506-RAZORPAY SOFTWARE PR IVATE LIMITED-SLICK ORGANICS PVT LITD-AX ISCN0123471338,insurance,,net_banking_transfer,3299.74
6229d5ddd8beac15993d375d,50200023535069,519067.29,60ec41ba55c00300382672d9,HDFC,Revenue-Mktplace,5eecc6d6449e4f7cfb1c2708,2022-02-23T00:00:00.000Z,NEFT CR-DEUT0797BGL-FLIPKART INTERNET PR IVATE LIMITED-SLICK ORGANICS PVT LTD-205 400111GN00012,shopping,,net_banking_transfer,12202.48
6229d5ddd8beac15993d375f,50200023535069,528603.86,60ec41ba55c00300382672d9,HDFC,Revenue-Mktplace,5eecc6d6449e4f7cfb1c2708,2022-02-23T00:00:00.000Z,NEFT CR-DEUT0797BGL-FLIPKART INTERNET PR IVATE LIMITED-SLICK ORGANICS PVT LTD-205 400138GN00106,shopping,,net_banking_transfer,9536.57
6229d5ddd8beac15993d3761,50200023535069,616578.62,60ec41ba55c00300382672d9,HDFC,Revenue-PG-non-split,5eecc6d6449e4f7cfb1c2708,2022-02-23T00:00:00.000Z,NEFT CR-PYTM0123456-PAYTM PAYMENTS SERVI CES LIMITED-SLICK ORGANICS PVT LTD-PYTM2 20546564847,ewallet,,net_banking_transfer,87974.76
6229d5ddd8beac15993d3763,50200023535069,619472.81,60ec41ba55c00300382672d9,HDFC,Revenue-Mktplace,5eecc6d6449e4f7cfb1c2708,2022-02-23T00:00:00.000Z,NEFT CR-DEUT0797BGL-MYNTRA DESIGNS PRIVA TE LIMITED-SLICK ORGANICS PVT. LTD.-2054 00553GN00184,shopping,,net_banking_transfer,2894.19
6229d5ddd8beac15993d3765,50200023535069,631421.41,60ec41ba55c00300382672d9,HDFC,Revenue-Mktplace,5eecc6d6449e4f7cfb1c2708,2022-02-23T00:00:00.000Z,NEFT CR-DEUT0797BGL-MYNTRA DESIGNS PRIVA TE LIMITED-SLICK ORGANICS PVT. LTD.-2054 00554GN00196,shopping,,net_banking_transfer,11948.6
6229d5ddd8beac15993d3767,50200023535069,633266,60ec41ba55c00300382672d9,HDFC,Revenue-PG-split enabled,5eecc6d6449e4f7cfb1c2708,2022-02-23T00:00:00.000Z,NEFT CR-UTIB0001506-RAZORPAY SOFTWARE PR IVATE LIMITED-SLICK ORGANICS PVT LITD-AX ISCN0123526585,insurance,,net_banking_transfer,1844.59
6229d5ddd8beac15993d3769,50200023535069,646973,60ec41ba55c00300382672d9,HDFC,Revenue-Mktplace,5eecc6d6449e4f7cfb1c2708,2022-02-23T00:00:00.000Z,NEFT CR-SCBL0036001-M/S DREAMPLUG TECHNO -SLICK ORGANICS PRIVATE LIMITEDSLICK-SIN 31436Q0033649,insurance,,net_banking_transfer,13707
6229d5ddd8beac15993d376b,50200023535069,648176.41,60ec41ba55c00300382672d9,HDFC,Revenue-Mktplace,5eecc6d6449e4f7cfb1c2708,2022-02-23T00:00:00.000Z,4060010802-TIMES INTERNET LIMITED NODAL,,,Other,1203.41
6229d5ded8beac15993d376d,50200023535069,649148.4,60ec41ba55c00300382672d9,HDFC,Revenue-Mktplace,5eecc6d6449e4f7cfb1c2708,2022-02-23T00:00:00.000Z,NEFT CR-ICIC0000105-MANASH LIFESTYLE PRI,shopping,,net_banking_transfer,971.99
6229d5ded8beac15993d3770,50200023535069,649583.09,60ec41ba55c00300382672d9,HDFC,Revenue-Mktplace,5eecc6d6449e4f7cfb1c2708,2022-02-23T00:00:00.000Z,NEFT CR-ICIC0000105-MANASH LIFESTYLE PRI VATE LIMITED NO-SLICK ORGANICS PRIVATE L IMITED BANG-ICIJ220540009158,shopping,,net_banking_transfer,434.69
6229d5ded8beac15993d3772,50200023535069,650857.78,60ec41ba55c00300382672d9,HDFC,Revenue-Mktplace,5eecc6d6449e4f7cfb1c2708,2022-02-23T00:00:00.000Z,NEFT CR-ICIC0000105-MANASH LIFESTYLE PRI VATE LIMITED NO-SLICK ORGANICS PRIVATE L IMITED MP M-ICIJ220540009154,shopping,,net_banking_transfer,1274.69
6229d5ded8beac15993d3774,50200023535069,651253.59,60ec41ba55c00300382672d9,HDFC,Revenue-Mktplace,5eecc6d6449e4f7cfb1c2708,2022-02-23T00:00:00.000Z,NEFT CR-ICIC0000105-MANASH LIFESTYLE PRI VATE LIMITED NO-SLICK ORGANICS PRIVATE L IMITED KOLK-ICIJ220540009156,shopping,,net_banking_transfer,395.81
6229d5ded8beac15993d3776,50200023535069,651302.64,60ec41ba55c00300382672d9,HDFC,Revenue-PG-split enabled,5eecc6d6449e4f7cfb1c2708,2022-02-23T00:00:00.000Z,NEFT CR-UTIB0001506-RAZORPAY SOFTWARE PR IVATE LIMITED-SLICK ORGANICS PVT LITD-AX ISCN0123628693,insurance,,net_banking_transfer,49.05
6229d5ded8beac15993d3778,50200023535069,652026.27,60ec41ba55c00300382672d9,HDFC,Revenue-PG-non-split,5eecc6d6449e4f7cfb1c2708,2022-02-23T00:00:00.000Z,NEFT CR-IDFB0010204-SEZZLE PAYMENTS PRIV ATE LIMITED-SLICK ORGANICS PRIVATE LIMIT ED-IDFBH22054058347,insurance,,net_banking_transfer,723.63
6229d5ded8beac15993d377a,50200023535069,722996.77,60ec41ba55c00300382672d9,HDFC,Revenue-COD,5eecc6d6449e4f7cfb1c2708,2022-02-23T00:00:00.000Z,NEFT CR-ICIC0000155-SHIPROCKET COD CRF I D 3863073-SLICK ORGANICS PVT LTD-CMS2412 930880,insurance,,net_banking_transfer,70970.5
6229d5ded8beac15993d377d,50200023535069,751266.55,60ec41ba55c00300382672d9,HDFC,Revenue-UPI,5eecc6d6449e4f7cfb1c2708,2022-02-23T00:00:00.000Z,UPI-GOKWIK-GOKWIK@YESBANK-YESB0000340-20 5482074448-PAYOUT FOR FEBRUAR,,,upi,28269.78
6229d5ded8beac15993d377f,50200023535069,762312.64,60ec41ba55c00300382672d9,HDFC,Revenue-PG-non-split,5eecc6d6449e4f7cfb1c2708,2022-02-24T00:00:00.000Z,IMPS-205504312593-PAYTM PAYMENTS SERVI-P YTM-XXXXXXXXXX0008-ALL202202242168200003 30830668628,ewallet,,net_banking_transfer,11046.09
6229d5ded8beac15993d3781,50200023535069,762694.08,60ec41ba55c00300382672d9,HDFC,Revenue-PG-split enabled,5eecc6d6449e4f7cfb1c2708,2022-02-24T00:00:00.000Z,NEFT CR-UTIB0001506-RAZORPAY SOFTWARE PR IVATE LIMITED-SLICK ORGANICS PVT LITD-AX ISCN0123755344,insurance,,net_banking_transfer,381.44
6229d5ded8beac15993d3783,50200023535069,754994.08,60ec41ba55c00300382672d9,HDFC,direct expenses,5eecc6d6449e4f7cfb1c2708,2022-02-24T00:00:00.000Z,"NEFT DR-ICIC0006297-SURUCHI SHARMA-NETBA NK, MUM-N055221845995596-7700",,,net_banking_transfer,-7700
6229d5ded8beac15993d3785,50200023535069,404994.08,60ec41ba55c00300382672d9,HDFC,direct expenses,5eecc6d6449e4f7cfb1c2708,2022-02-24T00:00:00.000Z,57500000443889-TPT-350000-WEBKLIPPER TEC HNOLOGIES PRIVATE LIMITED,,,net_banking_transfer,-350000
6229d5ded8beac15993d3787,50200023535069,384994.08,60ec41ba55c00300382672d9,HDFC,direct expenses,5eecc6d6449e4f7cfb1c2708,2022-02-24T00:00:00.000Z,"KUMAR - CHQ PAID - GKII, NEW DE",,,chq,-20000
6229d5ded8beac15993d3789,50200023535069,347310.43,60ec41ba55c00300382672d9,HDFC,SAAS/tech expense,5eecc6d6449e4f7cfb1c2708,2022-02-24T00:00:00.000Z,POS 514834XXXXXX9486 AMAZON.COM,shopping,,debit_card,-37683.65
6229d5ded8beac15993d378b,50200023535069,547310.43,60ec41ba55c00300382672d9,HDFC,Revenue-UPI,5eecc6d6449e4f7cfb1c2708,2022-02-24T00:00:00.000Z,UPI-GOKWIK-GOKWIK@YESBANK-YESB0000340-20 5583733120-PAYOUT FOR FEBRUAR,,,upi,200000
6229d5ded8beac15993d378d,50200023535069,551393.94,60ec41ba55c00300382672d9,HDFC,Revenue-UPI,5eecc6d6449e4f7cfb1c2708,2022-02-24T00:00:00.000Z,UPI-GOKWIK-GOKWIK@YESBANK-YESB0000340-20 5583733161-PAYOUT FOR FEBRUAR,,,upi,4083.51
6229d5ded8beac15993d378f,50200023535069,551744.32,60ec41ba55c00300382672d9,HDFC,Revenue-Mktplace,5eecc6d6449e4f7cfb1c2708,2022-02-24T00:00:00.000Z,NEFT CR-ICIC0000105-MANASH LIFESTYLE PRI VATE LIMITED NO-SLICK ORGANICS PRIVATE L IMITED KOLK-ICIJ220550010833,shopping,,net_banking_transfer,350.38
6229d5ded8beac15993d3791,50200023535069,552007.48,60ec41ba55c00300382672d9,HDFC,Revenue-Mktplace,5eecc6d6449e4f7cfb1c2708,2022-02-24T00:00:00.000Z,NEFT CR-ICIC0000105-MANASH LIFESTYLE PRI VATE LIMITED NO-SLICK ORGANICS PRIVATE L IMITED MP G-ICIJ220550010831,shopping,,net_banking_transfer,263.16
6229d5ded8beac15993d3793,50200023535069,552270.64,60ec41ba55c00300382672d9,HDFC,Revenue-Mktplace,5eecc6d6449e4f7cfb1c2708,2022-02-24T00:00:00.000Z,NEFT CR-ICIC0000105-MANASH LIFESTYLE PRI VATE LIMITED NO-SLICK ORGANICS PRIVATE L IMITED MP M-ICIJ220550010829,shopping,,net_banking_transfer,263.16
6229d5ded8beac15993d3795,50200023535069,552181.21,60ec41ba55c00300382672d9,HDFC,bank charges,5eecc6d6449e4f7cfb1c2708,2022-02-24T00:00:00.000Z,.DC INTL POS TXN MARKUP+ST 010222 020222 -CDT2203407778480,,,international_transaction_arbitrage,-89.43
6229d5ded8beac15993d3797,50200023535069,550634.35,60ec41ba55c00300382672d9,HDFC,bank charges,5eecc6d6449e4f7cfb1c2708,2022-02-24T00:00:00.000Z,.DC INTL POS TXN MARKUP+ST 010222 020222 -CDT2203407778480,,,international_transaction_arbitrage,-1546.86
6229d5ded8beac15993d3799,50200023535069,550822.52,60ec41ba55c00300382672d9,HDFC,Revenue-PG-split enabled,5eecc6d6449e4f7cfb1c2708,2022-02-24T00:00:00.000Z,NEFT CR-UTIB0001506-RAZORPAY SOFTWARE PR IVATE LIMITED-SLICK ORGANICS PVT LITD-AX ISCN0123866931,insurance,,net_banking_transfer,188.17
6229d5ded8beac15993d379b,50200023535069,560825.16,60ec41ba55c00300382672d9,HDFC,Revenue-PG-non-split,5eecc6d6449e4f7cfb1c2708,2022-02-24T00:00:00.000Z,NEFT CR-IDFB0010204-SEZZLE PAYMENTS PRIV ATE LIMITED-SLICK ORGANICS PRIVATE LIMIT ED-IDFBH22055144133,insurance,,net_banking_transfer,10002.64
6229d5ded8beac15993d379d,50200023535069,570019.16,60ec41ba55c00300382672d9,HDFC,Revenue-Mktplace,5eecc6d6449e4f7cfb1c2708,2022-02-24T00:00:00.000Z,NEFT CR-ICIC0000985-DIGITAL AGE RETAIL P VT LTD-SLICK ORGANICS PVT LTD-CMS2413733 143,,,net_banking_transfer,9194
6229d5ded8beac15993d379f,50200023535069,591941.77,60ec41ba55c00300382672d9,HDFC,Revenue-Mktplace,5eecc6d6449e4f7cfb1c2708,2022-02-25T00:00:00.000Z,NEFT CR-DEUT0797BGL-FLIPKART INTERNET PR IVATE LIMITED-SLICK ORGANICS PVT LTD-205 600122GN00083,shopping,,net_banking_transfer,21922.61
6229d5ded8beac15993d37a1,50200023535069,609486.03,60ec41ba55c00300382672d9,HDFC,Revenue-Mktplace,5eecc6d6449e4f7cfb1c2708,2022-02-25T00:00:00.000Z,NEFT CR-DEUT0797BGL-FLIPKART INTERNET PR,shopping,,net_banking_transfer,17544.26
6229d5ded8beac15993d37a3,50200023535069,624318.18,60ec41ba55c00300382672d9,HDFC,Revenue-PG-non-split,5eecc6d6449e4f7cfb1c2708,2022-02-25T00:00:00.000Z,IMPS-205604655019-PAYTM PAYMENTS SERVI-P YTM-XXXXXXXXXX0008-ALL202202252168200003 30830668628,ewallet,,net_banking_transfer,14832.15
6229d5ded8beac15993d37a5,50200023535069,626016.59,60ec41ba55c00300382672d9,HDFC,Revenue-Mktplace,5eecc6d6449e4f7cfb1c2708,2022-02-25T00:00:00.000Z,NEFT CR-DEUT0797BGL-MYNTRA DESIGNS PRIVA TE LIMITED-SLICK ORGANICS PVT. LTD.-2056 00565GN00190,shopping,,net_banking_transfer,1698.41
6229d5ded8beac15993d37a7,50200023535069,632849.56,60ec41ba55c00300382672d9,HDFC,Revenue-Mktplace,5eecc6d6449e4f7cfb1c2708,2022-02-25T00:00:00.000Z,NEFT CR-DEUT0797BGL-MYNTRA DESIGNS PRIVA TE LIMITED-SLICK ORGANICS PVT. LTD.-2056 00564GN00208,shopping,,net_banking_transfer,6832.97
6229d5ded8beac15993d37a9,50200023535069,532849.56,60ec41ba55c00300382672d9,HDFC,Marketing Expense,5eecc6d6449e4f7cfb1c2708,2022-02-25T00:00:00.000Z,POS 514834XXXXXX9486 GOOGLESERVIS,,,debit_card,-100000
6229d5ded8beac15993d37ab,50200023535069,533280.36,60ec41ba55c00300382672d9,HDFC,Revenue-PG-split enabled,5eecc6d6449e4f7cfb1c2708,2022-02-25T00:00:00.000Z,NEFT CR-UTIB0001506-RAZORPAY SOFTWARE PR IVATE LIMITED-SLICK ORGANICS PVT LITD-AX ISCN0123954005,insurance,,net_banking_transfer,430.8
6229d5ded8beac15993d37ad,50200023535069,523916.36,60ec41ba55c00300382672d9,HDFC,agency/vendor expense,5eecc6d6449e4f7cfb1c2708,2022-02-25T00:00:00.000Z,"NEFT DR-UTIB0003557-INCOSEC LEGAL-NETBAN K, MUM-N056221847331141-9364",,,net_banking_transfer,-9364
6229d5ded8beac15993d37af,50200023535069,518015.36,60ec41ba55c00300382672d9,HDFC,direct expenses,5eecc6d6449e4f7cfb1c2708,2022-02-25T00:00:00.000Z,50100097355028-TPT-5901-PALLAVI JUNEJA,,,net_banking_transfer,-5901
6229d5ded8beac15993d37b2,50200023535069,516856.36,60ec41ba55c00300382672d9,HDFC,direct expenses,5eecc6d6449e4f7cfb1c2708,2022-02-25T00:00:00.000Z,"NEFT DR-YESB0000048-SNEHA-NETBANK, MUM-N 056221847339830-1159",,,net_banking_transfer,-1159
6229d5ded8beac15993d37b4,50200023535069,518244.51,60ec41ba55c00300382672d9,HDFC,Transfer in/Revenue-other,5eecc6d6449e4f7cfb1c2708,2022-02-25T00:00:00.000Z,NEFT CR-YESB0000001-ILUMINAR MEDIA-SLICK ORGANICS PVT. LTD-N056221036574275,,,net_banking_transfer,1388.15
6229d5ded8beac15993d37b6,50200023535069,558234.51,60ec41ba55c00300382672d9,HDFC,Investments-New,5eecc6d6449e4f7cfb1c2708,2022-02-25T00:00:00.000Z,50200017917813-TPT-INV NO INV40741-1908 E-VENTURES PRIVATE LIMITED,,,net_banking_transfer,39990
6229d5ded8beac15993d37b8,50200023535069,303234.51,60ec41ba55c00300382672d9,HDFC,SAAS/tech expense,5eecc6d6449e4f7cfb1c2708,2022-02-25T00:00:00.000Z,POS 514834XXXXXX9486 AMAZON,shopping,,debit_card,-255000
6229d5ded8beac15993d37ba,50200023535069,301023.56,60ec41ba55c00300382672d9,HDFC,bank charges,5eecc6d6449e4f7cfb1c2708,2022-02-25T00:00:00.000Z,.DC INTL POS TXN MARKUP+ST 020222 030222 -CDT2203407778480,,,international_transaction_arbitrage,-2210.95
6229d5ded8beac15993d37be,50200023535069,344644.23,60ec41ba55c00300382672d9,HDFC,Revenue-UPI,5eecc6d6449e4f7cfb1c2708,2022-02-25T00:00:00.000Z,UPI-GOKWIK-GOKWIK@YESBANK-YESB0000340-20 5685827768-PAYOUT FOR FEBRUAR,,,upi,43620.67
6229d5ded8beac15993d37c0,50200023535069,354024.28,60ec41ba55c00300382672d9,HDFC,Revenue-COD,5eecc6d6449e4f7cfb1c2708,2022-02-25T00:00:00.000Z,NEFT CR-ICIC0000155-SHIPROCKET COD CRF I D 3883482-SLICK ORGANICS PVT LTD-CMS2417 081333,insurance,,net_banking_transfer,9380.05
6229d5ded8beac15993d37c2,50200023535069,354814.8,60ec41ba55c00300382672d9,HDFC,Revenue-Mktplace,5eecc6d6449e4f7cfb1c2708,2022-02-25T00:00:00.000Z,NEFT CR-DEUT0784BBY-TATA UNISTORE LTD-NO,,,net_banking_transfer,790.52
6229d5ded8beac15993d37c4,50200023535069,354929.27,60ec41ba55c00300382672d9,HDFC,Revenue-PG-split enabled,5eecc6d6449e4f7cfb1c2708,2022-02-25T00:00:00.000Z,NEFT CR-UTIB0001506-RAZORPAY SOFTWARE PR IVATE LIMITED-SLICK ORGANICS PVT LITD-AX ISCN0124060066,insurance,,net_banking_transfer,114.47
6229d5ded8beac15993d37c6,50200023535069,356113.25,60ec41ba55c00300382672d9,HDFC,Revenue-PG-non-split,5eecc6d6449e4f7cfb1c2708,2022-02-25T00:00:00.000Z,NEFT CR-IDFB0010204-SEZZLE PAYMENTS PRIV ATE LIMITED-SLICK ORGANICS PRIVATE LIMIT ED-IDFBH22056266872,insurance,,net_banking_transfer,1183.98
6229d5ded8beac15993d37c8,50200023535069,368542.65,60ec41ba55c00300382672d9,HDFC,Revenue-PG-non-split,5eecc6d6449e4f7cfb1c2708,2022-02-26T00:00:00.000Z,IMPS-205704325113-PAYTM PAYMENTS SERVI-P YTM-XXXXXXXXXX0008-ALL202202262168200003 30830668628,ewallet,,net_banking_transfer,12429.4
6229d5ded8beac15993d37ca,50200023535069,413782.72,60ec41ba55c00300382672d9,HDFC,Revenue-UPI,5eecc6d6449e4f7cfb1c2708,2022-02-26T00:00:00.000Z,UPI-GOKWIK-GOKWIK@YESBANK-YESB0000340-20 5787898135-PAYOUT FOR FEBRUAR,,,upi,45240.07
6229d5ded8beac15993d37cc,50200023535069,423235.76,60ec41ba55c00300382672d9,HDFC,Revenue-PG-non-split,5eecc6d6449e4f7cfb1c2708,2022-02-27T00:00:00.000Z,IMPS-205804854881-PAYTM PAYMENTS SERVI-P YTM-XXXXXXXXXX0008-ALL202202272168200003 30830668628,ewallet,,net_banking_transfer,9453.04
6229d5ded8beac15993d37ce,50200023535069,443877.71,60ec41ba55c00300382672d9,HDFC,Revenue-UPI,5eecc6d6449e4f7cfb1c2708,2022-02-27T00:00:00.000Z,UPI-GOKWIK-GOKWIK@YESBANK-YESB0000340-20 5889530723-PAYOUT FOR FEBRUAR,,,upi,20641.95
6229d5ded8beac15993d37d0,50200023535069,455540.32,60ec41ba55c00300382672d9,HDFC,Revenue-PG-non-split,5eecc6d6449e4f7cfb1c2708,2022-02-28T00:00:00.000Z,IMPS-205904243355-PAYTM PAYMENTS SERVI-P YTM-XXXXXXXXXX0008-ALL202202282168200003 30830668628,ewallet,,net_banking_transfer,11662.61
6229d5ded8beac15993d37d2,50200023535069,456583.57,60ec41ba55c00300382672d9,HDFC,Revenue-PG-split enabled,5eecc6d6449e4f7cfb1c2708,2022-02-28T00:00:00.000Z,NEFT CR-UTIB0001506-RAZORPAY SOFTWARE PR IVATE LIMITED-SLICK ORGANICS PVT LITD-AX ISCN0124189142,insurance,,net_banking_transfer,1043.25
6229d5ded8beac15993d37d4,50200023535069,334836.57,60ec41ba55c00300382672d9,HDFC,direct expenses,5eecc6d6449e4f7cfb1c2708,2022-02-28T00:00:00.000Z,"NEFT DR-KKBK0005289-HILL GROOVE CONSULTI NG LLP-NETBANK, MUM-N059221850398669-121 747",,,net_banking_transfer,-121747
6229d5ded8beac15993d37d6,50200023535069,334753.84,60ec41ba55c00300382672d9,HDFC,bank charges,5eecc6d6449e4f7cfb1c2708,2022-02-28T00:00:00.000Z,.DC INTL POS TXN MARKUP+ST 020222 040222 -CDT2203407778480,,,international_transaction_arbitrage,-82.73
6229d5ded8beac15993d37d8,50200023535069,503033.23,60ec41ba55c00300382672d9,HDFC,Revenue-Mktplace,5eecc6d6449e4f7cfb1c2708,2022-02-28T00:00:00.000Z,IMPS-205912335581-AMAZON SELLER SERVIC-H SBC-XXXXXXXX6004-384DYB48M4IM8TA6SLICK O RGANICS PVT LTD,shopping,,net_banking_transfer,168279.39
6229d5ded8beac15993d37da,50200023535069,935579.6,60ec41ba55c00300382672d9,HDFC,Revenue-Mktplace,5eecc6d6449e4f7cfb1c2708,2022-02-28T00:00:00.000Z,NEFT CR-DEUT0797BGL-AMAZON PAY (INDIA) P,shopping,,net_banking_transfer,432546.37
6229d5ded8beac15993d37dc,50200023535069,835579.6,60ec41ba55c00300382672d9,HDFC,Marketing Expense,5eecc6d6449e4f7cfb1c2708,2022-02-28T00:00:00.000Z,POS 514834XXXXXX9486 GOOGLESERVIS,,,debit_card,-100000
6229d5ded8beac15993d37de,50200023535069,827992.1,60ec41ba55c00300382672d9,HDFC,direct expenses,5eecc6d6449e4f7cfb1c2708,2022-02-28T00:00:00.000Z,POS 514834XXXXXX9486 GUPSHUP INC,,,debit_card,-7587.5
6229d5ded8beac15993d37e0,50200023535069,842977.69,60ec41ba55c00300382672d9,HDFC,Revenue-UPI,5eecc6d6449e4f7cfb1c2708,2022-02-28T00:00:00.000Z,UPI-GOKWIK-GOKWIK@YESBANK-YESB0000340-20 5991743976-PAYOUT FOR FEBRUAR,,,upi,14985.59
6229d5ded8beac15993d37e3,50200023535069,844334.17,60ec41ba55c00300382672d9,HDFC,Revenue-PG-non-split,5eecc6d6449e4f7cfb1c2708,2022-02-28T00:00:00.000Z,NEFT CR-KKBK0000958-BROKENTUSK TECHNOLOG IES PRIVATE LIMITED-SLICK ORGANICS PRIVA TE LIMITED-KKBK220593812152,,,net_banking_transfer,1356.48
6229d5ded8beac15993d37e5,50200023535069,845526.18,60ec41ba55c00300382672d9,HDFC,Revenue-PG-non-split,5eecc6d6449e4f7cfb1c2708,2022-02-28T00:00:00.000Z,NEFT CR-KKBK0000958-BROKENTUSK TECHNOLOG IES PRIVATE LIMITED-SLICK ORGANICS PRIVA TE LIMITED-KKBK220593812935,,,net_banking_transfer,1192.01
6229d5ded8beac15993d37e7,50200023535069,846239.18,60ec41ba55c00300382672d9,HDFC,Revenue-PG-non-split,5eecc6d6449e4f7cfb1c2708,2022-02-28T00:00:00.000Z,NEFT CR-IDFB0010204-SEZZLE PAYMENTS PRIV ATE LIMITED-SLICK ORGANICS PRIVATE LIMIT ED-IDFBH22059510626,insurance,,net_banking_transfer,713
6229d5ded8beac15993d37e9,50200023535069,846489.41,60ec41ba55c00300382672d9,HDFC,Revenue-PG-split enabled,5eecc6d6449e4f7cfb1c2708,2022-02-28T00:00:00.000Z,NEFT CR-UTIB0001506-RAZORPAY SOFTWARE PR,,,net_banking_transfer,250.23
62624756d8beac1599c6251a,50200035187206,6904.28,60ec419255c00300382671a5,HDFC,direct expenses,5eecc6d6449e4f7cfb1c2708,2021-07-10T00:00:00.000Z,INT. ON SWCR ON-50300462137427,,,Other,-12059
62624756d8beac1599c6251c,50200035187206,18963.28,60ec419255c00300382671a5,HDFC,Loan-in,5eecc6d6449e4f7cfb1c2708,2021-07-10T00:00:00.000Z,SWEEP-IN CREDIT - 50300462137427,,,self_transfer,948961
62624756d8beac1599c6251f,50200035187206,1.28,60ec419255c00300382671a5,HDFC,direct expenses,5eecc6d6449e4f7cfb1c2708,2021-07-11T00:00:00.000Z,INT. ON SWCR ON-50300462137427,,,Other,-39
62624756d8beac1599c62521,50200035187206,40.28,60ec419255c00300382671a5,HDFC,Loan-in,5eecc6d6449e4f7cfb1c2708,2021-07-11T00:00:00.000Z,SWEEP-IN CREDIT - 50300462137427,,,self_transfer,3136
62624756d8beac1599c62523,50200035187206,2500001.28,60ec419255c00300382671a5,HDFC,Transfer in/Revenue-other,5eecc6d6449e4f7cfb1c2708,2021-07-15T00:00:00.000Z,RTGS CR-KKBK0000958-SABJOT SINGH SAHNI-MS SLICK ORGANICS PVT LTD-0817918,insurance,,net_banking_transfer,2500000
62624756d8beac1599c62528,50200035187206,9505817.28,60ec419255c00300382671a5,HDFC,Transfer in/Revenue-other,5eecc6d6449e4f7cfb1c2708,2021-07-19T00:00:00.000Z,RTGS CR-UTIB0000514-NATARAJAN RANGANATHAN-SLICK ORGANICS PVT LTD-UTIBR5202107190 0193634,insurance,,net_banking_transfer,3502420
62624756d8beac1599c62533,50200035187206,5004841.28,60ec419255c00300382671a5,HDFC,Internal Transfers,5eecc6d6449e4f7cfb1c2708,2021-08-02T00:00:00.000Z,IB FUNDS TRANSFER DR-50200023535069 -SL ICK ORGANICS PVT LTD,insurance,,net_banking_transfer,-1000000
62624756d8beac1599c62535,50200035187206,3004841.28,60ec419255c00300382671a5,HDFC,Internal Transfers,5eecc6d6449e4f7cfb1c2708,2021-08-03T00:00:00.000Z,IB FUNDS TRANSFER DR-50200023535069 -SL ICK ORGANICS PVT LTD,insurance,,net_banking_transfer,-2000000
62624756d8beac1599c62537,50200035187206,2004841.28,60ec419255c00300382671a5,HDFC,Internal Transfers,5eecc6d6449e4f7cfb1c2708,2021-08-03T00:00:00.000Z,IB FUNDS TRANSFER DR-50200023535069 -SL ICK ORGANICS PVT LTD,insurance,,net_banking_transfer,-1000000
62624756d8beac1599c62539,50200035187206,1004841.28,60ec419255c00300382671a5,HDFC,Internal Transfers,5eecc6d6449e4f7cfb1c2708,2021-08-11T00:00:00.000Z,IB FUNDS TRANSFER DR-50200023535069 -SL ICK ORGANICS PVT LTD,insurance,,net_banking_transfer,-1000000
62624756d8beac1599c6253b,50200035187206,804841.28,60ec419255c00300382671a5,HDFC,Internal Transfers,5eecc6d6449e4f7cfb1c2708,2021-08-12T00:00:00.000Z,IB FUNDS TRANSFER DR-50200023535069 -SL ICK ORGANICS PVT LTD,insurance,,net_banking_transfer,-200000
62624756d8beac1599c6253d,50200035187206,704841.28,60ec419255c00300382671a5,HDFC,Internal Transfers,5eecc6d6449e4f7cfb1c2708,2021-08-12T00:00:00.000Z,IB FUNDS TRANSFER DR-50200023535069 -SL ICK ORGANICS PVT LTD,insurance,,net_banking_transfer,-100000
62624756d8beac1599c6253f,50200035187206,504841.28,60ec419255c00300382671a5,HDFC,Internal Transfers,5eecc6d6449e4f7cfb1c2708,2021-08-23T00:00:00.000Z,IB FUNDS TRANSFER DR-50200023535069 -SL ICK ORGANICS PVT LTD,insurance,,net_banking_transfer,-200000
62624756d8beac1599c62547,50200035187206,-498145.72,60ec419255c00300382671a5,HDFC,Transfer in/Revenue-other,5eecc6d6449e4f7cfb1c2708,2021-09-02T00:00:00.000Z,INT. ON SWCR ON-50300537849841,,,Other,932
62624756d8beac1599c62549,50200035187206,-499077.72,60ec419255c00300382671a5,HDFC,Loan-in,5eecc6d6449e4f7cfb1c2708,2021-09-02T00:00:00.000Z,SWEEP-IN CREDIT - 50300537849841,,,self_transfer,500000
62624756d8beac1599c6254e,50200035187206,957.28,60ec419255c00300382671a5,HDFC,Transfer in/Revenue-other,5eecc6d6449e4f7cfb1c2708,2021-09-03T00:00:00.000Z,INT. ON SWCR ON-50300537849841,,,Other,957
62624756d8beac1599c62550,50200035187206,0.28,60ec419255c00300382671a5,HDFC,Loan-in,5eecc6d6449e4f7cfb1c2708,2021-09-03T00:00:00.000Z,SWEEP-IN CREDIT - 50300537849841,,,self_transfer,499072
62624756d8beac1599c62556,50200035187206,1010.28,60ec419255c00300382671a5,HDFC,Transfer in/Revenue-other,5eecc6d6449e4f7cfb1c2708,2021-09-05T00:00:00.000Z,INT. ON SWCR ON-50300537849841,,,Other,1010
62624756d8beac1599c62558,50200035187206,0.28,60ec419255c00300382671a5,HDFC,Loan-in,5eecc6d6449e4f7cfb1c2708,2021-09-05T00:00:00.000Z,SWEEP-IN CREDIT - 50300537849841,,,self_transfer,497975
62624756d8beac1599c62561,50200035187206,-997808.72,60ec419255c00300382671a5,HDFC,Transfer in/Revenue-other,5eecc6d6449e4f7cfb1c2708,2021-09-08T00:00:00.000Z,INT. ON SWCR ON-50300537849841,,,Other,2191
62624756d8beac1599c62563,50200035187206,-999999.72,60ec419255c00300382671a5,HDFC,Loan-in,5eecc6d6449e4f7cfb1c2708,2021-09-08T00:00:00.000Z,SWEEP-IN CREDIT - 50300537849841,,,self_transfer,999575
62624756d8beac1599c62565,50200035187206,-496712.72,60ec419255c00300382671a5,HDFC,Transfer in/Revenue-other,5eecc6d6449e4f7cfb1c2708,2021-09-08T00:00:00.000Z,INT. ON SWCR ON-50300537849841,,,Other,1096
62624756d8beac1599c62567,50200035187206,-497808.72,60ec419255c00300382671a5,HDFC,Loan-in,5eecc6d6449e4f7cfb1c2708,2021-09-08T00:00:00.000Z,SWEEP-IN CREDIT - 50300537849841,,,self_transfer,500000
62624756d8beac1599c62569,50200035187206,1089.28,60ec419255c00300382671a5,HDFC,Transfer in/Revenue-other,5eecc6d6449e4f7cfb1c2708,2021-09-08T00:00:00.000Z,INT. ON SWCR ON-50300537849841,,,Other,1089
62624756d8beac1599c6256b,50200035187206,0.28,60ec419255c00300382671a5,HDFC,Loan-in,5eecc6d6449e4f7cfb1c2708,2021-09-08T00:00:00.000Z,SWEEP-IN CREDIT - 50300537849841,,,self_transfer,496713
62624756d8beac1599c6256d,50200035187206,-998910.72,60ec419255c00300382671a5,HDFC,Internal Transfers,5eecc6d6449e4f7cfb1c2708,2021-09-09T00:00:00.000Z,IB FUNDS TRANSFER DR-50200023535069 -SL,,,net_banking_transfer,-1000000
62624756d8beac1599c62579,50200035187206,2243.28,60ec419255c00300382671a5,HDFC,Transfer in/Revenue-other,5eecc6d6449e4f7cfb1c2708,2021-09-25T00:00:00.000Z,INT. ON SWCR ON-50300537849841,,,Other,2243
62624756d8beac1599c6257b,50200035187206,0.28,60ec419255c00300382671a5,HDFC,Loan-in,5eecc6d6449e4f7cfb1c2708,2021-09-25T00:00:00.000Z,SWEEP-IN CREDIT - 50300537849841,,,self_transfer,718174
62624756d8beac1599c6257e,50200035187206,1691.28,60ec419255c00300382671a5,HDFC,Transfer in/Revenue-other,5eecc6d6449e4f7cfb1c2708,2021-09-30T00:00:00.000Z,INT. ON SWCR ON-50300537849841,,,Other,1691
62624756d8beac1599c62580,50200035187206,0.28,60ec419255c00300382671a5,HDFC,Loan-in,5eecc6d6449e4f7cfb1c2708,2021-09-30T00:00:00.000Z,SWEEP-IN CREDIT - 50300537849841,,,self_transfer,497757
62624756d8beac1599c62583,50200035187206,3501.28,60ec419255c00300382671a5,HDFC,Transfer in/Revenue-other,5eecc6d6449e4f7cfb1c2708,2021-10-02T00:00:00.000Z,INT. ON SWCR ON-50300537849841,,,Other,3501
62624756d8beac1599c62585,50200035187206,0.28,60ec419255c00300382671a5,HDFC,Loan-in,5eecc6d6449e4f7cfb1c2708,2021-10-02T00:00:00.000Z,SWEEP-IN CREDIT - 50300537849841,,,self_transfer,998309
62624756d8beac1599c62588,50200035187206,1823.28,60ec419255c00300382671a5,HDFC,Transfer in/Revenue-other,5eecc6d6449e4f7cfb1c2708,2021-10-05T00:00:00.000Z,INT. ON SWCR ON-50300537849841,,,Other,1823
62624756d8beac1599c6258a,50200035187206,0.28,60ec419255c00300382671a5,HDFC,Loan-in,5eecc6d6449e4f7cfb1c2708,2021-10-05T00:00:00.000Z,SWEEP-IN CREDIT - 50300537849841,,,self_transfer,496499
62624756d8beac1599c6258d,50200035187206,-212176.72,60ec419255c00300382671a5,HDFC,Internal Transfers,5eecc6d6449e4f7cfb1c2708,2021-10-07T00:00:00.000Z,IB FUNDS TRANSFER DR-50200023535069 -SL,,,net_banking_transfer,-5000
62624756d8beac1599c6258f,50200035187206,-4204.72,60ec419255c00300382671a5,HDFC,Transfer in/Revenue-other,5eecc6d6449e4f7cfb1c2708,2021-10-08T00:00:00.000Z,INT. ON SWCR ON-50300537849841,,,Other,795
62624756d8beac1599c62591,50200035187206,-4999.72,60ec419255c00300382671a5,HDFC,Loan-in,5eecc6d6449e4f7cfb1c2708,2021-10-08T00:00:00.000Z,SWEEP-IN CREDIT - 50300537849841,,,self_transfer,207177
62624756d8beac1599c62593,50200035187206,-3176.72,60ec419255c00300382671a5,HDFC,Transfer in/Revenue-other,5eecc6d6449e4f7cfb1c2708,2021-10-08T00:00:00.000Z,INT. ON SWCR ON-50300537849841,,,Other,4
62624756d8beac1599c62595,50200035187206,-3180.72,60ec419255c00300382671a5,HDFC,Loan-in,5eecc6d6449e4f7cfb1c2708,2021-10-08T00:00:00.000Z,SWEEP-IN CREDIT - 50300537849841,,,self_transfer,1024
62624756d8beac1599c62597,50200035187206,0.28,60ec419255c00300382671a5,HDFC,direct expenses,5eecc6d6449e4f7cfb1c2708,2021-10-08T00:00:00.000Z,INT. ON SWCR ON-50300462137427,,,Other,-34
62624756d8beac1599c62599,50200035187206,34.28,60ec419255c00300382671a5,HDFC,Loan-in,5eecc6d6449e4f7cfb1c2708,2021-10-08T00:00:00.000Z,SWEEP-IN CREDIT - 50300462137427,,,self_transfer,3211
62624756d8beac1599c6259d,50200035187206,-199.72,60ec419255c00300382671a5,HDFC,direct expenses,5eecc6d6449e4f7cfb1c2708,2021-10-12T00:00:00.000Z,INT. ON SWCR ON-50300462137427,,,Other,-12
62624756d8beac1599c6259f,50200035187206,-187.72,60ec419255c00300382671a5,HDFC,Loan-in,5eecc6d6449e4f7cfb1c2708,2021-10-12T00:00:00.000Z,SWEEP-IN CREDIT - 50300462137427,,,self_transfer,1012
62624756d8beac1599c625a1,50200035187206,1.28,60ec419255c00300382671a5,HDFC,direct expenses,5eecc6d6449e4f7cfb1c2708,2021-10-12T00:00:00.000Z,INT. ON SWCR ON-50300462137427,,,Other,-2
62624756d8beac1599c625a3,50200035187206,3.28,60ec419255c00300382671a5,HDFC,Loan-in,5eecc6d6449e4f7cfb1c2708,2021-10-12T00:00:00.000Z,SWEEP-IN CREDIT - 50300462137427,,,self_transfer,203
62624756d8beac1599c625a5,50200035187206,20004035.82,60ec419255c00300382671a5,HDFC,Transfer in/Revenue-other,5eecc6d6449e4f7cfb1c2708,2021-11-18T00:00:00.000Z,RTGS CR-SCBL0036001-VULCANIS LLP-SLICK ORGANICS PRIVATE LIMITED-SCBLR12021111800 004450,insurance,,net_banking_transfer,20004034.54
62624756d8beac1599c625a7,50200035187206,70004035.82,60ec419255c00300382671a5,HDFC,Transfer in/Revenue-other,5eecc6d6449e4f7cfb1c2708,2021-11-18T00:00:00.000Z,RTGS CR-SCBL0036001-VULCANIS LLP-SLICK ORGANICS PRIVATE LIMITED-004449,insurance,,net_banking_transfer,50000000
62624756d8beac1599c625ae,50200035187206,61004035.82,60ec419255c00300382671a5,HDFC,Internal Transfers,5eecc6d6449e4f7cfb1c2708,2021-11-23T00:00:00.000Z,IB FUNDS TRANSFER DR-50200023535069 -SL,,,net_banking_transfer,-1000000
62624756d8beac1599c625c8,50200035187206,-499423.18,60ec419255c00300382671a5,HDFC,Transfer in/Revenue-other,5eecc6d6449e4f7cfb1c2708,2021-12-09T00:00:00.000Z,INT. ON SWCR ON-50300573433240,,,Other,288
62624756d8beac1599c625ca,50200035187206,-499711.18,60ec419255c00300382671a5,HDFC,Loan-in,5eecc6d6449e4f7cfb1c2708,2021-12-09T00:00:00.000Z,SWEEP-IN CREDIT - 50300573433240,,,self_transfer,1000000
62624756d8beac1599c625cc,50200035187206,144.82,60ec419255c00300382671a5,HDFC,Transfer in/Revenue-other,5eecc6d6449e4f7cfb1c2708,2021-12-09T00:00:00.000Z,INT. ON SWCR ON-50300573433240,,,Other,144
62624756d8beac1599c625ce,50200035187206,0.82,60ec419255c00300382671a5,HDFC,Loan-in,5eecc6d6449e4f7cfb1c2708,2021-12-09T00:00:00.000Z,SWEEP-IN CREDIT - 50300573433240,,,self_transfer,499424
62624756d8beac1599c625d1,50200035187206,740.82,60ec419255c00300382671a5,HDFC,Transfer in/Revenue-other,5eecc6d6449e4f7cfb1c2708,2021-12-11T00:00:00.000Z,INT. ON SWCR ON-50300573433240,,,Other,740
62624756d8beac1599c625d3,50200035187206,0.82,60ec419255c00300382671a5,HDFC,Loan-in,5eecc6d6449e4f7cfb1c2708,2021-12-11T00:00:00.000Z,SWEEP-IN CREDIT - 50300573433240,,,self_transfer,1999856
62624756d8beac1599c625d6,50200035187206,411.82,60ec419255c00300382671a5,HDFC,Transfer in/Revenue-other,5eecc6d6449e4f7cfb1c2708,2021-12-12T00:00:00.000Z,INT. ON SWCR ON-50300573433240,,,Other,411
62624756d8beac1599c625d8,50200035187206,0.82,60ec419255c00300382671a5,HDFC,Loan-in,5eecc6d6449e4f7cfb1c2708,2021-12-12T00:00:00.000Z,SWEEP-IN CREDIT - 50300573433240,,,self_transfer,999260
62624756d8beac1599c625db,50200035187206,493.82,60ec419255c00300382671a5,HDFC,Transfer in/Revenue-other,5eecc6d6449e4f7cfb1c2708,2021-12-14T00:00:00.000Z,INT. ON SWCR ON-50300573433240,,,Other,493
62624756d8beac1599c625dd,50200035187206,0.82,60ec419255c00300382671a5,HDFC,Loan-in,5eecc6d6449e4f7cfb1c2708,2021-12-14T00:00:00.000Z,SWEEP-IN CREDIT - 50300573433240,,,self_transfer,999589
62624756d8beac1599c625e1,50200035187206,-1493597.18,60ec419255c00300382671a5,HDFC,Transfer in/Revenue-other,5eecc6d6449e4f7cfb1c2708,2021-12-15T00:00:00.000Z,INT. ON SWCR ON-50300573433240,,,Other,3
62624756d8beac1599c625e3,50200035187206,-1493600.18,60ec419255c00300382671a5,HDFC,Loan-in,5eecc6d6449e4f7cfb1c2708,2021-12-15T00:00:00.000Z,SWEEP-IN CREDIT - 50300573433240,,,self_transfer,5906
62624756d8beac1599c625e7,50200035187206,267.82,60ec419255c00300382671a5,HDFC,Transfer in/Revenue-other,5eecc6d6449e4f7cfb1c2708,2021-12-15T00:00:00.000Z,INT. ON SWCR ON-50300573434322,,,Other,267
62624756d8beac1599c625e9,50200035187206,0.82,60ec419255c00300382671a5,HDFC,Loan-in,5eecc6d6449e4f7cfb1c2708,2021-12-15T00:00:00.000Z,SWEEP-IN CREDIT - 50300573434322,,,self_transfer,499466
62624756d8beac1599c625ef,50200035187206,-999424.18,60ec419255c00300382671a5,HDFC,Transfer in/Revenue-other,5eecc6d6449e4f7cfb1c2708,2021-12-16T00:00:00.000Z,INT. ON SWCR ON-50300573434322,,,Other,575
62624756d8beac1599c625f1,50200035187206,-999999.18,60ec419255c00300382671a5,HDFC,Loan-in,5eecc6d6449e4f7cfb1c2708,2021-12-16T00:00:00.000Z,SWEEP-IN CREDIT - 50300573434322,,,self_transfer,999733
62624756d8beac1599c625f8,50200035187206,308.82,60ec419255c00300382671a5,HDFC,Transfer in/Revenue-other,5eecc6d6449e4f7cfb1c2708,2021-12-17T00:00:00.000Z,INT. ON SWCR ON-50300573434322,,,Other,308
62624756d8beac1599c625fa,50200035187206,0.82,60ec419255c00300382671a5,HDFC,Loan-in,5eecc6d6449e4f7cfb1c2708,2021-12-17T00:00:00.000Z,SWEEP-IN CREDIT - 50300573434322,,,self_transfer,499713
62624756d8beac1599c625fe,50200035187206,-499218.18,60ec419255c00300382671a5,HDFC,Transfer in/Revenue-other,5eecc6d6449e4f7cfb1c2708,2021-12-21T00:00:00.000Z,INT. ON SWCR ON-50300573434322,,,Other,781
62624756d8beac1599c62600,50200035187206,-499999.18,60ec419255c00300382671a5,HDFC,Loan-in,5eecc6d6449e4f7cfb1c2708,2021-12-21T00:00:00.000Z,SWEEP-IN CREDIT - 50300573434322,,,self_transfer,999692
62624756d8beac1599c62602,50200035187206,390.82,60ec419255c00300382671a5,HDFC,Transfer in/Revenue-other,5eecc6d6449e4f7cfb1c2708,2021-12-21T00:00:00.000Z,INT. ON SWCR ON-50300573434322,,,Other,390
62624756d8beac1599c62604,50200035187206,0.82,60ec419255c00300382671a5,HDFC,Loan-in,5eecc6d6449e4f7cfb1c2708,2021-12-21T00:00:00.000Z,SWEEP-IN CREDIT - 50300573434322,,,self_transfer,499219
62624756d8beac1599c62608,50200035187206,1150.82,60ec419255c00300382671a5,HDFC,Transfer in/Revenue-other,5eecc6d6449e4f7cfb1c2708,2021-12-30T00:00:00.000Z,INT. ON SWCR ON-50300573434322,,,Other,1150
62624756d8beac1599c6260a,50200035187206,0.82,60ec419255c00300382671a5,HDFC,Loan-in,5eecc6d6449e4f7cfb1c2708,2021-12-30T00:00:00.000Z,SWEEP-IN CREDIT - 50300573434322,,,self_transfer,999609
62624756d8beac1599c6260d,50200035187206,595.82,60ec419255c00300382671a5,HDFC,Transfer in/Revenue-other,5eecc6d6449e4f7cfb1c2708,2021-12-31T00:00:00.000Z,INT. ON SWCR ON-50300573434322,,,Other,595
62624756d8beac1599c6260f,50200035187206,0.82,60ec419255c00300382671a5,HDFC,Loan-in,5eecc6d6449e4f7cfb1c2708,2021-12-31T00:00:00.000Z,SWEEP-IN CREDIT - 50300573434322,,,self_transfer,498850
62624756d8beac1599c62614,50200035187206,-999096.18,60ec419255c00300382671a5,HDFC,Transfer in/Revenue-other,5eecc6d6449e4f7cfb1c2708,2022-01-04T00:00:00.000Z,INT. ON SWCR ON-50300573434322,,,Other,903
62624756d8beac1599c62616,50200035187206,-999999.18,60ec419255c00300382671a5,HDFC,Loan-in,5eecc6d6449e4f7cfb1c2708,2022-01-04T00:00:00.000Z,SWEEP-IN CREDIT - 50300573434322,,,self_transfer,499405
62624756d8beac1599c62621,50200035187206,-498032.18,60ec419255c00300382671a5,HDFC,Transfer in/Revenue-other,5eecc6d6449e4f7cfb1c2708,2022-01-07T00:00:00.000Z,INT. ON SWCR ON-50300573434322,,,Other,1967
62624756d8beac1599c62623,50200035187206,-499999.18,60ec419255c00300382671a5,HDFC,Loan-in,5eecc6d6449e4f7cfb1c2708,2022-01-07T00:00:00.000Z,SWEEP-IN CREDIT - 50300573434322,,,self_transfer,997125
62624756d8beac1599c62628,50200035187206,-1999017.18,60ec419255c00300382671a5,HDFC,Internal Transfers,5eecc6d6449e4f7cfb1c2708,2022-01-07T00:00:00.000Z,IB FUNDS TRANSFER DR-50200023535069 -SL,,,net_banking_transfer,-500000
62624756d8beac1599c6262e,50200035187206,-1996960.18,60ec419255c00300382671a5,HDFC,Transfer in/Revenue-other,5eecc6d6449e4f7cfb1c2708,2022-01-08T00:00:00.000Z,INT. ON SWCR ON-50300573434322,,,Other,3039
62624756d8beac1599c62630,50200035187206,-1999999.18,60ec419255c00300382671a5,HDFC,Loan-in,5eecc6d6449e4f7cfb1c2708,2022-01-08T00:00:00.000Z,SWEEP-IN CREDIT - 50300573434322,,,self_transfer,1499018
62624756d8beac1599c62636,50200035187206,-493918.18,60ec419255c00300382671a5,HDFC,Transfer in/Revenue-other,5eecc6d6449e4f7cfb1c2708,2022-01-08T00:00:00.000Z,INT. ON SWCR ON-50300573434322,,,Other,1014
62624756d8beac1599c62638,50200035187206,-494932.18,60ec419255c00300382671a5,HDFC,Loan-in,5eecc6d6449e4f7cfb1c2708,2022-01-08T00:00:00.000Z,SWEEP-IN CREDIT - 50300573434322,,,self_transfer,500000
62624756d8beac1599c6263a,50200035187206,1001.82,60ec419255c00300382671a5,HDFC,Transfer in/Revenue-other,5eecc6d6449e4f7cfb1c2708,2022-01-08T00:00:00.000Z,INT. ON SWCR ON-50300573434322,,,Other,1001
62624756d8beac1599c6263c,50200035187206,0.82,60ec419255c00300382671a5,HDFC,Loan-in,5eecc6d6449e4f7cfb1c2708,2022-01-08T00:00:00.000Z,SWEEP-IN CREDIT - 50300573434322,,,self_transfer,493919
62624756d8beac1599c62644,50200035187206,1175.82,60ec419255c00300382671a5,HDFC,Transfer in/Revenue-other,5eecc6d6449e4f7cfb1c2708,2022-01-12T00:00:00.000Z,INT. ON SWCR ON-50300572637408,,,Other,1175
62624756d8beac1599c62646,50200035187206,0.82,60ec419255c00300382671a5,HDFC,Loan-in,5eecc6d6449e4f7cfb1c2708,2022-01-12T00:00:00.000Z,SWEEP-IN CREDIT - 50300572637408,,,self_transfer,498827
62624756d8beac1599c6264b,50200035187206,-498796.18,60ec419255c00300382671a5,HDFC,Internal Transfers,5eecc6d6449e4f7cfb1c2708,2022-01-14T00:00:00.000Z,IB FUNDS TRANSFER DR-50200023535069 -SL,,,net_banking_transfer,-500000
62624756d8beac1599c6264f,50200035187206,-1498742.18,60ec419255c00300382671a5,HDFC,Transfer in/Revenue-other,5eecc6d6449e4f7cfb1c2708,2022-01-15T00:00:00.000Z,INT. ON SWCR ON-50300572637408,,,Other,1257
62624756d8beac1599c62651,50200035187206,-1499999.18,60ec419255c00300382671a5,HDFC,Loan-in,5eecc6d6449e4f7cfb1c2708,2022-01-15T00:00:00.000Z,SWEEP-IN CREDIT - 50300572637408,,,self_transfer,498797
62624756d8beac1599c6265a,50200035187206,-498605.18,60ec419255c00300382671a5,HDFC,Transfer in/Revenue-other,5eecc6d6449e4f7cfb1c2708,2022-01-20T00:00:00.000Z,INT. ON SWCR ON-50300572637408,,,Other,1394
62624756d8beac1599c6265c,50200035187206,-499999.18,60ec419255c00300382671a5,HDFC,Loan-in,5eecc6d6449e4f7cfb1c2708,2022-01-20T00:00:00.000Z,SWEEP-IN CREDIT - 50300572637408,,,self_transfer,498722
62624756d8beac1599c6265e,50200035187206,1393.82,60ec419255c00300382671a5,HDFC,Transfer in/Revenue-other,5eecc6d6449e4f7cfb1c2708,2022-01-20T00:00:00.000Z,INT. ON SWCR ON-50300572637408,,,Other,1393
62624756d8beac1599c62660,50200035187206,0.82,60ec419255c00300382671a5,HDFC,Loan-in,5eecc6d6449e4f7cfb1c2708,2022-01-20T00:00:00.000Z,SWEEP-IN CREDIT - 50300572637408,,,self_transfer,498606
62624756d8beac1599c62669,50200035187206,579.82,60ec419255c00300382671a5,HDFC,Transfer in/Revenue-other,5eecc6d6449e4f7cfb1c2708,2022-01-22T00:00:00.000Z,INT. ON SWCR ON-50300572637408,,,Other,579
62624756d8beac1599c6266b,50200035187206,0.82,60ec419255c00300382671a5,HDFC,Loan-in,5eecc6d6449e4f7cfb1c2708,2022-01-22T00:00:00.000Z,SWEEP-IN CREDIT - 50300572637408,,,self_transfer,199438
62624756d8beac1599c6266d,50200035187206,-499420.18,60ec419255c00300382671a5,HDFC,Internal Transfers,5eecc6d6449e4f7cfb1c2708,2022-01-22T00:00:00.000Z,IB FUNDS TRANSFER DR-50200023535069 -SL,,,net_banking_transfer,-500000
62624756d8beac1599c6266f,50200035187206,1478.82,60ec419255c00300382671a5,HDFC,Transfer in/Revenue-other,5eecc6d6449e4f7cfb1c2708,2022-01-23T00:00:00.000Z,INT. ON SWCR ON-50300572637408,,,Other,1478
62624756d8beac1599c62671,50200035187206,0.82,60ec419255c00300382671a5,HDFC,Loan-in,5eecc6d6449e4f7cfb1c2708,2022-01-23T00:00:00.000Z,SWEEP-IN CREDIT - 50300572637408,,,self_transfer,499421
62624756d8beac1599c62676,50200035187206,-496935.18,60ec419255c00300382671a5,HDFC,Transfer in/Revenue-other,5eecc6d6449e4f7cfb1c2708,2022-01-25T00:00:00.000Z,INT. ON SWCR ON-50300572637408,,,Other,3064
62624756d8beac1599c62678,50200035187206,-499999.18,60ec419255c00300382671a5,HDFC,Loan-in,5eecc6d6449e4f7cfb1c2708,2022-01-25T00:00:00.000Z,SWEEP-IN CREDIT - 50300572637408,,,self_transfer,998522
62624756d8beac1599c6267a,50200035187206,-396628.18,60ec419255c00300382671a5,HDFC,Transfer in/Revenue-other,5eecc6d6449e4f7cfb1c2708,2022-01-25T00:00:00.000Z,INT. ON SWCR ON-50300572637408,,,Other,307
62624756d8beac1599c6267c,50200035187206,-396935.18,60ec419255c00300382671a5,HDFC,Loan-in,5eecc6d6449e4f7cfb1c2708,2022-01-25T00:00:00.000Z,SWEEP-IN CREDIT - 50300572637408,,,self_transfer,100000
62624756d8beac1599c62686,50200035187206,-498278.18,60ec419255c00300382671a5,HDFC,Internal Transfers,5eecc6d6449e4f7cfb1c2708,2022-02-01T00:00:00.000Z,IB FUNDS TRANSFER DR-50200023535069 -SL ICK ORGANICS PVT LTD,insurance,,net_banking_transfer,-500000
62624756d8beac1599c62688,50200035187206,-998278.18,60ec419255c00300382671a5,HDFC,Internal Transfers,5eecc6d6449e4f7cfb1c2708,2022-02-01T00:00:00.000Z,IB FUNDS TRANSFER DR-50200023535069 -SL ICK ORGANICS PVT LTD,insurance,,net_banking_transfer,-500000
62624756d8beac1599c6268a,50200035187206,-498252.18,60ec419255c00300382671a5,HDFC,Transfer in/Revenue-other,5eecc6d6449e4f7cfb1c2708,2022-02-02T00:00:00.000Z,INT. ON SWCR ON-50300572637408,,,Other,1747
62624756d8beac1599c6268c,50200035187206,-499999.18,60ec419255c00300382671a5,HDFC,Loan-in,5eecc6d6449e4f7cfb1c2708,2022-02-02T00:00:00.000Z,SWEEP-IN CREDIT - 50300572637408,,,self_transfer,498279
62624756d8beac1599c6268e,50200035187206,-496505.18,60ec419255c00300382671a5,HDFC,Transfer in/Revenue-other,5eecc6d6449e4f7cfb1c2708,2022-02-02T00:00:00.000Z,INT. ON SWCR ON-50300572637408,,,Other,1747
62624756d8beac1599c62690,50200035187206,1747.82,60ec419255c00300382671a5,HDFC,Loan-in,5eecc6d6449e4f7cfb1c2708,2022-02-02T00:00:00.000Z,SWEEP-IN CREDIT - 50300572637408,,,self_transfer,498253
62624756d8beac1599c62692,50200035187206,-498252.18,60ec419255c00300382671a5,HDFC,Internal Transfers,5eecc6d6449e4f7cfb1c2708,2022-02-02T00:00:00.000Z,IB FUNDS TRANSFER DR-50200023535069 -SL,,,net_banking_transfer,-500000
62624756d8beac1599c62694,50200035187206,1775.82,60ec419255c00300382671a5,HDFC,Transfer in/Revenue-other,5eecc6d6449e4f7cfb1c2708,2022-02-03T00:00:00.000Z,INT. ON SWCR ON-50300572637408,,,Other,1775
62624756d8beac1599c62696,50200035187206,0.82,60ec419255c00300382671a5,HDFC,Loan-in,5eecc6d6449e4f7cfb1c2708,2022-02-03T00:00:00.000Z,SWEEP-IN CREDIT - 50300572637408,,,self_transfer,498253
62624756d8beac1599c62698,50200035187206,-498224.18,60ec419255c00300382671a5,HDFC,Internal Transfers,5eecc6d6449e4f7cfb1c2708,2022-02-03T00:00:00.000Z,IB FUNDS TRANSFER DR-50200023535069 -SL ICK ORGANICS PVT LTD,insurance,,net_banking_transfer,-500000
62624756d8beac1599c6269a,50200035187206,-496422.18,60ec419255c00300382671a5,HDFC,Transfer in/Revenue-other,5eecc6d6449e4f7cfb1c2708,2022-02-04T00:00:00.000Z,INT. ON SWCR ON-50300572637408,,,Other,1802
62624756d8beac1599c6269c,50200035187206,1802.82,60ec419255c00300382671a5,HDFC,Loan-in,5eecc6d6449e4f7cfb1c2708,2022-02-04T00:00:00.000Z,SWEEP-IN CREDIT - 50300572637408,,,self_transfer,498225
62624756d8beac1599c6269e,50200035187206,-998197.18,60ec419255c00300382671a5,HDFC,Internal Transfers,5eecc6d6449e4f7cfb1c2708,2022-02-04T00:00:00.000Z,IB FUNDS TRANSFER DR-50200023535069 -SL ICK ORGANICS PVT LTD,insurance,,net_banking_transfer,-1000000
62624756d8beac1599c626a0,50200035187206,-994531.18,60ec419255c00300382671a5,HDFC,Transfer in/Revenue-other,5eecc6d6449e4f7cfb1c2708,2022-02-05T00:00:00.000Z,INT. ON SWCR ON-50300572637408,,,Other,3666
62624756d8beac1599c626a2,50200035187206,0.82,60ec419255c00300382671a5,HDFC,direct expenses,5eecc6d6449e4f7cfb1c2708,2022-02-05T00:00:00.000Z,TDS RECOVERED ON-50300572637408,,,Other,-4057
62624756d8beac1599c626a4,50200035187206,4057.82,60ec419255c00300382671a5,HDFC,Loan-in,5eecc6d6449e4f7cfb1c2708,2022-02-05T00:00:00.000Z,SWEEP-IN CREDIT - 50300572637408,,,self_transfer,998589
62624756d8beac1599c626a6,50200035187206,-499999.18,60ec419255c00300382671a5,HDFC,Internal Transfers,5eecc6d6449e4f7cfb1c2708,2022-02-07T00:00:00.000Z,IB FUNDS TRANSFER DR-50200023535069 -SL ICK ORGANICS PVT LTD,insurance,,net_banking_transfer,-500000
62624756d8beac1599c626a8,50200035187206,-999999.18,60ec419255c00300382671a5,HDFC,Internal Transfers,5eecc6d6449e4f7cfb1c2708,2022-02-07T00:00:00.000Z,IB FUNDS TRANSFER DR-50200023535069 -SL ICK ORGANICS PVT LTD,insurance,,net_banking_transfer,-500000
62624756d8beac1599c626aa,50200035187206,-1999999.18,60ec419255c00300382671a5,HDFC,Internal Transfers,5eecc6d6449e4f7cfb1c2708,2022-02-07T00:00:00.000Z,IB FUNDS TRANSFER DR-50200023535069 -SL ICK ORGANICS PVT LTD,insurance,,net_banking_transfer,-1000000
62624756d8beac1599c626ac,50200035187206,-2499999.18,60ec419255c00300382671a5,HDFC,Internal Transfers,5eecc6d6449e4f7cfb1c2708,2022-02-07T00:00:00.000Z,IB FUNDS TRANSFER DR-50200023535069 -SL ICK ORGANICS PVT LTD,insurance,,net_banking_transfer,-500000
62624756d8beac1599c626ae,50200035187206,-2999999.18,60ec419255c00300382671a5,HDFC,Internal Transfers,5eecc6d6449e4f7cfb1c2708,2022-02-07T00:00:00.000Z,IB FUNDS TRANSFER DR-50200023535069 -SL ICK ORGANICS PVT LTD,insurance,,net_banking_transfer,-500000
62624756d8beac1599c626b0,50200035187206,-2998272.98,60ec419255c00300382671a5,HDFC,direct expenses,5eecc6d6449e4f7cfb1c2708,2022-02-08T00:00:00.000Z,TDS RECOVERED ON-50300572637408,,,Other,-191.8
62624756d8beac1599c626b2,50200035187206,-2998081.18,60ec419255c00300382671a5,HDFC,Transfer in/Revenue-other,5eecc6d6449e4f7cfb1c2708,2022-02-08T00:00:00.000Z,INT. ON SWCR ON-50300572637408,,,Other,1918
62624756d8beac1599c626b4,50200035187206,-2498272.98,60ec419255c00300382671a5,HDFC,Loan-in,5eecc6d6449e4f7cfb1c2708,2022-02-08T00:00:00.000Z,SWEEP-IN CREDIT - 50300572637408,,,self_transfer,500000
62624756d8beac1599c626b6,50200035187206,-1998464.78,60ec419255c00300382671a5,HDFC,direct expenses,5eecc6d6449e4f7cfb1c2708,2022-02-08T00:00:00.000Z,TDS RECOVERED ON-50300572637408,,,Other,-191.8
62624756d8beac1599c626b8,50200035187206,-1996546.78,60ec419255c00300382671a5,HDFC,Transfer in/Revenue-other,5eecc6d6449e4f7cfb1c2708,2022-02-08T00:00:00.000Z,INT. ON SWCR ON-50300572637408,,,Other,1918
62624756d8beac1599c626ba,50200035187206,-1998272.98,60ec419255c00300382671a5,HDFC,Loan-in,5eecc6d6449e4f7cfb1c2708,2022-02-08T00:00:00.000Z,SWEEP-IN CREDIT - 50300572637408,,,self_transfer,500000
62624756d8beac1599c626bc,50200035187206,-993094.38,60ec419255c00300382671a5,HDFC,direct expenses,5eecc6d6449e4f7cfb1c2708,2022-02-08T00:00:00.000Z,TDS RECOVERED ON-50300572637408,,,Other,-383.6
62624756d8beac1599c626be,50200035187206,-992710.78,60ec419255c00300382671a5,HDFC,Transfer in/Revenue-other,5eecc6d6449e4f7cfb1c2708,2022-02-08T00:00:00.000Z,INT. ON SWCR ON-50300572637408,,,Other,3836
62624756d8beac1599c626c0,50200035187206,-996546.78,60ec419255c00300382671a5,HDFC,Loan-in,5eecc6d6449e4f7cfb1c2708,2022-02-08T00:00:00.000Z,SWEEP-IN CREDIT - 50300572637408,,,self_transfer,1000000
62624756d8beac1599c626c2,50200035187206,-991368.18,60ec419255c00300382671a5,HDFC,direct expenses,5eecc6d6449e4f7cfb1c2708,2022-02-08T00:00:00.000Z,TDS RECOVERED ON-50300572637408,,,Other,-191.8
62624756d8beac1599c626c4,50200035187206,-991176.38,60ec419255c00300382671a5,HDFC,Transfer in/Revenue-other,5eecc6d6449e4f7cfb1c2708,2022-02-08T00:00:00.000Z,INT. ON SWCR ON-50300572637408,,,Other,1918
62624756d8beac1599c626c6,50200035187206,-491368.18,60ec419255c00300382671a5,HDFC,Loan-in,5eecc6d6449e4f7cfb1c2708,2022-02-08T00:00:00.000Z,SWEEP-IN CREDIT - 50300572637408,,,self_transfer,500000
62624756d8beac1599c626c8,50200035187206,-331551.48,60ec419255c00300382671a5,HDFC,direct expenses,5eecc6d6449e4f7cfb1c2708,2022-02-08T00:00:00.000Z,TDS RECOVERED ON-50300572637408,,,Other,-61.3
62624756d8beac1599c626ca,50200035187206,-330938.48,60ec419255c00300382671a5,HDFC,Transfer in/Revenue-other,5eecc6d6449e4f7cfb1c2708,2022-02-08T00:00:00.000Z,INT. ON SWCR ON-50300572637408,,,Other,613
62624756d8beac1599c626cc,50200035187206,-331490.18,60ec419255c00300382671a5,HDFC,Loan-in,5eecc6d6449e4f7cfb1c2708,2022-02-08T00:00:00.000Z,SWEEP-IN CREDIT - 50300572637408,,,self_transfer,159878
62624756d8beac1599c626ce,50200035187206,1192.12,60ec419255c00300382671a5,HDFC,direct expenses,5eecc6d6449e4f7cfb1c2708,2022-02-08T00:00:00.000Z,TDS RECOVERED ON-50300571891040,,,Other,-132.4
62624756d8beac1599c626d0,50200035187206,-329614.48,60ec419255c00300382671a5,HDFC,Transfer in/Revenue-other,5eecc6d6449e4f7cfb1c2708,2022-02-08T00:00:00.000Z,INT. ON SWCR ON-50300571891040,,,Other,1324
62624756d8beac1599c626d2,50200035187206,1324.52,60ec419255c00300382671a5,HDFC,Loan-in,5eecc6d6449e4f7cfb1c2708,2022-02-08T00:00:00.000Z,SWEEP-IN CREDIT - 50300571891040,,,self_transfer,330939
62624756d8beac1599c626d4,50200035187206,-1498807.88,60ec419255c00300382671a5,HDFC,Internal Transfers,5eecc6d6449e4f7cfb1c2708,2022-02-10T00:00:00.000Z,IB FUNDS TRANSFER DR-50200023535069 -SL ICK ORGANICS PVT LTD,insurance,,net_banking_transfer,-1500000
62624756d8beac1599c626d6,50200035187206,-1998807.88,60ec419255c00300382671a5,HDFC,Internal Transfers,5eecc6d6449e4f7cfb1c2708,2022-02-10T00:00:00.000Z,IB FUNDS TRANSFER DR-50200023535069 -SL ICK ORGANICS PVT LTD,insurance,,net_banking_transfer,-500000
62624756d8beac1599c626d8,50200035187206,-494382.08,60ec419255c00300382671a5,HDFC,direct expenses,5eecc6d6449e4f7cfb1c2708,2022-02-11T00:00:00.000Z,TDS RECOVERED ON-50300571891040,,,Other,-624.2
62624756d8beac1599c626da,50200035187206,-493757.88,60ec419255c00300382671a5,HDFC,Transfer in/Revenue-other,5eecc6d6449e4f7cfb1c2708,2022-02-11T00:00:00.000Z,INT. ON SWCR ON-50300571891040,,,Other,6242
62624756d8beac1599c626dc,50200035187206,-499999.88,60ec419255c00300382671a5,HDFC,Loan-in,5eecc6d6449e4f7cfb1c2708,2022-02-11T00:00:00.000Z,SWEEP-IN CREDIT - 50300571891040,,,self_transfer,1498808
62624756d8beac1599c626de,50200035187206,-494587.98,60ec419255c00300382671a5,HDFC,direct expenses,5eecc6d6449e4f7cfb1c2708,2022-02-11T00:00:00.000Z,TDS RECOVERED ON-50300571891040,,,Other,-205.9
62624756d8beac1599c626e0,50200035187206,-492528.98,60ec419255c00300382671a5,HDFC,Transfer in/Revenue-other,5eecc6d6449e4f7cfb1c2708,2022-02-11T00:00:00.000Z,INT. ON SWCR ON-50300571891040,,,Other,2059
62624756d8beac1599c626e2,50200035187206,1854.02,60ec419255c00300382671a5,HDFC,Loan-in,5eecc6d6449e4f7cfb1c2708,2022-02-11T00:00:00.000Z,SWEEP-IN CREDIT - 50300571891040,,,self_transfer,494383
62624756d8beac1599c626e4,50200035187206,-498145.98,60ec419255c00300382671a5,HDFC,Internal Transfers,5eecc6d6449e4f7cfb1c2708,2022-02-13T00:00:00.000Z,IB FUNDS TRANSFER DR-50200023535069 -SL ICK ORGANICS PVT LTD,insurance,,net_banking_transfer,-500000
62624756d8beac1599c626e6,50200035187206,1940.42,60ec419255c00300382671a5,HDFC,direct expenses,5eecc6d6449e4f7cfb1c2708,2022-02-14T00:00:00.000Z,TDS RECOVERED ON-50300571891040,,,Other,-215.6
62624756d8beac1599c626e8,50200035187206,2156.02,60ec419255c00300382671a5,HDFC,Transfer in/Revenue-other,5eecc6d6449e4f7cfb1c2708,2022-02-14T00:00:00.000Z,INT. ON SWCR ON-50300571891040,,,Other,2156
62624756d8beac1599c626ea,50200035187206,0.02,60ec419255c00300382671a5,HDFC,Loan-in,5eecc6d6449e4f7cfb1c2708,2022-02-14T00:00:00.000Z,SWEEP-IN CREDIT - 50300571891040,,,self_transfer,498146
62624756d8beac1599c626ec,50200035187206,-498059.58,60ec419255c00300382671a5,HDFC,Internal Transfers,5eecc6d6449e4f7cfb1c2708,2022-02-17T00:00:00.000Z,IB FUNDS TRANSFER DR-50200023535069 -SL ICK ORGANICS PVT LTD,insurance,,net_banking_transfer,-500000
62624756d8beac1599c626ee,50200035187206,-498286.08,60ec419255c00300382671a5,HDFC,direct expenses,5eecc6d6449e4f7cfb1c2708,2022-02-18T00:00:00.000Z,TDS RECOVERED ON-50300571891040,,,Other,-226.5
62624756d8beac1599c626f0,50200035187206,-496021.08,60ec419255c00300382671a5,HDFC,Transfer in/Revenue-other,5eecc6d6449e4f7cfb1c2708,2022-02-18T00:00:00.000Z,INT. ON SWCR ON-50300571891040,,,Other,2265
62624756d8beac1599c626f2,50200035187206,2038.92,60ec419255c00300382671a5,HDFC,Loan-in,5eecc6d6449e4f7cfb1c2708,2022-02-18T00:00:00.000Z,SWEEP-IN CREDIT - 50300571891040,,,self_transfer,498060
62624756d8beac1599c626f4,50200035187206,-497961.08,60ec419255c00300382671a5,HDFC,Internal Transfers,5eecc6d6449e4f7cfb1c2708,2022-02-18T00:00:00.000Z,IB FUNDS TRANSFER DR-50200023535069 -SL ICK ORGANICS PVT LTD,insurance,,net_banking_transfer,-500000
62624756d8beac1599c626f6,50200035187206,-498190.28,60ec419255c00300382671a5,HDFC,direct expenses,5eecc6d6449e4f7cfb1c2708,2022-02-19T00:00:00.000Z,TDS RECOVERED ON-50300571891040,,,Other,-229.2
62624756d8beac1599c626f8,50200035187206,-495898.28,60ec419255c00300382671a5,HDFC,Transfer in/Revenue-other,5eecc6d6449e4f7cfb1c2708,2022-02-19T00:00:00.000Z,INT. ON SWCR ON-50300571891040,,,Other,2292
62624756d8beac1599c626fa,50200035187206,2063.72,60ec419255c00300382671a5,HDFC,Loan-in,5eecc6d6449e4f7cfb1c2708,2022-02-19T00:00:00.000Z,SWEEP-IN CREDIT - 50300571891040,,,self_transfer,497962
62624756d8beac1599c626fc,50200035187206,-497936.28,60ec419255c00300382671a5,HDFC,Internal Transfers,5eecc6d6449e4f7cfb1c2708,2022-02-21T00:00:00.000Z,IB FUNDS TRANSFER DR-50200023535069 -SL ICK ORGANICS PVT LTD,insurance,,net_banking_transfer,-500000
62624756d8beac1599c626fe,50200035187206,-1497936.28,60ec419255c00300382671a5,HDFC,Internal Transfers,5eecc6d6449e4f7cfb1c2708,2022-02-21T00:00:00.000Z,IB FUNDS TRANSFER DR-50200023535069 -SL ICK ORGANICS PVT LTD,insurance,,net_banking_transfer,-1000000
62624756d8beac1599c62700,50200035187206,8521473.52,60ec419255c00300382671a5,HDFC,Investments-New,5eecc6d6449e4f7cfb1c2708,2022-02-21T00:00:00.000Z,FT-57500000115294-AL TRUST,,,Other,10019409.8
62624756d8beac1599c62702,50200035187206,18518911.52,60ec419255c00300382671a5,HDFC,Transfer in/Revenue-other,5eecc6d6449e4f7cfb1c2708,2022-02-22T00:00:00.000Z,FT - CR - 05421050007790 - NIKHIL KISHOR E VORA,,,Other,9997438
62624756d8beac1599c62704,50200035187206,18503866.32,60ec419255c00300382671a5,HDFC,direct expenses,5eecc6d6449e4f7cfb1c2708,2022-02-26T00:00:00.000Z,TAX RECOVERY FOR TD A/C 50300571891040 : DEPOSIT NO.1 50300571891040,,,Other,-15045.2
62624756d8beac1599c62706,50200035187206,18654318.32,60ec419255c00300382671a5,HDFC,interest income,5eecc6d6449e4f7cfb1c2708,2022-02-26T00:00:00.000Z,QUARTERLY INTEREST CREDIT 50300571891040,,,Other,150452
62624756d8beac1599c62708,50200035187206,17699999.32,60ec419255c00300382671a5,HDFC,Internal Transfers,5eecc6d6449e4f7cfb1c2708,2022-03-02T00:00:00.000Z,IB FUNDS TRANSFER DR-50200023535069 -SL ICK ORGANICS PVT LTD,insurance,,net_banking_transfer,-954319
62624756d8beac1599c6270a,50200035187206,17400000.32,60ec419255c00300382671a5,HDFC,Internal Transfers,5eecc6d6449e4f7cfb1c2708,2022-03-02T00:00:00.000Z,IB FUNDS TRANSFER DR-50200023535069 -SL ICK ORGANICS PVT LTD,insurance,,net_banking_transfer,-299999
62624756d8beac1599c6270c,50200035187206,17000000.32,60ec419255c00300382671a5,HDFC,Internal Transfers,5eecc6d6449e4f7cfb1c2708,2022-03-02T00:00:00.000Z,IB FUNDS TRANSFER DR-50200023535069 -SL ICK ORGANICS PVT LTD,insurance,,net_banking_transfer,-400000
62624756d8beac1599c6270e,50200035187206,9000000.32,60ec419255c00300382671a5,HDFC,direct expenses,5eecc6d6449e4f7cfb1c2708,2022-03-02T00:00:00.000Z,FD BOOKED - 50300599981225 : SLICK ORGAN ICS PVT LTD,insurance,,investment,-8000000
62624756d8beac1599c62710,50200035187206,2000000.32,60ec419255c00300382671a5,HDFC,direct expenses,5eecc6d6449e4f7cfb1c2708,2022-03-02T00:00:00.000Z,FD BOOKED - 50300599982076 : SLICK ORGAN ICS PVT LTD,insurance,,investment,-7000000
62624756d8beac1599c62712,50200035187206,100000.32,60ec419255c00300382671a5,HDFC,Internal Transfers,5eecc6d6449e4f7cfb1c2708,2022-03-06T00:00:00.000Z,IB FUNDS TRANSFER DR-50200023535069 -SL ICK ORGANICS PVT LTD,insurance,,net_banking_transfer,-1900000
62624756d8beac1599c62714,50200035187206,0.32,60ec419255c00300382671a5,HDFC,Internal Transfers,5eecc6d6449e4f7cfb1c2708,2022-03-08T00:00:00.000Z,IB FUNDS TRANSFER DR-50200023535069 -SL ICK ORGANICS PVT LTD,insurance,,net_banking_transfer,-100000
62624756d8beac1599c62716,50200035187206,-1299999.68,60ec419255c00300382671a5,HDFC,Internal Transfers,5eecc6d6449e4f7cfb1c2708,2022-03-08T00:00:00.000Z,IB FUNDS TRANSFER DR-50200023535069 -SL ICK ORGANICS PVT LTD,insurance,,net_banking_transfer,-1300000
62624756d8beac1599c62718,50200035187206,0.32,60ec419255c00300382671a5,HDFC,Loan-in,5eecc6d6449e4f7cfb1c2708,2022-03-09T00:00:00.000Z,SWEEP-IN CREDIT - 50300599981225,,,self_transfer,1300000
62624756d8beac1599c6271a,50200035187206,-999999.68,60ec419255c00300382671a5,HDFC,Internal Transfers,5eecc6d6449e4f7cfb1c2708,2022-03-09T00:00:00.000Z,IB FUNDS TRANSFER DR-50200023535069 -SL ICK ORGANICS PVT LTD,insurance,,net_banking_transfer,-1000000
62624756d8beac1599c6271c,50200035187206,-1000028.48,60ec419255c00300382671a5,HDFC,direct expenses,5eecc6d6449e4f7cfb1c2708,2022-03-10T00:00:00.000Z,TDS RECOVERED ON-50300599981225,,,Other,-28.8
62624756d8beac1599c6271e,50200035187206,259.52,60ec419255c00300382671a5,HDFC,Transfer in/Revenue-other,5eecc6d6449e4f7cfb1c2708,2022-03-10T00:00:00.000Z,INT. ON SWCR ON-50300599981225,,,Other,288
62624756d8beac1599c62720,50200035187206,-28.48,60ec419255c00300382671a5,HDFC,Loan-in,5eecc6d6449e4f7cfb1c2708,2022-03-10T00:00:00.000Z,SWEEP-IN CREDIT - 50300599981225,,,self_transfer,1000000
62624756d8beac1599c62722,50200035187206,-999740.48,60ec419255c00300382671a5,HDFC,Internal Transfers,5eecc6d6449e4f7cfb1c2708,2022-03-13T00:00:00.000Z,IB FUNDS TRANSFER DR-50200023535069 -SL ICK ORGANICS PVT LTD,insurance,,net_banking_transfer,-1000000
62624756d8beac1599c62724,50200035187206,-999785.68,60ec419255c00300382671a5,HDFC,direct expenses,5eecc6d6449e4f7cfb1c2708,2022-03-14T00:00:00.000Z,TDS RECOVERED ON-50300599981225,,,Other,-45.2
62624756d8beac1599c62726,50200035187206,407.32,60ec419255c00300382671a5,HDFC,Transfer in/Revenue-other,5eecc6d6449e4f7cfb1c2708,2022-03-14T00:00:00.000Z,INT. ON SWCR ON-50300599981225,,,Other,452
62624756d8beac1599c62728,50200035187206,-44.68,60ec419255c00300382671a5,HDFC,Loan-in,5eecc6d6449e4f7cfb1c2708,2022-03-14T00:00:00.000Z,SWEEP-IN CREDIT - 50300599981225,,,self_transfer,999741
62624756d8beac1599c6272a,50200035187206,-999592.68,60ec419255c00300382671a5,HDFC,Internal Transfers,5eecc6d6449e4f7cfb1c2708,2022-03-20T00:00:00.000Z,IB FUNDS TRANSFER DR-50200023535069 -SL ICK ORGANICS PVT LTD,insurance,,net_banking_transfer,-1000000
62624756d8beac1599c6272c,50200035187206,-1299592.68,60ec419255c00300382671a5,HDFC,Internal Transfers,5eecc6d6449e4f7cfb1c2708,2022-03-20T00:00:00.000Z,IB FUNDS TRANSFER DR-50200023535069 -SL ICK ORGANICS PVT LTD,insurance,,net_banking_transfer,-300000
62624756d8beac1599c6272e,50200035187206,-299334.58,60ec419255c00300382671a5,HDFC,direct expenses,5eecc6d6449e4f7cfb1c2708,2022-03-21T00:00:00.000Z,TDS RECOVERED ON-50300599981225,,,Other,-73.9
62624757d8beac1599c62730,50200035187206,-299260.68,60ec419255c00300382671a5,HDFC,Transfer in/Revenue-other,5eecc6d6449e4f7cfb1c2708,2022-03-21T00:00:00.000Z,INT. ON SWCR ON-50300599981225,,,Other,739
62624757d8beac1599c62732,50200035187206,-299999.68,60ec419255c00300382671a5,HDFC,Loan-in,5eecc6d6449e4f7cfb1c2708,2022-03-21T00:00:00.000Z,SWEEP-IN CREDIT - 50300599981225,,,self_transfer,999593
62624757d8beac1599c62734,50200035187206,-21.68,60ec419255c00300382671a5,HDFC,direct expenses,5eecc6d6449e4f7cfb1c2708,2022-03-21T00:00:00.000Z,TDS RECOVERED ON-50300599981225,,,Other,-22.1
62624757d8beac1599c62736,50200035187206,199.32,60ec419255c00300382671a5,HDFC,Transfer in/Revenue-other,5eecc6d6449e4f7cfb1c2708,2022-03-21T00:00:00.000Z,INT. ON SWCR ON-50300599981225,,,Other,221
62624757d8beac1599c62738,50200035187206,0.42,60ec419255c00300382671a5,HDFC,Loan-in,5eecc6d6449e4f7cfb1c2708,2022-03-21T00:00:00.000Z,SWEEP-IN CREDIT - 50300599981225,,,self_transfer,299335
62624757d8beac1599c6273a,50200035187206,199.22,60ec419255c00300382671a5,HDFC,direct expenses,5eecc6d6449e4f7cfb1c2708,2022-03-23T00:00:00.000Z,TAX RECOVERY FOR TD A/C 50300462137427 : DEPOSIT NO.1 50300462137427,,,Other,-0.1
62624757d8beac1599c6273c,50200035187206,200.22,60ec419255c00300382671a5,HDFC,interest income,5eecc6d6449e4f7cfb1c2708,2022-03-23T00:00:00.000Z,QUARTERLY INTEREST CREDIT 50300462137427,,,Other,1
62624757d8beac1599c6273e,50200035187206,-999799.78,60ec419255c00300382671a5,HDFC,Internal Transfers,5eecc6d6449e4f7cfb1c2708,2022-03-25T00:00:00.000Z,IB FUNDS TRANSFER DR-50200023535069 -SL ICK ORGANICS PVT LTD,insurance,,net_banking_transfer,-1000000
62624757d8beac1599c62740,50200035187206,-94.28,60ec419255c00300382671a5,HDFC,direct expenses,5eecc6d6449e4f7cfb1c2708,2022-03-26T00:00:00.000Z,TDS RECOVERED ON-50300599981225,,,Other,-94.5
62624757d8beac1599c62742,50200035187206,850.72,60ec419255c00300382671a5,HDFC,Transfer in/Revenue-other,5eecc6d6449e4f7cfb1c2708,2022-03-26T00:00:00.000Z,INT. ON SWCR ON-50300599981225,,,Other,945
62624757d8beac1599c62744,50200035187206,0.22,60ec419255c00300382671a5,HDFC,Loan-in,5eecc6d6449e4f7cfb1c2708,2022-03-26T00:00:00.000Z,SWEEP-IN CREDIT - 50300599981225,,,self_transfer,999800
62624757d8beac1599c62746,50200035187206,-499149.28,60ec419255c00300382671a5,HDFC,Internal Transfers,5eecc6d6449e4f7cfb1c2708,2022-03-30T00:00:00.000Z,IB FUNDS TRANSFER DR-50200023535069 -SL ICK ORGANICS PVT LTD,insurance,,net_banking_transfer,-500000
62624757d8beac1599c62748,50200035187206,-499206.68,60ec419255c00300382671a5,HDFC,direct expenses,5eecc6d6449e4f7cfb1c2708,2022-03-31T00:00:00.000Z,TDS RECOVERED ON-50300599981225,,,Other,-57.4
62624757d8beac1599c6274a,50200035187206,517.32,60ec419255c00300382671a5,HDFC,Transfer in/Revenue-other,5eecc6d6449e4f7cfb1c2708,2022-03-31T00:00:00.000Z,INT. ON SWCR ON-50300599981225,,,Other,574
62624757d8beac1599c6274c,50200035187206,-56.68,60ec419255c00300382671a5,HDFC,Loan-in,5eecc6d6449e4f7cfb1c2708,2022-03-31T00:00:00.000Z,SWEEP-IN CREDIT - 50300599981225,,,self_transfer,499150
62624757d8beac1599c6274e,50200035187206,-499482.68,60ec419255c00300382671a5,HDFC,Internal Transfers,5eecc6d6449e4f7cfb1c2708,2022-03-31T00:00:00.000Z,IB FUNDS TRANSFER DR-50200023535069 -SL,,,net_banking_transfer,-500000
62624757d8beac1599c62750,50200035187206,-59.18,60ec419255c00300382671a5,HDFC,direct expenses,5eecc6d6449e4f7cfb1c2708,2022-04-01T00:00:00.000Z,TDS RECOVERED ON-50300599981225,,,Other,-59.5
62624757d8beac1599c62752,50200035187206,535.82,60ec419255c00300382671a5,HDFC,Transfer in/Revenue-other,5eecc6d6449e4f7cfb1c2708,2022-04-01T00:00:00.000Z,INT. ON SWCR ON-50300599981225,,,Other,595
62624757d8beac1599c62754,50200035187206,0.32,60ec419255c00300382671a5,HDFC,Loan-in,5eecc6d6449e4f7cfb1c2708,2022-04-01T00:00:00.000Z,SWEEP-IN CREDIT - 50300599981225,,,self_transfer,499483
62624757d8beac1599c62756,50200035187206,0,60ec419255c00300382671a5,HDFC,direct expenses,5eecc6d6449e4f7cfb1c2708,2022-04-01T00:00:00.000Z,TAX RECOVERY FOR TD A/C 50300571891040,,,Other,-535.82
6262478cd8beac1599c6554b,50200050976833,67288.36,60ec41a455c0030038267236,HDFC,Revenue-PG-non-split,5eecc6d6449e4f7cfb1c2708,2021-08-17T00:00:00.000Z,NEFT CR-CITI0100000-PAYPAL PAYMENTS PL-O PGSP COLL AC-SLICK ORGANICS PRIVATE LIMI TED-CITIN21221250074,insurance,,net_banking_transfer,11123.03
6262478cd8beac1599c65550,50200050976833,10470.45,60ec41a455c0030038267236,HDFC,Internal Transfers,5eecc6d6449e4f7cfb1c2708,2021-10-07T00:00:00.000Z,IB FUNDS TRANSFER DR-50200023535069 -SL ICK ORGANICS PVT LTD,insurance,,net_banking_transfer,-40000
6262478cd8beac1599c65552,50200050976833,13311.53,60ec41a455c0030038267236,HDFC,Revenue-PG-non-split,5eecc6d6449e4f7cfb1c2708,2021-10-25T00:00:00.000Z,NEFT CR-CITI0100000-PAYPAL PAYMENTS PL-O PGSP COLL AC-SLICK ORGANICS PRIVATE LIMI TED-CITIN21258612079,insurance,,net_banking_transfer,2841.08
6262478cd8beac1599c65557,50200050976833,9662.03,60ec41a455c0030038267236,HDFC,Revenue-PG-non-split,5eecc6d6449e4f7cfb1c2708,2022-01-31T00:00:00.000Z,NEFT CR-CITI0100000-PAYPAL PAYMENTS PL-O PGSP COLL AC-SLICK ORGANICS PRIVATE LIMI TED-CITIN22216362588,insurance,,net_banking_transfer,2855.01
6262478cd8beac1599c65559,50200050976833,23322.58,60ec41a455c0030038267236,HDFC,Revenue-PG-non-split,5eecc6d6449e4f7cfb1c2708,2022-02-14T00:00:00.000Z,NEFT CR-CITI0100000-PAYPAL PAYMENTS PL-O PGSP COLL AC-SLICK ORGANICS PRIVATE LIMI TED-CITIN22224197605,insurance,,net_banking_transfer,13660.55
6262478cd8beac1599c6555b,50200050976833,26522.34,60ec41a455c0030038267236,HDFC,Revenue-PG-non-split,5eecc6d6449e4f7cfb1c2708,2022-03-02T00:00:00.000Z,NEFT CR-CITI0100000-PAYPAL PAYMENTS PL-O PGSP COLL AC-SLICK ORGANICS PRIVATE LIMI TED-CITIN22234290385,insurance,,net_banking_transfer,3199.76
6262478cd8beac1599c6555d,50200050976833,30871.9,60ec41a455c0030038267236,HDFC,Revenue-PG-non-split,5eecc6d6449e4f7cfb1c2708,2022-03-24T00:00:00.000Z,NEFT CR-CITI0100000-PAYPAL PAYMENTS PL-O,,,net_banking_transfer,4349.56
626247d4d8beac1599c6941b,50200023535069,1634033,60ec41ba55c00300382672d9,HDFC,Transfer in/Revenue-other,5eecc6d6449e4f7cfb1c2708,2021-08-01T00:00:00.000Z,IMPS-121305643089-NA-HDFC-XXXXXXXXXX0007 -ALL20210801216820000330830668628,,,net_banking_transfer,16251.68
626247d4d8beac1599c6941d,50200023535069,1631874.12,60ec41ba55c00300382672d9,HDFC,direct expenses,5eecc6d6449e4f7cfb1c2708,2021-08-01T00:00:00.000Z,POS 514834XXXXXX9486 SEOPTIMER,,,debit_card,-2158.88
626247d4d8beac1599c6941f,50200023535069,1659270.95,60ec41ba55c00300382672d9,HDFC,Transfer in/Revenue-other,5eecc6d6449e4f7cfb1c2708,2021-08-02T00:00:00.000Z,IMPS-121405658831-NA-HDFC-XXXXXXXXXX0007 -ALL20210802216820000330830668628,,,net_banking_transfer,27396.83
626247d4d8beac1599c69421,50200023535069,1659547.48,60ec41ba55c00300382672d9,HDFC,Revenue-Mktplace,5eecc6d6449e4f7cfb1c2708,2021-08-02T00:00:00.000Z,NEFT CR-DEUT0797BGL-FLIPKART INTERNET PR IVATE LIMITED-SLICK ORGANICS PVT LTD-121 400074GN00139,shopping,,net_banking_transfer,276.53
626247d4d8beac1599c69423,50200023535069,1662709.51,60ec41ba55c00300382672d9,HDFC,Revenue-Mktplace,5eecc6d6449e4f7cfb1c2708,2021-08-02T00:00:00.000Z,NEFT CR-DEUT0797BGL-FLIPKART INTERNET PR IVATE LIMITED-SLICK ORGANICS PVT LTD-121 400093GN00051,shopping,,net_banking_transfer,3162.03
626247d4d8beac1599c69425,50200023535069,1678272.19,60ec41ba55c00300382672d9,HDFC,Revenue-Mktplace,5eecc6d6449e4f7cfb1c2708,2021-08-02T00:00:00.000Z,NEFT CR-DEUT0797BGL-MYNTRA DESIGNS PRIVA TE LIMITED-SLICK ORGANICS PRIVATE LIMITE D-121400185GN00266,shopping,,net_banking_transfer,15562.68
626247d4d8beac1599c69427,50200023535069,1706196.97,60ec41ba55c00300382672d9,HDFC,Revenue-PG-split enabled,5eecc6d6449e4f7cfb1c2708,2021-08-02T00:00:00.000Z,NEFT CR-UTIB0001506-RAZORPAY SOFTWARE PR IVATE LIMITED-SLICK ORGANICS PVT LITD-AX ISCN0086893614,insurance,,net_banking_transfer,27924.78
626247d4d8beac1599c69429,50200023535069,446196.97,60ec41ba55c00300382672d9,HDFC,SAAS/tech expense,5eecc6d6449e4f7cfb1c2708,2021-08-02T00:00:00.000Z,WHDF0161806786/BILLDKAMAZONSELLERSE,shopping,,Other,-1260000
626247d4d8beac1599c6942c,50200023535069,1446196.97,60ec41ba55c00300382672d9,HDFC,Internal Transfers,5eecc6d6449e4f7cfb1c2708,2021-08-02T00:00:00.000Z,IB FUNDS TRANSFER CR-50200035187206 -SL ICK ORGANICS PVT LTD,insurance,,Other,1000000
626247d4d8beac1599c6942e,50200023535069,1450072.99,60ec41ba55c00300382672d9,HDFC,Revenue-Mktplace,5eecc6d6449e4f7cfb1c2708,2021-08-02T00:00:00.000Z,NEFT CR-DEUT0797BGL-MYNTRA DESIGNS PRIVA TE LIMITED-SLICK ORGANICS PRIVATE LIMITE D-121400186GN00087,shopping,,net_banking_transfer,3876.02
626247d4d8beac1599c69430,50200023535069,555072.99,60ec41ba55c00300382672d9,HDFC,direct expenses,5eecc6d6449e4f7cfb1c2708,2021-08-02T00:00:00.000Z,"NEFT DR-YESB0000551-VISTTA COSMETICS-NET BANK, MUM-N214211586048416-895000",,,net_banking_transfer,-895000
626247d4d8beac1599c69432,50200023535069,330072.99,60ec41ba55c00300382672d9,HDFC,direct expenses,5eecc6d6449e4f7cfb1c2708,2021-08-02T00:00:00.000Z,02711930004579-TPT-225000-DHRUV BHASIN,,,net_banking_transfer,-225000
626247d4d8beac1599c69434,50200023535069,105072.99,60ec41ba55c00300382672d9,HDFC,direct expenses,5eecc6d6449e4f7cfb1c2708,2021-08-02T00:00:00.000Z,"NEFT DR-SCBL0036025-DHRUV MADHOK-NETBANK , MUM-N214211586078500-225000",,,net_banking_transfer,-225000
626247d4d8beac1599c69436,50200023535069,107112.24,60ec41ba55c00300382672d9,HDFC,Revenue-PG-non-split,5eecc6d6449e4f7cfb1c2708,2021-08-02T00:00:00.000Z,NEFT CR-IDFB0010204-SEZZLE PAYMENTS PRIV,,,net_banking_transfer,2039.25
626247d4d8beac1599c69438,50200023535069,120604.25,60ec41ba55c00300382672d9,HDFC,Revenue-PG-split enabled,5eecc6d6449e4f7cfb1c2708,2021-08-02T00:00:00.000Z,NEFT CR-UTIB0001506-RAZORPAY SOFTWARE PR IVATE LIMITED-SLICK ORGANICS PVT LITD-AX ISCN0087000865,insurance,,net_banking_transfer,13492.01
626247d4d8beac1599c6943a,50200023535069,102485.25,60ec41ba55c00300382672d9,HDFC,direct expenses,5eecc6d6449e4f7cfb1c2708,2021-08-02T00:00:00.000Z,"NEFT DR-UTIB0000514-NATS ASSOCIATES-NETB ANK, MUM-N214211586418585-18119",,,net_banking_transfer,-18119
626247d4d8beac1599c6943c,50200023535069,-197514.75,60ec41ba55c00300382672d9,HDFC,direct expenses,5eecc6d6449e4f7cfb1c2708,2021-08-02T00:00:00.000Z,I/W CHQ RETURN-INWAR-CAVALIER LOGISTICS,,,Other,-300000
626247d4d8beac1599c6943e,50200023535069,102485.25,60ec41ba55c00300382672d9,HDFC,Adjustments/Reversal,5eecc6d6449e4f7cfb1c2708,2021-08-02T00:00:00.000Z,I/W CHQ RETURN-INWARD TRANSFER 1-NOIDA W,,,inward_cheque_bounce,300000
626247d4d8beac1599c69440,50200023535069,121011.14,60ec41ba55c00300382672d9,HDFC,Transfer in/Revenue-other,5eecc6d6449e4f7cfb1c2708,2021-08-03T00:00:00.000Z,IMPS-121505820337-NA-HDFC-XXXXXXXXXX0007 -ALL20210803216820000330830668628,,,net_banking_transfer,18525.89
626247d4d8beac1599c69442,50200023535069,263539.32,60ec41ba55c00300382672d9,HDFC,Revenue-Mktplace,5eecc6d6449e4f7cfb1c2708,2021-08-03T00:00:00.000Z,IMPS-121505352891-AMAZON SELLER SERVIC-H DFC-XXXXXXXX6004-LOYBLNOSPCJONSUOSLICK O RGANICS PVT LTD,shopping,,net_banking_transfer,142528.18
626247d4d8beac1599c69444,50200023535069,731830.84,60ec41ba55c00300382672d9,HDFC,Revenue-Mktplace,5eecc6d6449e4f7cfb1c2708,2021-08-03T00:00:00.000Z,NEFT CR-DEUT0797BGL-AMAZON PAY (INDIA) P RIVATE LIMITED-SLICK ORGANICS PVT LTD-12 1500059GN05327,shopping,,net_banking_transfer,468291.52
626247d4d8beac1599c69446,50200023535069,733194.52,60ec41ba55c00300382672d9,HDFC,Transfer in/Revenue-other,5eecc6d6449e4f7cfb1c2708,2021-08-03T00:00:00.000Z,50200050675669-TPT-REMITTANCE OG JULY21- HOUZ OF NATURE PVT LTD,,,net_banking_transfer,1363.68
626247d4d8beac1599c69448,50200023535069,739326.16,60ec41ba55c00300382672d9,HDFC,Revenue-PG-split enabled,5eecc6d6449e4f7cfb1c2708,2021-08-03T00:00:00.000Z,NEFT CR-UTIB0001506-RAZORPAY SOFTWARE PR IVATE LIMITED-SLICK ORGANICS PVT LITD-AX ISCN0087041685,insurance,,net_banking_transfer,6131.64
626247d4d8beac1599c6944a,50200023535069,2739326.16,60ec41ba55c00300382672d9,HDFC,Internal Transfers,5eecc6d6449e4f7cfb1c2708,2021-08-03T00:00:00.000Z,IB FUNDS TRANSFER CR-50200035187206 -SL ICK ORGANICS PVT LTD,insurance,,Other,2000000
626247d4d8beac1599c6944c,50200023535069,739326.16,60ec41ba55c00300382672d9,HDFC,direct expenses,5eecc6d6449e4f7cfb1c2708,2021-08-03T00:00:00.000Z,"NEFT DR-PYTM0123456-PAYTM-NETBANK, MUM-N 215211587281991-2000000",ewallet,,net_banking_transfer,-2000000
626247d4d8beac1599c6944e,50200023535069,465450.16,60ec41ba55c00300382672d9,HDFC,OD/CC Repayment,5eecc6d6449e4f7cfb1c2708,2021-08-03T00:00:00.000Z,02711600008220-TPT-CREDIT CARD-VARUN SIN GH,bills,credit_card_bill,bill_payment,-273876
626247d4d8beac1599c69450,50200023535069,165450.16,60ec41ba55c00300382672d9,HDFC,direct expenses,5eecc6d6449e4f7cfb1c2708,2021-08-03T00:00:00.000Z,"NEFT DR-PYTM0123456-PAYTM-NETBANK, MUM-N 215211587322782-300000",ewallet,,net_banking_transfer,-300000
626247d4d8beac1599c69452,50200023535069,166855.6,60ec41ba55c00300382672d9,HDFC,Transfer in/Revenue-other,5eecc6d6449e4f7cfb1c2708,2021-08-03T00:00:00.000Z,FT - C74841030821130521 - - 50200050045 240 - ZOOBOP ME WORKS PRIVATE LIMITED,,,Other,1405.44
626247d4d8beac1599c69456,50200023535069,169435.36,60ec41ba55c00300382672d9,HDFC,Transfer in/Revenue-other,5eecc6d6449e4f7cfb1c2708,2021-08-03T00:00:00.000Z,ZOOBOP ME WORK-ARATA,,,Other,2579.76
626247d4d8beac1599c69458,50200023535069,119435.36,60ec41ba55c00300382672d9,HDFC,Marketing Expense,5eecc6d6449e4f7cfb1c2708,2021-08-03T00:00:00.000Z,POS 514834XXXXXX9486 GOOGLE ADS,,,debit_card,-50000
626247d4d8beac1599c6945a,50200023535069,124379.7,60ec41ba55c00300382672d9,HDFC,Revenue-PG-non-split,5eecc6d6449e4f7cfb1c2708,2021-08-03T00:00:00.000Z,NEFT CR-IDFB0010204-SEZZLE PAYMENTS PRIV ATE LIMITED-SLICK ORGANICS PRIVATE LIMIT ED-IDFBH21215208791,insurance,,net_banking_transfer,4944.34
626247d4d8beac1599c6945c,50200023535069,141929.1,60ec41ba55c00300382672d9,HDFC,Revenue-PG-split enabled,5eecc6d6449e4f7cfb1c2708,2021-08-03T00:00:00.000Z,NEFT CR-UTIB0001506-RAZORPAY SOFTWARE PR IVATE LIMITED-SLICK ORGANICS PVT LITD-AX ISCN0087118536,insurance,,net_banking_transfer,17549.4
626247d4d8beac1599c6945e,50200023535069,1141929.1,60ec41ba55c00300382672d9,HDFC,Internal Transfers,5eecc6d6449e4f7cfb1c2708,2021-08-03T00:00:00.000Z,IB FUNDS TRANSFER CR-50200035187206 -SL ICK ORGANICS PVT LTD,insurance,,Other,1000000
626247d4d8beac1599c69460,50200023535069,615663.1,60ec41ba55c00300382672d9,HDFC,direct expenses,5eecc6d6449e4f7cfb1c2708,2021-08-03T00:00:00.000Z,05892560000649-TPT-526266-DECORPAC INDIA PRIVATE LIMITED,,,net_banking_transfer,-526266
626247d4d8beac1599c69462,50200023535069,644569.23,60ec41ba55c00300382672d9,HDFC,Transfer in/Revenue-other,5eecc6d6449e4f7cfb1c2708,2021-08-04T00:00:00.000Z,IMPS-121605945595-NA-HDFC-XXXXXXXXXX0007 -ALL20210804216820000330830668628,,,net_banking_transfer,28906.13
626247d4d8beac1599c69464,50200023535069,1676573.45,60ec41ba55c00300382672d9,HDFC,Revenue-Mktplace,5eecc6d6449e4f7cfb1c2708,2021-08-04T00:00:00.000Z,NEFT CR-KKBK0000958-NYKAA E RETAIL PRIVA TE LIMITED NYKAA-SLICK ORGANICS PVT LTD- KKBK212165299428,insurance,,net_banking_transfer,1032004.22
626247d4d8beac1599c69466,50200023535069,1683354.57,60ec41ba55c00300382672d9,HDFC,Revenue-Mktplace,5eecc6d6449e4f7cfb1c2708,2021-08-04T00:00:00.000Z,NEFT CR-DEUT0797BGL-MYNTRA DESIGNS PRIVA TE LIMITED-SLICK ORGANICS PRIVATE LIMITE D-121600060GN00215,shopping,,net_banking_transfer,6781.12
626247d4d8beac1599c69468,50200023535069,1685457.51,60ec41ba55c00300382672d9,HDFC,Revenue-PG-split enabled,5eecc6d6449e4f7cfb1c2708,2021-08-04T00:00:00.000Z,NEFT CR-UTIB0001506-RAZORPAY SOFTWARE PR IVATE LIMITED-SLICK ORGANICS PVT LITD-AX ISCN0087166504,insurance,,net_banking_transfer,2102.94
626247d4d8beac1599c6946a,50200023535069,1691813.34,60ec41ba55c00300382672d9,HDFC,Revenue-Mktplace,5eecc6d6449e4f7cfb1c2708,2021-08-04T00:00:00.000Z,NEFT CR-DEUT0797BGL-FLIPKART INTERNET PR IVATE LIMITED-SLICK ORGANICS PVT LTD-121 600313GN00258,shopping,,net_banking_transfer,6355.83
626247d4d8beac1599c6946c,50200023535069,1695098.34,60ec41ba55c00300382672d9,HDFC,Revenue-Mktplace,5eecc6d6449e4f7cfb1c2708,2021-08-04T00:00:00.000Z,NEFT CR-DEUT0797BGL-MYNTRA DESIGNS PRIVA TE LIMITED-SLICK ORGANICS PRIVATE LIMITE D-121600059GN00040,shopping,,net_banking_transfer,3285
626247d4d8beac1599c6946e,50200023535069,1684138.94,60ec41ba55c00300382672d9,HDFC,direct expenses,5eecc6d6449e4f7cfb1c2708,2021-08-04T00:00:00.000Z,POS 514834XXXXXX9486 STK*SHUTTERSTOCK,,,debit_card,-10959.4
626247d4d8beac1599c69470,50200023535069,1360138.94,60ec41ba55c00300382672d9,HDFC,direct expenses,5eecc6d6449e4f7cfb1c2708,2021-08-04T00:00:00.000Z,"NEFT DR-UTIB0000514-NATS ASSOCIATES-NETB ANK, MUM-N216211588653517-324000",,,net_banking_transfer,-324000
626247d4d8beac1599c69472,50200023535069,1368094.51,60ec41ba55c00300382672d9,HDFC,Revenue-Mktplace,5eecc6d6449e4f7cfb1c2708,2021-08-04T00:00:00.000Z,NEFT CR-DEUT0797BGL-FLIPKART INTERNET PR,shopping,,net_banking_transfer,7955.57
626247d4d8beac1599c69474,50200023535069,1430745.05,60ec41ba55c00300382672d9,HDFC,Revenue-COD,5eecc6d6449e4f7cfb1c2708,2021-08-04T00:00:00.000Z,NEFT CR-ICIC0000155-SHIPROCKET COD CRF I D 2824268-SLICK ORGANICS PVT LTD-CMS2058 632898,insurance,,net_banking_transfer,62650.54
626247d4d8beac1599c69476,50200023535069,1330745.05,60ec41ba55c00300382672d9,HDFC,direct expenses,5eecc6d6449e4f7cfb1c2708,2021-08-04T00:00:00.000Z,"NEFT DR-PYTM0123456-PAYTM-NETBANK, MUM-N 216211588883135-100000",ewallet,,net_banking_transfer,-100000
626247d4d8beac1599c69478,50200023535069,1331232.86,60ec41ba55c00300382672d9,HDFC,Revenue-PG-non-split,5eecc6d6449e4f7cfb1c2708,2021-08-04T00:00:00.000Z,NEFT CR-IDFB0010204-SEZZLE PAYMENTS PRIV ATE LIMITED-SLICK ORGANICS PRIVATE LIMIT ED-IDFBH21216260295,insurance,,net_banking_transfer,487.81
626247d4d8beac1599c6947a,50200023535069,1348346.82,60ec41ba55c00300382672d9,HDFC,Revenue-PG-split enabled,5eecc6d6449e4f7cfb1c2708,2021-08-04T00:00:00.000Z,NEFT CR-UTIB0001506-RAZORPAY SOFTWARE PR IVATE LIMITED-SLICK ORGANICS PVT LITD-AX ISCN0087244495,insurance,,net_banking_transfer,17113.96
626247d4d8beac1599c6947c,50200023535069,1392100.82,60ec41ba55c00300382672d9,HDFC,Revenue-Mktplace,5eecc6d6449e4f7cfb1c2708,2021-08-04T00:00:00.000Z,NEFT CR-SCBL0036001-M/S DREAMPLUG TECHNO -SLICK ORGANICS PRIVATE LIMITEDSLICK-SIN 31436Q0017875,insurance,,net_banking_transfer,43754
626247d4d8beac1599c6947e,50200023535069,1192100.82,60ec41ba55c00300382672d9,HDFC,direct expenses,5eecc6d6449e4f7cfb1c2708,2021-08-04T00:00:00.000Z,"NEFT DR-KKBK0000180-VEDIC COSMECEUTICALS PVT LTD-NETBANK, MUM-N216211589300801-2 00000",,,net_banking_transfer,-200000
626247d4d8beac1599c69480,50200023535069,1211864.04,60ec41ba55c00300382672d9,HDFC,Transfer in/Revenue-other,5eecc6d6449e4f7cfb1c2708,2021-08-05T00:00:00.000Z,IMPS-121706123601-NA-HDFC-XXXXXXXXXX0007 -ALL20210805216820000330830668628,,,net_banking_transfer,19763.22
626247d4d8beac1599c69482,50200023535069,1213251.56,60ec41ba55c00300382672d9,HDFC,Revenue-PG-split enabled,5eecc6d6449e4f7cfb1c2708,2021-08-05T00:00:00.000Z,NEFT CR-UTIB0001506-RAZORPAY SOFTWARE PR IVATE LIMITED-SLICK ORGANICS PVT LITD-AX ISCN0087284813,insurance,,net_banking_transfer,1387.52
626247d4d8beac1599c69484,50200023535069,1214208.38,60ec41ba55c00300382672d9,HDFC,Revenue-Mktplace,5eecc6d6449e4f7cfb1c2708,2021-08-05T00:00:00.000Z,NEFT CR-DEUT0797BGL-MYNTRA DESIGNS PRIVA TE LIMITED-SLICK ORGANICS PRIVATE LIMITE D-121701268GN00123,shopping,,net_banking_transfer,956.82
626247d4d8beac1599c69486,50200023535069,1217016.83,60ec41ba55c00300382672d9,HDFC,Revenue-Mktplace,5eecc6d6449e4f7cfb1c2708,2021-08-05T00:00:00.000Z,NEFT CR-DEUT0797BGL-MYNTRA DESIGNS PRIVA TE LIMITED-SLICK ORGANICS PRIVATE LIMITE D-121701267GN00206,shopping,,net_banking_transfer,2808.45
626247d4d8beac1599c69488,50200023535069,1067016.83,60ec41ba55c00300382672d9,HDFC,direct expenses,5eecc6d6449e4f7cfb1c2708,2021-08-05T00:00:00.000Z,NEFT DR-SCBL0036031-PR PUNDIT PUBLIC REL,insurance,,net_banking_transfer,-150000
626247d4d8beac1599c6948a,50200023535069,867016.83,60ec41ba55c00300382672d9,HDFC,direct expenses,5eecc6d6449e4f7cfb1c2708,2021-08-05T00:00:00.000Z,IMPS-121713131194-PAYTM-PYTM-XXXXXXXX383 9-200000,ewallet,,net_banking_transfer,-200000
626247d4d8beac1599c6948c,50200023535069,867979.58,60ec41ba55c00300382672d9,HDFC,Revenue-PG-non-split,5eecc6d6449e4f7cfb1c2708,2021-08-05T00:00:00.000Z,NEFT CR-IDFB0010204-SEZZLE PAYMENTS PRIV ATE LIMITED-SLICK ORGANICS PRIVATE LIMIT ED-IDFBH21217333081,insurance,,net_banking_transfer,962.75
626247d4d8beac1599c6948e,50200023535069,885150.95,60ec41ba55c00300382672d9,HDFC,Revenue-PG-split enabled,5eecc6d6449e4f7cfb1c2708,2021-08-05T00:00:00.000Z,NEFT CR-UTIB0001506-RAZORPAY SOFTWARE PR IVATE LIMITED-SLICK ORGANICS PVT LITD-AX ISCN0087393194,insurance,,net_banking_transfer,17171.37
626247d4d8beac1599c69490,50200023535069,905287.33,60ec41ba55c00300382672d9,HDFC,Revenue-PG-non-split,5eecc6d6449e4f7cfb1c2708,2021-08-06T00:00:00.000Z,IMPS-121805218298-ONE97 COMMUNICATIONS-H DFC-XXXXXXXXXX0007-ALL202108062168200003 30830668628,ewallet,,net_banking_transfer,20136.38
626247d4d8beac1599c69492,50200023535069,910607.81,60ec41ba55c00300382672d9,HDFC,Revenue-Mktplace,5eecc6d6449e4f7cfb1c2708,2021-08-06T00:00:00.000Z,NEFT CR-DEUT0797BGL-FLIPKART INTERNET PR IVATE LIMITED-SLICK ORGANICS PVT LTD-121 800106GN00083,shopping,,net_banking_transfer,5320.48
626247d4d8beac1599c69494,50200023535069,926096.37,60ec41ba55c00300382672d9,HDFC,Revenue-PG-split enabled,5eecc6d6449e4f7cfb1c2708,2021-08-06T00:00:00.000Z,NEFT CR-UTIB0001506-RAZORPAY SOFTWARE PR IVATE LIMITED-SLICK ORGANICS PVT LITD-AX ISCN0087427660,insurance,,net_banking_transfer,15488.56
626247d5d8beac1599c69496,50200023535069,926418.9,60ec41ba55c00300382672d9,HDFC,Revenue-Mktplace,5eecc6d6449e4f7cfb1c2708,2021-08-06T00:00:00.000Z,NEFT CR-DEUT0797BGL-MYNTRA DESIGNS PRIVA TE LIMITED-SLICK ORGANICS PRIVATE LIMITE D-121800179GN00136,shopping,,net_banking_transfer,322.53
626247d5d8beac1599c69498,50200023535069,927535.54,60ec41ba55c00300382672d9,HDFC,Revenue-Mktplace,5eecc6d6449e4f7cfb1c2708,2021-08-06T00:00:00.000Z,NEFT CR-DEUT0797BGL-MYNTRA DESIGNS PRIVA TE LIMITED-SLICK ORGANICS PRIVATE LIMITE D-121800178GN00266,shopping,,net_banking_transfer,1116.64
626247d5d8beac1599c6949a,50200023535069,820535.54,60ec41ba55c00300382672d9,HDFC,direct expenses,5eecc6d6449e4f7cfb1c2708,2021-08-06T00:00:00.000Z,"NEFT DR-ICIC0000021-AKHILESH DIXIT-NETBA NK, MUM-N218211591461992-107000",,,net_banking_transfer,-107000
626247d5d8beac1599c6949c,50200023535069,806873.54,60ec41ba55c00300382672d9,HDFC,direct expenses,5eecc6d6449e4f7cfb1c2708,2021-08-06T00:00:00.000Z,"NEFT DR-SBIN0001859-PARSHOTAM AND ASSOCI ATES-NETBANK, MUM-N218211591592520-13662",,,net_banking_transfer,-13662
626247d5d8beac1599c6949e,50200023535069,793773.54,60ec41ba55c00300382672d9,HDFC,direct expenses,5eecc6d6449e4f7cfb1c2708,2021-08-06T00:00:00.000Z,"NEFT DR-ICIC0006956-LAKSHAY CARRYING COR PORATION-NETBANK, MUM-N218211591603317-1 3100",,,net_banking_transfer,-13100
626247d5d8beac1599c694a0,50200023535069,773773.54,60ec41ba55c00300382672d9,HDFC,direct expenses,5eecc6d6449e4f7cfb1c2708,2021-08-06T00:00:00.000Z,SARWAN KUMAR - CHQ PAID - DEVLI ROAD K,,,chq,-20000
626247d5d8beac1599c694a2,50200023535069,779949.13,60ec41ba55c00300382672d9,HDFC,Revenue-COD,5eecc6d6449e4f7cfb1c2708,2021-08-06T00:00:00.000Z,NEFT CR-ICIC0000155-SHIPROCKET COD CRF I D 2836476-SLICK ORGANICS PVT LTD-CMS2062 456378,insurance,,net_banking_transfer,6175.59
626247d5d8beac1599c694a5,50200023535069,782065.68,60ec41ba55c00300382672d9,HDFC,Revenue-Mktplace,5eecc6d6449e4f7cfb1c2708,2021-08-06T00:00:00.000Z,NEFT CR-DEUT0784BBY-TATA UNISTORE LTD-NO DAL-SLICK ORGANICS PVT LTD-121801693GN00 172,insurance,,net_banking_transfer,2116.55
626247d5d8beac1599c694a8,50200023535069,783623.86,60ec41ba55c00300382672d9,HDFC,Revenue-Mktplace,5eecc6d6449e4f7cfb1c2708,2021-08-06T00:00:00.000Z,NEFT CR-DEUT0784BBY-TATA UNISTORE LIMITE D-SLICK ORGANICS PVT LTD-121801682GN0012 3,insurance,,net_banking_transfer,1558.18
626247d5d8beac1599c694aa,50200023535069,791477.82,60ec41ba55c00300382672d9,HDFC,Revenue-Mktplace,5eecc6d6449e4f7cfb1c2708,2021-08-06T00:00:00.000Z,NEFT CR-DEUT0797BGL-FLIPKART INTERNET PR IVATE LIMITED-SLICK ORGANICS PVT LTD-121 800076GN00251,shopping,,net_banking_transfer,7853.96
626247d5d8beac1599c694ac,50200023535069,558477.82,60ec41ba55c00300382672d9,HDFC,direct expenses,5eecc6d6449e4f7cfb1c2708,2021-08-06T00:00:00.000Z,"NEFT DR-KKBK0000180-VEDIC COSMECEUTICALS PVT LTD-NETBANK, MUM-N218211591898732-2 33000",,,net_banking_transfer,-233000
626247d5d8beac1599c694ae,50200023535069,560008.54,60ec41ba55c00300382672d9,HDFC,Revenue-PG-non-split,5eecc6d6449e4f7cfb1c2708,2021-08-06T00:00:00.000Z,NEFT CR-IDFB0010204-SEZZLE PAYMENTS PRIV ATE LIMITED-SLICK ORGANICS PRIVATE LIMIT ED-IDFBH21218394264,insurance,,net_banking_transfer,1530.72
626247d5d8beac1599c694b0,50200023535069,588756.73,60ec41ba55c00300382672d9,HDFC,Revenue-PG-split enabled,5eecc6d6449e4f7cfb1c2708,2021-08-06T00:00:00.000Z,NEFT CR-UTIB0001506-RAZORPAY SOFTWARE PR IVATE LIMITED-SLICK ORGANICS PVT LITD-AX ISCN0087506335,insurance,,net_banking_transfer,28748.19
626247d5d8beac1599c694b2,50200023535069,622674.36,60ec41ba55c00300382672d9,HDFC,Revenue-PG-non-split,5eecc6d6449e4f7cfb1c2708,2021-08-07T00:00:00.000Z,IMPS-121905363695-ONE97 COMMUNICATIONS-H DFC-XXXXXXXXXX0007-ALL202108072168200003 30830668628,ewallet,,net_banking_transfer,33917.63
626247d5d8beac1599c694b4,50200023535069,579980.36,60ec41ba55c00300382672d9,HDFC,direct expenses,5eecc6d6449e4f7cfb1c2708,2021-08-07T00:00:00.000Z,CHQ PAID-MICR CTS-NO-UNITED INDIA INSURA,,,chq,-42694
626247d5d8beac1599c694b6,50200023535069,489400.36,60ec41ba55c00300382672d9,HDFC,direct expenses,5eecc6d6449e4f7cfb1c2708,2021-08-07T00:00:00.000Z,"NEFT DR-ICIC0000542-AVANTIKA SUKHIA-NETB ANK, MUM-N219211592959772-90580",,,net_banking_transfer,-90580
626247d5d8beac1599c694b8,50200023535069,439400.36,60ec41ba55c00300382672d9,HDFC,direct expenses,5eecc6d6449e4f7cfb1c2708,2021-08-07T00:00:00.000Z,"NEFT DR-UTIB0000120-ADNAN ALI-NETBANK, M UM-N219211592960053-50000",,,net_banking_transfer,-50000
626247d5d8beac1599c694bb,50200023535069,399400.36,60ec41ba55c00300382672d9,HDFC,direct expenses,5eecc6d6449e4f7cfb1c2708,2021-08-07T00:00:00.000Z,"NEFT DR-ICIC0003374-SIDDHARTH KANOJIA-NE TBANK, MUM-N219211592972441-40000",,,net_banking_transfer,-40000
626247d5d8beac1599c694be,50200023535069,378300.36,60ec41ba55c00300382672d9,HDFC,direct expenses,5eecc6d6449e4f7cfb1c2708,2021-08-07T00:00:00.000Z,NEFT DR-SIBL0000555-JAIVEER KUMAR-NETBAN,,,net_banking_transfer,-21100
626247d5d8beac1599c694c0,50200023535069,342300.36,60ec41ba55c00300382672d9,HDFC,direct expenses,5eecc6d6449e4f7cfb1c2708,2021-08-07T00:00:00.000Z,00901610080520-TPT-36000-POOJA KAPIL SHR OTRIYA,,,net_banking_transfer,-36000
626247d5d8beac1599c694c2,50200023535069,276300.36,60ec41ba55c00300382672d9,HDFC,direct expenses,5eecc6d6449e4f7cfb1c2708,2021-08-07T00:00:00.000Z,50100330586095-TPT-66000-DIWAKAR UNIYAL,,,net_banking_transfer,-66000
626247d5d8beac1599c694c4,50200023535069,241300.36,60ec41ba55c00300382672d9,HDFC,direct expenses,5eecc6d6449e4f7cfb1c2708,2021-08-07T00:00:00.000Z,50100064106714-TPT-35000-AKSHARANSH BHAT T,,,net_banking_transfer,-35000
626247d5d8beac1599c694c6,50200023535069,202800.36,60ec41ba55c00300382672d9,HDFC,direct expenses,5eecc6d6449e4f7cfb1c2708,2021-08-07T00:00:00.000Z,50100293329616-TPT-38500-SADIYA BANO,,,net_banking_transfer,-38500
626247d5d8beac1599c694c8,50200023535069,186920.36,60ec41ba55c00300382672d9,HDFC,direct expenses,5eecc6d6449e4f7cfb1c2708,2021-08-07T00:00:00.000Z,02711600008220-TPT-15880-VARUN SINGH,,,net_banking_transfer,-15880
626247d5d8beac1599c694ca,50200023535069,167070.36,60ec41ba55c00300382672d9,HDFC,direct expenses,5eecc6d6449e4f7cfb1c2708,2021-08-07T00:00:00.000Z,"NEFT DR-PUNB0307800-PRAKASH JHA-NETBANK, MUM-N219211592974828-19850",,,net_banking_transfer,-19850
626247d5d8beac1599c694cc,50200023535069,147220.36,60ec41ba55c00300382672d9,HDFC,direct expenses,5eecc6d6449e4f7cfb1c2708,2021-08-07T00:00:00.000Z,"NEFT DR-PUNB0482100-RAM BHAVAN YADAV-NET BANK, MUM-N219211592978882-19850",,,net_banking_transfer,-19850
626247d5d8beac1599c694ce,50200023535069,131340.36,60ec41ba55c00300382672d9,HDFC,direct expenses,5eecc6d6449e4f7cfb1c2708,2021-08-07T00:00:00.000Z,"NEFT DR-PUNB0151400-BHUWAN CHANDER JOSHI -NETBANK, MUM-N219211592979152-15880",,,net_banking_transfer,-15880
626247d5d8beac1599c694d0,50200023535069,128617.36,60ec41ba55c00300382672d9,HDFC,direct expenses,5eecc6d6449e4f7cfb1c2708,2021-08-07T00:00:00.000Z,"NEFT DR-UTIB0000120-ADNAN ALI-NETBANK, M UM-N219211593008776-2723",,,net_banking_transfer,-2723
626247d5d8beac1599c694d2,50200023535069,56617.36,60ec41ba55c00300382672d9,HDFC,direct expenses,5eecc6d6449e4f7cfb1c2708,2021-08-07T00:00:00.000Z,50100301160692-TPT-72000-TARUN GARG,,,net_banking_transfer,-72000
626247d5d8beac1599c694d4,50200023535069,56947.98,60ec41ba55c00300382672d9,HDFC,Revenue-PG-split enabled,5eecc6d6449e4f7cfb1c2708,2021-08-07T00:00:00.000Z,NEFT CR-UTIB0001506-RAZORPAY SOFTWARE PR IVATE LIMITED-SLICK ORGANICS PVT LITD-AX ISCN0087541224,insurance,,net_banking_transfer,330.62
626247d5d8beac1599c694d6,50200023535069,59219.98,60ec41ba55c00300382672d9,HDFC,Transfer in/Revenue-other,5eecc6d6449e4f7cfb1c2708,2021-08-07T00:00:00.000Z,NEFT CR-KKBK0000958-INNOVATIVE RETAIL CO NCEPTS PRIVATE LTD-SLICK ORGANICS PVT LT D-KKBK212196532835,,,net_banking_transfer,2272
626247d5d8beac1599c694d8,50200023535069,63285.33,60ec41ba55c00300382672d9,HDFC,Revenue-PG-non-split,5eecc6d6449e4f7cfb1c2708,2021-08-07T00:00:00.000Z,NEFT CR-IDFB0010204-SEZZLE PAYMENTS PRIV ATE LIMITED-SLICK ORGANICS PRIVATE LIMIT ED-IDFBH21219495526,insurance,,net_banking_transfer,4065.35
626247d5d8beac1599c694da,50200023535069,13285.33,60ec41ba55c00300382672d9,HDFC,Marketing Expense,5eecc6d6449e4f7cfb1c2708,2021-08-07T00:00:00.000Z,POS 514834XXXXXX9486 GOOGLE ADS,,,debit_card,-50000
626247d5d8beac1599c694dc,50200023535069,28335.06,60ec41ba55c00300382672d9,HDFC,Revenue-PG-split enabled,5eecc6d6449e4f7cfb1c2708,2021-08-07T00:00:00.000Z,NEFT CR-UTIB0001506-RAZORPAY SOFTWARE PR IVATE LIMITED-SLICK ORGANICS PVT LITD-AX ISCN0087601173,insurance,,net_banking_transfer,15049.73
626247d5d8beac1599c694de,50200023535069,46004.74,60ec41ba55c00300382672d9,HDFC,Revenue-PG-non-split,5eecc6d6449e4f7cfb1c2708,2021-08-08T00:00:00.000Z,IMPS-122005591751-ONE97 COMMUNICATIONS-H,ewallet,,net_banking_transfer,17669.68
626247d5d8beac1599c694e0,50200023535069,79615.76,60ec41ba55c00300382672d9,HDFC,Revenue-PG-non-split,5eecc6d6449e4f7cfb1c2708,2021-08-09T00:00:00.000Z,IMPS-122105625278-ONE97 COMMUNICATIONS-H DFC-XXXXXXXXXX0007-ALL202108092168200003 30830668628,ewallet,,net_banking_transfer,33611.02
626247d5d8beac1599c694e2,50200023535069,84264.51,60ec41ba55c00300382672d9,HDFC,Revenue-Mktplace,5eecc6d6449e4f7cfb1c2708,2021-08-09T00:00:00.000Z,NEFT CR-DEUT0797BGL-FLIPKART INTERNET PR IVATE LIMITED-SLICK ORGANICS PVT LTD-122 100097GN00070,shopping,,net_banking_transfer,4648.75
626247d5d8beac1599c694e4,50200023535069,90846.55,60ec41ba55c00300382672d9,HDFC,Revenue-Mktplace,5eecc6d6449e4f7cfb1c2708,2021-08-09T00:00:00.000Z,NEFT CR-DEUT0797BGL-MYNTRA DESIGNS PRIVA TE LIMITED-SLICK ORGANICS PRIVATE LIMITE D-122100165GN00030,shopping,,net_banking_transfer,6582.04
626247d5d8beac1599c694e6,50200023535069,91424.22,60ec41ba55c00300382672d9,HDFC,Revenue-Mktplace,5eecc6d6449e4f7cfb1c2708,2021-08-09T00:00:00.000Z,NEFT CR-DEUT0797BGL-MYNTRA DESIGNS PRIVA TE LIMITED-SLICK ORGANICS PRIVATE LIMITE D-122100166GN00262,shopping,,net_banking_transfer,577.67
626247d5d8beac1599c694e8,50200023535069,129724.57,60ec41ba55c00300382672d9,HDFC,Revenue-PG-split enabled,5eecc6d6449e4f7cfb1c2708,2021-08-09T00:00:00.000Z,NEFT CR-UTIB0001506-RAZORPAY SOFTWARE PR IVATE LIMITED-SLICK ORGANICS PVT LITD-AX ISCN0087630329,insurance,,net_banking_transfer,38300.35
626247d5d8beac1599c694ea,50200023535069,139488.52,60ec41ba55c00300382672d9,HDFC,Revenue-Mktplace,5eecc6d6449e4f7cfb1c2708,2021-08-09T00:00:00.000Z,NEFT CR-DEUT0797BGL-FLIPKART INTERNET PR IVATE LIMITED-SLICK ORGANICS PVT LTD-122 100118GN00008,shopping,,net_banking_transfer,9763.95
626247d5d8beac1599c694ec,50200023535069,73981.52,60ec41ba55c00300382672d9,HDFC,direct expenses,5eecc6d6449e4f7cfb1c2708,2021-08-09T00:00:00.000Z,00921000075586-TPT-65507-ROET BINDRA,,,net_banking_transfer,-65507
626247d5d8beac1599c694ee,50200023535069,3981.52,60ec41ba55c00300382672d9,HDFC,direct expenses,5eecc6d6449e4f7cfb1c2708,2021-08-09T00:00:00.000Z,"NEFT DR-KKBK0000173-ONE STOP ADVERTISING -NETBANK, MUM-N221211595393569-70000",,,net_banking_transfer,-70000
626247d5d8beac1599c694f0,50200023535069,16407.57,60ec41ba55c00300382672d9,HDFC,Revenue-PG-non-split,5eecc6d6449e4f7cfb1c2708,2021-08-09T00:00:00.000Z,NEFT CR-IDFB0010204-SEZZLE PAYMENTS PRIV ATE LIMITED-SLICK ORGANICS PRIVATE LIMIT ED-IDFBH21221588052,insurance,,net_banking_transfer,12426.05
626247d5d8beac1599c694f2,50200023535069,22081.43,60ec41ba55c00300382672d9,HDFC,Revenue-PG-split enabled,5eecc6d6449e4f7cfb1c2708,2021-08-09T00:00:00.000Z,NEFT CR-UTIB0001506-RAZORPAY SOFTWARE PR IVATE LIMITED-SLICK ORGANICS PVT LITD-AX ISCN0087720595,insurance,,net_banking_transfer,5673.86
626247d5d8beac1599c694f4,50200023535069,49561.28,60ec41ba55c00300382672d9,HDFC,Revenue-PG-non-split,5eecc6d6449e4f7cfb1c2708,2021-08-10T00:00:00.000Z,IMPS-122205911287-ONE97 COMMUNICATIONS-H DFC-XXXXXXXXXX0007-ALL202108102168200003 30830668628,ewallet,,net_banking_transfer,27479.85
626247d5d8beac1599c694f6,50200023535069,187567.1,60ec41ba55c00300382672d9,HDFC,Revenue-Mktplace,5eecc6d6449e4f7cfb1c2708,2021-08-10T00:00:00.000Z,IMPS-122205182103-AMAZON SELLER SERVIC-H,shopping,,net_banking_transfer,138005.82
626247d5d8beac1599c694f8,50200023535069,690100.51,60ec41ba55c00300382672d9,HDFC,Revenue-Mktplace,5eecc6d6449e4f7cfb1c2708,2021-08-10T00:00:00.000Z,NEFT CR-DEUT0797BGL-AMAZON PAY (INDIA) P RIVATE LIMITED-SLICK ORGANICS PVT LTD-12 2200044GN00292,shopping,,net_banking_transfer,502533.41
626247d5d8beac1599c694fa,50200023535069,645605.51,60ec41ba55c00300382672d9,HDFC,direct expenses,5eecc6d6449e4f7cfb1c2708,2021-08-10T00:00:00.000Z,"NEFT DR-KKBK0000187-APPLIED LIFE PRIVATE LIMITED-NETBANK, MUM-N222211596157932-4 4495",,,net_banking_transfer,-44495
626247d5d8beac1599c694fc,50200023535069,555605.51,60ec41ba55c00300382672d9,HDFC,direct expenses,5eecc6d6449e4f7cfb1c2708,2021-08-10T00:00:00.000Z,"NEFT DR-BARB0VJMATU-ARTISTO DESIGNZ-NETB ANK, MUM-N222211596193813-90000",,,net_banking_transfer,-90000
626247d5d8beac1599c694fe,50200023535069,566284.66,60ec41ba55c00300382672d9,HDFC,Revenue-PG-split enabled,5eecc6d6449e4f7cfb1c2708,2021-08-10T00:00:00.000Z,NEFT CR-UTIB0001506-RAZORPAY SOFTWARE PR IVATE LIMITED-SLICK ORGANICS PVT LITD-AX ISCN0087759409,insurance,,net_banking_transfer,10679.15
626247d5d8beac1599c69500,50200023535069,245912.66,60ec41ba55c00300382672d9,HDFC,direct expenses,5eecc6d6449e4f7cfb1c2708,2021-08-10T00:00:00.000Z,"NEFT DR-YESB0000551-VISTTA COSMETICS-NET BANK, MUM-N222211596283555-320372",,,net_banking_transfer,-320372
626247d5d8beac1599c69502,50200023535069,43431.66,60ec41ba55c00300382672d9,HDFC,direct expenses,5eecc6d6449e4f7cfb1c2708,2021-08-10T00:00:00.000Z,"NEFT DR-UTIB0000166-KRAUTER HEALTHCARE LIMITED-NETBANK, MUM-N222211596300887-20 2481",,,net_banking_transfer,-202481
626247d5d8beac1599c69504,50200023535069,245912.66,60ec41ba55c00300382672d9,HDFC,Adjustments/Reversal,5eecc6d6449e4f7cfb1c2708,2021-08-10T00:00:00.000Z,NEFT RETURN-UNABLE TO PROCESS-KRAUTER HE ALTHCARE LIMITED-AXRJ212226155779,,neft_return,refund,202481
626247d5d8beac1599c69506,50200023535069,143852.66,60ec41ba55c00300382672d9,HDFC,direct expenses,5eecc6d6449e4f7cfb1c2708,2021-08-10T00:00:00.000Z,"NEFT DR-KKBK0001393-MASCOT SPINCONTROL I NDIA PVT LTD-NETBANK, MUM-N2222115965121 13-102060",,,net_banking_transfer,-102060
626247d5d8beac1599c69508,50200023535069,147314.53,60ec41ba55c00300382672d9,HDFC,Revenue-PG-non-split,5eecc6d6449e4f7cfb1c2708,2021-08-10T00:00:00.000Z,NEFT CR-IDFB0010204-SEZZLE PAYMENTS PRIV ATE LIMITED-SLICK ORGANICS PRIVATE LIMIT ED-IDFBH21222669691,insurance,,net_banking_transfer,3461.87
626247d5d8beac1599c6950a,50200023535069,543041.69,60ec41ba55c00300382672d9,HDFC,Transfer in/Revenue-other,5eecc6d6449e4f7cfb1c2708,2021-08-10T00:00:00.000Z,NEFT CR-HSBC0110005-HANDS ON TRADES PRIV ATE LIMITED-SLICK ORGANICS PRIVATE LIMIT ED-HSBCN21222001234,,,net_banking_transfer,395727.16
626247d5d8beac1599c6950c,50200023535069,568189.35,60ec41ba55c00300382672d9,HDFC,Revenue-PG-non-split,5eecc6d6449e4f7cfb1c2708,2021-08-11T00:00:00.000Z,IMPS-122305123659-ONE97 COMMUNICATIONS-H,ewallet,,net_banking_transfer,25147.66
626247d5d8beac1599c6950e,50200023535069,573773.88,60ec41ba55c00300382672d9,HDFC,Revenue-Mktplace,5eecc6d6449e4f7cfb1c2708,2021-08-11T00:00:00.000Z,NEFT CR-DEUT0797BGL-FLIPKART INTERNET PR IVATE LIMITED-SLICK ORGANICS PVT LTD-122 300088GN00169,shopping,,net_banking_transfer,5584.53
626247d5d8beac1599c69510,50200023535069,574301.49,60ec41ba55c00300382672d9,HDFC,Revenue-Mktplace,5eecc6d6449e4f7cfb1c2708,2021-08-11T00:00:00.000Z,NEFT CR-DEUT0797BGL-MYNTRA DESIGNS PRIVA TE LIMITED-SLICK ORGANICS PRIVATE LIMITE D-122300193GN00299,shopping,,net_banking_transfer,527.61
626247d5d8beac1599c69512,50200023535069,576826.43,60ec41ba55c00300382672d9,HDFC,Revenue-Mktplace,5eecc6d6449e4f7cfb1c2708,2021-08-11T00:00:00.000Z,NEFT CR-DEUT0797BGL-MYNTRA DESIGNS PRIVA TE LIMITED-SLICK ORGANICS PRIVATE LIMITE D-122300194GN00072,shopping,,net_banking_transfer,2524.94
626247d5d8beac1599c69514,50200023535069,582630.74,60ec41ba55c00300382672d9,HDFC,Revenue-Mktplace,5eecc6d6449e4f7cfb1c2708,2021-08-11T00:00:00.000Z,NEFT CR-DEUT0797BGL-FLIPKART INTERNET PR IVATE LIMITED-SLICK ORGANICS PVT LTD-122 300096GN00110,shopping,,net_banking_transfer,5804.31
626247d5d8beac1599c69516,50200023535069,582877.75,60ec41ba55c00300382672d9,HDFC,Revenue-Mktplace,5eecc6d6449e4f7cfb1c2708,2021-08-11T00:00:00.000Z,NEFT CR-ICIC0000105-ICICI BANK NODAL AC MANASH LIFESTYL-SLICK ORGANICS PRIVATE L IMITED BANG-ICIJ212230001118,,,net_banking_transfer,247.01
626247d5d8beac1599c69518,50200023535069,584708.83,60ec41ba55c00300382672d9,HDFC,Revenue-Mktplace,5eecc6d6449e4f7cfb1c2708,2021-08-11T00:00:00.000Z,NEFT CR-ICIC0000105-ICICI BANK NODAL AC MANASH LIFESTYL-SLICK ORGANICS PRIVATE L IMITED MP G-ICIJ212230001116,,,net_banking_transfer,1831.08
626247d5d8beac1599c6951a,50200023535069,1584708.83,60ec41ba55c00300382672d9,HDFC,Internal Transfers,5eecc6d6449e4f7cfb1c2708,2021-08-11T00:00:00.000Z,IB FUNDS TRANSFER CR-50200035187206 -SL ICK ORGANICS PVT LTD,insurance,,Other,1000000
626247d5d8beac1599c6951c,50200023535069,584708.83,60ec41ba55c00300382672d9,HDFC,Marketing Expense,5eecc6d6449e4f7cfb1c2708,2021-08-11T00:00:00.000Z,"NEFT DR-CITI0000006-FACEBOOK INDIA ONLIN E SERVICES PVT LTD-NETBANK, MUM-N2232115 98403173-1000000",,,net_banking_transfer,-1000000
626247d5d8beac1599c6951e,50200023535069,382227.83,60ec41ba55c00300382672d9,HDFC,direct expenses,5eecc6d6449e4f7cfb1c2708,2021-08-11T00:00:00.000Z,"NEFT DR-PUNB0100110-KRAUTER HEALTHCARE L TD-NETBANK, MUM-N223211598433746-202481",,,net_banking_transfer,-202481
626247d5d8beac1599c69520,50200023535069,382990.38,60ec41ba55c00300382672d9,HDFC,Revenue-Mktplace,5eecc6d6449e4f7cfb1c2708,2021-08-11T00:00:00.000Z,4060003270-TIMES INTERNET LIMITED NODAL,,,Other,762.55
626247d5d8beac1599c69522,50200023535069,428491.23,60ec41ba55c00300382672d9,HDFC,Revenue-COD,5eecc6d6449e4f7cfb1c2708,2021-08-11T00:00:00.000Z,NEFT CR-ICIC0000155-SHIPROCKET COD CRF I D 2857038-SLICK ORGANICS PVT LTD-CMS2070 509516,insurance,,net_banking_transfer,45500.85
626247d5d8beac1599c69524,50200023535069,429215.15,60ec41ba55c00300382672d9,HDFC,Revenue-PG-non-split,5eecc6d6449e4f7cfb1c2708,2021-08-11T00:00:00.000Z,NEFT CR-IDFB0010204-SEZZLE PAYMENTS PRIV,,,net_banking_transfer,723.92
626247d5d8beac1599c69526,50200023535069,379215.15,60ec41ba55c00300382672d9,HDFC,Marketing Expense,5eecc6d6449e4f7cfb1c2708,2021-08-11T00:00:00.000Z,POS 514834XXXXXX9486 GOOGLE ADS,,,debit_card,-50000
626247d5d8beac1599c69528,50200023535069,401229.18,60ec41ba55c00300382672d9,HDFC,Revenue-PG-non-split,5eecc6d6449e4f7cfb1c2708,2021-08-12T00:00:00.000Z,IMPS-122405358309-ONE97 COMMUNICATIONS-H DFC-XXXXXXXXXX0007-ALL202108122168200003 30830668628,ewallet,,net_banking_transfer,22014.03
626247d5d8beac1599c6952a,50200023535069,201229.18,60ec41ba55c00300382672d9,HDFC,direct expenses,5eecc6d6449e4f7cfb1c2708,2021-08-12T00:00:00.000Z,"NEFT DR-PYTM0123456-PAYTM-NETBANK, MUM-N 224211599338596-200000",ewallet,,net_banking_transfer,-200000
626247d5d8beac1599c6952c,50200023535069,181909.18,60ec41ba55c00300382672d9,HDFC,Salary/Emp/consultant Expense,5eecc6d6449e4f7cfb1c2708,2021-08-12T00:00:00.000Z,"NEFT DR-UTIB0003142-ARIA DESAI UG ELIZAB ETH THOMAS ALEX-NETBANK, MUM-N2242115993 39923-19320",,,net_banking_transfer,-19320
626247d5d8beac1599c6952e,50200023535069,177916.18,60ec41ba55c00300382672d9,HDFC,direct expenses,5eecc6d6449e4f7cfb1c2708,2021-08-12T00:00:00.000Z,50100097355028-TPT-3993-PALLAVI JUNEJA,,,net_banking_transfer,-3993
626247d5d8beac1599c69530,50200023535069,200871.09,60ec41ba55c00300382672d9,HDFC,Revenue-PG-split enabled,5eecc6d6449e4f7cfb1c2708,2021-08-12T00:00:00.000Z,NEFT CR-UTIB0001506-RAZORPAY SOFTWARE PR IVATE LIMITED-SLICK ORGANICS PVT LITD-AX ISCN0088050913,insurance,,net_banking_transfer,22954.91
626247d5d8beac1599c69532,50200023535069,-50723.91,60ec41ba55c00300382672d9,HDFC,N-ACH payments,5eecc6d6449e4f7cfb1c2708,2021-08-12T00:00:00.000Z,ACH D- CTRAZORPAY-GETVANTAGEHJOECAYNYZCF,loans,lender_transaction,auto_debit_payment,-251595
626247d6d8beac1599c69534,50200023535069,200871.09,60ec41ba55c00300382672d9,HDFC,Revenue-PG-split enabled,5eecc6d6449e4f7cfb1c2708,2021-08-12T00:00:00.000Z,ACH D- CTRAZORPAY-GETVANTAGEHJOECAYNYZCF,,,Other,251595
626247d6d8beac1599c69536,50200023535069,218327.56,60ec41ba55c00300382672d9,HDFC,Revenue-PG-split enabled,5eecc6d6449e4f7cfb1c2708,2021-08-12T00:00:00.000Z,NEFT CR-UTIB0001506-RAZORPAY SOFTWARE PR IVATE LIMITED-SLICK ORGANICS PVT LITD-AX ISCN0088140162,insurance,,net_banking_transfer,17456.47
626247d6d8beac1599c69538,50200023535069,107646.56,60ec41ba55c00300382672d9,HDFC,direct expenses,5eecc6d6449e4f7cfb1c2708,2021-08-12T00:00:00.000Z,00918630000430-TPT-110681-UNICOMMERCE ES OLUTIONS PRIVATE LIMITED,,,net_banking_transfer,-110681
626247d6d8beac1599c6953a,50200023535069,307646.56,60ec41ba55c00300382672d9,HDFC,Internal Transfers,5eecc6d6449e4f7cfb1c2708,2021-08-12T00:00:00.000Z,IB FUNDS TRANSFER CR-50200035187206 -SL ICK ORGANICS PVT LTD,insurance,,Other,200000
626247d6d8beac1599c6953c,50200023535069,407646.56,60ec41ba55c00300382672d9,HDFC,Internal Transfers,5eecc6d6449e4f7cfb1c2708,2021-08-12T00:00:00.000Z,IB FUNDS TRANSFER CR-50200035187206 -SL ICK ORGANICS PVT LTD,insurance,,Other,100000
626247d6d8beac1599c6953e,50200023535069,409258.8,60ec41ba55c00300382672d9,HDFC,Revenue-PG-non-split,5eecc6d6449e4f7cfb1c2708,2021-08-12T00:00:00.000Z,NEFT CR-IDFB0010204-SEZZLE PAYMENTS PRIV ATE LIMITED-SLICK ORGANICS PRIVATE LIMIT ED-IDFBH21224821545,insurance,,net_banking_transfer,1612.24
626247d6d8beac1599c69540,50200023535069,405616.43,60ec41ba55c00300382672d9,HDFC,direct expenses,5eecc6d6449e4f7cfb1c2708,2021-08-12T00:00:00.000Z,POS 514834XXXXXX9486 WWW.FAQPRIME.COM,,,debit_card,-3642.37
626247d6d8beac1599c69542,50200023535069,409258.8,60ec41ba55c00300382672d9,HDFC,Transfer in/Revenue-other,5eecc6d6449e4f7cfb1c2708,2021-08-12T00:00:00.000Z,POS 514834XXXXXX9486 WWW.FAQPRIME.COM,,,debit_card,3642.37
626247d6d8beac1599c69544,50200023535069,1064685.02,60ec41ba55c00300382672d9,HDFC,Revenue-Mktplace,5eecc6d6449e4f7cfb1c2708,2021-08-12T00:00:00.000Z,NEFT CR-KKBK0000958-NYKAA E RETAIL PRIVA TE LIMITED NYKAA-SLICK ORGANICS PVT LTD- KKBK212247953612,insurance,,net_banking_transfer,655426.22
626247d6d8beac1599c69546,50200023535069,1089897.58,60ec41ba55c00300382672d9,HDFC,Revenue-PG-non-split,5eecc6d6449e4f7cfb1c2708,2021-08-13T00:00:00.000Z,IMPS-122505540871-ONE97 COMMUNICATIONS-H DFC-XXXXXXXXXX0007-ALL202108132168200003 30830668628,ewallet,,net_banking_transfer,25212.56
626247d6d8beac1599c69548,50200023535069,1098331.91,60ec41ba55c00300382672d9,HDFC,Revenue-Mktplace,5eecc6d6449e4f7cfb1c2708,2021-08-13T00:00:00.000Z,NEFT CR-DEUT0797BGL-FLIPKART INTERNET PR IVATE LIMITED-SLICK ORGANICS PVT LTD-122 500109GN00291,shopping,,net_banking_transfer,8434.33
626247d6d8beac1599c6954a,50200023535069,1114070.37,60ec41ba55c00300382672d9,HDFC,Revenue-PG-split enabled,5eecc6d6449e4f7cfb1c2708,2021-08-13T00:00:00.000Z,NEFT CR-UTIB0001506-RAZORPAY SOFTWARE PR IVATE LIMITED-SLICK ORGANICS PVT LITD-AX ISCN0088177820,insurance,,net_banking_transfer,15738.46
626247d6d8beac1599c6954c,50200023535069,1118009.96,60ec41ba55c00300382672d9,HDFC,Revenue-Mktplace,5eecc6d6449e4f7cfb1c2708,2021-08-13T00:00:00.000Z,NEFT CR-DEUT0797BGL-MYNTRA DESIGNS PRIVA TE LIMITED-SLICK ORGANICS PRIVATE LIMITE D-122500253GN00284,shopping,,net_banking_transfer,3939.59
626247d6d8beac1599c6954e,50200023535069,1126812.36,60ec41ba55c00300382672d9,HDFC,Revenue-Mktplace,5eecc6d6449e4f7cfb1c2708,2021-08-13T00:00:00.000Z,NEFT CR-DEUT0797BGL-MYNTRA DESIGNS PRIVA TE LIMITED-SLICK ORGANICS PRIVATE LIMITE D-122500277GN00087,shopping,,net_banking_transfer,8802.4
626247d6d8beac1599c69550,50200023535069,1126970.37,60ec41ba55c00300382672d9,HDFC,Transfer in/Revenue-other,5eecc6d6449e4f7cfb1c2708,2021-08-13T00:00:00.000Z,NEFT CR-ICIC0SF0002-ICICI BANK NODAL A-C -SLICK ORGANICS-24755007101DC,insurance,,net_banking_transfer,158.01
626247d6d8beac1599c69552,50200023535069,875375.37,60ec41ba55c00300382672d9,HDFC,N-ACH payments,5eecc6d6449e4f7cfb1c2708,2021-08-13T00:00:00.000Z,ACH D- CTRAZORPAY-GETVANTAGEHKHNNAQYM9Q6,loans,lender_transaction,auto_debit_payment,-251595
626247d6d8beac1599c69554,50200023535069,884416.85,60ec41ba55c00300382672d9,HDFC,Revenue-Mktplace,5eecc6d6449e4f7cfb1c2708,2021-08-13T00:00:00.000Z,NEFT CR-DEUT0797BGL-FLIPKART INTERNET PR IVATE LIMITED-SLICK ORGANICS PVT LTD-122 500115GN00210,shopping,,net_banking_transfer,9041.48
626247d6d8beac1599c69556,50200023535069,835816.85,60ec41ba55c00300382672d9,HDFC,direct expenses,5eecc6d6449e4f7cfb1c2708,2021-08-13T00:00:00.000Z,"NEFT DR-CNRB0015170-SNEHAL TAYDE-NETBANK , MUM-N225211601140387-48600",,,net_banking_transfer,-48600
626247d6d8beac1599c69558,50200023535069,853302,60ec41ba55c00300382672d9,HDFC,Revenue-COD,5eecc6d6449e4f7cfb1c2708,2021-08-13T00:00:00.000Z,NEFT CR-ICIC0000155-SHIPROCKET COD CRF I D 2877439-SLICK ORGANICS PVT LTD-CMS2074 094683,insurance,,net_banking_transfer,17485.15
626247d6d8beac1599c6955b,50200023535069,646501,60ec41ba55c00300382672d9,HDFC,direct expenses,5eecc6d6449e4f7cfb1c2708,2021-08-13T00:00:00.000Z,NEFT DR-YESB0000551-VISTTA COSMETICS-NET,,,net_banking_transfer,-206801
626247d6d8beac1599c6955d,50200023535069,645911,60ec41ba55c00300382672d9,HDFC,Tax,5eecc6d6449e4f7cfb1c2708,2021-08-13T00:00:00.000Z,CHQ RETURN CHGS INCL GST 020821-CDT21225 05289111,,chq_bounce_charge,bank_charge,-590
626247d6d8beac1599c6955f,50200023535069,612491,60ec41ba55c00300382672d9,HDFC,direct expenses,5eecc6d6449e4f7cfb1c2708,2021-08-13T00:00:00.000Z,"NEFT DR-ICIC0003430-HASHTAG ORANGE ADVER TISING PVT LTD-NETBANK, MUM-N22521160128 4847-33420",,,net_banking_transfer,-33420
626247d6d8beac1599c69562,50200023535069,608080,60ec41ba55c00300382672d9,HDFC,direct expenses,5eecc6d6449e4f7cfb1c2708,2021-08-13T00:00:00.000Z,"NEFT DR-SBIN0001859-PARSHOTAM AND ASSOCI ATES-NETBANK, MUM-N225211601462452-4411",,,net_banking_transfer,-4411
626247d6d8beac1599c69564,50200023535069,620379.53,60ec41ba55c00300382672d9,HDFC,Revenue-PG-split enabled,5eecc6d6449e4f7cfb1c2708,2021-08-13T00:00:00.000Z,NEFT CR-UTIB0001506-RAZORPAY SOFTWARE PR IVATE LIMITED-SLICK ORGANICS PVT LITD-AX ISCN0088260538,insurance,,net_banking_transfer,12299.53
626247d6d8beac1599c69566,50200023535069,621791.28,60ec41ba55c00300382672d9,HDFC,Revenue-PG-non-split,5eecc6d6449e4f7cfb1c2708,2021-08-13T00:00:00.000Z,NEFT CR-IDFB0010204-SEZZLE PAYMENTS PRIV ATE LIMITED-SLICK ORGANICS PRIVATE LIMIT ED-IDFBH21225888014,insurance,,net_banking_transfer,1411.75
626247d6d8beac1599c69568,50200023535069,621793.26,60ec41ba55c00300382672d9,HDFC,Revenue-Mktplace,5eecc6d6449e4f7cfb1c2708,2021-08-13T00:00:00.000Z,NEFT CR-DEUT0784BBY-TATA UNISTORE LIMITE D-SLICK ORGANICS PVT LTD-122502136GN0019 3,insurance,,net_banking_transfer,1.98
626247d6d8beac1599c6956a,50200023535069,622202.62,60ec41ba55c00300382672d9,HDFC,Revenue-Mktplace,5eecc6d6449e4f7cfb1c2708,2021-08-13T00:00:00.000Z,NEFT CR-DEUT0784BBY-TATA UNISTORE LIMITE D-SLICK ORGANICS PVT LTD-122502138GN0013 7,insurance,,net_banking_transfer,409.36
626247d6d8beac1599c6956c,50200023535069,623064.91,60ec41ba55c00300382672d9,HDFC,Revenue-Mktplace,5eecc6d6449e4f7cfb1c2708,2021-08-13T00:00:00.000Z,NEFT CR-DEUT0784BBY-TATA UNISTORE LTD-NO DAL-SLICK ORGANICS PVT LTD-122502160GN00 274,insurance,,net_banking_transfer,862.29
626247d6d8beac1599c6956e,50200023535069,962597.05,60ec41ba55c00300382672d9,HDFC,Transfer in/Revenue-other,5eecc6d6449e4f7cfb1c2708,2021-08-13T00:00:00.000Z,NEFT CR-HSBC0110005-HANDS ON TRADES PRIV ATE LIMITED-SLICK ORGANICS PRIVATE LIMIT ED-HSBCN21225428827,,,net_banking_transfer,339532.14
626247d6d8beac1599c69570,50200023535069,963881.06,60ec41ba55c00300382672d9,HDFC,Transfer in/Revenue-other,5eecc6d6449e4f7cfb1c2708,2021-08-13T00:00:00.000Z,NEFT CR-YESB0000001-ILUMINAR MEDIA-SLICK ORGANICS PVT. LTD-N225210709610024,,,net_banking_transfer,1284.01
626247d6d8beac1599c69572,50200023535069,991703.06,60ec41ba55c00300382672d9,HDFC,Revenue-PG-non-split,5eecc6d6449e4f7cfb1c2708,2021-08-14T00:00:00.000Z,IMPS-122605698237-ONE97 COMMUNICATIONS-H DFC-XXXXXXXXXX0007-ALL202108142168200003 30830668628,ewallet,,net_banking_transfer,27822
626247d6d8beac1599c69574,50200023535069,791703.06,60ec41ba55c00300382672d9,HDFC,direct expenses,5eecc6d6449e4f7cfb1c2708,2021-08-14T00:00:00.000Z,IMPS-122613114408-PAYTM-PYTM-XXXXXXXX383,ewallet,,net_banking_transfer,-200000
626247d6d8beac1599c69576,50200023535069,820418.36,60ec41ba55c00300382672d9,HDFC,Revenue-PG-non-split,5eecc6d6449e4f7cfb1c2708,2021-08-15T00:00:00.000Z,IMPS-122705789066-ONE97 COMMUNICATIONS-H DFC-XXXXXXXXXX0007-ALL202108152168200003 30830668628,ewallet,,net_banking_transfer,28715.3
626247d6d8beac1599c69578,50200023535069,770418.36,60ec41ba55c00300382672d9,HDFC,Marketing Expense,5eecc6d6449e4f7cfb1c2708,2021-08-15T00:00:00.000Z,POS 514834XXXXXX9486 GOOGLE ADS,,,debit_card,-50000
626247d6d8beac1599c6957a,50200023535069,797332.63,60ec41ba55c00300382672d9,HDFC,Revenue-PG-non-split,5eecc6d6449e4f7cfb1c2708,2021-08-16T00:00:00.000Z,IMPS-122805796521-ONE97 COMMUNICATIONS-H DFC-XXXXXXXXXX0007-ALL202108162168200003 30830668628,ewallet,,net_banking_transfer,26914.27
626247d6d8beac1599c6957d,50200023535069,801946.36,60ec41ba55c00300382672d9,HDFC,Revenue-Mktplace,5eecc6d6449e4f7cfb1c2708,2021-08-16T00:00:00.000Z,NEFT CR-DEUT0797BGL-FLIPKART INTERNET PR IVATE LIMITED-SLICK ORGANICS PVT LTD-122 800105GN00052,shopping,,net_banking_transfer,4613.73
626247d6d8beac1599c6957f,50200023535069,804674.94,60ec41ba55c00300382672d9,HDFC,Revenue-Mktplace,5eecc6d6449e4f7cfb1c2708,2021-08-16T00:00:00.000Z,NEFT CR-DEUT0797BGL-FLIPKART INTERNET PR IVATE LIMITED-SLICK ORGANICS PVT LTD-122 800111GN00072,shopping,,net_banking_transfer,2728.58
626247d6d8beac1599c69581,50200023535069,818347.94,60ec41ba55c00300382672d9,HDFC,Transfer in/Revenue-other,5eecc6d6449e4f7cfb1c2708,2021-08-16T00:00:00.000Z,NEFT CR-KKBK0000958-EKANEK NETWORKS PRIV ATE LIMITED-SLICK ORGANICS PVT LTD-KKBK2 12288521343,,,net_banking_transfer,13673
626247d6d8beac1599c69583,50200023535069,486847.94,60ec41ba55c00300382672d9,HDFC,SAAS/tech expense,5eecc6d6449e4f7cfb1c2708,2021-08-16T00:00:00.000Z,"NEFT DR-DEUT0797BGL-AMAZON SELLER SERVIC ES PVT LTD-NETBANK, MUM-N228211602701728 -331500",shopping,,net_banking_transfer,-331500
626247d6d8beac1599c69588,50200023535069,330247.94,60ec41ba55c00300382672d9,HDFC,direct expenses,5eecc6d6449e4f7cfb1c2708,2021-08-16T00:00:00.000Z,"NEFT DR-KKBK0005289-HILL GROOVE CONSULTI NG LLP-NETBANK, MUM-N228211602716984-156 600",,,net_banking_transfer,-156600
626247d6d8beac1599c6958a,50200023535069,348859.15,60ec41ba55c00300382672d9,HDFC,Revenue-Mktplace,5eecc6d6449e4f7cfb1c2708,2021-08-16T00:00:00.000Z,NEFT CR-DEUT0797BGL-MYNTRA DESIGNS PRIVA TE LIMITED-SLICK ORGANICS PRIVATE LIMITE D-122800322GN00085,shopping,,net_banking_transfer,18611.21
626247d6d8beac1599c6958c,50200023535069,356489.97,60ec41ba55c00300382672d9,HDFC,Revenue-Mktplace,5eecc6d6449e4f7cfb1c2708,2021-08-16T00:00:00.000Z,NEFT CR-DEUT0797BGL-MYNTRA DESIGNS PRIVA TE LIMITED-SLICK ORGANICS PRIVATE LIMITE D-122800323GN00024,shopping,,net_banking_transfer,7630.82
626247d6d8beac1599c6958e,50200023535069,352851.37,60ec41ba55c00300382672d9,HDFC,direct expenses,5eecc6d6449e4f7cfb1c2708,2021-08-16T00:00:00.000Z,POS 514834XXXXXX9486 FRESHWORKS INC,,,debit_card,-3638.6
626247d6d8beac1599c69590,50200023535069,349213.17,60ec41ba55c00300382672d9,HDFC,direct expenses,5eecc6d6449e4f7cfb1c2708,2021-08-16T00:00:00.000Z,POS 514834XXXXXX9486 WWW.FAQPRIME.COM,,,debit_card,-3638.2
626247d6d8beac1599c69592,50200023535069,349741.17,60ec41ba55c00300382672d9,HDFC,Revenue-Mktplace,5eecc6d6449e4f7cfb1c2708,2021-08-16T00:00:00.000Z,NEFT CR-KKBK0000958-SURFBOATS SOLUTIONS,,,net_banking_transfer,528
626247d6d8beac1599c69594,50200023535069,324430.17,60ec41ba55c00300382672d9,HDFC,direct expenses,5eecc6d6449e4f7cfb1c2708,2021-08-16T00:00:00.000Z,50200043297657-TPT-25311-AIDC PRODUCTS I NDIA PRIVATE LIMITED,,,net_banking_transfer,-25311
626247d6d8beac1599c69596,50200023535069,321065.17,60ec41ba55c00300382672d9,HDFC,direct expenses,5eecc6d6449e4f7cfb1c2708,2021-08-16T00:00:00.000Z,50100097355028-TPT-3365-PALLAVI JUNEJA,,,net_banking_transfer,-3365
626247d6d8beac1599c69598,50200023535069,715985.91,60ec41ba55c00300382672d9,HDFC,Transfer in/Revenue-other,5eecc6d6449e4f7cfb1c2708,2021-08-16T00:00:00.000Z,NEFT CR-HSBC0110005-HANDS ON TRADES PRIV ATE LIMITED-SLICK ORGANICS PRIVATE LIMIT ED-HSBCN21228640626,,,net_banking_transfer,394920.74
626247d6d8beac1599c6959a,50200023535069,768171.78,60ec41ba55c00300382672d9,HDFC,Revenue-PG-non-split,5eecc6d6449e4f7cfb1c2708,2021-08-17T00:00:00.000Z,IMPS-122905023823-ONE97 COMMUNICATIONS-H DFC-XXXXXXXXXX0007-ALL202108172168200003 30830668628,ewallet,,net_banking_transfer,52185.87
626247d6d8beac1599c6959c,50200023535069,894016.07,60ec41ba55c00300382672d9,HDFC,Revenue-Mktplace,5eecc6d6449e4f7cfb1c2708,2021-08-17T00:00:00.000Z,IMPS-122905102943-AMAZON SELLER SERVIC-H DFC-XXXXXXXX6004-235VCQ8MXVYKTD4VSLICK O RGANICS PVT LTD,shopping,,net_banking_transfer,125844.29
626247d6d8beac1599c6959f,50200023535069,1373270.35,60ec41ba55c00300382672d9,HDFC,Revenue-Mktplace,5eecc6d6449e4f7cfb1c2708,2021-08-17T00:00:00.000Z,NEFT CR-DEUT0797BGL-AMAZON PAY (INDIA) P RIVATE LIMITED-SLICK ORGANICS PVT LTD-12 2900042GN00114,shopping,,net_banking_transfer,479254.28
626247d6d8beac1599c695a1,50200023535069,1444359.9,60ec41ba55c00300382672d9,HDFC,Revenue-PG-split enabled,5eecc6d6449e4f7cfb1c2708,2021-08-17T00:00:00.000Z,NEFT CR-UTIB0001506-RAZORPAY SOFTWARE PR IVATE LIMITED-SLICK ORGANICS PVT LITD-AX ISCN0088424681,insurance,,net_banking_transfer,71089.55
626247d6d8beac1599c695a3,50200023535069,1444270.74,60ec41ba55c00300382672d9,HDFC,bank charges,5eecc6d6449e4f7cfb1c2708,2021-08-17T00:00:00.000Z,.DC INTL POS TXN MARKUP+ST 010821 030821 -CDT2122605298681,,,international_transaction_arbitrage,-89.16
626247d6d8beac1599c695a5,50200023535069,1390270.74,60ec41ba55c00300382672d9,HDFC,direct expenses,5eecc6d6449e4f7cfb1c2708,2021-08-17T00:00:00.000Z,"NEFT DR-SRCB0000281-3D TECHNOPACK PRIVAT E LIMITED-NETBANK, MUM-N229211604218852- 54000",,,net_banking_transfer,-54000
626247d6d8beac1599c695a7,50200023535069,1393973.18,60ec41ba55c00300382672d9,HDFC,Revenue-Mktplace,5eecc6d6449e4f7cfb1c2708,2021-08-17T00:00:00.000Z,NEFT CR-ICIC0000105-ICICI BANK NODAL AC MANASH LIFESTYL-SLICK ORGANICS PRIVATE L IMITED MP G-ICIJ212290003369,,,net_banking_transfer,3702.44
626247d6d8beac1599c695a9,50200023535069,1395261.08,60ec41ba55c00300382672d9,HDFC,Revenue-Mktplace,5eecc6d6449e4f7cfb1c2708,2021-08-17T00:00:00.000Z,NEFT CR-ICIC0000105-ICICI BANK NODAL AC MANASH LIFESTYL-SLICK ORGANICS PRIVATE L IMITED BANG-ICIJ212290003373,,,net_banking_transfer,1287.9
626247d6d8beac1599c695ab,50200023535069,1396314.43,60ec41ba55c00300382672d9,HDFC,Transfer in/Revenue-other,5eecc6d6449e4f7cfb1c2708,2021-08-17T00:00:00.000Z,NEFT CR-ICIC0000105-ICICI BANK NODAL AC,,,net_banking_transfer,1053.35
626247d6d8beac1599c695ad,50200023535069,1396920.64,60ec41ba55c00300382672d9,HDFC,Revenue-Mktplace,5eecc6d6449e4f7cfb1c2708,2021-08-17T00:00:00.000Z,NEFT CR-ICIC0000105-ICICI BANK NODAL AC MANASH LIFESTYL-SLICK ORGANICS PRIVATE L IMITED MP M-ICIJ212290003370,,,net_banking_transfer,606.21
626247d6d8beac1599c695af,50200023535069,1396468.02,60ec41ba55c00300382672d9,HDFC,bank charges,5eecc6d6449e4f7cfb1c2708,2021-08-17T00:00:00.000Z,.DC INTL POS TXN MARKUP+ST 040821 050821 -CDT2122605298681,,,international_transaction_arbitrage,-452.62
626247d6d8beac1599c695b1,50200023535069,1407954.47,60ec41ba55c00300382672d9,HDFC,Revenue-PG-split enabled,5eecc6d6449e4f7cfb1c2708,2021-08-17T00:00:00.000Z,NEFT CR-UTIB0001506-RAZORPAY SOFTWARE PR IVATE LIMITED-SLICK ORGANICS PVT LITD-AX ISCN0088512393,insurance,,net_banking_transfer,11486.45
626247d6d8beac1599c695b3,50200023535069,1411718.29,60ec41ba55c00300382672d9,HDFC,Revenue-PG-non-split,5eecc6d6449e4f7cfb1c2708,2021-08-17T00:00:00.000Z,NEFT CR-IDFB0010204-SEZZLE PAYMENTS PRIV ATE LIMITED-SLICK ORGANICS PRIVATE LIMIT ED-IDFBH21229071342,insurance,,net_banking_transfer,3763.82
626247d6d8beac1599c695b5,50200023535069,1637187.13,60ec41ba55c00300382672d9,HDFC,Transfer in/Revenue-other,5eecc6d6449e4f7cfb1c2708,2021-08-17T00:00:00.000Z,NEFT CR-HSBC0110005-HANDS ON TRADES PRIV ATE LIMITED-SLICK ORGANICS PRIVATE LIMIT ED-HSBCN21229779773,,,net_banking_transfer,225468.84
626247d6d8beac1599c695b7,50200023535069,1661882.5,60ec41ba55c00300382672d9,HDFC,Revenue-PG-non-split,5eecc6d6449e4f7cfb1c2708,2021-08-18T00:00:00.000Z,IMPS-123005182160-ONE97 COMMUNICATIONS-H DFC-XXXXXXXXXX0007-ALL202108182168200003 30830668628,ewallet,,net_banking_transfer,24695.37
626247d6d8beac1599c695b9,50200023535069,1670353.33,60ec41ba55c00300382672d9,HDFC,Revenue-Mktplace,5eecc6d6449e4f7cfb1c2708,2021-08-18T00:00:00.000Z,NEFT CR-DEUT0797BGL-FLIPKART INTERNET PR IVATE LIMITED-SLICK ORGANICS PVT LTD-123 000083GN00095,shopping,,net_banking_transfer,8470.83
626247d6d8beac1599c695bb,50200023535069,1679743.92,60ec41ba55c00300382672d9,HDFC,Revenue-Mktplace,5eecc6d6449e4f7cfb1c2708,2021-08-18T00:00:00.000Z,NEFT CR-DEUT0797BGL-FLIPKART INTERNET PR IVATE LIMITED-SLICK ORGANICS PVT LTD-123 000089GN00204,shopping,,net_banking_transfer,9390.59
626247d6d8beac1599c695bd,50200023535069,1680923.2,60ec41ba55c00300382672d9,HDFC,Revenue-PG-split enabled,5eecc6d6449e4f7cfb1c2708,2021-08-18T00:00:00.000Z,NEFT CR-UTIB0001506-RAZORPAY SOFTWARE PR IVATE LIMITED-SLICK ORGANICS PVT LITD-AX ISCN0088554854,insurance,,net_banking_transfer,1179.28
626247d6d8beac1599c695bf,50200023535069,1660923.2,60ec41ba55c00300382672d9,HDFC,direct expenses,5eecc6d6449e4f7cfb1c2708,2021-08-18T00:00:00.000Z,"NEFT DR-YESB0000551-VISTTA COSMETICS-NET BANK, MUM-N230211605045703-200000",,,net_banking_transfer,-20000
626247d6d8beac1599c695c1,50200023535069,1480923.2,60ec41ba55c00300382672d9,HDFC,direct expenses,5eecc6d6449e4f7cfb1c2708,2021-08-18T00:00:00.000Z,"NEFT DR-YESB0000551-VISTTA COSMETICS-NET BANK, MUM-N230211605035234-180000",,,net_banking_transfer,-180000
626247d6d8beac1599c695c3,50200023535069,1419043.2,60ec41ba55c00300382672d9,HDFC,direct expenses,5eecc6d6449e4f7cfb1c2708,2021-08-18T00:00:00.000Z,NEFT DR-KKBK0000173-MATRIX PRINTING SOLU,,,net_banking_transfer,-61880
626247d6d8beac1599c695c5,50200023535069,1160754.2,60ec41ba55c00300382672d9,HDFC,direct expenses,5eecc6d6449e4f7cfb1c2708,2021-08-18T00:00:00.000Z,"NEFT DR-PUNB0100110-KRAUTER HEALTHCARE L TD-NETBANK, MUM-N230211605057749-258289",,,net_banking_transfer,-258289
626247d6d8beac1599c695c7,50200023535069,1164984.31,60ec41ba55c00300382672d9,HDFC,Revenue-Mktplace,5eecc6d6449e4f7cfb1c2708,2021-08-18T00:00:00.000Z,NEFT CR-DEUT0797BGL-MYNTRA DESIGNS PRIVA TE LIMITED-SLICK ORGANICS PRIVATE LIMITE D-123000318GN00276,shopping,,net_banking_transfer,4230.11
626247d6d8beac1599c695c9,50200023535069,968848.31,60ec41ba55c00300382672d9,HDFC,direct expenses,5eecc6d6449e4f7cfb1c2708,2021-08-18T00:00:00.000Z,"NEFT DR-PUNB0100110-KRAUTER HEALTHCARE L TD-NETBANK, MUM-N230211605058005-196136",,,net_banking_transfer,-196136
626247d6d8beac1599c695cb,50200023535069,958848.31,60ec41ba55c00300382672d9,HDFC,direct expenses,5eecc6d6449e4f7cfb1c2708,2021-08-18T00:00:00.000Z,"NEFT DR-ICIC0000021-AKHILESH DIXIT-NETBA NK, MUM-N230211605053751-10000",,,net_banking_transfer,-10000
626247d6d8beac1599c695cd,50200023535069,957984.31,60ec41ba55c00300382672d9,HDFC,direct expenses,5eecc6d6449e4f7cfb1c2708,2021-08-18T00:00:00.000Z,02021122794217/ESIC,,,Other,-864
626247d6d8beac1599c695cf,50200023535069,954621.31,60ec41ba55c00300382672d9,HDFC,direct expenses,5eecc6d6449e4f7cfb1c2708,2021-08-18T00:00:00.000Z,02021124289555/ESIC,,,Other,-3363
626247d6d8beac1599c695d1,50200023535069,937121.31,60ec41ba55c00300382672d9,HDFC,direct expenses,5eecc6d6449e4f7cfb1c2708,2021-08-18T00:00:00.000Z,"NEFT DR-IBKL0000165-SHIV ENTERPRISES-NET BANK, MUM-N230211605239662-17500",,,net_banking_transfer,-17500
626247d6d8beac1599c695d3,50200023535069,936708.31,60ec41ba55c00300382672d9,HDFC,bank charges,5eecc6d6449e4f7cfb1c2708,2021-08-18T00:00:00.000Z,.ACH DEBIT RETURN CHARGES 120821 120821- CDT2122505289111,,ach_bounce_charge,bank_charge,-413
626247d6d8beac1599c695d5,50200023535069,944113.95,60ec41ba55c00300382672d9,HDFC,Revenue-Mktplace,5eecc6d6449e4f7cfb1c2708,2021-08-18T00:00:00.000Z,NEFT CR-DEUT0797BGL-MYNTRA DESIGNS PRIVA TE LIMITED-SLICK ORGANICS PRIVATE LIMITE D-123000320GN00295,shopping,,net_banking_transfer,7405.64
626247d6d8beac1599c695d7,50200023535069,802669.95,60ec41ba55c00300382672d9,HDFC,direct expenses,5eecc6d6449e4f7cfb1c2708,2021-08-18T00:00:00.000Z,"NEFT DR-YESB0000162-VINAY REDDY-NETBANK, MUM-N230211605401288-141444",,,net_banking_transfer,-141444
626247d6d8beac1599c695d9,50200023535069,827694.95,60ec41ba55c00300382672d9,HDFC,Revenue-Mktplace,5eecc6d6449e4f7cfb1c2708,2021-08-18T00:00:00.000Z,NEFT CR-SCBL0036001-M/S DREAMPLUG TECHNO -SLICK ORGANICS PRIVATE LIMITEDSLICK-SIN 31436Q0018351,insurance,,net_banking_transfer,25025
626247d6d8beac1599c695db,50200023535069,853139.15,60ec41ba55c00300382672d9,HDFC,Revenue-PG-split enabled,5eecc6d6449e4f7cfb1c2708,2021-08-18T00:00:00.000Z,NEFT CR-UTIB0001506-RAZORPAY SOFTWARE PR IVATE LIMITED-SLICK ORGANICS PVT LITD-AX ISCN0088643001,insurance,,net_banking_transfer,25444.2
626247d6d8beac1599c695dd,50200023535069,861522.59,60ec41ba55c00300382672d9,HDFC,Revenue-Mktplace,5eecc6d6449e4f7cfb1c2708,2021-08-18T00:00:00.000Z,NEFT CR-ICIC0000105-ICICI BANK NODAL AC MANASH LIFESTYL-SLICK ORGANICS PRIVATE L IMITED BANG-ICIJ212300005487,,,net_banking_transfer,8383.44
626247d6d8beac1599c695df,50200023535069,871487.06,60ec41ba55c00300382672d9,HDFC,Transfer in/Revenue-other,5eecc6d6449e4f7cfb1c2708,2021-08-18T00:00:00.000Z,NEFT CR-ICIC0000105-ICICI BANK NODAL AC,,,net_banking_transfer,9964.47
626247d6d8beac1599c695e1,50200023535069,893995.61,60ec41ba55c00300382672d9,HDFC,Revenue-Mktplace,5eecc6d6449e4f7cfb1c2708,2021-08-18T00:00:00.000Z,NEFT CR-ICIC0000105-ICICI BANK NODAL AC MANASH LIFESTYL-SLICK ORGANICS PRIVATE L IMITED MP G-ICIJ212300005480,,,net_banking_transfer,22508.55
626247d7d8beac1599c695e4,50200023535069,904405.05,60ec41ba55c00300382672d9,HDFC,Revenue-Mktplace,5eecc6d6449e4f7cfb1c2708,2021-08-18T00:00:00.000Z,NEFT CR-ICIC0000105-ICICI BANK NODAL AC MANASH LIFESTYL-SLICK ORGANICS PRIVATE L IMITED MP M-ICIJ212300005482,,,net_banking_transfer,10409.44
626247d7d8beac1599c695e6,50200023535069,908353.04,60ec41ba55c00300382672d9,HDFC,Revenue-Mktplace,5eecc6d6449e4f7cfb1c2708,2021-08-18T00:00:00.000Z,NEFT CR-ICIC0000105-ICICI BANK NODAL AC MANASH LIFESTYL-SLICK ORGANICS PRIVATE L IMITED HYD-ICIJ212300005485,,,net_banking_transfer,3947.99
626247d7d8beac1599c695e8,50200023535069,910494.32,60ec41ba55c00300382672d9,HDFC,Transfer in/Revenue-other,5eecc6d6449e4f7cfb1c2708,2021-08-18T00:00:00.000Z,FT - C78686180821032627 - - 50200050045 240 - ZOOBOP ME WORKS PRIVATE LIMITED,,,Other,2141.28
626247d7d8beac1599c695ea,50200023535069,937651.89,60ec41ba55c00300382672d9,HDFC,Revenue-PG-non-split,5eecc6d6449e4f7cfb1c2708,2021-08-19T00:00:00.000Z,IMPS-123107443428-ONE97 COMMUNICATIONS-H DFC-XXXXXXXXXX0007-ALL202108192168200003 30830668628,ewallet,,net_banking_transfer,27157.57
626247d7d8beac1599c695ec,50200023535069,938271.82,60ec41ba55c00300382672d9,HDFC,Transfer in/Revenue-other,5eecc6d6449e4f7cfb1c2708,2021-08-19T00:00:00.000Z,ZOOBOP ME WORK-ARATA,,,Other,619.93
626247d7d8beac1599c695ee,50200023535069,788271.82,60ec41ba55c00300382672d9,HDFC,direct expenses,5eecc6d6449e4f7cfb1c2708,2021-08-19T00:00:00.000Z,"NEFT DR-PYTM0123456-PAYTM-NETBANK, MUM-N 231211606415473-150000",ewallet,,net_banking_transfer,-150000
626247d7d8beac1599c695f0,50200023535069,738271.82,60ec41ba55c00300382672d9,HDFC,Marketing Expense,5eecc6d6449e4f7cfb1c2708,2021-08-19T00:00:00.000Z,POS 514834XXXXXX9486 GOOGLE ADS,,,debit_card,-50000
626247d7d8beac1599c695f2,50200023535069,739663.79,60ec41ba55c00300382672d9,HDFC,Revenue-Mktplace,5eecc6d6449e4f7cfb1c2708,2021-08-19T00:00:00.000Z,NEFT CR-ICIC0000105-MANASH LIFETYLE PVT LTD-SLICKORGANICSPRIVATELIMITEDMPGGN-ICI B212310014639,,,net_banking_transfer,1391.97
626247d7d8beac1599c695f4,50200023535069,739819.18,60ec41ba55c00300382672d9,HDFC,Revenue-Mktplace,5eecc6d6449e4f7cfb1c2708,2021-08-19T00:00:00.000Z,NEFT CR-ICIC0000105-MANASH LIFETYLE PVT LTD-SLICKORGANICSPRIVATELIMITEDHYD-ICIB2 12310014641,,,net_banking_transfer,155.39
626247d7d8beac1599c695f6,50200023535069,740857.88,60ec41ba55c00300382672d9,HDFC,Revenue-Mktplace,5eecc6d6449e4f7cfb1c2708,2021-08-19T00:00:00.000Z,NEFT CR-ICIC0000105-MANASH LIFETYLE PVT LTD-SLICKORGANICSPRIVATELIMITEDMPMUM-ICI B212310013925,,,net_banking_transfer,1038.7
626247d7d8beac1599c695f8,50200023535069,741307.23,60ec41ba55c00300382672d9,HDFC,Revenue-Mktplace,5eecc6d6449e4f7cfb1c2708,2021-08-19T00:00:00.000Z,NEFT CR-ICIC0000105-MANASH LIFETYLE PVT,,,net_banking_transfer,449.35
626247d7d8beac1599c695fa,50200023535069,750368.71,60ec41ba55c00300382672d9,HDFC,Revenue-PG-non-split,5eecc6d6449e4f7cfb1c2708,2021-08-19T00:00:00.000Z,NEFT CR-IDFB0010204-SEZZLE PAYMENTS PRIV ATE LIMITED-SLICK ORGANICS PRIVATE LIMIT ED-IDFBH21231188140,insurance,,net_banking_transfer,9061.48
626247d7d8beac1599c695fc,50200023535069,971784.71,60ec41ba55c00300382672d9,HDFC,Transfer in/Revenue-other,5eecc6d6449e4f7cfb1c2708,2021-08-19T00:00:00.000Z,NEFT CR-HSBC0110005-HANDS ON TRADES PRIV ATE LIMITED-SLICK ORGANICS PRIVATE LIMIT ED-HSBCN21231030834,,,net_banking_transfer,221416
626247d7d8beac1599c695fe,50200023535069,1014547.9,60ec41ba55c00300382672d9,HDFC,Revenue-PG-non-split,5eecc6d6449e4f7cfb1c2708,2021-08-20T00:00:00.000Z,IMPS-123205505973-ONE97 COMMUNICATIONS-H DFC-XXXXXXXXXX0007-ALL202108202168200003 30830668628,ewallet,,net_banking_transfer,42763.19
626247d7d8beac1599c69600,50200023535069,1036285.63,60ec41ba55c00300382672d9,HDFC,Revenue-PG-split enabled,5eecc6d6449e4f7cfb1c2708,2021-08-20T00:00:00.000Z,NEFT CR-UTIB0001506-RAZORPAY SOFTWARE PR IVATE LIMITED-SLICK ORGANICS PVT LITD-AX ISCN0088767415,insurance,,net_banking_transfer,21737.73
626247d7d8beac1599c69602,50200023535069,1031074.78,60ec41ba55c00300382672d9,HDFC,direct expenses,5eecc6d6449e4f7cfb1c2708,2021-08-20T00:00:00.000Z,POS 514834XXXXXX9486 FEEDBACKFIVE,,,debit_card,-5210.85
626247d7d8beac1599c69604,50200023535069,1042210.74,60ec41ba55c00300382672d9,HDFC,Revenue-Mktplace,5eecc6d6449e4f7cfb1c2708,2021-08-20T00:00:00.000Z,NEFT CR-DEUT0797BGL-FLIPKART INTERNET PR IVATE LIMITED-SLICK ORGANICS PVT LTD-123 200106GN00054,shopping,,net_banking_transfer,11135.96
626247d7d8beac1599c69606,50200023535069,1044236.45,60ec41ba55c00300382672d9,HDFC,Revenue-Mktplace,5eecc6d6449e4f7cfb1c2708,2021-08-20T00:00:00.000Z,NEFT CR-DEUT0797BGL-MYNTRA DESIGNS PRIVA TE LIMITED-SLICK ORGANICS PRIVATE LIMITE D-123200405GN00027,shopping,,net_banking_transfer,2025.71
626247d7d8beac1599c69608,50200023535069,1048676.75,60ec41ba55c00300382672d9,HDFC,Revenue-Mktplace,5eecc6d6449e4f7cfb1c2708,2021-08-20T00:00:00.000Z,NEFT CR-DEUT0797BGL-MYNTRA DESIGNS PRIVA TE LIMITED-SLICK ORGANICS PRIVATE LIMITE D-123200406GN00049,shopping,,net_banking_transfer,4440.3
626247d7d8beac1599c6960a,50200023535069,1039555.75,60ec41ba55c00300382672d9,HDFC,direct expenses,5eecc6d6449e4f7cfb1c2708,2021-08-20T00:00:00.000Z,"NEFT DR-ICIC0000021-AKHILESH DIXIT-NETBA NK, MUM-N232211607493833-9121",,,net_banking_transfer,-9121
626247d7d8beac1599c6960c,50200023535069,877589.75,60ec41ba55c00300382672d9,HDFC,direct expenses,5eecc6d6449e4f7cfb1c2708,2021-08-20T00:00:00.000Z,"NEFT DR-ICIC0006235-GLANCE GETVANTAGE ES CROW ACCOUNT 2-NETBANK, MUM-N23221160748 8644-161966",,,net_banking_transfer,-161966
626247d7d8beac1599c6960e,50200023535069,885399.08,60ec41ba55c00300382672d9,HDFC,Revenue-Mktplace,5eecc6d6449e4f7cfb1c2708,2021-08-20T00:00:00.000Z,NEFT CR-DEUT0797BGL-FLIPKART INTERNET PR IVATE LIMITED-SLICK ORGANICS PVT LTD-123 200110GN00040,shopping,,net_banking_transfer,7809.33
626247d7d8beac1599c69610,50200023535069,871519.55,60ec41ba55c00300382672d9,HDFC,direct expenses,5eecc6d6449e4f7cfb1c2708,2021-08-20T00:00:00.000Z,POS 514834XXXXXX9486 THE ROCKET SCIEN,,,debit_card,-13879.53
626247d7d8beac1599c69612,50200023535069,872302.91,60ec41ba55c00300382672d9,HDFC,Transfer in/Revenue-other,5eecc6d6449e4f7cfb1c2708,2021-08-20T00:00:00.000Z,NEFT CR-YESB0000001-ILUMINAR MEDIA-SLICK,,,net_banking_transfer,783.36
626247d7d8beac1599c69614,50200023535069,947516.73,60ec41ba55c00300382672d9,HDFC,Revenue-PG-split enabled,5eecc6d6449e4f7cfb1c2708,2021-08-20T00:00:00.000Z,NEFT CR-UTIB0001506-RAZORPAY SOFTWARE PR IVATE LIMITED-SLICK ORGANICS PVT LITD-AX ISCN0088850057,insurance,,net_banking_transfer,75213.82
626247d7d8beac1599c69616,50200023535069,948729.15,60ec41ba55c00300382672d9,HDFC,Revenue-Mktplace,5eecc6d6449e4f7cfb1c2708,2021-08-20T00:00:00.000Z,NEFT CR-DEUT0784BBY-TATA UNISTORE LIMITE D-SLICK ORGANICS PVT LTD-123202251GN0008 5,insurance,,net_banking_transfer,1212.42
626247d7d8beac1599c69618,50200023535069,949267.9,60ec41ba55c00300382672d9,HDFC,Revenue-Mktplace,5eecc6d6449e4f7cfb1c2708,2021-08-20T00:00:00.000Z,NEFT CR-DEUT0784BBY-TATA UNISTORE LIMITE D-SLICK ORGANICS PVT LTD-123202263GN0013 6,insurance,,net_banking_transfer,538.75
626247d7d8beac1599c6961a,50200023535069,949870.06,60ec41ba55c00300382672d9,HDFC,Revenue-Mktplace,5eecc6d6449e4f7cfb1c2708,2021-08-20T00:00:00.000Z,NEFT CR-DEUT0784BBY-TATA UNISTORE LTD-NO DAL-SLICK ORGANICS PVT LTD-123202276GN00 203,insurance,,net_banking_transfer,602.16
626247d7d8beac1599c6961c,50200023535069,942498.32,60ec41ba55c00300382672d9,HDFC,direct expenses,5eecc6d6449e4f7cfb1c2708,2021-08-20T00:00:00.000Z,POS 514834XXXXXX9486 HOTJAR,,,debit_card,-7371.74
626247d7d8beac1599c6961e,50200023535069,1044580.22,60ec41ba55c00300382672d9,HDFC,Revenue-PG-non-split,5eecc6d6449e4f7cfb1c2708,2021-08-21T00:00:00.000Z,IMPS-123306635466-ONE97 COMMUNICATIONS-H DFC-XXXXXXXXXX0007-ALL202108212168200003 30830668628,ewallet,,net_banking_transfer,102081.9
626247d7d8beac1599c69620,50200023535069,1045436.86,60ec41ba55c00300382672d9,HDFC,Revenue-PG-split enabled,5eecc6d6449e4f7cfb1c2708,2021-08-21T00:00:00.000Z,NEFT CR-UTIB0001506-RAZORPAY SOFTWARE PR IVATE LIMITED-SLICK ORGANICS PVT LITD-AX ISCN0088940845,insurance,,net_banking_transfer,856.64
626247d7d8beac1599c69622,50200023535069,1048307.3,60ec41ba55c00300382672d9,HDFC,Revenue-Mktplace,5eecc6d6449e4f7cfb1c2708,2021-08-21T00:00:00.000Z,NEFT CR-ICIC0000105-ICICI BANK NODAL AC MANASH LIFESTYL-SLICK ORGANICS PRIVATE L IMITED BANG-ICIJ212330003563,,,net_banking_transfer,2870.44
626247d7d8beac1599c69624,50200023535069,1050190.41,60ec41ba55c00300382672d9,HDFC,Revenue-Mktplace,5eecc6d6449e4f7cfb1c2708,2021-08-21T00:00:00.000Z,NEFT CR-ICIC0000105-ICICI BANK NODAL AC MANASH LIFESTYL-SLICK ORGANICS PRIVATE L IMITED MP G-ICIJ212330003559,,,net_banking_transfer,1883.11
626247d7d8beac1599c69626,50200023535069,1053222.12,60ec41ba55c00300382672d9,HDFC,Revenue-Mktplace,5eecc6d6449e4f7cfb1c2708,2021-08-21T00:00:00.000Z,NEFT CR-ICIC0000105-ICICI BANK NODAL AC MANASH LIFESTYL-SLICK ORGANICS PRIVATE L IMITED MP M-ICIJ212330003561,,,net_banking_transfer,3031.71
626247d7d8beac1599c69628,50200023535069,1056727.12,60ec41ba55c00300382672d9,HDFC,Transfer in/Revenue-other,5eecc6d6449e4f7cfb1c2708,2021-08-21T00:00:00.000Z,NEFT CR-KKBK0000958-INNOVATIVE RETAIL CO,,,net_banking_transfer,3505
626247d7d8beac1599c6962a,50200023535069,1070594.77,60ec41ba55c00300382672d9,HDFC,Revenue-PG-split enabled,5eecc6d6449e4f7cfb1c2708,2021-08-21T00:00:00.000Z,NEFT CR-UTIB0001506-RAZORPAY SOFTWARE PR IVATE LIMITED-SLICK ORGANICS PVT LITD-AX ISCN0089006227,insurance,,net_banking_transfer,13867.65
626247d7d8beac1599c6962c,50200023535069,1091844.52,60ec41ba55c00300382672d9,HDFC,Revenue-PG-non-split,5eecc6d6449e4f7cfb1c2708,2021-08-22T00:00:00.000Z,IMPS-123405712389-ONE97 COMMUNICATIONS-H DFC-XXXXXXXXXX0007-ALL202108222168200003 30830668628,ewallet,,net_banking_transfer,21249.75
626247d7d8beac1599c6962e,50200023535069,1093874.82,60ec41ba55c00300382672d9,HDFC,Revenue-Mktplace,5eecc6d6449e4f7cfb1c2708,2021-08-23T00:00:00.000Z,NEFT CR-DEUT0797BGL-FLIPKART INTERNET PR IVATE LIMITED-SLICK ORGANICS PVT LTD-123 500108GN00185,shopping,,net_banking_transfer,2030.3
626247d7d8beac1599c69630,50200023535069,1106870.3,60ec41ba55c00300382672d9,HDFC,Revenue-PG-split enabled,5eecc6d6449e4f7cfb1c2708,2021-08-23T00:00:00.000Z,NEFT CR-UTIB0001506-RAZORPAY SOFTWARE PR IVATE LIMITED-SLICK ORGANICS PVT LITD-AX ISCN0089038253,insurance,,net_banking_transfer,12995.48
626247d7d8beac1599c69632,50200023535069,1113317.2,60ec41ba55c00300382672d9,HDFC,Revenue-Mktplace,5eecc6d6449e4f7cfb1c2708,2021-08-23T00:00:00.000Z,NEFT CR-DEUT0797BGL-MYNTRA DESIGNS PRIVA TE LIMITED-SLICK ORGANICS PRIVATE LIMITE D-123500374GN00154,shopping,,net_banking_transfer,6446.9
626247d7d8beac1599c69634,50200023535069,1113166.94,60ec41ba55c00300382672d9,HDFC,bank charges,5eecc6d6449e4f7cfb1c2708,2021-08-23T00:00:00.000Z,.DC INTL POS TXN MARKUP+ST 160821 170821 -CDT2122605298681,,,international_transaction_arbitrage,-150.26
626247d7d8beac1599c69636,50200023535069,1152741.53,60ec41ba55c00300382672d9,HDFC,Revenue-PG-non-split,5eecc6d6449e4f7cfb1c2708,2021-08-23T00:00:00.000Z,NEFT CR-PYTM0123456-ONE97 COMMUNICATIONS LIMITED-SLICK ORGANICS PVT LTD-PYTM2123 56360041,ewallet,,net_banking_transfer,39574.59
626247d7d8beac1599c69638,50200023535069,1352741.53,60ec41ba55c00300382672d9,HDFC,Internal Transfers,5eecc6d6449e4f7cfb1c2708,2021-08-23T00:00:00.000Z,IB FUNDS TRANSFER CR-50200035187206 -SL ICK ORGANICS PVT LTD,insurance,,Other,200000
626247d7d8beac1599c6963b,50200023535069,127580.53,60ec41ba55c00300382672d9,HDFC,Marketing Expense,5eecc6d6449e4f7cfb1c2708,2021-08-23T00:00:00.000Z,"NEFT DR-CITI0000006-FACEBOOK INDIA ONLIN E SERVICES PVT LTD-NETBANK, MUM-N2352116 09639960-1225161",,,net_banking_transfer,-1225161
626247d7d8beac1599c6963d,50200023535069,129430.65,60ec41ba55c00300382672d9,HDFC,Revenue-Mktplace,5eecc6d6449e4f7cfb1c2708,2021-08-23T00:00:00.000Z,NEFT CR-DEUT0797BGL-MYNTRA DESIGNS PRIVA TE LIMITED-SLICK ORGANICS PRIVATE LIMITE D-123500375GN00132,shopping,,net_banking_transfer,1850.12
626247d7d8beac1599c6963f,50200023535069,138803.17,60ec41ba55c00300382672d9,HDFC,Revenue-Mktplace,5eecc6d6449e4f7cfb1c2708,2021-08-23T00:00:00.000Z,NEFT CR-DEUT0797BGL-FLIPKART INTERNET PR IVATE LIMITED-SLICK ORGANICS PVT LTD-123 500113GN00267,shopping,,net_banking_transfer,9372.52
626247d7d8beac1599c69641,50200023535069,142525.38,60ec41ba55c00300382672d9,HDFC,Transfer in/Revenue-other,5eecc6d6449e4f7cfb1c2708,2021-08-23T00:00:00.000Z,NEFT CR-ICIC0000105-ICICI BANK NODAL AC,,,net_banking_transfer,3722.21
626247d7d8beac1599c69643,50200023535069,142739.01,60ec41ba55c00300382672d9,HDFC,Revenue-PG-split enabled,5eecc6d6449e4f7cfb1c2708,2021-08-23T00:00:00.000Z,NEFT CR-UTIB0001506-RAZORPAY SOFTWARE PR IVATE LIMITED-SLICK ORGANICS PVT LITD-AX ISCN0089135708,insurance,,net_banking_transfer,213.63
626247d7d8beac1599c69645,50200023535069,148985.67,60ec41ba55c00300382672d9,HDFC,Revenue-PG-non-split,5eecc6d6449e4f7cfb1c2708,2021-08-23T00:00:00.000Z,NEFT CR-IDFB0010204-SEZZLE PAYMENTS PRIV ATE LIMITED-SLICK ORGANICS PRIVATE LIMIT ED-IDFBH21235427467,insurance,,net_banking_transfer,6246.66
626247d7d8beac1599c69647,50200023535069,155653.9,60ec41ba55c00300382672d9,HDFC,Revenue-COD,5eecc6d6449e4f7cfb1c2708,2021-08-23T00:00:00.000Z,NEFT CR-ICIC0000155-SHIPROCKET COD CRF I D 2918371-SLICK ORGANICS PVT LTD-CMS2088 328778,insurance,,net_banking_transfer,6668.23
626247d7d8beac1599c69649,50200023535069,176211.64,60ec41ba55c00300382672d9,HDFC,Revenue-PG-non-split,5eecc6d6449e4f7cfb1c2708,2021-08-24T00:00:00.000Z,IMPS-123605786726-ONE97 COMMUNICATIONS-H DFC-XXXXXXXXXX0007-ALL202108242168200003 30830668628,ewallet,,net_banking_transfer,20557.74
626247d7d8beac1599c6964b,50200023535069,245700.97,60ec41ba55c00300382672d9,HDFC,Revenue-Mktplace,5eecc6d6449e4f7cfb1c2708,2021-08-24T00:00:00.000Z,IMPS-123605312027-AMAZON SELLER SERVIC-H DFC-XXXXXXXX6004-7EPXZRT9J8LCEGANSLICK O RGANICS PVT LTD,shopping,,net_banking_transfer,69489.33
626247d7d8beac1599c6964d,50200023535069,195700.97,60ec41ba55c00300382672d9,HDFC,Marketing Expense,5eecc6d6449e4f7cfb1c2708,2021-08-24T00:00:00.000Z,POS 514834XXXXXX9486 GOOGLE ADS,,,debit_card,-50000
626247d7d8beac1599c6964f,50200023535069,591517.49,60ec41ba55c00300382672d9,HDFC,Revenue-Mktplace,5eecc6d6449e4f7cfb1c2708,2021-08-24T00:00:00.000Z,NEFT CR-DEUT0797BGL-AMAZON PAY (INDIA) P RIVATE LIMITED-SLICK ORGANICS PVT LTD-12 3600094GN00371,shopping,,net_banking_transfer,395816.52
626247d7d8beac1599c69651,50200023535069,594336.56,60ec41ba55c00300382672d9,HDFC,Revenue-PG-split enabled,5eecc6d6449e4f7cfb1c2708,2021-08-24T00:00:00.000Z,NEFT CR-UTIB0001506-RAZORPAY SOFTWARE PR IVATE LIMITED-SLICK ORGANICS PVT LITD-AX ISCN0089168251,insurance,,net_banking_transfer,2819.07
626247d7d8beac1599c69653,50200023535069,598490.61,60ec41ba55c00300382672d9,HDFC,Revenue-PG-non-split,5eecc6d6449e4f7cfb1c2708,2021-08-24T00:00:00.000Z,NEFT CR-SCBL0036001-STRIPE INDIA PRIVATE -SLICK ORGANICS PRIVATE LIMITED-SSG17413 Q0361904,insurance,,net_banking_transfer,4154.05
626247d7d8beac1599c69655,50200023535069,578490.61,60ec41ba55c00300382672d9,HDFC,direct expenses,5eecc6d6449e4f7cfb1c2708,2021-08-24T00:00:00.000Z,"SELF - CHQ PAID - KALKAJI, NEW",,,chq,-20000
626247d7d8beac1599c69657,50200023535069,578275.41,60ec41ba55c00300382672d9,HDFC,bank charges,5eecc6d6449e4f7cfb1c2708,2021-08-24T00:00:00.000Z,.DC INTL POS TXN MARKUP+ST 190821 210821 -CDT2122605298681,,,international_transaction_arbitrage,-215.2
626247d7d8beac1599c69659,50200023535069,584367.24,60ec41ba55c00300382672d9,HDFC,Revenue-PG-split enabled,5eecc6d6449e4f7cfb1c2708,2021-08-24T00:00:00.000Z,NEFT CR-UTIB0001506-RAZORPAY SOFTWARE PR,,,net_banking_transfer,6091.83
626247d7d8beac1599c6965b,50200023535069,610404.24,60ec41ba55c00300382672d9,HDFC,Revenue-Mktplace,5eecc6d6449e4f7cfb1c2708,2021-08-24T00:00:00.000Z,NEFT CR-SCBL0036001-M/S DREAMPLUG TECHNO -SLICK ORGANICS PRIVATE LIMITEDSLICK-SIN 31436Q0018637,insurance,,net_banking_transfer,26037
626247d7d8beac1599c6965d,50200023535069,613778.51,60ec41ba55c00300382672d9,HDFC,Revenue-PG-non-split,5eecc6d6449e4f7cfb1c2708,2021-08-24T00:00:00.000Z,NEFT CR-IDFB0010204-SEZZLE PAYMENTS PRIV ATE LIMITED-SLICK ORGANICS PRIVATE LIMIT ED-IDFBH21236587149,insurance,,net_banking_transfer,3374.27
626247d7d8beac1599c6965f,50200023535069,781886.32,60ec41ba55c00300382672d9,HDFC,Revenue-Mktplace,5eecc6d6449e4f7cfb1c2708,2021-08-24T00:00:00.000Z,NEFT CR-KKBK0000958-NYKAA E RETAIL PRIVA TE LIMITED NYKAA-SLICK ORGANICS PVT LTD- KKBK212361649528,insurance,,net_banking_transfer,168107.81
626247d7d8beac1599c69661,50200023535069,812776.95,60ec41ba55c00300382672d9,HDFC,Revenue-PG-non-split,5eecc6d6449e4f7cfb1c2708,2021-08-25T00:00:00.000Z,IMPS-123705768124-ONE97 COMMUNICATIONS-H DFC-XXXXXXXXXX0007-ALL202108252168200003 30830668628,ewallet,,net_banking_transfer,30890.63
626247d7d8beac1599c69663,50200023535069,818498.78,60ec41ba55c00300382672d9,HDFC,Revenue-Mktplace,5eecc6d6449e4f7cfb1c2708,2021-08-25T00:00:00.000Z,NEFT CR-DEUT0797BGL-FLIPKART INTERNET PR IVATE LIMITED-SLICK ORGANICS PVT LTD-123 700350GN00003,shopping,,net_banking_transfer,5721.83
626247d7d8beac1599c69665,50200023535069,831109.4,60ec41ba55c00300382672d9,HDFC,Revenue-PG-split enabled,5eecc6d6449e4f7cfb1c2708,2021-08-25T00:00:00.000Z,NEFT CR-UTIB0001506-RAZORPAY SOFTWARE PR IVATE LIMITED-SLICK ORGANICS PVT LITD-AX ISCN0089523577,insurance,,net_banking_transfer,12610.62
626247d7d8beac1599c69667,50200023535069,631109.4,60ec41ba55c00300382672d9,HDFC,direct expenses,5eecc6d6449e4f7cfb1c2708,2021-08-25T00:00:00.000Z,"NEFT DR-YESB0000551-VISTTA COSMETICS-NET BANK, MUM-N237211611775413-200000",,,net_banking_transfer,-200000
626247d7d8beac1599c69669,50200023535069,623280.4,60ec41ba55c00300382672d9,HDFC,direct expenses,5eecc6d6449e4f7cfb1c2708,2021-08-25T00:00:00.000Z,"NEFT DR-UCBA0001393-MOHMMAD YASIN FAZILI -NETBANK, MUM-N237211611927787-7829",,,net_banking_transfer,-7829
626247d7d8beac1599c6966b,50200023535069,621474.4,60ec41ba55c00300382672d9,HDFC,direct expenses,5eecc6d6449e4f7cfb1c2708,2021-08-25T00:00:00.000Z,"NEFT DR-SBIN0001859-PARSHOTAM AND ASSOCI ATES-NETBANK, MUM-N237211612025883-1806",,,net_banking_transfer,-1806
626247d7d8beac1599c6966d,50200023535069,631569.46,60ec41ba55c00300382672d9,HDFC,Revenue-Mktplace,5eecc6d6449e4f7cfb1c2708,2021-08-25T00:00:00.000Z,NEFT CR-DEUT0797BGL-FLIPKART INTERNET PR IVATE LIMITED-SLICK ORGANICS PVT LTD-123 700355GN00092,shopping,,net_banking_transfer,10095.06
626247d7d8beac1599c6966f,50200023535069,632141.2,60ec41ba55c00300382672d9,HDFC,Revenue-Mktplace,5eecc6d6449e4f7cfb1c2708,2021-08-25T00:00:00.000Z,NEFT CR-ICIC0000105-ICICI BANK NODAL AC MANASH LIFESTYL-SLICK ORGANICS PRIVATE L IMITED HYD-ICIJ212370004418,,,net_banking_transfer,571.74
626247d7d8beac1599c69671,50200023535069,632963.62,60ec41ba55c00300382672d9,HDFC,Transfer in/Revenue-other,5eecc6d6449e4f7cfb1c2708,2021-08-25T00:00:00.000Z,NEFT CR-ICIC0000105-ICICI BANK NODAL AC,,,net_banking_transfer,822.42
626247d7d8beac1599c69674,50200023535069,633398.28,60ec41ba55c00300382672d9,HDFC,Revenue-Mktplace,5eecc6d6449e4f7cfb1c2708,2021-08-25T00:00:00.000Z,NEFT CR-ICIC0000105-ICICI BANK NODAL AC MANASH LIFESTYL-SLICK ORGANICS PRIVATE L IMITED KOLK-ICIJ212370006188,,,net_banking_transfer,434.66
626247d7d8beac1599c69677,50200023535069,635059.27,60ec41ba55c00300382672d9,HDFC,Revenue-Mktplace,5eecc6d6449e4f7cfb1c2708,2021-08-25T00:00:00.000Z,NEFT CR-ICIC0000105-ICICI BANK NODAL AC MANASH LIFESTYL-SLICK ORGANICS PRIVATE L IMITED MP M-ICIJ212370004416,,,net_banking_transfer,1660.99
626247d7d8beac1599c69679,50200023535069,635936.65,60ec41ba55c00300382672d9,HDFC,Revenue-Mktplace,5eecc6d6449e4f7cfb1c2708,2021-08-25T00:00:00.000Z,NEFT CR-ICIC0000105-ICICI BANK NODAL AC MANASH LIFESTYL-SLICK ORGANICS PRIVATE L IMITED BANG-ICIJ212370004419,,,net_banking_transfer,877.38
626247d7d8beac1599c6967b,50200023535069,637406.17,60ec41ba55c00300382672d9,HDFC,Revenue-PG-split enabled,5eecc6d6449e4f7cfb1c2708,2021-08-25T00:00:00.000Z,NEFT CR-UTIB0001506-RAZORPAY SOFTWARE PR IVATE LIMITED-SLICK ORGANICS PVT LITD-AX ISCN0089605820,insurance,,net_banking_transfer,1469.52
626247d7d8beac1599c6967d,50200023535069,660601.31,60ec41ba55c00300382672d9,HDFC,Revenue-PG-non-split,5eecc6d6449e4f7cfb1c2708,2021-08-26T00:00:00.000Z,IMPS-123805792275-ONE97 COMMUNICATIONS-H DFC-XXXXXXXXXX0007-ALL202108262168200003 30830668628,ewallet,,net_banking_transfer,23195.14
626247d7d8beac1599c6967f,50200023535069,661929.38,60ec41ba55c00300382672d9,HDFC,Revenue-PG-split enabled,5eecc6d6449e4f7cfb1c2708,2021-08-26T00:00:00.000Z,NEFT CR-UTIB0001506-RAZORPAY SOFTWARE PR IVATE LIMITED-SLICK ORGANICS PVT LITD-AX ISCN0089650865,insurance,,net_banking_transfer,1328.07
626247d7d8beac1599c69681,50200023535069,646593.38,60ec41ba55c00300382672d9,HDFC,direct expenses,5eecc6d6449e4f7cfb1c2708,2021-08-26T00:00:00.000Z,"NEFT DR-ICIC0000021-AKHILESH DIXIT-NETBA NK, MUM-N238211612906342-15336",,,net_banking_transfer,-15336
626247d7d8beac1599c69683,50200023535069,646288.93,60ec41ba55c00300382672d9,HDFC,bank charges,5eecc6d6449e4f7cfb1c2708,2021-08-26T00:00:00.000Z,.DC INTL POS TXN MARKUP+ST 200821 220821 -CDT2122605298681,,,international_transaction_arbitrage,-304.45
626247d7d8beac1599c69685,50200023535069,446288.93,60ec41ba55c00300382672d9,HDFC,direct expenses,5eecc6d6449e4f7cfb1c2708,2021-08-26T00:00:00.000Z,"NEFT DR-PYTM0123456-PAYTM-NETBANK, MUM-N 238211613083638-200000",ewallet,,net_banking_transfer,-200000
626247d7d8beac1599c69687,50200023535069,446289.93,60ec41ba55c00300382672d9,HDFC,Transfer in/Revenue-other,5eecc6d6449e4f7cfb1c2708,2021-08-26T00:00:00.000Z,IMPS-123814035642-ACC VALIDATION BY ME-H DFC-XXXXXXXX1002-BANK ACCOUNT VALIDATION,,,net_banking_transfer,1
626247d7d8beac1599c69689,50200023535069,443814.41,60ec41ba55c00300382672d9,HDFC,direct expenses,5eecc6d6449e4f7cfb1c2708,2021-08-26T00:00:00.000Z,POS 514834XXXXXX9486 RAZ*KNOWLARITY,,,debit_card,-2475.52
626247d7d8beac1599c6968b,50200023535069,457249.65,60ec41ba55c00300382672d9,HDFC,Revenue-PG-split enabled,5eecc6d6449e4f7cfb1c2708,2021-08-26T00:00:00.000Z,NEFT CR-UTIB0001506-RAZORPAY SOFTWARE PR,,,net_banking_transfer,13435.24
626247d7d8beac1599c6968d,50200023535069,458978.37,60ec41ba55c00300382672d9,HDFC,Revenue-PG-non-split,5eecc6d6449e4f7cfb1c2708,2021-08-26T00:00:00.000Z,NEFT CR-IDFB0010204-SEZZLE PAYMENTS PRIV ATE LIMITED-SLICK ORGANICS PRIVATE LIMIT ED-IDFBH21238749479,insurance,,net_banking_transfer,1728.72
626247d7d8beac1599c6968f,50200023535069,482087.4,60ec41ba55c00300382672d9,HDFC,Revenue-PG-non-split,5eecc6d6449e4f7cfb1c2708,2021-08-27T00:00:00.000Z,IMPS-123905742024-ONE97 COMMUNICATIONS-H DFC-XXXXXXXXXX0007-ALL202108272168200003 30830668628,ewallet,,net_banking_transfer,23109.03
626247d8d8beac1599c69691,50200023535069,492734.88,60ec41ba55c00300382672d9,HDFC,Revenue-PG-split enabled,5eecc6d6449e4f7cfb1c2708,2021-08-27T00:00:00.000Z,NEFT CR-UTIB0001506-RAZORPAY SOFTWARE PR IVATE LIMITED-SLICK ORGANICS PVT LITD-AX ISCN0089764242,insurance,,net_banking_transfer,10647.48
626247d8d8beac1599c69693,50200023535069,500310.81,60ec41ba55c00300382672d9,HDFC,Revenue-Mktplace,5eecc6d6449e4f7cfb1c2708,2021-08-27T00:00:00.000Z,NEFT CR-DEUT0797BGL-FLIPKART INTERNET PR IVATE LIMITED-SLICK ORGANICS PVT LTD-123 900143GN00108,shopping,,net_banking_transfer,7575.93
626247d8d8beac1599c69695,50200023535069,500720.13,60ec41ba55c00300382672d9,HDFC,Transfer in/Revenue-other,5eecc6d6449e4f7cfb1c2708,2021-08-27T00:00:00.000Z,NEFT CR-ICIC0SF0002-ICICI BANK NODAL A-C -SLICK ORGANICS-24849484591DC,insurance,,net_banking_transfer,409.32
626247d8d8beac1599c69697,50200023535069,338720.13,60ec41ba55c00300382672d9,HDFC,direct expenses,5eecc6d6449e4f7cfb1c2708,2021-08-27T00:00:00.000Z,50200059455690-TPT-162000-KAMIYA SAMAR V ERMA,,,net_banking_transfer,-162000
626247d8d8beac1599c69699,50200023535069,346830.74,60ec41ba55c00300382672d9,HDFC,Revenue-Mktplace,5eecc6d6449e4f7cfb1c2708,2021-08-27T00:00:00.000Z,NEFT CR-DEUT0797BGL-FLIPKART INTERNET PR IVATE LIMITED-SLICK ORGANICS PVT LTD-123 900148GN00081,shopping,,net_banking_transfer,8110.61
626247d8d8beac1599c6969b,50200023535069,354478.13,60ec41ba55c00300382672d9,HDFC,Revenue-PG-non-split,5eecc6d6449e4f7cfb1c2708,2021-08-27T00:00:00.000Z,NEFT CR-SCBL0036001-STRIPE INDIA PRIVATE -SLICK ORGANICS PRIVATE LIMITED-SSG17413 Q0368419,insurance,,net_banking_transfer,7647.39
626247d8d8beac1599c6969d,50200023535069,356482.18,60ec41ba55c00300382672d9,HDFC,Revenue-Mktplace,5eecc6d6449e4f7cfb1c2708,2021-08-27T00:00:00.000Z,NEFT CR-ICIC0000105-ICICI BANK NODAL AC MANASH LIFESTYL-SLICK ORGANICS PRIVATE L IMITED MP G-ICIJ212390004502,,,net_banking_transfer,2004.05
626247d8d8beac1599c6969f,50200023535069,357467.34,60ec41ba55c00300382672d9,HDFC,Revenue-Mktplace,5eecc6d6449e4f7cfb1c2708,2021-08-27T00:00:00.000Z,NEFT CR-ICIC0000105-ICICI BANK NODAL AC MANASH LIFESTYL-SLICK ORGANICS PRIVATE L IMITED HYD-ICIJ212390002363,,,net_banking_transfer,985.16
626247d8d8beac1599c696a1,50200023535069,357659.39,60ec41ba55c00300382672d9,HDFC,Revenue-Mktplace,5eecc6d6449e4f7cfb1c2708,2021-08-27T00:00:00.000Z,NEFT CR-ICIC0000105-ICICI BANK NODAL AC MANASH LIFESTYL-SLICK ORGANICS PRIVATE L IMITED KOLK-ICIJ212390002362,,,net_banking_transfer,192.05
626247d8d8beac1599c696a3,50200023535069,359143.73,60ec41ba55c00300382672d9,HDFC,Transfer in/Revenue-other,5eecc6d6449e4f7cfb1c2708,2021-08-27T00:00:00.000Z,NEFT CR-ICIC0000105-ICICI BANK NODAL AC,,,net_banking_transfer,1484.34
626247d8d8beac1599c696a5,50200023535069,359867.36,60ec41ba55c00300382672d9,HDFC,Revenue-PG-non-split,5eecc6d6449e4f7cfb1c2708,2021-08-27T00:00:00.000Z,NEFT CR-IDFB0010204-SEZZLE PAYMENTS PRIV ATE LIMITED-SLICK ORGANICS PRIVATE LIMIT ED-IDFBH21239802104,insurance,,net_banking_transfer,723.63
626247d8d8beac1599c696a7,50200023535069,361074.74,60ec41ba55c00300382672d9,HDFC,Revenue-Mktplace,5eecc6d6449e4f7cfb1c2708,2021-08-27T00:00:00.000Z,NEFT CR-DEUT0784BBY-TATA UNISTORE LIMITE D-SLICK ORGANICS PVT LTD-123901875GN0031 7,insurance,,net_banking_transfer,1207.38
626247d8d8beac1599c696a9,50200023535069,361876.3,60ec41ba55c00300382672d9,HDFC,Revenue-Mktplace,5eecc6d6449e4f7cfb1c2708,2021-08-27T00:00:00.000Z,NEFT CR-DEUT0784BBY-TATA UNISTORE LTD-NO DAL-SLICK ORGANICS PVT LTD-123901886GN00 480,insurance,,net_banking_transfer,801.56
626247d8d8beac1599c696ab,50200023535069,363400.9,60ec41ba55c00300382672d9,HDFC,Revenue-Mktplace,5eecc6d6449e4f7cfb1c2708,2021-08-27T00:00:00.000Z,NEFT CR-DEUT0784BBY-TATA UNISTORE LTD-NO DAL-SLICK ORGANICS PVT LTD-123901886GN00 650,insurance,,net_banking_transfer,1524.6
626247d8d8beac1599c696ad,50200023535069,384196.91,60ec41ba55c00300382672d9,HDFC,Revenue-PG-split enabled,5eecc6d6449e4f7cfb1c2708,2021-08-27T00:00:00.000Z,NEFT CR-UTIB0001506-RAZORPAY SOFTWARE PR IVATE LIMITED-SLICK ORGANICS PVT LITD-AX ISCN0089963600,insurance,,net_banking_transfer,20796.01
626247d8d8beac1599c696af,50200023535069,129196.91,60ec41ba55c00300382672d9,HDFC,SAAS/tech expense,5eecc6d6449e4f7cfb1c2708,2021-08-27T00:00:00.000Z,WHDF0227514154/BILLDKAMAZONSELLERSE,shopping,,Other,-255000
626247d8d8beac1599c696b1,50200023535069,161870.19,60ec41ba55c00300382672d9,HDFC,Revenue-PG-non-split,5eecc6d6449e4f7cfb1c2708,2021-08-28T00:00:00.000Z,IMPS-124005724175-ONE97 COMMUNICATIONS-H DFC-XXXXXXXXXX0007-ALL202108282168200003 30830668628,ewallet,,net_banking_transfer,32673.28
626247d8d8beac1599c696b3,50200023535069,111870.19,60ec41ba55c00300382672d9,HDFC,Marketing Expense,5eecc6d6449e4f7cfb1c2708,2021-08-28T00:00:00.000Z,POS 514834XXXXXX9486 GOOGLE ADS,,,debit_card,-50000
626247d8d8beac1599c696b5,50200023535069,137952.2,60ec41ba55c00300382672d9,HDFC,Revenue-PG-non-split,5eecc6d6449e4f7cfb1c2708,2021-08-29T00:00:00.000Z,IMPS-124105820376-ONE97 COMMUNICATIONS-H DFC-XXXXXXXXXX0007-ALL202108292168200003 30830668628,ewallet,,net_banking_transfer,26082.01
626247d8d8beac1599c696b7,50200023535069,179034.81,60ec41ba55c00300382672d9,HDFC,Revenue-PG-non-split,5eecc6d6449e4f7cfb1c2708,2021-08-30T00:00:00.000Z,IMPS-124204713420-ONE97 COMMUNICATIONS-H DFC-XXXXXXXXXX0007-ALL202108302168200003 30830668628,ewallet,,net_banking_transfer,41082.61
626247d8d8beac1599c696b9,50200023535069,223662.25,60ec41ba55c00300382672d9,HDFC,Revenue-PG-split enabled,5eecc6d6449e4f7cfb1c2708,2021-08-30T00:00:00.000Z,NEFT CR-UTIB0001506-RAZORPAY SOFTWARE PR IVATE LIMITED-SLICK ORGANICS PVT LITD-AX ISCN0090111518,insurance,,net_banking_transfer,44627.44
626247d8d8beac1599c696bb,50200023535069,229788.42,60ec41ba55c00300382672d9,HDFC,Revenue-Mktplace,5eecc6d6449e4f7cfb1c2708,2021-08-30T00:00:00.000Z,NEFT CR-DEUT0797BGL-FLIPKART INTERNET PR,shopping,,net_banking_transfer,6126.17
626247d8d8beac1599c696bd,50200023535069,200786.79,60ec41ba55c00300382672d9,HDFC,SAAS/tech expense,5eecc6d6449e4f7cfb1c2708,2021-08-30T00:00:00.000Z,POS 514834XXXXXX9486 AMAZON SELLER RE,shopping,,debit_card,-29001.63
626247d8d8beac1599c696bf,50200023535069,206681.6,60ec41ba55c00300382672d9,HDFC,Revenue-Mktplace,5eecc6d6449e4f7cfb1c2708,2021-08-30T00:00:00.000Z,NEFT CR-DEUT0797BGL-FLIPKART INTERNET PR IVATE LIMITED-SLICK ORGANICS PVT LTD-124 200116GN00262,shopping,,net_banking_transfer,5894.81
626247d8d8beac1599c696c1,50200023535069,211330.31,60ec41ba55c00300382672d9,HDFC,Revenue-PG-split enabled,5eecc6d6449e4f7cfb1c2708,2021-08-30T00:00:00.000Z,NEFT CR-UTIB0001506-RAZORPAY SOFTWARE PR IVATE LIMITED-SLICK ORGANICS PVT LITD-AX ISCN0090255772,insurance,,net_banking_transfer,4648.71
626247d8d8beac1599c696c3,50200023535069,211577.33,60ec41ba55c00300382672d9,HDFC,Revenue-Mktplace,5eecc6d6449e4f7cfb1c2708,2021-08-30T00:00:00.000Z,NEFT CR-ICIC0000105-ICICI BANK NODAL AC MANASH LIFESTYL-SLICK ORGANICS PRIVATE L IMITED BANG-ICIJ212420001359,,,net_banking_transfer,247.02
626247d8d8beac1599c696c5,50200023535069,212099.23,60ec41ba55c00300382672d9,HDFC,Revenue-Mktplace,5eecc6d6449e4f7cfb1c2708,2021-08-30T00:00:00.000Z,NEFT CR-ICIC0000105-ICICI BANK NODAL AC MANASH LIFESTYL-SLICK ORGANICS PRIVATE L IMITED MP M-ICIJ212420001356,,,net_banking_transfer,521.9
626247d8d8beac1599c696c7,50200023535069,212346.25,60ec41ba55c00300382672d9,HDFC,Revenue-Mktplace,5eecc6d6449e4f7cfb1c2708,2021-08-30T00:00:00.000Z,NEFT CR-ICIC0000105-ICICI BANK NODAL AC MANASH LIFESTYL-SLICK ORGANICS PRIVATE L IMITED HYD-ICIJ212420001358,,,net_banking_transfer,247.02
626247d8d8beac1599c696c9,50200023535069,212593.27,60ec41ba55c00300382672d9,HDFC,Revenue-Mktplace,5eecc6d6449e4f7cfb1c2708,2021-08-30T00:00:00.000Z,NEFT CR-ICIC0000105-ICICI BANK NODAL AC MANASH LIFESTYL-SLICK ORGANICS PRIVATE L IMITED KOLK-ICIJ212420003017,,,net_banking_transfer,247.02
626247d8d8beac1599c696cb,50200023535069,212881.32,60ec41ba55c00300382672d9,HDFC,Revenue-Mktplace,5eecc6d6449e4f7cfb1c2708,2021-08-30T00:00:00.000Z,NEFT CR-ICIC0000105-ICICI BANK NODAL AC MANASH LIFESTYL-SLICK ORGANICS PRIVATE L IMITED MP G-ICIJ212420001354,,,net_banking_transfer,288.05
626247d8d8beac1599c696cd,50200023535069,333396.69,60ec41ba55c00300382672d9,HDFC,Revenue-Mktplace,5eecc6d6449e4f7cfb1c2708,2021-08-31T00:00:00.000Z,IMPS-124305019683-AMAZON SELLER SERVIC-H DFC-XXXXXXXX6004-1E2STMTJPD8D14ZQSLICK O RGANICS PVT LTD,shopping,,net_banking_transfer,120515.37
626247d8d8beac1599c696cf,50200023535069,357446.66,60ec41ba55c00300382672d9,HDFC,Revenue-PG-non-split,5eecc6d6449e4f7cfb1c2708,2021-08-31T00:00:00.000Z,IMPS-124305901124-ONE97 COMMUNICATIONS-H DFC-XXXXXXXXXX0007-ALL202108312168200003 30830668628,ewallet,,net_banking_transfer,24049.97
626247d8d8beac1599c696d1,50200023535069,785836.67,60ec41ba55c00300382672d9,HDFC,Revenue-Mktplace,5eecc6d6449e4f7cfb1c2708,2021-08-31T00:00:00.000Z,NEFT CR-DEUT0797BGL-AMAZON PAY (INDIA) P,shopping,,net_banking_transfer,428390.01
626247d8d8beac1599c696d3,50200023535069,794450.04,60ec41ba55c00300382672d9,HDFC,Revenue-PG-split enabled,5eecc6d6449e4f7cfb1c2708,2021-08-31T00:00:00.000Z,NEFT CR-UTIB0001506-RAZORPAY SOFTWARE PR IVATE LIMITED-SLICK ORGANICS PVT LITD-AX ISCN0090292504,insurance,,net_banking_transfer,8613.37
626247d8d8beac1599c696d6,50200023535069,789450.04,60ec41ba55c00300382672d9,HDFC,direct expenses,5eecc6d6449e4f7cfb1c2708,2021-08-31T00:00:00.000Z,IMPS-124311165292-AKHILESH DIXIT-ICIC-XX XXXXXX5528-5000,,,net_banking_transfer,-5000
626247d8d8beac1599c696d8,50200023535069,790706.04,60ec41ba55c00300382672d9,HDFC,Transfer in/Revenue-other,5eecc6d6449e4f7cfb1c2708,2021-08-31T00:00:00.000Z,NEFT CR-ICIC0SF0002-EARTH LOVE ECOMMERCE -SLICK ORGANICS PVT LTD-24870952201DC,,,net_banking_transfer,1256
626247d8d8beac1599c696da,50200023535069,792243.88,60ec41ba55c00300382672d9,HDFC,Revenue-Mktplace,5eecc6d6449e4f7cfb1c2708,2021-08-31T00:00:00.000Z,NEFT CR-ICIC0000105-MANASH LIFETYLE PVT LTD-SLICK ORGANICS PRIVATE LIMITED MP GG N-ICIB212430014721,,,net_banking_transfer,1537.84
626247d8d8beac1599c696dc,50200023535069,793672.51,60ec41ba55c00300382672d9,HDFC,Revenue-Mktplace,5eecc6d6449e4f7cfb1c2708,2021-08-31T00:00:00.000Z,NEFT CR-ICIC0000105-MANASH LIFETYLE PVT LTD-SLICK ORGANICS PRIVATE LIMITED HYD- ICIB212430016400,,,net_banking_transfer,1428.63
626247d8d8beac1599c696df,50200023535069,793837.43,60ec41ba55c00300382672d9,HDFC,Revenue-Mktplace,5eecc6d6449e4f7cfb1c2708,2021-08-31T00:00:00.000Z,NEFT CR-ICIC0000105-MANASH LIFETYLE PVT LTD-SLICK ORGANICS PRIVATE LIMITED KOLK ATA-ICIB212430016398,,,net_banking_transfer,164.92
626247d8d8beac1599c696e1,50200023535069,794977.98,60ec41ba55c00300382672d9,HDFC,Revenue-Mktplace,5eecc6d6449e4f7cfb1c2708,2021-08-31T00:00:00.000Z,NEFT CR-ICIC0000105-MANASH LIFETYLE PVT LTD-SLICK ORGANICS PRIVATE LIMITED MP MU M-ICIB212430016396,,,net_banking_transfer,1140.55
626247d8d8beac1599c696e3,50200023535069,807275.95,60ec41ba55c00300382672d9,HDFC,Revenue-PG-split enabled,5eecc6d6449e4f7cfb1c2708,2021-08-31T00:00:00.000Z,NEFT CR-UTIB0001506-RAZORPAY SOFTWARE PR IVATE LIMITED-SLICK ORGANICS PVT LITD-AX ISCN0090396202,insurance,,net_banking_transfer,12297.97
626247d8d8beac1599c696e5,50200023535069,810389.63,60ec41ba55c00300382672d9,HDFC,Revenue-PG-non-split,5eecc6d6449e4f7cfb1c2708,2021-08-31T00:00:00.000Z,NEFT CR-IDFB0010204-SEZZLE PAYMENTS PRIV,,,net_banking_transfer,3113.68
626247ecd8beac1599c6a098,50200023535069,846310.41,60ec41ba55c00300382672d9,HDFC,SAAS/tech expense,5eecc6d6449e4f7cfb1c2708,2022-02-28T00:00:00.000Z,ME DC SI 514834XXXXXX9486 AMAZON,shopping,,Other,-179
626247ecd8beac1599c6a09b,50200023535069,869331.29,60ec41ba55c00300382672d9,HDFC,Revenue-PG-non-split,5eecc6d6449e4f7cfb1c2708,2022-03-01T00:00:00.000Z,IMPS-206004088479-PAYTM PAYMENTS SERVI-P YTM-XXXXXXXXXX0008-ALL202203012168200003 30830668628,ewallet,,net_banking_transfer,23020.88
626247ecd8beac1599c6a09d,50200023535069,875872.77,60ec41ba55c00300382672d9,HDFC,Revenue-Mktplace,5eecc6d6449e4f7cfb1c2708,2022-03-01T00:00:00.000Z,NEFT CR-DEUT0797BGL-MYNTRA DESIGNS PRIVA TE LIMITED-SLICK ORGANICS PVT. LTD.-2060 00385GN00227,shopping,,net_banking_transfer,6541.48
626247ecd8beac1599c6a09f,50200023535069,873672.39,60ec41ba55c00300382672d9,HDFC,direct expenses,5eecc6d6449e4f7cfb1c2708,2022-03-01T00:00:00.000Z,POS 514834XXXXXX9486 SEOPTIMER,,,debit_card,-2200.38
626247ecd8beac1599c6a0a1,50200023535069,913426.88,60ec41ba55c00300382672d9,HDFC,Revenue-UPI,5eecc6d6449e4f7cfb1c2708,2022-03-01T00:00:00.000Z,UPI-GOKWIK-GOKWIK@YESBANK-YESB0000340-20 6093927881-PAYOUT FOR FEBRUAR,,,upi,39754.49
626247ecd8beac1599c6a0a3,50200023535069,916584.88,60ec41ba55c00300382672d9,HDFC,Revenue-COD,5eecc6d6449e4f7cfb1c2708,2022-03-01T00:00:00.000Z,NEFT CR-KKBK0000958-PICKRR TECHNOLOGIES PVT LTD-SLICKORGANICSPRIVATELIMITED-CMS0 602208880059,insurance,,net_banking_transfer,3158
626247ecd8beac1599c6a0a5,50200023535069,939709.52,60ec41ba55c00300382672d9,HDFC,Revenue-Mktplace,5eecc6d6449e4f7cfb1c2708,2022-03-02T00:00:00.000Z,NEFT CR-DEUT0797BGL-FLIPKART INTERNET PR IVATE LIMITED-SLICK ORGANICS PVT LTD-206 100100GN00005,shopping,,net_banking_transfer,23124.64
626247ecd8beac1599c6a0a7,50200023535069,975764.8,60ec41ba55c00300382672d9,HDFC,Revenue-PG-non-split,5eecc6d6449e4f7cfb1c2708,2022-03-02T00:00:00.000Z,NEFT CR-PYTM0123456-PAYTM PAYMENTS SERVI CES LIMITED-SLICK ORGANICS PVT LTD-PYTM2 20611621188,ewallet,,net_banking_transfer,36055.28
626247ecd8beac1599c6a0a9,50200023535069,750764.8,60ec41ba55c00300382672d9,HDFC,direct expenses,5eecc6d6449e4f7cfb1c2708,2022-03-02T00:00:00.000Z,02711930004579-TPT-225000-DHRUV BHASIN,,,net_banking_transfer,-225000
626247ecd8beac1599c6a0ab,50200023535069,525764.8,60ec41ba55c00300382672d9,HDFC,direct expenses,5eecc6d6449e4f7cfb1c2708,2022-03-02T00:00:00.000Z,"NEFT DR-SCBL0036025-DHRUV MADHOK-NETBANK , MUM-N061221854063958-225000",,,net_banking_transfer,-225000
626247ecd8beac1599c6a0ad,50200023535069,417764.8,60ec41ba55c00300382672d9,HDFC,direct expenses,5eecc6d6449e4f7cfb1c2708,2022-03-02T00:00:00.000Z,50200060178580-TPT-108000-CITREA GROWTH PARTNERS PRIVATE LIMITED,,,net_banking_transfer,-108000
626247ecd8beac1599c6a0af,50200023535069,117764.8,60ec41ba55c00300382672d9,HDFC,direct expenses,5eecc6d6449e4f7cfb1c2708,2022-03-02T00:00:00.000Z,"NEFT DR-YESB0000551-VISTTA COSMETICS-NET BANK, MUM-N061221854058608-300000",,,net_banking_transfer,-300000
626247ecd8beac1599c6a0b1,50200023535069,121446.25,60ec41ba55c00300382672d9,HDFC,Revenue-Mktplace,5eecc6d6449e4f7cfb1c2708,2022-03-02T00:00:00.000Z,NEFT CR-DEUT0797BGL-MYNTRA DESIGNS PRIVA,shopping,,net_banking_transfer,3681.45
626247ecd8beac1599c6a0b3,50200023535069,122135.95,60ec41ba55c00300382672d9,HDFC,Revenue-PG-split enabled,5eecc6d6449e4f7cfb1c2708,2022-03-02T00:00:00.000Z,NEFT CR-UTIB0001506-RAZORPAY SOFTWARE PR IVATE LIMITED-SLICK ORGANICS PVT LITD-AX ISCN0124529986,insurance,,net_banking_transfer,689.7
626247ecd8beac1599c6a0b5,50200023535069,125339.32,60ec41ba55c00300382672d9,HDFC,Revenue-Mktplace,5eecc6d6449e4f7cfb1c2708,2022-03-02T00:00:00.000Z,NEFT CR-DEUT0797BGL-MYNTRA DESIGNS PRIVA TE LIMITED-SLICK ORGANICS PVT. LTD.-2061 00697GN00235,shopping,,net_banking_transfer,3203.37
626247ecd8beac1599c6a0b7,50200023535069,158866.53,60ec41ba55c00300382672d9,HDFC,Revenue-Mktplace,5eecc6d6449e4f7cfb1c2708,2022-03-02T00:00:00.000Z,NEFT CR-HSBC0400002-AMAZON SERVICES LLC- SLICK ORGANICS PRIVATE LIMITED-HSBCN2206 1182363,shopping,,net_banking_transfer,33527.21
626247ecd8beac1599c6a0b9,50200023535069,1113185.53,60ec41ba55c00300382672d9,HDFC,Internal Transfers,5eecc6d6449e4f7cfb1c2708,2022-03-02T00:00:00.000Z,IB FUNDS TRANSFER CR-50200035187206 -SL ICK ORGANICS PVT LTD,insurance,,Other,954319
626247ecd8beac1599c6a0bb,50200023535069,113185.53,60ec41ba55c00300382672d9,HDFC,Marketing Expense,5eecc6d6449e4f7cfb1c2708,2022-03-02T00:00:00.000Z,"NEFT DR-CITI0000006-FACEBOOK INDIA ONLIN E SERVICES PVT LTD-NETBANK, MUM-N0612218 54214705-1000000",,,net_banking_transfer,-1000000
626247ecd8beac1599c6a0bd,50200023535069,413184.53,60ec41ba55c00300382672d9,HDFC,Internal Transfers,5eecc6d6449e4f7cfb1c2708,2022-03-02T00:00:00.000Z,IB FUNDS TRANSFER CR-50200035187206 -SL ICK ORGANICS PVT LTD,insurance,,Other,299999
626247ecd8beac1599c6a0bf,50200023535069,158184.53,60ec41ba55c00300382672d9,HDFC,SAAS/tech expense,5eecc6d6449e4f7cfb1c2708,2022-03-02T00:00:00.000Z,POS 514834XXXXXX9486 AMAZON,shopping,,debit_card,-255000
626247ecd8beac1599c6a0c1,50200023535069,145858.53,60ec41ba55c00300382672d9,HDFC,direct expenses,5eecc6d6449e4f7cfb1c2708,2022-03-02T00:00:00.000Z,02711600008220-TPT-12326-VARUN SINGH,,,net_banking_transfer,-12326
626247ecd8beac1599c6a0c3,50200023535069,-4141.47,60ec41ba55c00300382672d9,HDFC,direct expenses,5eecc6d6449e4f7cfb1c2708,2022-03-02T00:00:00.000Z,"NEFT DR-INDB0000148-ACQUISORY INDIA CONS ULTING PVT LTD-NETBANK, MUM-N06122185468 5219-150000",,,net_banking_transfer,-150000
626247ecd8beac1599c6a0c5,50200023535069,395858.53,60ec41ba55c00300382672d9,HDFC,Internal Transfers,5eecc6d6449e4f7cfb1c2708,2022-03-02T00:00:00.000Z,IB FUNDS TRANSFER CR-50200035187206 -SL ICK ORGANICS PVT LTD,insurance,,Other,400000
626247ecd8beac1599c6a0c7,50200023535069,453313.26,60ec41ba55c00300382672d9,HDFC,Revenue-UPI,5eecc6d6449e4f7cfb1c2708,2022-03-02T00:00:00.000Z,UPI-GOKWIK-GOKWIK@YESBANK-YESB0000340-20 6196072088-PAYOUT FOR FEBRUAR,,,upi,57454.73
626247ecd8beac1599c6a0c9,50200023535069,453464.28,60ec41ba55c00300382672d9,HDFC,Revenue-Mktplace,5eecc6d6449e4f7cfb1c2708,2022-03-02T00:00:00.000Z,NEFT CR-ICIC0000105-MANASH LIFESTYLE PRI VATE LIMITED NO-SLICK ORGANICS PRIVATE L IMITED MP M-ICIJ220610014113,shopping,,net_banking_transfer,151.02
626247ecd8beac1599c6a0cb,50200023535069,454177.51,60ec41ba55c00300382672d9,HDFC,Revenue-Mktplace,5eecc6d6449e4f7cfb1c2708,2022-03-02T00:00:00.000Z,NEFT CR-ICIC0000105-MANASH LIFESTYLE PRI VATE LIMITED NO-SLICK ORGANICS PRIVATE L IMITED MP G-ICIJ220610014111,shopping,,net_banking_transfer,713.23
626247ecd8beac1599c6a0cd,50200023535069,429930.14,60ec41ba55c00300382672d9,HDFC,SAAS/tech expense,5eecc6d6449e4f7cfb1c2708,2022-03-02T00:00:00.000Z,POS 514834XXXXXX9486 AMAZON.COM,shopping,,debit_card,-24247.37
626247ecd8beac1599c6a0cf,50200023535069,575211.37,60ec41ba55c00300382672d9,HDFC,Revenue-COD,5eecc6d6449e4f7cfb1c2708,2022-03-02T00:00:00.000Z,NEFT CR-ICIC0000155-SHIPROCKET COD CRF I D 3904027-SLICK ORGANICS PVT LTD-CMS2427 741786,insurance,,net_banking_transfer,145281.23
626247ecd8beac1599c6a0d1,50200023535069,575604.79,60ec41ba55c00300382672d9,HDFC,Revenue-PG-split enabled,5eecc6d6449e4f7cfb1c2708,2022-03-02T00:00:00.000Z,NEFT CR-UTIB0001506-RAZORPAY SOFTWARE PR IVATE LIMITED-SLICK ORGANICS PVT LITD-AX ISCN0124652750,insurance,,net_banking_transfer,393.42
626247ecd8beac1599c6a0d3,50200023535069,576906.19,60ec41ba55c00300382672d9,HDFC,Revenue-PG-non-split,5eecc6d6449e4f7cfb1c2708,2022-03-02T00:00:00.000Z,NEFT CR-IDFB0010204-SEZZLE PAYMENTS PRIV ATE LIMITED-SLICK ORGANICS PRIVATE LIMIT ED-IDFBH22061717643,insurance,,net_banking_transfer,1301.4
626247ecd8beac1599c6a0d5,50200023535069,590429.7,60ec41ba55c00300382672d9,HDFC,Revenue-PG-non-split,5eecc6d6449e4f7cfb1c2708,2022-03-03T00:00:00.000Z,IMPS-206204927674-PAYTM PAYMENTS SERVI-P YTM-XXXXXXXXXX0008-ALL202203032168200003 30830668628,ewallet,,net_banking_transfer,13523.51
626247ecd8beac1599c6a0d7,50200023535069,594360.7,60ec41ba55c00300382672d9,HDFC,Transfer in/Revenue-other,5eecc6d6449e4f7cfb1c2708,2022-03-03T00:00:00.000Z,50200050675669-TPT-REMITTANCE OG FEB22-H OUZ OF NATURE PVT LTD,,,net_banking_transfer,3931
626247ecd8beac1599c6a0df,50200023535069,595356.2,60ec41ba55c00300382672d9,HDFC,Revenue-PG-split enabled,5eecc6d6449e4f7cfb1c2708,2022-03-03T00:00:00.000Z,NEFT CR-UTIB0001506-RAZORPAY SOFTWARE PR IVATE LIMITED-SLICK ORGANICS PVT LITD-AX ISCN0124716129,insurance,,net_banking_transfer,995.5
626247ecd8beac1599c6a0ef,50200023535069,596798.76,60ec41ba55c00300382672d9,HDFC,Revenue-Mktplace,5eecc6d6449e4f7cfb1c2708,2022-03-03T00:00:00.000Z,NEFT CR-ICIC0000105-MANASH LIFESTYLE PRI VATE LIMITED NO-SLICK ORGANICS PRIVATE L IMITED MP M-ICIJ220620006683,shopping,,net_banking_transfer,1442.56
626247ecd8beac1599c6a105,50200023535069,597207.78,60ec41ba55c00300382672d9,HDFC,Revenue-Mktplace,5eecc6d6449e4f7cfb1c2708,2022-03-03T00:00:00.000Z,NEFT CR-ICIC0000105-MANASH LIFESTYLE PRI VATE LIMITED NO-SLICK ORGANICS PRIVATE L IMITED BANG-ICIJ220620006685,shopping,,net_banking_transfer,409.02
626247ecd8beac1599c6a116,50200023535069,597920.98,60ec41ba55c00300382672d9,HDFC,Revenue-Mktplace,5eecc6d6449e4f7cfb1c2708,2022-03-03T00:00:00.000Z,NEFT CR-ICIC0000105-MANASH LIFESTYLE PRI VATE LIMITED NO-SLICK ORGANICS PRIVATE L IMITED MP G-ICIJ220620006681,shopping,,net_banking_transfer,713.2
626247ecd8beac1599c6a118,50200023535069,598467.79,60ec41ba55c00300382672d9,HDFC,Revenue-Mktplace,5eecc6d6449e4f7cfb1c2708,2022-03-03T00:00:00.000Z,NEFT CR-ICIC0000105-MANASH LIFESTYLE PRI VATE LIMITED NO-SLICK ORGANICS PRIVATE L IMITED KOLK-ICIJ220620006684,shopping,,net_banking_transfer,546.81
626247ecd8beac1599c6a11a,50200023535069,531600.79,60ec41ba55c00300382672d9,HDFC,direct expenses,5eecc6d6449e4f7cfb1c2708,2022-03-03T00:00:00.000Z,NEFT DR-INDB0000275-LASH TECHNOLOGIES PR,,,net_banking_transfer,-66867
626247ecd8beac1599c6a11c,50200023535069,430823.79,60ec41ba55c00300382672d9,HDFC,direct expenses,5eecc6d6449e4f7cfb1c2708,2022-03-03T00:00:00.000Z,"NEFT DR-YESB0000058-SIXTEENBY9 VIDEO WOR KS-NETBANK, MUM-N062221857325719-100777",,,net_banking_transfer,-100777
626247ecd8beac1599c6a11f,50200023535069,357270.79,60ec41ba55c00300382672d9,HDFC,direct expenses,5eecc6d6449e4f7cfb1c2708,2022-03-03T00:00:00.000Z,"NEFT DR-INDB0000275-LASH TECHNOLOGIES PR IVATE LIMITED-NETBANK, MUM-N062221857361 643-73553",,,net_banking_transfer,-73553
626247ecd8beac1599c6a121,50200023535069,367352.87,60ec41ba55c00300382672d9,HDFC,Revenue-PG-split enabled,5eecc6d6449e4f7cfb1c2708,2022-03-03T00:00:00.000Z,NEFT CR-UTIB0001506-RAZORPAY SOFTWARE PR IVATE LIMITED-SLICK ORGANICS PVT LITD-AX ISCN0124830898,insurance,,net_banking_transfer,10082.08
626247ecd8beac1599c6a123,50200023535069,390733.34,60ec41ba55c00300382672d9,HDFC,Revenue-UPI,5eecc6d6449e4f7cfb1c2708,2022-03-03T00:00:00.000Z,UPI-GOKWIK-GOKWIK@YESBANK-YESB0000340-20 6298915657-PAYOUT FOR MARCH 1,,,upi,23380.47
626247ecd8beac1599c6a125,50200023535069,397802.19,60ec41ba55c00300382672d9,HDFC,Revenue-Mktplace,5eecc6d6449e4f7cfb1c2708,2022-03-04T00:00:00.000Z,NEFT CR-DEUT0797BGL-FLIPKART INTERNET PR IVATE LIMITED-SLICK ORGANICS PVT LTD-206 300114GN00208,shopping,,net_banking_transfer,7068.85
626247ecd8beac1599c6a127,50200023535069,414666.21,60ec41ba55c00300382672d9,HDFC,Revenue-PG-non-split,5eecc6d6449e4f7cfb1c2708,2022-03-04T00:00:00.000Z,IMPS-206304471995-PAYTM PAYMENTS SERVI-P YTM-XXXXXXXXXX0008-ALL202203042168200003 30830668628,ewallet,,net_banking_transfer,16864.02
626247ecd8beac1599c6a129,50200023535069,419552.9,60ec41ba55c00300382672d9,HDFC,Revenue-Mktplace,5eecc6d6449e4f7cfb1c2708,2022-03-04T00:00:00.000Z,NEFT CR-DEUT0797BGL-MYNTRA DESIGNS PRIVA TE LIMITED-SLICK ORGANICS PVT. LTD.-2063 00560GN00219,shopping,,net_banking_transfer,4886.69
626247edd8beac1599c6a12b,50200023535069,421079.36,60ec41ba55c00300382672d9,HDFC,Revenue-Mktplace,5eecc6d6449e4f7cfb1c2708,2022-03-04T00:00:00.000Z,NEFT CR-DEUT0797BGL-MYNTRA DESIGNS PRIVA TE LIMITED-SLICK ORGANICS PVT. LTD.-2063 00559GN00202,shopping,,net_banking_transfer,1526.46
626247edd8beac1599c6a12d,50200023535069,432082.79,60ec41ba55c00300382672d9,HDFC,Revenue-PG-split enabled,5eecc6d6449e4f7cfb1c2708,2022-03-04T00:00:00.000Z,NEFT CR-UTIB0001506-RAZORPAY SOFTWARE PR IVATE LIMITED-SLICK ORGANICS PVT LITD-AX ISCN0124878795,insurance,,net_banking_transfer,11003.43
626247edd8beac1599c6a12f,50200023535069,437082.79,60ec41ba55c00300382672d9,HDFC,Revenue-UPI,5eecc6d6449e4f7cfb1c2708,2022-03-04T00:00:00.000Z,UPI-JITENDER KUMAR SAGAR-JITENDERSAGAR91 @OKICICI-ICIC0003851-206309339720-UPI,,,upi,5000
626247edd8beac1599c6a131,50200023535069,398032.79,60ec41ba55c00300382672d9,HDFC,direct expenses,5eecc6d6449e4f7cfb1c2708,2022-03-04T00:00:00.000Z,"NEFT DR-ICIC0001370-LIGHT SPEED ENTERPRI SES-NETBANK, MUM-N063221858716191-39050",,,net_banking_transfer,-39050
626247edd8beac1599c6a133,50200023535069,406115.79,60ec41ba55c00300382672d9,HDFC,Revenue-Mktplace,5eecc6d6449e4f7cfb1c2708,2022-03-04T00:00:00.000Z,NEFT CR-SCBL0036001-M/S DREAMPLUG TECHNO,,,net_banking_transfer,8083
626247edd8beac1599c6a135,50200023535069,408550.19,60ec41ba55c00300382672d9,HDFC,Revenue-PG-non-split,5eecc6d6449e4f7cfb1c2708,2022-03-04T00:00:00.000Z,NEFT CR-IDFB0010204-SEZZLE PAYMENTS PRIV ATE LIMITED-SLICK ORGANICS PRIVATE LIMIT ED-IDFBH22063896277,insurance,,net_banking_transfer,2434.4
626247edd8beac1599c6a137,50200023535069,410130.32,60ec41ba55c00300382672d9,HDFC,Revenue-PG-non-split,5eecc6d6449e4f7cfb1c2708,2022-03-04T00:00:00.000Z,NEFT CR-IDFB0010204-SEZZLE PAYMENTS PRIV ATE LIMITED-SLICK ORGANICS PRIVATE LIMIT ED-IDFBH22063896567,insurance,,net_banking_transfer,1580.13
626247edd8beac1599c6a139,50200023535069,349080.32,60ec41ba55c00300382672d9,HDFC,direct expenses,5eecc6d6449e4f7cfb1c2708,2022-03-04T00:00:00.000Z,"NEFT DR-YESB0000162-VINAY REDDY-NETBANK, MUM-N063221859117624-61050",,,net_banking_transfer,-61050
626247edd8beac1599c6a13b,50200023535069,351069.69,60ec41ba55c00300382672d9,HDFC,Revenue-Mktplace,5eecc6d6449e4f7cfb1c2708,2022-03-04T00:00:00.000Z,NEFT CR-ICIC0000105-MANASH LIFESTYLE PRI VATE LIMITED NO-SLICK ORGANICS PRIVATE L IMITED MP G-ICIJ220630019893,shopping,,net_banking_transfer,1989.37
626247edd8beac1599c6a13d,50200023535069,351343.83,60ec41ba55c00300382672d9,HDFC,Revenue-Mktplace,5eecc6d6449e4f7cfb1c2708,2022-03-04T00:00:00.000Z,NEFT CR-ICIC0000105-MANASH LIFESTYLE PRI VATE LIMITED NO-SLICK ORGANICS PRIVATE L IMITED MP M-ICIJ220630019895,shopping,,net_banking_transfer,274.14
626247edd8beac1599c6a13f,50200023535069,297503.83,60ec41ba55c00300382672d9,HDFC,direct expenses,5eecc6d6449e4f7cfb1c2708,2022-03-04T00:00:00.000Z,"NEFT DR-YESB0000058-SIXTEENBY9 VIDEO WOR KS-NETBANK, MUM-N063221859167430-53840",,,net_banking_transfer,-53840
626247edd8beac1599c6a141,50200023535069,81503.83,60ec41ba55c00300382672d9,HDFC,direct expenses,5eecc6d6449e4f7cfb1c2708,2022-03-04T00:00:00.000Z,"NEFT DR-UTIB0000514-NATS ASSOCIATES-NETB ANK, MUM-N063221859171448-216000",,,net_banking_transfer,-216000
626247edd8beac1599c6a143,50200023535069,81351.07,60ec41ba55c00300382672d9,HDFC,bank charges,5eecc6d6449e4f7cfb1c2708,2022-03-04T00:00:00.000Z,.DC INTL POS TXN MARKUP+ST 120222 140222 -CDT2206308248860,,,international_transaction_arbitrage,-152.76
626247edd8beac1599c6a145,50200023535069,81945.74,60ec41ba55c00300382672d9,HDFC,Revenue-Mktplace,5eecc6d6449e4f7cfb1c2708,2022-03-04T00:00:00.000Z,NEFT CR-DEUT0784BBY-TATA UNISTORE LTD-NO DAL-SLICK ORGANICS PVT LTD-206301763GN00 385,insurance,,net_banking_transfer,594.67
626247edd8beac1599c6a147,50200023535069,120945.65,60ec41ba55c00300382672d9,HDFC,Revenue-COD,5eecc6d6449e4f7cfb1c2708,2022-03-04T00:00:00.000Z,NEFT CR-ICIC0000155-SHIPROCKET COD CRF I D 3924440-SLICK ORGANICS PVT LTD-CMS2432 829707,insurance,,net_banking_transfer,38999.91
626247edd8beac1599c6a149,50200023535069,120967.06,60ec41ba55c00300382672d9,HDFC,Adjustments/Reversal,5eecc6d6449e4f7cfb1c2708,2022-03-04T00:00:00.000Z,DEBIT CARD PUR ADJ DT 02/03/22,,,Other,21.41
626247edd8beac1599c6a14b,50200023535069,130213.83,60ec41ba55c00300382672d9,HDFC,Revenue-PG-split enabled,5eecc6d6449e4f7cfb1c2708,2022-03-04T00:00:00.000Z,NEFT CR-UTIB0001506-RAZORPAY SOFTWARE PR IVATE LIMITED-SLICK ORGANICS PVT LITD-AX ISCN0125039974,insurance,,net_banking_transfer,9246.77
626247edd8beac1599c6a14d,50200023535069,182472.07,60ec41ba55c00300382672d9,HDFC,Revenue-UPI,5eecc6d6449e4f7cfb1c2708,2022-03-04T00:00:00.000Z,UPI-GOKWIK-GOKWIK@YESBANK-YESB0000340-20,,,upi,52258.24
626247edd8beac1599c6a14f,50200023535069,206001.3,60ec41ba55c00300382672d9,HDFC,Revenue-PG-non-split,5eecc6d6449e4f7cfb1c2708,2022-03-05T00:00:00.000Z,IMPS-206404089525-PAYTM PAYMENTS SERVI-P YTM-XXXXXXXXXX0008-ALL202203052168200003 30830668628,ewallet,,net_banking_transfer,23529.23
626247edd8beac1599c6a152,50200023535069,207996.08,60ec41ba55c00300382672d9,HDFC,Revenue-PG-split enabled,5eecc6d6449e4f7cfb1c2708,2022-03-05T00:00:00.000Z,NEFT CR-UTIB0001506-RAZORPAY SOFTWARE PR IVATE LIMITED-SLICK ORGANICS PVT LITD-AX ISCN0125064690,insurance,,net_banking_transfer,1994.78
626247edd8beac1599c6a154,50200023535069,202996.08,60ec41ba55c00300382672d9,HDFC,direct expenses,5eecc6d6449e4f7cfb1c2708,2022-03-05T00:00:00.000Z,59209167284838-TPT-5000-ISHA RAGHUNATH M AHABAL,,,net_banking_transfer,-5000
626247edd8beac1599c6a157,50200023535069,200496.08,60ec41ba55c00300382672d9,HDFC,direct expenses,5eecc6d6449e4f7cfb1c2708,2022-03-05T00:00:00.000Z,50100337146994-TPT-2500-AGRIMA KUMAR,,,net_banking_transfer,-2500
626247edd8beac1599c6a159,50200023535069,190496.08,60ec41ba55c00300382672d9,HDFC,direct expenses,5eecc6d6449e4f7cfb1c2708,2022-03-05T00:00:00.000Z,03551930002310-TPT-10000-SHILPA PAVAN TO LANI,,,net_banking_transfer,-10000
626247edd8beac1599c6a15b,50200023535069,460940.64,60ec41ba55c00300382672d9,HDFC,Revenue-Mktplace,5eecc6d6449e4f7cfb1c2708,2022-03-05T00:00:00.000Z,NEFT CR-KKBK0000958-NYKAA E RETAIL PRIVA TE LIMITED NYKAA-SLICK ORGANICS PVT LTD- KKBK220645144829,insurance,,net_banking_transfer,270444.56
626247edd8beac1599c6a15d,50200023535069,494863.2,60ec41ba55c00300382672d9,HDFC,Revenue-UPI,5eecc6d6449e4f7cfb1c2708,2022-03-05T00:00:00.000Z,UPI-GOKWIK-GOKWIK@YESBANK-YESB0000340-20 6402658148-PAYOUT FOR MARCH 3,,,upi,33922.56
626247edd8beac1599c6a15f,50200023535069,502189.65,60ec41ba55c00300382672d9,HDFC,Revenue-PG-split enabled,5eecc6d6449e4f7cfb1c2708,2022-03-05T00:00:00.000Z,NEFT CR-UTIB0001506-RAZORPAY SOFTWARE PR IVATE LIMITED-SLICK ORGANICS PVT LITD-AX ISCN0125149604,insurance,,net_banking_transfer,7326.45
626247edd8beac1599c6a161,50200023535069,529467.65,60ec41ba55c00300382672d9,HDFC,Revenue-PG-non-split,5eecc6d6449e4f7cfb1c2708,2022-03-06T00:00:00.000Z,NEFT CR-PYTM0123456-PAYTM PAYMENTS SERVI CES LIMITED-SLICK ORGANICS PVT LTD-PYTM2 20654056139,ewallet,,net_banking_transfer,27278
626247edd8beac1599c6a163,50200023535069,517263.65,60ec41ba55c00300382672d9,HDFC,direct expenses,5eecc6d6449e4f7cfb1c2708,2022-03-06T00:00:00.000Z,"NEFT DR-SBIN0001859-PARSHOTAM AND ASSOCI ATES-NETBANK, MUM-N065221861355589-12204",,,net_banking_transfer,-12204
626247edd8beac1599c6a166,50200023535069,2417263.65,60ec41ba55c00300382672d9,HDFC,Internal Transfers,5eecc6d6449e4f7cfb1c2708,2022-03-06T00:00:00.000Z,IB FUNDS TRANSFER CR-50200035187206 -SL ICK ORGANICS PVT LTD,insurance,,Other,1900000
626247edd8beac1599c6a168,50200023535069,2392263.65,60ec41ba55c00300382672d9,HDFC,direct expenses,5eecc6d6449e4f7cfb1c2708,2022-03-06T00:00:00.000Z,"NEFT DR-ICIC0004328-MICHELLE MANUEL-NETB ANK, MUM-N065221861348064-25000",,,net_banking_transfer,-25000
626247edd8beac1599c6a16a,50200023535069,2067216.65,60ec41ba55c00300382672d9,HDFC,direct expenses,5eecc6d6449e4f7cfb1c2708,2022-03-06T00:00:00.000Z,50200029847721-TPT-325047-SPITI CONSULTI NG,,,net_banking_transfer,-325047
626247edd8beac1599c6a16c,50200023535069,2067418.54,60ec41ba55c00300382672d9,HDFC,Revenue-PG-non-split,5eecc6d6449e4f7cfb1c2708,2022-03-06T00:00:00.000Z,NEFT CR-UTIB0001506-RZPX PRIVATE LIMITED,,,net_banking_transfer,201.89
626247edd8beac1599c6a16e,50200023535069,2111127.8,60ec41ba55c00300382672d9,HDFC,Revenue-UPI,5eecc6d6449e4f7cfb1c2708,2022-03-06T00:00:00.000Z,UPI-GOKWIK-GOKWIK@YESBANK-YESB0000340-20 6504718423-PAYOUT FOR MARCH 4,,,upi,43709.26
626247edd8beac1599c6a170,50200023535069,2121916.26,60ec41ba55c00300382672d9,HDFC,Revenue-Mktplace,5eecc6d6449e4f7cfb1c2708,2022-03-07T00:00:00.000Z,NEFT CR-DEUT0797BGL-FLIPKART INTERNET PR IVATE LIMITED-SLICK ORGANICS PVT LTD-206 600132GN00191,shopping,,net_banking_transfer,10788.46
626247edd8beac1599c6a172,50200023535069,2139848.15,60ec41ba55c00300382672d9,HDFC,Revenue-PG-non-split,5eecc6d6449e4f7cfb1c2708,2022-03-07T00:00:00.000Z,IMPS-206604295719-PAYTM PAYMENTS SERVI-P YTM-XXXXXXXXXX0008-ALL202203072168200003 30830668628,ewallet,,net_banking_transfer,17931.89
626247edd8beac1599c6a174,50200023535069,2141550.62,60ec41ba55c00300382672d9,HDFC,Revenue-Mktplace,5eecc6d6449e4f7cfb1c2708,2022-03-07T00:00:00.000Z,NEFT CR-DEUT0797BGL-MYNTRA DESIGNS PRIVA TE LIMITED-SLICK ORGANICS PVT. LTD.-2066 00571GN00225,shopping,,net_banking_transfer,1702.47
626247edd8beac1599c6a176,50200023535069,2147940.34,60ec41ba55c00300382672d9,HDFC,Revenue-Mktplace,5eecc6d6449e4f7cfb1c2708,2022-03-07T00:00:00.000Z,NEFT CR-DEUT0797BGL-MYNTRA DESIGNS PRIVA TE LIMITED-SLICK ORGANICS PVT. LTD.-2066 00572GN00225,shopping,,net_banking_transfer,6389.72
626247edd8beac1599c6a178,50200023535069,2184672.42,60ec41ba55c00300382672d9,HDFC,Revenue-PG-split enabled,5eecc6d6449e4f7cfb1c2708,2022-03-07T00:00:00.000Z,NEFT CR-UTIB0001506-RAZORPAY SOFTWARE PR IVATE LIMITED-SLICK ORGANICS PVT LITD-AX ISCN0125218012,insurance,,net_banking_transfer,36732.08
626247edd8beac1599c6a17a,50200023535069,2289735.89,60ec41ba55c00300382672d9,HDFC,Revenue-Mktplace,5eecc6d6449e4f7cfb1c2708,2022-03-07T00:00:00.000Z,IMPS-206612230792-AMAZON SELLER SERVIC-H SBC-XXXXXXXX6004-3EIVW6SZQGWRUAIRSLICK O RGANICS PVT LTD,shopping,,net_banking_transfer,105063.47
626247edd8beac1599c6a17d,50200023535069,2787006.58,60ec41ba55c00300382672d9,HDFC,Revenue-Mktplace,5eecc6d6449e4f7cfb1c2708,2022-03-07T00:00:00.000Z,NEFT CR-DEUT0797BGL-AMAZON PAY (INDIA) P RIVATE LIMITED-SLICK ORGANICS PVT LTD-20 6600827GN00465,shopping,,net_banking_transfer,497270.69
626247edd8beac1599c6a17f,50200023535069,2731506.58,60ec41ba55c00300382672d9,HDFC,direct expenses,5eecc6d6449e4f7cfb1c2708,2022-03-07T00:00:00.000Z,50100293329616-TPT-55500-SADIYA BANO,,,net_banking_transfer,-55500
626247edd8beac1599c6a181,50200023535069,2681506.58,60ec41ba55c00300382672d9,HDFC,direct expenses,5eecc6d6449e4f7cfb1c2708,2022-03-07T00:00:00.000Z,"NEFT DR-UTIB0000120-ADNAN ALI-NETBANK, M UM-N066221862517558-50000",,,net_banking_transfer,-50000
626247edd8beac1599c6a183,50200023535069,2631506.58,60ec41ba55c00300382672d9,HDFC,direct expenses,5eecc6d6449e4f7cfb1c2708,2022-03-07T00:00:00.000Z,"NEFT DR-ICIC0003851-JITENDER KUMAR-NETBA NK, MUM-N066221862518706-50000",,,net_banking_transfer,-50000
626247edd8beac1599c6a185,50200023535069,2581506.58,60ec41ba55c00300382672d9,HDFC,direct expenses,5eecc6d6449e4f7cfb1c2708,2022-03-07T00:00:00.000Z,50100064106714-TPT-50000-AKSHARANSH BHAT T,,,net_banking_transfer,-50000
626247edd8beac1599c6a187,50200023535069,2545506.58,60ec41ba55c00300382672d9,HDFC,direct expenses,5eecc6d6449e4f7cfb1c2708,2022-03-07T00:00:00.000Z,00901610080520-TPT-36000-POOJA KAPIL SHR,,,net_banking_transfer,-36000
626247edd8beac1599c6a189,50200023535069,2515506.58,60ec41ba55c00300382672d9,HDFC,direct expenses,5eecc6d6449e4f7cfb1c2708,2022-03-07T00:00:00.000Z,"NEFT DR-KKBK0008365-SRIRAJ GUNDA-NETBANK , MUM-N066221862550620-30000",,,net_banking_transfer,-30000
626247edd8beac1599c6a18b,50200023535069,2494006.58,60ec41ba55c00300382672d9,HDFC,direct expenses,5eecc6d6449e4f7cfb1c2708,2022-03-07T00:00:00.000Z,"NEFT DR-BARB0VJGRKA-OM PRASAD PANDEY-NET BANK, MUM-N066221862552268-21500",,,net_banking_transfer,-21500
626247edd8beac1599c6a18d,50200023535069,2472506.58,60ec41ba55c00300382672d9,HDFC,direct expenses,5eecc6d6449e4f7cfb1c2708,2022-03-07T00:00:00.000Z,"NEFT DR-PUNB0482100-RAM BHAVAN YADAV-NET BANK, MUM-N066221862553371-21500",,,net_banking_transfer,-21500
626247edd8beac1599c6a18f,50200023535069,2454641.58,60ec41ba55c00300382672d9,HDFC,direct expenses,5eecc6d6449e4f7cfb1c2708,2022-03-07T00:00:00.000Z,"NEFT DR-KKBK0005032-DEEPAK YADAV-NETBANK , MUM-N066221862567447-17865",,,net_banking_transfer,-17865
626247edd8beac1599c6a191,50200023535069,2438654.58,60ec41ba55c00300382672d9,HDFC,direct expenses,5eecc6d6449e4f7cfb1c2708,2022-03-07T00:00:00.000Z,02711600008220-TPT-15987-VARUN SINGH,,,net_banking_transfer,-15987
626247edd8beac1599c6a193,50200023535069,2422667.58,60ec41ba55c00300382672d9,HDFC,direct expenses,5eecc6d6449e4f7cfb1c2708,2022-03-07T00:00:00.000Z,"NEFT DR-PUNB0151400-BHUWAN CHANDER JOSHI -NETBANK, MUM-N066221862592036-15987",,,net_banking_transfer,-15987
626247edd8beac1599c6a195,50200023535069,2406680.58,60ec41ba55c00300382672d9,HDFC,direct expenses,5eecc6d6449e4f7cfb1c2708,2022-03-07T00:00:00.000Z,"NEFT DR-PUNB0494300-KUNDAN PRASAD-NETBAN K, MUM-N066221862599044-15987",,,net_banking_transfer,-15987
626247edd8beac1599c6a197,50200023535069,2390693.58,60ec41ba55c00300382672d9,HDFC,direct expenses,5eecc6d6449e4f7cfb1c2708,2022-03-07T00:00:00.000Z,"NEFT DR-BARB0DINARA-MD ARIF RAZA-NETBANK , MUM-N066221862620681-15987",,,net_banking_transfer,-15987
626247edd8beac1599c6a199,50200023535069,2376066.58,60ec41ba55c00300382672d9,HDFC,direct expenses,5eecc6d6449e4f7cfb1c2708,2022-03-07T00:00:00.000Z,"NEFT DR-PUNB0307800-SANJEEV NIRMANIA-NET BANK, MUM-N066221862609685-14627",,,net_banking_transfer,-14627
626247edd8beac1599c6a19b,50200023535069,2359713.58,60ec41ba55c00300382672d9,HDFC,N-ACH payments,5eecc6d6449e4f7cfb1c2708,2022-03-07T00:00:00.000Z,"NEFT DR-DBSS0IN0811-SACHIN SINGH-NETBANK , MUM-N066221862624863-16353",,,net_banking_transfer,-16353
626247edd8beac1599c6a19d,50200023535069,2338213.58,60ec41ba55c00300382672d9,HDFC,direct expenses,5eecc6d6449e4f7cfb1c2708,2022-03-07T00:00:00.000Z,"NEFT DR-SIBL0000555-JAIVEER KUMAR-NETBAN K, MUM-N066221862637180-21500",,,net_banking_transfer,-21500
626247edd8beac1599c6a19f,50200023535069,2272503.58,60ec41ba55c00300382672d9,HDFC,direct expenses,5eecc6d6449e4f7cfb1c2708,2022-03-07T00:00:00.000Z,"NEFT DR-ICIC0000021-AKHILESH DIXIT-NETBA NK, MUM-N066221862655619-65710",,,net_banking_transfer,-65710
626247edd8beac1599c6a1a1,50200023535069,1982610.58,60ec41ba55c00300382672d9,HDFC,direct expenses,5eecc6d6449e4f7cfb1c2708,2022-03-07T00:00:00.000Z,"NEFT DR-ICIC0001134-VASU JAIN-NETBANK, M UM-N066221862694776-289893",,,net_banking_transfer,-289893
626247edd8beac1599c6a1a3,50200023535069,1920485.58,60ec41ba55c00300382672d9,HDFC,direct expenses,5eecc6d6449e4f7cfb1c2708,2022-03-07T00:00:00.000Z,"NEFT DR-UBIN0531855-MOHANISH KOTHARI-NET BANK, MUM-N066221862768205-62125",,,net_banking_transfer,-62125
626247edd8beac1599c6a1a5,50200023535069,1780376.58,60ec41ba55c00300382672d9,HDFC,direct expenses,5eecc6d6449e4f7cfb1c2708,2022-03-07T00:00:00.000Z,"NEFT DR-DBSS0IN0811-SARANSH KULKARNI-NET BANK, MUM-N066221862782684-140109",,,net_banking_transfer,-140109
626247edd8beac1599c6a1a7,50200023535069,1694376.58,60ec41ba55c00300382672d9,HDFC,direct expenses,5eecc6d6449e4f7cfb1c2708,2022-03-07T00:00:00.000Z,50200063349422-TPT-86000-COHORT E-COMMER,,,net_banking_transfer,-86000
626247edd8beac1599c6a1a9,50200023535069,1544376.58,60ec41ba55c00300382672d9,HDFC,direct expenses,5eecc6d6449e4f7cfb1c2708,2022-03-07T00:00:00.000Z,"NEFT DR-ICIC0006643-KRISHNA PACKAGING CO MPANY-NETBANK, MUM-N066221862835046-1500 00",,,net_banking_transfer,-150000
626247edd8beac1599c6a1ab,50200023535069,1577750.63,60ec41ba55c00300382672d9,HDFC,Revenue-UPI,5eecc6d6449e4f7cfb1c2708,2022-03-07T00:00:00.000Z,UPI-GOKWIK-GOKWIK@YESBANK-YESB0000340-20 6606908500-PAYOUT FOR MARCH 5,,,upi,33374.05
626247edd8beac1599c6a1ad,50200023535069,1277750.63,60ec41ba55c00300382672d9,HDFC,direct expenses,5eecc6d6449e4f7cfb1c2708,2022-03-07T00:00:00.000Z,"NEFT DR-YESB0000551-VISTTA COSMETICS-NET BANK, MUM-N066221862863380-300000",,,net_banking_transfer,-300000
626247edd8beac1599c6a1af,50200023535069,1169417.63,60ec41ba55c00300382672d9,HDFC,direct expenses,5eecc6d6449e4f7cfb1c2708,2022-03-07T00:00:00.000Z,"NEFT DR-ICIC0000396-SURABHI SARUP-NETBAN K, MUM-N066221862929329-108333",,,net_banking_transfer,-108333
626247edd8beac1599c6a1b1,50200023535069,1172151.41,60ec41ba55c00300382672d9,HDFC,Revenue-PG-non-split,5eecc6d6449e4f7cfb1c2708,2022-03-07T00:00:00.000Z,NEFT CR-IDFB0010204-SEZZLE PAYMENTS PRIV ATE LIMITED-SLICK ORGANICS PRIVATE LIMIT ED-IDFBH22066127716,insurance,,net_banking_transfer,2733.78
626247edd8beac1599c6a1b3,50200023535069,1174011.04,60ec41ba55c00300382672d9,HDFC,Transfer in/Revenue-other,5eecc6d6449e4f7cfb1c2708,2022-03-07T00:00:00.000Z,57500000644820-SLICK ORGANICS,insurance,,Other,1859.63
626247edd8beac1599c6a1b5,50200023535069,1208024.4,60ec41ba55c00300382672d9,HDFC,Revenue-PG-split enabled,5eecc6d6449e4f7cfb1c2708,2022-03-07T00:00:00.000Z,NEFT CR-UTIB0001506-RAZORPAY SOFTWARE PR IVATE LIMITED-SLICK ORGANICS PVT LITD-AX ISCN0125344412,insurance,,net_banking_transfer,34013.36
626247edd8beac1599c6a1b7,50200023535069,1008024.4,60ec41ba55c00300382672d9,HDFC,direct expenses,5eecc6d6449e4f7cfb1c2708,2022-03-07T00:00:00.000Z,02711930004579-TPT-200000-DHRUV BHASIN,,,net_banking_transfer,-200000
626247edd8beac1599c6a1b9,50200023535069,908024.4,60ec41ba55c00300382672d9,HDFC,direct expenses,5eecc6d6449e4f7cfb1c2708,2022-03-07T00:00:00.000Z,"NEFT DR-SCBL0036025-DHRUV MADHOK-NETBANK , MUM-N066221863954760-100000",,,net_banking_transfer,-100000
626247edd8beac1599c6a1bb,50200023535069,800024.4,60ec41ba55c00300382672d9,HDFC,direct expenses,5eecc6d6449e4f7cfb1c2708,2022-03-07T00:00:00.000Z,50200054531492-TPT-108000-ALETA PEOPLE S ERVICES,,,net_banking_transfer,-108000
626247edd8beac1599c6a1bd,50200023535069,788024.4,60ec41ba55c00300382672d9,HDFC,direct expenses,5eecc6d6449e4f7cfb1c2708,2022-03-07T00:00:00.000Z,"NEFT DR-KARB0000113-ASHWINI N DIXIT-NETB ANK, MUM-N066221864057019-12000",,,net_banking_transfer,-12000
626247edd8beac1599c6a1bf,50200023535069,750626.4,60ec41ba55c00300382672d9,HDFC,direct expenses,5eecc6d6449e4f7cfb1c2708,2022-03-07T00:00:00.000Z,50100362612187-TPT-37398-BHUPESH JAKHAR,,,net_banking_transfer,-37398
626247edd8beac1599c6a1c1,50200023535069,831171.57,60ec41ba55c00300382672d9,HDFC,Revenue-PG-non-split,5eecc6d6449e4f7cfb1c2708,2022-03-08T00:00:00.000Z,NEFT CR-PYTM0123456-PAYTM PAYMENTS SERVI CES LIMITED-SLICK ORGANICS PVT LTD-PYTM2 20674954890,ewallet,,net_banking_transfer,80545.17
626247edd8beac1599c6a1c3,50200023535069,576171.57,60ec41ba55c00300382672d9,HDFC,SAAS/tech expense,5eecc6d6449e4f7cfb1c2708,2022-03-08T00:00:00.000Z,POS 514834XXXXXX9486 AMAZON,shopping,,debit_card,-255000
626247edd8beac1599c6a1c5,50200023535069,528978.57,60ec41ba55c00300382672d9,HDFC,direct expenses,5eecc6d6449e4f7cfb1c2708,2022-03-08T00:00:00.000Z,"NEFT DR-ICIC0002451-SOUTH COURT CONDOMIN IUM ASSOCIATION-NETBANK, MUM-N0672218641 46690-47193",,,net_banking_transfer,-47193
626247edd8beac1599c6a1c7,50200023535069,568571.71,60ec41ba55c00300382672d9,HDFC,Revenue-PG-split enabled,5eecc6d6449e4f7cfb1c2708,2022-03-08T00:00:00.000Z,NEFT CR-UTIB0001506-RAZORPAY SOFTWARE PR,,,net_banking_transfer,39593.14
626247edd8beac1599c6a1c9,50200023535069,253355.2,60ec41ba55c00300382672d9,HDFC,N-ACH payments,5eecc6d6449e4f7cfb1c2708,2022-03-08T00:00:00.000Z,ACH D- CTRAZORPAY-GETVANTAGEJ47KSKFSC121,loans,lender_transaction,auto_debit_payment,-315216.51
626247eed8beac1599c6a1cb,50200023535069,96755.2,60ec41ba55c00300382672d9,HDFC,direct expenses,5eecc6d6449e4f7cfb1c2708,2022-03-08T00:00:00.000Z,"NEFT DR-KKBK0005289-HILL GROOVE CONSULTI NG LLP-NETBANK, MUM-N067221864678907-156 600",,,net_banking_transfer,-156600
626247eed8beac1599c6a1cd,50200023535069,34120.2,60ec41ba55c00300382672d9,HDFC,direct expenses,5eecc6d6449e4f7cfb1c2708,2022-03-08T00:00:00.000Z,"NEFT DR-KKBK0000187-APPLIED LIFE PRIVATE LIMITED-NETBANK, MUM-N067221864689544-6 2635",,,net_banking_transfer,-62635
626247eed8beac1599c6a1cf,50200023535069,134120.2,60ec41ba55c00300382672d9,HDFC,Internal Transfers,5eecc6d6449e4f7cfb1c2708,2022-03-08T00:00:00.000Z,IB FUNDS TRANSFER CR-50200035187206 -SL ICK ORGANICS PVT LTD,insurance,,Other,100000
626247eed8beac1599c6a1d1,50200023535069,95040.2,60ec41ba55c00300382672d9,HDFC,direct expenses,5eecc6d6449e4f7cfb1c2708,2022-03-08T00:00:00.000Z,"NEFT DR-YESB0000236-DELIGHT VACATION PVT LTD-NETBANK, MUM-N067221864747504-39080",,,net_banking_transfer,-39080
626247eed8beac1599c6a1d3,50200023535069,1395040.2,60ec41ba55c00300382672d9,HDFC,Internal Transfers,5eecc6d6449e4f7cfb1c2708,2022-03-08T00:00:00.000Z,IB FUNDS TRANSFER CR-50200035187206 -SL ICK ORGANICS PVT LTD,insurance,,Other,1300000
626247eed8beac1599c6a1d6,50200023535069,395040.2,60ec41ba55c00300382672d9,HDFC,Marketing Expense,5eecc6d6449e4f7cfb1c2708,2022-03-08T00:00:00.000Z,"NEFT DR-CITI0000006-FACEBOOK INDIA ONLIN E SERVICES PVT LTD-NETBANK, MUM-N0672218 64776673-1000000",,,net_banking_transfer,-1000000
626247eed8beac1599c6a1d9,50200023535069,431212.59,60ec41ba55c00300382672d9,HDFC,Revenue-UPI,5eecc6d6449e4f7cfb1c2708,2022-03-08T00:00:00.000Z,UPI-GOKWIK-GOKWIK@YESBANK-YESB0000340-20 6709150812-PAYOUT FOR MARCH 6,,,upi,36172.39
626247eed8beac1599c6a1dc,50200023535069,439150.42,60ec41ba55c00300382672d9,HDFC,Revenue-PG-non-split,5eecc6d6449e4f7cfb1c2708,2022-03-08T00:00:00.000Z,NEFT CR-SCBL0036001-STRIPE INDIA PRIVATE -SLICK ORGANICS PRIVATE LIMITED-SSG17413 Q0593502,insurance,,net_banking_transfer,7937.83
626247eed8beac1599c6a1de,50200023535069,268912.42,60ec41ba55c00300382672d9,HDFC,direct expenses,5eecc6d6449e4f7cfb1c2708,2022-03-08T00:00:00.000Z,"NEFT DR-KKBK0000261-TANVI TANEJA-NETBANK , MUM-N067221865455888-170238",,,net_banking_transfer,-170238
626247eed8beac1599c6a1e0,50200023535069,123112.42,60ec41ba55c00300382672d9,HDFC,direct expenses,5eecc6d6449e4f7cfb1c2708,2022-03-08T00:00:00.000Z,"NEFT DR-ICIC0006303-ALT SPACE STUDIO-NET BANK, MUM-N067221865509924-145800",,,net_banking_transfer,-145800
626247eed8beac1599c6a1e2,50200023535069,123359.44,60ec41ba55c00300382672d9,HDFC,Revenue-Mktplace,5eecc6d6449e4f7cfb1c2708,2022-03-08T00:00:00.000Z,NEFT CR-ICIC0000105-MANASH LIFESTYLE PRI VATE LIMITED NO-SLICK ORGANICS PRIVATE L IMITED BANG-ICIJ220670007554,shopping,,net_banking_transfer,247.02
626247eed8beac1599c6a1e4,50200023535069,125511.52,60ec41ba55c00300382672d9,HDFC,Revenue-Mktplace,5eecc6d6449e4f7cfb1c2708,2022-03-08T00:00:00.000Z,NEFT CR-ICIC0000105-MANASH LIFESTYLE PRI,shopping,,net_banking_transfer,2152.08
626247eed8beac1599c6a1e6,50200023535069,128106.36,60ec41ba55c00300382672d9,HDFC,Revenue-Mktplace,5eecc6d6449e4f7cfb1c2708,2022-03-08T00:00:00.000Z,NEFT CR-ICIC0000105-MANASH LIFESTYLE PRI VATE LIMITED NO-SLICK ORGANICS PRIVATE L IMITED MP M-ICIJ220670007552,shopping,,net_banking_transfer,2594.84
626247eed8beac1599c6a1e8,50200023535069,128829.99,60ec41ba55c00300382672d9,HDFC,Revenue-PG-non-split,5eecc6d6449e4f7cfb1c2708,2022-03-08T00:00:00.000Z,NEFT CR-IDFB0010204-SEZZLE PAYMENTS PRIV ATE LIMITED-SLICK ORGANICS PRIVATE LIMIT ED-IDFBH22067254105,insurance,,net_banking_transfer,723.63
626247eed8beac1599c6a1ea,50200023535069,171405.49,60ec41ba55c00300382672d9,HDFC,Revenue-PG-split enabled,5eecc6d6449e4f7cfb1c2708,2022-03-08T00:00:00.000Z,NEFT CR-UTIB0001506-RAZORPAY SOFTWARE PR IVATE LIMITED-SLICK ORGANICS PVT LITD-AX ISCN0125522145,insurance,,net_banking_transfer,42575.5
626247eed8beac1599c6a1ec,50200023535069,176632.33,60ec41ba55c00300382672d9,HDFC,Revenue-Mktplace,5eecc6d6449e4f7cfb1c2708,2022-03-09T00:00:00.000Z,NEFT CR-DEUT0797BGL-FLIPKART INTERNET PR IVATE LIMITED-SLICK ORGANICS PVT LTD-206 800140GN00262,shopping,,net_banking_transfer,5226.84
626247eed8beac1599c6a1ee,50200023535069,294290.67,60ec41ba55c00300382672d9,HDFC,Revenue-PG-non-split,5eecc6d6449e4f7cfb1c2708,2022-03-09T00:00:00.000Z,NEFT CR-PYTM0123456-PAYTM PAYMENTS SERVI CES LIMITED-SLICK ORGANICS PVT LTD-PYTM2 20685398366,ewallet,,net_banking_transfer,117658.34
626247eed8beac1599c6a1f0,50200023535069,296830.17,60ec41ba55c00300382672d9,HDFC,Revenue-Mktplace,5eecc6d6449e4f7cfb1c2708,2022-03-09T00:00:00.000Z,NEFT CR-DEUT0797BGL-MYNTRA DESIGNS PRIVA TE LIMITED-SLICK ORGANICS PVT. LTD.-2068 00567GN00228,shopping,,net_banking_transfer,2539.5
626247eed8beac1599c6a1f2,50200023535069,298859.05,60ec41ba55c00300382672d9,HDFC,Revenue-Mktplace,5eecc6d6449e4f7cfb1c2708,2022-03-09T00:00:00.000Z,NEFT CR-DEUT0797BGL-MYNTRA DESIGNS PRIVA TE LIMITED-SLICK ORGANICS PVT. LTD.-2068 00568GN00208,shopping,,net_banking_transfer,2028.88
626247eed8beac1599c6a1f4,50200023535069,352150.84,60ec41ba55c00300382672d9,HDFC,Revenue-PG-split enabled,5eecc6d6449e4f7cfb1c2708,2022-03-09T00:00:00.000Z,NEFT CR-UTIB0001506-RAZORPAY SOFTWARE PR IVATE LIMITED-SLICK ORGANICS PVT LITD-AX ISCN0125575529,insurance,,net_banking_transfer,53291.79
626247eed8beac1599c6a1f6,50200023535069,232900.84,60ec41ba55c00300382672d9,HDFC,direct expenses,5eecc6d6449e4f7cfb1c2708,2022-03-09T00:00:00.000Z,"NEFT DR-SBIN0011565-AANCHAL RAI-NETBANK, MUM-N068221866540174-119250",,,net_banking_transfer,-119250
626247eed8beac1599c6a1f8,50200023535069,142900.84,60ec41ba55c00300382672d9,HDFC,direct expenses,5eecc6d6449e4f7cfb1c2708,2022-03-09T00:00:00.000Z,"NEFT DR-ICIC0001937-SAUMITRA PANDEY-NETB ANK, MUM-N068221866581326-90000",,,net_banking_transfer,-90000
626247eed8beac1599c6a1fa,50200023535069,110500.84,60ec41ba55c00300382672d9,HDFC,direct expenses,5eecc6d6449e4f7cfb1c2708,2022-03-09T00:00:00.000Z,50200039330521-TPT-32400-ELITE PUBLICIST,insurance,,net_banking_transfer,-32400
626247eed8beac1599c6a1fc,50200023535069,-1999.16,60ec41ba55c00300382672d9,HDFC,direct expenses,5eecc6d6449e4f7cfb1c2708,2022-03-09T00:00:00.000Z,50100093802387-TPT-112500-ISSHANA MAHAJA,,,net_banking_transfer,-112500
626247eed8beac1599c6a1fe,50200023535069,-7483.16,60ec41ba55c00300382672d9,HDFC,agency/vendor expense,5eecc6d6449e4f7cfb1c2708,2022-03-09T00:00:00.000Z,"NEFT DR-KKBK0000298-ADMITAD MEDIA PRIVAT E LIMITED-NETBANK, MUM-N068221866815741- 5484",loans,lender_transaction,net_banking_transfer,-5484
626247eed8beac1599c6a200,50200023535069,992516.84,60ec41ba55c00300382672d9,HDFC,Internal Transfers,5eecc6d6449e4f7cfb1c2708,2022-03-09T00:00:00.000Z,IB FUNDS TRANSFER CR-50200035187206 -SL ICK ORGANICS PVT LTD,insurance,,Other,1000000
626247eed8beac1599c6a202,50200023535069,980616.84,60ec41ba55c00300382672d9,HDFC,direct expenses,5eecc6d6449e4f7cfb1c2708,2022-03-09T00:00:00.000Z,"NEFT DR-INDB0000275-LASH TECHNOLOGIES PR IVATE LIMITED-NETBANK, MUM-N068221866943 249-11900",,,net_banking_transfer,-11900
626247eed8beac1599c6a204,50200023535069,982222.85,60ec41ba55c00300382672d9,HDFC,Revenue-Mktplace,5eecc6d6449e4f7cfb1c2708,2022-03-09T00:00:00.000Z,NEFT CR-ICIC0000105-MANASH LIFESTYLE PRI VATE LIMITED NO-SLICK ORGANICS PRIVATE L IMITED MP G-ICIJ220680005575,shopping,,net_banking_transfer,1606.01
626247eed8beac1599c6a206,50200023535069,983606.03,60ec41ba55c00300382672d9,HDFC,Revenue-Mktplace,5eecc6d6449e4f7cfb1c2708,2022-03-09T00:00:00.000Z,NEFT CR-ICIC0000105-MANASH LIFESTYLE PRI VATE LIMITED NO-SLICK ORGANICS PRIVATE L IMITED MP M-ICIJ220680004720,shopping,,net_banking_transfer,1383.18
626247eed8beac1599c6a208,50200023535069,944671.59,60ec41ba55c00300382672d9,HDFC,SAAS/tech expense,5eecc6d6449e4f7cfb1c2708,2022-03-09T00:00:00.000Z,POS 514834XXXXXX9486 AMAZON.COM,shopping,,debit_card,-38934.44
626247eed8beac1599c6a20a,50200023535069,862811.59,60ec41ba55c00300382672d9,HDFC,direct expenses,5eecc6d6449e4f7cfb1c2708,2022-03-09T00:00:00.000Z,"NEFT DR-KKBK0000218-MONETIZE INFO LLP-NE TBANK, MUM-N068221867138182-81860",,,net_banking_transfer,-81860
626247eed8beac1599c6a20c,50200023535069,864789.59,60ec41ba55c00300382672d9,HDFC,Transfer in/Revenue-other,5eecc6d6449e4f7cfb1c2708,2022-03-09T00:00:00.000Z,NEFT CR-KKBK0000958-INNOVATIVE RETAIL CO NCEPTS PRIVATE LTD-SLICK ORGANICS PVT LT D-KKBK220686102626,,,net_banking_transfer,1978
626247eed8beac1599c6a20e,50200023535069,870402.59,60ec41ba55c00300382672d9,HDFC,Transfer in/Revenue-other,5eecc6d6449e4f7cfb1c2708,2022-03-09T00:00:00.000Z,NEFT CR-KKBK0000958-INNOVATIVE RETAIL CO NCEPTS PRIVATE LTD-SLICK ORGANICS PVT LT D-KKBK220686102787,,,net_banking_transfer,5613
626247eed8beac1599c6a210,50200023535069,870793.99,60ec41ba55c00300382672d9,HDFC,Transfer in/Revenue-other,5eecc6d6449e4f7cfb1c2708,2022-03-09T00:00:00.000Z,4060011462-09 03 2022-HDFAZCUR1,,,Other,391.4
626247eed8beac1599c6a212,50200023535069,882365.52,60ec41ba55c00300382672d9,HDFC,Revenue-PG-split enabled,5eecc6d6449e4f7cfb1c2708,2022-03-09T00:00:00.000Z,NEFT CR-UTIB0001506-RAZORPAY SOFTWARE PR IVATE LIMITED-SLICK ORGANICS PVT LITD-AX ISCN0125680134,insurance,,net_banking_transfer,11571.53
626247eed8beac1599c6a214,50200023535069,998253.72,60ec41ba55c00300382672d9,HDFC,Revenue-COD,5eecc6d6449e4f7cfb1c2708,2022-03-09T00:00:00.000Z,NEFT CR-ICIC0000155-SHIPROCKET COD CRF I D 3944165-SLICK ORGANICS PVT LTD-CMS2442 914127,insurance,,net_banking_transfer,115888.2
626247eed8beac1599c6a216,50200023535069,1168100.38,60ec41ba55c00300382672d9,HDFC,Revenue-UPI,5eecc6d6449e4f7cfb1c2708,2022-03-09T00:00:00.000Z,UPI-GOKWIK-GOKWIK@YESBANK-YESB0000340-20,,,upi,169846.66
626247eed8beac1599c6a218,50200023535069,1196928.56,60ec41ba55c00300382672d9,HDFC,Revenue-PG-non-split,5eecc6d6449e4f7cfb1c2708,2022-03-10T00:00:00.000Z,NEFT CR-PYTM0123456-PAYTM PAYMENTS SERVI CES LIMITED-SLICK ORGANICS PVT LTD-PYTM2 20695884437,ewallet,,net_banking_transfer,28828.18
626247eed8beac1599c6a21a,50200023535069,1210159.86,60ec41ba55c00300382672d9,HDFC,Revenue-PG-split enabled,5eecc6d6449e4f7cfb1c2708,2022-03-10T00:00:00.000Z,NEFT CR-UTIB0001506-RAZORPAY SOFTWARE PR IVATE LIMITED-SLICK ORGANICS PVT LITD-AX ISCN0125772385,insurance,,net_banking_transfer,13231.3
626247eed8beac1599c6a21c,50200023535069,1208582.77,60ec41ba55c00300382672d9,HDFC,bank charges,5eecc6d6449e4f7cfb1c2708,2022-03-10T00:00:00.000Z,.DC INTL POS TXN MARKUP+ST 140222 150222 -CDT2206308248860,,,international_transaction_arbitrage,-1577.09
626247eed8beac1599c6a21e,50200023535069,1196965.2,60ec41ba55c00300382672d9,HDFC,bank charges,5eecc6d6449e4f7cfb1c2708,2022-03-10T00:00:00.000Z,.DC INTL POS TXN MARKUP+ST 170222 180222 -CDT2206308248860,,,international_transaction_arbitrage,-11617.57
626247eed8beac1599c6a220,50200023535069,980965.2,60ec41ba55c00300382672d9,HDFC,direct expenses,5eecc6d6449e4f7cfb1c2708,2022-03-10T00:00:00.000Z,"NEFT DR-BARB0VJMATU-ARTISTO DESIGNZ-NETB ANK, MUM-N069221868577483-216000",,,net_banking_transfer,-216000
626247eed8beac1599c6a222,50200023535069,966289.2,60ec41ba55c00300382672d9,HDFC,direct expenses,5eecc6d6449e4f7cfb1c2708,2022-03-10T00:00:00.000Z,"NEFT DR-SBIN0008078-PANDIT PLASTICS-NETB ANK, MUM-N069221868601156-14676",,,net_banking_transfer,-14676
626247eed8beac1599c6a224,50200023535069,858289.2,60ec41ba55c00300382672d9,HDFC,direct expenses,5eecc6d6449e4f7cfb1c2708,2022-03-10T00:00:00.000Z,"NEFT DR-SCBL0036031-PR PUNDIT PUBLIC REL ATIONS PRIVATE LIMIT-NETBANK, MUM-N06922 1868603294-108000",insurance,,net_banking_transfer,-108000
626247eed8beac1599c6a226,50200023535069,818289.2,60ec41ba55c00300382672d9,HDFC,direct expenses,5eecc6d6449e4f7cfb1c2708,2022-03-10T00:00:00.000Z,50100297431252-TPT-40000-KOMALPREET KAUR,,,net_banking_transfer,-40000
626247eed8beac1599c6a228,50200023535069,475802.2,60ec41ba55c00300382672d9,HDFC,direct expenses,5eecc6d6449e4f7cfb1c2708,2022-03-10T00:00:00.000Z,05892560000649-TPT-342487-DECORPAC INDIA PRIVATE LIMITED,,,net_banking_transfer,-342487
626247eed8beac1599c6a22a,50200023535069,425802.2,60ec41ba55c00300382672d9,HDFC,direct expenses,5eecc6d6449e4f7cfb1c2708,2022-03-10T00:00:00.000Z,"NEFT DR-PUNB0062910-YADAVPACKAGING-NETBA NK, MUM-N069221868882325-50000",,,net_banking_transfer,-50000
626247eed8beac1599c6a22c,50200023535069,425586.14,60ec41ba55c00300382672d9,HDFC,bank charges,5eecc6d6449e4f7cfb1c2708,2022-03-10T00:00:00.000Z,.DC INTL POS TXN MARKUP+ST 190222 210222 -CDT2206308248860,,,international_transaction_arbitrage,-216.06
626247eed8beac1599c6a22e,50200023535069,420424.14,60ec41ba55c00300382672d9,HDFC,direct expenses,5eecc6d6449e4f7cfb1c2708,2022-03-10T00:00:00.000Z,50100362612187-TPT-5162-BHUPESH JAKHAR,,,net_banking_transfer,-5162
626247eed8beac1599c6a230,50200023535069,420890.34,60ec41ba55c00300382672d9,HDFC,Revenue-Mktplace,5eecc6d6449e4f7cfb1c2708,2022-03-10T00:00:00.000Z,NEFT CR-ICIC0000105-MANASH LIFESTYLE PRI VATE LIMITED NO-SLICK ORGANICS PRIVATE L IMITED MP M-ICIJ220690011906,shopping,,net_banking_transfer,466.2
626247eed8beac1599c6a233,50200023535069,421658.52,60ec41ba55c00300382672d9,HDFC,Revenue-Mktplace,5eecc6d6449e4f7cfb1c2708,2022-03-10T00:00:00.000Z,NEFT CR-ICIC0000105-MANASH LIFESTYLE PRI VATE LIMITED NO-SLICK ORGANICS PRIVATE L IMITED MP G-ICIJ220690011905,shopping,,net_banking_transfer,768.18
626247eed8beac1599c6a235,50200023535069,433077.49,60ec41ba55c00300382672d9,HDFC,Revenue-PG-split enabled,5eecc6d6449e4f7cfb1c2708,2022-03-10T00:00:00.000Z,NEFT CR-UTIB0001506-RAZORPAY SOFTWARE PR,,,net_banking_transfer,11418.97
626247eed8beac1599c6a237,50200023535069,443795.29,60ec41ba55c00300382672d9,HDFC,Revenue-PG-non-split,5eecc6d6449e4f7cfb1c2708,2022-03-10T00:00:00.000Z,NEFT CR-IDFB0010204-SEZZLE PAYMENTS PRIV ATE LIMITED-SLICK ORGANICS PRIVATE LIMIT ED-IDFBH22069475230,insurance,,net_banking_transfer,10717.8
626247eed8beac1599c6a23a,50200023535069,451184.21,60ec41ba55c00300382672d9,HDFC,Revenue-PG-non-split,5eecc6d6449e4f7cfb1c2708,2022-03-10T00:00:00.000Z,NEFT CR-IDFB0010204-SEZZLE PAYMENTS PRIV ATE LIMITED-SLICK ORGANICS PRIVATE LIMIT ED-IDFBH22069475599,insurance,,net_banking_transfer,7388.92
626247eed8beac1599c6a23c,50200023535069,651184.21,60ec41ba55c00300382672d9,HDFC,Revenue-UPI,5eecc6d6449e4f7cfb1c2708,2022-03-10T00:00:00.000Z,UPI-GOKWIK-GOKWIK@YESBANK-YESB0000340-20 6913606188-PAYOUT FOR MARCH 8,,,upi,200000
626247eed8beac1599c6a23e,50200023535069,682983.49,60ec41ba55c00300382672d9,HDFC,Revenue-UPI,5eecc6d6449e4f7cfb1c2708,2022-03-10T00:00:00.000Z,UPI-GOKWIK-GOKWIK@YESBANK-YESB0000340-20 6913606302-PAYOUT FOR MARCH 8,,,upi,31799.28
626247eed8beac1599c6a240,50200023535069,684807.96,60ec41ba55c00300382672d9,HDFC,Revenue-Mktplace,5eecc6d6449e4f7cfb1c2708,2022-03-11T00:00:00.000Z,NEFT CR-DEUT0797BGL-FLIPKART INTERNET PR IVATE LIMITED-SLICK ORGANICS PVT LTD-207 000125GN00043,shopping,,net_banking_transfer,1824.47
626247eed8beac1599c6a242,50200023535069,701032.65,60ec41ba55c00300382672d9,HDFC,Revenue-PG-non-split,5eecc6d6449e4f7cfb1c2708,2022-03-11T00:00:00.000Z,IMPS-207005020915-PAYTM PAYMENTS SERVI-P YTM-XXXXXXXXXX0008-ALL202203112168200003 30830668628,ewallet,,net_banking_transfer,16224.69
626247eed8beac1599c6a245,50200023535069,703488.33,60ec41ba55c00300382672d9,HDFC,Revenue-Mktplace,5eecc6d6449e4f7cfb1c2708,2022-03-11T00:00:00.000Z,NEFT CR-DEUT0797BGL-MYNTRA DESIGNS PRIVA TE LIMITED-SLICK ORGANICS PVT. LTD.-2070 00561GN00205,shopping,,net_banking_transfer,2455.68
626247eed8beac1599c6a247,50200023535069,708442.15,60ec41ba55c00300382672d9,HDFC,Revenue-Mktplace,5eecc6d6449e4f7cfb1c2708,2022-03-11T00:00:00.000Z,NEFT CR-DEUT0797BGL-MYNTRA DESIGNS PRIVA TE LIMITED-SLICK ORGANICS PVT. LTD.-2070 00560GN00252,shopping,,net_banking_transfer,4953.82
626247eed8beac1599c6a249,50200023535069,716701.47,60ec41ba55c00300382672d9,HDFC,Revenue-PG-split enabled,5eecc6d6449e4f7cfb1c2708,2022-03-11T00:00:00.000Z,NEFT CR-UTIB0001506-RAZORPAY SOFTWARE PR IVATE LIMITED-SLICK ORGANICS PVT LITD-AX ISCN0125951530,insurance,,net_banking_transfer,8259.32
626247eed8beac1599c6a24b,50200023535069,715145.14,60ec41ba55c00300382672d9,HDFC,bank charges,5eecc6d6449e4f7cfb1c2708,2022-03-11T00:00:00.000Z,.DC INTL POS TXN MARKUP+ST 240222 250222 -CDT2206308248860,,,international_transaction_arbitrage,-1556.33
626247eed8beac1599c6a24d,50200023535069,716361.1,60ec41ba55c00300382672d9,HDFC,Revenue-Mktplace,5eecc6d6449e4f7cfb1c2708,2022-03-11T00:00:00.000Z,4060011429-TIMES INTERNET LIMITED NODAL,,,Other,1215.96
626247eed8beac1599c6a24f,50200023535069,678303.3,60ec41ba55c00300382672d9,HDFC,direct expenses,5eecc6d6449e4f7cfb1c2708,2022-03-11T00:00:00.000Z,POS 514834XXXXXX9486 ALIBABA.COM,,,debit_card,-38057.8
626247eed8beac1599c6a251,50200023535069,678644.15,60ec41ba55c00300382672d9,HDFC,Revenue-Mktplace,5eecc6d6449e4f7cfb1c2708,2022-03-11T00:00:00.000Z,NEFT CR-ICIC0000105-MANASH LIFESTYLE PRI,shopping,,net_banking_transfer,340.85
626247eed8beac1599c6a253,50200023535069,679053.9,60ec41ba55c00300382672d9,HDFC,Revenue-Mktplace,5eecc6d6449e4f7cfb1c2708,2022-03-11T00:00:00.000Z,NEFT CR-ICIC0000105-MANASH LIFESTYLE PRI VATE LIMITED NO-SLICK ORGANICS PRIVATE L IMITED MP M-ICIJ220700012616,shopping,,net_banking_transfer,409.75
626247eed8beac1599c6a255,50200023535069,679951.11,60ec41ba55c00300382672d9,HDFC,Revenue-Mktplace,5eecc6d6449e4f7cfb1c2708,2022-03-11T00:00:00.000Z,NEFT CR-ICIC0000105-MANASH LIFESTYLE PRI VATE LIMITED NO-SLICK ORGANICS PRIVATE L IMITED KOLK-ICIJ220700010884,shopping,,net_banking_transfer,897.21
626247eed8beac1599c6a257,50200023535069,593951.11,60ec41ba55c00300382672d9,HDFC,direct expenses,5eecc6d6449e4f7cfb1c2708,2022-03-11T00:00:00.000Z,"NEFT DR-ICIC0000874-TRELION BUSINESS SOL UTIONS PVT LTD-NETBANK, MUM-N07022187072 4971-86000",,,net_banking_transfer,-86000
626247eed8beac1599c6a25a,50200023535069,602276.66,60ec41ba55c00300382672d9,HDFC,Revenue-PG-split enabled,5eecc6d6449e4f7cfb1c2708,2022-03-11T00:00:00.000Z,NEFT CR-UTIB0001506-RAZORPAY SOFTWARE PR IVATE LIMITED-SLICK ORGANICS PVT LITD-AX ISCN0126114586,insurance,,net_banking_transfer,8325.55
626247eed8beac1599c6a25c,50200023535069,631194.16,60ec41ba55c00300382672d9,HDFC,Revenue-COD,5eecc6d6449e4f7cfb1c2708,2022-03-11T00:00:00.000Z,NEFT CR-ICIC0000155-SHIPROCKET COD CRF I D 3964571-SLICK ORGANICS PVT LTD-CMS2448 197839,insurance,,net_banking_transfer,28917.5
626247eed8beac1599c6a25e,50200023535069,632560.16,60ec41ba55c00300382672d9,HDFC,Transfer in/Revenue-other,5eecc6d6449e4f7cfb1c2708,2022-03-11T00:00:00.000Z,SALARY HOUSE OF BEAUTY P L,,,salary,1366
626247eed8beac1599c6a260,50200023535069,672709.87,60ec41ba55c00300382672d9,HDFC,Revenue-UPI,5eecc6d6449e4f7cfb1c2708,2022-03-11T00:00:00.000Z,UPI-GOKWIK-GOKWIK@YESBANK-YESB0000340-20 7015622209-PAYOUT FOR MARCH 9,,,upi,40149.71
626247eed8beac1599c6a262,50200023535069,692550.46,60ec41ba55c00300382672d9,HDFC,Revenue-PG-non-split,5eecc6d6449e4f7cfb1c2708,2022-03-12T00:00:00.000Z,IMPS-207104709364-PAYTM PAYMENTS SERVI-P YTM-XXXXXXXXXX0008-ALL202203122168200003 30830668628,ewallet,,net_banking_transfer,19840.59
626247eed8beac1599c6a264,50200023535069,680030.46,60ec41ba55c00300382672d9,HDFC,direct expenses,5eecc6d6449e4f7cfb1c2708,2022-03-12T00:00:00.000Z,"NEFT DR-ICIC0001087-LETSPAK PACKAGING SO LUTION-NETBANK, MUM-N071221871837794-125 20",,,net_banking_transfer,-12520
626247eed8beac1599c6a266,50200023535069,672276.46,60ec41ba55c00300382672d9,HDFC,direct expenses,5eecc6d6449e4f7cfb1c2708,2022-03-12T00:00:00.000Z,00918630000430-TPT-7754-UNICOMMERCE ESOL UTIONS PRIVATE LIMITED,,,net_banking_transfer,-7754
626247eed8beac1599c6a268,50200023535069,684796.46,60ec41ba55c00300382672d9,HDFC,Adjustments/Reversal,5eecc6d6449e4f7cfb1c2708,2022-03-12T00:00:00.000Z,NEFT RETURN-BENEFICIARY NAME DIFFERES-LE TSPAK PACKAGING SOLUTION-ICICP2207100454 0,,neft_return,refund,12520
626247eed8beac1599c6a26a,50200023535069,681041.45,60ec41ba55c00300382672d9,HDFC,direct expenses,5eecc6d6449e4f7cfb1c2708,2022-03-12T00:00:00.000Z,POS 514834XXXXXX9486 WWW.FAQPRIME.COM,,,debit_card,-3755.01
626247eed8beac1599c6a26c,50200023535069,671041.45,60ec41ba55c00300382672d9,HDFC,Refund,5eecc6d6449e4f7cfb1c2708,2022-03-12T00:00:00.000Z,IMPS-207118173744-RAZORPAY REFUND CREDIT S TOPUP-YESB-XXXXXXXXXXXX5319-10000,bills,,net_banking_transfer,-10000
626247eed8beac1599c6a26f,50200023535069,696538.47,60ec41ba55c00300382672d9,HDFC,Revenue-UPI,5eecc6d6449e4f7cfb1c2708,2022-03-12T00:00:00.000Z,UPI-GOKWIK-GOKWIK@YESBANK-YESB0000340-20 7117500594-PAYOUT FOR MARCH 1,,,upi,25497.02
626247efd8beac1599c6a271,50200023535069,496538.47,60ec41ba55c00300382672d9,HDFC,direct expenses,5eecc6d6449e4f7cfb1c2708,2022-03-12T00:00:00.000Z,"NEFT DR-UTIB0000740-SUPARI STUDIOS-NETBA NK, MUM-N071221872116299-200000",,,net_banking_transfer,-200000
626247efd8beac1599c6a273,50200023535069,296538.47,60ec41ba55c00300382672d9,HDFC,direct expenses,5eecc6d6449e4f7cfb1c2708,2022-03-12T00:00:00.000Z,IMPS-207121174073-SUPARI STUDIOS-UTIB-XX XXXXXXXXX0337-200000,,,net_banking_transfer,-200000
626247efd8beac1599c6a275,50200023535069,96538.47,60ec41ba55c00300382672d9,HDFC,direct expenses,5eecc6d6449e4f7cfb1c2708,2022-03-12T00:00:00.000Z,"NEFT DR-YESB0000551-VISTTA COSMETICS-NET BANK, MUM-N071221872111187-200000",,,net_banking_transfer,-200000
626247efd8beac1599c6a277,50200023535069,109362.35,60ec41ba55c00300382672d9,HDFC,Revenue-PG-non-split,5eecc6d6449e4f7cfb1c2708,2022-03-13T00:00:00.000Z,IMPS-207204434242-PAYTM PAYMENTS SERVI-P YTM-XXXXXXXXXX0008-ALL202203132168200003 30830668628,ewallet,,net_banking_transfer,12823.88
626247efd8beac1599c6a279,50200023535069,1109362.35,60ec41ba55c00300382672d9,HDFC,Internal Transfers,5eecc6d6449e4f7cfb1c2708,2022-03-13T00:00:00.000Z,IB FUNDS TRANSFER CR-50200035187206 -SL ICK ORGANICS PVT LTD,insurance,,Other,1000000
626247efd8beac1599c6a27b,50200023535069,854362.35,60ec41ba55c00300382672d9,HDFC,SAAS/tech expense,5eecc6d6449e4f7cfb1c2708,2022-03-13T00:00:00.000Z,POS 514834XXXXXX9486 AMAZON,shopping,,debit_card,-255000
626247efd8beac1599c6a27d,50200023535069,908218.15,60ec41ba55c00300382672d9,HDFC,Revenue-UPI,5eecc6d6449e4f7cfb1c2708,2022-03-13T00:00:00.000Z,UPI-GOKWIK-GOKWIK@YESBANK-YESB0000340-20 7219567330-PAYOUT FOR MARCH 1,,,upi,53855.8
626247efd8beac1599c6a27f,50200023535069,931521.07,60ec41ba55c00300382672d9,HDFC,Revenue-PG-non-split,5eecc6d6449e4f7cfb1c2708,2022-03-14T00:00:00.000Z,IMPS-207304070369-PAYTM PAYMENTS SERVI-P YTM-XXXXXXXXXX0008-ALL202203142168200003 30830668628,ewallet,,net_banking_transfer,23302.92
626247efd8beac1599c6a281,50200023535069,934616.79,60ec41ba55c00300382672d9,HDFC,Revenue-Mktplace,5eecc6d6449e4f7cfb1c2708,2022-03-14T00:00:00.000Z,NEFT CR-DEUT0797BGL-MYNTRA DESIGNS PRIVA TE LIMITED-SLICK ORGANICS PVT. LTD.-2073 00578GN00236,shopping,,net_banking_transfer,3095.72
626247efd8beac1599c6a283,50200023535069,939725.09,60ec41ba55c00300382672d9,HDFC,Revenue-Mktplace,5eecc6d6449e4f7cfb1c2708,2022-03-14T00:00:00.000Z,NEFT CR-DEUT0797BGL-MYNTRA DESIGNS PRIVA TE LIMITED-SLICK ORGANICS PVT. LTD.-2073 00579GN00256,shopping,,net_banking_transfer,5108.3
626247efd8beac1599c6a285,50200023535069,1000889.36,60ec41ba55c00300382672d9,HDFC,Revenue-PG-split enabled,5eecc6d6449e4f7cfb1c2708,2022-03-14T00:00:00.000Z,NEFT CR-UTIB0001506-RAZORPAY SOFTWARE PR IVATE LIMITED-SLICK ORGANICS PVT LITD-AX ISCN0126267835,insurance,,net_banking_transfer,61164.27
626247efd8beac1599c6a287,50200023535069,1174775.21,60ec41ba55c00300382672d9,HDFC,Revenue-Mktplace,5eecc6d6449e4f7cfb1c2708,2022-03-14T00:00:00.000Z,IMPS-207312142140-AMAZON SELLER SERVIC-H,shopping,,net_banking_transfer,173885.85
626247efd8beac1599c6a289,50200023535069,1177759.34,60ec41ba55c00300382672d9,HDFC,Revenue-PG-non-split,5eecc6d6449e4f7cfb1c2708,2022-03-14T00:00:00.000Z,NEFT CR-SCBL0036001-STRIPE INDIA PRIVATE -SLICK ORGANICS PRIVATE LIMITED-SSG17413 Q0602126,insurance,,net_banking_transfer,2984.13
626247efd8beac1599c6a28b,50200023535069,1860646.34,60ec41ba55c00300382672d9,HDFC,Revenue-Mktplace,5eecc6d6449e4f7cfb1c2708,2022-03-14T00:00:00.000Z,NEFT CR-DEUT0797BGL-AMAZON PAY (INDIA) P RIVATE LIMITED-SLICK ORGANICS PVT LTD-20 7300839GN00300,shopping,,net_banking_transfer,682887
626247efd8beac1599c6a28d,50200023535069,1941646.34,60ec41ba55c00300382672d9,HDFC,Transfer in/Revenue-other,5eecc6d6449e4f7cfb1c2708,2022-03-14T00:00:00.000Z,NEFT CR-IDFB0010204-GETVANTAGE TECH PRIV ATE LIMITED-SLICK ORGANICS-IDFBH22073695 193,,,net_banking_transfer,81000
626247efd8beac1599c6a28f,50200023535069,1963696.71,60ec41ba55c00300382672d9,HDFC,Transfer in/Revenue-other,5eecc6d6449e4f7cfb1c2708,2022-03-14T00:00:00.000Z,POS REF 514834******9486-03/12 GOOGLESER,,,refund,22050.37
626247efd8beac1599c6a291,50200023535069,1680825.46,60ec41ba55c00300382672d9,HDFC,direct expenses,5eecc6d6449e4f7cfb1c2708,2022-03-14T00:00:00.000Z,POS 514834XXXXXX9486 SHOPIFY* 1355824,,,debit_card,-282871.25
626247efd8beac1599c6a293,50200023535069,1599385.46,60ec41ba55c00300382672d9,HDFC,direct expenses,5eecc6d6449e4f7cfb1c2708,2022-03-14T00:00:00.000Z,"NEFT DR-KKBK0001393-MASCOT SPINCONTROL I NDIA PVT LTD-NETBANK, MUM-N0732218734203 54-81440",,,net_banking_transfer,-81440
626247efd8beac1599c6a295,50200023535069,1390054.46,60ec41ba55c00300382672d9,HDFC,direct expenses,5eecc6d6449e4f7cfb1c2708,2022-03-14T00:00:00.000Z,"NEFT DR-YESB0000058-SIXTEENBY9 VIDEO WOR KS-NETBANK, MUM-N073221873424870-209331",,,net_banking_transfer,-209331
626247efd8beac1599c6a297,50200023535069,1391408.75,60ec41ba55c00300382672d9,HDFC,Revenue-PG-non-split,5eecc6d6449e4f7cfb1c2708,2022-03-14T00:00:00.000Z,NEFT CR-IDFB0010204-SEZZLE PAYMENTS PRIV ATE LIMITED-SLICK ORGANICS PRIVATE LIMIT ED-IDFBH22073754078,insurance,,net_banking_transfer,1354.29
626247efd8beac1599c6a299,50200023535069,1398869.42,60ec41ba55c00300382672d9,HDFC,Revenue-PG-split enabled,5eecc6d6449e4f7cfb1c2708,2022-03-14T00:00:00.000Z,NEFT CR-UTIB0001506-RAZORPAY SOFTWARE PR IVATE LIMITED-SLICK ORGANICS PVT LITD-AX ISCN0126459434,insurance,,net_banking_transfer,7460.67
626247efd8beac1599c6a29b,50200023535069,1399688.93,60ec41ba55c00300382672d9,HDFC,Revenue-Mktplace,5eecc6d6449e4f7cfb1c2708,2022-03-14T00:00:00.000Z,NEFT CR-ICIC0000105-MANASH LIFESTYLE PRI VATE LIMITED NO-SLICK ORGANICS PRIVATE L IMITED MP M-ICIJ220730017270,shopping,,net_banking_transfer,819.51
626247efd8beac1599c6a29e,50200023535069,1400482.03,60ec41ba55c00300382672d9,HDFC,Revenue-Mktplace,5eecc6d6449e4f7cfb1c2708,2022-03-14T00:00:00.000Z,NEFT CR-ICIC0000105-MANASH LIFESTYLE PRI VATE LIMITED NO-SLICK ORGANICS PRIVATE L IMITED BANG-ICIJ220730015871,shopping,,net_banking_transfer,793.1
626247efd8beac1599c6a2a0,50200023535069,1446322.19,60ec41ba55c00300382672d9,HDFC,Revenue-UPI,5eecc6d6449e4f7cfb1c2708,2022-03-14T00:00:00.000Z,UPI-GOKWIK-GOKWIK@YESBANK-YESB0000340-20 7321622195-PAYOUT FOR MARCH 1,,,upi,45840.16
626247efd8beac1599c6a2a2,50200023535069,1451010.13,60ec41ba55c00300382672d9,HDFC,Revenue-PG-non-split,5eecc6d6449e4f7cfb1c2708,2022-03-15T00:00:00.000Z,UPI-PAYTM-PPSL-PAYOUTS@PAYTM-PYTM0123456,ewallet,,upi,4687.94
626247efd8beac1599c6a2a4,50200023535069,1424010.13,60ec41ba55c00300382672d9,HDFC,direct expenses,5eecc6d6449e4f7cfb1c2708,2022-03-15T00:00:00.000Z,"NEFT DR-KKBK0000654-NIHARIKA MISHRA-NETB ANK, MUM-N074221874309775-27000",,,net_banking_transfer,-27000
626247efd8beac1599c6a2a6,50200023535069,1438725.64,60ec41ba55c00300382672d9,HDFC,Revenue-PG-split enabled,5eecc6d6449e4f7cfb1c2708,2022-03-15T00:00:00.000Z,NEFT CR-UTIB0001506-RAZORPAY SOFTWARE PR IVATE LIMITED-SLICK ORGANICS PVT LITD-AX ISCN0126518811,insurance,,net_banking_transfer,14715.51
626247efd8beac1599c6a2a8,50200023535069,1468650.28,60ec41ba55c00300382672d9,HDFC,Revenue-Mktplace,5eecc6d6449e4f7cfb1c2708,2022-03-15T00:00:00.000Z,NEFT CR-HSBC0400002-AMAZON SERVICES LLC- SLICK ORGANICS PRIVATE LIMITED-HSBCN2207 4801605,shopping,,net_banking_transfer,29924.64
626247efd8beac1599c6a2aa,50200023535069,1470185.28,60ec41ba55c00300382672d9,HDFC,Revenue-COD,5eecc6d6449e4f7cfb1c2708,2022-03-15T00:00:00.000Z,PICKRR TECHNOL-CODAKHILESHDIXIT85 G,,,Other,1535
626247efd8beac1599c6a2ac,50200023535069,1472751.52,60ec41ba55c00300382672d9,HDFC,Revenue-Mktplace,5eecc6d6449e4f7cfb1c2708,2022-03-15T00:00:00.000Z,NEFT CR-ICIC0000105-MANASH LIFESTYLE PRI VATE LIMITED NO-SLICK ORGANICS PRIVATE L IMITED MP M-ICIJ220740004357,shopping,,net_banking_transfer,2566.24
626247efd8beac1599c6a2ae,50200023535069,1474710.84,60ec41ba55c00300382672d9,HDFC,Revenue-Mktplace,5eecc6d6449e4f7cfb1c2708,2022-03-15T00:00:00.000Z,NEFT CR-ICIC0000105-MANASH LIFESTYLE PRI VATE LIMITED NO-SLICK ORGANICS PRIVATE L IMITED BANG-ICIJ220740004358,shopping,,net_banking_transfer,1959.32
626247efd8beac1599c6a2b1,50200023535069,1476431.91,60ec41ba55c00300382672d9,HDFC,Revenue-Mktplace,5eecc6d6449e4f7cfb1c2708,2022-03-15T00:00:00.000Z,NEFT CR-ICIC0000105-MANASH LIFESTYLE PRI VATE LIMITED NO-SLICK ORGANICS PRIVATE L IMITED MP G-ICIJ220740006051,shopping,,net_banking_transfer,1721.07
626247efd8beac1599c6a2b3,50200023535069,877031.91,60ec41ba55c00300382672d9,HDFC,direct expenses,5eecc6d6449e4f7cfb1c2708,2022-03-15T00:00:00.000Z,"NEFT DR-IDFB0040101-ACTIVES ADDITIVES AP PLICATIONS LLP-NETBANK, MUM-N07422187530 9737-599400",insurance,,net_banking_transfer,-599400
626247efd8beac1599c6a2b5,50200023535069,893289.91,60ec41ba55c00300382672d9,HDFC,Revenue-Mktplace,5eecc6d6449e4f7cfb1c2708,2022-03-15T00:00:00.000Z,NEFT CR-SCBL0036001-M/S DREAMPLUG TECHNO -SLICK ORGANICS PRIVATE LIMITEDSLICK-SIN 31436Q0035037,insurance,,net_banking_transfer,16258
626247efd8beac1599c6a2b7,50200023535069,583539.91,60ec41ba55c00300382672d9,HDFC,direct expenses,5eecc6d6449e4f7cfb1c2708,2022-03-15T00:00:00.000Z,50200016751567-TPT-309750-HUMANS OF BOMB AY STORIES PRIVATE LIMITED,,,net_banking_transfer,-309750
626247efd8beac1599c6a2b9,50200023535069,225639.91,60ec41ba55c00300382672d9,HDFC,direct expenses,5eecc6d6449e4f7cfb1c2708,2022-03-15T00:00:00.000Z,"NEFT DR-KKBK0000180-VEDIC COSMECEUTICALS PVT LTD-NETBANK, MUM-N074221875431155-3 57900",,,net_banking_transfer,-357900
626247efd8beac1599c6a2bf,50200023535069,236488.56,60ec41ba55c00300382672d9,HDFC,Revenue-PG-split enabled,5eecc6d6449e4f7cfb1c2708,2022-03-15T00:00:00.000Z,NEFT CR-UTIB0001506-RAZORPAY SOFTWARE PR,,,net_banking_transfer,10848.65
626247efd8beac1599c6a2c6,50200023535069,283026.99,60ec41ba55c00300382672d9,HDFC,Revenue-UPI,5eecc6d6449e4f7cfb1c2708,2022-03-15T00:00:00.000Z,UPI-GOKWIK-GOKWIK@YESBANK-YESB0000340-20 7423819717-PAYOUT FOR MARCH 1,,,upi,46538.43
626247efd8beac1599c6a2c9,50200023535069,283380.53,60ec41ba55c00300382672d9,HDFC,Revenue-Mktplace,5eecc6d6449e4f7cfb1c2708,2022-03-16T00:00:00.000Z,NEFT CR-DEUT0797BGL-FLIPKART INTERNET PR IVATE LIMITED-SLICK ORGANICS PVT LTD-207 500121GN00210,shopping,,net_banking_transfer,353.54
626247efd8beac1599c6a2cb,50200023535069,300220.54,60ec41ba55c00300382672d9,HDFC,Revenue-PG-non-split,5eecc6d6449e4f7cfb1c2708,2022-03-16T00:00:00.000Z,IMPS-207504619350-PAYTM PAYMENTS SERVI-P YTM-XXXXXXXXXX0008-ALL202203162168200003 30830668628,ewallet,,net_banking_transfer,16840.01
626247efd8beac1599c6a2cd,50200023535069,251620.54,60ec41ba55c00300382672d9,HDFC,direct expenses,5eecc6d6449e4f7cfb1c2708,2022-03-16T00:00:00.000Z,"NEFT DR-CNRB0015170-SNEHAL TAYDE-NETBANK , MUM-N075221876099034-48600",,,net_banking_transfer,-48600
626247efd8beac1599c6a2cf,50200023535069,254000.86,60ec41ba55c00300382672d9,HDFC,Revenue-Mktplace,5eecc6d6449e4f7cfb1c2708,2022-03-16T00:00:00.000Z,NEFT CR-DEUT0797BGL-MYNTRA DESIGNS PRIVA TE LIMITED-SLICK ORGANICS PVT. LTD.-2075 00551GN00242,shopping,,net_banking_transfer,2380.32
626247efd8beac1599c6a2d1,50200023535069,258098.4,60ec41ba55c00300382672d9,HDFC,Revenue-Mktplace,5eecc6d6449e4f7cfb1c2708,2022-03-16T00:00:00.000Z,NEFT CR-DEUT0797BGL-MYNTRA DESIGNS PRIVA TE LIMITED-SLICK ORGANICS PVT. LTD.-2075 00552GN00260,shopping,,net_banking_transfer,4097.54
626247efd8beac1599c6a2d3,50200023535069,270893.66,60ec41ba55c00300382672d9,HDFC,Revenue-PG-split enabled,5eecc6d6449e4f7cfb1c2708,2022-03-16T00:00:00.000Z,NEFT CR-UTIB0001506-RAZORPAY SOFTWARE PR IVATE LIMITED-SLICK ORGANICS PVT LITD-AX ISCN0126749856,insurance,,net_banking_transfer,12795.26
626247efd8beac1599c6a2d5,50200023535069,291845.86,60ec41ba55c00300382672d9,HDFC,Revenue-PG-split enabled,5eecc6d6449e4f7cfb1c2708,2022-03-16T00:00:00.000Z,NEFT CR-UTIB0001506-RAZORPAY SOFTWARE PR IVATE LIMITED-SLICK ORGANICS PVT LITD-AX ISCN0126877092,insurance,,net_banking_transfer,20952.2
626247efd8beac1599c6a2d7,50200023535069,433032.8,60ec41ba55c00300382672d9,HDFC,Revenue-COD,5eecc6d6449e4f7cfb1c2708,2022-03-16T00:00:00.000Z,NEFT CR-ICIC0000155-SHIPROCKET COD CRF I D 3985129-SLICK ORGANICS PVT LTD-CMS2457 690060,insurance,,net_banking_transfer,141186.94
626247efd8beac1599c6a2d9,50200023535069,462471.57,60ec41ba55c00300382672d9,HDFC,Revenue-UPI,5eecc6d6449e4f7cfb1c2708,2022-03-16T00:00:00.000Z,UPI-GOKWIK-GOKWIK@YESBANK-YESB0000340-20 7525889182-PAYOUT FOR MARCH 1,,,upi,29438.77
626247efd8beac1599c6a2db,50200023535069,207471.57,60ec41ba55c00300382672d9,HDFC,SAAS/tech expense,5eecc6d6449e4f7cfb1c2708,2022-03-16T00:00:00.000Z,POS 514834XXXXXX9486 AMAZON,shopping,,debit_card,-255000
626247efd8beac1599c6a2dd,50200023535069,246157.5,60ec41ba55c00300382672d9,HDFC,Revenue-PG-non-split,5eecc6d6449e4f7cfb1c2708,2022-03-17T00:00:00.000Z,NEFT CR-PYTM0123456-PAYTM PAYMENTS SERVI,ewallet,,net_banking_transfer,38685.93
626247efd8beac1599c6a2df,50200023535069,239523.5,60ec41ba55c00300382672d9,HDFC,Salary/Emp/consultant Expense,5eecc6d6449e4f7cfb1c2708,2022-03-17T00:00:00.000Z,1739441126/EPFO,,,Other,-6634
626247efd8beac1599c6a2e1,50200023535069,234861.5,60ec41ba55c00300382672d9,HDFC,direct expenses,5eecc6d6449e4f7cfb1c2708,2022-03-17T00:00:00.000Z,02022108831034/ESIC,,,Other,-4662
626247efd8beac1599c6a2e3,50200023535069,236183.46,60ec41ba55c00300382672d9,HDFC,Revenue-Mktplace,5eecc6d6449e4f7cfb1c2708,2022-03-17T00:00:00.000Z,NEFT CR-DEUT0797BGL-MYNTRA DESIGNS PRIVA TE LIMITED-SLICK ORGANICS PVT. LTD.-2076 00387GN00170,shopping,,net_banking_transfer,1321.96
626247efd8beac1599c6a2e5,50200023535069,238773.94,60ec41ba55c00300382672d9,HDFC,Revenue-Mktplace,5eecc6d6449e4f7cfb1c2708,2022-03-17T00:00:00.000Z,NEFT CR-DEUT0797BGL-MYNTRA DESIGNS PRIVA TE LIMITED-SLICK ORGANICS PVT. LTD.-2076 00388GN00179,shopping,,net_banking_transfer,2590.48
626247efd8beac1599c6a2e7,50200023535069,264593,60ec41ba55c00300382672d9,HDFC,Revenue-PG-split enabled,5eecc6d6449e4f7cfb1c2708,2022-03-17T00:00:00.000Z,NEFT CR-UTIB0001506-RAZORPAY SOFTWARE PR IVATE LIMITED-SLICK ORGANICS PVT LITD-AX ISCN0126978236,insurance,,net_banking_transfer,25819.06
626247efd8beac1599c6a2e9,50200023535069,244593,60ec41ba55c00300382672d9,HDFC,direct expenses,5eecc6d6449e4f7cfb1c2708,2022-03-17T00:00:00.000Z,"SARVAN KUMAR - CHQ PAID - KALKAJI, NEW",,,chq,-20000
626247efd8beac1599c6a2ec,50200023535069,232073,60ec41ba55c00300382672d9,HDFC,direct expenses,5eecc6d6449e4f7cfb1c2708,2022-03-17T00:00:00.000Z,"NEFT DR-ICIC0001087-SARVIN PRINTERS PVT LTD-NETBANK, MUM-N076221878099899-12520",,,net_banking_transfer,-12520
626247efd8beac1599c6a2ef,50200023535069,246088.17,60ec41ba55c00300382672d9,HDFC,Transfer in/Revenue-other,5eecc6d6449e4f7cfb1c2708,2022-03-17T00:00:00.000Z,FT- ARATA-50200053251420 - OCTAVOS ENTER PRISE SOLUTIONS PVT LTD -,,,Other,14015.17
626247efd8beac1599c6a2f1,50200023535069,247844.45,60ec41ba55c00300382672d9,HDFC,Revenue-Mktplace,5eecc6d6449e4f7cfb1c2708,2022-03-17T00:00:00.000Z,NEFT CR-ICIC0000105-MANASH LIFESTYLE PRI VATE LIMITED NO-SLICK ORGANICS PRIVATE L IMITED MP G-ICIJ220760004174,shopping,,net_banking_transfer,1756.28
626247efd8beac1599c6a2f3,50200023535069,248462.37,60ec41ba55c00300382672d9,HDFC,Revenue-Mktplace,5eecc6d6449e4f7cfb1c2708,2022-03-17T00:00:00.000Z,NEFT CR-ICIC0000105-MANASH LIFESTYLE PRI VATE LIMITED NO-SLICK ORGANICS PRIVATE L IMITED BANG-ICIJ220760004177,shopping,,net_banking_transfer,617.92
626247efd8beac1599c6a2f5,50200023535069,249395.48,60ec41ba55c00300382672d9,HDFC,Revenue-Mktplace,5eecc6d6449e4f7cfb1c2708,2022-03-17T00:00:00.000Z,NEFT CR-ICIC0000105-MANASH LIFESTYLE PRI VATE LIMITED NO-SLICK ORGANICS PRIVATE L IMITED MP M-ICIJ220760004176,shopping,,net_banking_transfer,933.11
626247efd8beac1599c6a2f7,50200023535069,270406.37,60ec41ba55c00300382672d9,HDFC,Revenue-PG-split enabled,5eecc6d6449e4f7cfb1c2708,2022-03-17T00:00:00.000Z,NEFT CR-UTIB0001506-RAZORPAY SOFTWARE PR IVATE LIMITED-SLICK ORGANICS PVT LITD-AX ISCN0127095072,insurance,,net_banking_transfer,21010.89
626247efd8beac1599c6a2f9,50200023535069,271266.36,60ec41ba55c00300382672d9,HDFC,Revenue-PG-non-split,5eecc6d6449e4f7cfb1c2708,2022-03-17T00:00:00.000Z,NEFT CR-YESB0000001-RZPX PVT LTD NODAL A CCOUNT-SLICKORGANICS-N076221079362644,insurance,,salary,859.99
626247efd8beac1599c6a2fb,50200023535069,271667.24,60ec41ba55c00300382672d9,HDFC,Revenue-Mktplace,5eecc6d6449e4f7cfb1c2708,2022-03-17T00:00:00.000Z,NEFT CR-DEUT0784BBY-TATA UNISTORE LIMITE,,,net_banking_transfer,400.88
626247efd8beac1599c6a2fd,50200023535069,71667.24,60ec41ba55c00300382672d9,HDFC,Tax,5eecc6d6449e4f7cfb1c2708,2022-03-17T00:00:00.000Z,GST/BANK REFERENCE NO: R2207633223352/CI N NO: HDFC22030700153101,,,Other,-200000
626247efd8beac1599c6a2ff,50200023535069,112122.32,60ec41ba55c00300382672d9,HDFC,Revenue-UPI,5eecc6d6449e4f7cfb1c2708,2022-03-17T00:00:00.000Z,UPI-GOKWIK-GOKWIK@YESBANK-YESB0000340-20 7628180295-PAYOUT FOR MARCH 1,,,upi,40455.08
626247efd8beac1599c6a301,50200023535069,151742.33,60ec41ba55c00300382672d9,HDFC,Revenue-PG-non-split,5eecc6d6449e4f7cfb1c2708,2022-03-18T00:00:00.000Z,NEFT CR-PYTM0123456-PAYTM PAYMENTS SERVI CES LIMITED-SLICK ORGANICS PVT LTD-PYTM2 20779570699,ewallet,,net_banking_transfer,39620.01
626247efd8beac1599c6a303,50200023535069,113314.76,60ec41ba55c00300382672d9,HDFC,SAAS/tech expense,5eecc6d6449e4f7cfb1c2708,2022-03-18T00:00:00.000Z,POS 514834XXXXXX9486 AMAZON.COM,shopping,,debit_card,-38427.57
626247efd8beac1599c6a305,50200023535069,116342.59,60ec41ba55c00300382672d9,HDFC,Revenue-PG-non-split,5eecc6d6449e4f7cfb1c2708,2022-03-18T00:00:00.000Z,NEFT CR-IDFB0010204-SEZZLE PAYMENTS PRIV ATE LIMITED-SLICK ORGANICS PRIVATE LIMIT ED-IDFBH22077164942,insurance,,net_banking_transfer,3027.83
626247efd8beac1599c6a308,50200023535069,225351.63,60ec41ba55c00300382672d9,HDFC,Revenue-UPI,5eecc6d6449e4f7cfb1c2708,2022-03-18T00:00:00.000Z,UPI-GOKWIK-GOKWIK@YESBANK-YESB0000340-20 7730008703-PAYOUT FOR MARCH 1,,,upi,109009.04
626247efd8beac1599c6a30a,50200023535069,263007.48,60ec41ba55c00300382672d9,HDFC,Revenue-PG-non-split,5eecc6d6449e4f7cfb1c2708,2022-03-19T00:00:00.000Z,NEFT CR-PYTM0123456-PAYTM PAYMENTS SERVI CES LIMITED-SLICK ORGANICS PVT LTD-PYTM2 20789962535,ewallet,,net_banking_transfer,37655.85
626247efd8beac1599c6a30c,50200023535069,330523.06,60ec41ba55c00300382672d9,HDFC,Revenue-PG-split enabled,5eecc6d6449e4f7cfb1c2708,2022-03-19T00:00:00.000Z,NEFT CR-UTIB0001506-RAZORPAY SOFTWARE PR IVATE LIMITED-SLICK ORGANICS PVT LITD-AX ISCN0127197586,insurance,,net_banking_transfer,67515.58
626247efd8beac1599c6a30e,50200023535069,130523.06,60ec41ba55c00300382672d9,HDFC,direct expenses,5eecc6d6449e4f7cfb1c2708,2022-03-19T00:00:00.000Z,"NEFT DR-YESB0000551-VISTTA COSMETICS-NET BANK, MUM-N078221879847945-200000",,,net_banking_transfer,-200000
626247efd8beac1599c6a310,50200023535069,118523.06,60ec41ba55c00300382672d9,HDFC,direct expenses,5eecc6d6449e4f7cfb1c2708,2022-03-19T00:00:00.000Z,50100201107051-TPT-12000-SHEETAL KLER,,,net_banking_transfer,-12000
626247efd8beac1599c6a312,50200023535069,130114.93,60ec41ba55c00300382672d9,HDFC,Revenue-PG-split enabled,5eecc6d6449e4f7cfb1c2708,2022-03-19T00:00:00.000Z,NEFT CR-UTIB0001506-RAZORPAY SOFTWARE PR IVATE LIMITED-SLICK ORGANICS PVT LITD-AX ISCN0127364156,insurance,,net_banking_transfer,11591.87
626247efd8beac1599c6a314,50200023535069,226216.46,60ec41ba55c00300382672d9,HDFC,Revenue-UPI,5eecc6d6449e4f7cfb1c2708,2022-03-19T00:00:00.000Z,UPI-GOKWIK-GOKWIK@YESBANK-YESB0000340-20 7831806274-PAYOUT FOR MARCH 1,,,upi,96101.53
626247efd8beac1599c6a316,50200023535069,240044.66,60ec41ba55c00300382672d9,HDFC,Revenue-PG-non-split,5eecc6d6449e4f7cfb1c2708,2022-03-20T00:00:00.000Z,IMPS-207905538041-PAYTM PAYMENTS SERVI-P YTM-XXXXXXXXXX0008-ALL202203202168200003 30830668628,ewallet,,net_banking_transfer,13828.2
626247efd8beac1599c6a318,50200023535069,240947.27,60ec41ba55c00300382672d9,HDFC,Revenue-PG-non-split,5eecc6d6449e4f7cfb1c2708,2022-03-20T00:00:00.000Z,NEFT CR-IDFB0010204-SEZZLE PAYMENTS PRIV,,,net_banking_transfer,902.61
626247efd8beac1599c6a31a,50200023535069,196534.19,60ec41ba55c00300382672d9,HDFC,direct expenses,5eecc6d6449e4f7cfb1c2708,2022-03-20T00:00:00.000Z,POS 514834XXXXXX9486 THE ROCKET SCIEN,,,debit_card,-44413.08
626247efd8beac1599c6a31c,50200023535069,191200.96,60ec41ba55c00300382672d9,HDFC,direct expenses,5eecc6d6449e4f7cfb1c2708,2022-03-20T00:00:00.000Z,POS 514834XXXXXX9486 ECOMENGINE* FEED,,,debit_card,-5333.23
626247efd8beac1599c6a31e,50200023535069,1191200.96,60ec41ba55c00300382672d9,HDFC,Internal Transfers,5eecc6d6449e4f7cfb1c2708,2022-03-20T00:00:00.000Z,IB FUNDS TRANSFER CR-50200035187206 -SL ICK ORGANICS PVT LTD,insurance,,Other,1000000
626247f0d8beac1599c6a320,50200023535069,936200.96,60ec41ba55c00300382672d9,HDFC,SAAS/tech expense,5eecc6d6449e4f7cfb1c2708,2022-03-20T00:00:00.000Z,POS 514834XXXXXX9486 AMAZON,shopping,,debit_card,-255000
626247f0d8beac1599c6a322,50200023535069,1044594.07,60ec41ba55c00300382672d9,HDFC,Revenue-UPI,5eecc6d6449e4f7cfb1c2708,2022-03-20T00:00:00.000Z,UPI-GOKWIK-GOKWIK@YESBANK-YESB0000340-20 7933631106-PAYOUT FOR MARCH 1,,,upi,108393.11
626247f0d8beac1599c6a324,50200023535069,1344594.07,60ec41ba55c00300382672d9,HDFC,Internal Transfers,5eecc6d6449e4f7cfb1c2708,2022-03-20T00:00:00.000Z,IB FUNDS TRANSFER CR-50200035187206 -SL ICK ORGANICS PVT LTD,insurance,,Other,300000
626247f0d8beac1599c6a326,50200023535069,1349644.19,60ec41ba55c00300382672d9,HDFC,Revenue-Mktplace,5eecc6d6449e4f7cfb1c2708,2022-03-21T00:00:00.000Z,NEFT CR-DEUT0797BGL-FLIPKART INTERNET PR IVATE LIMITED-SLICK ORGANICS PVT LTD-208 000152GN00207,shopping,,net_banking_transfer,5050.12
626247f0d8beac1599c6a328,50200023535069,1369817.15,60ec41ba55c00300382672d9,HDFC,Revenue-PG-non-split,5eecc6d6449e4f7cfb1c2708,2022-03-21T00:00:00.000Z,IMPS-208004028850-PAYTM PAYMENTS SERVI-P YTM-XXXXXXXXXX0008-ALL202203212168200003 30830668628,ewallet,,net_banking_transfer,20172.96
626247f0d8beac1599c6a32a,50200023535069,111348.15,60ec41ba55c00300382672d9,HDFC,Marketing Expense,5eecc6d6449e4f7cfb1c2708,2022-03-21T00:00:00.000Z,"NEFT DR-CITI0000006-FACEBOOK INDIA ONLIN E SERVICES PVT LTD-NETBANK, MUM-N0802218 80857954-1258469",,,net_banking_transfer,-1258469
626247f0d8beac1599c6a32c,50200023535069,116875.83,60ec41ba55c00300382672d9,HDFC,Revenue-Mktplace,5eecc6d6449e4f7cfb1c2708,2022-03-21T00:00:00.000Z,NEFT CR-DEUT0797BGL-MYNTRA DESIGNS PRIVA TE LIMITED-SLICK ORGANICS PVT. LTD.-2080 00556GN00285,shopping,,net_banking_transfer,5527.68
626247f0d8beac1599c6a32e,50200023535069,130364.81,60ec41ba55c00300382672d9,HDFC,Revenue-Mktplace,5eecc6d6449e4f7cfb1c2708,2022-03-21T00:00:00.000Z,NEFT CR-DEUT0797BGL-MYNTRA DESIGNS PRIVA TE LIMITED-SLICK ORGANICS PVT. LTD.-2080 00576GN00018,shopping,,net_banking_transfer,13488.98
626247f0d8beac1599c6a330,50200023535069,154892.07,60ec41ba55c00300382672d9,HDFC,Revenue-PG-split enabled,5eecc6d6449e4f7cfb1c2708,2022-03-21T00:00:00.000Z,NEFT CR-UTIB0001506-RAZORPAY SOFTWARE PR IVATE LIMITED-SLICK ORGANICS PVT LITD-AX ISCN0127431560,insurance,,net_banking_transfer,24527.26
626247f0d8beac1599c6a332,50200023535069,54892.07,60ec41ba55c00300382672d9,HDFC,direct expenses,5eecc6d6449e4f7cfb1c2708,2022-03-21T00:00:00.000Z,"NEFT DR-PUNB0642000-UFLEX LIMITED-NETBAN K, MUM-N080221881125715-100000",loans,lender_transaction,net_banking_transfer,-100000
626247f0d8beac1599c6a334,50200023535069,235667.05,60ec41ba55c00300382672d9,HDFC,Revenue-Mktplace,5eecc6d6449e4f7cfb1c2708,2022-03-21T00:00:00.000Z,IMPS-208012053110-AMAZON SELLER SERVIC-H,shopping,,net_banking_transfer,180774.98
626247f0d8beac1599c6a336,50200023535069,198212.05,60ec41ba55c00300382672d9,HDFC,direct expenses,5eecc6d6449e4f7cfb1c2708,2022-03-21T00:00:00.000Z,"NEFT DR-KKBK0000424-NATARAJAN RANGANATHA N-NETBANK, MUM-N080221881179239-37455",,,net_banking_transfer,-37455
626247f0d8beac1599c6a338,50200023535069,779431.03,60ec41ba55c00300382672d9,HDFC,Revenue-Mktplace,5eecc6d6449e4f7cfb1c2708,2022-03-21T00:00:00.000Z,NEFT CR-DEUT0797BGL-AMAZON PAY (INDIA) P RIVATE LIMITED-SLICK ORGANICS PVT LTD-20 8000851GN00355,shopping,,net_banking_transfer,581218.98
626247f0d8beac1599c6a33a,50200023535069,779430.03,60ec41ba55c00300382672d9,HDFC,Marketing Expense,5eecc6d6449e4f7cfb1c2708,2022-03-21T00:00:00.000Z,POS 514834XXXXXX9486 GOOGLE *TEMPORAR,,,debit_card,-1
626247f0d8beac1599c6a33c,50200023535069,779431.03,60ec41ba55c00300382672d9,HDFC,Transfer in/Revenue-other,5eecc6d6449e4f7cfb1c2708,2022-03-21T00:00:00.000Z,POS 514834XXXXXX9486 GOOGLE *TEMPORAR,,,debit_card,1
626247f0d8beac1599c6a33e,50200023535069,781078.83,60ec41ba55c00300382672d9,HDFC,Revenue-COD,5eecc6d6449e4f7cfb1c2708,2022-03-21T00:00:00.000Z,NEFT CR-ICIC0000155-SHIPROCKET COD CRF I D 4013690-SLICK ORGANICS PVT LTD-CMS2464 334738,insurance,,net_banking_transfer,1647.8
626247f0d8beac1599c6a340,50200023535069,782883.86,60ec41ba55c00300382672d9,HDFC,Revenue-PG-non-split,5eecc6d6449e4f7cfb1c2708,2022-03-21T00:00:00.000Z,NEFT CR-IDFB0010204-SEZZLE PAYMENTS PRIV ATE LIMITED-SLICK ORGANICS PRIVATE LIMIT ED-IDFBH22080289637,insurance,,net_banking_transfer,1805.03
626247f0d8beac1599c6a342,50200023535069,799626.51,60ec41ba55c00300382672d9,HDFC,Revenue-PG-non-split,5eecc6d6449e4f7cfb1c2708,2022-03-21T00:00:00.000Z,NEFT CR-IDFB0010204-SEZZLE PAYMENTS PRIV ATE LIMITED-SLICK ORGANICS PRIVATE LIMIT ED-IDFBH22080289851,insurance,,net_banking_transfer,16742.65
626247f0d8beac1599c6a344,50200023535069,810324.66,60ec41ba55c00300382672d9,HDFC,Revenue-PG-split enabled,5eecc6d6449e4f7cfb1c2708,2022-03-21T00:00:00.000Z,NEFT CR-UTIB0001506-RAZORPAY SOFTWARE PR IVATE LIMITED-SLICK ORGANICS PVT LITD-AX ISCN0127585407,insurance,,net_banking_transfer,10698.15
626247f0d8beac1599c6a346,50200023535069,892603.21,60ec41ba55c00300382672d9,HDFC,Revenue-COD,5eecc6d6449e4f7cfb1c2708,2022-03-21T00:00:00.000Z,NEFT CR-ICIC0000155-SHIPROCKET COD CRF I D 4005512-SLICK ORGANICS PVT LTD-CMS2464 301468,insurance,,net_banking_transfer,82278.55
626247f0d8beac1599c6a348,50200023535069,894872.61,60ec41ba55c00300382672d9,HDFC,Revenue-Mktplace,5eecc6d6449e4f7cfb1c2708,2022-03-21T00:00:00.000Z,NEFT CR-ICIC0000105-MANASH LIFESTYLE PRI VATE LIMITED NO-SLICK ORGANICS PRIVATE L IMITED MP G-ICIJ220800004558,shopping,,net_banking_transfer,2269.4
626247f0d8beac1599c6a34a,50200023535069,896218.43,60ec41ba55c00300382672d9,HDFC,Revenue-Mktplace,5eecc6d6449e4f7cfb1c2708,2022-03-21T00:00:00.000Z,NEFT CR-ICIC0000105-MANASH LIFESTYLE PRI VATE LIMITED NO-SLICK ORGANICS PRIVATE L IMITED BANG-ICIJ220800004562,shopping,,net_banking_transfer,1345.82
626247f0d8beac1599c6a34c,50200023535069,896730.81,60ec41ba55c00300382672d9,HDFC,Revenue-Mktplace,5eecc6d6449e4f7cfb1c2708,2022-03-21T00:00:00.000Z,NEFT CR-ICIC0000105-MANASH LIFESTYLE PRI,shopping,,net_banking_transfer,512.38
626247f0d8beac1599c6a34e,50200023535069,949602.9,60ec41ba55c00300382672d9,HDFC,Revenue-UPI,5eecc6d6449e4f7cfb1c2708,2022-03-21T00:00:00.000Z,UPI-GOKWIK-GOKWIK@YESBANK-YESB0000340-20 8035958542-PAYOUT FOR MARCH 1,,,upi,52872.09
626247f0d8beac1599c6a350,50200023535069,975231.87,60ec41ba55c00300382672d9,HDFC,Revenue-PG-non-split,5eecc6d6449e4f7cfb1c2708,2022-03-22T00:00:00.000Z,NEFT CR-PYTM0123456-PAYTM PAYMENTS SERVI CES LIMITED-SLICK ORGANICS PVT LTD-PYTM2 20811143657,ewallet,,net_banking_transfer,25628.97
626247f0d8beac1599c6a352,50200023535069,983218.94,60ec41ba55c00300382672d9,HDFC,Revenue-PG-split enabled,5eecc6d6449e4f7cfb1c2708,2022-03-22T00:00:00.000Z,NEFT CR-UTIB0001506-RAZORPAY SOFTWARE PR IVATE LIMITED-SLICK ORGANICS PVT LITD-AX ISCN0127691560,insurance,,net_banking_transfer,7987.07
626247f0d8beac1599c6a354,50200023535069,983603.03,60ec41ba55c00300382672d9,HDFC,Revenue-Mktplace,5eecc6d6449e4f7cfb1c2708,2022-03-22T00:00:00.000Z,NEFT CR-ICIC0000105-MANASH LIFESTYLE PRI VATE LIMITED NO-SLICK ORGANICS PRIVATE L IMITED BANG-ICIJ220810002596,shopping,,net_banking_transfer,384.09
626247f0d8beac1599c6a356,50200023535069,985056.57,60ec41ba55c00300382672d9,HDFC,Revenue-Mktplace,5eecc6d6449e4f7cfb1c2708,2022-03-22T00:00:00.000Z,NEFT CR-ICIC0000105-MANASH LIFESTYLE PRI VATE LIMITED NO-SLICK ORGANICS PRIVATE L IMITED MP G-ICIJ220810002595,shopping,,net_banking_transfer,1453.54
626247f0d8beac1599c6a359,50200023535069,983956.57,60ec41ba55c00300382672d9,HDFC,SAAS/tech expense,5eecc6d6449e4f7cfb1c2708,2022-03-22T00:00:00.000Z,POS 514834XXXXXX9486 AMAZON,shopping,,debit_card,-1100
626247f0d8beac1599c6a35b,50200023535069,971752.41,60ec41ba55c00300382672d9,HDFC,direct expenses,5eecc6d6449e4f7cfb1c2708,2022-03-22T00:00:00.000Z,POS 514834XXXXXX9486 JW SAHAR FO 1,,,debit_card,-12204.16
626247f0d8beac1599c6a35d,50200023535069,997792.22,60ec41ba55c00300382672d9,HDFC,Revenue-PG-split enabled,5eecc6d6449e4f7cfb1c2708,2022-03-22T00:00:00.000Z,NEFT CR-UTIB0001506-RAZORPAY SOFTWARE PR IVATE LIMITED-SLICK ORGANICS PVT LITD-AX ISCN0127820515,insurance,,net_banking_transfer,26039.81
626247f0d8beac1599c6a35f,50200023535069,1059225.26,60ec41ba55c00300382672d9,HDFC,Revenue-UPI,5eecc6d6449e4f7cfb1c2708,2022-03-22T00:00:00.000Z,UPI-GOKWIK-GOKWIK@YESBANK-YESB0000340-20 8137969242-PAYOUT FOR MARCH 2,,,upi,61433.04
626247f0d8beac1599c6a361,50200023535069,1070400.28,60ec41ba55c00300382672d9,HDFC,Revenue-Mktplace,5eecc6d6449e4f7cfb1c2708,2022-03-23T00:00:00.000Z,NEFT CR-DEUT0797BGL-FLIPKART INTERNET PR IVATE LIMITED-SLICK ORGANICS PVT LTD-208 200155GN00021,shopping,,net_banking_transfer,11175.02
626247f0d8beac1599c6a363,50200023535069,1085565.96,60ec41ba55c00300382672d9,HDFC,Revenue-PG-non-split,5eecc6d6449e4f7cfb1c2708,2022-03-23T00:00:00.000Z,IMPS-208204050922-PAYTM PAYMENTS SERVI-P YTM-XXXXXXXXXX0008-ALL202203232168200003 30830668628,ewallet,,net_banking_transfer,15165.68
626247f0d8beac1599c6a365,50200023535069,1086761.27,60ec41ba55c00300382672d9,HDFC,Transfer in/Revenue-other,5eecc6d6449e4f7cfb1c2708,2022-03-23T00:00:00.000Z,57500000644820-SLICK ORGANICS P,insurance,,Other,1195.31
626247f0d8beac1599c6a367,50200023535069,977584.27,60ec41ba55c00300382672d9,HDFC,direct expenses,5eecc6d6449e4f7cfb1c2708,2022-03-23T00:00:00.000Z,00921000075586-TPT-109177-ROET BINDRA,,,net_banking_transfer,-109177
626247f0d8beac1599c6a369,50200023535069,955334.27,60ec41ba55c00300382672d9,HDFC,direct expenses,5eecc6d6449e4f7cfb1c2708,2022-03-23T00:00:00.000Z,NEFT DR-ICIC0004328-MICHELLE MANUEL-NETB,,,net_banking_transfer,-22250
626247f0d8beac1599c6a36b,50200023535069,934330.27,60ec41ba55c00300382672d9,HDFC,direct expenses,5eecc6d6449e4f7cfb1c2708,2022-03-23T00:00:00.000Z,02712120000086-TPT-21004-SPOTON LOGISTIC S PVT LTD,,,net_banking_transfer,-21004
626247f0d8beac1599c6a36d,50200023535069,937502.03,60ec41ba55c00300382672d9,HDFC,Revenue-Mktplace,5eecc6d6449e4f7cfb1c2708,2022-03-23T00:00:00.000Z,NEFT CR-DEUT0797BGL-MYNTRA DESIGNS PRIVA TE LIMITED-SLICK ORGANICS PVT. LTD.-2082 00569GN00265,shopping,,net_banking_transfer,3171.76
626247f0d8beac1599c6a36f,50200023535069,948614.31,60ec41ba55c00300382672d9,HDFC,Revenue-PG-split enabled,5eecc6d6449e4f7cfb1c2708,2022-03-23T00:00:00.000Z,NEFT CR-UTIB0001506-RAZORPAY SOFTWARE PR IVATE LIMITED-SLICK ORGANICS PVT LITD-AX ISCN0127892609,insurance,,net_banking_transfer,11112.28
626247f0d8beac1599c6a371,50200023535069,955664.54,60ec41ba55c00300382672d9,HDFC,Revenue-Mktplace,5eecc6d6449e4f7cfb1c2708,2022-03-23T00:00:00.000Z,NEFT CR-DEUT0797BGL-MYNTRA DESIGNS PRIVA TE LIMITED-SLICK ORGANICS PVT. LTD.-2082 00570GN00293,shopping,,net_banking_transfer,7050.23
626247f0d8beac1599c6a373,50200023535069,917462.97,60ec41ba55c00300382672d9,HDFC,SAAS/tech expense,5eecc6d6449e4f7cfb1c2708,2022-03-23T00:00:00.000Z,POS 514834XXXXXX9486 AMAZON.COM,shopping,,debit_card,-38201.57
626247f0d8beac1599c6a375,50200023535069,922011.39,60ec41ba55c00300382672d9,HDFC,Revenue-PG-non-split,5eecc6d6449e4f7cfb1c2708,2022-03-23T00:00:00.000Z,NEFT CR-SCBL0036001-STRIPE INDIA PRIVATE -SLICK ORGANICS PRIVATE LIMITED-SSG17413 Q0612523,insurance,,net_banking_transfer,4548.42
626247f0d8beac1599c6a377,50200023535069,439633.39,60ec41ba55c00300382672d9,HDFC,direct expenses,5eecc6d6449e4f7cfb1c2708,2022-03-23T00:00:00.000Z,"NEFT DR-KKBK0000180-VEDIC COSMECEUTICALS PVT LTD-NETBANK, MUM-N082221884493862-4 82378",,,net_banking_transfer,-482378
626247f0d8beac1599c6a379,50200023535069,440264.5,60ec41ba55c00300382672d9,HDFC,Revenue-Mktplace,5eecc6d6449e4f7cfb1c2708,2022-03-23T00:00:00.000Z,NEFT CR-ICIC0000105-MANASH LIFESTYLE PRI VATE LIMITED NO-SLICK ORGANICS PRIVATE L IMITED MP G-ICIJ220820005654,shopping,,net_banking_transfer,631.11
626247f0d8beac1599c6a37b,50200023535069,440266.71,60ec41ba55c00300382672d9,HDFC,Revenue-Mktplace,5eecc6d6449e4f7cfb1c2708,2022-03-23T00:00:00.000Z,NEFT CR-KKBK0000958-NYKAA E RETAIL PRIVA TE LIMITED NYKAA-SLICK ORGANICS PVT LTD- KKBK220829589538,insurance,,net_banking_transfer,2.21
626247f0d8beac1599c6a37d,50200023535069,459017.71,60ec41ba55c00300382672d9,HDFC,Revenue-Mktplace,5eecc6d6449e4f7cfb1c2708,2022-03-23T00:00:00.000Z,NEFT CR-SCBL0036001-M/S DREAMPLUG TECHNO -SLICK ORGANICS PRIVATE LIMITEDSLICK-SIN 31436Q0035761,insurance,,net_banking_transfer,18751
626247f0d8beac1599c6a37f,50200023535069,549751.53,60ec41ba55c00300382672d9,HDFC,Revenue-COD,5eecc6d6449e4f7cfb1c2708,2022-03-23T00:00:00.000Z,NEFT CR-ICIC0000155-SHIPROCKET COD CRF I D 4026052-SLICK ORGANICS PVT LTD-CMS2468 434137,insurance,,net_banking_transfer,90733.82
626247f0d8beac1599c6a381,50200023535069,564026.17,60ec41ba55c00300382672d9,HDFC,Revenue-PG-split enabled,5eecc6d6449e4f7cfb1c2708,2022-03-23T00:00:00.000Z,NEFT CR-UTIB0001506-RAZORPAY SOFTWARE PR,,,net_banking_transfer,14274.64
626247f0d8beac1599c6a383,50200023535069,567121.56,60ec41ba55c00300382672d9,HDFC,Revenue-PG-non-split,5eecc6d6449e4f7cfb1c2708,2022-03-23T00:00:00.000Z,NEFT CR-IDFB0010204-SEZZLE PAYMENTS PRIV ATE LIMITED-SLICK ORGANICS PRIVATE LIMIT ED-IDFBH22082491912,insurance,,net_banking_transfer,3095.39
626247f0d8beac1599c6a385,50200023535069,611609.07,60ec41ba55c00300382672d9,HDFC,Revenue-UPI,5eecc6d6449e4f7cfb1c2708,2022-03-23T00:00:00.000Z,UPI-GOKWIK-GOKWIK@YESBANK-YESB0000340-20 8240111241-PAYOUT FOR MARCH 2,,,upi,44487.51
626247f0d8beac1599c6a387,50200023535069,765839.07,60ec41ba55c00300382672d9,HDFC,Transfer in/Revenue-other,5eecc6d6449e4f7cfb1c2708,2022-03-23T00:00:00.000Z,ACH C- AAYCS0313H-AY2021-22-CE2217315023,,,Other,154230
626247f0d8beac1599c6a389,50200023535069,797772.52,60ec41ba55c00300382672d9,HDFC,Revenue-PG-non-split,5eecc6d6449e4f7cfb1c2708,2022-03-24T00:00:00.000Z,NEFT CR-PYTM0123456-PAYTM PAYMENTS SERVI CES LIMITED-SLICK ORGANICS PVT LTD-PYTM2 20832023834,ewallet,,net_banking_transfer,31933.45
626247f0d8beac1599c6a38b,50200023535069,797459.16,60ec41ba55c00300382672d9,HDFC,bank charges,5eecc6d6449e4f7cfb1c2708,2022-03-24T00:00:00.000Z,.DC INTL POS TXN MARKUP+ST 280222 010322 -CDT2206308248860,,,international_transaction_arbitrage,-313.36
626247f0d8beac1599c6a38d,50200023535069,804108.27,60ec41ba55c00300382672d9,HDFC,Revenue-PG-split enabled,5eecc6d6449e4f7cfb1c2708,2022-03-24T00:00:00.000Z,NEFT CR-UTIB0001506-RAZORPAY SOFTWARE PR IVATE LIMITED-SLICK ORGANICS PVT LITD-AX ISCN0128103170,insurance,,net_banking_transfer,6649.11
626247f0d8beac1599c6a38f,50200023535069,604108.27,60ec41ba55c00300382672d9,HDFC,direct expenses,5eecc6d6449e4f7cfb1c2708,2022-03-24T00:00:00.000Z,"NEFT DR-YESB0000551-VISTTA COSMETICS-NET BANK, MUM-N083221886152247-200000",,,net_banking_transfer,-200000
626247f0d8beac1599c6a391,50200023535069,604017.4,60ec41ba55c00300382672d9,HDFC,bank charges,5eecc6d6449e4f7cfb1c2708,2022-03-24T00:00:00.000Z,.DC INTL POS TXN MARKUP+ST 010322 020322 -CDT2206308248860,,,international_transaction_arbitrage,-90.87
626247f0d8beac1599c6a393,50200023535069,597267.4,60ec41ba55c00300382672d9,HDFC,direct expenses,5eecc6d6449e4f7cfb1c2708,2022-03-24T00:00:00.000Z,"NEFT DR-ICIC0000558-ANJANA MURALIDHARAN- NETBANK, MUM-N083221886734027-6750",,,net_banking_transfer,-6750
626247f0d8beac1599c6a395,50200023535069,602140.19,60ec41ba55c00300382672d9,HDFC,Revenue-PG-non-split,5eecc6d6449e4f7cfb1c2708,2022-03-24T00:00:00.000Z,NEFT CR-SCBL0036001-STRIPE INDIA PRIVATE -SLICK ORGANICS PRIVATE LIMITED-SSG17413 Q0614328,insurance,,net_banking_transfer,4872.79
626247f0d8beac1599c6a397,50200023535069,602387.21,60ec41ba55c00300382672d9,HDFC,Revenue-Mktplace,5eecc6d6449e4f7cfb1c2708,2022-03-24T00:00:00.000Z,NEFT CR-ICIC0000105-MANASH LIFESTYLE PRI VATE LIMITED NO-SLICK ORGANICS PRIVATE L IMITED MP M-ICIJ220830004378,shopping,,net_banking_transfer,247.02
626247f0d8beac1599c6a399,50200023535069,602990.48,60ec41ba55c00300382672d9,HDFC,Revenue-Mktplace,5eecc6d6449e4f7cfb1c2708,2022-03-24T00:00:00.000Z,NEFT CR-ICIC0000105-MANASH LIFESTYLE PRI VATE LIMITED NO-SLICK ORGANICS PRIVATE L IMITED BANG-ICIJ220830004379,shopping,,net_banking_transfer,603.27
626247f0d8beac1599c6a39b,50200023535069,609818.48,60ec41ba55c00300382672d9,HDFC,Transfer in/Revenue-other,5eecc6d6449e4f7cfb1c2708,2022-03-24T00:00:00.000Z,NEFT CR-HSBC0560002-INNOVATIVE RETAIL CO,,,net_banking_transfer,6828
626247f0d8beac1599c6a39d,50200023535069,618076.48,60ec41ba55c00300382672d9,HDFC,Transfer in/Revenue-other,5eecc6d6449e4f7cfb1c2708,2022-03-24T00:00:00.000Z,NEFT CR-HSBC0560002-INNOVATIVE RETAIL CO NCEPTS PRIVATE-SLICK ORGANICS PVT LTD-HS BCN22083277113,,,net_banking_transfer,8258
626247f0d8beac1599c6a39f,50200023535069,620181.27,60ec41ba55c00300382672d9,HDFC,Revenue-PG-non-split,5eecc6d6449e4f7cfb1c2708,2022-03-24T00:00:00.000Z,NEFT CR-IDFB0010204-SEZZLE PAYMENTS PRIV ATE LIMITED-SLICK ORGANICS PRIVATE LIMIT ED-IDFBH22083570440,insurance,,net_banking_transfer,2104.79
626247f0d8beac1599c6a3a1,50200023535069,632798.13,60ec41ba55c00300382672d9,HDFC,Revenue-PG-split enabled,5eecc6d6449e4f7cfb1c2708,2022-03-24T00:00:00.000Z,NEFT CR-UTIB0001506-RAZORPAY SOFTWARE PR IVATE LIMITED-SLICK ORGANICS PVT LITD-AX ISCN0128405271,insurance,,net_banking_transfer,12616.86
626247f0d8beac1599c6a3a3,50200023535069,677742.02,60ec41ba55c00300382672d9,HDFC,Revenue-UPI,5eecc6d6449e4f7cfb1c2708,2022-03-24T00:00:00.000Z,UPI-GOKWIK-GOKWIK@YESBANK-YESB0000340-20 8341978184-PAYOUT FOR MARCH 2,,,upi,44943.89
626247f0d8beac1599c6a3a5,50200023535069,683849.84,60ec41ba55c00300382672d9,HDFC,Revenue-Mktplace,5eecc6d6449e4f7cfb1c2708,2022-03-25T00:00:00.000Z,NEFT CR-DEUT0797BGL-FLIPKART INTERNET PR IVATE LIMITED-SLICK ORGANICS PVT LTD-208 400128GN00295,shopping,,net_banking_transfer,6107.82
626247f0d8beac1599c6a3a7,50200023535069,720626.74,60ec41ba55c00300382672d9,HDFC,Revenue-PG-non-split,5eecc6d6449e4f7cfb1c2708,2022-03-25T00:00:00.000Z,NEFT CR-PYTM0123456-PAYTM PAYMENTS SERVI CES LIMITED-SLICK ORGANICS PVT LTD-PYTM2 20842460922,ewallet,,net_banking_transfer,36776.9
626247f0d8beac1599c6a3a9,50200023535069,944838.73,60ec41ba55c00300382672d9,HDFC,Revenue-Mktplace,5eecc6d6449e4f7cfb1c2708,2022-03-25T00:00:00.000Z,NEFT CR-KKBK0000958-NYKAA E RETAIL PRIVA TE LIMITED NYKAA-SLICK ORGANICS PVT LTD- KKBK220849918454,insurance,,net_banking_transfer,224211.99
626247f0d8beac1599c6a3ab,50200023535069,956112.69,60ec41ba55c00300382672d9,HDFC,Revenue-PG-split enabled,5eecc6d6449e4f7cfb1c2708,2022-03-25T00:00:00.000Z,NEFT CR-UTIB0001506-RAZORPAY SOFTWARE PR IVATE LIMITED-SLICK ORGANICS PVT LITD-AX ISCN0128555914,insurance,,net_banking_transfer,11273.96
626247f0d8beac1599c6a3ad,50200023535069,958339.03,60ec41ba55c00300382672d9,HDFC,Revenue-Mktplace,5eecc6d6449e4f7cfb1c2708,2022-03-25T00:00:00.000Z,NEFT CR-DEUT0797BGL-MYNTRA DESIGNS PRIVA TE LIMITED-SLICK ORGANICS PVT. LTD.-2084 00723GN00264,shopping,,net_banking_transfer,2226.34
626247f0d8beac1599c6a3af,50200023535069,969852.34,60ec41ba55c00300382672d9,HDFC,Revenue-Mktplace,5eecc6d6449e4f7cfb1c2708,2022-03-25T00:00:00.000Z,NEFT CR-DEUT0797BGL-MYNTRA DESIGNS PRIVA TE LIMITED-SLICK ORGANICS PVT. LTD.-2084 00718GN00016,shopping,,net_banking_transfer,11513.31
626247f0d8beac1599c6a3b1,50200023535069,958169.77,60ec41ba55c00300382672d9,HDFC,bank charges,5eecc6d6449e4f7cfb1c2708,2022-03-25T00:00:00.000Z,.DC INTL POS TXN MARKUP+ST 140322 150322,,,international_transaction_arbitrage,-11682.57
626247f0d8beac1599c6a3b3,50200023535069,950169.77,60ec41ba55c00300382672d9,HDFC,direct expenses,5eecc6d6449e4f7cfb1c2708,2022-03-25T00:00:00.000Z,00291000013955-TPT-8000-ALEENA MACKAR,,,net_banking_transfer,-8000
626247f0d8beac1599c6a3b5,50200023535069,600169.77,60ec41ba55c00300382672d9,HDFC,direct expenses,5eecc6d6449e4f7cfb1c2708,2022-03-25T00:00:00.000Z,57500000443889-TPT-350000-WEBKLIPPER TEC HNOLOGIES PRIVATE LIMITED,,,net_banking_transfer,-350000
626247f0d8beac1599c6a3b7,50200023535069,300169.77,60ec41ba55c00300382672d9,HDFC,direct expenses,5eecc6d6449e4f7cfb1c2708,2022-03-25T00:00:00.000Z,05892560000649-TPT-300000-DECORPAC INDIA PRIVATE LIMITED,,,net_banking_transfer,-300000
626247f0d8beac1599c6a3b9,50200023535069,1300169.77,60ec41ba55c00300382672d9,HDFC,Internal Transfers,5eecc6d6449e4f7cfb1c2708,2022-03-25T00:00:00.000Z,IB FUNDS TRANSFER CR-50200035187206 -SL ICK ORGANICS PVT LTD,insurance,,Other,1000000
626247f0d8beac1599c6a3bb,50200023535069,300169.77,60ec41ba55c00300382672d9,HDFC,Marketing Expense,5eecc6d6449e4f7cfb1c2708,2022-03-25T00:00:00.000Z,"NEFT DR-CITI0000006-FACEBOOK INDIA ONLIN E SERVICES PVT LTD-NETBANK, MUM-N0842218 88013473-1000000",,,net_banking_transfer,-1000000
626247f0d8beac1599c6a3bd,50200023535069,45169.77,60ec41ba55c00300382672d9,HDFC,SAAS/tech expense,5eecc6d6449e4f7cfb1c2708,2022-03-25T00:00:00.000Z,POS 514834XXXXXX9486 AMAZON,shopping,,debit_card,-255000
626247f1d8beac1599c6a3bf,50200023535069,27439.77,60ec41ba55c00300382672d9,HDFC,direct expenses,5eecc6d6449e4f7cfb1c2708,2022-03-25T00:00:00.000Z,"NEFT DR-YESB0000236-DELIGHT VACATION PVT LTD-NETBANK, MUM-N084221888062034-17730",,,net_banking_transfer,-17730
626247f1d8beac1599c6a3c1,50200023535069,60947.7,60ec41ba55c00300382672d9,HDFC,Revenue-PG-split enabled,5eecc6d6449e4f7cfb1c2708,2022-03-25T00:00:00.000Z,NEFT CR-UTIB0001506-RAZORPAY SOFTWARE PR IVATE LIMITED-SLICK ORGANICS PVT LITD-AX ISCN0128702243,insurance,,net_banking_transfer,33507.93
626247f1d8beac1599c6a3c3,50200023535069,61281.15,60ec41ba55c00300382672d9,HDFC,Revenue-Mktplace,5eecc6d6449e4f7cfb1c2708,2022-03-25T00:00:00.000Z,NEFT CR-DEUT0784BBY-TATA UNISTORE LTD-NO DAL-SLICK ORGANICS PVT LTD-208401723GN00 386,insurance,,net_banking_transfer,333.45
626247f1d8beac1599c6a3c5,50200023535069,125405.04,60ec41ba55c00300382672d9,HDFC,Revenue-UPI,5eecc6d6449e4f7cfb1c2708,2022-03-25T00:00:00.000Z,UPI-GOKWIK-GOKWIK@YESBANK-YESB0000340-20 8443808989-PAYOUT FOR MARCH 2,,,upi,64123.89
626247f1d8beac1599c6a3c8,50200023535069,214910.61,60ec41ba55c00300382672d9,HDFC,Revenue-PG-non-split,5eecc6d6449e4f7cfb1c2708,2022-03-26T00:00:00.000Z,NEFT CR-PYTM0123456-PAYTM PAYMENTS SERVI CES LIMITED-SLICK ORGANICS PVT LTD-PYTM2 20852921273,ewallet,,net_banking_transfer,89505.57
626247f1d8beac1599c6a3ca,50200023535069,204910.61,60ec41ba55c00300382672d9,HDFC,Refund,5eecc6d6449e4f7cfb1c2708,2022-03-26T00:00:00.000Z,"NEFT DR-YESB0CMSNOC-RAZORPAY REFUND CRED ITS TOPUP-NETBANK, MUM-N085221889587365- 10000",bills,,net_banking_transfer,-10000
626247f1d8beac1599c6a3cc,50200023535069,251683.15,60ec41ba55c00300382672d9,HDFC,Revenue-UPI,5eecc6d6449e4f7cfb1c2708,2022-03-26T00:00:00.000Z,UPI-GOKWIK-GOKWIK@YESBANK-YESB0000340-20 8545432264-PAYOUT FOR MARCH 2,,,upi,46772.54
626247f1d8beac1599c6a3ce,50200023535069,274935.02,60ec41ba55c00300382672d9,HDFC,Revenue-PG-non-split,5eecc6d6449e4f7cfb1c2708,2022-03-27T00:00:00.000Z,IMPS-208604358654-PAYTM PAYMENTS SERVI-P,ewallet,,net_banking_transfer,23251.87
626247f1d8beac1599c6a3d0,50200023535069,474935.02,60ec41ba55c00300382672d9,HDFC,Revenue-UPI,5eecc6d6449e4f7cfb1c2708,2022-03-27T00:00:00.000Z,UPI-GOKWIK-GOKWIK@YESBANK-YESB0000340-20 8647050356-PAYOUT FOR MARCH 2,,,upi,200000
626247f1d8beac1599c6a3d2,50200023535069,515036.09,60ec41ba55c00300382672d9,HDFC,Revenue-UPI,5eecc6d6449e4f7cfb1c2708,2022-03-27T00:00:00.000Z,UPI-GOKWIK-GOKWIK@YESBANK-YESB0000340-20 8647050023-PAYOUT FOR MARCH 2,,,upi,40101.07
626247f1d8beac1599c6a3d4,50200023535069,521576.56,60ec41ba55c00300382672d9,HDFC,Revenue-Mktplace,5eecc6d6449e4f7cfb1c2708,2022-03-28T00:00:00.000Z,NEFT CR-DEUT0797BGL-FLIPKART INTERNET PR IVATE LIMITED-SLICK ORGANICS PVT LTD-208 700135GN00288,shopping,,net_banking_transfer,6540.47
626247f1d8beac1599c6a3d6,50200023535069,540887.32,60ec41ba55c00300382672d9,HDFC,Revenue-PG-non-split,5eecc6d6449e4f7cfb1c2708,2022-03-28T00:00:00.000Z,IMPS-208704980134-PAYTM PAYMENTS SERVI-P YTM-XXXXXXXXXX0008-ALL202203282168200003 30830668628,ewallet,,net_banking_transfer,19310.76
626247f1d8beac1599c6a3d8,50200023535069,543638.18,60ec41ba55c00300382672d9,HDFC,Revenue-Mktplace,5eecc6d6449e4f7cfb1c2708,2022-03-28T00:00:00.000Z,NEFT CR-DEUT0797BGL-MYNTRA DESIGNS PRIVA TE LIMITED-SLICK ORGANICS PVT. LTD.-2087 00575GN00299,shopping,,net_banking_transfer,2750.86
626247f1d8beac1599c6a3db,50200023535069,552077.41,60ec41ba55c00300382672d9,HDFC,Revenue-Mktplace,5eecc6d6449e4f7cfb1c2708,2022-03-28T00:00:00.000Z,NEFT CR-DEUT0797BGL-MYNTRA DESIGNS PRIVA TE LIMITED-SLICK ORGANICS PVT. LTD.-2087 00596GN00043,shopping,,net_banking_transfer,8439.23
626247f1d8beac1599c6a3dd,50200023535069,658812.7,60ec41ba55c00300382672d9,HDFC,Revenue-PG-split enabled,5eecc6d6449e4f7cfb1c2708,2022-03-28T00:00:00.000Z,NEFT CR-UTIB0001506-RAZORPAY SOFTWARE PR IVATE LIMITED-SLICK ORGANICS PVT LITD-AX ISCN0128922586,insurance,,net_banking_transfer,106735.29
626247f1d8beac1599c6a3e0,50200023535069,550812.7,60ec41ba55c00300382672d9,HDFC,direct expenses,5eecc6d6449e4f7cfb1c2708,2022-03-28T00:00:00.000Z,50200060178580-TPT-108000-CITREA GROWTH PARTNERS PRIVATE LIMITED,,,net_banking_transfer,-108000
626247f1d8beac1599c6a3e3,50200023535069,627056.47,60ec41ba55c00300382672d9,HDFC,Revenue-Mktplace,5eecc6d6449e4f7cfb1c2708,2022-03-28T00:00:00.000Z,IMPS-208712376467-AMAZON SELLER SERVIC-H SBC-XXXXXXXX6004-3IDJNNYFCSGBFXIRSLICK O RGANICS PVT LTD,shopping,,net_banking_transfer,76243.77
626247f1d8beac1599c6a3e5,50200023535069,1136702.88,60ec41ba55c00300382672d9,HDFC,Revenue-Mktplace,5eecc6d6449e4f7cfb1c2708,2022-03-28T00:00:00.000Z,NEFT CR-DEUT0797BGL-AMAZON PAY (INDIA) P RIVATE LIMITED-SLICK ORGANICS PVT LTD-20 8700810GN00041,shopping,,net_banking_transfer,509646.41
626247f1d8beac1599c6a3e7,50200023535069,1206743.29,60ec41ba55c00300382672d9,HDFC,Revenue-COD,5eecc6d6449e4f7cfb1c2708,2022-03-28T00:00:00.000Z,NEFT CR-ICIC0000155-SHIPROCKET COD CRF I D 4054638-SLICK ORGANICS PVT LTD-CMS2478 574641,insurance,,net_banking_transfer,70040.41
626247f1d8beac1599c6a3ea,50200023535069,1217789.29,60ec41ba55c00300382672d9,HDFC,Transfer in/Revenue-other,5eecc6d6449e4f7cfb1c2708,2022-03-28T00:00:00.000Z,50200050241205-TPT-ARATA-NAPSA PRIVATE L,,,net_banking_transfer,11046
626247f1d8beac1599c6a3ec,50200023535069,1057787.29,60ec41ba55c00300382672d9,HDFC,direct expenses,5eecc6d6449e4f7cfb1c2708,2022-03-28T00:00:00.000Z,"NEFT DR-YESB0000162-VINAY REDDY-NETBANK, MUM-N087221890680164-160002",,,net_banking_transfer,-160002
626247f1d8beac1599c6a3ef,50200023535069,1058606.05,60ec41ba55c00300382672d9,HDFC,Revenue-Mktplace,5eecc6d6449e4f7cfb1c2708,2022-03-28T00:00:00.000Z,NEFT CR-ICIC0000105-MANASH LIFESTYLE PRI VATE LIMITED NO-SLICK ORGANICS PRIVATE L IMITED MP G-ICIJ220870006104,shopping,,net_banking_transfer,818.76
626247f1d8beac1599c6a3f1,50200023535069,1059810.38,60ec41ba55c00300382672d9,HDFC,Revenue-Mktplace,5eecc6d6449e4f7cfb1c2708,2022-03-28T00:00:00.000Z,NEFT CR-ICIC0000105-MANASH LIFESTYLE PRI VATE LIMITED NO-SLICK ORGANICS PRIVATE L IMITED BANG-ICIJ220870006106,shopping,,net_banking_transfer,1204.33
626247f1d8beac1599c6a3f3,50200023535069,1060084.52,60ec41ba55c00300382672d9,HDFC,Revenue-Mktplace,5eecc6d6449e4f7cfb1c2708,2022-03-28T00:00:00.000Z,NEFT CR-ICIC0000105-MANASH LIFESTYLE PRI VATE LIMITED NO-SLICK ORGANICS PRIVATE L IMITED MP M-ICIJ220870006105,shopping,,net_banking_transfer,274.14
626247f1d8beac1599c6a3f5,50200023535069,1071726.92,60ec41ba55c00300382672d9,HDFC,Revenue-PG-split enabled,5eecc6d6449e4f7cfb1c2708,2022-03-28T00:00:00.000Z,NEFT CR-UTIB0001506-RAZORPAY SOFTWARE PR IVATE LIMITED-SLICK ORGANICS PVT LITD-AX ISCN0129100463,insurance,,net_banking_transfer,11642.4
626247f1d8beac1599c6a3f7,50200023535069,1076252.71,60ec41ba55c00300382672d9,HDFC,Revenue-PG-non-split,5eecc6d6449e4f7cfb1c2708,2022-03-28T00:00:00.000Z,NEFT CR-IDFB0010204-SEZZLE PAYMENTS PRIV ATE LIMITED-SLICK ORGANICS PRIVATE LIMIT ED-IDFBH22087880016,insurance,,net_banking_transfer,4525.79
626247f1d8beac1599c6a3f9,50200023535069,1148436.66,60ec41ba55c00300382672d9,HDFC,Revenue-UPI,5eecc6d6449e4f7cfb1c2708,2022-03-28T00:00:00.000Z,UPI-GOKWIK-GOKWIK@YESBANK-YESB0000340-20 8748995381-PAYOUT FOR MARCH 2,,,upi,72183.95
626247f1d8beac1599c6a3fb,50200023535069,1123436.66,60ec41ba55c00300382672d9,HDFC,Refund,5eecc6d6449e4f7cfb1c2708,2022-03-28T00:00:00.000Z,"NEFT DR-YESB0CMSNOC-RAZORPAY REFUND CRED ITS TOPUP-NETBANK, MUM-N087221891718545- 25000",bills,,net_banking_transfer,-25000
626247f1d8beac1599c6a3fd,50200023535069,1144789.06,60ec41ba55c00300382672d9,HDFC,Revenue-PG-non-split,5eecc6d6449e4f7cfb1c2708,2022-03-29T00:00:00.000Z,IMPS-208804628969-PAYTM PAYMENTS SERVI-P YTM-XXXXXXXXXX0008-ALL202203292168200003 30830668628,ewallet,,net_banking_transfer,21352.4
626247f1d8beac1599c6a3ff,50200023535069,1156681.95,60ec41ba55c00300382672d9,HDFC,Revenue-PG-split enabled,5eecc6d6449e4f7cfb1c2708,2022-03-29T00:00:00.000Z,NEFT CR-UTIB0001506-RAZORPAY SOFTWARE PR IVATE LIMITED-SLICK ORGANICS PVT LITD-AX ISCN0129178015,insurance,,net_banking_transfer,11892.89
626247f1d8beac1599c6a401,50200023535069,156681.95,60ec41ba55c00300382672d9,HDFC,Tax,5eecc6d6449e4f7cfb1c2708,2022-03-29T00:00:00.000Z,051030829032212831- CBDT TAX,,,Other,-1000000
626247f1d8beac1599c6a403,50200023535069,138141.95,60ec41ba55c00300382672d9,HDFC,direct expenses,5eecc6d6449e4f7cfb1c2708,2022-03-29T00:00:00.000Z,"NEFT DR-SBIN0008078-PANDIT PLASTICS-NETB ANK, MUM-N088221892173656-18540",,,net_banking_transfer,-18540
626247f1d8beac1599c6a405,50200023535069,141434.32,60ec41ba55c00300382672d9,HDFC,Revenue-PG-non-split,5eecc6d6449e4f7cfb1c2708,2022-03-29T00:00:00.000Z,NEFT CR-SCBL0036001-STRIPE INDIA PRIVATE,,,net_banking_transfer,3292.37
626247f1d8beac1599c6a407,50200023535069,126566.32,60ec41ba55c00300382672d9,HDFC,direct expenses,5eecc6d6449e4f7cfb1c2708,2022-03-29T00:00:00.000Z,"NEFT DR-KKBK0000173-MATRIX PRINTING SOLU TIONS PRIVATE LIMITE-NETBANK, MUM-N08822 1892369886-14868",,,net_banking_transfer,-14868
626247f1d8beac1599c6a409,50200023535069,126971.35,60ec41ba55c00300382672d9,HDFC,Transfer in/Revenue-other,5eecc6d6449e4f7cfb1c2708,2022-03-29T00:00:00.000Z,4060012625-29 03 2022-HDFAZCUR1,,,Other,405.03
626247f1d8beac1599c6a40b,50200023535069,128859.64,60ec41ba55c00300382672d9,HDFC,Revenue-Mktplace,5eecc6d6449e4f7cfb1c2708,2022-03-29T00:00:00.000Z,4060012551-TIMES INTERNET LIMITED NODAL,,,Other,1888.29
626247f1d8beac1599c6a40d,50200023535069,140792.22,60ec41ba55c00300382672d9,HDFC,Revenue-PG-split enabled,5eecc6d6449e4f7cfb1c2708,2022-03-29T00:00:00.000Z,NEFT CR-UTIB0001506-RAZORPAY SOFTWARE PR IVATE LIMITED-SLICK ORGANICS PVT LITD-AX ISCN0129310108,insurance,,net_banking_transfer,11932.58
626247f1d8beac1599c6a40f,50200023535069,34592.22,60ec41ba55c00300382672d9,HDFC,direct expenses,5eecc6d6449e4f7cfb1c2708,2022-03-29T00:00:00.000Z,"NEFT DR-DEUT0784BBY-TATA AIG GENERAL INS URANCE CO LTD-NETBANK, MUM-N088221893314 433-106200",insurance,,net_banking_transfer,-106200
626247f1d8beac1599c6a411,50200023535069,96141.61,60ec41ba55c00300382672d9,HDFC,Revenue-UPI,5eecc6d6449e4f7cfb1c2708,2022-03-29T00:00:00.000Z,UPI-GOKWIK-GOKWIK@YESBANK-YESB0000340-20 8850826242-PAYOUT FOR MARCH 2,,,upi,61549.39
626247f1d8beac1599c6a413,50200023535069,98025.12,60ec41ba55c00300382672d9,HDFC,Transfer in/Revenue-other,5eecc6d6449e4f7cfb1c2708,2022-03-29T00:00:00.000Z,CRV POS-514834******9486-0327-AMZN MKTP,,,refund,1883.51
626247f1d8beac1599c6a415,50200023535069,101585.52,60ec41ba55c00300382672d9,HDFC,Revenue-Mktplace,5eecc6d6449e4f7cfb1c2708,2022-03-30T00:00:00.000Z,NEFT CR-DEUT0797BGL-FLIPKART INTERNET PR IVATE LIMITED-SLICK ORGANICS PVT LTD-208 900113GN00058,shopping,,net_banking_transfer,3560.4
626247f1d8beac1599c6a418,50200023535069,136671.17,60ec41ba55c00300382672d9,HDFC,Revenue-PG-non-split,5eecc6d6449e4f7cfb1c2708,2022-03-30T00:00:00.000Z,NEFT CR-PYTM0123456-PAYTM PAYMENTS SERVI CES LIMITED-SLICK ORGANICS PVT LTD-PYTM2 20894665987,ewallet,,net_banking_transfer,35085.65
626247f1d8beac1599c6a41a,50200023535069,151997.41,60ec41ba55c00300382672d9,HDFC,Revenue-PG-split enabled,5eecc6d6449e4f7cfb1c2708,2022-03-30T00:00:00.000Z,NEFT CR-UTIB0001506-RAZORPAY SOFTWARE PR IVATE LIMITED-SLICK ORGANICS PVT LITD-AX ISCN0129379373,insurance,,net_banking_transfer,15326.24
626247f1d8beac1599c6a41d,50200023535069,167214.18,60ec41ba55c00300382672d9,HDFC,Revenue-PG-non-split,5eecc6d6449e4f7cfb1c2708,2022-03-30T00:00:00.000Z,NEFT CR-IDFB0010204-SEZZLE PAYMENTS PRIV ATE LIMITED-SLICK ORGANICS PRIVATE LIMIT ED-IDFBH22089029740,insurance,,net_banking_transfer,15216.77
626247f1d8beac1599c6a41f,50200023535069,160745.05,60ec41ba55c00300382672d9,HDFC,SAAS/tech expense,5eecc6d6449e4f7cfb1c2708,2022-03-30T00:00:00.000Z,POS 514834XXXXXX9486 AMAZON,shopping,,debit_card,-6469.13
626247f1d8beac1599c6a422,50200023535069,153634.9,60ec41ba55c00300382672d9,HDFC,SAAS/tech expense,5eecc6d6449e4f7cfb1c2708,2022-03-30T00:00:00.000Z,POS 514834XXXXXX9486 AMAZON,shopping,,debit_card,-7110.15
626247f1d8beac1599c6a430,50200023535069,146583.6,60ec41ba55c00300382672d9,HDFC,SAAS/tech expense,5eecc6d6449e4f7cfb1c2708,2022-03-30T00:00:00.000Z,POS 514834XXXXXX9486 AMAZON,shopping,,debit_card,-7051.3
626247f1d8beac1599c6a43a,50200023535069,139688.61,60ec41ba55c00300382672d9,HDFC,SAAS/tech expense,5eecc6d6449e4f7cfb1c2708,2022-03-30T00:00:00.000Z,POS 514834XXXXXX9486 AMAZON,shopping,,debit_card,-6894.99
626247f1d8beac1599c6a446,50200023535069,132593.73,60ec41ba55c00300382672d9,HDFC,SAAS/tech expense,5eecc6d6449e4f7cfb1c2708,2022-03-30T00:00:00.000Z,POS 514834XXXXXX9486 AMAZON,shopping,,debit_card,-7094.88
626247f1d8beac1599c6a448,50200023535069,125785.28,60ec41ba55c00300382672d9,HDFC,SAAS/tech expense,5eecc6d6449e4f7cfb1c2708,2022-03-30T00:00:00.000Z,POS 514834XXXXXX9486 AMAZON,shopping,,debit_card,-6808.45
626247f1d8beac1599c6a44a,50200023535069,118842.59,60ec41ba55c00300382672d9,HDFC,SAAS/tech expense,5eecc6d6449e4f7cfb1c2708,2022-03-30T00:00:00.000Z,POS 514834XXXXXX9486 AMAZON,shopping,,debit_card,-6942.69
626247f1d8beac1599c6a44c,50200023535069,111791.77,60ec41ba55c00300382672d9,HDFC,SAAS/tech expense,5eecc6d6449e4f7cfb1c2708,2022-03-30T00:00:00.000Z,POS 514834XXXXXX9486 AMAZON,shopping,,debit_card,-7050.82
626247f1d8beac1599c6a44e,50200023535069,104975.97,60ec41ba55c00300382672d9,HDFC,SAAS/tech expense,5eecc6d6449e4f7cfb1c2708,2022-03-30T00:00:00.000Z,POS 514834XXXXXX9486 AMAZON,shopping,,debit_card,-6815.8
626247f1d8beac1599c6a450,50200023535069,98107.57,60ec41ba55c00300382672d9,HDFC,SAAS/tech expense,5eecc6d6449e4f7cfb1c2708,2022-03-30T00:00:00.000Z,POS 514834XXXXXX9486 AMAZON,shopping,,debit_card,-6868.4
626247f1d8beac1599c6a457,50200023535069,113107.57,60ec41ba55c00300382672d9,HDFC,Transfer in/Revenue-other,5eecc6d6449e4f7cfb1c2708,2022-03-30T00:00:00.000Z,NEFT CR-UTIB0003683-ALPHACMA PRIVATE LIM ITED-SLICK ORGANICS PVT LTD-AXIC22089905 6364,,,net_banking_transfer,15000
626247f1d8beac1599c6a45a,50200023535069,116540,60ec41ba55c00300382672d9,HDFC,Revenue-PG-non-split,5eecc6d6449e4f7cfb1c2708,2022-03-30T00:00:00.000Z,NEFT CR-IDFB0010204-SEZZLE PAYMENTS PRIV ATE LIMITED-SLICK ORGANICS PRIVATE LIMIT ED-IDFBH22089065298,insurance,,net_banking_transfer,3432.43
626247f1d8beac1599c6a45c,50200023535069,117448.21,60ec41ba55c00300382672d9,HDFC,Revenue-Mktplace,5eecc6d6449e4f7cfb1c2708,2022-03-30T00:00:00.000Z,NEFT CR-ICIC0000105-MANASH LIFESTYLE PRI VATE LIMITED NO-SLICK ORGANICS PRIVATE L IMITED MP G-ICIJ220890006803,shopping,,net_banking_transfer,908.21
626247f1d8beac1599c6a45e,50200023535069,118327.09,60ec41ba55c00300382672d9,HDFC,Revenue-Mktplace,5eecc6d6449e4f7cfb1c2708,2022-03-30T00:00:00.000Z,NEFT CR-ICIC0000105-MANASH LIFESTYLE PRI VATE LIMITED NO-SLICK ORGANICS PRIVATE L IMITED MP M-ICIJ220890006805,shopping,,net_banking_transfer,878.88
626247f1d8beac1599c6a461,50200023535069,119468.4,60ec41ba55c00300382672d9,HDFC,Revenue-Mktplace,5eecc6d6449e4f7cfb1c2708,2022-03-30T00:00:00.000Z,NEFT CR-ICIC0000105-MANASH LIFESTYLE PRI VATE LIMITED NO-SLICK ORGANICS PRIVATE L IMITED BANG-ICIJ220890006806,shopping,,net_banking_transfer,1141.31
626247f1d8beac1599c6a463,50200023535069,619468.4,60ec41ba55c00300382672d9,HDFC,Internal Transfers,5eecc6d6449e4f7cfb1c2708,2022-03-30T00:00:00.000Z,IB FUNDS TRANSFER CR-50200035187206 -SL ICK ORGANICS PVT LTD,insurance,,Other,500000
626247f1d8beac1599c6a465,50200023535069,648550.25,60ec41ba55c00300382672d9,HDFC,Revenue-Mktplace,5eecc6d6449e4f7cfb1c2708,2022-03-30T00:00:00.000Z,NEFT CR-HSBC0400002-AMAZON SERVICES LLC- SLICK ORGANICS PRIVATE LIMITED-HSBCN2208 9366981,shopping,,net_banking_transfer,29081.85
626247f1d8beac1599c6a467,50200023535069,658248.3,60ec41ba55c00300382672d9,HDFC,Revenue-PG-split enabled,5eecc6d6449e4f7cfb1c2708,2022-03-30T00:00:00.000Z,NEFT CR-UTIB0001506-RAZORPAY SOFTWARE PR IVATE LIMITED-SLICK ORGANICS PVT LITD-AX ISCN0129540924,insurance,,net_banking_transfer,9698.05
626247f1d8beac1599c6a469,50200023535069,662626.2,60ec41ba55c00300382672d9,HDFC,Revenue-COD,5eecc6d6449e4f7cfb1c2708,2022-03-30T00:00:00.000Z,NEFT CR-ICIC0000155-SHIPROCKET COD CRF I,,,net_banking_transfer,4377.9
626247f1d8beac1599c6a46b,50200023535069,511426.2,60ec41ba55c00300382672d9,HDFC,agency/vendor expense,5eecc6d6449e4f7cfb1c2708,2022-03-30T00:00:00.000Z,"NEFT DR-UTIB0000020-FIREFOX MEDIA-NETBAN K, MUM-N089221895286864-151200",,,net_banking_transfer,-151200
626247f1d8beac1599c6a46d,50200023535069,562797.2,60ec41ba55c00300382672d9,HDFC,Revenue-UPI,5eecc6d6449e4f7cfb1c2708,2022-03-30T00:00:00.000Z,UPI-GOKWIK-GOKWIK@YESBANK-YESB0000340-20 8952912980-PAYOUT FOR MARCH 2,,,upi,51371
626247f1d8beac1599c6a46f,50200023535069,562618.2,60ec41ba55c00300382672d9,HDFC,SAAS/tech expense,5eecc6d6449e4f7cfb1c2708,2022-03-30T00:00:00.000Z,ME DC SI 514834XXXXXX9486 AMAZON,shopping,,Other,-179
626247f1d8beac1599c6a471,50200023535069,609749.8,60ec41ba55c00300382672d9,HDFC,Revenue-PG-non-split,5eecc6d6449e4f7cfb1c2708,2022-03-31T00:00:00.000Z,NEFT CR-PYTM0123456-PAYTM PAYMENTS SERVI CES LIMITED-SLICK ORGANICS PVT LTD-PYTM2 20905162857,ewallet,,net_banking_transfer,47131.6
626247f1d8beac1599c6a473,50200023535069,644404.25,60ec41ba55c00300382672d9,HDFC,Revenue-PG-split enabled,5eecc6d6449e4f7cfb1c2708,2022-03-31T00:00:00.000Z,NEFT CR-UTIB0001506-RAZORPAY SOFTWARE PR IVATE LIMITED-SLICK ORGANICS PVT LITD-AX ISCN0129646559,insurance,,net_banking_transfer,34654.45
626247f1d8beac1599c6a475,50200023535069,144404.25,60ec41ba55c00300382672d9,HDFC,direct expenses,5eecc6d6449e4f7cfb1c2708,2022-03-31T00:00:00.000Z,"NEFT DR-ICIC0000369-BO INTERNATIONAL-NET BANK, MUM-N090221895767300-500000",,,net_banking_transfer,-500000
626247f1d8beac1599c6a477,50200023535069,644404.25,60ec41ba55c00300382672d9,HDFC,Internal Transfers,5eecc6d6449e4f7cfb1c2708,2022-03-31T00:00:00.000Z,IB FUNDS TRANSFER CR-50200035187206 -SL ICK ORGANICS PVT LTD,insurance,,Other,500000
626247f1d8beac1599c6a479,50200023535069,499834.25,60ec41ba55c00300382672d9,HDFC,direct expenses,5eecc6d6449e4f7cfb1c2708,2022-03-31T00:00:00.000Z,"NEFT DR-PUNB0642000-UFLEX LIMITED-NETBAN K, MUM-N090221895900458-144570",loans,lender_transaction,net_banking_transfer,-144570
626247f1d8beac1599c6a47b,50200023535069,337834.25,60ec41ba55c00300382672d9,HDFC,direct expenses,5eecc6d6449e4f7cfb1c2708,2022-03-31T00:00:00.000Z,50200029847721-TPT-162000-SPITI CONSULTI NG,,,net_banking_transfer,-162000
626247f1d8beac1599c6a47d,50200023535069,2291033.77,60ec41ba55c00300382672d9,HDFC,Revenue-Mktplace,5eecc6d6449e4f7cfb1c2708,2022-03-31T00:00:00.000Z,NEFT CR-KKBK0000958-NYKAA E RETAIL PRIVA TE LIMITED NYKAA-SLICK ORGANICS PVT LTD- KKBK220903114763,insurance,,net_banking_transfer,1953199.52
626247f1d8beac1599c6a47f,50200023535069,2330604.97,60ec41ba55c00300382672d9,HDFC,Revenue-COD,5eecc6d6449e4f7cfb1c2708,2022-03-31T00:00:00.000Z,NEFT CR-ICIC0000155-BIGFOOT RETAIL SOLUT IONS PVT L-SLICK ORGANICS PVT LTD-CMS248 7601607,,,net_banking_transfer,39571.2
626247f1d8beac1599c6a481,50200023535069,2331416.81,60ec41ba55c00300382672d9,HDFC,Revenue-Mktplace,5eecc6d6449e4f7cfb1c2708,2022-03-31T00:00:00.000Z,NEFT CR-DEUT0784BBY-TATA UNISTORE LTD-NO DAL-SLICK ORGANICS PVT LTD-209001893GN00 371,insurance,,net_banking_transfer,811.84
626247f1d8beac1599c6a483,50200023535069,2357329.74,60ec41ba55c00300382672d9,HDFC,Revenue-PG-split enabled,5eecc6d6449e4f7cfb1c2708,2022-03-31T00:00:00.000Z,NEFT CR-UTIB0001506-RAZORPAY SOFTWARE PR,,,net_banking_transfer,25912.93
626247f1d8beac1599c6a485,50200023535069,2304799.74,60ec41ba55c00300382672d9,HDFC,agency/vendor expense,5eecc6d6449e4f7cfb1c2708,2022-03-31T00:00:00.000Z,"NEFT DR-IDFB0021001-CLICKONIK DIGITAL ME DIA PVT LTD-NETBANK, MUM-N09022189785181 9-52530",insurance,,net_banking_transfer,-52530
626247f1d8beac1599c6a489,50200023535069,1954799.74,60ec41ba55c00300382672d9,HDFC,direct expenses,5eecc6d6449e4f7cfb1c2708,2022-03-31T00:00:00.000Z,57500000443889-TPT-350000-WEBKLIPPER TEC HNOLOGIES PRIVATE LIMITED,,,net_banking_transfer,-350000
626247f2d8beac1599c6a48b,50200023535069,2023544.38,60ec41ba55c00300382672d9,HDFC,Revenue-UPI,5eecc6d6449e4f7cfb1c2708,2022-03-31T00:00:00.000Z,UPI-GOKWIK-GOKWIK@YESBANK-YESB0000340-20,,,upi,68744.64
6329a4622e1a0ebb7f3cacf6,50200035187206,17004841.28,60ec419255c00300382671a5,HDFC,Transfer in/Revenue-other,5eecc6d6449e4f7cfb1c2708,2021-07-20T00:00:00.000Z,FT - CR - 05421050007790 - NIKHIL KISHOR E VORA,,,Other,5000000
6329a4622e1a0ebb7f3cacfb,50200035187206,6004841.28,60ec419255c00300382671a5,HDFC,direct expenses,5eecc6d6449e4f7cfb1c2708,2021-07-29T00:00:00.000Z,FD BOOKED - 50300537849841 : SLICK ORGAN ICS PVT LTD,insurance,,investment,-10000000
6329a4622e1a0ebb7f3cad19,50200035187206,-999574.72,60ec419255c00300382671a5,HDFC,Internal Transfers,5eecc6d6449e4f7cfb1c2708,2021-09-07T00:00:00.000Z,IB FUNDS TRANSFER DR-50200023535069 -SL ICK ORGANICS PVT LTD,insurance,,net_banking_transfer,-1000000
6329a4622e1a0ebb7f3cad52,50200035187206,28004035.82,60ec419255c00300382671a5,HDFC,direct expenses,5eecc6d6449e4f7cfb1c2708,2021-11-29T00:00:00.000Z,FD BOOKED - 50300572637408 : SLICK ORGAN ICS PVT LTD,insurance,,investment,-15000000
6329a4622e1a0ebb7f3cad7e,50200035187206,-1999732.18,60ec419255c00300382671a5,HDFC,Internal Transfers,5eecc6d6449e4f7cfb1c2708,2021-12-15T00:00:00.000Z,IB FUNDS TRANSFER DR-50200023535069 -SL ICK ORGANICS PVT LTD,insurance,,net_banking_transfer,-500000
6329a4622e1a0ebb7f3cadaa,50200035187206,-2499017.18,60ec419255c00300382671a5,HDFC,Internal Transfers,5eecc6d6449e4f7cfb1c2708,2022-01-07T00:00:00.000Z,IB FUNDS TRANSFER DR-50200023535069 -SL ICK ORGANICS PVT LTD,insurance,,net_banking_transfer,-500000
6329a4632e1a0ebb7f3cadc5,50200035187206,-1998796.18,60ec419255c00300382671a5,HDFC,Internal Transfers,5eecc6d6449e4f7cfb1c2708,2022-01-14T00:00:00.000Z,IB FUNDS TRANSFER DR-50200023535069 -SL ICK ORGANICS PVT LTD,insurance,,net_banking_transfer,-1500000
6329a4632e1a0ebb7f3cae5b,50200035187206,5119569.97,60ec419255c00300382671a5,HDFC,Transfer in/Revenue-other,5eecc6d6449e4f7cfb1c2708,2022-07-04T00:00:00.000Z,FT - CR - 50100198713718 - BHAVNA SAKUL NARULA,,,Other,3010217.43
6329a4632e1a0ebb7f3cae5d,50200035187206,11118032.97,60ec419255c00300382671a5,HDFC,Transfer in/Revenue-other,5eecc6d6449e4f7cfb1c2708,2022-07-04T00:00:00.000Z,FT - CR - 00891530001382 - ARJUN MALHOTR A,,,Other,5998463
6329a4632e1a0ebb7f3cae60,50200035187206,51129755.16,60ec419255c00300382671a5,HDFC,Transfer in/Revenue-other,5eecc6d6449e4f7cfb1c2708,2022-07-04T00:00:00.000Z,RTGS CR-KKBK0000958-SABJOT SINGH SAHNI-S LICK ORGANICS PRIVATE LIMITED-KKBKR52022 070400935765,insurance,insurance,net_banking_transfer,40011722.19
6329a4632e1a0ebb7f3cae62,50200035187206,50029755.16,60ec419255c00300382671a5,HDFC,Internal Transfers,5eecc6d6449e4f7cfb1c2708,2022-07-06T00:00:00.000Z,IB FUNDS TRANSFER DR-50200023535069 -SL ICK ORGANICS PVT LTD,,,net_banking_transfer,-1100000
6329a4632e1a0ebb7f3cae64,50200035187206,48029755.16,60ec419255c00300382671a5,HDFC,Internal Transfers,5eecc6d6449e4f7cfb1c2708,2022-07-06T00:00:00.000Z,IB FUNDS TRANSFER DR-50200023535069 -SL ICK ORGANICS PVT LTD,,,net_banking_transfer,-2000000
6329a4632e1a0ebb7f3cae66,50200035187206,47029755.16,60ec419255c00300382671a5,HDFC,Internal Transfers,5eecc6d6449e4f7cfb1c2708,2022-07-07T00:00:00.000Z,IB FUNDS TRANSFER DR-50200023535069 -SL ICK ORGANICS PVT LTD,,,net_banking_transfer,-1000000
6329a4632e1a0ebb7f3cae68,50200035187206,46129755.16,60ec419255c00300382671a5,HDFC,Internal Transfers,5eecc6d6449e4f7cfb1c2708,2022-07-07T00:00:00.000Z,IB FUNDS TRANSFER DR-50200023535069 -SL ICK ORGANICS PVT LTD,,,net_banking_transfer,-900000
6329a4632e1a0ebb7f3cae6a,50200035187206,45129755.16,60ec419255c00300382671a5,HDFC,Internal Transfers,5eecc6d6449e4f7cfb1c2708,2022-07-07T00:00:00.000Z,IB FUNDS TRANSFER DR-50200023535069 -SL ICK ORGANICS PVT LTD,,,net_banking_transfer,-1000000
6329a4632e1a0ebb7f3cae6c,50200035187206,5129755.16,60ec419255c00300382671a5,HDFC,direct expenses,5eecc6d6449e4f7cfb1c2708,2022-07-07T00:00:00.000Z,FD BOOKED - 50300648944085 : SLICK ORGAN ICS PVT LTD,,,investment,-40000000
6329a4632e1a0ebb7f3cae6e,50200035187206,4129755.16,60ec419255c00300382671a5,HDFC,Internal Transfers,5eecc6d6449e4f7cfb1c2708,2022-07-07T00:00:00.000Z,IB FUNDS TRANSFER DR-50200023535069 -SL ICK ORGANICS PVT LTD,,,net_banking_transfer,-1000000
6329a4632e1a0ebb7f3cae70,50200035187206,29755.16,60ec419255c00300382671a5,HDFC,Internal Transfers,5eecc6d6449e4f7cfb1c2708,2022-07-08T00:00:00.000Z,IB FUNDS TRANSFER DR-50200023535069 -SL ICK ORGANICS PVT LTD,,,net_banking_transfer,-4100000
6329a4632e1a0ebb7f3cae72,50200035187206,-970244.84,60ec419255c00300382671a5,HDFC,Internal Transfers,5eecc6d6449e4f7cfb1c2708,2022-07-12T00:00:00.000Z,IB FUNDS TRANSFER DR-50200023535069 -SL ICK ORGANICS PVT LTD,,,net_banking_transfer,-1000000
6329a4632e1a0ebb7f3cae74,50200035187206,0.16,60ec419255c00300382671a5,HDFC,Loan-in,5eecc6d6449e4f7cfb1c2708,2022-07-13T00:00:00.000Z,SWEEP-IN CREDIT - 50300648944085,,,self_transfer,970245
6329a4632e1a0ebb7f3cae76,50200035187206,-999999.84,60ec419255c00300382671a5,HDFC,Internal Transfers,5eecc6d6449e4f7cfb1c2708,2022-07-13T00:00:00.000Z,IB FUNDS TRANSFER DR-50200023535069 -SL ICK ORGANICS PVT LTD,,,net_banking_transfer,-1000000
6329a4632e1a0ebb7f3cae78,50200035187206,-1499999.84,60ec419255c00300382671a5,HDFC,Internal Transfers,5eecc6d6449e4f7cfb1c2708,2022-07-13T00:00:00.000Z,IB FUNDS TRANSFER DR-50200023535069 -SL,,,net_banking_transfer,-500000
6329a4632e1a0ebb7f3cae7a,50200035187206,-499999.84,60ec419255c00300382671a5,HDFC,Loan-in,5eecc6d6449e4f7cfb1c2708,2022-07-14T00:00:00.000Z,SWEEP-IN CREDIT - 50300648944085,,,self_transfer,1000000
6329a4632e1a0ebb7f3cae7c,50200035187206,0.16,60ec419255c00300382671a5,HDFC,Loan-in,5eecc6d6449e4f7cfb1c2708,2022-07-14T00:00:00.000Z,SWEEP-IN CREDIT - 50300648944085,,,self_transfer,500000
6329a4632e1a0ebb7f3cae7e,50200035187206,5009705.08,60ec419255c00300382671a5,HDFC,Transfer in/Revenue-other,5eecc6d6449e4f7cfb1c2708,2022-07-15T00:00:00.000Z,RTGS CR-IBKL0000874-VIRAT RAJ BOBAL-SLIC K ORGANICS PRIVATE LIMITED-IBKLR92022071 500028799,,,net_banking_transfer,5009704.92
6329a4632e1a0ebb7f3cae80,50200035187206,5029498.08,60ec419255c00300382671a5,HDFC,Investment/FD redeem,5eecc6d6449e4f7cfb1c2708,2022-07-18T00:00:00.000Z,FD REDEEM INTEREST -50300648944085/1,,,Other,19793
6329a4632e1a0ebb7f3cae82,50200035187206,42559253.08,60ec419255c00300382671a5,HDFC,Investment/FD redeem,5eecc6d6449e4f7cfb1c2708,2022-07-18T00:00:00.000Z,FD REDEEM PRINCIPAL -50300648944085/1,,,Other,37529755
6329a4632e1a0ebb7f3cae84,50200035187206,39059253.08,60ec419255c00300382671a5,HDFC,Internal Transfers,5eecc6d6449e4f7cfb1c2708,2022-07-18T00:00:00.000Z,IB FUNDS TRANSFER DR-50200023535069 -SL ICK ORGANICS PVT LTD,,,net_banking_transfer,-3500000
6329a4632e1a0ebb7f3cae86,50200035187206,34059253.08,60ec419255c00300382671a5,HDFC,Internal Transfers,5eecc6d6449e4f7cfb1c2708,2022-07-18T00:00:00.000Z,IB FUNDS TRANSFER DR-50200023535069 -SL ICK ORGANICS PVT LTD,,,net_banking_transfer,-5000000
6329a4632e1a0ebb7f3cae88,50200035187206,29059253.08,60ec419255c00300382671a5,HDFC,Internal Transfers,5eecc6d6449e4f7cfb1c2708,2022-07-18T00:00:00.000Z,IB FUNDS TRANSFER DR-50200023535069 -SL ICK ORGANICS PVT LTD,,,net_banking_transfer,-5000000
6329a4632e1a0ebb7f3cae8a,50200035187206,26559253.08,60ec419255c00300382671a5,HDFC,Internal Transfers,5eecc6d6449e4f7cfb1c2708,2022-07-18T00:00:00.000Z,IB FUNDS TRANSFER DR-50200023535069 -SL ICK ORGANICS PVT LTD,,,net_banking_transfer,-2500000
6329a4632e1a0ebb7f3cae8c,50200035187206,6559253.08,60ec419255c00300382671a5,HDFC,direct expenses,5eecc6d6449e4f7cfb1c2708,2022-07-18T00:00:00.000Z,FD BOOKED - 50300653996950 : SLICK ORGAN,insurance,insurance,investment,-20000000
6329a4632e1a0ebb7f3cae8e,50200035187206,22549276,60ec419255c00300382671a5,HDFC,Revenue-COD,5eecc6d6449e4f7cfb1c2708,2022-08-19T00:00:00.000Z,NEFT CR-ICIC0000155-BIGFOOT RETAIL SOLUT IONS PVT L-SLICK ORGANICS PVT LTD-CMS277 6393387,,,net_banking_transfer,9997437.45
6329a4632e1a0ebb7f3cae90,50200035187206,23540006,60ec419255c00300382671a5,HDFC,Transfer in/Revenue-other,5eecc6d6449e4f7cfb1c2708,2022-08-25T00:00:00.000Z,RTGS CR-PUNB0040810-JAGWANT SINGH GILL SO RANJIT SINGH-SLICK ORGANICS PRIVATE L IMITED-PUNBR52022082515747042,,,net_banking_transfer,990730
6329a4632e1a0ebb7f3cae92,50200035187206,23560006,60ec419255c00300382671a5,HDFC,Transfer in/Revenue-other,5eecc6d6449e4f7cfb1c2708,2022-08-25T00:00:00.000Z,NEFT CR-PUNB0040810-JAGWANT SINGH GILL SO RANJIT SINGH-SLICK ORGANICS PRIVATE L IMITED-PUNBH22237378605,,,net_banking_transfer,20000
6329a4632e1a0ebb7f3cae94,50200035187206,23560036,60ec419255c00300382671a5,HDFC,interest income,5eecc6d6449e4f7cfb1c2708,2022-08-26T00:00:00.000Z,QUARTERLY INTEREST CREDIT 50300571891040,,,Other,30
6329a4632e1a0ebb7f3cae96,50200035187206,26560036,60ec419255c00300382671a5,HDFC,Transfer in/Revenue-other,5eecc6d6449e4f7cfb1c2708,2022-08-26T00:00:00.000Z,RTGS CR-UTIB0000514-NATARAJAN RANGANATHA N-SLICK ORGANICS PVT LTD-UTIBR5202208260 0182757,insurance,insurance,net_banking_transfer,3000000
6329a4632e1a0ebb7f3cae98,50200035187206,26570254,60ec419255c00300382671a5,HDFC,Transfer in/Revenue-other,5eecc6d6449e4f7cfb1c2708,2022-08-26T00:00:00.000Z,NEFT CR-UTIB0000514-NATARAJAN RANGANATHA,,,net_banking_transfer,10218
632ae6bf2e1a0ebb7f46f157,50200023535069,2073770.35,60ec41ba55c00300382672d9,HDFC,Revenue-PG-non-split,5eecc6d6449e4f7cfb1c2708,2022-04-01T00:00:00.000Z,NEFT CR-PYTM0123456-PAYTM PAYMENTS SERVI CES LIMITED-SLICK ORGANICS PVT LTD-PYTM2 20915640525,insurance,insurance,net_banking_transfer,50225.97
632ae6bf2e1a0ebb7f46f15c,50200023535069,1818770.35,60ec41ba55c00300382672d9,HDFC,SAAS/tech expense,5eecc6d6449e4f7cfb1c2708,2022-04-01T00:00:00.000Z,POS 514834XXXXXX9486 AMAZON,shopping,,debit_card,-255000
632ae6bf2e1a0ebb7f46f15e,50200023535069,1816567.77,60ec41ba55c00300382672d9,HDFC,direct expenses,5eecc6d6449e4f7cfb1c2708,2022-04-01T00:00:00.000Z,POS 514834XXXXXX9486 SEOPTIMER,,,debit_card,-2202.58
632ae6bf2e1a0ebb7f46f160,50200023535069,1762499.77,60ec41ba55c00300382672d9,HDFC,direct expenses,5eecc6d6449e4f7cfb1c2708,2022-04-01T00:00:00.000Z,"POS 514834XXXXXX9486 CROMA,",,,debit_card,-54068
632ae6bf2e1a0ebb7f46f163,50200023535069,762499.77,60ec41ba55c00300382672d9,HDFC,Marketing Expense,5eecc6d6449e4f7cfb1c2708,2022-04-01T00:00:00.000Z,"NEFT DR-CITI0000006-FACEBOOK INDIA ONLIN E SERVICES PVT LTD-NETBANK, MUM-N0912218 98490542-1000000",,,net_banking_transfer,-1000000
632ae6bf2e1a0ebb7f46f165,50200023535069,1262499.77,60ec41ba55c00300382672d9,HDFC,Internal Transfers,5eecc6d6449e4f7cfb1c2708,2022-04-01T00:00:00.000Z,IB FUNDS TRANSFER CR-50200035187206 -SL ICK ORGANICS PVT LTD,insurance,insurance,Other,500000
632ae6bf2e1a0ebb7f46f167,50200023535069,362499.77,60ec41ba55c00300382672d9,HDFC,direct expenses,5eecc6d6449e4f7cfb1c2708,2022-04-01T00:00:00.000Z,"NEFT DR-UTIB0000740-SUPARI STUDIOS-NETBA NK, MUM-N091221898491860-900000",,,net_banking_transfer,-900000
632ae6bf2e1a0ebb7f46f169,50200023535069,862499.77,60ec41ba55c00300382672d9,HDFC,Internal Transfers,5eecc6d6449e4f7cfb1c2708,2022-04-01T00:00:00.000Z,IB FUNDS TRANSFER CR-50200035187206 -SL ICK ORGANICS PVT LTD,insurance,insurance,Other,500000
632ae6bf2e1a0ebb7f46f16b,50200023535069,304179.77,60ec41ba55c00300382672d9,HDFC,direct expenses,5eecc6d6449e4f7cfb1c2708,2022-04-01T00:00:00.000Z,"NEFT DR-ICIC0000024-TAKE MOTO YOHKI INDI A PRIVATE LIMITED-NETBANK, MUM-N09122189 8550483-558320",travel,,net_banking_transfer,-558320
632ae6bf2e1a0ebb7f46f16d,50200023535069,79179.77,60ec41ba55c00300382672d9,HDFC,direct expenses,5eecc6d6449e4f7cfb1c2708,2022-04-01T00:00:00.000Z,02711930004579-TPT-225000-DHRUV BHASIN,,,net_banking_transfer,-225000
632ae6bf2e1a0ebb7f46f16f,50200023535069,579179.77,60ec41ba55c00300382672d9,HDFC,Internal Transfers,5eecc6d6449e4f7cfb1c2708,2022-04-01T00:00:00.000Z,IB FUNDS TRANSFER CR-50200035187206 -SL ICK ORGANICS PVT LTD,insurance,insurance,Other,500000
632ae6bf2e1a0ebb7f46f171,50200023535069,379179.77,60ec41ba55c00300382672d9,HDFC,direct expenses,5eecc6d6449e4f7cfb1c2708,2022-04-01T00:00:00.000Z,"NEFT DR-SCBL0036025-DHRUV MADHOK-NETBANK , MUM-N091221898776224-200000",,,net_banking_transfer,-200000
632ae6bf2e1a0ebb7f46f173,50200023535069,354179.77,60ec41ba55c00300382672d9,HDFC,direct expenses,5eecc6d6449e4f7cfb1c2708,2022-04-01T00:00:00.000Z,IMPS-209119156974-DHRUV MADHOK-SCBL-XXXX XXX0749-25000,,,net_banking_transfer,-25000
632ae6bf2e1a0ebb7f46f176,50200023535069,336473.77,60ec41ba55c00300382672d9,HDFC,direct expenses,5eecc6d6449e4f7cfb1c2708,2022-04-01T00:00:00.000Z,"NEFT DR-YESB0000236-DELIGHT VACATION PVT LTD-NETBANK, MUM-N091221898777152-17706",,,net_banking_transfer,-17706
632ae6bf2e1a0ebb7f46f179,50200023535069,422023.86,60ec41ba55c00300382672d9,HDFC,Revenue-UPI,5eecc6d6449e4f7cfb1c2708,2022-04-01T00:00:00.000Z,UPI-GOKWIK-GOKWIK@YESBANK-YESB0000340-20 9157602197-PAYOUT FOR MARCH 3,,,upi,85550.09
632ae6bf2e1a0ebb7f46f17b,50200023535069,426767.54,60ec41ba55c00300382672d9,HDFC,Revenue-PG-non-split,5eecc6d6449e4f7cfb1c2708,2022-04-01T00:00:00.000Z,NEFT CR-IDFB0010204-SEZZLE PAYMENTS PRIV,,,net_banking_transfer,4743.68
632ae6bf2e1a0ebb7f46f17d,50200023535069,432473.13,60ec41ba55c00300382672d9,HDFC,Revenue-Mktplace,5eecc6d6449e4f7cfb1c2708,2022-04-02T00:00:00.000Z,NEFT CR-DEUT0797BGL-FLIPKART INTERNET PR IVATE LIMITED-SLICK ORGANICS PVT LTD-209 001312GN00205,shopping,,net_banking_transfer,5705.59
632ae6bf2e1a0ebb7f46f17f,50200023535069,459382.51,60ec41ba55c00300382672d9,HDFC,Revenue-PG-non-split,5eecc6d6449e4f7cfb1c2708,2022-04-02T00:00:00.000Z,NEFT CR-PYTM0123456-PAYTM PAYMENTS SERVI CES LIMITED-SLICK ORGANICS PVT LTD-PYTM2 20926069738,insurance,insurance,net_banking_transfer,26909.38
632ae6bf2e1a0ebb7f46f181,50200023535069,520142.32,60ec41ba55c00300382672d9,HDFC,Revenue-PG-non-split,5eecc6d6449e4f7cfb1c2708,2022-04-02T00:00:00.000Z,NEFT CR-KKBK0000958-BROKENTUSK TECHNOLOG IES PRIVATE LIMITED-SLICK ORGANICS PRIVA TE LIMITED-KKBK220923692679,,,net_banking_transfer,60759.81
632ae6bf2e1a0ebb7f46f183,50200023535069,482032.42,60ec41ba55c00300382672d9,HDFC,SAAS/tech expense,5eecc6d6449e4f7cfb1c2708,2022-04-02T00:00:00.000Z,POS 514834XXXXXX9486 AMAZON.COM,shopping,,debit_card,-38109.9
632ae6bf2e1a0ebb7f46f185,50200023535069,432032.42,60ec41ba55c00300382672d9,HDFC,Marketing Expense,5eecc6d6449e4f7cfb1c2708,2022-04-02T00:00:00.000Z,POS 514834XXXXXX9486 RSP*GOOGLE ADS,,,debit_card,-50000
632ae6bf2e1a0ebb7f46f18d,50200023535069,496640.48,60ec41ba55c00300382672d9,HDFC,Revenue-UPI,5eecc6d6449e4f7cfb1c2708,2022-04-02T00:00:00.000Z,UPI-GOKWIK-GOKWIK@YESBANK-YESB0000340-20 9259990480-PAYOUT FOR MARCH 3,,,upi,64608.06
632ae6bf2e1a0ebb7f46f190,50200023535069,518608.92,60ec41ba55c00300382672d9,HDFC,Revenue-PG-non-split,5eecc6d6449e4f7cfb1c2708,2022-04-03T00:00:00.000Z,IMPS-209304293575-PAYTM PAYMENTS SERVI-P YTM-XXXXXXXXXX0008-ALL202204032168200003 30830668628,ewallet,,net_banking_transfer,21968.44
632ae6bf2e1a0ebb7f46f192,50200023535069,544481.43,60ec41ba55c00300382672d9,HDFC,Revenue-UPI,5eecc6d6449e4f7cfb1c2708,2022-04-03T00:00:00.000Z,UPI-GOKWIK-GOKWIK@YESBANK-YESB0000340-20 9362178157-PAYOUT FOR APRIL 1,,,upi,25872.51
632ae6bf2e1a0ebb7f46f194,50200023535069,544993.95,60ec41ba55c00300382672d9,HDFC,Revenue-Mktplace,5eecc6d6449e4f7cfb1c2708,2022-04-04T00:00:00.000Z,NEFT CR-DEUT0797BGL-FLIPKART INTERNET PR IVATE LIMITED-SLICK ORGANICS PVT LTD-209 400134GN00148,shopping,,net_banking_transfer,512.52
632ae6bf2e1a0ebb7f46f196,50200023535069,574481,60ec41ba55c00300382672d9,HDFC,Revenue-PG-non-split,5eecc6d6449e4f7cfb1c2708,2022-04-04T00:00:00.000Z,NEFT CR-PYTM0123456-PAYTM PAYMENTS SERVI CES LIMITED-SLICK ORGANICS PVT LTD-PYTM2 20946949540,insurance,insurance,net_banking_transfer,29487.05
632ae6bf2e1a0ebb7f46f198,50200023535069,556461,60ec41ba55c00300382672d9,HDFC,direct expenses,5eecc6d6449e4f7cfb1c2708,2022-04-04T00:00:00.000Z,02711600008220-TPT-18020-VARUN SINGH,,,net_banking_transfer,-18020
632ae6bf2e1a0ebb7f46f19a,50200023535069,301461,60ec41ba55c00300382672d9,HDFC,SAAS/tech expense,5eecc6d6449e4f7cfb1c2708,2022-04-04T00:00:00.000Z,POS 514834XXXXXX9486 AMAZON,shopping,,debit_card,-255000
632ae6bf2e1a0ebb7f46f19c,50200023535069,309835.19,60ec41ba55c00300382672d9,HDFC,Revenue-Mktplace,5eecc6d6449e4f7cfb1c2708,2022-04-04T00:00:00.000Z,NEFT CR-DEUT0797BGL-MYNTRA DESIGNS PRIVA TE LIMITED-SLICK ORGANICS PVT. LTD.-2094 00567GN00056,shopping,,net_banking_transfer,8374.19
632ae6bf2e1a0ebb7f46f19e,50200023535069,315902.28,60ec41ba55c00300382672d9,HDFC,Revenue-Mktplace,5eecc6d6449e4f7cfb1c2708,2022-04-04T00:00:00.000Z,NEFT CR-DEUT0797BGL-MYNTRA DESIGNS PRIVA,shopping,,net_banking_transfer,6067.09
632ae6bf2e1a0ebb7f46f1a0,50200023535069,420109.51,60ec41ba55c00300382672d9,HDFC,Revenue-PG-split enabled,5eecc6d6449e4f7cfb1c2708,2022-04-04T00:00:00.000Z,NEFT CR-UTIB0001506-RAZORPAY SOFTWARE PR IVATE LIMITED-SLICK ORGANICS PVT LITD-AX ISCN0130016914,insurance,insurance,net_banking_transfer,104207.23
632ae6bf2e1a0ebb7f46f1a2,50200023535069,599604.6,60ec41ba55c00300382672d9,HDFC,Revenue-Mktplace,5eecc6d6449e4f7cfb1c2708,2022-04-04T00:00:00.000Z,IMPS-209412299087-AMAZON SELLER SERVIC-H SBC-XXXXXXXX6004-12JLNBNJ6TCXFW0ASLICK O RGANICS PVT LTD,shopping,,net_banking_transfer,179495.09
632ae6bf2e1a0ebb7f46f1a4,50200023535069,1152033.47,60ec41ba55c00300382672d9,HDFC,Revenue-Mktplace,5eecc6d6449e4f7cfb1c2708,2022-04-04T00:00:00.000Z,NEFT CR-DEUT0797BGL-AMAZON PAY (INDIA) P RIVATE LIMITED-SLICK ORGANICS PVT LTD-20 9400782GN00606,shopping,,net_banking_transfer,552428.87
632ae6bf2e1a0ebb7f46f1a6,50200023535069,1160175.26,60ec41ba55c00300382672d9,HDFC,Transfer in/Revenue-other,5eecc6d6449e4f7cfb1c2708,2022-04-04T00:00:00.000Z,FT- REMITTANCE OG MAR 22-50200050675669 - HOUZ OF NATURE PVT LTD -,,,Other,8141.79
632ae6bf2e1a0ebb7f46f1a8,50200023535069,1192293.82,60ec41ba55c00300382672d9,HDFC,Revenue-PG-non-split,5eecc6d6449e4f7cfb1c2708,2022-04-04T00:00:00.000Z,NEFT CR-KKBK0000958-BROKENTUSK TECHNOLOG IES PRIVATE LIMITED-SLICK ORGANICS PRIVA TE LIMITED-KKBK220944122901,,,net_banking_transfer,32118.56
632ae6bf2e1a0ebb7f46f1aa,50200023535069,1192567.96,60ec41ba55c00300382672d9,HDFC,Revenue-Mktplace,5eecc6d6449e4f7cfb1c2708,2022-04-04T00:00:00.000Z,NEFT CR-ICIC0000105-MANASH LIFESTYLE PRI VATE LIMITED NO-SLICK ORGANICS PRIVATE L IMITED MP M-ICIJ220940008150,shopping,,net_banking_transfer,274.14
632ae6bf2e1a0ebb7f46f1ac,50200023535069,1192611.93,60ec41ba55c00300382672d9,HDFC,Revenue-Mktplace,5eecc6d6449e4f7cfb1c2708,2022-04-04T00:00:00.000Z,NEFT CR-ICIC0000105-MANASH LIFESTYLE PRI VATE LIMITED NO-SLICK ORGANICS PRIVATE L IMITED MP G-ICIJ220940008149,shopping,,net_banking_transfer,43.97
632ae6bf2e1a0ebb7f46f1ae,50200023535069,1221796.93,60ec41ba55c00300382672d9,HDFC,Revenue-Mktplace,5eecc6d6449e4f7cfb1c2708,2022-04-04T00:00:00.000Z,NEFT CR-SCBL0036001-M/S DREAMPLUG TECHNO -SLICK ORGANICS PRIVATE LIMITEDSLICK-SIN 31436Q0036563,insurance,insurance,net_banking_transfer,29185
632ae6bf2e1a0ebb7f46f1b0,50200023535069,1230683,60ec41ba55c00300382672d9,HDFC,Revenue-PG-split enabled,5eecc6d6449e4f7cfb1c2708,2022-04-04T00:00:00.000Z,NEFT CR-UTIB0001506-RAZORPAY SOFTWARE PR IVATE LIMITED-SLICK ORGANICS PVT LITD-AX ISCN0130165379,insurance,insurance,net_banking_transfer,8886.07
632ae6bf2e1a0ebb7f46f1b4,50200023535069,1278616.46,60ec41ba55c00300382672d9,HDFC,Revenue-COD,5eecc6d6449e4f7cfb1c2708,2022-04-04T00:00:00.000Z,NEFT CR-ICIC0000155-SHIPROCKET COD CRF I D 4095700-SLICK ORGANICS PVT LTD-CMS2494 698758,insurance,insurance,net_banking_transfer,47933.46
632ae6bf2e1a0ebb7f46f1b9,50200023535069,1280645.63,60ec41ba55c00300382672d9,HDFC,Revenue-PG-non-split,5eecc6d6449e4f7cfb1c2708,2022-04-04T00:00:00.000Z,NEFT CR-IDFB0010204-SEZZLE PAYMENTS PRIV,,,net_banking_transfer,2029.17
632ae6bf2e1a0ebb7f46f1bb,50200023535069,1280668.95,60ec41ba55c00300382672d9,HDFC,Transfer in/Revenue-other,5eecc6d6449e4f7cfb1c2708,2022-04-04T00:00:00.000Z,POS REF 514834******9486-04/03 GOOGLESER,,,refund,23.32
632ae6bf2e1a0ebb7f46f1bd,50200023535069,1281174.51,60ec41ba55c00300382672d9,HDFC,Revenue-UPI,5eecc6d6449e4f7cfb1c2708,2022-04-04T00:00:00.000Z,UPI-GOKWIK-GOKWIK@YESBANK-YESB0000340-20 9464480139-PAYOUT FOR APRIL 2,,,upi,505.56
632ae6bf2e1a0ebb7f46f1bf,50200023535069,1306845.27,60ec41ba55c00300382672d9,HDFC,Revenue-PG-non-split,5eecc6d6449e4f7cfb1c2708,2022-04-05T00:00:00.000Z,NEFT CR-PYTM0123456-PAYTM PAYMENTS SERVI CES LIMITED-SLICK ORGANICS PVT LTD-PYTM2 20957428218,insurance,insurance,net_banking_transfer,25670.76
632ae6bf2e1a0ebb7f46f1c1,50200023535069,1329214.3,60ec41ba55c00300382672d9,HDFC,Revenue-PG-split enabled,5eecc6d6449e4f7cfb1c2708,2022-04-05T00:00:00.000Z,NEFT CR-UTIB0001506-RAZORPAY SOFTWARE PR IVATE LIMITED-SLICK ORGANICS PVT LITD-AX ISCN0130240071,insurance,insurance,net_banking_transfer,22369.03
632ae6bf2e1a0ebb7f46f1c3,50200023535069,829214.3,60ec41ba55c00300382672d9,HDFC,direct expenses,5eecc6d6449e4f7cfb1c2708,2022-04-05T00:00:00.000Z,"NEFT DR-ICIC0000369-BO INTERNATIONAL-NET BANK, MUM-N095221903070953-500000",,,net_banking_transfer,-500000
632ae6bf2e1a0ebb7f46f1c5,50200023535069,807714.3,60ec41ba55c00300382672d9,HDFC,direct expenses,5eecc6d6449e4f7cfb1c2708,2022-04-05T00:00:00.000Z,"NEFT DR-PUNB0482100-RAM BHAVAN YADAV-NET BANK, MUM-N095221903292014-21500",,,net_banking_transfer,-21500
632ae6bf2e1a0ebb7f46f1c7,50200023535069,800714.3,60ec41ba55c00300382672d9,HDFC,direct expenses,5eecc6d6449e4f7cfb1c2708,2022-04-05T00:00:00.000Z,00071610019925-TPT-7000-KHUSHBOO SINGHVI,,,net_banking_transfer,-7000
632ae6bf2e1a0ebb7f46f1c9,50200023535069,811132.07,60ec41ba55c00300382672d9,HDFC,Revenue-PG-non-split,5eecc6d6449e4f7cfb1c2708,2022-04-05T00:00:00.000Z,NEFT CR-IDFB0010204-SEZZLE PAYMENTS PRIV ATE LIMITED-SLICK ORGANICS PRIVATE LIMIT ED-IDFBH22095635025,insurance,insurance,net_banking_transfer,10417.77
632ae6bf2e1a0ebb7f46f1cb,50200023535069,818175.78,60ec41ba55c00300382672d9,HDFC,Revenue-PG-split enabled,5eecc6d6449e4f7cfb1c2708,2022-04-05T00:00:00.000Z,NEFT CR-UTIB0001506-RAZORPAY SOFTWARE PR IVATE LIMITED-SLICK ORGANICS PVT LITD-AX ISCN0130378309,insurance,insurance,net_banking_transfer,7043.71
632ae6bf2e1a0ebb7f46f1cd,50200023535069,888675.63,60ec41ba55c00300382672d9,HDFC,Revenue-PG-non-split,5eecc6d6449e4f7cfb1c2708,2022-04-05T00:00:00.000Z,NEFT CR-KKBK0000958-BROKENTUSK TECHNOLOG IES PRIVATE LIMITED-SLICK ORGANICS PRIVA TE LIMITED-KKBK220954392398,,,net_banking_transfer,70499.85
632ae6bf2e1a0ebb7f46f1d0,50200023535069,961307.2,60ec41ba55c00300382672d9,HDFC,Revenue-UPI,5eecc6d6449e4f7cfb1c2708,2022-04-05T00:00:00.000Z,UPI-GOKWIK-GOKWIK@YESBANK-YESB0000340-20 9567171524-PAYOUT FOR APRIL 3,,,upi,72631.57
632ae6bf2e1a0ebb7f46f1d3,50200023535069,965500.51,60ec41ba55c00300382672d9,HDFC,Revenue-Mktplace,5eecc6d6449e4f7cfb1c2708,2022-04-06T00:00:00.000Z,NEFT CR-DEUT0797BGL-FLIPKART INTERNET PR IVATE LIMITED-SLICK ORGANICS PVT LTD-209 600138GN00101,shopping,,net_banking_transfer,4193.31
632ae6bf2e1a0ebb7f46f1d5,50200023535069,990954.57,60ec41ba55c00300382672d9,HDFC,Revenue-PG-non-split,5eecc6d6449e4f7cfb1c2708,2022-04-06T00:00:00.000Z,NEFT CR-PYTM0123456-PAYTM PAYMENTS SERVI,ewallet,,net_banking_transfer,25454.06
632ae6bf2e1a0ebb7f46f1d7,50200023535069,1011529.24,60ec41ba55c00300382672d9,HDFC,Revenue-PG-split enabled,5eecc6d6449e4f7cfb1c2708,2022-04-06T00:00:00.000Z,NEFT CR-UTIB0001506-RAZORPAY SOFTWARE PR IVATE LIMITED-SLICK ORGANICS PVT LITD-AX ISCN0130450168,insurance,insurance,net_banking_transfer,20574.67
632ae6bf2e1a0ebb7f46f1d9,50200023535069,1019348.08,60ec41ba55c00300382672d9,HDFC,Revenue-Mktplace,5eecc6d6449e4f7cfb1c2708,2022-04-06T00:00:00.000Z,NEFT CR-DEUT0797BGL-MYNTRA DESIGNS PRIVA TE LIMITED-SLICK ORGANICS PVT. LTD.-2096 00680GN00056,shopping,,net_banking_transfer,7818.84
632ae6bf2e1a0ebb7f46f1db,50200023535069,1029102.94,60ec41ba55c00300382672d9,HDFC,Revenue-Mktplace,5eecc6d6449e4f7cfb1c2708,2022-04-06T00:00:00.000Z,NEFT CR-DEUT0797BGL-MYNTRA DESIGNS PRIVA TE LIMITED-SLICK ORGANICS PVT. LTD.-2096 00680GN00011,shopping,,net_banking_transfer,9754.86
632ae6bf2e1a0ebb7f46f1dd,50200023535069,1032869.41,60ec41ba55c00300382672d9,HDFC,Revenue-Mktplace,5eecc6d6449e4f7cfb1c2708,2022-04-06T00:00:00.000Z,NEFT CR-DEUT0797BGL-MYNTRA DESIGNS PRIVA TE LIMITED-SLICK ORGANICS PVT. LTD.-2096 00681GN00031,shopping,,net_banking_transfer,3766.47
632ae6bf2e1a0ebb7f46f1df,50200023535069,32869.41,60ec41ba55c00300382672d9,HDFC,Marketing Expense,5eecc6d6449e4f7cfb1c2708,2022-04-06T00:00:00.000Z,"NEFT DR-CITI0000006-FACEBOOK INDIA ONLIN E SERVICES PVT LTD-NETBANK, MUM-N0962219 05234589-1000000",,,net_banking_transfer,-1000000
632ae6bf2e1a0ebb7f46f1e2,50200023535069,1032869.41,60ec41ba55c00300382672d9,HDFC,Internal Transfers,5eecc6d6449e4f7cfb1c2708,2022-04-06T00:00:00.000Z,IB FUNDS TRANSFER CR-50200035187206 -SL ICK ORGANICS PVT LTD,insurance,insurance,Other,1000000
632ae6bf2e1a0ebb7f46f1e4,50200023535069,1033161.15,60ec41ba55c00300382672d9,HDFC,Revenue-Mktplace,5eecc6d6449e4f7cfb1c2708,2022-04-06T00:00:00.000Z,NEFT CR-ICIC0000105-MANASH LIFESTYLE PRI VATE LIMITED NO-SLICK ORGANICS PRIVATE L IMITED MP M-ICIJ220960003433,shopping,,net_banking_transfer,291.74
632ae6bf2e1a0ebb7f46f1e7,50200023535069,1034331.03,60ec41ba55c00300382672d9,HDFC,Revenue-Mktplace,5eecc6d6449e4f7cfb1c2708,2022-04-06T00:00:00.000Z,NEFT CR-ICIC0000105-MANASH LIFESTYLE PRI VATE LIMITED NO-SLICK ORGANICS PRIVATE L IMITED KOLK-ICIJ220960003434,shopping,,net_banking_transfer,1169.88
632ae6c02e1a0ebb7f46f1e9,50200023535069,1034681.41,60ec41ba55c00300382672d9,HDFC,Revenue-Mktplace,5eecc6d6449e4f7cfb1c2708,2022-04-06T00:00:00.000Z,NEFT CR-ICIC0000105-MANASH LIFESTYLE PRI VATE LIMITED NO-SLICK ORGANICS PRIVATE L IMITED MP G-ICIJ220960006555,shopping,,net_banking_transfer,350.38
632ae6c02e1a0ebb7f46f1eb,50200023535069,1048135.16,60ec41ba55c00300382672d9,HDFC,Revenue-PG-split enabled,5eecc6d6449e4f7cfb1c2708,2022-04-06T00:00:00.000Z,NEFT CR-UTIB0001506-RAZORPAY SOFTWARE PR IVATE LIMITED-SLICK ORGANICS PVT LITD-AX ISCN0130602919,insurance,insurance,net_banking_transfer,13453.75
632ae6c02e1a0ebb7f46f1ed,50200023535069,1053392.16,60ec41ba55c00300382672d9,HDFC,Transfer in/Revenue-other,5eecc6d6449e4f7cfb1c2708,2022-04-06T00:00:00.000Z,NEFT CR-HSBC0560002-INNOVATIVE RETAIL CO,,,net_banking_transfer,5257
632ae6c02e1a0ebb7f46f1ef,50200023535069,1063648.16,60ec41ba55c00300382672d9,HDFC,Transfer in/Revenue-other,5eecc6d6449e4f7cfb1c2708,2022-04-06T00:00:00.000Z,NEFT CR-HSBC0560002-INNOVATIVE RETAIL CO NCEPTS PRIVATE-SLICK ORGANICS PVT LTD-HS BCN22096153300,,,net_banking_transfer,10256
632ae6c02e1a0ebb7f46f1f1,50200023535069,1269131.42,60ec41ba55c00300382672d9,HDFC,Revenue-COD,5eecc6d6449e4f7cfb1c2708,2022-04-06T00:00:00.000Z,NEFT CR-ICIC0000155-SHIPROCKET COD CRF I D 4116177-SLICK ORGANICS PVT LTD-CMS2499 689301,insurance,insurance,net_banking_transfer,205483.26
632ae6c02e1a0ebb7f46f1f3,50200023535069,1272577.74,60ec41ba55c00300382672d9,HDFC,Revenue-PG-non-split,5eecc6d6449e4f7cfb1c2708,2022-04-06T00:00:00.000Z,NEFT CR-IDFB0010204-SEZZLE PAYMENTS PRIV ATE LIMITED-SLICK ORGANICS PRIVATE LIMIT ED-IDFBH22096735496,insurance,insurance,net_banking_transfer,3446.32
632ae6c02e1a0ebb7f46f1f5,50200023535069,1330033.71,60ec41ba55c00300382672d9,HDFC,Revenue-UPI,5eecc6d6449e4f7cfb1c2708,2022-04-06T00:00:00.000Z,UPI-GOKWIK-GOKWIK@YESBANK-YESB0000340-20 9669037759-PAYOUT FOR APRIL 4,,,upi,57455.97
632ae6c02e1a0ebb7f46f1f7,50200023535069,1274533.71,60ec41ba55c00300382672d9,HDFC,direct expenses,5eecc6d6449e4f7cfb1c2708,2022-04-07T00:00:00.000Z,50100293329616 NET BANKING SI -55500,,,Other,-55500
632ae6c02e1a0ebb7f46f1f9,50200023535069,1220366.71,60ec41ba55c00300382672d9,HDFC,direct expenses,5eecc6d6449e4f7cfb1c2708,2022-04-07T00:00:00.000Z,50100362612187 NET BANKING SI -54167,,,Other,-54167
632ae6c02e1a0ebb7f46f1fb,50200023535069,1170366.71,60ec41ba55c00300382672d9,HDFC,direct expenses,5eecc6d6449e4f7cfb1c2708,2022-04-07T00:00:00.000Z,50100064106714 NET BANKING SI -50000,,,Other,-50000
632ae6c02e1a0ebb7f46f1fd,50200023535069,1134366.71,60ec41ba55c00300382672d9,HDFC,direct expenses,5eecc6d6449e4f7cfb1c2708,2022-04-07T00:00:00.000Z,00901610080520 NET BANKING SI -36000,,,Other,-36000
632ae6c02e1a0ebb7f46f1ff,50200023535069,1118387.71,60ec41ba55c00300382672d9,HDFC,direct expenses,5eecc6d6449e4f7cfb1c2708,2022-04-07T00:00:00.000Z,02711600008220 NET BANKING SI -15979,,,Other,-15979
632ae6c02e1a0ebb7f46f201,50200023535069,1012468.71,60ec41ba55c00300382672d9,HDFC,direct expenses,5eecc6d6449e4f7cfb1c2708,2022-04-07T00:00:00.000Z,50100093802387 NET BANKING SI -105919,,,Other,-105919
632ae6c02e1a0ebb7f46f203,50200023535069,962468.71,60ec41ba55c00300382672d9,HDFC,direct expenses,5eecc6d6449e4f7cfb1c2708,2022-04-07T00:00:00.000Z,NEFT DR-UTIB0000120-ADNAN ALI-SANDOZ - M UM-N097221906697276-NET BANKING SI -5000 0,,,net_banking_transfer,-50000
632ae6c02e1a0ebb7f46f205,50200023535069,882468.71,60ec41ba55c00300382672d9,HDFC,direct expenses,5eecc6d6449e4f7cfb1c2708,2022-04-07T00:00:00.000Z,NEFT DR-ICIC0003851-JITENDER KUMAR-SANDO Z - MUM-N097221906697278-NET BANKING SI -80000,,,net_banking_transfer,-80000
632ae6c02e1a0ebb7f46f207,50200023535069,852468.71,60ec41ba55c00300382672d9,HDFC,direct expenses,5eecc6d6449e4f7cfb1c2708,2022-04-07T00:00:00.000Z,NEFT DR-KKBK0008365-SRIRAJ GUNDA-SANDOZ - MUM-N097221906697280-NET BANKING SI -3 0000,,,net_banking_transfer,-30000
632ae6c02e1a0ebb7f46f20c,50200023535069,830968.71,60ec41ba55c00300382672d9,HDFC,direct expenses,5eecc6d6449e4f7cfb1c2708,2022-04-07T00:00:00.000Z,NEFT DR-SIBL0000555-JAIVEER KUMAR-SANDOZ - MUM-N097221906697281-NET BANKING SI - 21500,,,net_banking_transfer,-21500
632ae6c02e1a0ebb7f46f20f,50200023535069,809468.71,60ec41ba55c00300382672d9,HDFC,direct expenses,5eecc6d6449e4f7cfb1c2708,2022-04-07T00:00:00.000Z,NEFT DR-BARB0VJGRKA-OM PRASAD PANDEY-SAN,,,net_banking_transfer,-21500
632ae6c02e1a0ebb7f46f212,50200023535069,592801.71,60ec41ba55c00300382672d9,HDFC,direct expenses,5eecc6d6449e4f7cfb1c2708,2022-04-07T00:00:00.000Z,NEFT DR-KKBK0000261-TANVI TANEJA-SANDOZ - MUM-N097221906697285-NET BANKING SI -2 16667,,,net_banking_transfer,-216667
632ae6c02e1a0ebb7f46f214,50200023535069,574936.71,60ec41ba55c00300382672d9,HDFC,direct expenses,5eecc6d6449e4f7cfb1c2708,2022-04-07T00:00:00.000Z,NEFT DR-KKBK0005032-DEEPAK YADAV-SANDOZ - MUM-N097221906697287-NET BANKING SI -1 7865,,,net_banking_transfer,-17865
632ae6c02e1a0ebb7f46f216,50200023535069,558957.71,60ec41ba55c00300382672d9,HDFC,direct expenses,5eecc6d6449e4f7cfb1c2708,2022-04-07T00:00:00.000Z,NEFT DR-PUNB0151400-BHUWAN CHANDER JOSHI -SANDOZ - MUM-N097221906697288-NET BANKI NG SI -15979,,,net_banking_transfer,-15979
632ae6c02e1a0ebb7f46f21d,50200023535069,542978.71,60ec41ba55c00300382672d9,HDFC,direct expenses,5eecc6d6449e4f7cfb1c2708,2022-04-07T00:00:00.000Z,NEFT DR-PUNB0494300-KUNDAN PRASAD-SANDOZ - MUM-N097221906697290-NET BANKING SI - 15979,,,net_banking_transfer,-15979
632ae6c02e1a0ebb7f46f220,50200023535069,528351.71,60ec41ba55c00300382672d9,HDFC,direct expenses,5eecc6d6449e4f7cfb1c2708,2022-04-07T00:00:00.000Z,NEFT DR-PUNB0307800-SANJEEV NIRMANIA-SAN DOZ - MUM-N097221906697292-NET BANKING S I -14627,,,net_banking_transfer,-14627
632ae6c02e1a0ebb7f46f223,50200023535069,511998.71,60ec41ba55c00300382672d9,HDFC,N-ACH payments,5eecc6d6449e4f7cfb1c2708,2022-04-07T00:00:00.000Z,NEFT DR-DBSS0IN0811-SACHIN SINGH-SANDOZ - MUM-N097221906697293-NET BANKING SI -1 6353,,,net_banking_transfer,-16353
632ae6c02e1a0ebb7f46f225,50200023535069,403665.71,60ec41ba55c00300382672d9,HDFC,direct expenses,5eecc6d6449e4f7cfb1c2708,2022-04-07T00:00:00.000Z,NEFT DR-ICIC0000396-SURABHI SARUP-SANDOZ - MUM-N097221906697295-NET BANKING SI - 108333,,,net_banking_transfer,-108333
632ae6c02e1a0ebb7f46f227,50200023535069,419781.97,60ec41ba55c00300382672d9,HDFC,Revenue-PG-non-split,5eecc6d6449e4f7cfb1c2708,2022-04-07T00:00:00.000Z,IMPS-209704218414-PAYTM PAYMENTS SERVI-P YTM-XXXXXXXXXX0008-ALL202204072168200003 30830668628,ewallet,,net_banking_transfer,16116.26
632ae6c02e1a0ebb7f46f229,50200023535069,238330.97,60ec41ba55c00300382672d9,HDFC,direct expenses,5eecc6d6449e4f7cfb1c2708,2022-04-07T00:00:00.000Z,50100370748619-TPT-181451-RITIKA SAXENA,,,net_banking_transfer,-181451
632ae6c02e1a0ebb7f46f22b,50200023535069,50158.97,60ec41ba55c00300382672d9,HDFC,direct expenses,5eecc6d6449e4f7cfb1c2708,2022-04-07T00:00:00.000Z,50100179603876-TPT-188172-APURBA NAYAK,,,net_banking_transfer,-188172
632ae6c02e1a0ebb7f46f22d,50200023535069,-2099.03,60ec41ba55c00300382672d9,HDFC,direct expenses,5eecc6d6449e4f7cfb1c2708,2022-04-07T00:00:00.000Z,"NEFT DR-SBIN0070392-APARNA MOHANAN KONAT -NETBANK, MUM-N097221906828391-52258",,,net_banking_transfer,-52258
632ae6c02e1a0ebb7f46f22f,50200023535069,8666.71,60ec41ba55c00300382672d9,HDFC,Revenue-PG-split enabled,5eecc6d6449e4f7cfb1c2708,2022-04-07T00:00:00.000Z,NEFT CR-UTIB0001506-RAZORPAY SOFTWARE PR,,,net_banking_transfer,10765.74
632ae6c02e1a0ebb7f46f231,50200023535069,1008666.71,60ec41ba55c00300382672d9,HDFC,Internal Transfers,5eecc6d6449e4f7cfb1c2708,2022-04-07T00:00:00.000Z,IB FUNDS TRANSFER CR-50200035187206 -SL ICK ORGANICS PVT LTD,insurance,insurance,Other,1000000
632ae6c02e1a0ebb7f46f233,50200023535069,708666.71,60ec41ba55c00300382672d9,HDFC,direct expenses,5eecc6d6449e4f7cfb1c2708,2022-04-07T00:00:00.000Z,"NEFT DR-ICIC0000024-TAKE MOTO YOHKI INDI A PRIVATE LIMITED-NETBANK, MUM-N09722190 7006878-300000",travel,,net_banking_transfer,-300000
632ae6c02e1a0ebb7f46f235,50200023535069,701166.71,60ec41ba55c00300382672d9,HDFC,direct expenses,5eecc6d6449e4f7cfb1c2708,2022-04-07T00:00:00.000Z,"NEFT DR-KKBK0002866-QUINN CARE PRIVATE L IMITED-NETBANK, MUM-N097221906992606-750 0",,,net_banking_transfer,-7500
632ae6c02e1a0ebb7f46f237,50200023535069,695166.71,60ec41ba55c00300382672d9,HDFC,direct expenses,5eecc6d6449e4f7cfb1c2708,2022-04-07T00:00:00.000Z,"NEFT DR-ICIC0006986-ASHWINI SHARMA-NETBA NK, MUM-N097221907021495-6000",,,net_banking_transfer,-6000
632ae6c02e1a0ebb7f46f239,50200023535069,460466.71,60ec41ba55c00300382672d9,HDFC,direct expenses,5eecc6d6449e4f7cfb1c2708,2022-04-07T00:00:00.000Z,"NEFT DR-SCBL0036031-PR PUNDIT PUBLIC REL ATIONS PRIVATE LIMIT-NETBANK, MUM-N09722 1907025015-234700",insurance,insurance,net_banking_transfer,-234700
632ae6c02e1a0ebb7f46f23b,50200023535069,388742.71,60ec41ba55c00300382672d9,HDFC,direct expenses,5eecc6d6449e4f7cfb1c2708,2022-04-07T00:00:00.000Z,"NEFT DR-KKBK0000187-APPLIED LIFE PRIVATE LIMITED-NETBANK, MUM-N097221907051418-7 1724",,,net_banking_transfer,-71724
632ae6c02e1a0ebb7f46f23d,50200023535069,404630.46,60ec41ba55c00300382672d9,HDFC,Revenue-PG-non-split,5eecc6d6449e4f7cfb1c2708,2022-04-07T00:00:00.000Z,NEFT CR-KKBK0000958-BROKENTUSK TECHNOLOG IES PRIVATE LIMITED-SLICK ORGANICS PRIVA TE LIMITED-KKBK220974806885,,,net_banking_transfer,15887.75
632ae6c02e1a0ebb7f46f23f,50200023535069,248030.46,60ec41ba55c00300382672d9,HDFC,direct expenses,5eecc6d6449e4f7cfb1c2708,2022-04-07T00:00:00.000Z,"NEFT DR-KKBK0005289-HILL GROOVE CONSULTI NG LLP-NETBANK, MUM-N097221907081224-156 600",,,net_banking_transfer,-156600
632ae6c02e1a0ebb7f46f241,50200023535069,162030.46,60ec41ba55c00300382672d9,HDFC,direct expenses,5eecc6d6449e4f7cfb1c2708,2022-04-07T00:00:00.000Z,50200063349422-TPT-86000-COHORT E-COMMER CE CONSULTING LLP,,,net_banking_transfer,-86000
632ae6c02e1a0ebb7f46f243,50200023535069,30270.46,60ec41ba55c00300382672d9,HDFC,direct expenses,5eecc6d6449e4f7cfb1c2708,2022-04-07T00:00:00.000Z,"NEFT DR-DBSS0IN0811-SARANSH KULKARNI-NET BANK, MUM-N097221907098802-131760",,,net_banking_transfer,-131760
632ae6c02e1a0ebb7f46f245,50200023535069,1030270.46,60ec41ba55c00300382672d9,HDFC,Internal Transfers,5eecc6d6449e4f7cfb1c2708,2022-04-07T00:00:00.000Z,IB FUNDS TRANSFER CR-50200035187206 -SL ICK ORGANICS PVT LTD,insurance,insurance,Other,1000000
632ae6c02e1a0ebb7f46f247,50200023535069,940270.46,60ec41ba55c00300382672d9,HDFC,direct expenses,5eecc6d6449e4f7cfb1c2708,2022-04-07T00:00:00.000Z,"NEFT DR-ICIC0001937-SAUMITRA PANDEY-NETB ANK, MUM-N097221907105978-90000",,,net_banking_transfer,-90000
632ae6c02e1a0ebb7f46f249,50200023535069,907870.46,60ec41ba55c00300382672d9,HDFC,direct expenses,5eecc6d6449e4f7cfb1c2708,2022-04-07T00:00:00.000Z,50200039330521-TPT-32400-ELITE PUBLICIST,insurance,insurance,net_banking_transfer,-32400
632ae6c02e1a0ebb7f46f24b,50200023535069,844997.46,60ec41ba55c00300382672d9,HDFC,direct expenses,5eecc6d6449e4f7cfb1c2708,2022-04-07T00:00:00.000Z,NEFT DR-UTIB0003142-ELIZABETH THALEX-NET,,,net_banking_transfer,-62873
632ae6c02e1a0ebb7f46f24e,50200023535069,817997.46,60ec41ba55c00300382672d9,HDFC,direct expenses,5eecc6d6449e4f7cfb1c2708,2022-04-07T00:00:00.000Z,"NEFT DR-KKBK0000654-NIHARIKA MISHRA-NETB ANK, MUM-N097221907173194-27000",,,net_banking_transfer,-27000
632ae6c02e1a0ebb7f46f250,50200023535069,703924.46,60ec41ba55c00300382672d9,HDFC,direct expenses,5eecc6d6449e4f7cfb1c2708,2022-04-07T00:00:00.000Z,00918630000430-TPT-114073-UNICOMMERCE ES OLUTIONS PRIVATE LIMITED,,,net_banking_transfer,-114073
632ae6c02e1a0ebb7f46f252,50200023535069,487924.46,60ec41ba55c00300382672d9,HDFC,direct expenses,5eecc6d6449e4f7cfb1c2708,2022-04-07T00:00:00.000Z,"NEFT DR-UTIB0000514-NATS ASSOCIATES-NETB ANK, MUM-N097221907256349-216000",,,net_banking_transfer,-216000
632ae6c02e1a0ebb7f46f254,50200023535069,198942.46,60ec41ba55c00300382672d9,HDFC,direct expenses,5eecc6d6449e4f7cfb1c2708,2022-04-07T00:00:00.000Z,"NEFT DR-KKBK0000180-VEDIC COSMECEUTICALS PVT LTD-NETBANK, MUM-N097221907245108-2 88982",,,net_banking_transfer,-288982
632ae6c02e1a0ebb7f46f256,50200023535069,200640.11,60ec41ba55c00300382672d9,HDFC,Revenue-Mktplace,5eecc6d6449e4f7cfb1c2708,2022-04-07T00:00:00.000Z,NEFT CR-ICIC0000105-MANASH LIFESTYLE PRI VATE LIMITED NO-SLICK ORGANICS PRIVATE L IMITED BANG-ICIJ220970003592,shopping,,net_banking_transfer,1697.65
632ae6c02e1a0ebb7f46f258,50200023535069,200969.22,60ec41ba55c00300382672d9,HDFC,Revenue-Mktplace,5eecc6d6449e4f7cfb1c2708,2022-04-07T00:00:00.000Z,NEFT CR-ICIC0000105-MANASH LIFESTYLE PRI VATE LIMITED NO-SLICK ORGANICS PRIVATE L IMITED KOLK-ICIJ220970001305,shopping,,net_banking_transfer,329.11
632ae6c02e1a0ebb7f46f25b,50200023535069,201436.14,60ec41ba55c00300382672d9,HDFC,Revenue-Mktplace,5eecc6d6449e4f7cfb1c2708,2022-04-07T00:00:00.000Z,NEFT CR-ICIC0000105-MANASH LIFESTYLE PRI VATE LIMITED NO-SLICK ORGANICS PRIVATE L IMITED MP M-ICIJ220970003591,shopping,,net_banking_transfer,466.92
632ae6c02e1a0ebb7f46f25e,50200023535069,549539.15,60ec41ba55c00300382672d9,HDFC,Revenue-Mktplace,5eecc6d6449e4f7cfb1c2708,2022-04-07T00:00:00.000Z,NEFT CR-KKBK0000958-NYKAA E RETAIL PRIVA TE LIMITED NYKAA-SLICK ORGANICS PVT LTD- KKBK220974834934,insurance,insurance,net_banking_transfer,348103.01
632ae6c02e1a0ebb7f46f260,50200023535069,249539.15,60ec41ba55c00300382672d9,HDFC,direct expenses,5eecc6d6449e4f7cfb1c2708,2022-04-07T00:00:00.000Z,"NEFT DR-YESB0000551-VISTTA COSMETICS-NET BANK, MUM-N097221907650391-300000",,,net_banking_transfer,-300000
632ae6c02e1a0ebb7f46f262,50200023535069,261116.94,60ec41ba55c00300382672d9,HDFC,Revenue-PG-split enabled,5eecc6d6449e4f7cfb1c2708,2022-04-07T00:00:00.000Z,NEFT CR-UTIB0001506-RAZORPAY SOFTWARE PR IVATE LIMITED-SLICK ORGANICS PVT LITD-AX ISCN0130807216,insurance,insurance,net_banking_transfer,11577.79
632ae6c02e1a0ebb7f46f264,50200023535069,302205.94,60ec41ba55c00300382672d9,HDFC,Revenue-UPI,5eecc6d6449e4f7cfb1c2708,2022-04-07T00:00:00.000Z,UPI-GOKWIK-GOKWIK@YESBANK-YESB0000340-20 9771300266-PAYOUT FOR APRIL 5,,,upi,41089
632ae6c02e1a0ebb7f46f266,50200023535069,47205.94,60ec41ba55c00300382672d9,HDFC,SAAS/tech expense,5eecc6d6449e4f7cfb1c2708,2022-04-08T00:00:00.000Z,POS 514834XXXXXX9486 AMAZON,shopping,,debit_card,-255000
632ae6c02e1a0ebb7f46f268,50200023535069,74262.9,60ec41ba55c00300382672d9,HDFC,Revenue-PG-non-split,5eecc6d6449e4f7cfb1c2708,2022-04-08T00:00:00.000Z,NEFT CR-PYTM0123456-PAYTM PAYMENTS SERVI,ewallet,,net_banking_transfer,27056.96
632ae6c02e1a0ebb7f46f26a,50200023535069,79457.34,60ec41ba55c00300382672d9,HDFC,Revenue-Mktplace,5eecc6d6449e4f7cfb1c2708,2022-04-08T00:00:00.000Z,NEFT CR-DEUT0797BGL-FLIPKART INTERNET PR IVATE LIMITED-SLICK ORGANICS PVT LTD-209 800142GN00059,shopping,,net_banking_transfer,5194.44
632ae6c02e1a0ebb7f46f26c,50200023535069,85140.13,60ec41ba55c00300382672d9,HDFC,Revenue-Mktplace,5eecc6d6449e4f7cfb1c2708,2022-04-08T00:00:00.000Z,NEFT CR-DEUT0797BGL-MYNTRA DESIGNS PRIVA TE LIMITED-SLICK ORGANICS PVT. LTD.-2098 00555GN00106,shopping,,net_banking_transfer,5682.79
632ae6c02e1a0ebb7f46f26f,50200023535069,90882.23,60ec41ba55c00300382672d9,HDFC,Revenue-Mktplace,5eecc6d6449e4f7cfb1c2708,2022-04-08T00:00:00.000Z,NEFT CR-DEUT0797BGL-MYNTRA DESIGNS PRIVA TE LIMITED-SLICK ORGANICS PVT. LTD.-2098 00576GN00026,shopping,,net_banking_transfer,5742.1
632ae6c02e1a0ebb7f46f271,50200023535069,106274.93,60ec41ba55c00300382672d9,HDFC,Revenue-PG-split enabled,5eecc6d6449e4f7cfb1c2708,2022-04-08T00:00:00.000Z,NEFT CR-UTIB0001506-RAZORPAY SOFTWARE PR IVATE LIMITED-SLICK ORGANICS PVT LITD-AX ISCN0130884556,insurance,insurance,net_banking_transfer,15392.7
632ae6c02e1a0ebb7f46f273,50200023535069,-1725.07,60ec41ba55c00300382672d9,HDFC,direct expenses,5eecc6d6449e4f7cfb1c2708,2022-04-08T00:00:00.000Z,50200054531492-TPT-108000-ALETA PEOPLE S ERVICES,,,net_banking_transfer,-108000
632ae6c02e1a0ebb7f46f275,50200023535069,24101.98,60ec41ba55c00300382672d9,HDFC,Revenue-PG-non-split,5eecc6d6449e4f7cfb1c2708,2022-04-08T00:00:00.000Z,NEFT CR-KKBK0000958-BROKENTUSK TECHNOLOG IES PRIVATE LIMITED-SLICK ORGANICS PRIVA TE LIMITED-KKBK220985141027,,,net_banking_transfer,25827.05
632ae6c02e1a0ebb7f46f278,50200023535069,79939.41,60ec41ba55c00300382672d9,HDFC,Revenue-COD,5eecc6d6449e4f7cfb1c2708,2022-04-08T00:00:00.000Z,NEFT CR-ICIC0000155-SHIPROCKET COD CRF I D 4136530-SLICK ORGANICS PVT LTD-CMS2504 579494,insurance,insurance,net_banking_transfer,55837.43
632ae6c02e1a0ebb7f46f27a,50200023535069,86952.43,60ec41ba55c00300382672d9,HDFC,Revenue-PG-split enabled,5eecc6d6449e4f7cfb1c2708,2022-04-08T00:00:00.000Z,NEFT CR-UTIB0001506-RAZORPAY SOFTWARE PR IVATE LIMITED-SLICK ORGANICS PVT LITD-AX ISCN0131003297,insurance,insurance,net_banking_transfer,7013.02
632ae6c02e1a0ebb7f46f27c,50200023535069,139507.34,60ec41ba55c00300382672d9,HDFC,Revenue-UPI,5eecc6d6449e4f7cfb1c2708,2022-04-08T00:00:00.000Z,UPI-GOKWIK-GOKWIK@YESBANK-YESB0000340-20 9873560492-PAYOUT FOR APRIL 6,,,upi,52554.91
632ae6c02e1a0ebb7f46f27e,50200023535069,165501.33,60ec41ba55c00300382672d9,HDFC,Revenue-PG-non-split,5eecc6d6449e4f7cfb1c2708,2022-04-09T00:00:00.000Z,NEFT CR-PYTM0123456-PAYTM PAYMENTS SERVI CES LIMITED-SLICK ORGANICS PVT LTD-PYTM2 20990523521,insurance,insurance,net_banking_transfer,25993.99
632ae6c02e1a0ebb7f46f280,50200023535069,665501.33,60ec41ba55c00300382672d9,HDFC,Internal Transfers,5eecc6d6449e4f7cfb1c2708,2022-04-09T00:00:00.000Z,IB FUNDS TRANSFER CR-50200035187206 -SL ICK ORGANICS PVT LTD,insurance,insurance,Other,500000
632ae6c02e1a0ebb7f46f282,50200023535069,465501.33,60ec41ba55c00300382672d9,HDFC,direct expenses,5eecc6d6449e4f7cfb1c2708,2022-04-09T00:00:00.000Z,NEFT DR-ICIC0000369-BO INTERNATIONAL-NET,,,net_banking_transfer,-200000
632ae6c02e1a0ebb7f46f284,50200023535069,265501.33,60ec41ba55c00300382672d9,HDFC,direct expenses,5eecc6d6449e4f7cfb1c2708,2022-04-09T00:00:00.000Z,IMPS-209916146382-BO INTERNATIONAL-ICIC- XXXXXXXX3230-200000,,,net_banking_transfer,-200000
632ae6c02e1a0ebb7f46f286,50200023535069,291933.1,60ec41ba55c00300382672d9,HDFC,Revenue-UPI,5eecc6d6449e4f7cfb1c2708,2022-04-09T00:00:00.000Z,UPI-GOKWIK-GOKWIK@YESBANK-YESB0000340-20 9975732144-PAYOUT FOR APRIL 7,,,upi,26431.77
632ae6c02e1a0ebb7f46f288,50200023535069,311695.7,60ec41ba55c00300382672d9,HDFC,Revenue-PG-non-split,5eecc6d6449e4f7cfb1c2708,2022-04-10T00:00:00.000Z,IMPS-210004993772-PAYTM PAYMENTS SERVI-P YTM-XXXXXXXXXX0008-ALL202204102168200003 30830668628,ewallet,,net_banking_transfer,19762.6
632ae6c12e1a0ebb7f46f28a,50200023535069,290933.7,60ec41ba55c00300382672d9,HDFC,direct expenses,5eecc6d6449e4f7cfb1c2708,2022-04-10T00:00:00.000Z,"NEFT DR-UTIB0001964-BLUE BELLS EVENTS AN D PROMOTIONS-NETBANK, MUM-N1002219118893 17-20762",,,net_banking_transfer,-20762
632ae6c12e1a0ebb7f46f28c,50200023535069,285933.7,60ec41ba55c00300382672d9,HDFC,direct expenses,5eecc6d6449e4f7cfb1c2708,2022-04-10T00:00:00.000Z,"NEFT DR-ICIC0000558-ANJANA MURALIDHARAN- NETBANK, MUM-N100221911884732-5000",,,net_banking_transfer,-5000
632ae6c12e1a0ebb7f46f28e,50200023535069,280033.7,60ec41ba55c00300382672d9,HDFC,direct expenses,5eecc6d6449e4f7cfb1c2708,2022-04-10T00:00:00.000Z,"NEFT DR-KKBK0004581-MJ GLOBAL PVT LTD-NE TBANK, MUM-N100221911902437-5900",,,net_banking_transfer,-5900
632ae6c12e1a0ebb7f46f290,50200023535069,261176.7,60ec41ba55c00300382672d9,HDFC,direct expenses,5eecc6d6449e4f7cfb1c2708,2022-04-10T00:00:00.000Z,"NEFT DR-ICIC0001963-HARSHADA WAGHMARE-NE TBANK, MUM-N100221911935319-18857",,,net_banking_transfer,-18857
632ae6c12e1a0ebb7f46f292,50200023535069,250796.7,60ec41ba55c00300382672d9,HDFC,direct expenses,5eecc6d6449e4f7cfb1c2708,2022-04-10T00:00:00.000Z,"NEFT DR-CNRB0019016-MANEESH-NETBANK, MUM -N100221911943529-10380",,,net_banking_transfer,-10380
632ae6c12e1a0ebb7f46f294,50200023535069,202196.7,60ec41ba55c00300382672d9,HDFC,direct expenses,5eecc6d6449e4f7cfb1c2708,2022-04-10T00:00:00.000Z,"NEFT DR-CNRB0015170-SNEHAL TAYDE-NETBANK , MUM-N100221911948028-48600",,,net_banking_transfer,-48600
632ae6c12e1a0ebb7f46f296,50200023535069,2196.7,60ec41ba55c00300382672d9,HDFC,direct expenses,5eecc6d6449e4f7cfb1c2708,2022-04-10T00:00:00.000Z,"NEFT DR-ICIC0000369-BO INTERNATIONAL-NET BANK, MUM-N100221911961971-200000",,,net_banking_transfer,-200000
632ae6c12e1a0ebb7f46f299,50200023535069,502196.7,60ec41ba55c00300382672d9,HDFC,Internal Transfers,5eecc6d6449e4f7cfb1c2708,2022-04-10T00:00:00.000Z,IB FUNDS TRANSFER CR-50200035187206 -SL ICK ORGANICS PVT LTD,insurance,insurance,Other,500000
632ae6c12e1a0ebb7f46f29b,50200023535069,247196.7,60ec41ba55c00300382672d9,HDFC,SAAS/tech expense,5eecc6d6449e4f7cfb1c2708,2022-04-10T00:00:00.000Z,POS 514834XXXXXX9486 AMAZON,shopping,,debit_card,-255000
632ae6c12e1a0ebb7f46f29d,50200023535069,248488.78,60ec41ba55c00300382672d9,HDFC,Revenue-Mktplace,5eecc6d6449e4f7cfb1c2708,2022-04-11T00:00:00.000Z,NEFT CR-DEUT0797BGL-FLIPKART INTERNET PR IVATE LIMITED-SLICK ORGANICS PVT LTD-210 100154GN00174,shopping,,net_banking_transfer,1292.08
632ae6c12e1a0ebb7f46f29f,50200023535069,312785.41,60ec41ba55c00300382672d9,HDFC,Revenue-PG-non-split,5eecc6d6449e4f7cfb1c2708,2022-04-11T00:00:00.000Z,NEFT CR-PYTM0123456-PAYTM PAYMENTS SERVI,ewallet,,net_banking_transfer,64296.63
632ae6c12e1a0ebb7f46f2a2,50200023535069,320925.82,60ec41ba55c00300382672d9,HDFC,Revenue-Mktplace,5eecc6d6449e4f7cfb1c2708,2022-04-11T00:00:00.000Z,NEFT CR-DEUT0797BGL-MYNTRA DESIGNS PRIVA TE LIMITED-SLICK ORGANICS PVT. LTD.-2101 00538GN00264,shopping,,net_banking_transfer,8140.41
632ae6c12e1a0ebb7f46f2a4,50200023535069,323609.38,60ec41ba55c00300382672d9,HDFC,Revenue-Mktplace,5eecc6d6449e4f7cfb1c2708,2022-04-11T00:00:00.000Z,NEFT CR-DEUT0797BGL-MYNTRA DESIGNS PRIVA TE LIMITED-SLICK ORGANICS PVT. LTD.-2101 00537GN00207,shopping,,net_banking_transfer,2683.56
632ae6c12e1a0ebb7f46f2a6,50200023535069,324541.71,60ec41ba55c00300382672d9,HDFC,Revenue-Mktplace,5eecc6d6449e4f7cfb1c2708,2022-04-11T00:00:00.000Z,NEFT CR-DEUT0797BGL-MYNTRA DESIGNS PRIVA TE LIMITED-SLICK ORGANICS PRIVATE LIMITE D-210100640GN00197,shopping,,net_banking_transfer,932.33
632ae6c12e1a0ebb7f46f2a8,50200023535069,459673.99,60ec41ba55c00300382672d9,HDFC,Revenue-PG-split enabled,5eecc6d6449e4f7cfb1c2708,2022-04-11T00:00:00.000Z,NEFT CR-UTIB0001506-RAZORPAY SOFTWARE PR IVATE LIMITED-SLICK ORGANICS PVT LITD-AX ISCN0131131081,insurance,insurance,net_banking_transfer,135132.28
632ae6c12e1a0ebb7f46f2aa,50200023535069,650379.88,60ec41ba55c00300382672d9,HDFC,Revenue-Mktplace,5eecc6d6449e4f7cfb1c2708,2022-04-11T00:00:00.000Z,IMPS-210112117812-AMAZON SELLER SERVIC-H SBC-XXXXXXXX6004-6KR8LFPBJ404KNNNSLICK O RGANICS PVT LTD,shopping,,net_banking_transfer,190705.89
632ae6c12e1a0ebb7f46f2ac,50200023535069,659250.9,60ec41ba55c00300382672d9,HDFC,Revenue-PG-non-split,5eecc6d6449e4f7cfb1c2708,2022-04-11T00:00:00.000Z,NEFT CR-SCBL0036001-STRIPE INDIA PRIVATE -SLICK ORGANICS PRIVATE LIMITED-SSG17413 Q0635440,insurance,insurance,net_banking_transfer,8871.02
632ae6c12e1a0ebb7f46f2ae,50200023535069,1389711.04,60ec41ba55c00300382672d9,HDFC,Revenue-Mktplace,5eecc6d6449e4f7cfb1c2708,2022-04-11T00:00:00.000Z,NEFT CR-DEUT0797BGL-AMAZON PAY (INDIA) P RIVATE LIMITED-SLICK ORGANICS PVT LTD-21 0101076GN00119,shopping,,net_banking_transfer,730460.14
632ae6c12e1a0ebb7f46f2b0,50200023535069,1392147.67,60ec41ba55c00300382672d9,HDFC,Revenue-PG-non-split,5eecc6d6449e4f7cfb1c2708,2022-04-11T00:00:00.000Z,NEFT CR-IDFB0010204-SEZZLE PAYMENTS PRIV ATE LIMITED-SLICK ORGANICS PRIVATE LIMIT ED-IDFBH22101063175,insurance,insurance,net_banking_transfer,2436.63
632ae6c12e1a0ebb7f46f2b2,50200023535069,1392982.54,60ec41ba55c00300382672d9,HDFC,Revenue-Mktplace,5eecc6d6449e4f7cfb1c2708,2022-04-11T00:00:00.000Z,NEFT CR-ICIC0000105-MANASH LIFESTYLE PRI VATE LIMITED NO-SLICK ORGANICS PRIVATE L IMITED MP M-ICIJ221010006473,shopping,,net_banking_transfer,834.87
632ae6c12e1a0ebb7f46f2b4,50200023535069,1395065.74,60ec41ba55c00300382672d9,HDFC,Revenue-Mktplace,5eecc6d6449e4f7cfb1c2708,2022-04-11T00:00:00.000Z,NEFT CR-ICIC0000105-MANASH LIFESTYLE PRI VATE LIMITED NO-SLICK ORGANICS PRIVATE L IMITED BANG-ICIJ221010006477,shopping,,net_banking_transfer,2083.2
632ae6c12e1a0ebb7f46f2b6,50200023535069,1395504.07,60ec41ba55c00300382672d9,HDFC,Revenue-Mktplace,5eecc6d6449e4f7cfb1c2708,2022-04-11T00:00:00.000Z,NEFT CR-ICIC0000105-MANASH LIFESTYLE PRI,shopping,,net_banking_transfer,438.33
632ae6c12e1a0ebb7f46f2b8,50200023535069,1459032.24,60ec41ba55c00300382672d9,HDFC,Revenue-PG-non-split,5eecc6d6449e4f7cfb1c2708,2022-04-11T00:00:00.000Z,NEFT CR-KKBK0000958-BROKENTUSK TECHNOLOG IES PRIVATE LIMITED-SLICK ORGANICS PRIVA TE LIMITED-KKBK221015763693,,,net_banking_transfer,63528.17
632ae6c12e1a0ebb7f46f2ba,50200023535069,1610606.93,60ec41ba55c00300382672d9,HDFC,Revenue-PG-non-split,5eecc6d6449e4f7cfb1c2708,2022-04-11T00:00:00.000Z,NEFT CR-KKBK0000958-BROKENTUSK TECHNOLOG IES PRIVATE LIMITED-SLICK ORGANICS PRIVA TE LIMITED-KKBK221015769819,,,net_banking_transfer,151574.69
632ae6c12e1a0ebb7f46f2bc,50200023535069,1707229.24,60ec41ba55c00300382672d9,HDFC,Revenue-PG-non-split,5eecc6d6449e4f7cfb1c2708,2022-04-11T00:00:00.000Z,NEFT CR-KKBK0000958-BROKENTUSK TECHNOLOG IES PRIVATE LIMITED-SLICK ORGANICS PRIVA TE LIMITED-KKBK221015770366,,,net_banking_transfer,96622.31
632ae6c12e1a0ebb7f46f2be,50200023535069,1711447.32,60ec41ba55c00300382672d9,HDFC,Revenue-PG-split enabled,5eecc6d6449e4f7cfb1c2708,2022-04-11T00:00:00.000Z,NEFT CR-UTIB0001506-RAZORPAY SOFTWARE PR IVATE LIMITED-SLICK ORGANICS PVT LITD-AX ISCN0131256174,insurance,insurance,net_banking_transfer,4218.08
632ae6c12e1a0ebb7f46f2c0,50200023535069,1737849.77,60ec41ba55c00300382672d9,HDFC,Revenue-COD,5eecc6d6449e4f7cfb1c2708,2022-04-11T00:00:00.000Z,NEFT CR-ICIC0000155-SHIPROCKET COD CRF I D 4144762-SLICK ORGANICS PVT LTD-CMS2510 191215,insurance,insurance,net_banking_transfer,26402.45
632ae6c12e1a0ebb7f46f2c2,50200023535069,1779256.39,60ec41ba55c00300382672d9,HDFC,Revenue-PG-non-split,5eecc6d6449e4f7cfb1c2708,2022-04-12T00:00:00.000Z,NEFT CR-PYTM0123456-PAYTM PAYMENTS SERVI CES LIMITED-SLICK ORGANICS PVT LTD-PYTM2 21021907527,insurance,insurance,net_banking_transfer,41406.62
632ae6c12e1a0ebb7f46f2c4,50200023535069,1782319.06,60ec41ba55c00300382672d9,HDFC,Revenue-Mktplace,5eecc6d6449e4f7cfb1c2708,2022-04-12T00:00:00.000Z,NEFT CR-DEUT0797BGL-MYNTRA DESIGNS PRIVA TE LIMITED-SLICK ORGANICS PVT. LTD.-2102 00351GN00238,shopping,,net_banking_transfer,3062.67
632ae6c12e1a0ebb7f46f2c6,50200023535069,1785014.55,60ec41ba55c00300382672d9,HDFC,Revenue-Mktplace,5eecc6d6449e4f7cfb1c2708,2022-04-12T00:00:00.000Z,NEFT CR-DEUT0797BGL-MYNTRA DESIGNS PRIVA TE LIMITED-SLICK ORGANICS PVT. LTD.-2102 00352GN00204,shopping,,net_banking_transfer,2695.49
632ae6c12e1a0ebb7f46f2c8,50200023535069,1788636.24,60ec41ba55c00300382672d9,HDFC,Revenue-Mktplace,5eecc6d6449e4f7cfb1c2708,2022-04-12T00:00:00.000Z,NEFT CR-DEUT0797BGL-MYNTRA DESIGNS PRIVA TE LIMITED-SLICK ORGANICS PRIVATE LIMITE D-210200379GN00139,shopping,,net_banking_transfer,3621.69
632ae6c12e1a0ebb7f46f2ca,50200023535069,1800940.62,60ec41ba55c00300382672d9,HDFC,Revenue-PG-split enabled,5eecc6d6449e4f7cfb1c2708,2022-04-12T00:00:00.000Z,NEFT CR-UTIB0001506-RAZORPAY SOFTWARE PR IVATE LIMITED-SLICK ORGANICS PVT LITD-AX ISCN0131312051,insurance,insurance,net_banking_transfer,12304.38
632ae6c12e1a0ebb7f46f2cc,50200023535069,1831153.23,60ec41ba55c00300382672d9,HDFC,Revenue-Mktplace,5eecc6d6449e4f7cfb1c2708,2022-04-12T00:00:00.000Z,NEFT CR-HSBC0400002-AMAZON SERVICES LLC-,shopping,,net_banking_transfer,30212.61
632ae6c12e1a0ebb7f46f2ce,50200023535069,1852884.8,60ec41ba55c00300382672d9,HDFC,Revenue-PG-non-split,5eecc6d6449e4f7cfb1c2708,2022-04-12T00:00:00.000Z,NEFT CR-KKBK0000958-BROKENTUSK TECHNOLOG IES PRIVATE LIMITED-SLICK ORGANICS PRIVA TE LIMITED-KKBK221026022964,,,net_banking_transfer,21731.57
632ae6c12e1a0ebb7f46f2d0,50200023535069,1855845.1,60ec41ba55c00300382672d9,HDFC,Transfer in/Revenue-other,5eecc6d6449e4f7cfb1c2708,2022-04-12T00:00:00.000Z,57500000644820-SLICK ORGANICS,insurance,insurance,Other,2960.3
632ae6c12e1a0ebb7f46f2d2,50200023535069,1872270.56,60ec41ba55c00300382672d9,HDFC,Revenue-PG-split enabled,5eecc6d6449e4f7cfb1c2708,2022-04-12T00:00:00.000Z,NEFT CR-UTIB0001506-RAZORPAY SOFTWARE PR IVATE LIMITED-SLICK ORGANICS PVT LITD-AX ISCN0131420476,insurance,insurance,net_banking_transfer,16425.46
632ae6c12e1a0ebb7f46f2d4,50200023535069,1873090.8,60ec41ba55c00300382672d9,HDFC,Revenue-Mktplace,5eecc6d6449e4f7cfb1c2708,2022-04-12T00:00:00.000Z,NEFT CR-ICIC0000105-MANASH LIFESTYLE PRI VATE LIMITED NO-SLICK ORGANICS PRIVATE L IMITED BANG-ICIJ221020009693,shopping,,net_banking_transfer,820.24
632ae6c12e1a0ebb7f46f2d6,50200023535069,1873529.86,60ec41ba55c00300382672d9,HDFC,Revenue-Mktplace,5eecc6d6449e4f7cfb1c2708,2022-04-12T00:00:00.000Z,NEFT CR-ICIC0000105-MANASH LIFESTYLE PRI VATE LIMITED NO-SLICK ORGANICS PRIVATE L IMITED MP M-ICIJ221020011826,shopping,,net_banking_transfer,439.06
632ae6c12e1a0ebb7f46f2d8,50200023535069,1877692.68,60ec41ba55c00300382672d9,HDFC,Revenue-Mktplace,5eecc6d6449e4f7cfb1c2708,2022-04-13T00:00:00.000Z,NEFT CR-DEUT0797BGL-FLIPKART INTERNET PR IVATE LIMITED-SLICK ORGANICS PVT LTD-210 300147GN00119,shopping,,net_banking_transfer,4162.82
632ae6c12e1a0ebb7f46f2da,50200023535069,1879621.32,60ec41ba55c00300382672d9,HDFC,Revenue-Mktplace,5eecc6d6449e4f7cfb1c2708,2022-04-13T00:00:00.000Z,NEFT CR-DEUT0797BGL-FLIPKART INTERNET PR IVATE LIMITED-SLICK ORGANICS PVT LTD-210 300164GN00120,shopping,,net_banking_transfer,1928.64
632ae6c12e1a0ebb7f46f2dc,50200023535069,1902581.97,60ec41ba55c00300382672d9,HDFC,Revenue-PG-non-split,5eecc6d6449e4f7cfb1c2708,2022-04-13T00:00:00.000Z,IMPS-210304107228-PAYTM PAYMENTS SERVI-P YTM-XXXXXXXXXX0008-ALL202204132168200003 30830668628,ewallet,,net_banking_transfer,22960.65
632ae6c12e1a0ebb7f46f2de,50200023535069,1907956.56,60ec41ba55c00300382672d9,HDFC,Revenue-Mktplace,5eecc6d6449e4f7cfb1c2708,2022-04-13T00:00:00.000Z,NEFT CR-DEUT0797BGL-MYNTRA DESIGNS PRIVA TE LIMITED-SLICK ORGANICS PVT. LTD.-2103 00546GN00285,shopping,,net_banking_transfer,5374.59
632ae6c12e1a0ebb7f46f2e0,50200023535069,1910670.32,60ec41ba55c00300382672d9,HDFC,Revenue-Mktplace,5eecc6d6449e4f7cfb1c2708,2022-04-13T00:00:00.000Z,NEFT CR-DEUT0797BGL-MYNTRA DESIGNS PRIVA TE LIMITED-SLICK ORGANICS PVT. LTD.-2103 00547GN00250,shopping,,net_banking_transfer,2713.76
632ae6c12e1a0ebb7f46f2e2,50200023535069,1912832.56,60ec41ba55c00300382672d9,HDFC,Revenue-Mktplace,5eecc6d6449e4f7cfb1c2708,2022-04-13T00:00:00.000Z,4060000263-TIMES INTERNET LIMITED NODAL,,,Other,2162.24
632ae6c12e1a0ebb7f46f2e4,50200023535069,1928503.36,60ec41ba55c00300382672d9,HDFC,Revenue-PG-split enabled,5eecc6d6449e4f7cfb1c2708,2022-04-13T00:00:00.000Z,NEFT CR-UTIB0001506-RAZORPAY SOFTWARE PR,,,net_banking_transfer,15670.8
632ae6c12e1a0ebb7f46f2e6,50200023535069,1928952.71,60ec41ba55c00300382672d9,HDFC,Revenue-Mktplace,5eecc6d6449e4f7cfb1c2708,2022-04-13T00:00:00.000Z,NEFT CR-ICIC0000105-MANASH LIFESTYLE PRI VATE LIMITED NO-SLICK ORGANICS PRIVATE L IMITED MP G-ICIJ221030003693,shopping,,net_banking_transfer,449.35
632ae6c12e1a0ebb7f46f2e8,50200023535069,1929933.46,60ec41ba55c00300382672d9,HDFC,Revenue-Mktplace,5eecc6d6449e4f7cfb1c2708,2022-04-13T00:00:00.000Z,NEFT CR-ICIC0000105-MANASH LIFESTYLE PRI VATE LIMITED NO-SLICK ORGANICS PRIVATE L IMITED MP M-ICIJ221030001989,shopping,,net_banking_transfer,980.75
632ae6c12e1a0ebb7f46f2ea,50200023535069,1839933.46,60ec41ba55c00300382672d9,HDFC,direct expenses,5eecc6d6449e4f7cfb1c2708,2022-04-13T00:00:00.000Z,50200031284040-TPT-90000-BURGEON LAW LLP,,,net_banking_transfer,-90000
632ae6c12e1a0ebb7f46f2ed,50200023535069,1831377.46,60ec41ba55c00300382672d9,HDFC,Salary/Emp/consultant Expense,5eecc6d6449e4f7cfb1c2708,2022-04-13T00:00:00.000Z,1764728468/EPFO,,,Other,-8556
632ae6c12e1a0ebb7f46f2ef,50200023535069,1826184.46,60ec41ba55c00300382672d9,HDFC,direct expenses,5eecc6d6449e4f7cfb1c2708,2022-04-13T00:00:00.000Z,"NEFT DR-BARB0DINARA-MD ARIF RAZA-NETBANK , MUM-N103221916937730-5193",,,net_banking_transfer,-5193
632ae6c12e1a0ebb7f46f2f1,50200023535069,1831376.46,60ec41ba55c00300382672d9,HDFC,Transfer in/Revenue-other,5eecc6d6449e4f7cfb1c2708,2022-04-13T00:00:00.000Z,FT - CR - 50200038726231 - HOUSE OF BEAU TY PRIVATE LIMITED,,,Other,5192
632ae6c12e1a0ebb7f46f2f4,50200023535069,1826693.46,60ec41ba55c00300382672d9,HDFC,direct expenses,5eecc6d6449e4f7cfb1c2708,2022-04-13T00:00:00.000Z,02022112295549/ESIC,,,Other,-4683
632ae6c12e1a0ebb7f46f2f7,50200023535069,1235953.46,60ec41ba55c00300382672d9,HDFC,direct expenses,5eecc6d6449e4f7cfb1c2708,2022-04-13T00:00:00.000Z,50200020787428-TPT-590740-SHRI AKSHARA F ILMS,,,net_banking_transfer,-590740
632ae6c12e1a0ebb7f46f2f9,50200023535069,1247039.06,60ec41ba55c00300382672d9,HDFC,Revenue-PG-split enabled,5eecc6d6449e4f7cfb1c2708,2022-04-13T00:00:00.000Z,NEFT CR-UTIB0001506-RAZORPAY SOFTWARE PR IVATE LIMITED-SLICK ORGANICS PVT LITD-AX ISCN0131631137,insurance,insurance,net_banking_transfer,11085.6
632ae6c12e1a0ebb7f46f2fb,50200023535069,1299350.1,60ec41ba55c00300382672d9,HDFC,Revenue-COD,5eecc6d6449e4f7cfb1c2708,2022-04-13T00:00:00.000Z,NEFT CR-ICIC0000155-SHIPROCKET COD CRF I D 4157112-SLICK ORGANICS PVT LTD-CMS2515 748658,insurance,insurance,net_banking_transfer,52311.04
632ae6c12e1a0ebb7f46f2fd,50200023535069,1354544.13,60ec41ba55c00300382672d9,HDFC,Revenue-UPI,5eecc6d6449e4f7cfb1c2708,2022-04-13T00:00:00.000Z,UPI-GOKWIK-GOKWIK@YESBANK-YESB0000340-21 0383854976-PAYOUT FOR APRIL 1,,,upi,55194.03
632ae6c12e1a0ebb7f46f2ff,50200023535069,1390158.45,60ec41ba55c00300382672d9,HDFC,Revenue-PG-non-split,5eecc6d6449e4f7cfb1c2708,2022-04-14T00:00:00.000Z,NEFT CR-PYTM0123456-PAYTM PAYMENTS SERVI CES LIMITED-SLICK ORGANICS PVT LTD-PYTM2 21042946959,insurance,insurance,net_banking_transfer,35614.32
632ae6c12e1a0ebb7f46f301,50200023535069,1135158.45,60ec41ba55c00300382672d9,HDFC,SAAS/tech expense,5eecc6d6449e4f7cfb1c2708,2022-04-14T00:00:00.000Z,POS 514834XXXXXX9486 AMAZON,shopping,,debit_card,-255000
632ae6c12e1a0ebb7f46f303,50200023535069,1137744.09,60ec41ba55c00300382672d9,HDFC,Revenue-Mktplace,5eecc6d6449e4f7cfb1c2708,2022-04-14T00:00:00.000Z,NEFT CR-DEUT0797BGL-MYNTRA DESIGNS PRIVA,shopping,,net_banking_transfer,2585.64
632ae6c12e1a0ebb7f46f305,50200023535069,1028567.09,60ec41ba55c00300382672d9,HDFC,direct expenses,5eecc6d6449e4f7cfb1c2708,2022-04-14T00:00:00.000Z,00921000075586-TPT-109177-ROET BINDRA,,,net_banking_transfer,-109177
632ae6c12e1a0ebb7f46f307,50200023535069,812567.09,60ec41ba55c00300382672d9,HDFC,direct expenses,5eecc6d6449e4f7cfb1c2708,2022-04-14T00:00:00.000Z,"NEFT DR-BARB0VJMATU-ARTISTO DESIGNZ-NETB ANK, MUM-N104221917984093-216000",,,net_banking_transfer,-216000
632ae6c12e1a0ebb7f46f309,50200023535069,644897.09,60ec41ba55c00300382672d9,HDFC,direct expenses,5eecc6d6449e4f7cfb1c2708,2022-04-14T00:00:00.000Z,"NEFT DR-YESB0000058-SIXTEENBY9 VIDEO WOR KS-NETBANK, MUM-N104221917984673-167670",,,net_banking_transfer,-167670
632ae6c12e1a0ebb7f46f30c,50200023535069,641357.09,60ec41ba55c00300382672d9,HDFC,direct expenses,5eecc6d6449e4f7cfb1c2708,2022-04-14T00:00:00.000Z,POS 514834XXXXXX9486 SHERATON BANGALO,,,debit_card,-3540
632ae6c12e1a0ebb7f46f30e,50200023535069,641543.28,60ec41ba55c00300382672d9,HDFC,Revenue-Mktplace,5eecc6d6449e4f7cfb1c2708,2022-04-14T00:00:00.000Z,NEFT CR-ICIC0000105-MANASH LIFESTYLE PRI VATE LIMITED NO-SLICK ORGANICS PRIVATE L IMITED MP G-ICIJ221040000869,shopping,,net_banking_transfer,186.19
632ae6c12e1a0ebb7f46f310,50200023535069,695433.8,60ec41ba55c00300382672d9,HDFC,Revenue-UPI,5eecc6d6449e4f7cfb1c2708,2022-04-14T00:00:00.000Z,UPI-GOKWIK-GOKWIK@YESBANK-YESB0000340-21 0485922305-PAYOUT FOR APRIL 1,,,upi,53890.52
632ae6c12e1a0ebb7f46f312,50200023535069,714681.97,60ec41ba55c00300382672d9,HDFC,Revenue-PG-non-split,5eecc6d6449e4f7cfb1c2708,2022-04-15T00:00:00.000Z,IMPS-210504337783-PAYTM PAYMENTS SERVI-P YTM-XXXXXXXXXX0008-ALL202204152168200003 30830668628,ewallet,,net_banking_transfer,19248.17
632ae6c12e1a0ebb7f46f314,50200023535069,683181.97,60ec41ba55c00300382672d9,HDFC,direct expenses,5eecc6d6449e4f7cfb1c2708,2022-04-15T00:00:00.000Z,"NEFT DR-UBIN0531855-MOHANISH KOTHARI-NET BANK, MUM-N105221918701347-31500",,,net_banking_transfer,-31500
632ae6c12e1a0ebb7f46f316,50200023535069,686146.58,60ec41ba55c00300382672d9,HDFC,Revenue-Mktplace,5eecc6d6449e4f7cfb1c2708,2022-04-15T00:00:00.000Z,NEFT CR-DEUT0797BGL-MYNTRA DESIGNS PRIVA TE LIMITED-SLICK ORGANICS PVT. LTD.-2105 00370GN00001,shopping,,net_banking_transfer,2964.61
632ae6c12e1a0ebb7f46f318,50200023535069,639646.58,60ec41ba55c00300382672d9,HDFC,agency/vendor expense,5eecc6d6449e4f7cfb1c2708,2022-04-15T00:00:00.000Z,"NEFT DR-UTIB0003557-INCOSEC LEGAL-NETBAN K, MUM-N105221918719773-46500",,,net_banking_transfer,-46500
632ae6c12e1a0ebb7f46f31a,50200023535069,579182.58,60ec41ba55c00300382672d9,HDFC,direct expenses,5eecc6d6449e4f7cfb1c2708,2022-04-15T00:00:00.000Z,"NEFT DR-CITI0000002-OMG NETWORK INDIA PR IVATE LIMITED-NETBANK, MUM-N105221918871 362-60464",,,net_banking_transfer,-60464
632ae6c12e1a0ebb7f46f31c,50200023535069,455201.58,60ec41ba55c00300382672d9,HDFC,direct expenses,5eecc6d6449e4f7cfb1c2708,2022-04-15T00:00:00.000Z,"NEFT DR-DEUT0784BBY-DHL EXPRESS INDIA PV T LTD-NETBANK, MUM-N105221918905803-1239 81",,,net_banking_transfer,-123981
632ae6c12e1a0ebb7f46f31e,50200023535069,151150.26,60ec41ba55c00300382672d9,HDFC,direct expenses,5eecc6d6449e4f7cfb1c2708,2022-04-15T00:00:00.000Z,POS 514834XXXXXX9486 SHOPIFY* 1382068,,,debit_card,-304051.32
632ae6c12e1a0ebb7f46f320,50200023535069,162368.82,60ec41ba55c00300382672d9,HDFC,Transfer in/Revenue-other,5eecc6d6449e4f7cfb1c2708,2022-04-15T00:00:00.000Z,FT- ARATA-50200053251420 - OCTAVOS ENTER PRISE SOLUTIONS PVT LTD -,,,Other,11218.56
632ae6c12e1a0ebb7f46f322,50200023535069,163340.78,60ec41ba55c00300382672d9,HDFC,Revenue-Mktplace,5eecc6d6449e4f7cfb1c2708,2022-04-15T00:00:00.000Z,NEFT CR-ICIC0000105-MANASH LIFESTYLE PRI,shopping,,net_banking_transfer,971.96
632ae6c12e1a0ebb7f46f324,50200023535069,663340.78,60ec41ba55c00300382672d9,HDFC,Internal Transfers,5eecc6d6449e4f7cfb1c2708,2022-04-15T00:00:00.000Z,IB FUNDS TRANSFER CR-50200035187206 -SL ICK ORGANICS PVT LTD,insurance,insurance,Other,500000
632ae6c12e1a0ebb7f46f326,50200023535069,408340.78,60ec41ba55c00300382672d9,HDFC,SAAS/tech expense,5eecc6d6449e4f7cfb1c2708,2022-04-15T00:00:00.000Z,POS 514834XXXXXX9486 AMAZON,shopping,,debit_card,-255000
632ae6c12e1a0ebb7f46f328,50200023535069,461669.8,60ec41ba55c00300382672d9,HDFC,Revenue-UPI,5eecc6d6449e4f7cfb1c2708,2022-04-15T00:00:00.000Z,UPI-GOKWIK-GOKWIK@YESBANK-YESB0000340-21 0587817296-PAYOUT FOR APRIL 1,,,upi,53329.02
632ae6c12e1a0ebb7f46f32a,50200023535069,300069.8,60ec41ba55c00300382672d9,HDFC,direct expenses,5eecc6d6449e4f7cfb1c2708,2022-04-15T00:00:00.000Z,50200054531492-TPT-161600-ALETA PEOPLE S ERVICES,,,net_banking_transfer,-161600
632ae6c12e1a0ebb7f46f32d,50200023535069,100069.8,60ec41ba55c00300382672d9,HDFC,direct expenses,5eecc6d6449e4f7cfb1c2708,2022-04-15T00:00:00.000Z,"NEFT DR-ICIC0000369-BO INTERNATIONAL-NET BANK, MUM-N105221919233859-200000",,,net_banking_transfer,-200000
632ae6c22e1a0ebb7f46f32f,50200023535069,50069.8,60ec41ba55c00300382672d9,HDFC,direct expenses,5eecc6d6449e4f7cfb1c2708,2022-04-15T00:00:00.000Z,"NEFT DR-YESB0000236-DELIGHT VACATION PVT LTD-NETBANK, MUM-N105221919234820-50000",,,net_banking_transfer,-50000
632ae6c22e1a0ebb7f46f332,50200023535069,41069.8,60ec41ba55c00300382672d9,HDFC,direct expenses,5eecc6d6449e4f7cfb1c2708,2022-04-15T00:00:00.000Z,"NEFT DR-ICIC0004109-ASHRAFI ASSOCIATES-N ETBANK, MUM-N105221919235105-9000",,,net_banking_transfer,-9000
632ae6c22e1a0ebb7f46f334,50200023535069,55022.3,60ec41ba55c00300382672d9,HDFC,Revenue-PG-non-split,5eecc6d6449e4f7cfb1c2708,2022-04-16T00:00:00.000Z,IMPS-210604898966-PAYTM PAYMENTS SERVI-P YTM-XXXXXXXXXX0008-ALL202204162168200003 30830668628,ewallet,,net_banking_transfer,13952.5
632ae6c22e1a0ebb7f46f336,50200023535069,105937.21,60ec41ba55c00300382672d9,HDFC,Revenue-PG-split enabled,5eecc6d6449e4f7cfb1c2708,2022-04-16T00:00:00.000Z,NEFT CR-UTIB0001506-RAZORPAY SOFTWARE PR IVATE LIMITED-SLICK ORGANICS PVT LITD-AX ISCN0131799721,insurance,insurance,net_banking_transfer,50914.91
632ae6c22e1a0ebb7f46f338,50200023535069,1105937.21,60ec41ba55c00300382672d9,HDFC,Internal Transfers,5eecc6d6449e4f7cfb1c2708,2022-04-16T00:00:00.000Z,IB FUNDS TRANSFER CR-50200035187206 -SL ICK ORGANICS PVT LTD,insurance,insurance,Other,1000000
632ae6c22e1a0ebb7f46f33a,50200023535069,105937.21,60ec41ba55c00300382672d9,HDFC,Marketing Expense,5eecc6d6449e4f7cfb1c2708,2022-04-16T00:00:00.000Z,"NEFT DR-CITI0000006-FACEBOOK INDIA ONLIN E SERVICES PVT LTD-NETBANK, MUM-N1062219 19427131-1000000",,,net_banking_transfer,-1000000
632ae6c22e1a0ebb7f46f33c,50200023535069,605937.21,60ec41ba55c00300382672d9,HDFC,Internal Transfers,5eecc6d6449e4f7cfb1c2708,2022-04-16T00:00:00.000Z,IB FUNDS TRANSFER CR-50200035187206,,,Other,500000
632ae6c22e1a0ebb7f46f33e,50200023535069,455937.21,60ec41ba55c00300382672d9,HDFC,direct expenses,5eecc6d6449e4f7cfb1c2708,2022-04-16T00:00:00.000Z,"NEFT DR-UTIB0000120-ADNAN ALI-NETBANK, M UM-N106221919847120-150000",,,net_banking_transfer,-150000
632ae6c22e1a0ebb7f46f340,50200023535069,417584.11,60ec41ba55c00300382672d9,HDFC,SAAS/tech expense,5eecc6d6449e4f7cfb1c2708,2022-04-16T00:00:00.000Z,POS 514834XXXXXX9486 AMAZON.COM,shopping,,debit_card,-38353.1
632ae6c22e1a0ebb7f46f343,50200023535069,424530.02,60ec41ba55c00300382672d9,HDFC,Revenue-PG-split enabled,5eecc6d6449e4f7cfb1c2708,2022-04-16T00:00:00.000Z,NEFT CR-UTIB0001506-RAZORPAY SOFTWARE PR,,,net_banking_transfer,6945.91
632ae6c22e1a0ebb7f46f345,50200023535069,487595.56,60ec41ba55c00300382672d9,HDFC,Revenue-UPI,5eecc6d6449e4f7cfb1c2708,2022-04-16T00:00:00.000Z,UPI-GOKWIK-GOKWIK@YESBANK-YESB0000340-21 0689501786-PAYOUT FOR APRIL 1,,,upi,63065.54
632ae6c22e1a0ebb7f46f347,50200023535069,287595.56,60ec41ba55c00300382672d9,HDFC,direct expenses,5eecc6d6449e4f7cfb1c2708,2022-04-16T00:00:00.000Z,50200054531492-TPT-200000-ALETA PEOPLE S ERVICES,,,net_banking_transfer,-200000
632ae6c22e1a0ebb7f46f349,50200023535069,87595.56,60ec41ba55c00300382672d9,HDFC,direct expenses,5eecc6d6449e4f7cfb1c2708,2022-04-16T00:00:00.000Z,"NEFT DR-ICIC0000369-BO INTERNATIONAL-NET BANK, MUM-N106221920432808-200000",,,net_banking_transfer,-200000
632ae6c22e1a0ebb7f46f34b,50200023535069,8158.56,60ec41ba55c00300382672d9,HDFC,direct expenses,5eecc6d6449e4f7cfb1c2708,2022-04-16T00:00:00.000Z,"NEFT DR-YESB0000236-DELIGHT VACATION PVT LTD-NETBANK, MUM-N106221920424591-79437",,,net_banking_transfer,-79437
632ae6c22e1a0ebb7f46f34d,50200023535069,17343.38,60ec41ba55c00300382672d9,HDFC,Revenue-PG-non-split,5eecc6d6449e4f7cfb1c2708,2022-04-17T00:00:00.000Z,IMPS-210704375320-PAYTM PAYMENTS SERVI-P YTM-XXXXXXXXXX0008-ALL202204172168200003 30830668628,ewallet,,net_banking_transfer,9184.82
632ae6c22e1a0ebb7f46f34f,50200023535069,517343.38,60ec41ba55c00300382672d9,HDFC,Internal Transfers,5eecc6d6449e4f7cfb1c2708,2022-04-17T00:00:00.000Z,IB FUNDS TRANSFER CR-50200035187206 -SL ICK ORGANICS PVT LTD,insurance,insurance,Other,500000
632ae6c22e1a0ebb7f46f351,50200023535069,262343.38,60ec41ba55c00300382672d9,HDFC,SAAS/tech expense,5eecc6d6449e4f7cfb1c2708,2022-04-17T00:00:00.000Z,POS 514834XXXXXX9486 AMAZON,shopping,,debit_card,-255000
632ae6c22e1a0ebb7f46f354,50200023535069,258844.38,60ec41ba55c00300382672d9,HDFC,direct expenses,5eecc6d6449e4f7cfb1c2708,2022-04-17T00:00:00.000Z,"NEFT DR-DCBL0000001-SUKAINA MEGHANI-NETB ANK, MUM-N107221920658768-3499",,,net_banking_transfer,-3499
632ae6c22e1a0ebb7f46f357,50200023535069,247044.38,60ec41ba55c00300382672d9,HDFC,direct expenses,5eecc6d6449e4f7cfb1c2708,2022-04-17T00:00:00.000Z,50200056366495-TPT-11800-MJ ENTERPRISES,,,net_banking_transfer,-11800
632ae6c22e1a0ebb7f46f359,50200023535069,284517.87,60ec41ba55c00300382672d9,HDFC,Revenue-UPI,5eecc6d6449e4f7cfb1c2708,2022-04-17T00:00:00.000Z,UPI-GOKWIK-GOKWIK@YESBANK-YESB0000340-21 0790986369-PAYOUT FOR APRIL 1,,,upi,37473.49
632ae6c22e1a0ebb7f46f35b,50200023535069,301683.35,60ec41ba55c00300382672d9,HDFC,Revenue-PG-non-split,5eecc6d6449e4f7cfb1c2708,2022-04-18T00:00:00.000Z,IMPS-210805917216-PAYTM PAYMENTS SERVI-P YTM-XXXXXXXXXX0008-ALL202204182168200003 30830668628,ewallet,,net_banking_transfer,17165.48
632ae6c22e1a0ebb7f46f35d,50200023535069,305098.47,60ec41ba55c00300382672d9,HDFC,Revenue-Mktplace,5eecc6d6449e4f7cfb1c2708,2022-04-18T00:00:00.000Z,NEFT CR-DEUT0797BGL-MYNTRA DESIGNS PRIVA TE LIMITED-SLICK ORGANICS PVT. LTD.-2108 00358GN00074,shopping,,net_banking_transfer,3415.12
632ae6c22e1a0ebb7f46f35f,50200023535069,312709.44,60ec41ba55c00300382672d9,HDFC,Revenue-Mktplace,5eecc6d6449e4f7cfb1c2708,2022-04-18T00:00:00.000Z,NEFT CR-DEUT0797BGL-MYNTRA DESIGNS PRIVA TE LIMITED-SLICK ORGANICS PVT. LTD.-2108 00357GN00098,shopping,,net_banking_transfer,7610.97
632ae6c22e1a0ebb7f46f362,50200023535069,314198.97,60ec41ba55c00300382672d9,HDFC,Revenue-Mktplace,5eecc6d6449e4f7cfb1c2708,2022-04-18T00:00:00.000Z,NEFT CR-DEUT0797BGL-MYNTRA DESIGNS PRIVA TE LIMITED-SLICK ORGANICS PVT. LTD.-2108 00370GN00265,shopping,,net_banking_transfer,1489.53
632ae6c22e1a0ebb7f46f364,50200023535069,314200.22,60ec41ba55c00300382672d9,HDFC,Transfer in/Revenue-other,5eecc6d6449e4f7cfb1c2708,2022-04-18T00:00:00.000Z,IMPS-210810920620-DIGIOTECH SOLUTIONS-YE,,,net_banking_transfer,1.25
632ae6c22e1a0ebb7f46f366,50200023535069,362508.76,60ec41ba55c00300382672d9,HDFC,Revenue-PG-split enabled,5eecc6d6449e4f7cfb1c2708,2022-04-18T00:00:00.000Z,NEFT CR-UTIB0001506-RAZORPAY SOFTWARE PR IVATE LIMITED-SLICK ORGANICS PVT LITD-AX ISCN0131963520,insurance,insurance,net_banking_transfer,48308.54
632ae6c22e1a0ebb7f46f368,50200023535069,1128846.7,60ec41ba55c00300382672d9,HDFC,Revenue-Mktplace,5eecc6d6449e4f7cfb1c2708,2022-04-18T00:00:00.000Z,NEFT CR-DEUT0797BGL-AMAZON PAY (INDIA) P RIVATE LIMITED-SLICK ORGANICS PVT LTD-21 0800423GN01244,shopping,,net_banking_transfer,766337.94
632ae6c22e1a0ebb7f46f36a,50200023535069,1129048.59,60ec41ba55c00300382672d9,HDFC,Revenue-PG-non-split,5eecc6d6449e4f7cfb1c2708,2022-04-18T00:00:00.000Z,NEFT CR-YESB0000001-RZPX PVT LTD NODAL A CCOUNT-SLICKORGANICS-N108221145133026,insurance,insurance,net_banking_transfer,201.89
632ae6c22e1a0ebb7f46f36c,50200023535069,1365142.01,60ec41ba55c00300382672d9,HDFC,Revenue-Mktplace,5eecc6d6449e4f7cfb1c2708,2022-04-18T00:00:00.000Z,NEFT CR-HSBC0560002-AMAZON SELLER SERVIC ES PRIVATE LIMI-SLICK ORGANICS PVT L-HSB CN22108456736,shopping,,net_banking_transfer,236093.42
632ae6c22e1a0ebb7f46f36e,50200023535069,1365140.01,60ec41ba55c00300382672d9,HDFC,Marketing Expense,5eecc6d6449e4f7cfb1c2708,2022-04-18T00:00:00.000Z,ME DC SI 514834XXXXXX9486 LINKEDIN,,,Other,-2
632ae6c22e1a0ebb7f46f370,50200023535069,1389366.01,60ec41ba55c00300382672d9,HDFC,Revenue-Mktplace,5eecc6d6449e4f7cfb1c2708,2022-04-18T00:00:00.000Z,NEFT CR-SCBL0036001-M/S DREAMPLUG TECHNO -SLICK ORGANICS PRIVATE LIMITEDSLICK-SIN 31436Q0037326,insurance,insurance,net_banking_transfer,24226
632ae6c22e1a0ebb7f46f372,50200023535069,1379366.01,60ec41ba55c00300382672d9,HDFC,direct expenses,5eecc6d6449e4f7cfb1c2708,2022-04-18T00:00:00.000Z,"NEFT DR-SBIN0032160-KARISHMA NAVLANI-NET BANK, MUM-N108221921769748-10000",,,net_banking_transfer,-10000
632ae6c22e1a0ebb7f46f374,50200023535069,1375366.01,60ec41ba55c00300382672d9,HDFC,direct expenses,5eecc6d6449e4f7cfb1c2708,2022-04-18T00:00:00.000Z,"NEFT DR-ICIC0000058-MEHER KAUR CHEEMA-NE TBANK, MUM-N108221921789451-4000",,,net_banking_transfer,-4000
632ae6c22e1a0ebb7f46f376,50200023535069,1325366.01,60ec41ba55c00300382672d9,HDFC,direct expenses,5eecc6d6449e4f7cfb1c2708,2022-04-18T00:00:00.000Z,"NEFT DR-KKBK0000173-MATRIX PRINTING SOLU TIONS PRIVATE LIMITE-NETBANK, MUM-N10822 1921819716-50000",,,net_banking_transfer,-50000
632ae6c22e1a0ebb7f46f378,50200023535069,1319466.01,60ec41ba55c00300382672d9,HDFC,direct expenses,5eecc6d6449e4f7cfb1c2708,2022-04-18T00:00:00.000Z,50200056366495-TPT-5900-MJ ENTERPRISES,,,net_banking_transfer,-5900
632ae6c22e1a0ebb7f46f37a,50200023535069,1319464.01,60ec41ba55c00300382672d9,HDFC,Marketing Expense,5eecc6d6449e4f7cfb1c2708,2022-04-18T00:00:00.000Z,ME DC SI 514834XXXXXX9486 LINKEDIN,,,Other,-2
632ae6c22e1a0ebb7f46f37c,50200023535069,1342354.9,60ec41ba55c00300382672d9,HDFC,Revenue-PG-split enabled,5eecc6d6449e4f7cfb1c2708,2022-04-18T00:00:00.000Z,NEFT CR-UTIB0001506-RAZORPAY SOFTWARE PR IVATE LIMITED-SLICK ORGANICS PVT LITD-AX ISCN0132071827,insurance,insurance,net_banking_transfer,22890.89
632ae6c22e1a0ebb7f46f37f,50200023535069,1410148.9,60ec41ba55c00300382672d9,HDFC,Transfer in/Revenue-other,5eecc6d6449e4f7cfb1c2708,2022-04-18T00:00:00.000Z,NEFT CR-ICIC0SF0002-ENRICH HAIR - SKIN S,,,net_banking_transfer,67794
632ae6c22e1a0ebb7f46f381,50200023535069,1421066.52,60ec41ba55c00300382672d9,HDFC,Revenue-Mktplace,5eecc6d6449e4f7cfb1c2708,2022-04-18T00:00:00.000Z,NEFT CR-DEUT0797BGL-FLIPKART INTERNET PR IVATE LIMITED-SLICK ORGANICS PVT LTD-210 800931GN00091,shopping,,net_banking_transfer,10917.62
632ae6c22e1a0ebb7f46f383,50200023535069,1426947.04,60ec41ba55c00300382672d9,HDFC,Revenue-Mktplace,5eecc6d6449e4f7cfb1c2708,2022-04-18T00:00:00.000Z,NEFT CR-DEUT0797BGL-FLIPKART INTERNET PR IVATE LIMITED-SLICK ORGANICS PVT LTD-210 800954GN00140,shopping,,net_banking_transfer,5880.52
632ae6c22e1a0ebb7f46f385,50200023535069,1431152.13,60ec41ba55c00300382672d9,HDFC,Revenue-COD,5eecc6d6449e4f7cfb1c2708,2022-04-18T00:00:00.000Z,NEFT CR-ICIC0000155-SHIPROCKET COD CRF I D 4177467-SLICK ORGANICS PVT LTD-CMS2524 328423,insurance,insurance,net_banking_transfer,4205.09
632ae6c22e1a0ebb7f46f387,50200023535069,1464965.8,60ec41ba55c00300382672d9,HDFC,Revenue-UPI,5eecc6d6449e4f7cfb1c2708,2022-04-18T00:00:00.000Z,UPI-GOKWIK-GOKWIK@YESBANK-YESB0000340-21 0892893017-PAYOUT FOR APRIL 1,,,upi,33813.67
632ae6c22e1a0ebb7f46f389,50200023535069,1526953.61,60ec41ba55c00300382672d9,HDFC,Revenue-COD,5eecc6d6449e4f7cfb1c2708,2022-04-18T00:00:00.000Z,NEFT CR-ICIC0000155-SHIPROCKET COD CRF I D 4185659-SLICK ORGANICS PVT LTD-CMS2524 343510,insurance,insurance,net_banking_transfer,61987.81
632ae6c22e1a0ebb7f46f38b,50200023535069,1555235.75,60ec41ba55c00300382672d9,HDFC,Revenue-PG-non-split,5eecc6d6449e4f7cfb1c2708,2022-04-19T00:00:00.000Z,NEFT CR-PYTM0123456-PAYTM PAYMENTS SERVI CES LIMITED-SLICK ORGANICS PVT LTD-PYTM2 21095225133,insurance,insurance,net_banking_transfer,28282.14
632ae6c22e1a0ebb7f46f38d,50200023535069,1585843.96,60ec41ba55c00300382672d9,HDFC,Revenue-PG-split enabled,5eecc6d6449e4f7cfb1c2708,2022-04-19T00:00:00.000Z,NEFT CR-UTIB0001506-RAZORPAY SOFTWARE PR IVATE LIMITED-SLICK ORGANICS PVT LITD-AX ISCN0132134512,insurance,insurance,net_banking_transfer,30608.21
632ae6c22e1a0ebb7f46f38f,50200023535069,1629809.96,60ec41ba55c00300382672d9,HDFC,Investments-New,5eecc6d6449e4f7cfb1c2708,2022-04-19T00:00:00.000Z,50200017917813-TPT-ADVANCE-1908 E-VENTUR ES PRIVATE LIMITED,,,net_banking_transfer,43966
632ae6c22e1a0ebb7f46f391,50200023535069,1379809.96,60ec41ba55c00300382672d9,HDFC,direct expenses,5eecc6d6449e4f7cfb1c2708,2022-04-19T00:00:00.000Z,"NEFT DR-YESB0000551-VISTTA COSMETICS-NET BANK, MUM-N109221922661591-250000",,,net_banking_transfer,-250000
632ae6c22e1a0ebb7f46f393,50200023535069,1370371.14,60ec41ba55c00300382672d9,HDFC,direct expenses,5eecc6d6449e4f7cfb1c2708,2022-04-19T00:00:00.000Z,POS 514834XXXXXX9486 ONLINE PAYMENT,,,debit_card,-9438.82
632ae6c22e1a0ebb7f46f395,50200023535069,1360371.14,60ec41ba55c00300382672d9,HDFC,direct expenses,5eecc6d6449e4f7cfb1c2708,2022-04-19T00:00:00.000Z,JL8DPXZOSGGURW/RAZPSEZZLE,,,Other,-10000
632ae6c22e1a0ebb7f46f397,50200023535069,1105371.14,60ec41ba55c00300382672d9,HDFC,SAAS/tech expense,5eecc6d6449e4f7cfb1c2708,2022-04-19T00:00:00.000Z,POS 514834XXXXXX9486 AMAZON,shopping,,debit_card,-255000
632ae6c22e1a0ebb7f46f399,50200023535069,905371.14,60ec41ba55c00300382672d9,HDFC,direct expenses,5eecc6d6449e4f7cfb1c2708,2022-04-19T00:00:00.000Z,50200054531492-TPT-200000-ALETA PEOPLE S ERVICES,,,net_banking_transfer,-200000
632ae6c22e1a0ebb7f46f39b,50200023535069,890171.14,60ec41ba55c00300382672d9,HDFC,direct expenses,5eecc6d6449e4f7cfb1c2708,2022-04-19T00:00:00.000Z,NEFT DR-ICIC0006956-LAKSHAY CARRYING COR,,,net_banking_transfer,-15200
632ae6c22e1a0ebb7f46f39d,50200023535069,845461.14,60ec41ba55c00300382672d9,HDFC,SAAS/tech expense,5eecc6d6449e4f7cfb1c2708,2022-04-19T00:00:00.000Z,"NEFT DR-HSBC0560002-AMAZON SELLER SERVIC ES PVT LTD-NETBANK, MUM-N109221923001694 -44710",shopping,,net_banking_transfer,-44710
632ae6c22e1a0ebb7f46f39f,50200023535069,846690.39,60ec41ba55c00300382672d9,HDFC,Revenue-Mktplace,5eecc6d6449e4f7cfb1c2708,2022-04-19T00:00:00.000Z,NEFT CR-ICIC0000105-MANASH LIFESTYLE PRI VATE LIMITED NO-SLICK ORGANICS PRIVATE L IMITED MP M-ICIJ221090005843,shopping,,net_banking_transfer,1229.25
632ae6c22e1a0ebb7f46f3a2,50200023535069,846975.54,60ec41ba55c00300382672d9,HDFC,Revenue-Mktplace,5eecc6d6449e4f7cfb1c2708,2022-04-19T00:00:00.000Z,NEFT CR-ICIC0000105-MANASH LIFESTYLE PRI VATE LIMITED NO-SLICK ORGANICS PRIVATE L IMITED BANG-ICIJ221090005844,shopping,,net_banking_transfer,285.15
632ae6c22e1a0ebb7f46f3a4,50200023535069,887536.52,60ec41ba55c00300382672d9,HDFC,Transfer in/Revenue-other,5eecc6d6449e4f7cfb1c2708,2022-04-19T00:00:00.000Z,"IMPS-210917078909-GOKWIK COMMERCE SOLU-I CIC-XXXXXXXX0630-PAYOUT FOR APRIL 17, 20 22",,,net_banking_transfer,40560.98
632ae6c22e1a0ebb7f46f3a6,50200023535069,872278.26,60ec41ba55c00300382672d9,HDFC,direct expenses,5eecc6d6449e4f7cfb1c2708,2022-04-19T00:00:00.000Z,POS 514834XXXXXX9486 GUPSHUP INC,,,debit_card,-15258.26
632ae6c22e1a0ebb7f46f3a8,50200023535069,890114.96,60ec41ba55c00300382672d9,HDFC,Revenue-PG-split enabled,5eecc6d6449e4f7cfb1c2708,2022-04-19T00:00:00.000Z,NEFT CR-UTIB0001506-RAZORPAY SOFTWARE PR IVATE LIMITED-SLICK ORGANICS PVT LITD-AX ISCN0132256859,insurance,insurance,net_banking_transfer,17836.7
632ae6c22e1a0ebb7f46f3aa,50200023535069,894830.56,60ec41ba55c00300382672d9,HDFC,Revenue-Mktplace,5eecc6d6449e4f7cfb1c2708,2022-04-20T00:00:00.000Z,NEFT CR-DEUT0797BGL-FLIPKART INTERNET PR IVATE LIMITED-SLICK ORGANICS PVT LTD-211 000120GN00230,shopping,,net_banking_transfer,4715.6
632ae6c22e1a0ebb7f46f3ac,50200023535069,896469.07,60ec41ba55c00300382672d9,HDFC,Revenue-Mktplace,5eecc6d6449e4f7cfb1c2708,2022-04-20T00:00:00.000Z,NEFT CR-DEUT0797BGL-FLIPKART INTERNET PR IVATE LIMITED-SLICK ORGANICS PVT LTD-211 000148GN00005,shopping,,net_banking_transfer,1638.51
632ae6c22e1a0ebb7f46f3ae,50200023535069,923661.27,60ec41ba55c00300382672d9,HDFC,Revenue-PG-non-split,5eecc6d6449e4f7cfb1c2708,2022-04-20T00:00:00.000Z,NEFT CR-PYTM0123456-PAYTM PAYMENTS SERVI CES LIMITED-SLICK ORGANICS PVT LTD-PYTM2 21105746125,insurance,insurance,net_banking_transfer,27192.2
632ae6c22e1a0ebb7f46f3b0,50200023535069,929142.14,60ec41ba55c00300382672d9,HDFC,Revenue-Mktplace,5eecc6d6449e4f7cfb1c2708,2022-04-20T00:00:00.000Z,NEFT CR-DEUT0797BGL-MYNTRA DESIGNS PRIVA TE LIMITED-SLICK ORGANICS PVT. LTD.-2110 00563GN00048,shopping,,net_banking_transfer,5480.87
632ae6c22e1a0ebb7f46f3b2,50200023535069,939738.19,60ec41ba55c00300382672d9,HDFC,Revenue-Mktplace,5eecc6d6449e4f7cfb1c2708,2022-04-20T00:00:00.000Z,NEFT CR-DEUT0797BGL-MYNTRA DESIGNS PRIVA,shopping,,net_banking_transfer,10596.05
632ae6c22e1a0ebb7f46f3b4,50200023535069,934382.27,60ec41ba55c00300382672d9,HDFC,direct expenses,5eecc6d6449e4f7cfb1c2708,2022-04-20T00:00:00.000Z,POS 514834XXXXXX9486 ECOMENGINE* FEED,,,debit_card,-5355.92
632ae6c22e1a0ebb7f46f3b6,50200023535069,954333.83,60ec41ba55c00300382672d9,HDFC,Revenue-PG-split enabled,5eecc6d6449e4f7cfb1c2708,2022-04-20T00:00:00.000Z,NEFT CR-UTIB0001506-RAZORPAY SOFTWARE PR IVATE LIMITED-SLICK ORGANICS PVT LITD-AX ISCN0132339172,insurance,insurance,net_banking_transfer,19951.56
632ae6c22e1a0ebb7f46f3b8,50200023535069,954331.83,60ec41ba55c00300382672d9,HDFC,Marketing Expense,5eecc6d6449e4f7cfb1c2708,2022-04-20T00:00:00.000Z,POS 514834XXXXXX9486 LINKEDIN 7545961,,,debit_card,-2
632ae6c22e1a0ebb7f46f3bc,50200023535069,954333.83,60ec41ba55c00300382672d9,HDFC,Transfer in/Revenue-other,5eecc6d6449e4f7cfb1c2708,2022-04-20T00:00:00.000Z,POS 514834XXXXXX9486 LINKEDIN 7545961,,,debit_card,2
632ae6c22e1a0ebb7f46f3be,50200023535069,954331.83,60ec41ba55c00300382672d9,HDFC,Marketing Expense,5eecc6d6449e4f7cfb1c2708,2022-04-20T00:00:00.000Z,ME DC SI 514834XXXXXX9486 LINKEDIN,,,Other,-2
632ae6c22e1a0ebb7f46f3c0,50200023535069,934331.83,60ec41ba55c00300382672d9,HDFC,direct expenses,5eecc6d6449e4f7cfb1c2708,2022-04-20T00:00:00.000Z,"SARWAN KUMAR - CHQ PAID - KALKAJI, NEW",,,chq,-20000
632ae6c22e1a0ebb7f46f3c2,50200023535069,902374.83,60ec41ba55c00300382672d9,HDFC,direct expenses,5eecc6d6449e4f7cfb1c2708,2022-04-20T00:00:00.000Z,"NEFT DR-ICIC0006643-KRISHNA PACKAGING CO MPANY-NETBANK, MUM-N110221924375119-3195 7",,,net_banking_transfer,-31957
632ae6c22e1a0ebb7f46f3c4,50200023535069,743411.83,60ec41ba55c00300382672d9,HDFC,Tax,5eecc6d6449e4f7cfb1c2708,2022-04-20T00:00:00.000Z,GST/BANK REFERENCE NO: R2211034047446/CI N NO: HDFC22040700230245,,,Other,-158963
632ae6c22e1a0ebb7f46f3c7,50200023535069,698648,60ec41ba55c00300382672d9,HDFC,direct expenses,5eecc6d6449e4f7cfb1c2708,2022-04-20T00:00:00.000Z,POS 514834XXXXXX9486 THE ROCKET SCIEN,,,debit_card,-44763.83
632ae6c22e1a0ebb7f46f3c9,50200023535069,712347,60ec41ba55c00300382672d9,HDFC,Transfer in/Revenue-other,5eecc6d6449e4f7cfb1c2708,2022-04-20T00:00:00.000Z,50200050241205-TPT-ARATA-NAPSA PRIVATE L IMITED,,,net_banking_transfer,13699
632ae6c22e1a0ebb7f46f3cb,50200023535069,712629.94,60ec41ba55c00300382672d9,HDFC,Revenue-Mktplace,5eecc6d6449e4f7cfb1c2708,2022-04-20T00:00:00.000Z,NEFT CR-ICIC0000105-MANASH LIFESTYLE PRI VATE LIMITED NO-SLICK ORGANICS PRIVATE L IMITED BANG-ICIJ221100001152,shopping,,net_banking_transfer,282.94
632ae6c22e1a0ebb7f46f3cd,50200023535069,713272.77,60ec41ba55c00300382672d9,HDFC,Revenue-Mktplace,5eecc6d6449e4f7cfb1c2708,2022-04-20T00:00:00.000Z,NEFT CR-ICIC0000105-MANASH LIFESTYLE PRI VATE LIMITED NO-SLICK ORGANICS PRIVATE L IMITED MP M-ICIJ221100001150,shopping,,net_banking_transfer,642.83
632ae6c22e1a0ebb7f46f3cf,50200023535069,790986.95,60ec41ba55c00300382672d9,HDFC,Transfer in/Revenue-other,5eecc6d6449e4f7cfb1c2708,2022-04-20T00:00:00.000Z,"IMPS-211017455858-GOKWIK COMMERCE SOLU-I CIC-XXXXXXXX0630-PAYOUT FOR APRIL 18, 20 22",,,net_banking_transfer,77714.18
632ae6c22e1a0ebb7f46f3d1,50200023535069,799170.96,60ec41ba55c00300382672d9,HDFC,Revenue-PG-split enabled,5eecc6d6449e4f7cfb1c2708,2022-04-20T00:00:00.000Z,NEFT CR-UTIB0001506-RAZORPAY SOFTWARE PR IVATE LIMITED-SLICK ORGANICS PVT LITD-AX ISCN0132445579,insurance,insurance,net_banking_transfer,8184.01
632ae6c22e1a0ebb7f46f3d4,50200023535069,799168.96,60ec41ba55c00300382672d9,HDFC,Marketing Expense,5eecc6d6449e4f7cfb1c2708,2022-04-20T00:00:00.000Z,ME DC SI 514834XXXXXX9486 LINKEDIN,,,Other,-2
632ae6c22e1a0ebb7f46f3d6,50200023535069,881497.94,60ec41ba55c00300382672d9,HDFC,Revenue-COD,5eecc6d6449e4f7cfb1c2708,2022-04-20T00:00:00.000Z,NEFT CR-ICIC0000155-SHIPROCKET COD CRF I D 4198051-SLICK ORGANICS PVT LTD-CMS2530 063572,insurance,insurance,net_banking_transfer,82328.98
632ae6c22e1a0ebb7f46f3d8,50200023535069,742599.94,60ec41ba55c00300382672d9,HDFC,Tax,5eecc6d6449e4f7cfb1c2708,2022-04-20T00:00:00.000Z,GST/BANK REFERENCE NO: R2211034175566/CI N NO: HDFC22040700276941,,,Other,-138898
632ae6c32e1a0ebb7f46f3da,50200023535069,775495.27,60ec41ba55c00300382672d9,HDFC,Revenue-PG-non-split,5eecc6d6449e4f7cfb1c2708,2022-04-21T00:00:00.000Z,NEFT CR-PYTM0123456-PAYTM PAYMENTS SERVI CES LIMITED-SLICK ORGANICS PVT LTD-PYTM2 21116266172,insurance,insurance,net_banking_transfer,32895.33
632ae6c32e1a0ebb7f46f3dc,50200023535069,783533.03,60ec41ba55c00300382672d9,HDFC,Revenue-PG-split enabled,5eecc6d6449e4f7cfb1c2708,2022-04-21T00:00:00.000Z,NEFT CR-UTIB0001506-RAZORPAY SOFTWARE PR IVATE LIMITED-SLICK ORGANICS PVT LITD-AX ISCN0132527891,insurance,insurance,net_banking_transfer,8037.76
632ae6c32e1a0ebb7f46f3de,50200023535069,674491.03,60ec41ba55c00300382672d9,HDFC,direct expenses,5eecc6d6449e4f7cfb1c2708,2022-04-21T00:00:00.000Z,"NEFT DR-YESB0000162-VINAY REDDY-NETBANK, MUM-N111221925751091-109042",,,net_banking_transfer,-109042
632ae6c32e1a0ebb7f46f3e1,50200023535069,673047.03,60ec41ba55c00300382672d9,HDFC,direct expenses,5eecc6d6449e4f7cfb1c2708,2022-04-21T00:00:00.000Z,POS 514834XXXXXX9486 PAYU-HTTPS://STO,,,debit_card,-1444
632ae6c32e1a0ebb7f46f3e3,50200023535069,739850.61,60ec41ba55c00300382672d9,HDFC,Transfer in/Revenue-other,5eecc6d6449e4f7cfb1c2708,2022-04-21T00:00:00.000Z,"IMPS-211117737917-GOKWIK COMMERCE SOLU-I CIC-XXXXXXXX0630-PAYOUT FOR APRIL 19, 20 22",,,net_banking_transfer,66803.58
632ae6c32e1a0ebb7f46f3e5,50200023535069,752468.03,60ec41ba55c00300382672d9,HDFC,Revenue-PG-split enabled,5eecc6d6449e4f7cfb1c2708,2022-04-21T00:00:00.000Z,NEFT CR-UTIB0001506-RAZORPAY SOFTWARE PR IVATE LIMITED-SLICK ORGANICS PVT LITD-AX ISCN0132623729,insurance,insurance,net_banking_transfer,12617.42
632ae6c32e1a0ebb7f46f3e7,50200023535069,1007468.03,60ec41ba55c00300382672d9,HDFC,Revenue-Mktplace,5eecc6d6449e4f7cfb1c2708,2022-04-21T00:00:00.000Z,REF-BILLDKAMAZON-WHDF0271927104-15-09-20,shopping,,refund,255000
632ae6c32e1a0ebb7f46f3e9,50200023535069,1012393,60ec41ba55c00300382672d9,HDFC,Revenue-Mktplace,5eecc6d6449e4f7cfb1c2708,2022-04-22T00:00:00.000Z,NEFT CR-DEUT0797BGL-FLIPKART INTERNET PR IVATE LIMITED-SLICK ORGANICS PVT LTD-211 200136GN00061,shopping,,net_banking_transfer,4924.97
632ae6c32e1a0ebb7f46f3eb,50200023535069,1028113.93,60ec41ba55c00300382672d9,HDFC,Revenue-PG-non-split,5eecc6d6449e4f7cfb1c2708,2022-04-22T00:00:00.000Z,IMPS-211205027735-PAYTM PAYMENTS SERVI-P YTM-XXXXXXXXXX0008-ALL202204222168200003 30830668628,ewallet,,net_banking_transfer,15720.93
632ae6c32e1a0ebb7f46f3ed,50200023535069,773113.93,60ec41ba55c00300382672d9,HDFC,SAAS/tech expense,5eecc6d6449e4f7cfb1c2708,2022-04-22T00:00:00.000Z,POS 514834XXXXXX9486 AMAZON,shopping,,debit_card,-255000
632ae6c32e1a0ebb7f46f3ef,50200023535069,777177.02,60ec41ba55c00300382672d9,HDFC,Revenue-Mktplace,5eecc6d6449e4f7cfb1c2708,2022-04-22T00:00:00.000Z,NEFT CR-DEUT0797BGL-MYNTRA DESIGNS PRIVA TE LIMITED-SLICK ORGANICS PVT. LTD.-2112 00563GN00045,shopping,,net_banking_transfer,4063.09
632ae6c32e1a0ebb7f46f3f1,50200023535069,787066.69,60ec41ba55c00300382672d9,HDFC,Revenue-Mktplace,5eecc6d6449e4f7cfb1c2708,2022-04-22T00:00:00.000Z,NEFT CR-DEUT0797BGL-MYNTRA DESIGNS PRIVA,shopping,,net_banking_transfer,9889.67
632ae6c32e1a0ebb7f46f3f3,50200023535069,799147.11,60ec41ba55c00300382672d9,HDFC,Revenue-PG-split enabled,5eecc6d6449e4f7cfb1c2708,2022-04-22T00:00:00.000Z,NEFT CR-UTIB0001506-RAZORPAY SOFTWARE PR IVATE LIMITED-SLICK ORGANICS PVT LITD-AX ISCN0132692676,insurance,insurance,net_banking_transfer,12080.42
632ae6c32e1a0ebb7f46f3f5,50200023535069,1799147.11,60ec41ba55c00300382672d9,HDFC,Internal Transfers,5eecc6d6449e4f7cfb1c2708,2022-04-22T00:00:00.000Z,IB FUNDS TRANSFER CR-50200035187206 -SL ICK ORGANICS PVT LTD,insurance,insurance,Other,1000000
632ae6c32e1a0ebb7f46f3f7,50200023535069,188424.11,60ec41ba55c00300382672d9,HDFC,Marketing Expense,5eecc6d6449e4f7cfb1c2708,2022-04-22T00:00:00.000Z,"NEFT DR-CITI0000006-FACEBOOK INDIA ONLIN E SERVICES PVT LTD-NETBANK, MUM-N1122219 26997523-1610723",,,net_banking_transfer,-1610723
632ae6c32e1a0ebb7f46f3f9,50200023535069,688424.11,60ec41ba55c00300382672d9,HDFC,Internal Transfers,5eecc6d6449e4f7cfb1c2708,2022-04-22T00:00:00.000Z,IB FUNDS TRANSFER CR-50200035187206 -SL ICK ORGANICS PVT LTD,insurance,insurance,Other,500000
632ae6c32e1a0ebb7f46f3fb,50200023535069,688928.4,60ec41ba55c00300382672d9,HDFC,Revenue-Mktplace,5eecc6d6449e4f7cfb1c2708,2022-04-22T00:00:00.000Z,NEFT CR-ICIC0000105-MANASH LIFESTYLE PRI VATE LIMITED NO-SLICK ORGANICS PRIVATE L IMITED MP M-ICIJ221120002704,shopping,,net_banking_transfer,504.29
632ae6c32e1a0ebb7f46f3fd,50200023535069,688926.4,60ec41ba55c00300382672d9,HDFC,Marketing Expense,5eecc6d6449e4f7cfb1c2708,2022-04-22T00:00:00.000Z,POS 514834XXXXXX9486 LINKEDIN,,,debit_card,-2
632ae6c32e1a0ebb7f46f3ff,50200023535069,696829.4,60ec41ba55c00300382672d9,HDFC,Revenue-PG-non-split,5eecc6d6449e4f7cfb1c2708,2022-04-22T00:00:00.000Z,NEFT CR-IDFB0010204-SEZZLE PAYMENTS PRIV ATE LIMITED-SLICK ORGANICS PRIVATE LIMIT ED-IDFBH22112832954,insurance,insurance,net_banking_transfer,7903
632ae6c32e1a0ebb7f46f401,50200023535069,759690.37,60ec41ba55c00300382672d9,HDFC,Transfer in/Revenue-other,5eecc6d6449e4f7cfb1c2708,2022-04-22T00:00:00.000Z,"IMPS-211217853373-GOKWIK COMMERCE SOLU-I CIC-XXXXXXXX0630-PAYOUT FOR APRIL 20, 20 22",,,net_banking_transfer,62860.97
632ae6c32e1a0ebb7f46f403,50200023535069,787031.57,60ec41ba55c00300382672d9,HDFC,Revenue-PG-split enabled,5eecc6d6449e4f7cfb1c2708,2022-04-22T00:00:00.000Z,NEFT CR-UTIB0001506-RAZORPAY SOFTWARE PR IVATE LIMITED-SLICK ORGANICS PVT LITD-AX ISCN0132792835,insurance,insurance,net_banking_transfer,27341.2
632ae6c32e1a0ebb7f46f406,50200023535069,788118.57,60ec41ba55c00300382672d9,HDFC,Transfer in/Revenue-other,5eecc6d6449e4f7cfb1c2708,2022-04-22T00:00:00.000Z,57500000644820-SLICK ORGANICS,insurance,insurance,Other,1087
632ae6c32e1a0ebb7f46f408,50200023535069,873075.39,60ec41ba55c00300382672d9,HDFC,Revenue-PG-non-split,5eecc6d6449e4f7cfb1c2708,2022-04-23T00:00:00.000Z,NEFT CR-PYTM0123456-PAYTM PAYMENTS SERVI CES LIMITED-SLICK ORGANICS PVT LTD-PYTM2 21137216838,insurance,insurance,net_banking_transfer,84956.82
632ae6c32e1a0ebb7f46f40a,50200023535069,673075.39,60ec41ba55c00300382672d9,HDFC,direct expenses,5eecc6d6449e4f7cfb1c2708,2022-04-23T00:00:00.000Z,"NEFT DR-ICIC0000369-BO INTERNATIONAL-NET BANK, MUM-N113221928615730-200000",,,net_banking_transfer,-200000
632ae6c32e1a0ebb7f46f40c,50200023535069,736855.74,60ec41ba55c00300382672d9,HDFC,Transfer in/Revenue-other,5eecc6d6449e4f7cfb1c2708,2022-04-23T00:00:00.000Z,IMPS-211317156305-GOKWIK COMMERCE SOLU-I,,,net_banking_transfer,63780.35
632ae6c32e1a0ebb7f46f40f,50200023535069,736857.74,60ec41ba55c00300382672d9,HDFC,Transfer in/Revenue-other,5eecc6d6449e4f7cfb1c2708,2022-04-23T00:00:00.000Z,CRV POS-514834******9486-0421-LINKEDIN,,,refund,2
632ae6c32e1a0ebb7f46f411,50200023535069,736859.74,60ec41ba55c00300382672d9,HDFC,Transfer in/Revenue-other,5eecc6d6449e4f7cfb1c2708,2022-04-23T00:00:00.000Z,CRV POS-514834******9486-0421-LINKEDIN,,,refund,2
632ae6c32e1a0ebb7f46f413,50200023535069,779394.51,60ec41ba55c00300382672d9,HDFC,Revenue-PG-non-split,5eecc6d6449e4f7cfb1c2708,2022-04-24T00:00:00.000Z,NEFT CR-PYTM0123456-PAYTM PAYMENTS SERVI CES LIMITED-SLICK ORGANICS PVT LTD-PYTM2 21147651650,insurance,insurance,net_banking_transfer,42534.77
632ae6c32e1a0ebb7f46f415,50200023535069,524394.51,60ec41ba55c00300382672d9,HDFC,SAAS/tech expense,5eecc6d6449e4f7cfb1c2708,2022-04-24T00:00:00.000Z,POS 514834XXXXXX9486 AMAZON,shopping,,debit_card,-255000
632ae6c32e1a0ebb7f46f417,50200023535069,672535.08,60ec41ba55c00300382672d9,HDFC,Transfer in/Revenue-other,5eecc6d6449e4f7cfb1c2708,2022-04-24T00:00:00.000Z,"IMPS-211417987211-GOKWIK COMMERCE SOLU-I CIC-XXXXXXXX0630-PAYOUT FOR APRIL 22, 20 22",,,net_banking_transfer,148140.57
632ae6c32e1a0ebb7f46f419,50200023535069,677571.25,60ec41ba55c00300382672d9,HDFC,Revenue-Mktplace,5eecc6d6449e4f7cfb1c2708,2022-04-25T00:00:00.000Z,NEFT CR-DEUT0797BGL-FLIPKART INTERNET PR IVATE LIMITED-SLICK ORGANICS PVT LTD-211 500082GN00261,shopping,,net_banking_transfer,5036.17
632ae6c32e1a0ebb7f46f41b,50200023535069,705494.69,60ec41ba55c00300382672d9,HDFC,Revenue-PG-non-split,5eecc6d6449e4f7cfb1c2708,2022-04-25T00:00:00.000Z,NEFT CR-PYTM0123456-PAYTM PAYMENTS SERVI CES LIMITED-SLICK ORGANICS PVT LTD-PYTM2 21158055875,insurance,insurance,net_banking_transfer,27923.44
632ae6c32e1a0ebb7f46f41d,50200023535069,710331.9,60ec41ba55c00300382672d9,HDFC,Revenue-Mktplace,5eecc6d6449e4f7cfb1c2708,2022-04-25T00:00:00.000Z,NEFT CR-DEUT0797BGL-MYNTRA DESIGNS PRIVA TE LIMITED-SLICK ORGANICS PVT. LTD.-2115 00289GN00120,shopping,,net_banking_transfer,4837.21
632ae6c32e1a0ebb7f46f41f,50200023535069,720498.5,60ec41ba55c00300382672d9,HDFC,Revenue-Mktplace,5eecc6d6449e4f7cfb1c2708,2022-04-25T00:00:00.000Z,NEFT CR-DEUT0797BGL-MYNTRA DESIGNS PRIVA TE LIMITED-SLICK ORGANICS PVT. LTD.-2115 00288GN00169,shopping,,net_banking_transfer,10166.6
632ae6c32e1a0ebb7f46f421,50200023535069,834077.28,60ec41ba55c00300382672d9,HDFC,Revenue-PG-split enabled,5eecc6d6449e4f7cfb1c2708,2022-04-25T00:00:00.000Z,NEFT CR-UTIB0001506-RAZORPAY SOFTWARE PR IVATE LIMITED-SLICK ORGANICS PVT LITD-AX ISCN0132947451,insurance,insurance,net_banking_transfer,113578.78
632ae6c32e1a0ebb7f46f423,50200023535069,1538834,60ec41ba55c00300382672d9,HDFC,Revenue-Mktplace,5eecc6d6449e4f7cfb1c2708,2022-04-25T00:00:00.000Z,NEFT CR-DEUT0797BGL-AMAZON PAY (INDIA) P RIVATE LIMITED-SLICK ORGANICS PVT LTD-21 1500593GN00394,shopping,,net_banking_transfer,704756.72
632ae6c32e1a0ebb7f46f426,50200023535069,1782569.63,60ec41ba55c00300382672d9,HDFC,Revenue-Mktplace,5eecc6d6449e4f7cfb1c2708,2022-04-25T00:00:00.000Z,NEFT CR-HSBC0560002-AMAZON SELLER SERVIC,shopping,,net_banking_transfer,243735.63
632ae6c32e1a0ebb7f46f429,50200023535069,1772569.63,60ec41ba55c00300382672d9,HDFC,Refund,5eecc6d6449e4f7cfb1c2708,2022-04-25T00:00:00.000Z,"NEFT DR-YESB0CMSNOC-RAZORPAY REFUND CRED ITS TOPUP-NETBANK, MUM-N115221930194598- 10000",,,net_banking_transfer,-10000
632ae6c32e1a0ebb7f46f42b,50200023535069,1673569.63,60ec41ba55c00300382672d9,HDFC,direct expenses,5eecc6d6449e4f7cfb1c2708,2022-04-25T00:00:00.000Z,"NEFT DR-UTIB0001964-BLUE BELLS EVENTS AN D PROMOTIONS-NETBANK, MUM-N1152219302105 34-99000",,,net_banking_transfer,-99000
632ae6c32e1a0ebb7f46f42d,50200023535069,1683569.63,60ec41ba55c00300382672d9,HDFC,Revenue-PG-split enabled,5eecc6d6449e4f7cfb1c2708,2022-04-25T00:00:00.000Z,IMPS-211517059676-RAZORPAYSOFTWAREPR-UTI B-XXXXXXXXXXX6002-RAZORPAYREFUN115221930 194598,,,net_banking_transfer,10000
632ae6c32e1a0ebb7f46f42f,50200023535069,1749330.09,60ec41ba55c00300382672d9,HDFC,Transfer in/Revenue-other,5eecc6d6449e4f7cfb1c2708,2022-04-25T00:00:00.000Z,"IMPS-211517229746-GOKWIK COMMERCE SOLU-I CIC-XXXXXXXX0630-PAYOUT FOR APRIL 23, 20 22",,,net_banking_transfer,65760.46
632ae6c32e1a0ebb7f46f431,50200023535069,1759490.41,60ec41ba55c00300382672d9,HDFC,Revenue-PG-split enabled,5eecc6d6449e4f7cfb1c2708,2022-04-25T00:00:00.000Z,NEFT CR-UTIB0001506-RAZORPAY SOFTWARE PR IVATE LIMITED-SLICK ORGANICS PVT LITD-AX ISCN0133079405,insurance,insurance,net_banking_transfer,10160.32
632ae6c32e1a0ebb7f46f433,50200023535069,1766711.41,60ec41ba55c00300382672d9,HDFC,Transfer in/Revenue-other,5eecc6d6449e4f7cfb1c2708,2022-04-25T00:00:00.000Z,NEFT CR-HSBC0560002-INNOVATIVE RETAIL CO NCEPTS PRIVATE-SLICK ORGANICS PVT LTD-HS BCN22115719929,,,net_banking_transfer,7221
632ae6c32e1a0ebb7f46f435,50200023535069,1775080.41,60ec41ba55c00300382672d9,HDFC,Transfer in/Revenue-other,5eecc6d6449e4f7cfb1c2708,2022-04-25T00:00:00.000Z,NEFT CR-HSBC0560002-INNOVATIVE RETAIL CO NCEPTS PRIVATE-SLICK ORGANICS PVT LTD-HS BCN22115720238,,,net_banking_transfer,8369
632ae6c32e1a0ebb7f46f437,50200023535069,1675080.41,60ec41ba55c00300382672d9,HDFC,direct expenses,5eecc6d6449e4f7cfb1c2708,2022-04-25T00:00:00.000Z,"NEFT DR-INDB0000148-ACQUISORY INDIA CONS ULTING PVT LTD-NETBANK, MUM-N11522193059 8919-100000",,,net_banking_transfer,-100000
632ae6c32e1a0ebb7f46f439,50200023535069,1375080.41,60ec41ba55c00300382672d9,HDFC,direct expenses,5eecc6d6449e4f7cfb1c2708,2022-04-25T00:00:00.000Z,"NEFT DR-ICIC0000369-BO INTERNATIONAL-NET BANK, MUM-N115221930614610-300000",,,net_banking_transfer,-300000
632ae6c32e1a0ebb7f46f43b,50200023535069,1225080.41,60ec41ba55c00300382672d9,HDFC,direct expenses,5eecc6d6449e4f7cfb1c2708,2022-04-25T00:00:00.000Z,"NEFT DR-SCBL0036046-INDOLEADS TECHNOLOGI ES P LTD-NETBANK, MUM-N115221930635852-1 50000",,,net_banking_transfer,-150000
632ae6c32e1a0ebb7f46f43d,50200023535069,1225451.31,60ec41ba55c00300382672d9,HDFC,Revenue-Mktplace,5eecc6d6449e4f7cfb1c2708,2022-04-25T00:00:00.000Z,NEFT CR-ICIC0000105-MANASH LIFESTYLE PRI,shopping,,net_banking_transfer,370.9
632ae6c32e1a0ebb7f46f43f,50200023535069,1226010.58,60ec41ba55c00300382672d9,HDFC,Revenue-Mktplace,5eecc6d6449e4f7cfb1c2708,2022-04-25T00:00:00.000Z,NEFT CR-ICIC0000105-MANASH LIFESTYLE PRI VATE LIMITED NO-SLICK ORGANICS PRIVATE L IMITED BANG-ICIJ221150007814,shopping,,net_banking_transfer,559.27
632ae6c32e1a0ebb7f46f441,50200023535069,1297780.25,60ec41ba55c00300382672d9,HDFC,Revenue-COD,5eecc6d6449e4f7cfb1c2708,2022-04-25T00:00:00.000Z,NEFT CR-ICIC0000155-SHIPROCKET COD CRF I D 4226699-SLICK ORGANICS PVT LTD-CMS2540 308546,insurance,insurance,net_banking_transfer,71769.67
632ae6c32e1a0ebb7f46f443,50200023535069,1297782.25,60ec41ba55c00300382672d9,HDFC,Transfer in/Revenue-other,5eecc6d6449e4f7cfb1c2708,2022-04-25T00:00:00.000Z,CRV POS 514834******9486 LINKEDIN,,,refund,2
632ae6c32e1a0ebb7f46f445,50200023535069,1297784.25,60ec41ba55c00300382672d9,HDFC,Transfer in/Revenue-other,5eecc6d6449e4f7cfb1c2708,2022-04-25T00:00:00.000Z,CRV POS 514834******9486 LINKEDIN,,,refund,2
632ae6c32e1a0ebb7f46f448,50200023535069,1323204.94,60ec41ba55c00300382672d9,HDFC,Revenue-PG-non-split,5eecc6d6449e4f7cfb1c2708,2022-04-26T00:00:00.000Z,NEFT CR-PYTM0123456-PAYTM PAYMENTS SERVI CES LIMITED-SLICK ORGANICS PVT LTD-PYTM2 21168524007,insurance,insurance,net_banking_transfer,25420.69
632ae6c32e1a0ebb7f46f44a,50200023535069,1273204.94,60ec41ba55c00300382672d9,HDFC,direct expenses,5eecc6d6449e4f7cfb1c2708,2022-04-26T00:00:00.000Z,"NEFT DR-CNRB0000349-USHA ENGINEERING WOR KS-NETBANK, MUM-N116221930994965-50000",,,net_banking_transfer,-50000
632ae6c32e1a0ebb7f46f44c,50200023535069,1018204.94,60ec41ba55c00300382672d9,HDFC,SAAS/tech expense,5eecc6d6449e4f7cfb1c2708,2022-04-26T00:00:00.000Z,POS 514834XXXXXX9486 AMAZON,shopping,,debit_card,-255000
632ae6c32e1a0ebb7f46f44e,50200023535069,1012451.94,60ec41ba55c00300382672d9,HDFC,direct expenses,5eecc6d6449e4f7cfb1c2708,2022-04-26T00:00:00.000Z,"NEFT DR-SCBL0036031-PR PUNDIT PUBLIC REL ATIONS PRIVATE LIMIT-NETBANK, MUM-N11622 1931018642-5753",insurance,insurance,net_banking_transfer,-5753
632ae6c32e1a0ebb7f46f450,50200023535069,989951.94,60ec41ba55c00300382672d9,HDFC,direct expenses,5eecc6d6449e4f7cfb1c2708,2022-04-26T00:00:00.000Z,"NEFT DR-ICIC0004328-MICHELLE MANUEL-NETB ANK, MUM-N116221931030854-22500",,,net_banking_transfer,-22500
632ae6c32e1a0ebb7f46f452,50200023535069,917951.94,60ec41ba55c00300382672d9,HDFC,direct expenses,5eecc6d6449e4f7cfb1c2708,2022-04-26T00:00:00.000Z,"NEFT DR-KKBK0000664-SHRADDHA DINESH SHU KLA-NETBANK, MUM-N116221931021121-72000",,,net_banking_transfer,-72000
632ae6c32e1a0ebb7f46f454,50200023535069,902951.94,60ec41ba55c00300382672d9,HDFC,direct expenses,5eecc6d6449e4f7cfb1c2708,2022-04-26T00:00:00.000Z,50100167600761-TPT-15000-RITU SINGH,,,net_banking_transfer,-15000
632ae6c32e1a0ebb7f46f456,50200023535069,877864.94,60ec41ba55c00300382672d9,HDFC,direct expenses,5eecc6d6449e4f7cfb1c2708,2022-04-26T00:00:00.000Z,POS 514834XXXXXX9486 PAYU-HTTPS://STO,,,debit_card,-25087
632ae6c32e1a0ebb7f46f458,50200023535069,894548.56,60ec41ba55c00300382672d9,HDFC,Revenue-PG-split enabled,5eecc6d6449e4f7cfb1c2708,2022-04-26T00:00:00.000Z,NEFT CR-UTIB0001506-RAZORPAY SOFTWARE PR IVATE LIMITED-SLICK ORGANICS PVT LITD-AX ISCN0133247186,insurance,insurance,net_banking_transfer,16683.62
632ae6c32e1a0ebb7f46f45a,50200023535069,892961.5,60ec41ba55c00300382672d9,HDFC,bank charges,5eecc6d6449e4f7cfb1c2708,2022-04-26T00:00:00.000Z,.DC INTL POS TXN MARKUP+ST 180322 190322 -CDT2211508766690,,,international_transaction_arbitrage,-1587.06
632ae6c32e1a0ebb7f46f45c,50200023535069,892741.24,60ec41ba55c00300382672d9,HDFC,bank charges,5eecc6d6449e4f7cfb1c2708,2022-04-26T00:00:00.000Z,.DC INTL POS TXN MARKUP+ST 200322 220322 -CDT2211508766690,,,international_transaction_arbitrage,-220.26
632ae6c32e1a0ebb7f46f45e,50200023535069,922151.82,60ec41ba55c00300382672d9,HDFC,Revenue-Mktplace,5eecc6d6449e4f7cfb1c2708,2022-04-26T00:00:00.000Z,NEFT CR-HSBC0400002-AMAZON SERVICES LLC-,shopping,,net_banking_transfer,29410.58
632ae6c32e1a0ebb7f46f460,50200023535069,500280.14,60ec41ba55c00300382672d9,HDFC,direct expenses,5eecc6d6449e4f7cfb1c2708,2022-04-26T00:00:00.000Z,FCY OUTWARD REMITTANCE,,,Other,-421871.68
632ae6c32e1a0ebb7f46f462,50200023535069,498702.43,60ec41ba55c00300382672d9,HDFC,bank charges,5eecc6d6449e4f7cfb1c2708,2022-04-26T00:00:00.000Z,.DC INTL POS TXN MARKUP+ST 230322 240322 -CDT2211508766690,,,international_transaction_arbitrage,-1577.71
632ae6c32e1a0ebb7f46f465,50200023535069,482573.8,60ec41ba55c00300382672d9,HDFC,direct expenses,5eecc6d6449e4f7cfb1c2708,2022-04-26T00:00:00.000Z,POS 514834XXXXXX9486 DOCUSIGN,,,debit_card,-16128.63
632ae6c32e1a0ebb7f46f468,50200023535069,547344.82,60ec41ba55c00300382672d9,HDFC,Transfer in/Revenue-other,5eecc6d6449e4f7cfb1c2708,2022-04-26T00:00:00.000Z,"IMPS-211617376544-GOKWIK COMMERCE SOLU-I CIC-XXXXXXXX0630-PAYOUT FOR APRIL 24, 20 22",,,net_banking_transfer,64771.02
632ae6c32e1a0ebb7f46f46a,50200023535069,571618.82,60ec41ba55c00300382672d9,HDFC,Revenue-Mktplace,5eecc6d6449e4f7cfb1c2708,2022-04-26T00:00:00.000Z,NEFT CR-SCBL0036001-M/S DREAMPLUG TECHNO -SLICK ORGANICS PRIVATE LIMITEDSLICK-SIN 31436Q0038118,insurance,insurance,net_banking_transfer,24274
632ae6c32e1a0ebb7f46f46c,50200023535069,605642.81,60ec41ba55c00300382672d9,HDFC,Revenue-PG-split enabled,5eecc6d6449e4f7cfb1c2708,2022-04-26T00:00:00.000Z,NEFT CR-UTIB0001506-RAZORPAY SOFTWARE PR IVATE LIMITED-SLICK ORGANICS PVT LITD-AX ISCN0133362083,insurance,insurance,net_banking_transfer,34023.99
632ae6c32e1a0ebb7f46f46e,50200023535069,606956.39,60ec41ba55c00300382672d9,HDFC,Revenue-Mktplace,5eecc6d6449e4f7cfb1c2708,2022-04-26T00:00:00.000Z,NEFT CR-ICIC0000105-MANASH LIFESTYLE PRI VATE LIMITED NO-SLICK ORGANICS PRIVATE L IMITED MP G-ICIJ221160008484,shopping,,net_banking_transfer,1313.58
632ae6c32e1a0ebb7f46f470,50200023535069,611645.26,60ec41ba55c00300382672d9,HDFC,Revenue-UPI,5eecc6d6449e4f7cfb1c2708,2022-04-26T00:00:00.000Z,UPI-GOKWIK-GOKWIK@YESBANK-YESB0000340-21 1607087054-PAYOUT FOR APRIL 2,,,upi,4688.87
632ae6c32e1a0ebb7f46f472,50200023535069,614366.79,60ec41ba55c00300382672d9,HDFC,Revenue-Mktplace,5eecc6d6449e4f7cfb1c2708,2022-04-27T00:00:00.000Z,NEFT CR-DEUT0797BGL-FLIPKART INTERNET PR IVATE LIMITED-SLICK ORGANICS PVT LTD-211 700088GN00109,shopping,,net_banking_transfer,2721.53
632ae6c32e1a0ebb7f46f474,50200023535069,691238.92,60ec41ba55c00300382672d9,HDFC,Revenue-PG-non-split,5eecc6d6449e4f7cfb1c2708,2022-04-27T00:00:00.000Z,NEFT CR-PYTM0123456-PAYTM PAYMENTS SERVI CES LIMITED-SLICK ORGANICS PVT LTD-PYTM2 21178982238,insurance,insurance,net_banking_transfer,76872.13
632ae6c32e1a0ebb7f46f476,50200023535069,635038.92,60ec41ba55c00300382672d9,HDFC,direct expenses,5eecc6d6449e4f7cfb1c2708,2022-04-27T00:00:00.000Z,"NEFT DR-KKBK0000173-MATRIX PRINTING SOLU TIONS PRIVATE LIMITE-NETBANK, MUM-N11722 1932475325-56200",,,net_banking_transfer,-56200
632ae6c32e1a0ebb7f46f478,50200023535069,609267.92,60ec41ba55c00300382672d9,HDFC,direct expenses,5eecc6d6449e4f7cfb1c2708,2022-04-27T00:00:00.000Z,50200043297657-TPT-25771-AIDC PRODUCTS I NDIA PRIVATE LIMITED,,,net_banking_transfer,-25771
632ae6c32e1a0ebb7f46f47a,50200023535069,549267.92,60ec41ba55c00300382672d9,HDFC,direct expenses,5eecc6d6449e4f7cfb1c2708,2022-04-27T00:00:00.000Z,NEFT DR-KKBK0000180-VIMAL PLASTICS-NETBA,,,net_banking_transfer,-60000
632ae6c32e1a0ebb7f46f47c,50200023535069,555795.51,60ec41ba55c00300382672d9,HDFC,Revenue-Mktplace,5eecc6d6449e4f7cfb1c2708,2022-04-27T00:00:00.000Z,NEFT CR-DEUT0797BGL-MYNTRA DESIGNS PRIVA TE LIMITED-SLICK ORGANICS PVT. LTD.-2117 00588GN00168,shopping,,net_banking_transfer,6527.59
632ae6c32e1a0ebb7f46f47e,50200023535069,628395.81,60ec41ba55c00300382672d9,HDFC,Revenue-PG-split enabled,5eecc6d6449e4f7cfb1c2708,2022-04-27T00:00:00.000Z,NEFT CR-UTIB0001506-RAZORPAY SOFTWARE PR IVATE LIMITED-SLICK ORGANICS PVT LITD-AX ISCN0133433630,insurance,insurance,net_banking_transfer,72600.3
632ae6c42e1a0ebb7f46f481,50200023535069,1128395.81,60ec41ba55c00300382672d9,HDFC,Internal Transfers,5eecc6d6449e4f7cfb1c2708,2022-04-27T00:00:00.000Z,IB FUNDS TRANSFER CR-50200035187206 -SL ICK ORGANICS PVT LTD,insurance,insurance,Other,500000
632ae6c42e1a0ebb7f46f483,50200023535069,153502.81,60ec41ba55c00300382672d9,HDFC,Marketing Expense,5eecc6d6449e4f7cfb1c2708,2022-04-27T00:00:00.000Z,"NEFT DR-CITI0100000-GOOGLE INDIA PVT LTD -NETBANK, MUM-N117221932612648-974893",,,net_banking_transfer,-974893
632ae6c42e1a0ebb7f46f485,50200023535069,139342.81,60ec41ba55c00300382672d9,HDFC,direct expenses,5eecc6d6449e4f7cfb1c2708,2022-04-27T00:00:00.000Z,POS 514834XXXXXX9486 CAS*INSTASPACES,,,debit_card,-14160
632ae6c42e1a0ebb7f46f489,50200023535069,125182.81,60ec41ba55c00300382672d9,HDFC,direct expenses,5eecc6d6449e4f7cfb1c2708,2022-04-27T00:00:00.000Z,POS 514834XXXXXX9486 CAS*INSTASPACES,,,debit_card,-14160
632ae6c42e1a0ebb7f46f48b,50200023535069,115182.81,60ec41ba55c00300382672d9,HDFC,Refund,5eecc6d6449e4f7cfb1c2708,2022-04-27T00:00:00.000Z,"NEFT DR-YESB0CMSNOC-RAZORPAY REFUND CRED ITS TOPUP-NETBANK, MUM-N117221932786428- 10000",,,net_banking_transfer,-10000
632ae6c42e1a0ebb7f46f48d,50200023535069,125182.81,60ec41ba55c00300382672d9,HDFC,Revenue-PG-split enabled,5eecc6d6449e4f7cfb1c2708,2022-04-27T00:00:00.000Z,IMPS-211713518089-RAZORPAYSOFTWAREPR-UTI B-XXXXXXXXXXX6002-RAZORPAYREFUN117221932 786428,,,net_banking_transfer,10000
632ae6c42e1a0ebb7f46f48f,50200023535069,180348.65,60ec41ba55c00300382672d9,HDFC,Transfer in/Revenue-other,5eecc6d6449e4f7cfb1c2708,2022-04-27T00:00:00.000Z,"IMPS-211717629134-GOKWIK COMMERCE SOLU-I CIC-XXXXXXXX0630-PAYOUT FOR APRIL 25, 20 22",,,net_banking_transfer,55165.84
632ae6c42e1a0ebb7f46f491,50200023535069,180622.79,60ec41ba55c00300382672d9,HDFC,Revenue-Mktplace,5eecc6d6449e4f7cfb1c2708,2022-04-27T00:00:00.000Z,NEFT CR-ICIC0000105-MANASH LIFESTYLE PRI VATE LIMITED NO-SLICK ORGANICS PRIVATE L IMITED MP M-ICIJ221170009938,shopping,,net_banking_transfer,274.14
632ae6c42e1a0ebb7f46f493,50200023535069,180759.87,60ec41ba55c00300382672d9,HDFC,Revenue-Mktplace,5eecc6d6449e4f7cfb1c2708,2022-04-27T00:00:00.000Z,NEFT CR-ICIC0000105-MANASH LIFESTYLE PRI VATE LIMITED NO-SLICK ORGANICS PRIVATE L IMITED BANG-ICIJ221170009939,shopping,,net_banking_transfer,137.08
632ae6c42e1a0ebb7f46f495,50200023535069,181580.11,60ec41ba55c00300382672d9,HDFC,Revenue-Mktplace,5eecc6d6449e4f7cfb1c2708,2022-04-27T00:00:00.000Z,NEFT CR-ICIC0000105-MANASH LIFESTYLE PRI VATE LIMITED NO-SLICK ORGANICS PRIVATE L IMITED MP G-ICIJ221170009937,shopping,,net_banking_transfer,820.24
632ae6c42e1a0ebb7f46f498,50200023535069,213447.62,60ec41ba55c00300382672d9,HDFC,Revenue-PG-split enabled,5eecc6d6449e4f7cfb1c2708,2022-04-27T00:00:00.000Z,NEFT CR-UTIB0001506-RAZORPAY SOFTWARE PR,,,net_banking_transfer,31867.51
632ae6c42e1a0ebb7f46f49a,50200023535069,296723.38,60ec41ba55c00300382672d9,HDFC,Revenue-PG-non-split,5eecc6d6449e4f7cfb1c2708,2022-04-28T00:00:00.000Z,NEFT CR-PYTM0123456-PAYTM PAYMENTS SERVI CES LIMITED-SLICK ORGANICS PVT LTD-PYTM2 21189422577,insurance,insurance,net_banking_transfer,83275.76
632ae6c42e1a0ebb7f46f49c,50200023535069,41723.38,60ec41ba55c00300382672d9,HDFC,SAAS/tech expense,5eecc6d6449e4f7cfb1c2708,2022-04-28T00:00:00.000Z,POS 514834XXXXXX9486 AMAZON,shopping,,debit_card,-255000
632ae6c42e1a0ebb7f46f49f,50200023535069,45511.73,60ec41ba55c00300382672d9,HDFC,Revenue-Mktplace,5eecc6d6449e4f7cfb1c2708,2022-04-28T00:00:00.000Z,NEFT CR-DEUT0797BGL-MYNTRA DESIGNS PRIVA TE LIMITED-SLICK ORGANICS PVT. LTD.-2118 00347GN00144,shopping,,net_banking_transfer,3788.35
632ae6c42e1a0ebb7f46f4a1,50200023535069,91608.7,60ec41ba55c00300382672d9,HDFC,Revenue-PG-split enabled,5eecc6d6449e4f7cfb1c2708,2022-04-28T00:00:00.000Z,NEFT CR-UTIB0001506-RAZORPAY SOFTWARE PR IVATE LIMITED-SLICK ORGANICS PVT LITD-AX ISCN0133604376,insurance,insurance,net_banking_transfer,46096.97
632ae6c42e1a0ebb7f46f4a3,50200023535069,69118.7,60ec41ba55c00300382672d9,HDFC,direct expenses,5eecc6d6449e4f7cfb1c2708,2022-04-28T00:00:00.000Z,POS 514834XXXXXX9486 RAZ*DEANGRO PACK,,,debit_card,-22490
632ae6c42e1a0ebb7f46f4a5,50200023535069,63036.7,60ec41ba55c00300382672d9,HDFC,direct expenses,5eecc6d6449e4f7cfb1c2708,2022-04-28T00:00:00.000Z,"NEFT DR-ICIC0001087-SARVIN PRINTERS PVT LTD-NETBANK, MUM-N118221934123160-6082",,,net_banking_transfer,-6082
632ae6c42e1a0ebb7f46f4a7,50200023535069,58704.7,60ec41ba55c00300382672d9,HDFC,direct expenses,5eecc6d6449e4f7cfb1c2708,2022-04-28T00:00:00.000Z,POS 514834XXXXXX9486 PAYU-HTTPS://STO,,,debit_card,-4332
632ae6c42e1a0ebb7f46f4a9,50200023535069,193428.62,60ec41ba55c00300382672d9,HDFC,Transfer in/Revenue-other,5eecc6d6449e4f7cfb1c2708,2022-04-28T00:00:00.000Z,"IMPS-211817797128-GOKWIK COMMERCE SOLU-I CIC-XXXXXXXX0630-PAYOUT FOR APRIL 26, 20 22",,,net_banking_transfer,134723.92
632ae6c42e1a0ebb7f46f4ab,50200023535069,216385.62,60ec41ba55c00300382672d9,HDFC,Revenue-PG-split enabled,5eecc6d6449e4f7cfb1c2708,2022-04-28T00:00:00.000Z,NEFT CR-UTIB0001506-RAZORPAY SOFTWARE PR IVATE LIMITED-SLICK ORGANICS PVT LITD-AX ISCN0133718152,insurance,insurance,net_banking_transfer,22957
632ae6c42e1a0ebb7f46f4ad,50200023535069,300659.45,60ec41ba55c00300382672d9,HDFC,Revenue-PG-non-split,5eecc6d6449e4f7cfb1c2708,2022-04-29T00:00:00.000Z,NEFT CR-PYTM0123456-PAYTM PAYMENTS SERVI CES LIMITED-SLICK ORGANICS PVT LTD-PYTM2 21199902138,insurance,insurance,net_banking_transfer,84273.83
632ae6c42e1a0ebb7f46f4af,50200023535069,329610.11,60ec41ba55c00300382672d9,HDFC,Revenue-PG-split enabled,5eecc6d6449e4f7cfb1c2708,2022-04-29T00:00:00.000Z,NEFT CR-UTIB0001506-RAZORPAY SOFTWARE PR IVATE LIMITED-SLICK ORGANICS PVT LITD-AX ISCN0133774255,insurance,insurance,net_banking_transfer,28950.66
632ae6c42e1a0ebb7f46f4b1,50200023535069,333366.02,60ec41ba55c00300382672d9,HDFC,Revenue-Mktplace,5eecc6d6449e4f7cfb1c2708,2022-04-29T00:00:00.000Z,NEFT CR-DEUT0797BGL-MYNTRA DESIGNS PRIVA TE LIMITED-SLICK ORGANICS PVT. LTD.-2119 00342GN00174,shopping,,net_banking_transfer,3755.91
632ae6c42e1a0ebb7f46f4b3,50200023535069,333777,60ec41ba55c00300382672d9,HDFC,Revenue-Mktplace,5eecc6d6449e4f7cfb1c2708,2022-04-29T00:00:00.000Z,NEFT CR-DEUT0797BGL-MYNTRA DESIGNS PRIVA,shopping,,net_banking_transfer,410.98
632ae6c42e1a0ebb7f46f4b5,50200023535069,269877,60ec41ba55c00300382672d9,HDFC,direct expenses,5eecc6d6449e4f7cfb1c2708,2022-04-29T00:00:00.000Z,"NEFT DR-UTIB0000081-MARIAM ROY-NETBANK, MUM-N119221935560727-63900",,,net_banking_transfer,-63900
632ae6c42e1a0ebb7f46f4b7,50200023535069,268215.4,60ec41ba55c00300382672d9,HDFC,direct expenses,5eecc6d6449e4f7cfb1c2708,2022-04-29T00:00:00.000Z,"NEFT DR-SBIN0006894-SHAROO NARANG-NETBAN K, MUM-N119221935561179-1662",,,net_banking_transfer,-1661.6
632ae6c42e1a0ebb7f46f4b9,50200023535069,248215.4,60ec41ba55c00300382672d9,HDFC,direct expenses,5eecc6d6449e4f7cfb1c2708,2022-04-29T00:00:00.000Z,SARVAN KUMAR - CHQ PAID - DEVLI ROAD K,,,chq,-20000
632ae6c42e1a0ebb7f46f4bb,50200023535069,251271.45,60ec41ba55c00300382672d9,HDFC,Revenue-Mktplace,5eecc6d6449e4f7cfb1c2708,2022-04-29T00:00:00.000Z,NEFT CR-DEUT0797BGL-FLIPKART INTERNET PR IVATE LIMITED-SLICK ORGANICS PVT LTD-211 900660GN00273,shopping,,net_banking_transfer,3056.05
632ae6c42e1a0ebb7f46f4bd,50200023535069,253644.86,60ec41ba55c00300382672d9,HDFC,Transfer in/Revenue-other,5eecc6d6449e4f7cfb1c2708,2022-04-29T00:00:00.000Z,NEFT CR-UTIB0000114-ONE SIGMA TECHNOLOGI ES PRIVATE LIM-SLICK ORGANICS PRIVATE LI MITED-AXISP00283934161,insurance,insurance,net_banking_transfer,2373.41
632ae6c42e1a0ebb7f46f4c1,50200023535069,390201.15,60ec41ba55c00300382672d9,HDFC,Transfer in/Revenue-other,5eecc6d6449e4f7cfb1c2708,2022-04-29T00:00:00.000Z,"IMPS-211917123304-GOKWIK COMMERCE SOLU-I CIC-XXXXXXXX0630-PAYOUT FOR APRIL 27, 20 22",,,net_banking_transfer,136556.29
632ae6c42e1a0ebb7f46f4c3,50200023535069,406594.36,60ec41ba55c00300382672d9,HDFC,Revenue-PG-split enabled,5eecc6d6449e4f7cfb1c2708,2022-04-29T00:00:00.000Z,NEFT CR-UTIB0001506-RAZORPAY SOFTWARE PR IVATE LIMITED-SLICK ORGANICS PVT LITD-AX ISCN0133948741,insurance,insurance,net_banking_transfer,16393.21
632ae6c42e1a0ebb7f46f4c5,50200023535069,406596.36,60ec41ba55c00300382672d9,HDFC,Transfer in/Revenue-other,5eecc6d6449e4f7cfb1c2708,2022-04-29T00:00:00.000Z,CRV POS 514834******9486 LINKEDIN,,,refund,2
632ae6c42e1a0ebb7f46f4c7,50200023535069,402841.02,60ec41ba55c00300382672d9,HDFC,direct expenses,5eecc6d6449e4f7cfb1c2708,2022-04-30T00:00:00.000Z,POS 514834XXXXXX9486 WWW.FAQPRIME.COM,,,debit_card,-3755.34
632ae6c42e1a0ebb7f46f4c9,50200023535069,437777.05,60ec41ba55c00300382672d9,HDFC,Revenue-PG-non-split,5eecc6d6449e4f7cfb1c2708,2022-04-30T00:00:00.000Z,NEFT CR-PYTM0123456-PAYTM PAYMENTS SERVI CES LIMITED-SLICK ORGANICS PVT LTD-PYTM2 21200351118,insurance,insurance,net_banking_transfer,34936.03
632ae6c42e1a0ebb7f46f4cb,50200023535069,460741.06,60ec41ba55c00300382672d9,HDFC,Revenue-PG-split enabled,5eecc6d6449e4f7cfb1c2708,2022-04-30T00:00:00.000Z,NEFT CR-UTIB0001506-RAZORPAY SOFTWARE PR IVATE LIMITED-SLICK ORGANICS PVT LITD-AX ISCN0134059902,insurance,insurance,net_banking_transfer,22964.01
632ae6c42e1a0ebb7f46f4cd,50200023535069,450741.06,60ec41ba55c00300382672d9,HDFC,direct expenses,5eecc6d6449e4f7cfb1c2708,2022-04-30T00:00:00.000Z,"NEFT DR-ICIC0000021-AKHILESH DIXIT-NETBA NK, MUM-N120221937350545-10000",,,net_banking_transfer,-10000
632ae6c42e1a0ebb7f46f4cf,50200023535069,175341.06,60ec41ba55c00300382672d9,HDFC,direct expenses,5eecc6d6449e4f7cfb1c2708,2022-04-30T00:00:00.000Z,50200029166957-TPT-275400-GENIEHR SOLUTI ONS PRIVATE LIMITED,,,net_banking_transfer,-275400
632ae6c42e1a0ebb7f46f4d1,50200023535069,188423.06,60ec41ba55c00300382672d9,HDFC,Revenue-Mktplace,5eecc6d6449e4f7cfb1c2708,2022-04-30T00:00:00.000Z,NEFT CR-ICIC0000985-DIGITAL AGE RETAIL P,,,net_banking_transfer,13082
632ae6c42e1a0ebb7f46f4d3,50200023535069,1188423.06,60ec41ba55c00300382672d9,HDFC,Internal Transfers,5eecc6d6449e4f7cfb1c2708,2022-04-30T00:00:00.000Z,IB FUNDS TRANSFER CR-50200035187206 -SL ICK ORGANICS PVT LTD,insurance,insurance,Other,1000000
632ae6c42e1a0ebb7f46f4d5,50200023535069,188423.06,60ec41ba55c00300382672d9,HDFC,Tax,5eecc6d6449e4f7cfb1c2708,2022-04-30T00:00:00.000Z,051030830042286692- CBDT TAX,,,Other,-1000000
632ae6c42e1a0ebb7f46f4d7,50200023535069,366258.06,60ec41ba55c00300382672d9,HDFC,Transfer in/Revenue-other,5eecc6d6449e4f7cfb1c2708,2022-04-30T00:00:00.000Z,"IMPS-212017871426-GOKWIK COMMERCE SOLU-I CIC-XXXXXXXX0630-PAYOUT FOR APRIL 28, 20 22",,,net_banking_transfer,177835
632ae6c42e1a0ebb7f46f4d9,50200023535069,384852.67,60ec41ba55c00300382672d9,HDFC,Revenue-PG-split enabled,5eecc6d6449e4f7cfb1c2708,2022-04-30T00:00:00.000Z,NEFT CR-UTIB0001506-RAZORPAY SOFTWARE PR IVATE LIMITED-SLICK ORGANICS PVT LITD-AX ISCN0134239052,insurance,insurance,net_banking_transfer,18594.61
632ae6c42e1a0ebb7f46f4db,50200023535069,384673.67,60ec41ba55c00300382672d9,HDFC,SAAS/tech expense,5eecc6d6449e4f7cfb1c2708,2022-04-30T00:00:00.000Z,ME DC SI 514834XXXXXX9486 AMAZON,shopping,,Other,-179
632ae6c42e1a0ebb7f46f4dd,50200023535069,595016.98,60ec41ba55c00300382672d9,HDFC,Revenue-Mktplace,5eecc6d6449e4f7cfb1c2708,2022-06-01T00:00:00.000Z,NEFT CR-DEUT0797BGL-FLIPKART INTERNET PR IVATE LIMITED-SLICK ORGANICS PVT LTD-215 200097GN00244,shopping,,net_banking_transfer,20869.55
632ae6c42e1a0ebb7f46f4df,50200023535069,600116.6,60ec41ba55c00300382672d9,HDFC,Revenue-Mktplace,5eecc6d6449e4f7cfb1c2708,2022-06-01T00:00:00.000Z,NEFT CR-DEUT0797BGL-FLIPKART INTERNET PR IVATE LIMITED-SLICK ORGANICS PVT LTD-215 200111GN00136,shopping,,net_banking_transfer,5099.62
632ae6c42e1a0ebb7f46f4e1,50200023535069,345116.6,60ec41ba55c00300382672d9,HDFC,SAAS/tech expense,5eecc6d6449e4f7cfb1c2708,2022-06-01T00:00:00.000Z,POS 514834XXXXXX9486 AMAZON,shopping,,debit_card,-255000
632ae6c42e1a0ebb7f46f4e3,50200023535069,375405.51,60ec41ba55c00300382672d9,HDFC,Revenue-PG-non-split,5eecc6d6449e4f7cfb1c2708,2022-06-01T00:00:00.000Z,NEFT CR-PYTM0123456-PAYTM PAYMENTS SERVI CES LIMITED-SLICK ORGANICS PVT LTD-PYTM2 21520256709,insurance,insurance,net_banking_transfer,30288.91
632ae6c42e1a0ebb7f46f4e5,50200023535069,382124.87,60ec41ba55c00300382672d9,HDFC,Revenue-Mktplace,5eecc6d6449e4f7cfb1c2708,2022-06-01T00:00:00.000Z,NEFT CR-DEUT0797BGL-MYNTRA DESIGNS PRIVA TE LIMITED-SLICK ORGANICS PVT. LTD.-2152 00541GN00046,shopping,,net_banking_transfer,6719.36
632ae6c42e1a0ebb7f46f4e7,50200023535069,383071.83,60ec41ba55c00300382672d9,HDFC,Revenue-Mktplace,5eecc6d6449e4f7cfb1c2708,2022-06-01T00:00:00.000Z,NEFT CR-DEUT0797BGL-MYNTRA DESIGNS PRIVA TE LIMITED-SLICK ORGANICS PVT. LTD.-2152 00518GN00275,shopping,,net_banking_transfer,946.96
632ae6c42e1a0ebb7f46f4e9,50200023535069,424760.09,60ec41ba55c00300382672d9,HDFC,Revenue-PG-split enabled,5eecc6d6449e4f7cfb1c2708,2022-06-01T00:00:00.000Z,NEFT CR-UTIB0001506-RAZORPAY SOFTWARE PR IVATE LIMITED-SLICK ORGANICS PVT LITD-AX ISCN0143955838,insurance,insurance,net_banking_transfer,41688.26
632ae6c42e1a0ebb7f46f4eb,50200023535069,467687.87,60ec41ba55c00300382672d9,HDFC,Transfer in/Revenue-other,5eecc6d6449e4f7cfb1c2708,2022-06-01T00:00:00.000Z,"IMPS-215216237566-GOKWIK COMMERCE SOLU-I CIC-XXXXXXXX0630-PAYOUT FOR MAY 30, 2022",,,net_banking_transfer,42927.78
632ae6c42e1a0ebb7f46f4ed,50200023535069,468083.68,60ec41ba55c00300382672d9,HDFC,Revenue-Mktplace,5eecc6d6449e4f7cfb1c2708,2022-06-01T00:00:00.000Z,NEFT CR-ICIC0000105-MANASH LIFESTYLE PRI VATE LIMITED NO-SLICK ORGANICS PRIVATE L IMITED BANG-ICIJ221520006331,shopping,,net_banking_transfer,395.81
632ae6c42e1a0ebb7f46f4ef,50200023535069,468269.87,60ec41ba55c00300382672d9,HDFC,Revenue-Mktplace,5eecc6d6449e4f7cfb1c2708,2022-06-01T00:00:00.000Z,NEFT CR-ICIC0000105-MANASH LIFESTYLE PRI VATE LIMITED NO-SLICK ORGANICS PRIVATE L IMITED KOLK-ICIJ221520006330,shopping,,net_banking_transfer,186.19
632ae6c42e1a0ebb7f46f4f1,50200023535069,513349.97,60ec41ba55c00300382672d9,HDFC,Transfer in/Revenue-other,5eecc6d6449e4f7cfb1c2708,2022-06-01T00:00:00.000Z,59209873901899-TPT-ARATA PAYMENT-NYNM OR GANICS PVT LTD,,,net_banking_transfer,45080.1
632ae6c42e1a0ebb7f46f4f3,50200023535069,520674.19,60ec41ba55c00300382672d9,HDFC,Transfer in/Revenue-other,5eecc6d6449e4f7cfb1c2708,2022-06-01T00:00:00.000Z,IMPS-215217367354-GOKWIK COMMERCE SOLU-I,,,net_banking_transfer,7324.22
632ae6c42e1a0ebb7f46f4f5,50200023535069,520583.22,60ec41ba55c00300382672d9,HDFC,bank charges,5eecc6d6449e4f7cfb1c2708,2022-06-01T00:00:00.000Z,.DC INTL POS TXN MARKUP+ST 010422 020422 -CDT2215209278210,,,international_transaction_arbitrage,-90.97
632ae6c42e1a0ebb7f46f4f7,50200023535069,526014.66,60ec41ba55c00300382672d9,HDFC,Revenue-PG-split enabled,5eecc6d6449e4f7cfb1c2708,2022-06-01T00:00:00.000Z,NEFT CR-UTIB0001506-RAZORPAY SOFTWARE PR IVATE LIMITED-SLICK ORGANICS PVT LITD-AX ISCN0144315999,insurance,insurance,net_banking_transfer,5431.44
632ae6c42e1a0ebb7f46f4f9,50200023535069,592955.1,60ec41ba55c00300382672d9,HDFC,Revenue-UPI,5eecc6d6449e4f7cfb1c2708,2022-06-01T00:00:00.000Z,"UPI-GOKWIK-GOKWIK@YESBANK-YESB0000340-21 5284214869-PAYOUT FOR MAY 30,",,,upi,66940.44
632ae6c42e1a0ebb7f46f4fb,50200023535069,554011.06,60ec41ba55c00300382672d9,HDFC,SAAS/tech expense,5eecc6d6449e4f7cfb1c2708,2022-06-01T00:00:00.000Z,POS 514834XXXXXX9486 AMAZON.COM,shopping,,debit_card,-38944.04
632ae6c42e1a0ebb7f46f4fe,50200023535069,561544.45,60ec41ba55c00300382672d9,HDFC,Revenue-PG-non-split,5eecc6d6449e4f7cfb1c2708,2022-06-02T00:00:00.000Z,IMPS-215306425238-PAYTM PAYMENTS SERVI-P YTM-XXXXXXXXXX0008-ALL202206022168200003 30830668628,ewallet,,net_banking_transfer,7533.39
632ae6c42e1a0ebb7f46f502,50200023535069,570703.91,60ec41ba55c00300382672d9,HDFC,Revenue-PG-split enabled,5eecc6d6449e4f7cfb1c2708,2022-06-02T00:00:00.000Z,NEFT CR-UTIB0001506-RAZORPAY SOFTWARE PR IVATE LIMITED-SLICK ORGANICS PVT LITD-AX ISCN0144575592,insurance,insurance,net_banking_transfer,9159.46
632ae6c42e1a0ebb7f46f504,50200023535069,583170.87,60ec41ba55c00300382672d9,HDFC,Transfer in/Revenue-other,5eecc6d6449e4f7cfb1c2708,2022-06-02T00:00:00.000Z,NEFT CR-UTIB0000114-ONE SIGMA TECHNOLOGI ES PRIVATE LIM-SLICK ORGANICS PRIVATE LI MITED-AXISP00292873450,insurance,insurance,net_banking_transfer,12466.96
632ae6c42e1a0ebb7f46f507,50200023535069,283170.87,60ec41ba55c00300382672d9,HDFC,direct expenses,5eecc6d6449e4f7cfb1c2708,2022-06-02T00:00:00.000Z,"NEFT DR-YESB0000551-VISTTA COSMETICS-NET BANK, MUM-N153221982149194-300000",,,net_banking_transfer,-300000
632ae6c42e1a0ebb7f46f509,50200023535069,263920.86,60ec41ba55c00300382672d9,HDFC,direct expenses,5eecc6d6449e4f7cfb1c2708,2022-06-02T00:00:00.000Z,POS 514834XXXXXX9486 ARVIND BEAUTY BR,,,debit_card,-19250.01
632ae6c42e1a0ebb7f46f50b,50200023535069,256840.86,60ec41ba55c00300382672d9,HDFC,direct expenses,5eecc6d6449e4f7cfb1c2708,2022-06-02T00:00:00.000Z,"NEFT DR-SBIN0061195-AYUSH FLEXIPACK PVT LIMITED-NETBANK, MUM-N153221982217694-70 80",loans,lender_transaction,net_banking_transfer,-7080
632ae6c42e1a0ebb7f46f50d,50200023535069,252292.86,60ec41ba55c00300382672d9,HDFC,direct expenses,5eecc6d6449e4f7cfb1c2708,2022-06-02T00:00:00.000Z,POS 514834XXXXXX9486 DESERTCART.COM,,,debit_card,-4548
632ae6c42e1a0ebb7f46f50f,50200023535069,276860.65,60ec41ba55c00300382672d9,HDFC,Transfer in/Revenue-other,5eecc6d6449e4f7cfb1c2708,2022-06-02T00:00:00.000Z,"IMPS-215316906560-GOKWIK COMMERCE SOLU-I CIC-XXXXXXXX0630-PAYOUT FOR MAY 31, 2022",,,net_banking_transfer,24567.79
632ae6c42e1a0ebb7f46f511,50200023535069,266860.65,60ec41ba55c00300382672d9,HDFC,direct expenses,5eecc6d6449e4f7cfb1c2708,2022-06-02T00:00:00.000Z,"NEFT DR-ICIC0000021-AKHILESH DIXIT-NETBA NK, MUM-N153221982425510-10000",,,net_banking_transfer,-10000
632ae6c42e1a0ebb7f46f513,50200023535069,271447.65,60ec41ba55c00300382672d9,HDFC,Revenue-Mktplace,5eecc6d6449e4f7cfb1c2708,2022-06-02T00:00:00.000Z,NEFT CR-SCBL0036001-M/S DREAMPLUG TECHNO,,,net_banking_transfer,4587
632ae6c42e1a0ebb7f46f515,50200023535069,286184.16,60ec41ba55c00300382672d9,HDFC,Revenue-PG-split enabled,5eecc6d6449e4f7cfb1c2708,2022-06-02T00:00:00.000Z,NEFT CR-UTIB0001506-RAZORPAY SOFTWARE PR IVATE LIMITED-SLICK ORGANICS PVT LITD-AX ISCN0144879669,insurance,insurance,net_banking_transfer,14736.51
632ae6c42e1a0ebb7f46f517,50200023535069,286214.16,60ec41ba55c00300382672d9,HDFC,Revenue-PG-non-split,5eecc6d6449e4f7cfb1c2708,2022-06-02T00:00:00.000Z,NEFT CR-IDFB0010204-SEZZLE PAYMENTS PRIV ATE LIMITED-SLICK ORGANICS PRIVATE LIMIT ED-IDFBH22153112524,insurance,insurance,net_banking_transfer,30
632ae6c42e1a0ebb7f46f519,50200023535069,286772.73,60ec41ba55c00300382672d9,HDFC,Revenue-Mktplace,5eecc6d6449e4f7cfb1c2708,2022-06-02T00:00:00.000Z,NEFT CR-ICIC0000105-MANASH LIFESTYLE PRI VATE LIMITED NO-SLICK ORGANICS PRIVATE L IMITED KOLK-ICIJ221530006740,shopping,,net_banking_transfer,558.57
632ae6c42e1a0ebb7f46f51b,50200023535069,287362.07,60ec41ba55c00300382672d9,HDFC,Revenue-Mktplace,5eecc6d6449e4f7cfb1c2708,2022-06-02T00:00:00.000Z,NEFT CR-ICIC0000105-MANASH LIFESTYLE PRI VATE LIMITED NO-SLICK ORGANICS PRIVATE L IMITED MP M-ICIJ221530006739,shopping,,net_banking_transfer,589.34
632ae6c42e1a0ebb7f46f51d,50200023535069,283555.92,60ec41ba55c00300382672d9,HDFC,direct expenses,5eecc6d6449e4f7cfb1c2708,2022-06-02T00:00:00.000Z,POS 514834XXXXXX9486 WWW.FAQPRIME.COM,,,debit_card,-3806.15
632ae6c42e1a0ebb7f46f520,50200023535069,288143.57,60ec41ba55c00300382672d9,HDFC,Revenue-Mktplace,5eecc6d6449e4f7cfb1c2708,2022-06-03T00:00:00.000Z,NEFT CR-DEUT0797BGL-FLIPKART INTERNET PR IVATE LIMITED-SLICK ORGANICS PVT LTD-215 400164GN00157,shopping,,net_banking_transfer,4587.65
632ae6c42e1a0ebb7f46f522,50200023535069,306527.23,60ec41ba55c00300382672d9,HDFC,Revenue-PG-non-split,5eecc6d6449e4f7cfb1c2708,2022-06-03T00:00:00.000Z,IMPS-215406837902-PAYTM PAYMENTS SERVI-P YTM-XXXXXXXXXX0008-ALL202206032168200003 30830668628,ewallet,,net_banking_transfer,18383.66
632ae6c42e1a0ebb7f46f524,50200023535069,307109.69,60ec41ba55c00300382672d9,HDFC,Revenue-Mktplace,5eecc6d6449e4f7cfb1c2708,2022-06-03T00:00:00.000Z,NEFT CR-DEUT0797BGL-FLIPKART INTERNET PR IVATE LIMITED-SLICK ORGANICS PVT LTD-215 400207GN00226,shopping,,net_banking_transfer,582.46
632ae6c42e1a0ebb7f46f526,50200023535069,310415.47,60ec41ba55c00300382672d9,HDFC,Revenue-Mktplace,5eecc6d6449e4f7cfb1c2708,2022-06-03T00:00:00.000Z,NEFT CR-DEUT0797BGL-MYNTRA DESIGNS PRIVA TE LIMITED-SLICK ORGANICS PVT. LTD.-2154 00546GN00253,shopping,,net_banking_transfer,3305.78
632ae6c52e1a0ebb7f46f528,50200023535069,324798.49,60ec41ba55c00300382672d9,HDFC,Revenue-Mktplace,5eecc6d6449e4f7cfb1c2708,2022-06-03T00:00:00.000Z,NEFT CR-DEUT0797BGL-MYNTRA DESIGNS PRIVA TE LIMITED-SLICK ORGANICS PVT. LTD.-2154 00568GN00032,shopping,,net_banking_transfer,14383.02
632ae6c52e1a0ebb7f46f530,50200023535069,308302.49,60ec41ba55c00300382672d9,HDFC,direct expenses,5eecc6d6449e4f7cfb1c2708,2022-06-03T00:00:00.000Z,"NEFT DR-SBIN0018817-RIGHT VISION SECURIT Y SYSTEMS-NETBANK, MUM-N154221983050669- 16496",,,net_banking_transfer,-16496
632ae6c52e1a0ebb7f46f532,50200023535069,322571.01,60ec41ba55c00300382672d9,HDFC,Revenue-PG-split enabled,5eecc6d6449e4f7cfb1c2708,2022-06-03T00:00:00.000Z,NEFT CR-UTIB0001506-RAZORPAY SOFTWARE PR,,,net_banking_transfer,14268.52
632ae6c52e1a0ebb7f46f534,50200023535069,330023.12,60ec41ba55c00300382672d9,HDFC,Transfer in/Revenue-other,5eecc6d6449e4f7cfb1c2708,2022-06-03T00:00:00.000Z,NEFT CR-UTIB0000114-ONE SIGMA TECHNOLOGI ES PRIVATE LIM-SLICK ORGANICS PRIVATE LI MITED-AXISP00293145346,insurance,insurance,net_banking_transfer,7452.11
632ae6c52e1a0ebb7f46f536,50200023535069,328938.12,60ec41ba55c00300382672d9,HDFC,direct expenses,5eecc6d6449e4f7cfb1c2708,2022-06-03T00:00:00.000Z,POS 514834XXXXXX9486 SMARTSHIFT LOGIS,,,debit_card,-1085
632ae6c52e1a0ebb7f46f538,50200023535069,321798.12,60ec41ba55c00300382672d9,HDFC,direct expenses,5eecc6d6449e4f7cfb1c2708,2022-06-03T00:00:00.000Z,POS 514834XXXXXX9486 CLEARTRIP,,,debit_card,-7140
632ae6c52e1a0ebb7f46f53a,50200023535069,303480.12,60ec41ba55c00300382672d9,HDFC,direct expenses,5eecc6d6449e4f7cfb1c2708,2022-06-03T00:00:00.000Z,02711600008220-TPT-18318-VARUN SINGH,,,net_banking_transfer,-18318
632ae6c52e1a0ebb7f46f53c,50200023535069,324738.69,60ec41ba55c00300382672d9,HDFC,Transfer in/Revenue-other,5eecc6d6449e4f7cfb1c2708,2022-06-03T00:00:00.000Z,"IMPS-215416263125-GOKWIK COMMERCE SOLU-I CIC-XXXXXXXX0630-PAYOUT FOR JUNE 1, 2022",,,net_banking_transfer,21258.57
632ae6c52e1a0ebb7f46f53e,50200023535069,325320.69,60ec41ba55c00300382672d9,HDFC,Revenue-Mktplace,5eecc6d6449e4f7cfb1c2708,2022-06-03T00:00:00.000Z,NEFT CR-ICIC0000105-MANASH LIFESTYLE PRI VATE LIMITED NO-SLICK ORGANICS PRIVATE L IMITED KOLK-ICIJ221540008083,shopping,,net_banking_transfer,582
632ae6c52e1a0ebb7f46f540,50200023535069,325897.58,60ec41ba55c00300382672d9,HDFC,Revenue-Mktplace,5eecc6d6449e4f7cfb1c2708,2022-06-03T00:00:00.000Z,NEFT CR-ICIC0000105-MANASH LIFESTYLE PRI VATE LIMITED NO-SLICK ORGANICS PRIVATE L IMITED BANG-ICIJ221540007602,shopping,,net_banking_transfer,576.89
632ae6c52e1a0ebb7f46f543,50200023535069,327161.28,60ec41ba55c00300382672d9,HDFC,Revenue-Mktplace,5eecc6d6449e4f7cfb1c2708,2022-06-03T00:00:00.000Z,NEFT CR-ICIC0000105-MANASH LIFESTYLE PRI VATE LIMITED NO-SLICK ORGANICS PRIVATE L IMITED MP G-ICIJ221540007600,shopping,,net_banking_transfer,1263.7
632ae6c52e1a0ebb7f46f545,50200023535069,337148.38,60ec41ba55c00300382672d9,HDFC,Revenue-PG-split enabled,5eecc6d6449e4f7cfb1c2708,2022-06-03T00:00:00.000Z,NEFT CR-UTIB0001506-RAZORPAY SOFTWARE PR IVATE LIMITED-SLICK ORGANICS PVT LITD-AX ISCN0145379663,insurance,insurance,net_banking_transfer,9987.1
632ae6c52e1a0ebb7f46f547,50200023535069,343267.4,60ec41ba55c00300382672d9,HDFC,Revenue-PG-non-split,5eecc6d6449e4f7cfb1c2708,2022-06-04T00:00:00.000Z,IMPS-215505215073-PAYTM PAYMENTS SERVI-P YTM-XXXXXXXXXX0008-ALL202206042168200003 30830668628,ewallet,,net_banking_transfer,6119.02
632ae6c52e1a0ebb7f46f549,50200023535069,351705.52,60ec41ba55c00300382672d9,HDFC,Revenue-PG-split enabled,5eecc6d6449e4f7cfb1c2708,2022-06-04T00:00:00.000Z,NEFT CR-UTIB0001506-RAZORPAY SOFTWARE PR IVATE LIMITED-SLICK ORGANICS PVT LITD-AX ISCN0145564093,insurance,insurance,net_banking_transfer,8438.12
632ae6c52e1a0ebb7f46f54b,50200023535069,349453.16,60ec41ba55c00300382672d9,HDFC,direct expenses,5eecc6d6449e4f7cfb1c2708,2022-06-04T00:00:00.000Z,POS 514834XXXXXX9486 SEOPTIMER,,,debit_card,-2252.36
632ae6c52e1a0ebb7f46f54d,50200023535069,374531.19,60ec41ba55c00300382672d9,HDFC,Revenue-UPI,5eecc6d6449e4f7cfb1c2708,2022-06-04T00:00:00.000Z,"UPI-GOKWIK-GOKWIK@YESBANK-YESB0000340-21 5589816271-PAYOUT FOR JUNE 1,",,,upi,25078.03
632ae6c52e1a0ebb7f46f54f,50200023535069,467136.49,60ec41ba55c00300382672d9,HDFC,Revenue-UPI,5eecc6d6449e4f7cfb1c2708,2022-06-04T00:00:00.000Z,UPI-GOKWIK-GOKWIK@YESBANK-YESB0000340-21,,,upi,92605.3
632ae6c52e1a0ebb7f46f552,50200023535069,548224.22,60ec41ba55c00300382672d9,HDFC,Transfer in/Revenue-other,5eecc6d6449e4f7cfb1c2708,2022-06-04T00:00:00.000Z,"IMPS-215516522378-GOKWIK COMMERCE SOLU-I CIC-XXXXXXXX0630-PAYOUT FOR JUNE 2, 2022",,,net_banking_transfer,81087.73
632ae6c52e1a0ebb7f46f556,50200023535069,562109.36,60ec41ba55c00300382672d9,HDFC,Revenue-PG-split enabled,5eecc6d6449e4f7cfb1c2708,2022-06-04T00:00:00.000Z,NEFT CR-UTIB0001506-RAZORPAY SOFTWARE PR IVATE LIMITED-SLICK ORGANICS PVT LITD-AX ISCN0145841105,insurance,insurance,net_banking_transfer,13885.14
632ae6c52e1a0ebb7f46f558,50200023535069,570633.77,60ec41ba55c00300382672d9,HDFC,Revenue-PG-non-split,5eecc6d6449e4f7cfb1c2708,2022-06-05T00:00:00.000Z,IMPS-215605676434-PAYTM PAYMENTS SERVI-P YTM-XXXXXXXXXX0008-ALL202206052168200003 30830668628,ewallet,,net_banking_transfer,8524.41
632ae6c52e1a0ebb7f46f55a,50200023535069,624861.71,60ec41ba55c00300382672d9,HDFC,Transfer in/Revenue-other,5eecc6d6449e4f7cfb1c2708,2022-06-05T00:00:00.000Z,"IMPS-215616548991-GOKWIK COMMERCE SOLU-I CIC-XXXXXXXX0630-PAYOUT FOR JUNE 3, 2022",,,net_banking_transfer,54227.94
632ae6c52e1a0ebb7f46f55c,50200023535069,594861.71,60ec41ba55c00300382672d9,HDFC,direct expenses,5eecc6d6449e4f7cfb1c2708,2022-06-05T00:00:00.000Z,"NEFT DR-KKBK0008365-SRIRAJ GUNDA-NETBANK , MUM-N156221986023495-30000",,,net_banking_transfer,-30000
632ae6c52e1a0ebb7f46f55e,50200023535069,576288.71,60ec41ba55c00300382672d9,HDFC,direct expenses,5eecc6d6449e4f7cfb1c2708,2022-06-05T00:00:00.000Z,"NEFT DR-BARB0DINARA-MD ARIF RAZA-NETBANK , MUM-N156221986027902-18573",,,net_banking_transfer,-18573
632ae6c52e1a0ebb7f46f560,50200023535069,583661.99,60ec41ba55c00300382672d9,HDFC,Revenue-Mktplace,5eecc6d6449e4f7cfb1c2708,2022-06-06T00:00:00.000Z,NEFT CR-DEUT0797BGL-FLIPKART INTERNET PR IVATE LIMITED-SLICK ORGANICS PVT LTD-215 700126GN00212,shopping,,net_banking_transfer,7373.28
632ae6c52e1a0ebb7f46f562,50200023535069,605167.62,60ec41ba55c00300382672d9,HDFC,Revenue-PG-non-split,5eecc6d6449e4f7cfb1c2708,2022-06-06T00:00:00.000Z,IMPS-215705008140-PAYTM PAYMENTS SERVI-P YTM-XXXXXXXXXX0008-ALL202206062168200003 30830668628,ewallet,,net_banking_transfer,21505.63
632ae6c52e1a0ebb7f46f564,50200023535069,1345167.62,60ec41ba55c00300382672d9,HDFC,Internal Transfers,5eecc6d6449e4f7cfb1c2708,2022-06-06T00:00:00.000Z,IB FUNDS TRANSFER CR-50200035187206 -SL ICK ORGANICS PVT LTD,insurance,insurance,Other,740000
632ae6c52e1a0ebb7f46f566,50200023535069,1359063.31,60ec41ba55c00300382672d9,HDFC,Revenue-Mktplace,5eecc6d6449e4f7cfb1c2708,2022-06-06T00:00:00.000Z,NEFT CR-DEUT0797BGL-MYNTRA DESIGNS PRIVA TE LIMITED-SLICK ORGANICS PVT. LTD.-2157 00587GN00068,shopping,,net_banking_transfer,13895.69
632ae6c52e1a0ebb7f46f568,50200023535069,1370226.55,60ec41ba55c00300382672d9,HDFC,Revenue-Mktplace,5eecc6d6449e4f7cfb1c2708,2022-06-06T00:00:00.000Z,NEFT CR-DEUT0797BGL-MYNTRA DESIGNS PRIVA TE LIMITED-SLICK ORGANICS PVT. LTD.-2157 00586GN00030,shopping,,net_banking_transfer,11163.24
632ae6c52e1a0ebb7f46f56a,50200023535069,1425321.74,60ec41ba55c00300382672d9,HDFC,Revenue-PG-split enabled,5eecc6d6449e4f7cfb1c2708,2022-06-06T00:00:00.000Z,NEFT CR-UTIB0001506-RAZORPAY SOFTWARE PR,,,net_banking_transfer,55095.19
632ae6c52e1a0ebb7f46f56c,50200023535069,1425980.71,60ec41ba55c00300382672d9,HDFC,Revenue-Mktplace,5eecc6d6449e4f7cfb1c2708,2022-06-06T00:00:00.000Z,NEFT CR-ICIC0000105-MANASH LIFESTYLE PRI VATE LIMITED NO-SLICK ORGANICS PRIVATE L IMITED MP M-ICIJ221570001065,shopping,,net_banking_transfer,658.97
632ae6c52e1a0ebb7f46f56f,50200023535069,1426177.91,60ec41ba55c00300382672d9,HDFC,Revenue-Mktplace,5eecc6d6449e4f7cfb1c2708,2022-06-06T00:00:00.000Z,NEFT CR-ICIC0000105-MANASH LIFESTYLE PRI VATE LIMITED NO-SLICK ORGANICS PRIVATE L IMITED MP G-ICIJ221570001063,shopping,,net_banking_transfer,197.2
632ae6c52e1a0ebb7f46f571,50200023535069,1426550.29,60ec41ba55c00300382672d9,HDFC,Revenue-Mktplace,5eecc6d6449e4f7cfb1c2708,2022-06-06T00:00:00.000Z,NEFT CR-ICIC0000105-MANASH LIFESTYLE PRI VATE LIMITED NO-SLICK ORGANICS PRIVATE L IMITED KOLK-ICIJ221570001066,shopping,,net_banking_transfer,372.38
632ae6c52e1a0ebb7f46f573,50200023535069,1427635.51,60ec41ba55c00300382672d9,HDFC,Transfer in/Revenue-other,5eecc6d6449e4f7cfb1c2708,2022-06-06T00:00:00.000Z,NEFT CR-UTIB0000114-ONE SIGMA TECHNOLOGI ES PRIVATE LIM-SLICK ORGANICS PRIVATE LI MITED-AXISP00293693313,insurance,insurance,net_banking_transfer,1085.22
632ae6c52e1a0ebb7f46f577,50200023535069,1429042.98,60ec41ba55c00300382672d9,HDFC,Transfer in/Revenue-other,5eecc6d6449e4f7cfb1c2708,2022-06-06T00:00:00.000Z,NEFT CR-UTIB0000114-ONE SIGMA TECHNOLOGI ES PRIVATE LIM-SLICK ORGANICS PRIVATE LI MITED-AXISP00293693525,insurance,insurance,net_banking_transfer,1407.47
632ae6c52e1a0ebb7f46f579,50200023535069,1439546.4,60ec41ba55c00300382672d9,HDFC,Transfer in/Revenue-other,5eecc6d6449e4f7cfb1c2708,2022-06-06T00:00:00.000Z,NEFT CR-UTIB0000114-ONE SIGMA TECHNOLOGI ES PRIVATE LIM-SLICK ORGANICS PRIVATE LI MITED-AXISP00293693392,insurance,insurance,net_banking_transfer,10503.42
632ae6c52e1a0ebb7f46f57b,50200023535069,1482596.11,60ec41ba55c00300382672d9,HDFC,Transfer in/Revenue-other,5eecc6d6449e4f7cfb1c2708,2022-06-06T00:00:00.000Z,"IMPS-215716689912-GOKWIK COMMERCE SOLU-I CIC-XXXXXXXX0630-PAYOUT FOR JUNE 4, 2022",,,net_banking_transfer,43049.71
632ae6c52e1a0ebb7f46f57d,50200023535069,1499724.11,60ec41ba55c00300382672d9,HDFC,Revenue-PG-split enabled,5eecc6d6449e4f7cfb1c2708,2022-06-06T00:00:00.000Z,NEFT CR-UTIB0001506-RAZORPAY SOFTWARE PR IVATE LIMITED-SLICK ORGANICS PVT LITD-AX ISCN0146594134,insurance,insurance,net_banking_transfer,17128
632ae6c52e1a0ebb7f46f57f,50200023535069,1484190.61,60ec41ba55c00300382672d9,HDFC,direct expenses,5eecc6d6449e4f7cfb1c2708,2022-06-06T00:00:00.000Z,POS 514834XXXXXX9486 GUPSHUP INC,,,debit_card,-15533.5
632ae6c52e1a0ebb7f46f581,50200023535069,1563911.39,60ec41ba55c00300382672d9,HDFC,Revenue-COD,5eecc6d6449e4f7cfb1c2708,2022-06-06T00:00:00.000Z,NEFT CR-ICIC0000155-SHIPROCKET COD CRF I D 4423229-SLICK ORGANICS PVT LTD-CMS2628 232493,insurance,insurance,net_banking_transfer,79720.78
632ae6c52e1a0ebb7f46f583,50200023535069,1509744.39,60ec41ba55c00300382672d9,HDFC,direct expenses,5eecc6d6449e4f7cfb1c2708,2022-06-07T00:00:00.000Z,50100362612187 NET BANKING SI -54167,,,Other,-54167
632ae6c52e1a0ebb7f46f585,50200023535069,1439744.39,60ec41ba55c00300382672d9,HDFC,direct expenses,5eecc6d6449e4f7cfb1c2708,2022-06-07T00:00:00.000Z,50100064106714 NET BANKING SI -70000,,,Other,-70000
632ae6c52e1a0ebb7f46f587,50200023535069,1266225.39,60ec41ba55c00300382672d9,HDFC,direct expenses,5eecc6d6449e4f7cfb1c2708,2022-06-07T00:00:00.000Z,50100155115510 NET BANKING SI -173519,,,Other,-173519
632ae6c52e1a0ebb7f46f589,50200023535069,1200999.39,60ec41ba55c00300382672d9,HDFC,direct expenses,5eecc6d6449e4f7cfb1c2708,2022-06-07T00:00:00.000Z,50100293329616 NET BANKING SI -65226,,,Other,-65226
632ae6c52e1a0ebb7f46f58b,50200023535069,1067017.39,60ec41ba55c00300382672d9,HDFC,direct expenses,5eecc6d6449e4f7cfb1c2708,2022-06-07T00:00:00.000Z,50100093802387 NET BANKING SI -133982,,,Other,-133982
632ae6c52e1a0ebb7f46f58d,50200023535069,944045.39,60ec41ba55c00300382672d9,HDFC,direct expenses,5eecc6d6449e4f7cfb1c2708,2022-06-07T00:00:00.000Z,NEFT DR-ICIC0000021-AKHILESH DIXIT-SANDO Z - MUM-N158221988162980-NET BANKING SI -122972,,,net_banking_transfer,-122972
632ae6c52e1a0ebb7f46f58f,50200023535069,907545.39,60ec41ba55c00300382672d9,HDFC,direct expenses,5eecc6d6449e4f7cfb1c2708,2022-06-07T00:00:00.000Z,NEFT DR-SIBL0000555-JAIVEER KUMAR-SANDOZ - MUM-N158221988162981-NET BANKING SI - 36500,,,net_banking_transfer,-36500
632ae6c52e1a0ebb7f46f591,50200023535069,879045.39,60ec41ba55c00300382672d9,HDFC,direct expenses,5eecc6d6449e4f7cfb1c2708,2022-06-07T00:00:00.000Z,NEFT DR-BARB0VJGRKA-OM PRASAD PANDEY-SAN DOZ - MUM-N158221988162982-NET BANKING S I -28500,,,net_banking_transfer,-28500
632ae6c52e1a0ebb7f46f593,50200023535069,857545.39,60ec41ba55c00300382672d9,HDFC,direct expenses,5eecc6d6449e4f7cfb1c2708,2022-06-07T00:00:00.000Z,NEFT DR-PUNB0482100-RAM BHAVAN YADAV-SAN DOZ - MUM-N158221988162983-NET BANKING S I -21500,,,net_banking_transfer,-21500
632ae6c52e1a0ebb7f46f595,50200023535069,837222.39,60ec41ba55c00300382672d9,HDFC,direct expenses,5eecc6d6449e4f7cfb1c2708,2022-06-07T00:00:00.000Z,NEFT DR-KKBK0005032-DEEPAK YADAV-SANDOZ - MUM-N158221988162984-NET BANKING SI -2 0323,,,net_banking_transfer,-20323
632ae6c52e1a0ebb7f46f597,50200023535069,818649.39,60ec41ba55c00300382672d9,HDFC,direct expenses,5eecc6d6449e4f7cfb1c2708,2022-06-07T00:00:00.000Z,NEFT DR-PUNB0151400-BHUWAN CHANDER JOSHI -SANDOZ - MUM-N158221988162985-NET BANKI NG SI -18573,,,net_banking_transfer,-18573
632ae6c52e1a0ebb7f46f599,50200023535069,798258.39,60ec41ba55c00300382672d9,HDFC,direct expenses,5eecc6d6449e4f7cfb1c2708,2022-06-07T00:00:00.000Z,NEFT DR-PUNB0494300-KUNDAN PRASAD-SANDOZ - MUM-N158221988162986-NET BANKING SI - 20391,,,net_banking_transfer,-20391
632ae6c52e1a0ebb7f46f59b,50200023535069,779655.39,60ec41ba55c00300382672d9,HDFC,N-ACH payments,5eecc6d6449e4f7cfb1c2708,2022-06-07T00:00:00.000Z,NEFT DR-DBSS0IN0811-SACHIN SINGH-SANDOZ - MUM-N158221988162987-NET BANKING SI -1 8603,,,net_banking_transfer,-18603
632ae6c52e1a0ebb7f46f59d,50200023535069,760990.39,60ec41ba55c00300382672d9,HDFC,direct expenses,5eecc6d6449e4f7cfb1c2708,2022-06-07T00:00:00.000Z,NEFT DR-PUNB0307800-SANJEEV NIRMANIA-SAN DOZ - MUM-N158221988162988-NET BANKING S I -18665,,,net_banking_transfer,-18665
632ae6c52e1a0ebb7f46f59f,50200023535069,745909.39,60ec41ba55c00300382672d9,HDFC,direct expenses,5eecc6d6449e4f7cfb1c2708,2022-06-07T00:00:00.000Z,NEFT DR-CNRB0019016-MANEESH-SANDOZ - MUM -N158221988162989-NET BANKING SI -15081,,,net_banking_transfer,-15081
632ae6c52e1a0ebb7f46f5a1,50200023535069,730828.39,60ec41ba55c00300382672d9,HDFC,direct expenses,5eecc6d6449e4f7cfb1c2708,2022-06-07T00:00:00.000Z,NEFT DR-IPOS0000001-PANKAJ KUMAR-SANDOZ,,,net_banking_transfer,-15081
632ae6c52e1a0ebb7f46f5a3,50200023535069,947443.87,60ec41ba55c00300382672d9,HDFC,Revenue-Mktplace,5eecc6d6449e4f7cfb1c2708,2022-06-07T00:00:00.000Z,IMPS-215805368303-AMAZON SELLER SERVIC-H SBC-XXXXXXXX6004-5AYNMYV1WTT1T5JJSLICK O RGANICS PVT LTD,shopping,,net_banking_transfer,216615.48
632ae6c52e1a0ebb7f46f5a5,50200023535069,1573492.39,60ec41ba55c00300382672d9,HDFC,Revenue-Mktplace,5eecc6d6449e4f7cfb1c2708,2022-06-07T00:00:00.000Z,NEFT CR-DEUT0797BGL-AMAZON PAY (INDIA) P RIVATE LIMITED-SLICK ORGANICS PVT LTD-21 5800132GN00453,shopping,,net_banking_transfer,626048.52
632ae6c52e1a0ebb7f46f5a7,50200023535069,1583995.83,60ec41ba55c00300382672d9,HDFC,Revenue-PG-non-split,5eecc6d6449e4f7cfb1c2708,2022-06-07T00:00:00.000Z,IMPS-215806461020-PAYTM PAYMENTS SERVI-P YTM-XXXXXXXXXX0008-ALL202206072168200003 30830668628,ewallet,,net_banking_transfer,10503.44
632ae6c52e1a0ebb7f46f5a9,50200023535069,1578995.83,60ec41ba55c00300382672d9,HDFC,direct expenses,5eecc6d6449e4f7cfb1c2708,2022-06-07T00:00:00.000Z,"NEFT DR-PUNB0482100-RAM BHAVAN YADAV-NET BANK, MUM-N158221988338673-5000",,,net_banking_transfer,-5000
632ae6c52e1a0ebb7f46f5ab,50200023535069,1397119.83,60ec41ba55c00300382672d9,HDFC,direct expenses,5eecc6d6449e4f7cfb1c2708,2022-06-07T00:00:00.000Z,50100370748619-TPT-181876-RITIKA SAXENA,,,net_banking_transfer,-181876
632ae6c52e1a0ebb7f46f5ad,50200023535069,1203072.83,60ec41ba55c00300382672d9,HDFC,direct expenses,5eecc6d6449e4f7cfb1c2708,2022-06-07T00:00:00.000Z,"NEFT DR-KKBK0000261-TANVI TANEJA-NETBANK , MUM-N158221988340636-194047",,,net_banking_transfer,-194047
632ae6c52e1a0ebb7f46f5b1,50200023535069,1169236.83,60ec41ba55c00300382672d9,HDFC,direct expenses,5eecc6d6449e4f7cfb1c2708,2022-06-07T00:00:00.000Z,"NEFT DR-UTIB0001720-ANUBHAV RAO-NETBANK, MUM-N158221988340820-33836",,,net_banking_transfer,-33836
632ae6c52e1a0ebb7f46f5b3,50200023535069,1156462.83,60ec41ba55c00300382672d9,HDFC,direct expenses,5eecc6d6449e4f7cfb1c2708,2022-06-07T00:00:00.000Z,"NEFT DR-KKBK0008066-KUSHAGRA SINGH-NETBA NK, MUM-N158221988340910-12774",,,net_banking_transfer,-12774
632ae6c52e1a0ebb7f46f5b5,50200023535069,1125223.83,60ec41ba55c00300382672d9,HDFC,direct expenses,5eecc6d6449e4f7cfb1c2708,2022-06-07T00:00:00.000Z,"NEFT DR-KKBK0000261-AAYUSHI PAREEK-NETBA NK, MUM-N158221988355614-31239",,,net_banking_transfer,-31239
632ae6c52e1a0ebb7f46f5b8,50200023535069,1048098.83,60ec41ba55c00300382672d9,HDFC,direct expenses,5eecc6d6449e4f7cfb1c2708,2022-06-07T00:00:00.000Z,"NEFT DR-SBIN0070392-APARNA MOHANAN KONAT -NETBANK, MUM-N158221988351577-77125",,,net_banking_transfer,-77125
632ae6c52e1a0ebb7f46f5ba,50200023535069,1017972.83,60ec41ba55c00300382672d9,HDFC,direct expenses,5eecc6d6449e4f7cfb1c2708,2022-06-07T00:00:00.000Z,00901610080520-TPT-30126-POOJA KAPIL SHR OTRIYA,,,net_banking_transfer,-30126
632ae6c52e1a0ebb7f46f5bc,50200023535069,836857.83,60ec41ba55c00300382672d9,HDFC,direct expenses,5eecc6d6449e4f7cfb1c2708,2022-06-07T00:00:00.000Z,50100179603876-TPT-181115-APURBA NAYAK,,,net_banking_transfer,-181115
632ae6c52e1a0ebb7f46f5be,50200023535069,818672.83,60ec41ba55c00300382672d9,HDFC,direct expenses,5eecc6d6449e4f7cfb1c2708,2022-06-07T00:00:00.000Z,02711600008220-TPT-18185-VARUN SINGH,,,net_banking_transfer,-18185
632ae6c52e1a0ebb7f46f5c0,50200023535069,803228.83,60ec41ba55c00300382672d9,HDFC,direct expenses,5eecc6d6449e4f7cfb1c2708,2022-06-07T00:00:00.000Z,"NEFT DR-SBIN0017746-MANOJ KUMAR-NETBANK, MUM-N158221988359435-15444",,,net_banking_transfer,-15444
632ae6c52e1a0ebb7f46f5c2,50200023535069,768228.83,60ec41ba55c00300382672d9,HDFC,direct expenses,5eecc6d6449e4f7cfb1c2708,2022-06-07T00:00:00.000Z,"NEFT DR-ICIC0003851-JITENDER KUMAR-NETBA NK, MUM-N158221988402138-35000",,,net_banking_transfer,-35000
632ae6c52e1a0ebb7f46f5c4,50200023535069,773711.83,60ec41ba55c00300382672d9,HDFC,Revenue-PG-split enabled,5eecc6d6449e4f7cfb1c2708,2022-06-07T00:00:00.000Z,NEFT CR-UTIB0001506-RAZORPAY SOFTWARE PR,,,net_banking_transfer,5483
632ae6c52e1a0ebb7f46f5c6,50200023535069,689111.83,60ec41ba55c00300382672d9,HDFC,direct expenses,5eecc6d6449e4f7cfb1c2708,2022-06-07T00:00:00.000Z,"NEFT DR-UTIB0000120-ADNAN ALI-NETBANK, M UM-N158221988625594-84600",,,net_banking_transfer,-84600
632ae6c52e1a0ebb7f46f5c8,50200023535069,473111.83,60ec41ba55c00300382672d9,HDFC,direct expenses,5eecc6d6449e4f7cfb1c2708,2022-06-07T00:00:00.000Z,"NEFT DR-UTIB0000514-NATS ASSOCIATES-NETB ANK, MUM-N158221988635792-216000",,,net_banking_transfer,-216000
632ae6c52e1a0ebb7f46f5ca,50200023535069,460017.83,60ec41ba55c00300382672d9,HDFC,direct expenses,5eecc6d6449e4f7cfb1c2708,2022-06-07T00:00:00.000Z,"NEFT DR-SBIN0008078-PANDIT PLASTICS-NETB ANK, MUM-N158221988690628-13094",,,net_banking_transfer,-13094
632ae6c52e1a0ebb7f46f5cc,50200023535069,465524.07,60ec41ba55c00300382672d9,HDFC,Transfer in/Revenue-other,5eecc6d6449e4f7cfb1c2708,2022-06-07T00:00:00.000Z,NEFT CR-UTIB0000114-ONE SIGMA TECHNOLOGI ES PRIVATE LIM-SLICK ORGANICS PRIVATE LI MITED-AXISP00294038593,insurance,insurance,net_banking_transfer,5506.24
632ae6c52e1a0ebb7f46f5ce,50200023535069,456524.07,60ec41ba55c00300382672d9,HDFC,agency/vendor expense,5eecc6d6449e4f7cfb1c2708,2022-06-07T00:00:00.000Z,"NEFT DR-UTIB0003557-INCOSEC LEGAL-NETBAN K, MUM-N158221988997105-9000",,,net_banking_transfer,-9000
632ae6c52e1a0ebb7f46f5d0,50200023535069,457408.08,60ec41ba55c00300382672d9,HDFC,Revenue-Mktplace,5eecc6d6449e4f7cfb1c2708,2022-06-07T00:00:00.000Z,NEFT CR-ICIC0000105-MANASH LIFESTYLE PRI VATE LIMITED NO-SLICK ORGANICS PRIVATE L IMITED MP G-ICIJ221580008012,shopping,,net_banking_transfer,884.01
632ae6c52e1a0ebb7f46f5d2,50200023535069,457780.46,60ec41ba55c00300382672d9,HDFC,Revenue-Mktplace,5eecc6d6449e4f7cfb1c2708,2022-06-07T00:00:00.000Z,NEFT CR-ICIC0000105-MANASH LIFESTYLE PRI VATE LIMITED NO-SLICK ORGANICS PRIVATE L IMITED KOLK-ICIJ221580008014,shopping,,net_banking_transfer,372.38
632ae6c52e1a0ebb7f46f5d4,50200023535069,537288.97,60ec41ba55c00300382672d9,HDFC,Transfer in/Revenue-other,5eecc6d6449e4f7cfb1c2708,2022-06-07T00:00:00.000Z,"IMPS-215816992408-GOKWIK COMMERCE SOLU-I CIC-XXXXXXXX0630-PAYOUT FOR JUNE 5, 2022",,,net_banking_transfer,79508.51
632ae6c62e1a0ebb7f46f5d6,50200023535069,428246.97,60ec41ba55c00300382672d9,HDFC,direct expenses,5eecc6d6449e4f7cfb1c2708,2022-06-07T00:00:00.000Z,"NEFT DR-YESB0000162-VINAY REDDY-NETBANK, MUM-N158221990345196-109042",,,net_banking_transfer,-109042
632ae6c62e1a0ebb7f46f5d8,50200023535069,357786.97,60ec41ba55c00300382672d9,HDFC,direct expenses,5eecc6d6449e4f7cfb1c2708,2022-06-07T00:00:00.000Z,"NEFT DR-KKBK0000187-APPLIED LIFE PRIVATE LIMITED-NETBANK, MUM-N158221990362916-7 0460",,,net_banking_transfer,-70460
632ae6c62e1a0ebb7f46f5da,50200023535069,399103,60ec41ba55c00300382672d9,HDFC,Revenue-UPI,5eecc6d6449e4f7cfb1c2708,2022-06-07T00:00:00.000Z,"UPI-GOKWIK-GOKWIK@YESBANK-YESB0000340-21 5896585481-PAYOUT FOR JUNE 5,",,,upi,41316.03
632ae6c62e1a0ebb7f46f5dc,50200023535069,392103,60ec41ba55c00300382672d9,HDFC,direct expenses,5eecc6d6449e4f7cfb1c2708,2022-06-07T00:00:00.000Z,50200025384647-TPT-7000-AG POLY PACKS PV T LTD,,,net_banking_transfer,-7000
632ae6c62e1a0ebb7f46f5df,50200023535069,340891,60ec41ba55c00300382672d9,HDFC,direct expenses,5eecc6d6449e4f7cfb1c2708,2022-06-07T00:00:00.000Z,50200025384647-TPT-51212-AG POLY PACKS P VT LTD,,,net_banking_transfer,-51212
632ae6c62e1a0ebb7f46f5e1,50200023535069,354410.45,60ec41ba55c00300382672d9,HDFC,Revenue-PG-split enabled,5eecc6d6449e4f7cfb1c2708,2022-06-07T00:00:00.000Z,NEFT CR-UTIB0001506-RAZORPAY SOFTWARE PR,,,net_banking_transfer,13519.45
632ae6c62e1a0ebb7f46f5e3,50200023535069,364176.19,60ec41ba55c00300382672d9,HDFC,Revenue-Mktplace,5eecc6d6449e4f7cfb1c2708,2022-06-08T00:00:00.000Z,NEFT CR-DEUT0797BGL-FLIPKART INTERNET PR IVATE LIMITED-SLICK ORGANICS PVT LTD-215 900155GN00043,shopping,,net_banking_transfer,9765.74
632ae6c62e1a0ebb7f46f5e5,50200023535069,370620.13,60ec41ba55c00300382672d9,HDFC,Revenue-Mktplace,5eecc6d6449e4f7cfb1c2708,2022-06-08T00:00:00.000Z,NEFT CR-DEUT0797BGL-FLIPKART INTERNET PR IVATE LIMITED-SLICK ORGANICS PVT LTD-215 900168GN00187,shopping,,net_banking_transfer,6443.94
632ae6c62e1a0ebb7f46f5e8,50200023535069,384153.3,60ec41ba55c00300382672d9,HDFC,Revenue-PG-non-split,5eecc6d6449e4f7cfb1c2708,2022-06-08T00:00:00.000Z,IMPS-215905058644-PAYTM PAYMENTS SERVI-P YTM-XXXXXXXXXX0008-ALL202206082168200003 30830668628,ewallet,,net_banking_transfer,13533.17
632ae6c62e1a0ebb7f46f5ea,50200023535069,386548.76,60ec41ba55c00300382672d9,HDFC,Revenue-Mktplace,5eecc6d6449e4f7cfb1c2708,2022-06-08T00:00:00.000Z,NEFT CR-DEUT0797BGL-MYNTRA DESIGNS PRIVA TE LIMITED-SLICK ORGANICS PVT. LTD.-2159 00578GN00008,shopping,,net_banking_transfer,2395.46
632ae6c62e1a0ebb7f46f5ec,50200023535069,392182.02,60ec41ba55c00300382672d9,HDFC,Revenue-Mktplace,5eecc6d6449e4f7cfb1c2708,2022-06-08T00:00:00.000Z,NEFT CR-DEUT0797BGL-MYNTRA DESIGNS PRIVA TE LIMITED-SLICK ORGANICS PVT. LTD.-2159 00577GN00039,shopping,,net_banking_transfer,5633.26
632ae6c62e1a0ebb7f46f5ee,50200023535069,413865.39,60ec41ba55c00300382672d9,HDFC,Revenue-PG-split enabled,5eecc6d6449e4f7cfb1c2708,2022-06-08T00:00:00.000Z,NEFT CR-UTIB0001506-RAZORPAY SOFTWARE PR IVATE LIMITED-SLICK ORGANICS PVT LITD-AX ISCN0147207157,insurance,insurance,net_banking_transfer,21683.37
632ae6c62e1a0ebb7f46f5f0,50200023535069,338865.39,60ec41ba55c00300382672d9,HDFC,agency/vendor expense,5eecc6d6449e4f7cfb1c2708,2022-06-08T00:00:00.000Z,"DD ISSUE - HDFC BANK LT - DEHRADUN-UTT - 032535 - 027113030613 - SENIOR INSPECT OR LEGAL METROLOGY , DEHRADUN",,,demand_draft,-75000
632ae6c62e1a0ebb7f46f5f2,50200023535069,277205.39,60ec41ba55c00300382672d9,HDFC,agency/vendor expense,5eecc6d6449e4f7cfb1c2708,2022-06-08T00:00:00.000Z,"NEFT DR-KKBK0000298-ADMITAD MEDIA PRIVAT E LIMITED-NETBANK, MUM-N159221990733090- 61660",,,net_banking_transfer,-61660
632ae6c62e1a0ebb7f46f5f4,50200023535069,256502.39,60ec41ba55c00300382672d9,HDFC,direct expenses,5eecc6d6449e4f7cfb1c2708,2022-06-08T00:00:00.000Z,"NEFT DR-UTIB0003142-ELIZABETH THALEX-NET BANK, MUM-N159221990833632-20703",,,net_banking_transfer,-20703
632ae6c62e1a0ebb7f46f5f6,50200023535069,271062.86,60ec41ba55c00300382672d9,HDFC,Revenue-Mktplace,5eecc6d6449e4f7cfb1c2708,2022-06-08T00:00:00.000Z,NEFT CR-HSBC0400002-AMAZON SERVICES LLC- SLICK ORGANICS PRIVATE LIMITED-HSBCN2215 9134156,shopping,,net_banking_transfer,14560.47
632ae6c62e1a0ebb7f46f5f8,50200023535069,270062.86,60ec41ba55c00300382672d9,HDFC,direct expenses,5eecc6d6449e4f7cfb1c2708,2022-06-08T00:00:00.000Z,POS 514834XXXXXX9486 RAZ*RAZORPAY SOF,,,debit_card,-1000
632ae6c62e1a0ebb7f46f5fa,50200023535069,269062.86,60ec41ba55c00300382672d9,HDFC,direct expenses,5eecc6d6449e4f7cfb1c2708,2022-06-08T00:00:00.000Z,POS 514834XXXXXX9486 RAZ*RAZORPAY SOF,,,debit_card,-1000
632ae6c62e1a0ebb7f46f5fc,50200023535069,119062.86,60ec41ba55c00300382672d9,HDFC,direct expenses,5eecc6d6449e4f7cfb1c2708,2022-06-08T00:00:00.000Z,"NEFT DR-YESB0000551-VISTTA COSMETICS-NET BANK, MUM-N159221991189084-150000",,,net_banking_transfer,-150000
632ae6c62e1a0ebb7f46f5fe,50200023535069,124062.86,60ec41ba55c00300382672d9,HDFC,Internal Transfers,5eecc6d6449e4f7cfb1c2708,2022-06-08T00:00:00.000Z,IB FUNDS TRANSFER CR-50200035187206 -SL ICK ORGANICS PVT LTD,insurance,insurance,Other,5000
632ae6c62e1a0ebb7f46f601,50200023535069,117455.86,60ec41ba55c00300382672d9,HDFC,direct expenses,5eecc6d6449e4f7cfb1c2708,2022-06-08T00:00:00.000Z,50100097355028-TPT-6607-PALLAVI JUNEJA,,,net_banking_transfer,-6607
632ae6c62e1a0ebb7f46f603,50200023535069,117001.86,60ec41ba55c00300382672d9,HDFC,direct expenses,5eecc6d6449e4f7cfb1c2708,2022-06-08T00:00:00.000Z,"NEFT DR-BARB0VJNAZA-HEENA P TALREJA-NETB ANK, MUM-N159221991216108-454",,,net_banking_transfer,-454
632ae6c62e1a0ebb7f46f605,50200023535069,124744.9,60ec41ba55c00300382672d9,HDFC,Transfer in/Revenue-other,5eecc6d6449e4f7cfb1c2708,2022-06-08T00:00:00.000Z,NEFT CR-UTIB0000114-ONE SIGMA TECHNOLOGI ES PRIVATE LIM-SLICK ORGANICS PRIVATE LI MITED-AXISP00294593183,insurance,insurance,net_banking_transfer,7743.04
632ae6c62e1a0ebb7f46f607,50200023535069,125129.02,60ec41ba55c00300382672d9,HDFC,Revenue-Mktplace,5eecc6d6449e4f7cfb1c2708,2022-06-08T00:00:00.000Z,NEFT CR-ICIC0000105-MANASH LIFESTYLE PRI VATE LIMITED NO-SLICK ORGANICS PRIVATE L IMITED MP G-ICIJ221590006031,shopping,,net_banking_transfer,384.12
632ae6c62e1a0ebb7f46f609,50200023535069,183756.32,60ec41ba55c00300382672d9,HDFC,Transfer in/Revenue-other,5eecc6d6449e4f7cfb1c2708,2022-06-08T00:00:00.000Z,"IMPS-215916323829-GOKWIK COMMERCE SOLU-I CIC-XXXXXXXX0630-PAYOUT FOR JUNE 6, 2022",,,net_banking_transfer,58627.3
632ae6c62e1a0ebb7f46f60b,50200023535069,201268.61,60ec41ba55c00300382672d9,HDFC,Revenue-PG-split enabled,5eecc6d6449e4f7cfb1c2708,2022-06-08T00:00:00.000Z,NEFT CR-UTIB0001506-RAZORPAY SOFTWARE PR IVATE LIMITED-SLICK ORGANICS PVT LITD-AX ISCN0147401314,insurance,insurance,net_banking_transfer,17512.29
632ae6c62e1a0ebb7f46f60d,50200023535069,273793.41,60ec41ba55c00300382672d9,HDFC,Revenue-COD,5eecc6d6449e4f7cfb1c2708,2022-06-08T00:00:00.000Z,NEFT CR-ICIC0000155-SHIPROCKET COD CRF I D 4435532-SLICK ORGANICS PVT LTD-CMS2632 820854,insurance,insurance,net_banking_transfer,72524.8
632ae6c62e1a0ebb7f46f60f,50200023535069,258019.41,60ec41ba55c00300382672d9,HDFC,direct expenses,5eecc6d6449e4f7cfb1c2708,2022-06-08T00:00:00.000Z,50200025384647-TPT-15774-AG POLY PACKS P VT LTD,,,net_banking_transfer,-15774
632ae6c62e1a0ebb7f46f611,50200023535069,259747.79,60ec41ba55c00300382672d9,HDFC,Revenue-UPI,5eecc6d6449e4f7cfb1c2708,2022-06-08T00:00:00.000Z,"UPI-GOKWIK-GOKWIK@YESBANK-YESB0000340-21 5998939689-PAYOUT FOR JUNE 4,",,,upi,1728.38
632ae6c62e1a0ebb7f46f613,50200023535069,277224.73,60ec41ba55c00300382672d9,HDFC,Revenue-PG-non-split,5eecc6d6449e4f7cfb1c2708,2022-06-09T00:00:00.000Z,IMPS-216007706161-PAYTM PAYMENTS SERVI-P YTM-XXXXXXXXXX0008-ALL202206092168200003 30830668628,ewallet,,net_banking_transfer,17476.94
632ae6c62e1a0ebb7f46f615,50200023535069,286734.56,60ec41ba55c00300382672d9,HDFC,Revenue-PG-split enabled,5eecc6d6449e4f7cfb1c2708,2022-06-09T00:00:00.000Z,NEFT CR-UTIB0001506-RAZORPAY SOFTWARE PR,,,net_banking_transfer,9509.83
632ae6c62e1a0ebb7f46f617,50200023535069,333204.56,60ec41ba55c00300382672d9,HDFC,Transfer in/Revenue-other,5eecc6d6449e4f7cfb1c2708,2022-06-09T00:00:00.000Z,FT - CR - 00322000016711 - FORWEST ESTAT ES PVT LTD,,,Other,46470
632ae6c62e1a0ebb7f46f619,50200023535069,268404.56,60ec41ba55c00300382672d9,HDFC,direct expenses,5eecc6d6449e4f7cfb1c2708,2022-06-09T00:00:00.000Z,"NEFT DR-KKBK0001393-MASCOT SPINCONTROL I NDIA PVT LTD-NETBANK, MUM-N1602219926261 43-64800",,,net_banking_transfer,-64800
632ae6c62e1a0ebb7f46f61b,50200023535069,266830.61,60ec41ba55c00300382672d9,HDFC,bank charges,5eecc6d6449e4f7cfb1c2708,2022-06-09T00:00:00.000Z,.DC INTL POS TXN MARKUP+ST 020422 030422 -CDT2215209278210,,,international_transaction_arbitrage,-1573.95
632ae6c62e1a0ebb7f46f61d,50200023535069,272173,60ec41ba55c00300382672d9,HDFC,Transfer in/Revenue-other,5eecc6d6449e4f7cfb1c2708,2022-06-09T00:00:00.000Z,NEFT CR-UTIB0000114-ONE SIGMA TECHNOLOGI ES PRIVATE LIM-SLICK ORGANICS PRIVATE LI MITED-AXISP00294914958,insurance,insurance,net_banking_transfer,5342.39
632ae6c62e1a0ebb7f46f61f,50200023535069,268550,60ec41ba55c00300382672d9,HDFC,direct expenses,5eecc6d6449e4f7cfb1c2708,2022-06-09T00:00:00.000Z,"NEFT DR-BARB0SUSGUR-GREENIECAN INDIA-NET BANK, MUM-N160221992938034-3623",,,net_banking_transfer,-3623
632ae6c62e1a0ebb7f46f621,50200023535069,261222,60ec41ba55c00300382672d9,HDFC,direct expenses,5eecc6d6449e4f7cfb1c2708,2022-06-09T00:00:00.000Z,"NEFT DR-RATN0000156-GIRNAR NEWTEL SOLUTI ONS PVT LTD-NETBANK, MUM-N16022199296849 6-7328",,,net_banking_transfer,-7328
632ae6c62e1a0ebb7f46f623,50200023535069,262965.08,60ec41ba55c00300382672d9,HDFC,Revenue-Mktplace,5eecc6d6449e4f7cfb1c2708,2022-06-09T00:00:00.000Z,NEFT CR-ICIC0000105-MANASH LIFESTYLE PRI VATE LIMITED NO-SLICK ORGANICS PRIVATE L IMITED MP G-ICIJ221600006001,shopping,,net_banking_transfer,1743.08
632ae6c62e1a0ebb7f46f625,50200023535069,271609.15,60ec41ba55c00300382672d9,HDFC,Revenue-PG-split enabled,5eecc6d6449e4f7cfb1c2708,2022-06-09T00:00:00.000Z,NEFT CR-UTIB0001506-RAZORPAY SOFTWARE PR IVATE LIMITED-SLICK ORGANICS PVT LITD-AX ISCN0147652323,insurance,insurance,net_banking_transfer,8644.07
632ae6c62e1a0ebb7f46f628,50200023535069,327413.68,60ec41ba55c00300382672d9,HDFC,Revenue-UPI,5eecc6d6449e4f7cfb1c2708,2022-06-09T00:00:00.000Z,"UPI-GOKWIK-GOKWIK@YESBANK-YESB0000340-21 6001264950-PAYOUT FOR JUNE 7,",,,upi,55804.53
632ae6c62e1a0ebb7f46f62b,50200023535069,333598.22,60ec41ba55c00300382672d9,HDFC,Revenue-Mktplace,5eecc6d6449e4f7cfb1c2708,2022-06-10T00:00:00.000Z,NEFT CR-DEUT0797BGL-FLIPKART INTERNET PR IVATE LIMITED-SLICK ORGANICS PVT LTD-216 100123GN00207,shopping,,net_banking_transfer,6184.54
632ae6c62e1a0ebb7f46f62e,50200023535069,335463.07,60ec41ba55c00300382672d9,HDFC,Revenue-Mktplace,5eecc6d6449e4f7cfb1c2708,2022-06-10T00:00:00.000Z,NEFT CR-DEUT0797BGL-FLIPKART INTERNET PR IVATE LIMITED-SLICK ORGANICS PVT LTD-216 100133GN00208,shopping,,net_banking_transfer,1864.85
632ae6c62e1a0ebb7f46f630,50200023535069,345741.64,60ec41ba55c00300382672d9,HDFC,Revenue-PG-non-split,5eecc6d6449e4f7cfb1c2708,2022-06-10T00:00:00.000Z,IMPS-216106144895-PAYTM PAYMENTS SERVI-P,ewallet,,net_banking_transfer,10278.57
632ae6c62e1a0ebb7f46f632,50200023535069,348035.67,60ec41ba55c00300382672d9,HDFC,Revenue-Mktplace,5eecc6d6449e4f7cfb1c2708,2022-06-10T00:00:00.000Z,NEFT CR-DEUT0797BGL-MYNTRA DESIGNS PRIVA TE LIMITED-SLICK ORGANICS PVT. LTD.-2161 00524GN00281,shopping,,net_banking_transfer,2294.03
632ae6c62e1a0ebb7f46f634,50200023535069,343035.67,60ec41ba55c00300382672d9,HDFC,direct expenses,5eecc6d6449e4f7cfb1c2708,2022-06-10T00:00:00.000Z,"NEFT DR-CNRB0019016-MANEESH-NETBANK, MUM -N161221993955169-5000",,,net_banking_transfer,-5000
632ae6c62e1a0ebb7f46f636,50200023535069,350083.97,60ec41ba55c00300382672d9,HDFC,Revenue-Mktplace,5eecc6d6449e4f7cfb1c2708,2022-06-10T00:00:00.000Z,NEFT CR-DEUT0797BGL-MYNTRA DESIGNS PRIVA TE LIMITED-SLICK ORGANICS PVT. LTD.-2161 00544GN00040,shopping,,net_banking_transfer,7048.3
632ae6c62e1a0ebb7f46f638,50200023535069,363301.93,60ec41ba55c00300382672d9,HDFC,Revenue-PG-split enabled,5eecc6d6449e4f7cfb1c2708,2022-06-10T00:00:00.000Z,NEFT CR-UTIB0001506-RAZORPAY SOFTWARE PR IVATE LIMITED-SLICK ORGANICS PVT LITD-AX ISCN0147749554,insurance,insurance,net_banking_transfer,13217.96
632ae6c62e1a0ebb7f46f63a,50200023535069,436999.05,60ec41ba55c00300382672d9,HDFC,Revenue-UPI,5eecc6d6449e4f7cfb1c2708,2022-06-10T00:00:00.000Z,"UPI-GOKWIK-GOKWIK@YESBANK-YESB0000340-21 6101970551-PAYOUT FOR JUNE 8,",,,upi,73697.12
632ae6c62e1a0ebb7f46f63c,50200023535069,446107.05,60ec41ba55c00300382672d9,HDFC,Revenue-Mktplace,5eecc6d6449e4f7cfb1c2708,2022-06-10T00:00:00.000Z,NEFT CR-ICIC0000985-DIGITAL AGE RETAIL P VT LTD-SLICK ORGANICS PVT LTD DS-CMS26 36737398,,,net_banking_transfer,9108
632ae6c62e1a0ebb7f46f63e,50200023535069,346107.05,60ec41ba55c00300382672d9,HDFC,direct expenses,5eecc6d6449e4f7cfb1c2708,2022-06-10T00:00:00.000Z,"NEFT DR-ICIC0000369-BO INTERNATIONAL-NET BANK, MUM-N161221994254238-100000",,,net_banking_transfer,-100000
632ae6c62e1a0ebb7f46f640,50200023535069,353554.88,60ec41ba55c00300382672d9,HDFC,Transfer in/Revenue-other,5eecc6d6449e4f7cfb1c2708,2022-06-10T00:00:00.000Z,NEFT CR-UTIB0000114-ONE SIGMA TECHNOLOGI ES PRIVATE LIM-SLICK ORGANICS PRIVATE LI MITED-AXISP00295151374,insurance,insurance,net_banking_transfer,7447.83
632ae6c62e1a0ebb7f46f642,50200023535069,283954.88,60ec41ba55c00300382672d9,HDFC,direct expenses,5eecc6d6449e4f7cfb1c2708,2022-06-10T00:00:00.000Z,"NEFT DR-ICIC0000024-TAKE MOTO YOHKI INDI A PRIVATE LIMITED-NETBANK, MUM-N16122199 4487616-69600",travel,,net_banking_transfer,-69600
632ae6c62e1a0ebb7f46f644,50200023535069,284431.66,60ec41ba55c00300382672d9,HDFC,Revenue-PG-non-split,5eecc6d6449e4f7cfb1c2708,2022-06-10T00:00:00.000Z,NEFT CR-YESB0000001-RZPX PVT LTD NODAL A CCOUNT-SLICKORGANICS-N161221268447749,insurance,insurance,net_banking_transfer,476.78
632ae6c62e1a0ebb7f46f646,50200023535069,284938.26,60ec41ba55c00300382672d9,HDFC,Transfer in/Revenue-other,5eecc6d6449e4f7cfb1c2708,2022-06-10T00:00:00.000Z,"IMPS-216116614604-GOKWIK COMMERCE SOLU-I CIC-XXXXXXXX0630-PAYOUT FOR JUNE 8, 2022",,,net_banking_transfer,506.6
632ae6c62e1a0ebb7f46f648,50200023535069,295629.47,60ec41ba55c00300382672d9,HDFC,Revenue-PG-split enabled,5eecc6d6449e4f7cfb1c2708,2022-06-10T00:00:00.000Z,NEFT CR-UTIB0001506-RAZORPAY SOFTWARE PR IVATE LIMITED-SLICK ORGANICS PVT LITD-AX ISCN0147910116,insurance,insurance,net_banking_transfer,10691.21
632ae6c62e1a0ebb7f46f64a,50200023535069,313243.1,60ec41ba55c00300382672d9,HDFC,Revenue-COD,5eecc6d6449e4f7cfb1c2708,2022-06-10T00:00:00.000Z,NEFT CR-ICIC0000155-SHIPROCKET COD CRF I,,,net_banking_transfer,17613.63
632ae6c62e1a0ebb7f46f64c,50200023535069,331336.12,60ec41ba55c00300382672d9,HDFC,Revenue-PG-non-split,5eecc6d6449e4f7cfb1c2708,2022-06-11T00:00:00.000Z,IMPS-216206761342-PAYTM PAYMENTS SERVI-P YTM-XXXXXXXXXX0008-ALL202206112168200003 30830668628,ewallet,,net_banking_transfer,18093.02
632ae6c62e1a0ebb7f46f64e,50200023535069,384928.45,60ec41ba55c00300382672d9,HDFC,Transfer in/Revenue-other,5eecc6d6449e4f7cfb1c2708,2022-06-11T00:00:00.000Z,"IMPS-216216492539-GOKWIK COMMERCE SOLU-I CIC-XXXXXXXX0630-PAYOUT FOR JUNE 9, 2022",,,net_banking_transfer,53592.33
632ae6c62e1a0ebb7f46f650,50200023535069,374928.45,60ec41ba55c00300382672d9,HDFC,direct expenses,5eecc6d6449e4f7cfb1c2708,2022-06-11T00:00:00.000Z,POS 514834XXXXXX9486 RAZ*RAZORPAY SOF,,,debit_card,-10000
632ae6c62e1a0ebb7f46f652,50200023535069,234928.45,60ec41ba55c00300382672d9,HDFC,direct expenses,5eecc6d6449e4f7cfb1c2708,2022-06-11T00:00:00.000Z,POS 514834XXXXXX9486 RAZ*RAZORPAY SOF,,,debit_card,-140000
632ae6c62e1a0ebb7f46f654,50200023535069,275855.48,60ec41ba55c00300382672d9,HDFC,Revenue-PG-non-split,5eecc6d6449e4f7cfb1c2708,2022-06-12T00:00:00.000Z,NEFT CR-PYTM0123456-PAYTM PAYMENTS SERVI CES LIMITED-SLICK ORGANICS PVT LTD-PYTM2 21630927002,insurance,insurance,net_banking_transfer,40927.03
632ae6c62e1a0ebb7f46f656,50200023535069,188631.48,60ec41ba55c00300382672d9,HDFC,Salary/Emp/consultant Expense,5eecc6d6449e4f7cfb1c2708,2022-06-12T00:00:00.000Z,1819783373/EPFO,,,Other,-87224
632ae6c62e1a0ebb7f46f658,50200023535069,241031.52,60ec41ba55c00300382672d9,HDFC,Transfer in/Revenue-other,5eecc6d6449e4f7cfb1c2708,2022-06-12T00:00:00.000Z,"IMPS-216316070463-GOKWIK COMMERCE SOLU-I CIC-XXXXXXXX0630-PAYOUT FOR JUNE 10, 202 2",,,net_banking_transfer,52400.04
632ae6c62e1a0ebb7f46f65a,50200023535069,233433.52,60ec41ba55c00300382672d9,HDFC,direct expenses,5eecc6d6449e4f7cfb1c2708,2022-06-12T00:00:00.000Z,02022119163832/ESIC,,,Other,-7598
632ae6c62e1a0ebb7f46f65c,50200023535069,270646.91,60ec41ba55c00300382672d9,HDFC,Revenue-PG-non-split,5eecc6d6449e4f7cfb1c2708,2022-06-13T00:00:00.000Z,NEFT CR-PYTM0123456-PAYTM PAYMENTS SERVI CES LIMITED-SLICK ORGANICS PVT LTD-PYTM2 21642000523,insurance,insurance,net_banking_transfer,37213.39
632ae6c62e1a0ebb7f46f65e,50200023535069,278504.84,60ec41ba55c00300382672d9,HDFC,Revenue-Mktplace,5eecc6d6449e4f7cfb1c2708,2022-06-13T00:00:00.000Z,NEFT CR-DEUT0797BGL-MYNTRA DESIGNS PRIVA TE LIMITED-SLICK ORGANICS PVT. LTD.-2164 00373GN00090,shopping,,net_banking_transfer,7857.93
632ae6c62e1a0ebb7f46f660,50200023535069,282890.99,60ec41ba55c00300382672d9,HDFC,Revenue-Mktplace,5eecc6d6449e4f7cfb1c2708,2022-06-13T00:00:00.000Z,NEFT CR-DEUT0797BGL-MYNTRA DESIGNS PRIVA TE LIMITED-SLICK ORGANICS PVT. LTD.-2164 00376GN00038,shopping,,net_banking_transfer,4386.15
632ae6c62e1a0ebb7f46f662,50200023535069,444154.16,60ec41ba55c00300382672d9,HDFC,Revenue-PG-split enabled,5eecc6d6449e4f7cfb1c2708,2022-06-13T00:00:00.000Z,NEFT CR-UTIB0001506-RAZORPAY SOFTWARE PR IVATE LIMITED-SLICK ORGANICS PVT LITD-AX ISCN0148219322,insurance,insurance,net_banking_transfer,161263.17
632ae6c62e1a0ebb7f46f664,50200023535069,447853.26,60ec41ba55c00300382672d9,HDFC,Revenue-PG-non-split,5eecc6d6449e4f7cfb1c2708,2022-06-13T00:00:00.000Z,NEFT CR-SCBL0036001-STRIPE INDIA PRIVATE,,,net_banking_transfer,3699.1
632ae6c62e1a0ebb7f46f667,50200023535069,451632.26,60ec41ba55c00300382672d9,HDFC,Transfer in/Revenue-other,5eecc6d6449e4f7cfb1c2708,2022-06-13T00:00:00.000Z,NEFT CR-HSBC0560002-INNOVATIVE RETAIL CO NCEPTS PRIVATE-SLICK ORGANICS PVT LTD-HS BCN22164799296,,,net_banking_transfer,3779
632ae6c62e1a0ebb7f46f669,50200023535069,454211.76,60ec41ba55c00300382672d9,HDFC,Transfer in/Revenue-other,5eecc6d6449e4f7cfb1c2708,2022-06-13T00:00:00.000Z,NEFT CR-HSBC0560002-INNOVATIVE RETAIL CO NCEPTS PRIVATE-SLICK ORGANICS PVT LTD-HS BCN22164799574,,,net_banking_transfer,2579.5
632ae6c62e1a0ebb7f46f66b,50200023535069,457098.76,60ec41ba55c00300382672d9,HDFC,Transfer in/Revenue-other,5eecc6d6449e4f7cfb1c2708,2022-06-13T00:00:00.000Z,NEFT CR-HSBC0560002-INNOVATIVE RETAIL CO NCEPTS PRIVATE-SLICK ORGANICS PVT LTD-HS BCN22164799991,,,net_banking_transfer,2887
632ae6c62e1a0ebb7f46f66d,50200023535069,456168.76,60ec41ba55c00300382672d9,HDFC,direct expenses,5eecc6d6449e4f7cfb1c2708,2022-06-13T00:00:00.000Z,POS 514834XXXXXX9486 RAZ*BERKOWITS HA,,,debit_card,-930
632ae6c62e1a0ebb7f46f66f,50200023535069,456515.35,60ec41ba55c00300382672d9,HDFC,Transfer in/Revenue-other,5eecc6d6449e4f7cfb1c2708,2022-06-13T00:00:00.000Z,4060002409-11 06 2022-HDFAZCUR1,,,Other,346.59
632ae6c62e1a0ebb7f46f671,50200023535069,411083.35,60ec41ba55c00300382672d9,HDFC,direct expenses,5eecc6d6449e4f7cfb1c2708,2022-06-13T00:00:00.000Z,"NEFT DR-INDB0000004-GATI KINTETSU EXPRES S PVT LTD-NETBANK, MUM-N164221997427744- 45432",,,net_banking_transfer,-45432
632ae6c72e1a0ebb7f46f673,50200023535069,410144.35,60ec41ba55c00300382672d9,HDFC,direct expenses,5eecc6d6449e4f7cfb1c2708,2022-06-13T00:00:00.000Z,POS 514834XXXXXX9486 RSP*NYKAA,,,debit_card,-939
632ae6c72e1a0ebb7f46f676,50200023535069,423455.87,60ec41ba55c00300382672d9,HDFC,Transfer in/Revenue-other,5eecc6d6449e4f7cfb1c2708,2022-06-13T00:00:00.000Z,NEFT CR-UTIB0000114-ONE SIGMA TECHNOLOGI ES PRIVATE LIM-SLICK ORGANICS PRIVATE LI MITED-AXISP00295598070,insurance,insurance,net_banking_transfer,13311.52
632ae6c72e1a0ebb7f46f679,50200023535069,431433.48,60ec41ba55c00300382672d9,HDFC,Transfer in/Revenue-other,5eecc6d6449e4f7cfb1c2708,2022-06-13T00:00:00.000Z,NEFT CR-UTIB0000114-ONE SIGMA TECHNOLOGI ES PRIVATE LIM-SLICK ORGANICS PRIVATE LI MITED-AXISP00295598134,insurance,insurance,net_banking_transfer,7977.61
632ae6c72e1a0ebb7f46f67b,50200023535069,436955.04,60ec41ba55c00300382672d9,HDFC,Transfer in/Revenue-other,5eecc6d6449e4f7cfb1c2708,2022-06-13T00:00:00.000Z,NEFT CR-UTIB0000114-ONE SIGMA TECHNOLOGI ES PRIVATE LIM-SLICK ORGANICS PRIVATE LI MITED-AXISP00295598264,insurance,insurance,net_banking_transfer,5521.56
632ae6c72e1a0ebb7f46f67d,50200023535069,447645.18,60ec41ba55c00300382672d9,HDFC,Revenue-Mktplace,5eecc6d6449e4f7cfb1c2708,2022-06-13T00:00:00.000Z,NEFT CR-DEUT0797BGL-FLIPKART INTERNET PR IVATE LIMITED-SLICK ORGANICS PVT LTD-216 401378GN00261,shopping,,net_banking_transfer,10690.14
632ae6c72e1a0ebb7f46f67f,50200023535069,635998.3,60ec41ba55c00300382672d9,HDFC,Transfer in/Revenue-other,5eecc6d6449e4f7cfb1c2708,2022-06-13T00:00:00.000Z,"IMPS-216416882460-GOKWIK COMMERCE SOLU-I CIC-XXXXXXXX0630-PAYOUT FOR JUNE 11, 202 2",,,net_banking_transfer,188353.12
632ae6c72e1a0ebb7f46f681,50200023535069,637229.61,60ec41ba55c00300382672d9,HDFC,Revenue-Mktplace,5eecc6d6449e4f7cfb1c2708,2022-06-13T00:00:00.000Z,4060002353-TIMES INTERNET LIMITED NODAL,,,Other,1231.31
632ae6c72e1a0ebb7f46f685,50200023535069,646747.98,60ec41ba55c00300382672d9,HDFC,Revenue-PG-split enabled,5eecc6d6449e4f7cfb1c2708,2022-06-13T00:00:00.000Z,NEFT CR-UTIB0001506-RAZORPAY SOFTWARE PR,,,net_banking_transfer,9518.37
632ae6c72e1a0ebb7f46f687,50200023535069,781031.46,60ec41ba55c00300382672d9,HDFC,Revenue-COD,5eecc6d6449e4f7cfb1c2708,2022-06-13T00:00:00.000Z,NEFT CR-KKBK0000958-BIGFOOT RETAIL SOLUT IONS PRIVATE LIMITED-SLICK ORGANICS PVT LTD-KKBK221643212697,,,net_banking_transfer,134283.48
632ae6c72e1a0ebb7f46f689,50200023535069,975483.45,60ec41ba55c00300382672d9,HDFC,Revenue-Mktplace,5eecc6d6449e4f7cfb1c2708,2022-06-14T00:00:00.000Z,IMPS-216505016609-AMAZON SELLER SERVIC-H SBC-XXXXXXXX6004-7FPEGOQL4CHLGXASSLICK O RGANICS PVT LTD,shopping,,net_banking_transfer,194451.99
632ae6c72e1a0ebb7f46f68b,50200023535069,983057.37,60ec41ba55c00300382672d9,HDFC,Revenue-PG-non-split,5eecc6d6449e4f7cfb1c2708,2022-06-14T00:00:00.000Z,IMPS-216505005025-PAYTM PAYMENTS SERVI-P YTM-XXXXXXXXXX0008-ALL202206142168200003 30830668628,ewallet,,net_banking_transfer,7573.92
632ae6c72e1a0ebb7f46f68d,50200023535069,1708091.65,60ec41ba55c00300382672d9,HDFC,Revenue-Mktplace,5eecc6d6449e4f7cfb1c2708,2022-06-14T00:00:00.000Z,NEFT CR-DEUT0797BGL-AMAZON PAY (INDIA) P RIVATE LIMITED-SLICK ORGANICS PVT LTD-21 6500124GN00124,shopping,,net_banking_transfer,725034.28
632ae6c72e1a0ebb7f46f68f,50200023535069,708091.65,60ec41ba55c00300382672d9,HDFC,Marketing Expense,5eecc6d6449e4f7cfb1c2708,2022-06-14T00:00:00.000Z,"NEFT DR-CITI0000006-FACEBOOK INDIA ONLIN E SERVICES PVT LTD-NETBANK, MUM-N1652219 98412592-1000000",,,net_banking_transfer,-1000000
632ae6c72e1a0ebb7f46f691,50200023535069,723508.83,60ec41ba55c00300382672d9,HDFC,Revenue-PG-split enabled,5eecc6d6449e4f7cfb1c2708,2022-06-14T00:00:00.000Z,NEFT CR-UTIB0001506-RAZORPAY SOFTWARE PR IVATE LIMITED-SLICK ORGANICS PVT LITD-AX ISCN0148460115,insurance,insurance,net_banking_transfer,15417.18
632ae6c72e1a0ebb7f46f693,50200023535069,726313.83,60ec41ba55c00300382672d9,HDFC,Transfer in/Revenue-other,5eecc6d6449e4f7cfb1c2708,2022-06-14T00:00:00.000Z,NEFT CR-HSBC0110005-HOUSE OF BEAUTY PRIV ATE LIMITED-SLICK ORGANICS PVT LTD-HSBCN 22165932033,,,net_banking_transfer,2805
632ae6c72e1a0ebb7f46f695,50200023535069,729439.87,60ec41ba55c00300382672d9,HDFC,Revenue-PG-non-split,5eecc6d6449e4f7cfb1c2708,2022-06-14T00:00:00.000Z,NEFT CR-SCBL0036001-STRIPE INDIA PRIVATE -SLICK ORGANICS PRIVATE LIMITED-SSG17413 Q0702118,insurance,insurance,net_banking_transfer,3126.04
632ae6c72e1a0ebb7f46f697,50200023535069,704439.87,60ec41ba55c00300382672d9,HDFC,direct expenses,5eecc6d6449e4f7cfb1c2708,2022-06-14T00:00:00.000Z,POS 514834XXXXXX9486 RAZ*RAZORPAY SOF,,,debit_card,-25000
632ae6c72e1a0ebb7f46f699,50200023535069,706615.29,60ec41ba55c00300382672d9,HDFC,Transfer in/Revenue-other,5eecc6d6449e4f7cfb1c2708,2022-06-14T00:00:00.000Z,NEFT CR-UTIB0000114-ONE SIGMA TECHNOLOGI ES PRIVATE LIM-SLICK ORGANICS PRIVATE LI MITED-AXISP00295932204,insurance,insurance,net_banking_transfer,2175.42
632ae6c72e1a0ebb7f46f69b,50200023535069,681615.29,60ec41ba55c00300382672d9,HDFC,direct expenses,5eecc6d6449e4f7cfb1c2708,2022-06-14T00:00:00.000Z,POS 514834XXXXXX9486 WORLDLINE EPAYME,,,debit_card,-25000
632ae6c72e1a0ebb7f46f69d,50200023535069,633215.29,60ec41ba55c00300382672d9,HDFC,direct expenses,5eecc6d6449e4f7cfb1c2708,2022-06-14T00:00:00.000Z,NEFT DR-UTIB0000032-SKUMAR MULTIPRODUCTS,,,net_banking_transfer,-48400
632ae6c72e1a0ebb7f46f6a1,50200023535069,536015.29,60ec41ba55c00300382672d9,HDFC,direct expenses,5eecc6d6449e4f7cfb1c2708,2022-06-14T00:00:00.000Z,00321000085687-TPT-97200-SAMEER AHUJA,,,net_banking_transfer,-97200
632ae6c72e1a0ebb7f46f6a3,50200023535069,426838.29,60ec41ba55c00300382672d9,HDFC,direct expenses,5eecc6d6449e4f7cfb1c2708,2022-06-14T00:00:00.000Z,00921000075586-TPT-109177-ROET BINDRA,,,net_banking_transfer,-109177
632ae6c72e1a0ebb7f46f6a5,50200023535069,426754.29,60ec41ba55c00300382672d9,HDFC,direct expenses,5eecc6d6449e4f7cfb1c2708,2022-06-14T00:00:00.000Z,POS 514834XXXXXX9486 SMARTSHIFT LOGIS,,,debit_card,-84
632ae6c72e1a0ebb7f46f6a8,50200023535069,610668.05,60ec41ba55c00300382672d9,HDFC,Revenue-UPI,5eecc6d6449e4f7cfb1c2708,2022-06-14T00:00:00.000Z,UPI-GOKWIK-GOKWIK@YESBANK-YESB0000340-21 6510322129-PAYOUT FOR JUNE 12,,,upi,183913.76
632ae6c72e1a0ebb7f46f6aa,50200023535069,619178.28,60ec41ba55c00300382672d9,HDFC,Transfer in/Revenue-other,5eecc6d6449e4f7cfb1c2708,2022-06-14T00:00:00.000Z,"IMPS-216516079295-GOKWIK COMMERCE SOLU-I CIC-XXXXXXXX0630-PAYOUT FOR JUNE 12, 202 2",,,net_banking_transfer,8510.23
632ae6c72e1a0ebb7f46f6ac,50200023535069,619879.78,60ec41ba55c00300382672d9,HDFC,Revenue-Mktplace,5eecc6d6449e4f7cfb1c2708,2022-06-14T00:00:00.000Z,NEFT CR-ICIC0000105-MANASH LIFESTYLE PRI VATE LIMITED NO-SLICK ORGANICS PRIVATE L IMITED MP G-ICIJ221650004430,shopping,,net_banking_transfer,701.5
632ae6c72e1a0ebb7f46f6ae,50200023535069,636169.59,60ec41ba55c00300382672d9,HDFC,Revenue-PG-split enabled,5eecc6d6449e4f7cfb1c2708,2022-06-14T00:00:00.000Z,NEFT CR-UTIB0001506-RAZORPAY SOFTWARE PR IVATE LIMITED-SLICK ORGANICS PVT LITD-AX ISCN0148613286,insurance,insurance,net_banking_transfer,16289.81
632ae6c72e1a0ebb7f46f6b0,50200023535069,636704.9,60ec41ba55c00300382672d9,HDFC,Revenue-UPI,5eecc6d6449e4f7cfb1c2708,2022-06-14T00:00:00.000Z,"UPI-GOKWIK-GOKWIK@YESBANK-YESB0000340-21 6510770105-PAYOUT FOR MAY 27,",,,upi,535.31
632ae6c72e1a0ebb7f46f6b2,50200023535069,642582.82,60ec41ba55c00300382672d9,HDFC,Revenue-PG-non-split,5eecc6d6449e4f7cfb1c2708,2022-06-15T00:00:00.000Z,IMPS-216605353143-PAYTM PAYMENTS SERVI-P YTM-XXXXXXXXXX0008-ALL202206152168200003 30830668628,ewallet,,net_banking_transfer,5877.92
632ae6c72e1a0ebb7f46f6b5,50200023535069,647267.96,60ec41ba55c00300382672d9,HDFC,Revenue-Mktplace,5eecc6d6449e4f7cfb1c2708,2022-06-15T00:00:00.000Z,NEFT CR-DEUT0797BGL-MYNTRA DESIGNS PRIVA TE LIMITED-SLICK ORGANICS PVT. LTD.-2166 00529GN00006,shopping,,net_banking_transfer,4685.14
632ae6c72e1a0ebb7f46f6b7,50200023535069,654188.39,60ec41ba55c00300382672d9,HDFC,Revenue-Mktplace,5eecc6d6449e4f7cfb1c2708,2022-06-15T00:00:00.000Z,NEFT CR-DEUT0797BGL-MYNTRA DESIGNS PRIVA TE LIMITED-SLICK ORGANICS PVT. LTD.-2166 00528GN00081,shopping,,net_banking_transfer,6920.43
632ae6c72e1a0ebb7f46f6b9,50200023535069,604188.39,60ec41ba55c00300382672d9,HDFC,direct expenses,5eecc6d6449e4f7cfb1c2708,2022-06-15T00:00:00.000Z,POS 514834XXXXXX9486 RAZ*RAZORPAY SOF,,,debit_card,-50000
632ae6c72e1a0ebb7f46f6bb,50200023535069,612591.17,60ec41ba55c00300382672d9,HDFC,Revenue-PG-split enabled,5eecc6d6449e4f7cfb1c2708,2022-06-15T00:00:00.000Z,NEFT CR-UTIB0001506-RAZORPAY SOFTWARE PR IVATE LIMITED-SLICK ORGANICS PVT LITD-AX ISCN0148678234,insurance,insurance,net_banking_transfer,8402.78
632ae6c72e1a0ebb7f46f6bd,50200023535069,384611.17,60ec41ba55c00300382672d9,HDFC,direct expenses,5eecc6d6449e4f7cfb1c2708,2022-06-15T00:00:00.000Z,NEFT DR-ICIC0000024-TAKE MOTO YOHKI INDI,travel,,net_banking_transfer,-227980
632ae6c72e1a0ebb7f46f6bf,50200023535069,372053.85,60ec41ba55c00300382672d9,HDFC,bank charges,5eecc6d6449e4f7cfb1c2708,2022-06-15T00:00:00.000Z,.DC INTL POS TXN MARKUP+ST 150422 160422 -CDT2215209278210,,,international_transaction_arbitrage,-12557.32
632ae6c72e1a0ebb7f46f6c1,50200023535069,371334.85,60ec41ba55c00300382672d9,HDFC,direct expenses,5eecc6d6449e4f7cfb1c2708,2022-06-15T00:00:00.000Z,POS 514834XXXXXX9486 ONE97 COMMUNICAT,ewallet,,debit_card,-719
632ae6c72e1a0ebb7f46f6c3,50200023535069,361334.85,60ec41ba55c00300382672d9,HDFC,direct expenses,5eecc6d6449e4f7cfb1c2708,2022-06-15T00:00:00.000Z,"NEFT DR-ICIC0000021-AKHILESH DIXIT-NETBA NK, MUM-N166222000248752-10000",,,net_banking_transfer,-10000
632ae6c72e1a0ebb7f46f6c5,50200023535069,350021.85,60ec41ba55c00300382672d9,HDFC,direct expenses,5eecc6d6449e4f7cfb1c2708,2022-06-15T00:00:00.000Z,"NEFT DR-SIBL0000555-JAIVEER KUMAR-NETBAN K, MUM-N166222000261939-11313",,,net_banking_transfer,-11313
632ae6c72e1a0ebb7f46f6c7,50200023535069,347799.85,60ec41ba55c00300382672d9,HDFC,direct expenses,5eecc6d6449e4f7cfb1c2708,2022-06-15T00:00:00.000Z,"NEFT DR-CNRB0019016-MANEESH-NETBANK, MUM -N166222000270833-2222",,,net_banking_transfer,-2222
632ae6c72e1a0ebb7f46f6c9,50200023535069,331989.85,60ec41ba55c00300382672d9,HDFC,direct expenses,5eecc6d6449e4f7cfb1c2708,2022-06-15T00:00:00.000Z,"NEFT DR-KKBK0000173-NITISH KUMAR MANDAL- NETBANK, MUM-N166222000276915-15810",,,net_banking_transfer,-15810
632ae6c72e1a0ebb7f46f6cc,50200023535069,333005.05,60ec41ba55c00300382672d9,HDFC,Revenue-Mktplace,5eecc6d6449e4f7cfb1c2708,2022-06-15T00:00:00.000Z,NEFT CR-ICIC0000105-MANASH LIFESTYLE PRI VATE LIMITED NO-SLICK ORGANICS PRIVATE L IMITED MP G-ICIJ221660005005,shopping,,net_banking_transfer,1015.2
632ae6c72e1a0ebb7f46f6ce,50200023535069,331421.07,60ec41ba55c00300382672d9,HDFC,bank charges,5eecc6d6449e4f7cfb1c2708,2022-06-15T00:00:00.000Z,.DC INTL POS TXN MARKUP+ST 160422 180422 -CDT2215209278210,,,international_transaction_arbitrage,-1583.98
632ae6c72e1a0ebb7f46f6d0,50200023535069,336208.85,60ec41ba55c00300382672d9,HDFC,Transfer in/Revenue-other,5eecc6d6449e4f7cfb1c2708,2022-06-15T00:00:00.000Z,NEFT CR-UTIB0000114-ONE SIGMA TECHNOLOGI ES PRIVATE LIM-SLICK ORGANICS PRIVATE LI MITED-AXISP00296144225,insurance,insurance,net_banking_transfer,4787.78
632ae6c72e1a0ebb7f46f6d2,50200023535069,334091.85,60ec41ba55c00300382672d9,HDFC,direct expenses,5eecc6d6449e4f7cfb1c2708,2022-06-15T00:00:00.000Z,POS 514834XXXXXX9486 SMARTSHIFT LOGIS,,,debit_card,-2117
632ae6c72e1a0ebb7f46f6d4,50200023535069,349667.67,60ec41ba55c00300382672d9,HDFC,Revenue-COD,5eecc6d6449e4f7cfb1c2708,2022-06-15T00:00:00.000Z,NEFT CR-ICIC0000155-SHIPROCKET COD CRF I D 4468308-SLICK ORGANICS PVT LTD-CMS2645 469792,insurance,insurance,net_banking_transfer,15575.82
632ae6c72e1a0ebb7f46f6d6,50200023535069,599203.67,60ec41ba55c00300382672d9,HDFC,Transfer in/Revenue-other,5eecc6d6449e4f7cfb1c2708,2022-06-15T00:00:00.000Z,BP1022212384-15 06 2022-HD00713732,,,Other,249536
632ae6c72e1a0ebb7f46f6d8,50200023535069,609742.49,60ec41ba55c00300382672d9,HDFC,Revenue-PG-split enabled,5eecc6d6449e4f7cfb1c2708,2022-06-15T00:00:00.000Z,NEFT CR-UTIB0001506-RAZORPAY SOFTWARE PR IVATE LIMITED-SLICK ORGANICS PVT LITD-AX ISCN0148808567,insurance,insurance,net_banking_transfer,10538.82
632ae6c72e1a0ebb7f46f6da,50200023535069,676826.83,60ec41ba55c00300382672d9,HDFC,Revenue-UPI,5eecc6d6449e4f7cfb1c2708,2022-06-15T00:00:00.000Z,UPI-GOKWIK-GOKWIK@YESBANK-YESB0000340-21 6613107875-PAYOUT FOR JUNE 13,,,upi,67084.34
632ae6c72e1a0ebb7f46f6dc,50200023535069,687773.91,60ec41ba55c00300382672d9,HDFC,Transfer in/Revenue-other,5eecc6d6449e4f7cfb1c2708,2022-06-15T00:00:00.000Z,FT- ARATA-50200053251420 - OCTAVOS ENTER,,,Other,10947.08
632ae6c72e1a0ebb7f46f6de,50200023535069,694598.97,60ec41ba55c00300382672d9,HDFC,Revenue-PG-non-split,5eecc6d6449e4f7cfb1c2708,2022-06-16T00:00:00.000Z,IMPS-216705641653-PAYTM PAYMENTS SERVI-P YTM-XXXXXXXXXX0008-ALL202206162168200003 30830668628,ewallet,,net_banking_transfer,6825.06
632ae6c72e1a0ebb7f46f6e0,50200023535069,697268.97,60ec41ba55c00300382672d9,HDFC,Revenue-Mktplace,5eecc6d6449e4f7cfb1c2708,2022-06-16T00:00:00.000Z,NEFT CR-SCBL0036001-M/S DREAMPLUG TECHNO -SLICK ORGANICS PRIVATE LIMITEDSLICK-SIN 31436Q0042336,insurance,insurance,net_banking_transfer,2670
632ae6c72e1a0ebb7f46f6e2,50200023535069,704666.81,60ec41ba55c00300382672d9,HDFC,Revenue-PG-split enabled,5eecc6d6449e4f7cfb1c2708,2022-06-16T00:00:00.000Z,NEFT CR-UTIB0001506-RAZORPAY SOFTWARE PR IVATE LIMITED-SLICK ORGANICS PVT LITD-AX ISCN0148900960,insurance,insurance,net_banking_transfer,7397.84
632ae6c72e1a0ebb7f46f6e4,50200023535069,504666.81,60ec41ba55c00300382672d9,HDFC,direct expenses,5eecc6d6449e4f7cfb1c2708,2022-06-16T00:00:00.000Z,POS 514834XXXXXX9486 RAZ*RAZORPAY SOF,,,debit_card,-200000
632ae6c72e1a0ebb7f46f6e6,50200023535069,504381.81,60ec41ba55c00300382672d9,HDFC,direct expenses,5eecc6d6449e4f7cfb1c2708,2022-06-16T00:00:00.000Z,POS 514834XXXXXX9486 RAZ*SMARTSHIFT L,,,debit_card,-285
632ae6c72e1a0ebb7f46f6e8,50200023535069,354381.81,60ec41ba55c00300382672d9,HDFC,direct expenses,5eecc6d6449e4f7cfb1c2708,2022-06-16T00:00:00.000Z,"NEFT DR-YESB0000551-VISTTA COSMETICS-NET BANK, MUM-N167222001599936-150000",,,net_banking_transfer,-150000
632ae6c72e1a0ebb7f46f6ec,50200023535069,204381.81,60ec41ba55c00300382672d9,HDFC,direct expenses,5eecc6d6449e4f7cfb1c2708,2022-06-16T00:00:00.000Z,"NEFT DR-IDFB0040101-ACTIVES ADDITIVES AP PLICATIONS LLP-NETBANK, MUM-N16722200162 0464-150000",insurance,insurance,net_banking_transfer,-150000
632ae6c72e1a0ebb7f46f6ee,50200023535069,154381.81,60ec41ba55c00300382672d9,HDFC,SAAS/tech expense,5eecc6d6449e4f7cfb1c2708,2022-06-16T00:00:00.000Z,POS 514834XXXXXX9486 AMAZON,shopping,,debit_card,-50000
632ae6c72e1a0ebb7f46f6f0,50200023535069,155222.55,60ec41ba55c00300382672d9,HDFC,Revenue-Mktplace,5eecc6d6449e4f7cfb1c2708,2022-06-16T00:00:00.000Z,NEFT CR-ICIC0000105-MANASH LIFESTYLE PRI VATE LIMITED NO-SLICK ORGANICS PRIVATE L IMITED MP G-ICIJ221670002628,shopping,,net_banking_transfer,840.74
632ae6c72e1a0ebb7f46f6f2,50200023535069,154104.55,60ec41ba55c00300382672d9,HDFC,direct expenses,5eecc6d6449e4f7cfb1c2708,2022-06-16T00:00:00.000Z,POS 514834XXXXXX9486 SMARTSHIFT LOGIS,,,debit_card,-1118
632ae6c72e1a0ebb7f46f6f4,50200023535069,156304.96,60ec41ba55c00300382672d9,HDFC,Transfer in/Revenue-other,5eecc6d6449e4f7cfb1c2708,2022-06-16T00:00:00.000Z,NEFT CR-UTIB0000114-ONE SIGMA TECHNOLOGI ES PRIVATE LIM-SLICK ORGANICS PRIVATE LI MITED-AXISP00296448692,insurance,insurance,net_banking_transfer,2200.41
632ae6c72e1a0ebb7f46f6f6,50200023535069,154962.96,60ec41ba55c00300382672d9,HDFC,direct expenses,5eecc6d6449e4f7cfb1c2708,2022-06-16T00:00:00.000Z,POS 514834XXXXXX9486 SMARTSHIFT LOGIS,,,debit_card,-1342
632ae6c72e1a0ebb7f46f6f8,50200023535069,167150.47,60ec41ba55c00300382672d9,HDFC,Revenue-PG-split enabled,5eecc6d6449e4f7cfb1c2708,2022-06-16T00:00:00.000Z,NEFT CR-UTIB0001506-RAZORPAY SOFTWARE PR IVATE LIMITED-SLICK ORGANICS PVT LITD-AX ISCN0149043364,insurance,insurance,net_banking_transfer,12187.51
632ae6c72e1a0ebb7f46f6fa,50200023535069,216972.3,60ec41ba55c00300382672d9,HDFC,Revenue-UPI,5eecc6d6449e4f7cfb1c2708,2022-06-16T00:00:00.000Z,UPI-GOKWIK-GOKWIK@YESBANK-YESB0000340-21 6715639398-PAYOUT FOR JUNE 14,,,upi,49821.83
632ae6c72e1a0ebb7f46f6fc,50200023535069,237683.25,60ec41ba55c00300382672d9,HDFC,Revenue-Mktplace,5eecc6d6449e4f7cfb1c2708,2022-06-17T00:00:00.000Z,NEFT CR-DEUT0797BGL-FLIPKART INTERNET PR,shopping,,net_banking_transfer,20710.95
632ae6c72e1a0ebb7f46f6fe,50200023535069,241196.09,60ec41ba55c00300382672d9,HDFC,Revenue-Mktplace,5eecc6d6449e4f7cfb1c2708,2022-06-17T00:00:00.000Z,NEFT CR-DEUT0797BGL-FLIPKART INTERNET PR IVATE LIMITED-SLICK ORGANICS PVT LTD-216 800165GN00282,shopping,,net_banking_transfer,3512.84
632ae6c72e1a0ebb7f46f700,50200023535069,191196.09,60ec41ba55c00300382672d9,HDFC,SAAS/tech expense,5eecc6d6449e4f7cfb1c2708,2022-06-17T00:00:00.000Z,POS 514834XXXXXX9486 AMAZON,shopping,,debit_card,-50000
632ae6c72e1a0ebb7f46f702,50200023535069,200768.09,60ec41ba55c00300382672d9,HDFC,Revenue-PG-non-split,5eecc6d6449e4f7cfb1c2708,2022-06-17T00:00:00.000Z,NEFT CR-PYTM0123456-PAYTM PAYMENTS SERVI CES LIMITED-SLICK ORGANICS PVT LTD-PYTM2 21686179644,insurance,insurance,net_banking_transfer,9572
632ae6c72e1a0ebb7f46f704,50200023535069,155768.09,60ec41ba55c00300382672d9,HDFC,direct expenses,5eecc6d6449e4f7cfb1c2708,2022-06-17T00:00:00.000Z,50100052049836-TPT-45000-RAVI KULSRESHTH A,,,net_banking_transfer,-45000
632ae6c72e1a0ebb7f46f706,50200023535069,153728.09,60ec41ba55c00300382672d9,HDFC,direct expenses,5eecc6d6449e4f7cfb1c2708,2022-06-17T00:00:00.000Z,"NEFT DR-HSBC0110002-SIMRAN AGGARWAL-NETB ANK, MUM-N168222002778664-2040",,,net_banking_transfer,-2040
632ae6c72e1a0ebb7f46f708,50200023535069,141628.09,60ec41ba55c00300382672d9,HDFC,direct expenses,5eecc6d6449e4f7cfb1c2708,2022-06-17T00:00:00.000Z,"NEFT DR-ICIC0006956-LAKSHAY CARRYING COR PORATION-NETBANK, MUM-N168222002787332-1 2100",,,net_banking_transfer,-12100
632ae6c72e1a0ebb7f46f70a,50200023535069,133283.09,60ec41ba55c00300382672d9,HDFC,direct expenses,5eecc6d6449e4f7cfb1c2708,2022-06-17T00:00:00.000Z,"NEFT DR-INDB0000004-GATI KINTETSU EXPRES S PVT LTD-NETBANK, MUM-N168222002813362- 8345",,,net_banking_transfer,-8345
632ae6c72e1a0ebb7f46f70c,50200023535069,147763.58,60ec41ba55c00300382672d9,HDFC,Revenue-PG-split enabled,5eecc6d6449e4f7cfb1c2708,2022-06-17T00:00:00.000Z,NEFT CR-UTIB0001506-RAZORPAY SOFTWARE PR IVATE LIMITED-SLICK ORGANICS PVT LITD-AX ISCN0149124746,insurance,insurance,net_banking_transfer,14480.49
632ae6c72e1a0ebb7f46f70e,50200023535069,147490.58,60ec41ba55c00300382672d9,HDFC,direct expenses,5eecc6d6449e4f7cfb1c2708,2022-06-17T00:00:00.000Z,POS 514834XXXXXX9486 SMARTSHIFT LOGIS,,,debit_card,-273
632ae6c72e1a0ebb7f46f710,50200023535069,150949.65,60ec41ba55c00300382672d9,HDFC,Transfer in/Revenue-other,5eecc6d6449e4f7cfb1c2708,2022-06-17T00:00:00.000Z,NEFT CR-UTIB0000114-ONE SIGMA TECHNOLOGI ES PRIVATE LIM-SLICK ORGANICS PRIVATE LI MITED-AXISP00296687402,insurance,insurance,net_banking_transfer,3459.07
632ae6c72e1a0ebb7f46f712,50200023535069,152906.8,60ec41ba55c00300382672d9,HDFC,Revenue-Mktplace,5eecc6d6449e4f7cfb1c2708,2022-06-17T00:00:00.000Z,NEFT CR-DEUT0797BGL-MYNTRA DESIGNS PRIVA TE LIMITED-SLICK ORGANICS PVT. LTD.-2168 00956GN00300,shopping,,net_banking_transfer,1957.15
632ae6c82e1a0ebb7f46f714,50200023535069,161180.11,60ec41ba55c00300382672d9,HDFC,Revenue-Mktplace,5eecc6d6449e4f7cfb1c2708,2022-06-17T00:00:00.000Z,NEFT CR-DEUT0797BGL-MYNTRA DESIGNS PRIVA,shopping,,net_banking_transfer,8273.31
632ae6c82e1a0ebb7f46f716,50200023535069,231905.21,60ec41ba55c00300382672d9,HDFC,Revenue-Mktplace,5eecc6d6449e4f7cfb1c2708,2022-06-17T00:00:00.000Z,NEFT CR-KKBK0000958-NYKAA E RETAIL PRIVA TE LIMITED NYKAA-SLICK ORGANICS PVT LTD- KKBK221684208207,insurance,insurance,net_banking_transfer,70725.1
632ae6c82e1a0ebb7f46f718,50200023535069,235215.47,60ec41ba55c00300382672d9,HDFC,Revenue-Mktplace,5eecc6d6449e4f7cfb1c2708,2022-06-17T00:00:00.000Z,NEFT CR-ICIC0000105-MANASH LIFESTYLE PRI VATE LIMITED NO-SLICK ORGANICS PRIVATE L IMITED MP G-ICIJ221680003350,shopping,,net_banking_transfer,3310.26
632ae6c82e1a0ebb7f46f71a,50200023535069,243660.29,60ec41ba55c00300382672d9,HDFC,Revenue-PG-split enabled,5eecc6d6449e4f7cfb1c2708,2022-06-17T00:00:00.000Z,NEFT CR-UTIB0001506-RAZORPAY SOFTWARE PR IVATE LIMITED-SLICK ORGANICS PVT LITD-AX ISCN0149259440,insurance,insurance,net_banking_transfer,8444.82
632ae6c82e1a0ebb7f46f71c,50200023535069,299450.09,60ec41ba55c00300382672d9,HDFC,Revenue-UPI,5eecc6d6449e4f7cfb1c2708,2022-06-17T00:00:00.000Z,UPI-GOKWIK-GOKWIK@YESBANK-YESB0000340-21 6817583898-PAYOUT FOR JUNE 15,,,upi,55789.8
632ae6c82e1a0ebb7f46f71e,50200023535069,301609.35,60ec41ba55c00300382672d9,HDFC,Revenue-Mktplace,5eecc6d6449e4f7cfb1c2708,2022-06-17T00:00:00.000Z,NEFT CR-DEUT0784BBY-TATA UNISTORE LTD-NO DAL-SLICK ORGANICS PVT LTD-216801992GN00 193,insurance,insurance,net_banking_transfer,2159.26
632ae6c82e1a0ebb7f46f720,50200023535069,353356.03,60ec41ba55c00300382672d9,HDFC,Revenue-Mktplace,5eecc6d6449e4f7cfb1c2708,2022-06-17T00:00:00.000Z,NEFT CR-KKBK0000958-THREPSI SOLUTIONS PV T LTD AHEMEDABAD-SLICK ORGANICS PVT LTD -KKBK221684293231,insurance,insurance,net_banking_transfer,51746.68
632ae6c82e1a0ebb7f46f722,50200023535069,363175.23,60ec41ba55c00300382672d9,HDFC,Revenue-PG-non-split,5eecc6d6449e4f7cfb1c2708,2022-06-18T00:00:00.000Z,NEFT CR-PYTM0123456-PAYTM PAYMENTS SERVI CES LIMITED-SLICK ORGANICS PVT LTD-PYTM2 21697983253,insurance,insurance,net_banking_transfer,9819.2
632ae6c82e1a0ebb7f46f725,50200023535069,374612.17,60ec41ba55c00300382672d9,HDFC,Revenue-PG-split enabled,5eecc6d6449e4f7cfb1c2708,2022-06-18T00:00:00.000Z,NEFT CR-UTIB0001506-RAZORPAY SOFTWARE PR IVATE LIMITED-SLICK ORGANICS PVT LITD-AX ISCN0149329701,insurance,insurance,net_banking_transfer,11436.94
632ae6c82e1a0ebb7f46f727,50200023535069,389462.57,60ec41ba55c00300382672d9,HDFC,Revenue-PG-split enabled,5eecc6d6449e4f7cfb1c2708,2022-06-18T00:00:00.000Z,NEFT CR-UTIB0001506-RAZORPAY SOFTWARE PR IVATE LIMITED-SLICK ORGANICS PVT LITD-AX ISCN0149423406,insurance,insurance,net_banking_transfer,14850.4
632ae6c82e1a0ebb7f46f729,50200023535069,425920.65,60ec41ba55c00300382672d9,HDFC,Revenue-UPI,5eecc6d6449e4f7cfb1c2708,2022-06-18T00:00:00.000Z,UPI-GOKWIK-GOKWIK@YESBANK-YESB0000340-21 6919113630-PAYOUT FOR JUNE 16,,,upi,36458.08
632ae6c82e1a0ebb7f46f72b,50200023535069,463934.05,60ec41ba55c00300382672d9,HDFC,Revenue-PG-non-split,5eecc6d6449e4f7cfb1c2708,2022-06-19T00:00:00.000Z,NEFT CR-PYTM0123456-PAYTM PAYMENTS SERVI CES LIMITED-SLICK ORGANICS PVT LTD-PYTM2 21709217073,insurance,insurance,net_banking_transfer,38013.4
632ae6c82e1a0ebb7f46f72d,50200023535069,491623.46,60ec41ba55c00300382672d9,HDFC,Revenue-UPI,5eecc6d6449e4f7cfb1c2708,2022-06-19T00:00:00.000Z,UPI-GOKWIK-GOKWIK@YESBANK-YESB0000340-21,,,upi,27689.41
632ae6c82e1a0ebb7f46f72f,50200023535069,236623.46,60ec41ba55c00300382672d9,HDFC,SAAS/tech expense,5eecc6d6449e4f7cfb1c2708,2022-06-20T00:00:00.000Z,POS 514834XXXXXX9486 AMAZON,shopping,,debit_card,-255000
632ae6c82e1a0ebb7f46f731,50200023535069,256774.94,60ec41ba55c00300382672d9,HDFC,Revenue-Mktplace,5eecc6d6449e4f7cfb1c2708,2022-06-20T00:00:00.000Z,NEFT CR-DEUT0797BGL-FLIPKART INTERNET PR IVATE LIMITED-SLICK ORGANICS PVT LTD-217 100183GN00137,shopping,,net_banking_transfer,20151.48
632ae6c82e1a0ebb7f46f733,50200023535069,295327.94,60ec41ba55c00300382672d9,HDFC,Revenue-PG-non-split,5eecc6d6449e4f7cfb1c2708,2022-06-20T00:00:00.000Z,NEFT CR-PYTM0123456-PAYTM PAYMENTS SERVI CES LIMITED-SLICK ORGANICS PVT LTD-PYTM2 21710374823,insurance,insurance,net_banking_transfer,38553
632ae6c82e1a0ebb7f46f735,50200023535069,295352.45,60ec41ba55c00300382672d9,HDFC,Revenue-Mktplace,5eecc6d6449e4f7cfb1c2708,2022-06-20T00:00:00.000Z,NEFT CR-DEUT0797BGL-MYNTRA DESIGNS PRIVA TE LIMITED-SLICK ORGANICS PVT. LTD.-2171 00488GN00005,shopping,,net_banking_transfer,24.51
632ae6c82e1a0ebb7f46f737,50200023535069,302251.29,60ec41ba55c00300382672d9,HDFC,Revenue-Mktplace,5eecc6d6449e4f7cfb1c2708,2022-06-20T00:00:00.000Z,NEFT CR-DEUT0797BGL-MYNTRA DESIGNS PRIVA TE LIMITED-SLICK ORGANICS PVT. LTD.-2171 00487GN00033,shopping,,net_banking_transfer,6898.84
632ae6c82e1a0ebb7f46f739,50200023535069,380388.78,60ec41ba55c00300382672d9,HDFC,Revenue-PG-split enabled,5eecc6d6449e4f7cfb1c2708,2022-06-20T00:00:00.000Z,NEFT CR-UTIB0001506-RAZORPAY SOFTWARE PR IVATE LIMITED-SLICK ORGANICS PVT LITD-AX ISCN0149574684,insurance,insurance,net_banking_transfer,78137.49
632ae6c82e1a0ebb7f46f73b,50200023535069,374921.24,60ec41ba55c00300382672d9,HDFC,direct expenses,5eecc6d6449e4f7cfb1c2708,2022-06-20T00:00:00.000Z,POS 514834XXXXXX9486 ECOMENGINE* FEED,,,debit_card,-5467.54
632ae6c82e1a0ebb7f46f73e,50200023535069,374033.24,60ec41ba55c00300382672d9,HDFC,direct expenses,5eecc6d6449e4f7cfb1c2708,2022-06-20T00:00:00.000Z,POS 514834XXXXXX9486 PAYU-HTTPS://STO,,,debit_card,-888
632ae6c82e1a0ebb7f46f743,50200023535069,261182.24,60ec41ba55c00300382672d9,HDFC,Tax,5eecc6d6449e4f7cfb1c2708,2022-06-20T00:00:00.000Z,GST/BANK REFERENCE NO: R2217135486913/CI N NO: HDFC22060700167975,,,Other,-112851
632ae6c82e1a0ebb7f46f749,50200023535069,207306.08,60ec41ba55c00300382672d9,HDFC,direct expenses,5eecc6d6449e4f7cfb1c2708,2022-06-20T00:00:00.000Z,POS 514834XXXXXX9486 THE ROCKET SCIEN,,,debit_card,-53876.16
632ae6c82e1a0ebb7f46f74d,50200023535069,209678.01,60ec41ba55c00300382672d9,HDFC,Transfer in/Revenue-other,5eecc6d6449e4f7cfb1c2708,2022-06-20T00:00:00.000Z,NEFT CR-UTIB0000114-ONE SIGMA TECHNOLOGI ES PRIVATE LIM-SLICK ORGANICS PRIVATE LI MITED-AXISP00297119660,insurance,insurance,net_banking_transfer,2371.93
632ae6c82e1a0ebb7f46f74f,50200023535069,210570.64,60ec41ba55c00300382672d9,HDFC,Transfer in/Revenue-other,5eecc6d6449e4f7cfb1c2708,2022-06-20T00:00:00.000Z,NEFT CR-UTIB0000114-ONE SIGMA TECHNOLOGI ES PRIVATE LIM-SLICK ORGANICS PRIVATE LI MITED-AXISP00297119700,insurance,insurance,net_banking_transfer,892.63
632ae6c82e1a0ebb7f46f752,50200023535069,210716.5,60ec41ba55c00300382672d9,HDFC,Revenue-Mktplace,5eecc6d6449e4f7cfb1c2708,2022-06-20T00:00:00.000Z,NEFT CR-ICIC0000105-MANASH LIFESTYLE PRI VATE LIMITED NO-SLICK ORGANICS PRIVATE L IMITED MP G-ICIJ221710002736,shopping,,net_banking_transfer,145.86
632ae6c82e1a0ebb7f46f759,50200023535069,202084.5,60ec41ba55c00300382672d9,HDFC,SAAS/tech expense,5eecc6d6449e4f7cfb1c2708,2022-06-20T00:00:00.000Z,POS 514834XXXXXX9486 AMAZON,shopping,,debit_card,-8632
632ae6c82e1a0ebb7f46f75b,50200023535069,253692.17,60ec41ba55c00300382672d9,HDFC,Transfer in/Revenue-other,5eecc6d6449e4f7cfb1c2708,2022-06-20T00:00:00.000Z,"IMPS-217116621216-GOKWIK COMMERCE SOLU-I CIC-XXXXXXXX0630-PAYOUT FOR JUNE 18, 202 2",,,net_banking_transfer,51607.67
632ae6c82e1a0ebb7f46f75d,50200023535069,376828.12,60ec41ba55c00300382672d9,HDFC,Revenue-COD,5eecc6d6449e4f7cfb1c2708,2022-06-20T00:00:00.000Z,NEFT CR-ICIC0000155-SHIPROCKET COD CRF I D 4488752-SLICK ORGANICS PVT LTD-CMS2654 513690,insurance,insurance,net_banking_transfer,123135.95
632ae6c82e1a0ebb7f46f75f,50200023535069,375401.12,60ec41ba55c00300382672d9,HDFC,direct expenses,5eecc6d6449e4f7cfb1c2708,2022-06-20T00:00:00.000Z,POS 514834XXXXXX9486 SMARTSHIFT LOGIS,,,debit_card,-1427
632ae6c82e1a0ebb7f46f761,50200023535069,375402.97,60ec41ba55c00300382672d9,HDFC,Revenue-Mktplace,5eecc6d6449e4f7cfb1c2708,2022-06-20T00:00:00.000Z,IMPS-217117918968-DIGIOTECH SOLUTIONS-YE SB-XXXXXXXXXXX6178-MYNTRA BANK ACCOUNT V ERIFICATION PENNYDROP,shopping,,net_banking_transfer,1.85
632ae6c82e1a0ebb7f46f763,50200023535069,393550.63,60ec41ba55c00300382672d9,HDFC,Revenue-PG-split enabled,5eecc6d6449e4f7cfb1c2708,2022-06-20T00:00:00.000Z,NEFT CR-UTIB0001506-RAZORPAY SOFTWARE PR IVATE LIMITED-SLICK ORGANICS PVT LITD-AX ISCN0149725552,insurance,insurance,net_banking_transfer,18147.66
632ae6c82e1a0ebb7f46f765,50200023535069,447999.02,60ec41ba55c00300382672d9,HDFC,Revenue-UPI,5eecc6d6449e4f7cfb1c2708,2022-06-20T00:00:00.000Z,UPI-GOKWIK-GOKWIK@YESBANK-YESB0000340-21 7122755507-PAYOUT FOR JUNE 18,,,upi,54448.39
632ae6c82e1a0ebb7f46f767,50200023535069,580811.02,60ec41ba55c00300382672d9,HDFC,Transfer in/Revenue-other,5eecc6d6449e4f7cfb1c2708,2022-06-20T00:00:00.000Z,BP1022212595-20 06 2022-HD00713732,,,Other,132812
632ae6c82e1a0ebb7f46f769,50200023535069,1248280.33,60ec41ba55c00300382672d9,HDFC,Revenue-Mktplace,5eecc6d6449e4f7cfb1c2708,2022-06-21T00:00:00.000Z,NEFT CR-DEUT0797BGL-AMAZON PAY (INDIA) P RIVATE LIMITED-SLICK ORGANICS PVT LTD-21 7200137GN00360,shopping,,net_banking_transfer,667469.31
632ae6c82e1a0ebb7f46f76c,50200023535069,1259717.72,60ec41ba55c00300382672d9,HDFC,Revenue-PG-non-split,5eecc6d6449e4f7cfb1c2708,2022-06-21T00:00:00.000Z,IMPS-217205535887-PAYTM PAYMENTS SERVI-P YTM-XXXXXXXXXX0008-ALL202206212168200003 30830668628,ewallet,,net_banking_transfer,11437.39
632ae6c82e1a0ebb7f46f76e,50200023535069,1462830.7,60ec41ba55c00300382672d9,HDFC,Revenue-Mktplace,5eecc6d6449e4f7cfb1c2708,2022-06-21T00:00:00.000Z,IMPS-217205072563-AMAZON SELLER SERVIC-H SBC-XXXXXXXX6004-2AKKU4MT2GUBIWDDSLICK O RGANICS PVT LTD,shopping,,net_banking_transfer,203112.98
632ae6c82e1a0ebb7f46f770,50200023535069,1472990.22,60ec41ba55c00300382672d9,HDFC,Revenue-PG-split enabled,5eecc6d6449e4f7cfb1c2708,2022-06-21T00:00:00.000Z,NEFT CR-UTIB0001506-RAZORPAY SOFTWARE PR IVATE LIMITED-SLICK ORGANICS PVT LITD-AX ISCN0149813766,insurance,insurance,net_banking_transfer,10159.52
632ae6c82e1a0ebb7f46f772,50200023535069,1474920.82,60ec41ba55c00300382672d9,HDFC,Transfer in/Revenue-other,5eecc6d6449e4f7cfb1c2708,2022-06-21T00:00:00.000Z,NEFT CR-UTIB0000114-ONE SIGMA TECHNOLOGI ES PRIVATE LIM-SLICK ORGANICS PRIVATE LI MITED-AXISP00297288098,insurance,insurance,net_banking_transfer,1930.6
632ae6c82e1a0ebb7f46f774,50200023535069,474920.82,60ec41ba55c00300382672d9,HDFC,Marketing Expense,5eecc6d6449e4f7cfb1c2708,2022-06-21T00:00:00.000Z,NEFT DR-CITI0000006-FACEBOOK INDIA ONLIN,,,net_banking_transfer,-1000000
632ae6c82e1a0ebb7f46f776,50200023535069,224920.82,60ec41ba55c00300382672d9,HDFC,direct expenses,5eecc6d6449e4f7cfb1c2708,2022-06-21T00:00:00.000Z,"NEFT DR-UTIB0000740-SUPARI STUDIOS-NETBA NK, MUM-N172222007106177-250000",,,net_banking_transfer,-250000
632ae6c82e1a0ebb7f46f778,50200023535069,265355.63,60ec41ba55c00300382672d9,HDFC,Transfer in/Revenue-other,5eecc6d6449e4f7cfb1c2708,2022-06-21T00:00:00.000Z,"IMPS-217216585378-GOKWIK COMMERCE SOLU-I CIC-XXXXXXXX0630-PAYOUT FOR JUNE 19, 202 2",,,net_banking_transfer,40434.81
632ae6c82e1a0ebb7f46f77a,50200023535069,272995.09,60ec41ba55c00300382672d9,HDFC,Revenue-PG-split enabled,5eecc6d6449e4f7cfb1c2708,2022-06-21T00:00:00.000Z,NEFT CR-UTIB0001506-RAZORPAY SOFTWARE PR IVATE LIMITED-SLICK ORGANICS PVT LITD-AX ISCN0149956566,insurance,insurance,net_banking_transfer,7639.46
632ae6c82e1a0ebb7f46f77c,50200023535069,365055.47,60ec41ba55c00300382672d9,HDFC,Revenue-UPI,5eecc6d6449e4f7cfb1c2708,2022-06-21T00:00:00.000Z,UPI-GOKWIK-GOKWIK@YESBANK-YESB0000340-21 7224703477-PAYOUT FOR JUNE 19,,,upi,92060.38
632ae6c82e1a0ebb7f46f77e,50200023535069,389394.15,60ec41ba55c00300382672d9,HDFC,Revenue-Mktplace,5eecc6d6449e4f7cfb1c2708,2022-06-22T00:00:00.000Z,NEFT CR-DEUT0797BGL-FLIPKART INTERNET PR IVATE LIMITED-SLICK ORGANICS PVT LTD-217 300140GN00240,shopping,,net_banking_transfer,24338.68
632ae6c82e1a0ebb7f46f780,50200023535069,400667.66,60ec41ba55c00300382672d9,HDFC,Revenue-PG-non-split,5eecc6d6449e4f7cfb1c2708,2022-06-22T00:00:00.000Z,IMPS-217305637579-PAYTM PAYMENTS SERVI-P YTM-XXXXXXXXXX0008-ALL202206222168200003 30830668628,ewallet,,net_banking_transfer,11273.51
632ae6c82e1a0ebb7f46f782,50200023535069,403777.09,60ec41ba55c00300382672d9,HDFC,Revenue-Mktplace,5eecc6d6449e4f7cfb1c2708,2022-06-22T00:00:00.000Z,NEFT CR-DEUT0797BGL-MYNTRA DESIGNS PRIVA TE LIMITED-SLICK ORGANICS PVT. LTD.-2173 00498GN00201,shopping,,net_banking_transfer,3109.43
632ae6c82e1a0ebb7f46f784,50200023535069,406903.01,60ec41ba55c00300382672d9,HDFC,Revenue-Mktplace,5eecc6d6449e4f7cfb1c2708,2022-06-22T00:00:00.000Z,NEFT CR-DEUT0797BGL-MYNTRA DESIGNS PRIVA TE LIMITED-SLICK ORGANICS PVT. LTD.-2173 00503GN00242,shopping,,net_banking_transfer,3125.92
632ae6c82e1a0ebb7f46f786,50200023535069,416765.85,60ec41ba55c00300382672d9,HDFC,Revenue-PG-split enabled,5eecc6d6449e4f7cfb1c2708,2022-06-22T00:00:00.000Z,NEFT CR-UTIB0001506-RAZORPAY SOFTWARE PR IVATE LIMITED-SLICK ORGANICS PVT LITD-AX ISCN0150059482,insurance,insurance,net_banking_transfer,9862.84
632ae6c82e1a0ebb7f46f788,50200023535069,396765.85,60ec41ba55c00300382672d9,HDFC,direct expenses,5eecc6d6449e4f7cfb1c2708,2022-06-22T00:00:00.000Z,CW-SELF/SARVAN KUMAR - CHQ PAID - NOIDA SECTOR,,,chq,-20000
632ae6c82e1a0ebb7f46f78a,50200023535069,141765.85,60ec41ba55c00300382672d9,HDFC,SAAS/tech expense,5eecc6d6449e4f7cfb1c2708,2022-06-22T00:00:00.000Z,POS 514834XXXXXX9486 AMAZON,shopping,,debit_card,-255000
632ae6c82e1a0ebb7f46f78c,50200023535069,136765.85,60ec41ba55c00300382672d9,HDFC,direct expenses,5eecc6d6449e4f7cfb1c2708,2022-06-22T00:00:00.000Z,NEFT DR-ICIC0000021-AKHILESH DIXIT-NETBA,,,net_banking_transfer,-5000
632ae6c82e1a0ebb7f46f78e,50200023535069,131765.85,60ec41ba55c00300382672d9,HDFC,direct expenses,5eecc6d6449e4f7cfb1c2708,2022-06-22T00:00:00.000Z,"NEFT DR-SIBL0000555-JAIVEER KUMAR-NETBAN K, MUM-N173222008345018-5000",,,net_banking_transfer,-5000
632ae6c82e1a0ebb7f46f790,50200023535069,133657.55,60ec41ba55c00300382672d9,HDFC,Transfer in/Revenue-other,5eecc6d6449e4f7cfb1c2708,2022-06-22T00:00:00.000Z,NEFT CR-UTIB0000114-ONE SIGMA TECHNOLOGI ES PRIVATE LIM-SLICK ORGANICS PRIVATE LI MITED-AXISP00297518389,insurance,insurance,net_banking_transfer,1891.7
632ae6c82e1a0ebb7f46f792,50200023535069,143666.6,60ec41ba55c00300382672d9,HDFC,Revenue-Mktplace,5eecc6d6449e4f7cfb1c2708,2022-06-22T00:00:00.000Z,NEFT CR-HSBC0400002-AMAZON SERVICES LLC- SLICK ORGANICS PRIVATE LIMITED-HSBCN2217 3005114,shopping,,net_banking_transfer,10009.05
632ae6c82e1a0ebb7f46f794,50200023535069,142188.6,60ec41ba55c00300382672d9,HDFC,direct expenses,5eecc6d6449e4f7cfb1c2708,2022-06-22T00:00:00.000Z,POS 514834XXXXXX9486 SMARTSHIFT LOGIS,,,debit_card,-1478
632ae6c82e1a0ebb7f46f796,50200023535069,162649.25,60ec41ba55c00300382672d9,HDFC,Revenue-PG-split enabled,5eecc6d6449e4f7cfb1c2708,2022-06-22T00:00:00.000Z,NEFT CR-UTIB0001506-RAZORPAY SOFTWARE PR IVATE LIMITED-SLICK ORGANICS PVT LITD-AX ISCN0150237761,insurance,insurance,net_banking_transfer,20460.65
632ae6c82e1a0ebb7f46f799,50200023535069,192651.24,60ec41ba55c00300382672d9,HDFC,Revenue-UPI,5eecc6d6449e4f7cfb1c2708,2022-06-22T00:00:00.000Z,UPI-GOKWIK-GOKWIK@YESBANK-YESB0000340-21 7326425828-PAYOUT FOR JUNE 20,,,upi,30001.99
632ae6c82e1a0ebb7f46f79b,50200023535069,193000.19,60ec41ba55c00300382672d9,HDFC,Revenue-Mktplace,5eecc6d6449e4f7cfb1c2708,2022-06-22T00:00:00.000Z,NEFT CR-ICIC0000105-MANASH LIFESTYLE PRI VATE LIMITED NO-SLICK ORGANICS PRIVATE L IMITED KOLK-ICIJ221730005101,shopping,,net_banking_transfer,348.95
632ae6c82e1a0ebb7f46f79d,50200023535069,193274.33,60ec41ba55c00300382672d9,HDFC,Revenue-Mktplace,5eecc6d6449e4f7cfb1c2708,2022-06-22T00:00:00.000Z,NEFT CR-ICIC0000105-MANASH LIFESTYLE PRI VATE LIMITED NO-SLICK ORGANICS PRIVATE L IMITED MP M-ICIJ221730005100,shopping,,net_banking_transfer,274.14
632ae6c82e1a0ebb7f46f79f,50200023535069,218936.26,60ec41ba55c00300382672d9,HDFC,Revenue-PG-non-split,5eecc6d6449e4f7cfb1c2708,2022-06-23T00:00:00.000Z,NEFT CR-PYTM0123456-PAYTM PAYMENTS SERVI CES LIMITED-SLICK ORGANICS PVT LTD-PYTM2 21744312861,insurance,insurance,net_banking_transfer,25661.93
632ae6c82e1a0ebb7f46f7a1,50200023535069,264786.53,60ec41ba55c00300382672d9,HDFC,Revenue-PG-split enabled,5eecc6d6449e4f7cfb1c2708,2022-06-23T00:00:00.000Z,NEFT CR-UTIB0001506-RAZORPAY SOFTWARE PR IVATE LIMITED-SLICK ORGANICS PVT LITD-AX ISCN0150334513,insurance,insurance,net_banking_transfer,45850.27
632ae6c82e1a0ebb7f46f7a3,50200023535069,264565.33,60ec41ba55c00300382672d9,HDFC,bank charges,5eecc6d6449e4f7cfb1c2708,2022-06-23T00:00:00.000Z,.DC INTL POS TXN MARKUP+ST 190422 260422 -CDT2215209278210,,,international_transaction_arbitrage,-221.2
632ae6c82e1a0ebb7f46f7a5,50200023535069,263935.17,60ec41ba55c00300382672d9,HDFC,bank charges,5eecc6d6449e4f7cfb1c2708,2022-06-23T00:00:00.000Z,.DC INTL POS TXN MARKUP+ST 190422 260422 -CDT2215209278210,,,international_transaction_arbitrage,-630.16
632ae6c82e1a0ebb7f46f7a7,50200023535069,261626.17,60ec41ba55c00300382672d9,HDFC,direct expenses,5eecc6d6449e4f7cfb1c2708,2022-06-23T00:00:00.000Z,POS 514834XXXXXX9486 PAYUP*GETSELLGO,,,debit_card,-2309
632ae6c82e1a0ebb7f46f7a9,50200023535069,266193.71,60ec41ba55c00300382672d9,HDFC,Transfer in/Revenue-other,5eecc6d6449e4f7cfb1c2708,2022-06-23T00:00:00.000Z,NEFT CR-UTIB0000114-ONE SIGMA TECHNOLOGI,,,net_banking_transfer,4567.54
632ae6c82e1a0ebb7f46f7ab,50200023535069,265107.71,60ec41ba55c00300382672d9,HDFC,direct expenses,5eecc6d6449e4f7cfb1c2708,2022-06-23T00:00:00.000Z,POS 514834XXXXXX9486 SMARTSHIFT LOGIS,,,debit_card,-1086
632ae6c82e1a0ebb7f46f7ad,50200023535069,264441.59,60ec41ba55c00300382672d9,HDFC,bank charges,5eecc6d6449e4f7cfb1c2708,2022-06-23T00:00:00.000Z,.DC INTL POS TXN MARKUP+ST 260422 280422 -CDT2215209278210,,,international_transaction_arbitrage,-666.12
632ae6c82e1a0ebb7f46f7af,50200023535069,283733.17,60ec41ba55c00300382672d9,HDFC,Revenue-PG-split enabled,5eecc6d6449e4f7cfb1c2708,2022-06-23T00:00:00.000Z,NEFT CR-UTIB0001506-RAZORPAY SOFTWARE PR IVATE LIMITED-SLICK ORGANICS PVT LITD-AX ISCN0150467027,insurance,insurance,net_banking_transfer,19291.58
632ae6c82e1a0ebb7f46f7b1,50200023535069,320965.62,60ec41ba55c00300382672d9,HDFC,Revenue-UPI,5eecc6d6449e4f7cfb1c2708,2022-06-23T00:00:00.000Z,UPI-GOKWIK-GOKWIK@YESBANK-YESB0000340-21 7428347063-PAYOUT FOR JUNE 21,,,upi,37232.45
632ae6c82e1a0ebb7f46f7b3,50200023535069,331987.7,60ec41ba55c00300382672d9,HDFC,Revenue-Mktplace,5eecc6d6449e4f7cfb1c2708,2022-06-24T00:00:00.000Z,NEFT CR-DEUT0797BGL-FLIPKART INTERNET PR IVATE LIMITED-SLICK ORGANICS PVT LTD-217 500177GN00078,shopping,,net_banking_transfer,11022.08
632ae6c82e1a0ebb7f46f7b5,50200023535069,336915.93,60ec41ba55c00300382672d9,HDFC,Revenue-Mktplace,5eecc6d6449e4f7cfb1c2708,2022-06-24T00:00:00.000Z,NEFT CR-DEUT0797BGL-MYNTRA DESIGNS PRIVA TE LIMITED-SLICK ORGANICS PVT. LTD.-2175 00475GN00185,shopping,,net_banking_transfer,4928.23
632ae6c82e1a0ebb7f46f7b7,50200023535069,340866.16,60ec41ba55c00300382672d9,HDFC,Revenue-Mktplace,5eecc6d6449e4f7cfb1c2708,2022-06-24T00:00:00.000Z,NEFT CR-DEUT0797BGL-MYNTRA DESIGNS PRIVA TE LIMITED-SLICK ORGANICS PVT. LTD.-2175 00474GN00157,shopping,,net_banking_transfer,3950.23
632ae6c82e1a0ebb7f46f7b9,50200023535069,-9133.84,60ec41ba55c00300382672d9,HDFC,direct expenses,5eecc6d6449e4f7cfb1c2708,2022-06-24T00:00:00.000Z,"NEFT DR-ICIC0000369-BO INTERNATIONAL-NET BANK, MUM-N175222010515105-350000",,,net_banking_transfer,-350000
632ae6c82e1a0ebb7f46f7bb,50200023535069,22952.8,60ec41ba55c00300382672d9,HDFC,Revenue-PG-split enabled,5eecc6d6449e4f7cfb1c2708,2022-06-24T00:00:00.000Z,NEFT CR-UTIB0001506-RAZORPAY SOFTWARE PR IVATE LIMITED-SLICK ORGANICS PVT LITD-AX ISCN0150719875,insurance,insurance,net_banking_transfer,32086.64
632ae6c82e1a0ebb7f46f7bd,50200023535069,57786.69,60ec41ba55c00300382672d9,HDFC,Revenue-PG-non-split,5eecc6d6449e4f7cfb1c2708,2022-06-24T00:00:00.000Z,NEFT CR-PYTM0123456-PAYTM PAYMENTS SERVI CES LIMITED-SLICK ORGANICS PVT LTD-PYTM2 21755127374,insurance,insurance,net_banking_transfer,34833.89
632ae6c82e1a0ebb7f46f7c0,50200023535069,52786.69,60ec41ba55c00300382672d9,HDFC,Refund,5eecc6d6449e4f7cfb1c2708,2022-06-24T00:00:00.000Z,"NEFT DR-RATN0VAAPIS-RAZORPAY REFUND CRED ITS TOPUP-NETBANK, MUM-N175222010681011- 5000",,,net_banking_transfer,-5000
632ae6c92e1a0ebb7f46f7c2,50200023535069,67786.69,60ec41ba55c00300382672d9,HDFC,Internal Transfers,5eecc6d6449e4f7cfb1c2708,2022-06-24T00:00:00.000Z,IB FUNDS TRANSFER CR-50200050976833 -SL,,,Other,15000
632ae6c92e1a0ebb7f46f7c6,50200023535069,70982.74,60ec41ba55c00300382672d9,HDFC,Revenue-PG-non-split,5eecc6d6449e4f7cfb1c2708,2022-06-24T00:00:00.000Z,NEFT CR-SCBL0036001-STRIPE INDIA PRIVATE -SLICK ORGANICS PRIVATE LIMITED-SSG17413 Q0710963,insurance,insurance,net_banking_transfer,3196.05
632ae6c92e1a0ebb7f46f7c8,50200023535069,72704.2,60ec41ba55c00300382672d9,HDFC,Transfer in/Revenue-other,5eecc6d6449e4f7cfb1c2708,2022-06-24T00:00:00.000Z,NEFT CR-UTIB0000114-ONE SIGMA TECHNOLOGI ES PRIVATE LIM-SLICK ORGANICS PRIVATE LI MITED-AXISP00298189410,insurance,insurance,net_banking_transfer,1721.46
632ae6c92e1a0ebb7f46f7ca,50200023535069,72430.2,60ec41ba55c00300382672d9,HDFC,direct expenses,5eecc6d6449e4f7cfb1c2708,2022-06-24T00:00:00.000Z,POS 514834XXXXXX9486 SMARTSHIFT LOGIS,,,debit_card,-274
632ae6c92e1a0ebb7f46f7cc,50200023535069,110377.67,60ec41ba55c00300382672d9,HDFC,Revenue-PG-split enabled,5eecc6d6449e4f7cfb1c2708,2022-06-24T00:00:00.000Z,NEFT CR-UTIB0001506-RAZORPAY SOFTWARE PR IVATE LIMITED-SLICK ORGANICS PVT LITD-AX ISCN0150857160,insurance,insurance,net_banking_transfer,37947.47
632ae6c92e1a0ebb7f46f7ce,50200023535069,217463.54,60ec41ba55c00300382672d9,HDFC,Revenue-UPI,5eecc6d6449e4f7cfb1c2708,2022-06-24T00:00:00.000Z,UPI-GOKWIK-GOKWIK@YESBANK-YESB0000340-21 7530126805-PAYOUT FOR JUNE 22,,,upi,107085.87
632ae6c92e1a0ebb7f46f7d0,50200023535069,242792.1,60ec41ba55c00300382672d9,HDFC,Revenue-COD,5eecc6d6449e4f7cfb1c2708,2022-06-24T00:00:00.000Z,NEFT CR-ICIC0000155-SHIPROCKET COD CRF I D 4513366-SLICK ORGANICS PVT LTD-CMS2661 244214,insurance,insurance,net_banking_transfer,25328.56
632ae6c92e1a0ebb7f46f7d2,50200023535069,248086.1,60ec41ba55c00300382672d9,HDFC,Revenue-Mktplace,5eecc6d6449e4f7cfb1c2708,2022-06-24T00:00:00.000Z,NEFT CR-ICIC0000985-DIGITAL AGE RETAIL P VT LTD-SLICK ORGANICS PVT LTD DS-CMS26 61133459,,,net_banking_transfer,5294
632ae6c92e1a0ebb7f46f7d4,50200023535069,264554.38,60ec41ba55c00300382672d9,HDFC,Revenue-PG-non-split,5eecc6d6449e4f7cfb1c2708,2022-06-25T00:00:00.000Z,IMPS-217604976544-PAYTM PAYMENTS SERVI-P YTM-XXXXXXXXXX0008-ALL202206252168200003 30830668628,ewallet,,net_banking_transfer,16468.28
632ae6c92e1a0ebb7f46f7d6,50200023535069,260714.04,60ec41ba55c00300382672d9,HDFC,direct expenses,5eecc6d6449e4f7cfb1c2708,2022-06-25T00:00:00.000Z,POS 514834XXXXXX9486 WWW.FAQPRIME.COM,,,debit_card,-3840.34
632ae6c92e1a0ebb7f46f7d8,50200023535069,259311.04,60ec41ba55c00300382672d9,HDFC,direct expenses,5eecc6d6449e4f7cfb1c2708,2022-06-25T00:00:00.000Z,POS 514834XXXXXX9486 SMARTSHIFT LOGIS,,,debit_card,-1403
632ae6c92e1a0ebb7f46f7da,50200023535069,361454.37,60ec41ba55c00300382672d9,HDFC,Revenue-UPI,5eecc6d6449e4f7cfb1c2708,2022-06-25T00:00:00.000Z,UPI-GOKWIK-GOKWIK@YESBANK-YESB0000340-21 7631724300-PAYOUT FOR JUNE 23,,,upi,102143.33
632ae6c92e1a0ebb7f46f7dc,50200023535069,391753.53,60ec41ba55c00300382672d9,HDFC,Revenue-PG-non-split,5eecc6d6449e4f7cfb1c2708,2022-06-26T00:00:00.000Z,NEFT CR-PYTM0123456-PAYTM PAYMENTS SERVI CES LIMITED-SLICK ORGANICS PVT LTD-PYTM2 21777632416,insurance,insurance,net_banking_transfer,30299.16
632ae6c92e1a0ebb7f46f7de,50200023535069,523684.77,60ec41ba55c00300382672d9,HDFC,Revenue-UPI,5eecc6d6449e4f7cfb1c2708,2022-06-26T00:00:00.000Z,UPI-GOKWIK-GOKWIK@YESBANK-YESB0000340-21 7733239611-PAYOUT FOR JUNE 24,,,upi,131931.24
632ae6c92e1a0ebb7f46f7e0,50200023535069,542333.34,60ec41ba55c00300382672d9,HDFC,Revenue-Mktplace,5eecc6d6449e4f7cfb1c2708,2022-06-27T00:00:00.000Z,NEFT CR-DEUT0797BGL-FLIPKART INTERNET PR,shopping,,net_banking_transfer,18648.57
632ae6c92e1a0ebb7f46f7e2,50200023535069,564848.63,60ec41ba55c00300382672d9,HDFC,Revenue-PG-non-split,5eecc6d6449e4f7cfb1c2708,2022-06-27T00:00:00.000Z,IMPS-217805181263-PAYTM PAYMENTS SERVI-P YTM-XXXXXXXXXX0008-ALL202206272168200003 30830668628,ewallet,,net_banking_transfer,22515.29
632ae6c92e1a0ebb7f46f7e4,50200023535069,570675.01,60ec41ba55c00300382672d9,HDFC,Revenue-Mktplace,5eecc6d6449e4f7cfb1c2708,2022-06-27T00:00:00.000Z,NEFT CR-DEUT0797BGL-MYNTRA DESIGNS PRIVA TE LIMITED-SLICK ORGANICS PVT. LTD.-2178 00539GN00249,shopping,,net_banking_transfer,5826.38
632ae6c92e1a0ebb7f46f7e6,50200023535069,578982.5,60ec41ba55c00300382672d9,HDFC,Revenue-Mktplace,5eecc6d6449e4f7cfb1c2708,2022-06-27T00:00:00.000Z,NEFT CR-DEUT0797BGL-MYNTRA DESIGNS PRIVA TE LIMITED-SLICK ORGANICS PVT. LTD.-2178 00553GN00034,shopping,,net_banking_transfer,8307.49
632ae6c92e1a0ebb7f46f7e8,50200023535069,694979.03,60ec41ba55c00300382672d9,HDFC,Revenue-PG-split enabled,5eecc6d6449e4f7cfb1c2708,2022-06-27T00:00:00.000Z,NEFT CR-UTIB0001506-RAZORPAY SOFTWARE PR IVATE LIMITED-SLICK ORGANICS PVT LITD-AX ISCN0151140812,insurance,insurance,net_banking_transfer,115996.53
632ae6c92e1a0ebb7f46f7ea,50200023535069,444979.03,60ec41ba55c00300382672d9,HDFC,direct expenses,5eecc6d6449e4f7cfb1c2708,2022-06-27T00:00:00.000Z,"NEFT DR-IDFB0040101-ACTIVES ADDITIVES AP PLICATIONS LLP-NETBANK, MUM-N17822201259 1181-250000",insurance,insurance,net_banking_transfer,-250000
632ae6c92e1a0ebb7f46f7ec,50200023535069,392887.03,60ec41ba55c00300382672d9,HDFC,direct expenses,5eecc6d6449e4f7cfb1c2708,2022-06-27T00:00:00.000Z,"NEFT DR-YESB0000162-VINAY REDDY-NETBANK, MUM-N178222012824484-52092",,,net_banking_transfer,-52092
632ae6c92e1a0ebb7f46f7ee,50200023535069,342887.03,60ec41ba55c00300382672d9,HDFC,direct expenses,5eecc6d6449e4f7cfb1c2708,2022-06-27T00:00:00.000Z,"NEFT DR-KKBK0000173-MATRIX PRINTING SOLU TIONS PRIVATE LIMITE-NETBANK, MUM-N17822 2012842746-50000",,,net_banking_transfer,-50000
632ae6c92e1a0ebb7f46f7f0,50200023535069,341111.03,60ec41ba55c00300382672d9,HDFC,direct expenses,5eecc6d6449e4f7cfb1c2708,2022-06-27T00:00:00.000Z,POS 514834XXXXXX9486 PAYU-HTTPS://STO,,,debit_card,-1776
632ae6c92e1a0ebb7f46f7f2,50200023535069,356693.3,60ec41ba55c00300382672d9,HDFC,Transfer in/Revenue-other,5eecc6d6449e4f7cfb1c2708,2022-06-27T00:00:00.000Z,NEFT CR-UTIB0000114-ONE SIGMA TECHNOLOGI ES PRIVATE LIM-SLICK ORGANICS PRIVATE LI MITED-AXISP00298528050,insurance,insurance,net_banking_transfer,15582.27
632ae6c92e1a0ebb7f46f7f4,50200023535069,366346.05,60ec41ba55c00300382672d9,HDFC,Transfer in/Revenue-other,5eecc6d6449e4f7cfb1c2708,2022-06-27T00:00:00.000Z,NEFT CR-UTIB0000114-ONE SIGMA TECHNOLOGI ES PRIVATE LIM-SLICK ORGANICS PRIVATE LI MITED-AXISP00298528228,insurance,insurance,net_banking_transfer,9652.75
632ae6c92e1a0ebb7f46f7f7,50200023535069,367558.45,60ec41ba55c00300382672d9,HDFC,Transfer in/Revenue-other,5eecc6d6449e4f7cfb1c2708,2022-06-27T00:00:00.000Z,NEFT CR-UTIB0000114-ONE SIGMA TECHNOLOGI ES PRIVATE LIM-SLICK ORGANICS PRIVATE LI MITED-AXISP00298527905,insurance,insurance,net_banking_transfer,1212.4
632ae6c92e1a0ebb7f46f7fa,50200023535069,363010.45,60ec41ba55c00300382672d9,HDFC,direct expenses,5eecc6d6449e4f7cfb1c2708,2022-06-27T00:00:00.000Z,POS 514834XXXXXX9486 PAYU-HTTPS://STO,,,debit_card,-4548
632ae6c92e1a0ebb7f46f7fc,50200023535069,363601.48,60ec41ba55c00300382672d9,HDFC,Revenue-UPI,5eecc6d6449e4f7cfb1c2708,2022-06-27T00:00:00.000Z,UPI-GOKWIK-GOKWIK@YESBANK-YESB0000340-21 7834677571-PAYOUT FOR MARCH 6,,,upi,591.03
632ae6c92e1a0ebb7f46f7fe,50200023535069,364192.66,60ec41ba55c00300382672d9,HDFC,Revenue-UPI,5eecc6d6449e4f7cfb1c2708,2022-06-27T00:00:00.000Z,UPI-GOKWIK-GOKWIK@YESBANK-YESB0000340-21 7834677704-PAYOUT FOR MARCH 1,,,upi,591.18
632ae6c92e1a0ebb7f46f800,50200023535069,364886.86,60ec41ba55c00300382672d9,HDFC,Transfer in/Revenue-other,5eecc6d6449e4f7cfb1c2708,2022-06-27T00:00:00.000Z,4060002845-27 06 2022-HDFAZCUR1,,,Other,694.2
632ae6c92e1a0ebb7f46f802,50200023535069,368660.86,60ec41ba55c00300382672d9,HDFC,Revenue-Mktplace,5eecc6d6449e4f7cfb1c2708,2022-06-27T00:00:00.000Z,NEFT CR-SCBL0036001-M/S DREAMPLUG TECHNO -SLICK ORGANICS PRIVATE LIMITEDSLICK-SIN 31436Q0043222,insurance,insurance,net_banking_transfer,3774
632ae6c92e1a0ebb7f46f804,50200023535069,537242.61,60ec41ba55c00300382672d9,HDFC,Revenue-COD,5eecc6d6449e4f7cfb1c2708,2022-06-27T00:00:00.000Z,NEFT CR-ICIC0000155-SHIPROCKET COD CRF I D 4521482-SLICK ORGANICS PVT LTD-CMS2665 285658,insurance,insurance,net_banking_transfer,168581.75
632ae6c92e1a0ebb7f46f806,50200023535069,548604.62,60ec41ba55c00300382672d9,HDFC,Revenue-PG-split enabled,5eecc6d6449e4f7cfb1c2708,2022-06-27T00:00:00.000Z,NEFT CR-UTIB0001506-RAZORPAY SOFTWARE PR IVATE LIMITED-SLICK ORGANICS PVT LITD-AX ISCN0151300598,insurance,insurance,net_banking_transfer,11362.01
632ae6c92e1a0ebb7f46f808,50200023535069,550777.73,60ec41ba55c00300382672d9,HDFC,Revenue-Mktplace,5eecc6d6449e4f7cfb1c2708,2022-06-27T00:00:00.000Z,4060002794-TIMES INTERNET LIMITED NODAL,,,Other,2173.11
632ae6c92e1a0ebb7f46f80a,50200023535069,658960.69,60ec41ba55c00300382672d9,HDFC,Revenue-UPI,5eecc6d6449e4f7cfb1c2708,2022-06-27T00:00:00.000Z,UPI-GOKWIK-GOKWIK@YESBANK-YESB0000340-21 7834934100-PAYOUT FOR JUNE 25,,,upi,108182.96
632ae6c92e1a0ebb7f46f80c,50200023535069,666409.69,60ec41ba55c00300382672d9,HDFC,Revenue-COD,5eecc6d6449e4f7cfb1c2708,2022-06-27T00:00:00.000Z,NEFT CR-KKBK0000958-PICKRR TECHNOLOGIES PVT LTD-SLICKORGANICSPRIVATELIMITED-CMS1 782218139343,insurance,insurance,net_banking_transfer,7449
632ae6c92e1a0ebb7f46f80f,50200023535069,1277123.07,60ec41ba55c00300382672d9,HDFC,Revenue-Mktplace,5eecc6d6449e4f7cfb1c2708,2022-06-28T00:00:00.000Z,NEFT CR-DEUT0797BGL-AMAZON PAY (INDIA) P RIVATE LIMITED-SLICK ORGANICS PVT LTD-21 7900141GN00423,shopping,,net_banking_transfer,610713.38
632ae6c92e1a0ebb7f46f811,50200023535069,1285911.42,60ec41ba55c00300382672d9,HDFC,Revenue-PG-non-split,5eecc6d6449e4f7cfb1c2708,2022-06-28T00:00:00.000Z,NEFT CR-PYTM0123456-PAYTM PAYMENTS SERVI CES LIMITED-SLICK ORGANICS PVT LTD-PYTM2 21790100046,insurance,insurance,net_banking_transfer,8788.35
632ae6c92e1a0ebb7f46f813,50200023535069,1290362.67,60ec41ba55c00300382672d9,HDFC,Revenue-Mktplace,5eecc6d6449e4f7cfb1c2708,2022-06-28T00:00:00.000Z,NEFT CR-DEUT0797BGL-MYNTRA DESIGNS PRIVA TE LIMITED-SLICK ORGANICS PVT. LTD.-2179 00382GN00200,shopping,,net_banking_transfer,4451.25
632ae6c92e1a0ebb7f46f815,50200023535069,1299377.91,60ec41ba55c00300382672d9,HDFC,Revenue-Mktplace,5eecc6d6449e4f7cfb1c2708,2022-06-28T00:00:00.000Z,NEFT CR-DEUT0797BGL-MYNTRA DESIGNS PRIVA,shopping,,net_banking_transfer,9015.24
632ae6c92e1a0ebb7f46f817,50200023535069,1149377.91,60ec41ba55c00300382672d9,HDFC,direct expenses,5eecc6d6449e4f7cfb1c2708,2022-06-28T00:00:00.000Z,"NEFT DR-ICIC0000369-BO INTERNATIONAL-NET BANK, MUM-N179222013872788-150000",,,net_banking_transfer,-150000
632ae6c92e1a0ebb7f46f819,50200023535069,1158674.8,60ec41ba55c00300382672d9,HDFC,Revenue-PG-split enabled,5eecc6d6449e4f7cfb1c2708,2022-06-28T00:00:00.000Z,NEFT CR-UTIB0001506-RAZORPAY SOFTWARE PR IVATE LIMITED-SLICK ORGANICS PVT LITD-AX ISCN0151391860,insurance,insurance,net_banking_transfer,9296.89
632ae6c92e1a0ebb7f46f81b,50200023535069,1152774.8,60ec41ba55c00300382672d9,HDFC,direct expenses,5eecc6d6449e4f7cfb1c2708,2022-06-28T00:00:00.000Z,"NEFT DR-ICIC0000211-RETAILERS ASSOCIATIO N OF INDIA-NETBANK, MUM-N179222014014366 -5900",,,net_banking_transfer,-5900
632ae6c92e1a0ebb7f46f81d,50200023535069,1152932.8,60ec41ba55c00300382672d9,HDFC,Revenue-Mktplace,5eecc6d6449e4f7cfb1c2708,2022-06-28T00:00:00.000Z,POS REF 514834******9486-06/28 AMAZON,shopping,,refund,158
632ae6c92e1a0ebb7f46f81f,50200023535069,1152585.8,60ec41ba55c00300382672d9,HDFC,direct expenses,5eecc6d6449e4f7cfb1c2708,2022-06-28T00:00:00.000Z,POS 514834XXXXXX9486 SMARTSHIFT LOGIS,,,debit_card,-347
632ae6c92e1a0ebb7f46f821,50200023535069,1152295.8,60ec41ba55c00300382672d9,HDFC,direct expenses,5eecc6d6449e4f7cfb1c2708,2022-06-28T00:00:00.000Z,POS 514834XXXXXX9486 SMARTSHIFT LOGIS,,,debit_card,-290
632ae6c92e1a0ebb7f46f823,50200023535069,1154467.97,60ec41ba55c00300382672d9,HDFC,Transfer in/Revenue-other,5eecc6d6449e4f7cfb1c2708,2022-06-28T00:00:00.000Z,NEFT CR-UTIB0000114-ONE SIGMA TECHNOLOGI ES PRIVATE LIM-SLICK ORGANICS PRIVATE LI MITED-AXISP00298796361,insurance,insurance,net_banking_transfer,2172.17
632ae6c92e1a0ebb7f46f825,50200023535069,1249789.02,60ec41ba55c00300382672d9,HDFC,Revenue-UPI,5eecc6d6449e4f7cfb1c2708,2022-06-28T00:00:00.000Z,UPI-GOKWIK-GOKWIK@YESBANK-YESB0000340-21 7936606532-PAYOUT FOR JUNE 26,,,upi,95321.05
632ae6c92e1a0ebb7f46f827,50200023535069,1255415.53,60ec41ba55c00300382672d9,HDFC,Revenue-PG-split enabled,5eecc6d6449e4f7cfb1c2708,2022-06-28T00:00:00.000Z,NEFT CR-UTIB0001506-RAZORPAY SOFTWARE PR IVATE LIMITED-SLICK ORGANICS PVT LITD-AX ISCN0151533486,insurance,insurance,net_banking_transfer,5626.51
632ae6c92e1a0ebb7f46f829,50200023535069,2556980.34,60ec41ba55c00300382672d9,HDFC,Revenue-Mktplace,5eecc6d6449e4f7cfb1c2708,2022-06-28T00:00:00.000Z,NEFT CR-KKBK0000958-NYKAA E RETAIL PRIVA TE LIMITED NYKAA-SLICK ORGANICS PVT LTD- KKBK221796774992,insurance,insurance,net_banking_transfer,1301564.81
632ae6c92e1a0ebb7f46f82b,50200023535069,2610045.34,60ec41ba55c00300382672d9,HDFC,Revenue-Mktplace,5eecc6d6449e4f7cfb1c2708,2022-06-28T00:00:00.000Z,NEFT CR-KKBK0000958-THREPSI SOLUTIONS PV T LTD GURUGRAM-SLICK ORGANICS PRIVATE L IMITED-KKBK221796791883,insurance,insurance,net_banking_transfer,53065
632ae6c92e1a0ebb7f46f82d,50200023535069,2627793.61,60ec41ba55c00300382672d9,HDFC,Revenue-Mktplace,5eecc6d6449e4f7cfb1c2708,2022-06-29T00:00:00.000Z,NEFT CR-DEUT0797BGL-FLIPKART INTERNET PR IVATE LIMITED-SLICK ORGANICS PVT LTD-218 000097GN00240,shopping,,net_banking_transfer,17748.27
632ae6c92e1a0ebb7f46f831,50200023535069,627793.61,60ec41ba55c00300382672d9,HDFC,Marketing Expense,5eecc6d6449e4f7cfb1c2708,2022-06-29T00:00:00.000Z,"NEFT DR-CITI0000006-FACEBOOK INDIA ONLIN E SERVICES PVT LTD-NETBANK, MUM-N1802220 15287950-2000000",,,net_banking_transfer,-2000000
632ae6c92e1a0ebb7f46f834,50200023535069,630387.61,60ec41ba55c00300382672d9,HDFC,Transfer in/Revenue-other,5eecc6d6449e4f7cfb1c2708,2022-06-29T00:00:00.000Z,NEFT CR-HSBC0560002-INNOVATIVE RETAIL CO,,,net_banking_transfer,2594
632ae6c92e1a0ebb7f46f837,50200023535069,636391.61,60ec41ba55c00300382672d9,HDFC,Transfer in/Revenue-other,5eecc6d6449e4f7cfb1c2708,2022-06-29T00:00:00.000Z,NEFT CR-HSBC0560002-INNOVATIVE RETAIL CO NCEPTS PRIVATE-SLICK ORGANICS PVT LTD-HS BCN22180906315,,,net_banking_transfer,6004
632ae6c92e1a0ebb7f46f83a,50200023535069,637624.61,60ec41ba55c00300382672d9,HDFC,Transfer in/Revenue-other,5eecc6d6449e4f7cfb1c2708,2022-06-29T00:00:00.000Z,NEFT CR-HSBC0560002-INNOVATIVE RETAIL CO NCEPTS PRIVATE-SLICK ORGANICS PVT LTD-HS BCN22180907709,,,net_banking_transfer,1233
632ae6c92e1a0ebb7f46f83c,50200023535069,647567.88,60ec41ba55c00300382672d9,HDFC,Revenue-PG-non-split,5eecc6d6449e4f7cfb1c2708,2022-06-29T00:00:00.000Z,NEFT CR-PYTM0123456-PAYTM PAYMENTS SERVI CES LIMITED-SLICK ORGANICS PVT LTD-PYTM2 21801212170,insurance,insurance,net_banking_transfer,9943.27
632ae6c92e1a0ebb7f46f83e,50200023535069,672155.75,60ec41ba55c00300382672d9,HDFC,Revenue-PG-split enabled,5eecc6d6449e4f7cfb1c2708,2022-06-29T00:00:00.000Z,NEFT CR-UTIB0001506-RAZORPAY SOFTWARE PR IVATE LIMITED-SLICK ORGANICS PVT LITD-AX ISCN0151598308,insurance,insurance,net_banking_transfer,24587.87
632ae6c92e1a0ebb7f46f840,50200023535069,671785.75,60ec41ba55c00300382672d9,HDFC,direct expenses,5eecc6d6449e4f7cfb1c2708,2022-06-29T00:00:00.000Z,POS 514834XXXXXX9486 SMARTSHIFT LOGIS,,,debit_card,-370
632ae6c92e1a0ebb7f46f842,50200023535069,669608.75,60ec41ba55c00300382672d9,HDFC,direct expenses,5eecc6d6449e4f7cfb1c2708,2022-06-29T00:00:00.000Z,POS 514834XXXXXX9486 RAZ*SMARTSHIFT L,,,debit_card,-2177
632ae6c92e1a0ebb7f46f844,50200023535069,614475.75,60ec41ba55c00300382672d9,HDFC,direct expenses,5eecc6d6449e4f7cfb1c2708,2022-06-29T00:00:00.000Z,"NEFT DR-UTIB0000032-SKUMAR MULTIPRODUCTS PVT LTD-NETBANK, MUM-N180222015572953-5 5133",,,net_banking_transfer,-55133
632ae6c92e1a0ebb7f46f846,50200023535069,538875.75,60ec41ba55c00300382672d9,HDFC,direct expenses,5eecc6d6449e4f7cfb1c2708,2022-06-29T00:00:00.000Z,"NEFT DR-KKBK0001393-MASCOT SPINCONTROL I NDIA PVT LTD-NETBANK, MUM-N1802220155969 13-75600",,,net_banking_transfer,-75600
632ae6c92e1a0ebb7f46f848,50200023535069,513875.75,60ec41ba55c00300382672d9,HDFC,direct expenses,5eecc6d6449e4f7cfb1c2708,2022-06-29T00:00:00.000Z,"NEFT DR-ICIC0000542-AVANTIKA SUKHIA-NETB ANK, MUM-N180222015611533-25000",,,net_banking_transfer,-25000
632ae6c92e1a0ebb7f46f84a,50200023535069,459875.75,60ec41ba55c00300382672d9,HDFC,direct expenses,5eecc6d6449e4f7cfb1c2708,2022-06-29T00:00:00.000Z,50200044693544-TPT-54000-POCKET ACES PIC TURES PRIVATE LIMITED,,,net_banking_transfer,-54000
632ae6c92e1a0ebb7f46f84c,50200023535069,459720.65,60ec41ba55c00300382672d9,HDFC,bank charges,5eecc6d6449e4f7cfb1c2708,2022-06-29T00:00:00.000Z,.DC INTL POS TXN MARKUP+ST 290422 020522 -CDT2215209278210,,,international_transaction_arbitrage,-155.1
632ae6c92e1a0ebb7f46f84e,50200023535069,459717.65,60ec41ba55c00300382672d9,HDFC,Marketing Expense,5eecc6d6449e4f7cfb1c2708,2022-06-29T00:00:00.000Z,ME DC SI 514834XXXXXX9486 FACEBOOK INDIA ONLINE,,,Other,-3
632ae6c92e1a0ebb7f46f850,50200023535069,489320.32,60ec41ba55c00300382672d9,HDFC,Revenue-COD,5eecc6d6449e4f7cfb1c2708,2022-06-29T00:00:00.000Z,NEFT CR-ICIC0000155-SHIPROCKET COD CRF I,,,net_banking_transfer,29602.67
632ae6c92e1a0ebb7f46f854,50200023535069,501598.96,60ec41ba55c00300382672d9,HDFC,Transfer in/Revenue-other,5eecc6d6449e4f7cfb1c2708,2022-06-29T00:00:00.000Z,"IMPS-218016845043-GOKWIK COMMERCE SOLU-I CIC-XXXXXXXX0630-PAYOUT FOR JUNE 27, 202 2",,,net_banking_transfer,12278.64
632ae6c92e1a0ebb7f46f856,50200023535069,504571.26,60ec41ba55c00300382672d9,HDFC,Transfer in/Revenue-other,5eecc6d6449e4f7cfb1c2708,2022-06-29T00:00:00.000Z,NEFT CR-CITI0000004-ONE SIGMA TECHNOLOGI ES PVT LTD-SLICK ORGANICS PRIVATE LIMITE D-CITIN22296906771,insurance,insurance,net_banking_transfer,2972.3
632ae6c92e1a0ebb7f46f858,50200023535069,499571.26,60ec41ba55c00300382672d9,HDFC,Refund,5eecc6d6449e4f7cfb1c2708,2022-06-29T00:00:00.000Z,"NEFT DR-RATN0VAAPIS-RAZORPAY REFUND CRED ITS TOPUP-NETBANK, MUM-N180222016068563- 5000",,,net_banking_transfer,-5000
632ae6c92e1a0ebb7f46f85a,50200023535069,494571.26,60ec41ba55c00300382672d9,HDFC,direct expenses,5eecc6d6449e4f7cfb1c2708,2022-06-29T00:00:00.000Z,"NEFT DR-ICIC0000021-AKHILESH DIXIT-NETBA NK, MUM-N180222016063471-5000",,,net_banking_transfer,-5000
632ae6c92e1a0ebb7f46f85c,50200023535069,510150.3,60ec41ba55c00300382672d9,HDFC,Revenue-PG-split enabled,5eecc6d6449e4f7cfb1c2708,2022-06-29T00:00:00.000Z,NEFT CR-UTIB0001506-RAZORPAY SOFTWARE PR IVATE LIMITED-SLICK ORGANICS PVT LITD-AX ISCN0151744732,insurance,insurance,net_banking_transfer,15579.04
632ae6c92e1a0ebb7f46f85e,50200023535069,528942.7,60ec41ba55c00300382672d9,HDFC,Revenue-UPI,5eecc6d6449e4f7cfb1c2708,2022-06-29T00:00:00.000Z,UPI-GOKWIK-GOKWIK@YESBANK-YESB0000340-21 8038462270-PAYOUT FOR JUNE 27,,,upi,18792.4
632ae6c92e1a0ebb7f46f860,50200023535069,530621.7,60ec41ba55c00300382672d9,HDFC,Revenue-Mktplace,5eecc6d6449e4f7cfb1c2708,2022-06-29T00:00:00.000Z,POS REF 514834******9486-06/29 AMAZON,shopping,,refund,1679
632ae6c92e1a0ebb7f46f862,50200023535069,545934.31,60ec41ba55c00300382672d9,HDFC,Revenue-PG-non-split,5eecc6d6449e4f7cfb1c2708,2022-06-30T00:00:00.000Z,IMPS-218105379031-PAYTM PAYMENTS SERVI-P YTM-XXXXXXXXXX0008-ALL202206302168200003 30830668628,ewallet,,net_banking_transfer,15312.61
632ae6c92e1a0ebb7f46f864,50200023535069,559814.81,60ec41ba55c00300382672d9,HDFC,Revenue-PG-split enabled,5eecc6d6449e4f7cfb1c2708,2022-06-30T00:00:00.000Z,NEFT CR-UTIB0001506-RAZORPAY SOFTWARE PR IVATE LIMITED-SLICK ORGANICS PVT LITD-AX ISCN0151826625,insurance,insurance,net_banking_transfer,13880.5
632ae6ca2e1a0ebb7f46f866,50200023535069,557424.81,60ec41ba55c00300382672d9,HDFC,direct expenses,5eecc6d6449e4f7cfb1c2708,2022-06-30T00:00:00.000Z,"NEFT DR-UTIB0000119-SAFEXPRESS-NETBANK, MUM-N181222017088145-2390",,,net_banking_transfer,-2390
632ae6ca2e1a0ebb7f46f868,50200023535069,555939.19,60ec41ba55c00300382672d9,HDFC,bank charges,5eecc6d6449e4f7cfb1c2708,2022-06-30T00:00:00.000Z,.DC INTL POS TXN MARKUP+ST 020522 040522 -CDT2215209278210,,,international_transaction_arbitrage,-1485.62
632ae6ca2e1a0ebb7f46f86a,50200023535069,541039.19,60ec41ba55c00300382672d9,HDFC,direct expenses,5eecc6d6449e4f7cfb1c2708,2022-06-30T00:00:00.000Z,POS 514834XXXXXX9486 ARVIND LIFESTYLE,shopping,,debit_card,-14900
632ae6ca2e1a0ebb7f46f86c,50200023535069,522799.19,60ec41ba55c00300382672d9,HDFC,direct expenses,5eecc6d6449e4f7cfb1c2708,2022-06-30T00:00:00.000Z,"NEFT DR-KKBK0000173-NITISH KUMAR MANDAL- NETBANK, MUM-N181222017441198-18240",,,net_banking_transfer,-18240
632ae6ca2e1a0ebb7f46f86e,50200023535069,520374.55,60ec41ba55c00300382672d9,HDFC,direct expenses,5eecc6d6449e4f7cfb1c2708,2022-06-30T00:00:00.000Z,POS 514834XXXXXX9486 AIP*GODADDY INDI,,,debit_card,-2424.64
632ae6ca2e1a0ebb7f46f870,50200023535069,598707.47,60ec41ba55c00300382672d9,HDFC,Transfer in/Revenue-other,5eecc6d6449e4f7cfb1c2708,2022-06-30T00:00:00.000Z,"IMPS-218116239223-GOKWIK COMMERCE SOLU-I CIC-XXXXXXXX0630-PAYOUT FOR JUNE 28, 202 2",,,net_banking_transfer,78332.92
632ae6ca2e1a0ebb7f46f872,50200023535069,596705.01,60ec41ba55c00300382672d9,HDFC,direct expenses,5eecc6d6449e4f7cfb1c2708,2022-06-30T00:00:00.000Z,POS 514834XXXXXX9486 ONE97 COMMUNICAT,ewallet,,debit_card,-2002.46
632ae6ca2e1a0ebb7f46f874,50200023535069,595441.01,60ec41ba55c00300382672d9,HDFC,direct expenses,5eecc6d6449e4f7cfb1c2708,2022-06-30T00:00:00.000Z,POS 514834XXXXXX9486 SMARTSHIFT LOGIS,,,debit_card,-1264
632ae6ca2e1a0ebb7f46f876,50200023535069,610412.87,60ec41ba55c00300382672d9,HDFC,Revenue-PG-split enabled,5eecc6d6449e4f7cfb1c2708,2022-06-30T00:00:00.000Z,NEFT CR-UTIB0001506-RAZORPAY SOFTWARE PR IVATE LIMITED-SLICK ORGANICS PVT LITD-AX ISCN0151996552,insurance,insurance,net_banking_transfer,14971.86
632ae6ca2e1a0ebb7f46f878,50200023535069,108540.87,60ec41ba55c00300382672d9,HDFC,Marketing Expense,5eecc6d6449e4f7cfb1c2708,2022-06-30T00:00:00.000Z,"NEFT DR-CITI0100000-GOOGLE INDIA PVT LTD -NETBANK, MUM-N181222018557983-501872",,,net_banking_transfer,-501872
632ae6ca2e1a0ebb7f46f87a,50200023535069,103540.87,60ec41ba55c00300382672d9,HDFC,direct expenses,5eecc6d6449e4f7cfb1c2708,2022-06-30T00:00:00.000Z,"NEFT DR-ICIC0000021-AKHILESH DIXIT-NETBA NK, MUM-N181222018572471-5000",,,net_banking_transfer,-5000
632ae6ca2e1a0ebb7f46f87c,50200023535069,103361.87,60ec41ba55c00300382672d9,HDFC,SAAS/tech expense,5eecc6d6449e4f7cfb1c2708,2022-06-30T00:00:00.000Z,ME DC SI 514834XXXXXX9486 AMAZON,shopping,,Other,-179
632ae6ca2e1a0ebb7f46f87e,50200023535069,119522.58,60ec41ba55c00300382672d9,HDFC,Revenue-Mktplace,5eecc6d6449e4f7cfb1c2708,2022-07-01T00:00:00.000Z,NEFT CR-DEUT0797BGL-FLIPKART INTERNET PR IVATE LIMITED-SLICK ORGANICS PVT LTD-218 200084GN00118,shopping,,net_banking_transfer,16160.71
632ae6ca2e1a0ebb7f46f880,50200023535069,133316.09,60ec41ba55c00300382672d9,HDFC,Revenue-PG-non-split,5eecc6d6449e4f7cfb1c2708,2022-07-01T00:00:00.000Z,IMPS-218204493511-PAYTM PAYMENTS SERVI-P YTM-XXXXXXXXXX0008-ALL202207012168200003 30830668628,ewallet,,net_banking_transfer,13793.51
632ae6ca2e1a0ebb7f46f883,50200023535069,144652.07,60ec41ba55c00300382672d9,HDFC,Revenue-Mktplace,5eecc6d6449e4f7cfb1c2708,2022-07-01T00:00:00.000Z,NEFT CR-DEUT0797BGL-MYNTRA DESIGNS PRIVA TE LIMITED-SLICK ORGANICS PVT. LTD.-2182 00496GN00070,shopping,,net_banking_transfer,11335.98
632ae6ca2e1a0ebb7f46f885,50200023535069,171082.36,60ec41ba55c00300382672d9,HDFC,Revenue-Mktplace,5eecc6d6449e4f7cfb1c2708,2022-07-01T00:00:00.000Z,NEFT CR-DEUT0797BGL-MYNTRA DESIGNS PRIVA TE LIMITED-SLICK ORGANICS PVT. LTD.-2182 00497GN00176,shopping,,net_banking_transfer,26430.29
632ae6ca2e1a0ebb7f46f887,50200023535069,168788.17,60ec41ba55c00300382672d9,HDFC,direct expenses,5eecc6d6449e4f7cfb1c2708,2022-07-01T00:00:00.000Z,POS 514834XXXXXX9486 SEOPTIMER,,,debit_card,-2294.19
632ae6ca2e1a0ebb7f46f88c,50200023535069,183600.94,60ec41ba55c00300382672d9,HDFC,Revenue-PG-split enabled,5eecc6d6449e4f7cfb1c2708,2022-07-01T00:00:00.000Z,NEFT CR-UTIB0001506-RAZORPAY SOFTWARE PR IVATE LIMITED-SLICK ORGANICS PVT LITD-AX ISCN0152208213,insurance,insurance,net_banking_transfer,14812.77
632ae6ca2e1a0ebb7f46f891,50200023535069,183350.94,60ec41ba55c00300382672d9,HDFC,direct expenses,5eecc6d6449e4f7cfb1c2708,2022-07-01T00:00:00.000Z,POS 514834XXXXXX9486 SMARTSHIFT LOGIS,,,debit_card,-250
632ae6ca2e1a0ebb7f46f893,50200023535069,185558.16,60ec41ba55c00300382672d9,HDFC,Transfer in/Revenue-other,5eecc6d6449e4f7cfb1c2708,2022-07-01T00:00:00.000Z,NEFT CR-UTIB0000114-ONE SIGMA TECHNOLOGI ES PRIVATE LIM-SLICK ORGANICS PRIVATE LI MITED-AXISP00300210258,insurance,insurance,net_banking_transfer,2207.22
632ae6ca2e1a0ebb7f46f896,50200023535069,250907.73,60ec41ba55c00300382672d9,HDFC,Transfer in/Revenue-other,5eecc6d6449e4f7cfb1c2708,2022-07-01T00:00:00.000Z,"IMPS-218216125491-GOKWIK COMMERCE SOLU-I CIC-XXXXXXXX0630-PAYOUT FOR JUNE 29, 202 2",,,net_banking_transfer,65349.57
632ae6ca2e1a0ebb7f46f898,50200023535069,255341.45,60ec41ba55c00300382672d9,HDFC,Revenue-COD,5eecc6d6449e4f7cfb1c2708,2022-07-01T00:00:00.000Z,NEFT CR-ICIC0000155-SHIPROCKET COD CRF I D 4546070-SLICK ORGANICS PVT LTD-CMS2678 404673,insurance,insurance,net_banking_transfer,4433.72
632ae6ca2e1a0ebb7f46f89a,50200023535069,268209.24,60ec41ba55c00300382672d9,HDFC,Revenue-PG-split enabled,5eecc6d6449e4f7cfb1c2708,2022-07-01T00:00:00.000Z,NEFT CR-UTIB0001506-RAZORPAY SOFTWARE PR IVATE LIMITED-SLICK ORGANICS PVT LITD-AX ISCN0152343306,insurance,insurance,net_banking_transfer,12867.79
632ae6ca2e1a0ebb7f46f89c,50200023535069,268212.24,60ec41ba55c00300382672d9,HDFC,Transfer in/Revenue-other,5eecc6d6449e4f7cfb1c2708,2022-07-01T00:00:00.000Z,CRV POS 514834******9486 FACEBOOK INDIA,,,refund,3
632ae6ca2e1a0ebb7f46f89e,50200023535069,276546.72,60ec41ba55c00300382672d9,HDFC,Revenue-PG-non-split,5eecc6d6449e4f7cfb1c2708,2022-07-02T00:00:00.000Z,NEFT CR-PYTM0123456-PAYTM PAYMENTS SERVI CES LIMITED-SLICK ORGANICS PVT LTD-PYTM2 21834588565,insurance,insurance,net_banking_transfer,8334.48
632ae6ca2e1a0ebb7f46f8a0,50200023535069,296209.34,60ec41ba55c00300382672d9,HDFC,Revenue-PG-split enabled,5eecc6d6449e4f7cfb1c2708,2022-07-02T00:00:00.000Z,NEFT CR-UTIB0001506-RAZORPAY SOFTWARE PR IVATE LIMITED-SLICK ORGANICS PVT LITD-AX ISCN0152417878,insurance,insurance,net_banking_transfer,19662.62
632ae6ca2e1a0ebb7f46f8a3,50200023535069,96209.34,60ec41ba55c00300382672d9,HDFC,direct expenses,5eecc6d6449e4f7cfb1c2708,2022-07-02T00:00:00.000Z,"NEFT DR-YESB0000551-VISTTA COSMETICS-NET BANK, MUM-N183222021733905-200000",,,net_banking_transfer,-200000
632ae6ca2e1a0ebb7f46f8a5,50200023535069,137093.09,60ec41ba55c00300382672d9,HDFC,Transfer in/Revenue-other,5eecc6d6449e4f7cfb1c2708,2022-07-02T00:00:00.000Z,"IMPS-218316762954-GOKWIK COMMERCE SOLU-I CIC-XXXXXXXX0630-PAYOUT FOR JUNE 30, 202 2",,,net_banking_transfer,40883.75
632ae6ca2e1a0ebb7f46f8a7,50200023535069,142774.9,60ec41ba55c00300382672d9,HDFC,Revenue-PG-split enabled,5eecc6d6449e4f7cfb1c2708,2022-07-02T00:00:00.000Z,NEFT CR-UTIB0001506-RAZORPAY SOFTWARE PR IVATE LIMITED-SLICK ORGANICS PVT LITD-AX ISCN0152566530,insurance,insurance,net_banking_transfer,5681.81
632ae6ca2e1a0ebb7f46f8a9,50200023535069,160035.9,60ec41ba55c00300382672d9,HDFC,Revenue-Mktplace,5eecc6d6449e4f7cfb1c2708,2022-07-02T00:00:00.000Z,NEFT CR-KKBK0000958-THREPSI SOLUTIONS PV T LTD KOLKATA-SLICK ORGANICS PRIVATE LI MITED-KKBK221838033839,insurance,insurance,net_banking_transfer,17261
632ae6ca2e1a0ebb7f46f8ab,50200023535069,153315.13,60ec41ba55c00300382672d9,HDFC,SAAS/tech expense,5eecc6d6449e4f7cfb1c2708,2022-07-02T00:00:00.000Z,POS 514834XXXXXX9486 AMAZON.COM,shopping,,debit_card,-6720.77
632ae6ca2e1a0ebb7f46f8ad,50200023535069,166395.46,60ec41ba55c00300382672d9,HDFC,Revenue-PG-non-split,5eecc6d6449e4f7cfb1c2708,2022-07-03T00:00:00.000Z,IMPS-218405166291-PAYTM PAYMENTS SERVI-P YTM-XXXXXXXXXX0008-ALL202207032168200003 30830668628,ewallet,,net_banking_transfer,13080.33
632ae6ca2e1a0ebb7f46f8af,50200023535069,233154.77,60ec41ba55c00300382672d9,HDFC,Transfer in/Revenue-other,5eecc6d6449e4f7cfb1c2708,2022-07-03T00:00:00.000Z,"IMPS-218416656943-GOKWIK COMMERCE SOLU-I CIC-XXXXXXXX0630-PAYOUT FOR JULY 1, 2022",,,net_banking_transfer,66759.31
632ae6ca2e1a0ebb7f46f8b1,50200023535069,240673.33,60ec41ba55c00300382672d9,HDFC,Revenue-PG-non-split,5eecc6d6449e4f7cfb1c2708,2022-07-04T00:00:00.000Z,NEFT CR-PYTM0123456-PAYTM PAYMENTS SERVI CES LIMITED-SLICK ORGANICS PVT LTD-PYTM2 21856686628,insurance,insurance,net_banking_transfer,7518.56
632ae6ca2e1a0ebb7f46f8b3,50200023535069,253420.57,60ec41ba55c00300382672d9,HDFC,Revenue-Mktplace,5eecc6d6449e4f7cfb1c2708,2022-07-04T00:00:00.000Z,NEFT CR-DEUT0797BGL-FLIPKART INTERNET PR IVATE LIMITED-SLICK ORGANICS PVT LTD-218 500194GN00048,shopping,,net_banking_transfer,12747.24
632ae6ca2e1a0ebb7f46f8b5,50200023535069,286956.26,60ec41ba55c00300382672d9,HDFC,Revenue-Mktplace,5eecc6d6449e4f7cfb1c2708,2022-07-04T00:00:00.000Z,NEFT CR-DEUT0797BGL-MYNTRA DESIGNS PRIVA,shopping,,net_banking_transfer,33535.69
632ae6ca2e1a0ebb7f46f8b7,50200023535069,300676.22,60ec41ba55c00300382672d9,HDFC,Revenue-Mktplace,5eecc6d6449e4f7cfb1c2708,2022-07-04T00:00:00.000Z,NEFT CR-DEUT0797BGL-MYNTRA DESIGNS PRIVA TE LIMITED-SLICK ORGANICS PVT. LTD.-2185 00508GN00112,shopping,,net_banking_transfer,13719.96
632ae6ca2e1a0ebb7f46f8b9,50200023535069,338714.73,60ec41ba55c00300382672d9,HDFC,Revenue-PG-split enabled,5eecc6d6449e4f7cfb1c2708,2022-07-04T00:00:00.000Z,NEFT CR-UTIB0001506-RAZORPAY SOFTWARE PR IVATE LIMITED-SLICK ORGANICS PVT LITD-AX ISCN0152705116,insurance,insurance,net_banking_transfer,38038.51
632ae6ca2e1a0ebb7f46f8bb,50200023535069,338057.83,60ec41ba55c00300382672d9,HDFC,direct expenses,5eecc6d6449e4f7cfb1c2708,2022-07-04T00:00:00.000Z,"NEFT DR-FDRL0007777-JYOTIKARATNA GUDDAD- NETBANK, MUM-N185222022904421-657",,,net_banking_transfer,-656.9
632ae6ca2e1a0ebb7f46f8bd,50200023535069,223812.83,60ec41ba55c00300382672d9,HDFC,direct expenses,5eecc6d6449e4f7cfb1c2708,2022-07-04T00:00:00.000Z,"NEFT DR-UTIB0000032-SKUMAR MULTIPRODUCTS PVT LTD-NETBANK, MUM-N185222022946574-1 14245",,,net_banking_transfer,-114245
632ae6ca2e1a0ebb7f46f8bf,50200023535069,180312.83,60ec41ba55c00300382672d9,HDFC,direct expenses,5eecc6d6449e4f7cfb1c2708,2022-07-04T00:00:00.000Z,50200025384647-TPT-43500-AG POLY PACKS P VT LTD,,,net_banking_transfer,-43500
632ae6ca2e1a0ebb7f46f8c1,50200023535069,185746.13,60ec41ba55c00300382672d9,HDFC,Transfer in/Revenue-other,5eecc6d6449e4f7cfb1c2708,2022-07-04T00:00:00.000Z,NEFT CR-UTIB0000114-ONE SIGMA TECHNOLOGI ES PRIVATE LIM-SLICK ORGANICS PRIVATE LI MITED-AXISP00300918370,insurance,insurance,net_banking_transfer,5433.3
632ae6ca2e1a0ebb7f46f8c3,50200023535069,191850.78,60ec41ba55c00300382672d9,HDFC,Transfer in/Revenue-other,5eecc6d6449e4f7cfb1c2708,2022-07-04T00:00:00.000Z,NEFT CR-UTIB0000114-ONE SIGMA TECHNOLOGI ES PRIVATE LIM-SLICK ORGANICS PRIVATE LI MITED-AXISP00300918048,insurance,insurance,net_banking_transfer,6104.65
632ae6ca2e1a0ebb7f46f8c5,50200023535069,198839.3,60ec41ba55c00300382672d9,HDFC,Transfer in/Revenue-other,5eecc6d6449e4f7cfb1c2708,2022-07-04T00:00:00.000Z,NEFT CR-UTIB0000114-ONE SIGMA TECHNOLOGI ES PRIVATE LIM-SLICK ORGANICS PRIVATE LI MITED-AXISP00300918221,insurance,insurance,net_banking_transfer,6988.52
632ae6ca2e1a0ebb7f46f8c7,50200023535069,246416.72,60ec41ba55c00300382672d9,HDFC,Transfer in/Revenue-other,5eecc6d6449e4f7cfb1c2708,2022-07-04T00:00:00.000Z,"IMPS-218516669095-GOKWIK COMMERCE SOLU-I CIC-XXXXXXXX0630-PAYOUT FOR JULY 2, 2022",,,net_banking_transfer,47577.42
632ae6ca2e1a0ebb7f46f8c9,50200023535069,352584.16,60ec41ba55c00300382672d9,HDFC,Revenue-COD,5eecc6d6449e4f7cfb1c2708,2022-07-04T00:00:00.000Z,NEFT CR-ICIC0000155-SHIPROCKET COD CRF I D 4554244-SLICK ORGANICS PVT LTD-CMS2683 270357,insurance,insurance,net_banking_transfer,106167.44
632ae6ca2e1a0ebb7f46f8cb,50200023535069,352585.16,60ec41ba55c00300382672d9,HDFC,Revenue-Mktplace,5eecc6d6449e4f7cfb1c2708,2022-07-04T00:00:00.000Z,NEFT CR-SCBL0036001-M/S DREAMPLUG TECHNO -SLICK ORGANICS PRIVATE LIMITEDSLICK-SIN 31436Q0044039,insurance,insurance,net_banking_transfer,1
632ae6ca2e1a0ebb7f46f8cd,50200023535069,662885.16,60ec41ba55c00300382672d9,HDFC,Transfer in/Revenue-other,5eecc6d6449e4f7cfb1c2708,2022-07-04T00:00:00.000Z,00640330000510-SLICK ORGANICS PVT L,insurance,insurance,Other,310300
632ae6ca2e1a0ebb7f46f8cf,50200023535069,670376.26,60ec41ba55c00300382672d9,HDFC,Revenue-PG-split enabled,5eecc6d6449e4f7cfb1c2708,2022-07-04T00:00:00.000Z,NEFT CR-UTIB0001506-RAZORPAY SOFTWARE PR,,,net_banking_transfer,7491.1
632ae6ca2e1a0ebb7f46f8d2,50200023535069,681672.26,60ec41ba55c00300382672d9,HDFC,Revenue-COD,5eecc6d6449e4f7cfb1c2708,2022-07-04T00:00:00.000Z,NEFT CR-KKBK0000958-PICKRR TECHNOLOGIES PVT LTD-SLICKORGANICSPRIVATELIMITED-CMS1 852218805719,insurance,insurance,net_banking_transfer,11296
632ae6ca2e1a0ebb7f46f8d4,50200023535069,695126.23,60ec41ba55c00300382672d9,HDFC,Revenue-PG-non-split,5eecc6d6449e4f7cfb1c2708,2022-07-05T00:00:00.000Z,IMPS-218604664807-PAYTM PAYMENTS SERVI-P YTM-XXXXXXXXXX0008-ALL202207052168200003 30830668628,ewallet,,net_banking_transfer,13453.97
632ae6ca2e1a0ebb7f46f8d7,50200023535069,622685.23,60ec41ba55c00300382672d9,HDFC,direct expenses,5eecc6d6449e4f7cfb1c2708,2022-07-05T00:00:00.000Z,"NEFT DR-KKBK0000173-MATRIX PRINTING SOLU TIONS PRIVATE LIMITE-NETBANK, MUM-N18622 2024377254-72441",,,net_banking_transfer,-72441
632ae6ca2e1a0ebb7f46f8de,50200023535069,565504.23,60ec41ba55c00300382672d9,HDFC,direct expenses,5eecc6d6449e4f7cfb1c2708,2022-07-05T00:00:00.000Z,"NEFT DR-ICIC0006643-KRISHNA PACKAGING CO MPANY-NETBANK, MUM-N186222024396113-5718 1",,,net_banking_transfer,-57181
632ae6ca2e1a0ebb7f46f8e0,50200023535069,438504.23,60ec41ba55c00300382672d9,HDFC,direct expenses,5eecc6d6449e4f7cfb1c2708,2022-07-05T00:00:00.000Z,"NEFT DR-IDFB0040101-ACTIVES ADDITIVES AP PLICATIONS LLP-NETBANK, MUM-N18622202423 5034-127000",insurance,insurance,net_banking_transfer,-127000
632ae6ca2e1a0ebb7f46f8e2,50200023535069,422928.23,60ec41ba55c00300382672d9,HDFC,direct expenses,5eecc6d6449e4f7cfb1c2708,2022-07-05T00:00:00.000Z,50200043297657-TPT-15576-AIDC PRODUCTS I NDIA PRIVATE LIMITED,,,net_banking_transfer,-15576
632ae6ca2e1a0ebb7f46f8e4,50200023535069,407828.23,60ec41ba55c00300382672d9,HDFC,direct expenses,5eecc6d6449e4f7cfb1c2708,2022-07-05T00:00:00.000Z,"NEFT DR-SBIN0008078-PANDIT PLASTICS-NETB ANK, MUM-N186222024393279-15100",,,net_banking_transfer,-15100
632ae6ca2e1a0ebb7f46f8e7,50200023535069,342655.23,60ec41ba55c00300382672d9,HDFC,direct expenses,5eecc6d6449e4f7cfb1c2708,2022-07-05T00:00:00.000Z,"NEFT DR-PUNB0062910-YADAVPACKAGING-NETBA NK, MUM-N186222024379781-65173",,,net_banking_transfer,-65173
632ae6ca2e1a0ebb7f46f8ea,50200023535069,347654.16,60ec41ba55c00300382672d9,HDFC,Revenue-Mktplace,5eecc6d6449e4f7cfb1c2708,2022-07-05T00:00:00.000Z,NEFT CR-DEUT0797BGL-MYNTRA DESIGNS PRIVA TE LIMITED-SLICK ORGANICS PVT. LTD.-2186 00398GN00286,shopping,,net_banking_transfer,4998.93
632ae6ca2e1a0ebb7f46f8ec,50200023535069,352743.3,60ec41ba55c00300382672d9,HDFC,Revenue-Mktplace,5eecc6d6449e4f7cfb1c2708,2022-07-05T00:00:00.000Z,NEFT CR-DEUT0797BGL-MYNTRA DESIGNS PRIVA TE LIMITED-SLICK ORGANICS PVT. LTD.-2186 00402GN00086,shopping,,net_banking_transfer,5089.14
632ae6ca2e1a0ebb7f46f8ee,50200023535069,374272.5,60ec41ba55c00300382672d9,HDFC,Revenue-PG-split enabled,5eecc6d6449e4f7cfb1c2708,2022-07-05T00:00:00.000Z,NEFT CR-UTIB0001506-RAZORPAY SOFTWARE PR,,,net_banking_transfer,21529.2
632ae6ca2e1a0ebb7f46f8f0,50200023535069,274272.5,60ec41ba55c00300382672d9,HDFC,direct expenses,5eecc6d6449e4f7cfb1c2708,2022-07-05T00:00:00.000Z,"NEFT DR-SBIN0011783-GALACTIC GRIP-NETBAN K, MUM-N186222024547771-100000",,,net_banking_transfer,-100000
632ae6ca2e1a0ebb7f46f8f2,50200023535069,276053.85,60ec41ba55c00300382672d9,HDFC,Transfer in/Revenue-other,5eecc6d6449e4f7cfb1c2708,2022-07-05T00:00:00.000Z,NEFT CR-UTIB0000114-ONE SIGMA TECHNOLOGI ES PRIVATE LIM-SLICK ORGANICS PRIVATE LI MITED-AXISP00301155536,insurance,insurance,net_banking_transfer,1781.35
632ae6ca2e1a0ebb7f46f8f4,50200023535069,719777.18,60ec41ba55c00300382672d9,HDFC,Revenue-Mktplace,5eecc6d6449e4f7cfb1c2708,2022-07-05T00:00:00.000Z,NEFT CR-DEUT0797BGL-AMAZON PAY (INDIA) P RIVATE LIMITED-SLICK ORGANICS PVT LTD-21 8600473GN00047,shopping,,net_banking_transfer,443723.33
632ae6ca2e1a0ebb7f46f8f6,50200023535069,731524.31,60ec41ba55c00300382672d9,HDFC,Revenue-Mktplace,5eecc6d6449e4f7cfb1c2708,2022-07-05T00:00:00.000Z,IMPS-218611361466-AMAZON SELLER SERVIC-H SBC-XXXXXXXX6004-3O8QKC67SKILAX9PSLICK O RGANICS PVT LTD,shopping,,net_banking_transfer,11747.13
632ae6ca2e1a0ebb7f46f8f8,50200023535069,731252.31,60ec41ba55c00300382672d9,HDFC,direct expenses,5eecc6d6449e4f7cfb1c2708,2022-07-05T00:00:00.000Z,POS 514834XXXXXX9486 SMARTSHIFT LOGIS,,,debit_card,-272
632ae6ca2e1a0ebb7f46f8fa,50200023535069,730903.31,60ec41ba55c00300382672d9,HDFC,direct expenses,5eecc6d6449e4f7cfb1c2708,2022-07-05T00:00:00.000Z,POS 514834XXXXXX9486 SMARTSHIFT LOGIS,,,debit_card,-349
632ae6ca2e1a0ebb7f46f8fc,50200023535069,797554.43,60ec41ba55c00300382672d9,HDFC,Transfer in/Revenue-other,5eecc6d6449e4f7cfb1c2708,2022-07-05T00:00:00.000Z,"IMPS-218616081957-GOKWIK COMMERCE SOLU-I CIC-XXXXXXXX0630-PAYOUT FOR JULY 3, 2022",,,net_banking_transfer,66651.12
632ae6ca2e1a0ebb7f46f8fe,50200023535069,813202.15,60ec41ba55c00300382672d9,HDFC,Revenue-PG-split enabled,5eecc6d6449e4f7cfb1c2708,2022-07-05T00:00:00.000Z,NEFT CR-UTIB0001506-RAZORPAY SOFTWARE PR IVATE LIMITED-SLICK ORGANICS PVT LITD-AX ISCN0153104904,insurance,insurance,net_banking_transfer,15647.72
632ae6ca2e1a0ebb7f46f900,50200023535069,818306.42,60ec41ba55c00300382672d9,HDFC,Revenue-Mktplace,5eecc6d6449e4f7cfb1c2708,2022-07-06T00:00:00.000Z,NEFT CR-DEUT0797BGL-FLIPKART INTERNET PR IVATE LIMITED-SLICK ORGANICS PVT LTD-218 700140GN00262,shopping,,net_banking_transfer,5104.27
632ae6ca2e1a0ebb7f46f902,50200023535069,853796.76,60ec41ba55c00300382672d9,HDFC,Revenue-PG-non-split,5eecc6d6449e4f7cfb1c2708,2022-07-06T00:00:00.000Z,NEFT CR-PYTM0123456-PAYTM PAYMENTS SERVI CES LIMITED-SLICK ORGANICS PVT LTD-PYTM2 21878709274,insurance,insurance,net_banking_transfer,35490.34
632ae6ca2e1a0ebb7f46f904,50200023535069,872229.25,60ec41ba55c00300382672d9,HDFC,Revenue-PG-split enabled,5eecc6d6449e4f7cfb1c2708,2022-07-06T00:00:00.000Z,NEFT CR-UTIB0001506-RAZORPAY SOFTWARE PR IVATE LIMITED-SLICK ORGANICS PVT LITD-AX ISCN0153172975,insurance,insurance,net_banking_transfer,18432.49
632ae6ca2e1a0ebb7f46f906,50200023535069,881308.35,60ec41ba55c00300382672d9,HDFC,Revenue-Mktplace,5eecc6d6449e4f7cfb1c2708,2022-07-06T00:00:00.000Z,NEFT CR-HSBC0400002-AMAZON SERVICES LLC- SLICK ORGANICS PRIVATE LIMITED-HSBCN2218 7726113,shopping,,net_banking_transfer,9079.1
632ae6ca2e1a0ebb7f46f908,50200023535069,884657.73,60ec41ba55c00300382672d9,HDFC,Revenue-Mktplace,5eecc6d6449e4f7cfb1c2708,2022-07-06T00:00:00.000Z,NEFT CR-DEUT0797BGL-MYNTRA DESIGNS PRIVA,shopping,,net_banking_transfer,3349.38
632ae6ca2e1a0ebb7f46f90a,50200023535069,888353.55,60ec41ba55c00300382672d9,HDFC,Revenue-Mktplace,5eecc6d6449e4f7cfb1c2708,2022-07-06T00:00:00.000Z,NEFT CR-DEUT0797BGL-MYNTRA DESIGNS PRIVA TE LIMITED-SLICK ORGANICS PVT. LTD.-2187 00828GN00039,shopping,,net_banking_transfer,3695.82
632ae6ca2e1a0ebb7f46f90d,50200023535069,866695.55,60ec41ba55c00300382672d9,HDFC,direct expenses,5eecc6d6449e4f7cfb1c2708,2022-07-06T00:00:00.000Z,"NEFT DR-HSBC0400002-ARAMEX INDIA PVT LTD -NETBANK, MUM-N187222026744186-21658",,,net_banking_transfer,-21658
632ae6ca2e1a0ebb7f46f90f,50200023535069,866693.55,60ec41ba55c00300382672d9,HDFC,Marketing Expense,5eecc6d6449e4f7cfb1c2708,2022-07-06T00:00:00.000Z,ME DC SI 514834XXXXXX9486 LINKEDIN,,,Other,-2
632ae6ca2e1a0ebb7f46f911,50200023535069,867071.36,60ec41ba55c00300382672d9,HDFC,Transfer in/Revenue-other,5eecc6d6449e4f7cfb1c2708,2022-07-06T00:00:00.000Z,NEFT CR-UTIB0000114-ONE SIGMA TECHNOLOGI ES PRIVATE LIM-SLICK ORGANICS PRIVATE LI MITED-AXISP00301499090,insurance,insurance,net_banking_transfer,377.81
632ae6cb2e1a0ebb7f46f913,50200023535069,1967071.36,60ec41ba55c00300382672d9,HDFC,Internal Transfers,5eecc6d6449e4f7cfb1c2708,2022-07-06T00:00:00.000Z,IB FUNDS TRANSFER CR-50200035187206 -SL ICK ORGANICS PVT LTD,insurance,insurance,Other,1100000
632ae6cb2e1a0ebb7f46f915,50200023535069,2018428.2,60ec41ba55c00300382672d9,HDFC,Transfer in/Revenue-other,5eecc6d6449e4f7cfb1c2708,2022-07-06T00:00:00.000Z,"IMPS-218716345127-GOKWIK COMMERCE SOLU-I CIC-XXXXXXXX0630-PAYOUT FOR JULY 4, 2022",,,net_banking_transfer,51356.84
632ae6cb2e1a0ebb7f46f917,50200023535069,2017979.2,60ec41ba55c00300382672d9,HDFC,SAAS/tech expense,5eecc6d6449e4f7cfb1c2708,2022-07-06T00:00:00.000Z,POS 514834XXXXXX9486 AMAZON,shopping,,debit_card,-449
632ae6cb2e1a0ebb7f46f919,50200023535069,1981729.2,60ec41ba55c00300382672d9,HDFC,direct expenses,5eecc6d6449e4f7cfb1c2708,2022-07-06T00:00:00.000Z,"NEFT DR-ICIC0000874-TRELION BUSINESS SOL UTIONS PVT LTD-NETBANK, MUM-N18722202756 6220-36250",,,net_banking_transfer,-36250
632ae6cb2e1a0ebb7f46f91b,50200023535069,1949665.2,60ec41ba55c00300382672d9,HDFC,direct expenses,5eecc6d6449e4f7cfb1c2708,2022-07-06T00:00:00.000Z,04851000021473-TPT-32064-SURINA KAKKAR,,,net_banking_transfer,-32064
632ae6cb2e1a0ebb7f46f91d,50200023535069,1973386.1,60ec41ba55c00300382672d9,HDFC,Revenue-PG-split enabled,5eecc6d6449e4f7cfb1c2708,2022-07-06T00:00:00.000Z,NEFT CR-UTIB0001506-RAZORPAY SOFTWARE PR IVATE LIMITED-SLICK ORGANICS PVT LITD-AX ISCN0153301924,insurance,insurance,net_banking_transfer,23720.9
632ae6cb2e1a0ebb7f46f91f,50200023535069,809021.1,60ec41ba55c00300382672d9,HDFC,Marketing Expense,5eecc6d6449e4f7cfb1c2708,2022-07-06T00:00:00.000Z,"NEFT DR-CITI0000006-FACEBOOK INDIA ONLIN E SERVICES PVT LTD-NETBANK, MUM-N1872220 27569150-1164365",,,net_banking_transfer,-1164365
632ae6cb2e1a0ebb7f46f921,50200023535069,2809021.1,60ec41ba55c00300382672d9,HDFC,Internal Transfers,5eecc6d6449e4f7cfb1c2708,2022-07-06T00:00:00.000Z,IB FUNDS TRANSFER CR-50200035187206 -SL ICK ORGANICS PVT LTD,insurance,insurance,Other,2000000
632ae6cb2e1a0ebb7f46f924,50200023535069,1809021.1,60ec41ba55c00300382672d9,HDFC,direct expenses,5eecc6d6449e4f7cfb1c2708,2022-07-06T00:00:00.000Z,"NEFT DR-ICIC0000369-BO INTERNATIONAL-NET BANK, MUM-N187222027662314-1000000",,,net_banking_transfer,-1000000
632ae6cb2e1a0ebb7f46f926,50200023535069,1371428.1,60ec41ba55c00300382672d9,HDFC,direct expenses,5eecc6d6449e4f7cfb1c2708,2022-07-06T00:00:00.000Z,NEFT DR-SCBL0036025-DHRUV MADHOK-NETBANK,,,net_banking_transfer,-437593
632ae6cb2e1a0ebb7f46f928,50200023535069,1439283.88,60ec41ba55c00300382672d9,HDFC,Revenue-COD,5eecc6d6449e4f7cfb1c2708,2022-07-06T00:00:00.000Z,NEFT CR-ICIC0000155-SHIPROCKET COD CRF I D 4566597-SLICK ORGANICS PVT LTD-CMS2688 125375,insurance,insurance,net_banking_transfer,67855.78
632ae6cb2e1a0ebb7f46f92b,50200023535069,1419475.88,60ec41ba55c00300382672d9,HDFC,direct expenses,5eecc6d6449e4f7cfb1c2708,2022-07-07T00:00:00.000Z,02711600008220 NET BANKING SI -19808,,,Other,-19808
632ae6cb2e1a0ebb7f46f92d,50200023535069,1351975.88,60ec41ba55c00300382672d9,HDFC,direct expenses,5eecc6d6449e4f7cfb1c2708,2022-07-07T00:00:00.000Z,50100064106714 NET BANKING SI -67500,,,Other,-67500
632ae6cb2e1a0ebb7f46f92f,50200023535069,1178456.88,60ec41ba55c00300382672d9,HDFC,direct expenses,5eecc6d6449e4f7cfb1c2708,2022-07-07T00:00:00.000Z,50100155115510 NET BANKING SI -173519,,,Other,-173519
632ae6cb2e1a0ebb7f46f931,50200023535069,1123027.88,60ec41ba55c00300382672d9,HDFC,direct expenses,5eecc6d6449e4f7cfb1c2708,2022-07-07T00:00:00.000Z,50100293329616 NET BANKING SI -55429,,,Other,-55429
632ae6cb2e1a0ebb7f46f933,50200023535069,1082707.88,60ec41ba55c00300382672d9,HDFC,direct expenses,5eecc6d6449e4f7cfb1c2708,2022-07-07T00:00:00.000Z,00901610080520 NET BANKING SI -40320,,,Other,-40320
632ae6cb2e1a0ebb7f46f935,50200023535069,1041040.88,60ec41ba55c00300382672d9,HDFC,direct expenses,5eecc6d6449e4f7cfb1c2708,2022-07-07T00:00:00.000Z,50100108772229 NET BANKING SI -41667,,,Other,-41667
632ae6cb2e1a0ebb7f46f938,50200023535069,990484.88,60ec41ba55c00300382672d9,HDFC,direct expenses,5eecc6d6449e4f7cfb1c2708,2022-07-07T00:00:00.000Z,50100362612187 NET BANKING SI -50556,,,Other,-50556
632ae6cb2e1a0ebb7f46f93a,50200023535069,872747.88,60ec41ba55c00300382672d9,HDFC,direct expenses,5eecc6d6449e4f7cfb1c2708,2022-07-07T00:00:00.000Z,50100093802387 NET BANKING SI -117737,,,Other,-117737
632ae6cb2e1a0ebb7f46f93c,50200023535069,850885.88,60ec41ba55c00300382672d9,HDFC,direct expenses,5eecc6d6449e4f7cfb1c2708,2022-07-07T00:00:00.000Z,50100349886722 NET BANKING SI -21862,,,Other,-21862
632ae6cb2e1a0ebb7f46f93e,50200023535069,828493.88,60ec41ba55c00300382672d9,HDFC,direct expenses,5eecc6d6449e4f7cfb1c2708,2022-07-07T00:00:00.000Z,NEFT DR-BARB0DINARA-MD ARIF RAZA-SANDOZ - MUM-N188222028024852-NET BANKING SI -2 2392,,,net_banking_transfer,-22392
632ae6cb2e1a0ebb7f46f940,50200023535069,806498.88,60ec41ba55c00300382672d9,HDFC,direct expenses,5eecc6d6449e4f7cfb1c2708,2022-07-07T00:00:00.000Z,NEFT DR-PUNB0151400-BHUWAN CHANDER JOSHI -SANDOZ - MUM-N188222028024853-NET BANKI NG SI -21995,,,net_banking_transfer,-21995
632ae6cb2e1a0ebb7f46f942,50200023535069,783344.88,60ec41ba55c00300382672d9,HDFC,direct expenses,5eecc6d6449e4f7cfb1c2708,2022-07-07T00:00:00.000Z,NEFT DR-PUNB0494300-KUNDAN PRASAD-SANDOZ - MUM-N188222028024854-NET BANKING SI - 23154,,,net_banking_transfer,-23154
632ae6cb2e1a0ebb7f46f944,50200023535069,759032.88,60ec41ba55c00300382672d9,HDFC,direct expenses,5eecc6d6449e4f7cfb1c2708,2022-07-07T00:00:00.000Z,NEFT DR-KKBK0005032-DEEPAK YADAV-SANDOZ - MUM-N188222028024855-NET BANKING SI -2 4312,,,net_banking_transfer,-24312
632ae6cb2e1a0ebb7f46f946,50200023535069,743555.88,60ec41ba55c00300382672d9,HDFC,direct expenses,5eecc6d6449e4f7cfb1c2708,2022-07-07T00:00:00.000Z,NEFT DR-CNRB0019016-MANEESH-SANDOZ - MUM -N188222028024856-NET BANKING SI -15477,,,net_banking_transfer,-15477
632ae6cb2e1a0ebb7f46f948,50200023535069,728111.88,60ec41ba55c00300382672d9,HDFC,direct expenses,5eecc6d6449e4f7cfb1c2708,2022-07-07T00:00:00.000Z,NEFT DR-SBIN0017746-MANOJ KUMAR-SANDOZ - MUM-N188222028024857-NET BANKING SI -15 444,,,net_banking_transfer,-15444
632ae6cb2e1a0ebb7f46f94a,50200023535069,707038.88,60ec41ba55c00300382672d9,HDFC,direct expenses,5eecc6d6449e4f7cfb1c2708,2022-07-07T00:00:00.000Z,NEFT DR-PUNB0307800-SANJEEV NIRMANIA-SAN,,,net_banking_transfer,-21073
632ae6cb2e1a0ebb7f46f94c,50200023535069,684821.88,60ec41ba55c00300382672d9,HDFC,N-ACH payments,5eecc6d6449e4f7cfb1c2708,2022-07-07T00:00:00.000Z,NEFT DR-DBSS0IN0811-SACHIN SINGH-SANDOZ - MUM-N188222028024859-NET BANKING SI -2 2217,,,net_banking_transfer,-22217
632ae6cb2e1a0ebb7f46f94e,50200023535069,558715.88,60ec41ba55c00300382672d9,HDFC,direct expenses,5eecc6d6449e4f7cfb1c2708,2022-07-07T00:00:00.000Z,NEFT DR-ICIC0000021-AKHILESH DIXIT-SANDO Z - MUM-N188222028024860-NET BANKING SI -126106,,,net_banking_transfer,-126106
632ae6cb2e1a0ebb7f46f950,50200023535069,523715.88,60ec41ba55c00300382672d9,HDFC,direct expenses,5eecc6d6449e4f7cfb1c2708,2022-07-07T00:00:00.000Z,NEFT DR-ICIC0003851-JITENDER KUMAR-SANDO Z - MUM-N188222028024861-NET BANKING SI -35000,,,net_banking_transfer,-35000
632ae6cb2e1a0ebb7f46f952,50200023535069,493715.88,60ec41ba55c00300382672d9,HDFC,direct expenses,5eecc6d6449e4f7cfb1c2708,2022-07-07T00:00:00.000Z,NEFT DR-KKBK0008365-SRIRAJ GUNDA-SANDOZ - MUM-N188222028024862-NET BANKING SI -3 0000,,,net_banking_transfer,-30000
632ae6cb2e1a0ebb7f46f954,50200023535069,463332.88,60ec41ba55c00300382672d9,HDFC,direct expenses,5eecc6d6449e4f7cfb1c2708,2022-07-07T00:00:00.000Z,NEFT DR-SIBL0000555-JAIVEER KUMAR-SANDOZ - MUM-N188222028024863-NET BANKING SI - 30383,,,net_banking_transfer,-30383
632ae6cb2e1a0ebb7f46f956,50200023535069,438332.88,60ec41ba55c00300382672d9,HDFC,direct expenses,5eecc6d6449e4f7cfb1c2708,2022-07-07T00:00:00.000Z,NEFT DR-BARB0VJGRKA-OM PRASAD PANDEY-SAN DOZ - MUM-N188222028024864-NET BANKING S I -25000,,,net_banking_transfer,-25000
632ae6cb2e1a0ebb7f46f958,50200023535069,414332.88,60ec41ba55c00300382672d9,HDFC,direct expenses,5eecc6d6449e4f7cfb1c2708,2022-07-07T00:00:00.000Z,NEFT DR-PUNB0482100-RAM BHAVAN YADAV-SAN DOZ - MUM-N188222028024865-NET BANKING S I -24000,,,net_banking_transfer,-24000
632ae6cb2e1a0ebb7f46f95a,50200023535069,370968.88,60ec41ba55c00300382672d9,HDFC,direct expenses,5eecc6d6449e4f7cfb1c2708,2022-07-07T00:00:00.000Z,NEFT DR-UTIB0001720-ANUBHAV RAO-SANDOZ - MUM-N188222028024866-NET BANKING SI -43 364,,,net_banking_transfer,-43364
632ae6cb2e1a0ebb7f46f95c,50200023535069,293843.88,60ec41ba55c00300382672d9,HDFC,direct expenses,5eecc6d6449e4f7cfb1c2708,2022-07-07T00:00:00.000Z,NEFT DR-SBIN0070392-APARNA MOHANAN KONAT -SANDOZ - MUM-N188222028024867-NET BANKI NG SI -77125,,,net_banking_transfer,-77125
632ae6cb2e1a0ebb7f46f95e,50200023535069,224555.88,60ec41ba55c00300382672d9,HDFC,direct expenses,5eecc6d6449e4f7cfb1c2708,2022-07-07T00:00:00.000Z,NEFT DR-UTIB0000120-ADNAN ALI-SANDOZ - M UM-N188222028024868-NET BANKING SI -6928 8,,,net_banking_transfer,-69288
632ae6cb2e1a0ebb7f46f960,50200023535069,219025.88,60ec41ba55c00300382672d9,HDFC,direct expenses,5eecc6d6449e4f7cfb1c2708,2022-07-07T00:00:00.000Z,NEFT DR-SCBL0036028-SHUBHAM SINGH PANWAR,,,net_banking_transfer,-5530
632ae6cb2e1a0ebb7f46f962,50200023535069,210983.88,60ec41ba55c00300382672d9,HDFC,direct expenses,5eecc6d6449e4f7cfb1c2708,2022-07-07T00:00:00.000Z,NEFT DR-SCBL0036023-VIVEK YADAV-SANDOZ - MUM-N188222028024871-NET BANKING SI -80 42,,,net_banking_transfer,-8042
632ae6cb2e1a0ebb7f46f964,50200023535069,137916.88,60ec41ba55c00300382672d9,HDFC,direct expenses,5eecc6d6449e4f7cfb1c2708,2022-07-07T00:00:00.000Z,NEFT DR-IOBA0001445-PRIYANKA GOPAL-SANDO Z - MUM-N188222028024872-NET BANKING SI -73067,,,net_banking_transfer,-73067
632ae6cb2e1a0ebb7f46f966,50200023535069,91517.88,60ec41ba55c00300382672d9,HDFC,direct expenses,5eecc6d6449e4f7cfb1c2708,2022-07-07T00:00:00.000Z,NEFT DR-KKBK0008066-KUSHAGRA SINGH-SANDO Z - MUM-N188222028024873-NET BANKING SI -46399,,,net_banking_transfer,-46399
632ae6cb2e1a0ebb7f46f968,50200023535069,-11443.12,60ec41ba55c00300382672d9,HDFC,direct expenses,5eecc6d6449e4f7cfb1c2708,2022-07-07T00:00:00.000Z,NEFT DR-KKBK0000261-AAYUSHI PAREEK-SANDO Z - MUM-N188222028024874-NET BANKING SI -102961,,,net_banking_transfer,-102961
632ae6cb2e1a0ebb7f46f96a,50200023535069,988556.88,60ec41ba55c00300382672d9,HDFC,Internal Transfers,5eecc6d6449e4f7cfb1c2708,2022-07-07T00:00:00.000Z,IB FUNDS TRANSFER CR-50200035187206 -SL ICK ORGANICS PVT LTD,insurance,insurance,Other,1000000
632ae6cb2e1a0ebb7f46f96c,50200023535069,1021174.71,60ec41ba55c00300382672d9,HDFC,Revenue-PG-non-split,5eecc6d6449e4f7cfb1c2708,2022-07-07T00:00:00.000Z,NEFT CR-PYTM0123456-PAYTM PAYMENTS SERVI CES LIMITED-SLICK ORGANICS PVT LTD-PYTM2 21889777670,insurance,insurance,net_banking_transfer,32617.83
632ae6cb2e1a0ebb7f46f96e,50200023535069,864574.71,60ec41ba55c00300382672d9,HDFC,direct expenses,5eecc6d6449e4f7cfb1c2708,2022-07-07T00:00:00.000Z,"NEFT DR-KKBK0005289-HILL GROOVE CONSULTI NG LLP-NETBANK, MUM-N188222028162978-156 600",,,net_banking_transfer,-156600
632ae6cb2e1a0ebb7f46f970,50200023535069,502410.71,60ec41ba55c00300382672d9,HDFC,direct expenses,5eecc6d6449e4f7cfb1c2708,2022-07-07T00:00:00.000Z,50200063349422-TPT-362164-COHORT E-COMME RCE CONSULTING LLP,,,net_banking_transfer,-362164
632ae6cb2e1a0ebb7f46f972,50200023535069,217290.71,60ec41ba55c00300382672d9,HDFC,direct expenses,5eecc6d6449e4f7cfb1c2708,2022-07-07T00:00:00.000Z,"NEFT DR-DBSS0IN0811-SARANSH KULKARNI-NET BANK, MUM-N188222028163165-285120",,,net_banking_transfer,-285120
632ae6cb2e1a0ebb7f46f975,50200023535069,-13829.29,60ec41ba55c00300382672d9,HDFC,direct expenses,5eecc6d6449e4f7cfb1c2708,2022-07-07T00:00:00.000Z,"NEFT DR-BARB0VJMATU-ARTISTO DESIGNZ-NETB ANK, MUM-N188222028174331-231120",,,net_banking_transfer,-231120
632ae6cb2e1a0ebb7f46f977,50200023535069,886170.71,60ec41ba55c00300382672d9,HDFC,Internal Transfers,5eecc6d6449e4f7cfb1c2708,2022-07-07T00:00:00.000Z,IB FUNDS TRANSFER CR-50200035187206 -SL ICK ORGANICS PVT LTD,insurance,insurance,Other,900000
632ae6cb2e1a0ebb7f46f97a,50200023535069,832170.71,60ec41ba55c00300382672d9,HDFC,direct expenses,5eecc6d6449e4f7cfb1c2708,2022-07-07T00:00:00.000Z,"NEFT DR-KKBK0000654-NIHARIKA MISHRA-NETB ANK, MUM-N188222028175825-54000",,,net_banking_transfer,-54000
632ae6cb2e1a0ebb7f46f97c,50200023535069,734970.71,60ec41ba55c00300382672d9,HDFC,direct expenses,5eecc6d6449e4f7cfb1c2708,2022-07-07T00:00:00.000Z,NEFT DR-CNRB0015170-SNEHAL TAYDE-NETBANK,,,net_banking_transfer,-97200
632ae6cb2e1a0ebb7f46f97f,50200023535069,702570.71,60ec41ba55c00300382672d9,HDFC,direct expenses,5eecc6d6449e4f7cfb1c2708,2022-07-07T00:00:00.000Z,50200039330521-TPT-32400-ELITE PUBLICIST,insurance,insurance,net_banking_transfer,-32400
632ae6cb2e1a0ebb7f46f981,50200023535069,520694.71,60ec41ba55c00300382672d9,HDFC,direct expenses,5eecc6d6449e4f7cfb1c2708,2022-07-07T00:00:00.000Z,50100370748619-TPT-181876-RITIKA SAXENA,,,net_banking_transfer,-181876
632ae6cb2e1a0ebb7f46f983,50200023535069,318725.71,60ec41ba55c00300382672d9,HDFC,direct expenses,5eecc6d6449e4f7cfb1c2708,2022-07-07T00:00:00.000Z,"NEFT DR-ICIC0000024-TAKE MOTO YOHKI INDI A PRIVATE LIMITED-NETBANK, MUM-N18822202 8198670-201969",travel,,net_banking_transfer,-201969
632ae6cb2e1a0ebb7f46f985,50200023535069,218725.71,60ec41ba55c00300382672d9,HDFC,direct expenses,5eecc6d6449e4f7cfb1c2708,2022-07-07T00:00:00.000Z,"NEFT DR-ICIC0006643-KRISHNA PACKAGING CO MPANY-NETBANK, MUM-N188222028200703-1000 00",,,net_banking_transfer,-100000
632ae6cb2e1a0ebb7f46f987,50200023535069,245173.97,60ec41ba55c00300382672d9,HDFC,Revenue-PG-split enabled,5eecc6d6449e4f7cfb1c2708,2022-07-07T00:00:00.000Z,NEFT CR-UTIB0001506-RAZORPAY SOFTWARE PR IVATE LIMITED-SLICK ORGANICS PVT LITD-AX ISCN0153372221,insurance,insurance,net_banking_transfer,26448.26
632ae6cb2e1a0ebb7f46f989,50200023535069,145173.97,60ec41ba55c00300382672d9,HDFC,direct expenses,5eecc6d6449e4f7cfb1c2708,2022-07-07T00:00:00.000Z,50200054531492-TPT-100000-ALETA PEOPLE S ERVICES,,,net_banking_transfer,-100000
632ae6cb2e1a0ebb7f46f98b,50200023535069,1145173.97,60ec41ba55c00300382672d9,HDFC,Internal Transfers,5eecc6d6449e4f7cfb1c2708,2022-07-07T00:00:00.000Z,IB FUNDS TRANSFER CR-50200035187206 -SL ICK ORGANICS PVT LTD,insurance,insurance,Other,1000000
632ae6cb2e1a0ebb7f46f98d,50200023535069,975173.97,60ec41ba55c00300382672d9,HDFC,direct expenses,5eecc6d6449e4f7cfb1c2708,2022-07-07T00:00:00.000Z,50200054531492-TPT-170000-ALETA PEOPLE S ERVICES,,,net_banking_transfer,-170000
632ae6cb2e1a0ebb7f46f990,50200023535069,794058.97,60ec41ba55c00300382672d9,HDFC,direct expenses,5eecc6d6449e4f7cfb1c2708,2022-07-07T00:00:00.000Z,50100179603876-TPT-181115-APURBA NAYAK,,,net_banking_transfer,-181115
632ae6cb2e1a0ebb7f46f992,50200023535069,562938.97,60ec41ba55c00300382672d9,HDFC,direct expenses,5eecc6d6449e4f7cfb1c2708,2022-07-07T00:00:00.000Z,"NEFT DR-BARB0VJMATU-ARTISTO DESIGNZ-NETB ANK, MUM-N188222028365643-231120",,,net_banking_transfer,-231120
632ae6cb2e1a0ebb7f46f994,50200023535069,541878.97,60ec41ba55c00300382672d9,HDFC,direct expenses,5eecc6d6449e4f7cfb1c2708,2022-07-07T00:00:00.000Z,"NEFT DR-HSBC0400004-A LITTLE FLY-NETBANK , MUM-N188222028375463-21060",,,net_banking_transfer,-21060
632ae6cb2e1a0ebb7f46f996,50200023535069,520278.97,60ec41ba55c00300382672d9,HDFC,direct expenses,5eecc6d6449e4f7cfb1c2708,2022-07-07T00:00:00.000Z,"NEFT DR-ICIC0002320-LEAPUS TECHNOLOGIES PVT LTD-NETBANK, MUM-N188222028383276-21 600",,,net_banking_transfer,-21600
632ae6cb2e1a0ebb7f46f998,50200023535069,470278.97,60ec41ba55c00300382672d9,HDFC,direct expenses,5eecc6d6449e4f7cfb1c2708,2022-07-07T00:00:00.000Z,POS 514834XXXXXX9486 FLIPKART,shopping,,debit_card,-50000
632ae6cb2e1a0ebb7f46f99a,50200023535069,254278.97,60ec41ba55c00300382672d9,HDFC,direct expenses,5eecc6d6449e4f7cfb1c2708,2022-07-07T00:00:00.000Z,"NEFT DR-UTIB0000514-NATS ASSOCIATES-NETB ANK, MUM-N188222028464804-216000",,,net_banking_transfer,-216000
632ae6cb2e1a0ebb7f46f99c,50200023535069,218278.97,60ec41ba55c00300382672d9,HDFC,direct expenses,5eecc6d6449e4f7cfb1c2708,2022-07-07T00:00:00.000Z,"NEFT DR-KKBK0000664-SHRADDHA DINESH SHU KLA-NETBANK, MUM-N188222028486955-36000",,,net_banking_transfer,-36000
632ae6cb2e1a0ebb7f46f99e,50200023535069,226864.06,60ec41ba55c00300382672d9,HDFC,Transfer in/Revenue-other,5eecc6d6449e4f7cfb1c2708,2022-07-07T00:00:00.000Z,NEFT CR-UTIB0000114-ONE SIGMA TECHNOLOGI,,,net_banking_transfer,8585.09
632ae6cb2e1a0ebb7f46f9a0,50200023535069,218864.06,60ec41ba55c00300382672d9,HDFC,direct expenses,5eecc6d6449e4f7cfb1c2708,2022-07-07T00:00:00.000Z,"NEFT DR-KKBK0001369-ALISHA LIYAKAT ALI-N ETBANK, MUM-N188222028557719-8000",,,net_banking_transfer,-8000
632ae6cb2e1a0ebb7f46f9a2,50200023535069,214228.06,60ec41ba55c00300382672d9,HDFC,direct expenses,5eecc6d6449e4f7cfb1c2708,2022-07-07T00:00:00.000Z,"NEFT DR-ICIC0000715-GAJENDRA BAHADUR SIN GH-NETBANK, MUM-N188222028670541-4636",,,net_banking_transfer,-4636
632ae6cb2e1a0ebb7f46f9a4,50200023535069,212211.06,60ec41ba55c00300382672d9,HDFC,direct expenses,5eecc6d6449e4f7cfb1c2708,2022-07-07T00:00:00.000Z,50100108772229-TPT-2017-HEMANT GUPTA,,,net_banking_transfer,-2017
632ae6cb2e1a0ebb7f46f9a6,50200023535069,196893.06,60ec41ba55c00300382672d9,HDFC,direct expenses,5eecc6d6449e4f7cfb1c2708,2022-07-07T00:00:00.000Z,"NEFT DR-IPOS0000001-PANKAJ KUMAR-NETBANK , MUM-N188222028664429-15318",,,net_banking_transfer,-15318
632ae6cb2e1a0ebb7f46f9a8,50200023535069,96893.06,60ec41ba55c00300382672d9,HDFC,direct expenses,5eecc6d6449e4f7cfb1c2708,2022-07-07T00:00:00.000Z,"NEFT DR-UBIN0820296-HITESH ARORA-NETBANK , MUM-N188222028676248-100000",,,net_banking_transfer,-100000
632ae6cb2e1a0ebb7f46f9aa,50200023535069,76893.06,60ec41ba55c00300382672d9,HDFC,direct expenses,5eecc6d6449e4f7cfb1c2708,2022-07-07T00:00:00.000Z,"NEFT DR-SCBL0036025-GUNVEET SINGH-NETBAN K, MUM-N188222028694898-20000",,,net_banking_transfer,-20000
632ae6cb2e1a0ebb7f46f9ac,50200023535069,62193.06,60ec41ba55c00300382672d9,HDFC,direct expenses,5eecc6d6449e4f7cfb1c2708,2022-07-07T00:00:00.000Z,50100167600761-TPT-14700-RITU SINGH,,,net_banking_transfer,-14700
632ae6cb2e1a0ebb7f46f9ae,50200023535069,1062193.06,60ec41ba55c00300382672d9,HDFC,Internal Transfers,5eecc6d6449e4f7cfb1c2708,2022-07-07T00:00:00.000Z,IB FUNDS TRANSFER CR-50200035187206 -SL ICK ORGANICS PVT LTD,insurance,insurance,Other,1000000
632ae6cc2e1a0ebb7f46f9b1,50200023535069,807193.06,60ec41ba55c00300382672d9,HDFC,SAAS/tech expense,5eecc6d6449e4f7cfb1c2708,2022-07-07T00:00:00.000Z,POS 514834XXXXXX9486 AMAZON,shopping,,debit_card,-255000
632ae6cc2e1a0ebb7f46f9b3,50200023535069,783440.87,60ec41ba55c00300382672d9,HDFC,direct expenses,5eecc6d6449e4f7cfb1c2708,2022-07-07T00:00:00.000Z,POS 514834XXXXXX9486 GUPSHUP INC,,,debit_card,-23752.19
632ae6cc2e1a0ebb7f46f9b6,50200023535069,844638.09,60ec41ba55c00300382672d9,HDFC,Transfer in/Revenue-other,5eecc6d6449e4f7cfb1c2708,2022-07-07T00:00:00.000Z,"IMPS-218816547633-GOKWIK COMMERCE SOLU-I CIC-XXXXXXXX0630-PAYOUT FOR JULY 5, 2022",,,net_banking_transfer,61197.22
632ae6cc2e1a0ebb7f46f9b8,50200023535069,853493.09,60ec41ba55c00300382672d9,HDFC,Revenue-Mktplace,5eecc6d6449e4f7cfb1c2708,2022-07-07T00:00:00.000Z,NEFT CR-ICIC0000985-DIGITAL AGE RETAIL P VT LTD-SLICK ORGANICS PVT LTD DS-CMS26 89366587,,,net_banking_transfer,8855
632ae6cc2e1a0ebb7f46f9ba,50200023535069,782286.09,60ec41ba55c00300382672d9,HDFC,direct expenses,5eecc6d6449e4f7cfb1c2708,2022-07-07T00:00:00.000Z,"NEFT DR-KKBK0000187-APPLIED LIFE PRIVATE LIMITED-NETBANK, MUM-N188222029464727-7 1207",,,net_banking_transfer,-71207
632ae6cc2e1a0ebb7f46f9bc,50200023535069,780888.09,60ec41ba55c00300382672d9,HDFC,direct expenses,5eecc6d6449e4f7cfb1c2708,2022-07-07T00:00:00.000Z,POS 514834XXXXXX9486 SMARTSHIFT LOGIS,,,debit_card,-1398
632ae6cc2e1a0ebb7f46f9be,50200023535069,755888.09,60ec41ba55c00300382672d9,HDFC,direct expenses,5eecc6d6449e4f7cfb1c2708,2022-07-07T00:00:00.000Z,"NEFT DR-SBIN0001706-ANMOL TREHAN-NETBANK , MUM-N188222029513451-25000",,,net_banking_transfer,-25000
632ae6cc2e1a0ebb7f46f9c0,50200023535069,768544.61,60ec41ba55c00300382672d9,HDFC,Revenue-PG-split enabled,5eecc6d6449e4f7cfb1c2708,2022-07-07T00:00:00.000Z,NEFT CR-UTIB0001506-RAZORPAY SOFTWARE PR,,,net_banking_transfer,12656.52
632ae6cc2e1a0ebb7f46f9c2,50200023535069,772301.45,60ec41ba55c00300382672d9,HDFC,Revenue-UPI,5eecc6d6449e4f7cfb1c2708,2022-07-07T00:00:00.000Z,"UPI-GOKWIK-GOKWIK@YESBANK-YESB0000340-21 8857308300-PAYOUT FOR JULY 5,",,,upi,3756.84
632ae6cc2e1a0ebb7f46f9c5,50200023535069,886455.45,60ec41ba55c00300382672d9,HDFC,Revenue-COD,5eecc6d6449e4f7cfb1c2708,2022-07-07T00:00:00.000Z,NEFT CR-KKBK0000958-PICKRR TECHNOLOGIES PVT LTD-SLICKORGANICSPRIVATELIMITED-CMS1 882219291404,insurance,insurance,net_banking_transfer,114154
632ae6cc2e1a0ebb7f46f9c7,50200023535069,891240.18,60ec41ba55c00300382672d9,HDFC,Revenue-Mktplace,5eecc6d6449e4f7cfb1c2708,2022-07-08T00:00:00.000Z,NEFT CR-DEUT0797BGL-FLIPKART INTERNET PR IVATE LIMITED-SLICK ORGANICS PVT LTD-218 900121GN00254,shopping,,net_banking_transfer,4784.73
632ae6cc2e1a0ebb7f46f9c9,50200023535069,906037.94,60ec41ba55c00300382672d9,HDFC,Revenue-PG-non-split,5eecc6d6449e4f7cfb1c2708,2022-07-08T00:00:00.000Z,IMPS-218905390527-PAYTM PAYMENTS SERVI-P YTM-XXXXXXXXXX0008-ALL202207082168200003 30830668628,ewallet,,net_banking_transfer,14797.76
632ae6cc2e1a0ebb7f46f9cb,50200023535069,5006037.94,60ec41ba55c00300382672d9,HDFC,Internal Transfers,5eecc6d6449e4f7cfb1c2708,2022-07-08T00:00:00.000Z,IB FUNDS TRANSFER CR-50200035187206 -SL ICK ORGANICS PVT LTD,insurance,insurance,Other,4100000
632ae6cc2e1a0ebb7f46f9cd,50200023535069,4506037.94,60ec41ba55c00300382672d9,HDFC,direct expenses,5eecc6d6449e4f7cfb1c2708,2022-07-08T00:00:00.000Z,05892560000649-TPT-500000-DECORPAC INDIA PRIVATE LIMITED,,,net_banking_transfer,-500000
632ae6cc2e1a0ebb7f46f9cf,50200023535069,4006037.94,60ec41ba55c00300382672d9,HDFC,direct expenses,5eecc6d6449e4f7cfb1c2708,2022-07-08T00:00:00.000Z,"NEFT DR-KKBK0000180-VEDIC COSMECEUTICALS PVT LTD-NETBANK, MUM-N189222030317062-5 00000",,,net_banking_transfer,-500000
632ae6cc2e1a0ebb7f46f9d1,50200023535069,3952217.94,60ec41ba55c00300382672d9,HDFC,direct expenses,5eecc6d6449e4f7cfb1c2708,2022-07-08T00:00:00.000Z,09291610057185-TPT-53820-MANISH KUMAR,,,net_banking_transfer,-53820
632ae6cc2e1a0ebb7f46f9d4,50200023535069,3956030.98,60ec41ba55c00300382672d9,HDFC,Revenue-Mktplace,5eecc6d6449e4f7cfb1c2708,2022-07-08T00:00:00.000Z,NEFT CR-DEUT0797BGL-MYNTRA DESIGNS PRIVA TE LIMITED-SLICK ORGANICS PVT. LTD.-2189 00573GN00084,shopping,,net_banking_transfer,3813.04
632ae6cc2e1a0ebb7f46f9d7,50200023535069,3958918.88,60ec41ba55c00300382672d9,HDFC,Revenue-Mktplace,5eecc6d6449e4f7cfb1c2708,2022-07-08T00:00:00.000Z,NEFT CR-DEUT0797BGL-MYNTRA DESIGNS PRIVA TE LIMITED-SLICK ORGANICS PVT. LTD.-2189 00574GN00027,shopping,,net_banking_transfer,2887.9
632ae6cc2e1a0ebb7f46f9d9,50200023535069,3970337.89,60ec41ba55c00300382672d9,HDFC,Revenue-PG-split enabled,5eecc6d6449e4f7cfb1c2708,2022-07-08T00:00:00.000Z,NEFT CR-UTIB0001506-RAZORPAY SOFTWARE PR IVATE LIMITED-SLICK ORGANICS PVT LITD-AX ISCN0153590824,insurance,insurance,net_banking_transfer,11419.01
632ae6cc2e1a0ebb7f46f9db,50200023535069,3950337.89,60ec41ba55c00300382672d9,HDFC,direct expenses,5eecc6d6449e4f7cfb1c2708,2022-07-08T00:00:00.000Z,"NEFT DR-SBIN0016639-AMIT DEY-NETBANK, MU M-N189222030450416-20000",,,net_banking_transfer,-20000
632ae6cc2e1a0ebb7f46f9dd,50200023535069,3750337.89,60ec41ba55c00300382672d9,HDFC,direct expenses,5eecc6d6449e4f7cfb1c2708,2022-07-08T00:00:00.000Z,NEFT DR-YESB0000551-VISTTA COSMETICS-NET,,,net_banking_transfer,-200000
632ae6cc2e1a0ebb7f46f9e0,50200023535069,3691413.89,60ec41ba55c00300382672d9,HDFC,direct expenses,5eecc6d6449e4f7cfb1c2708,2022-07-08T00:00:00.000Z,50200025384647-TPT-58924-AG POLY PACKS P VT LTD,,,net_banking_transfer,-58924
632ae6cc2e1a0ebb7f46f9e2,50200023535069,3679613.89,60ec41ba55c00300382672d9,HDFC,direct expenses,5eecc6d6449e4f7cfb1c2708,2022-07-08T00:00:00.000Z,POS 514834XXXXXX9486 RAZ*PURPLLE,,,debit_card,-11800
632ae6cc2e1a0ebb7f46f9e4,50200023535069,3629613.89,60ec41ba55c00300382672d9,HDFC,direct expenses,5eecc6d6449e4f7cfb1c2708,2022-07-08T00:00:00.000Z,"NEFT DR-ICIC0002451-SOUTH COURT CONDOMIN IUM ASSOCIATION-NETBANK, MUM-N1892220306 45868-50000",,,net_banking_transfer,-50000
632ae6cc2e1a0ebb7f46f9e6,50200023535069,3579613.89,60ec41ba55c00300382672d9,HDFC,direct expenses,5eecc6d6449e4f7cfb1c2708,2022-07-08T00:00:00.000Z,"NEFT DR-KKBK0004583-PICKRR TECHNOLOGIES PVT LTD-NETBANK, MUM-N189222030646883-50 000",,,net_banking_transfer,-50000
632ae6cc2e1a0ebb7f46f9e8,50200023535069,3559613.89,60ec41ba55c00300382672d9,HDFC,direct expenses,5eecc6d6449e4f7cfb1c2708,2022-07-08T00:00:00.000Z,"NEFT DR-ICIC0000314-UPASANA KOCHHAR-NETB ANK, MUM-N189222030726006-20000",,,net_banking_transfer,-20000
632ae6cc2e1a0ebb7f46f9ea,50200023535069,3536083.89,60ec41ba55c00300382672d9,HDFC,direct expenses,5eecc6d6449e4f7cfb1c2708,2022-07-08T00:00:00.000Z,POS 514834XXXXXX9486 PTM*PAYTM,ewallet,,debit_card,-23530
632ae6cc2e1a0ebb7f46f9ec,50200023535069,3521083.89,60ec41ba55c00300382672d9,HDFC,direct expenses,5eecc6d6449e4f7cfb1c2708,2022-07-08T00:00:00.000Z,50100011521772-TPT-15000-KAVYA AJIT,,,net_banking_transfer,-15000
632ae6cc2e1a0ebb7f46f9ee,50200023535069,3321083.89,60ec41ba55c00300382672d9,HDFC,direct expenses,5eecc6d6449e4f7cfb1c2708,2022-07-08T00:00:00.000Z,57500000443889-TPT-200000-WEBKLIPPER TEC HNOLOGIES PRIVATE LIMITED,,,net_banking_transfer,-200000
632ae6cc2e1a0ebb7f46f9f0,50200023535069,3320963.89,60ec41ba55c00300382672d9,HDFC,direct expenses,5eecc6d6449e4f7cfb1c2708,2022-07-08T00:00:00.000Z,POS 514834XXXXXX9486 RAZ*SMARTSHIFT L,,,debit_card,-120
632ae6cc2e1a0ebb7f46f9f2,50200023535069,3321815.62,60ec41ba55c00300382672d9,HDFC,Transfer in/Revenue-other,5eecc6d6449e4f7cfb1c2708,2022-07-08T00:00:00.000Z,NEFT CR-UTIB0000114-ONE SIGMA TECHNOLOGI ES PRIVATE LIM-SLICK ORGANICS PRIVATE LI MITED-AXISP00302463644,insurance,insurance,net_banking_transfer,851.73
632ae6cc2e1a0ebb7f46f9f4,50200023535069,3319780.12,60ec41ba55c00300382672d9,HDFC,direct expenses,5eecc6d6449e4f7cfb1c2708,2022-07-08T00:00:00.000Z,50100296883199-TPT-2035.5-NIDAMANURI CHA NIKYA GUPTA,,,net_banking_transfer,-2035.5
632ae6cc2e1a0ebb7f46f9f6,50200023535069,3219780.12,60ec41ba55c00300382672d9,HDFC,direct expenses,5eecc6d6449e4f7cfb1c2708,2022-07-08T00:00:00.000Z,"NEFT DR-ICIC0006643-KRISHNA PACKAGING CO MPANY-NETBANK, MUM-N189222031059836-1000 00",,,net_banking_transfer,-100000
632ae6cc2e1a0ebb7f46f9f8,50200023535069,3219318.89,60ec41ba55c00300382672d9,HDFC,bank charges,5eecc6d6449e4f7cfb1c2708,2022-07-08T00:00:00.000Z,.DC INTL POS TXN MARKUP+ST 100522 120522 -CDT2218609955197,,,international_transaction_arbitrage,-461.23
632ae6cc2e1a0ebb7f46f9fa,50200023535069,3214318.89,60ec41ba55c00300382672d9,HDFC,Refund,5eecc6d6449e4f7cfb1c2708,2022-07-08T00:00:00.000Z,"NEFT DR-RATN0VAAPIS-RAZORPAY REFUND CRED ITS TOPUP-NETBANK, MUM-N189222031290781- 5000",,,net_banking_transfer,-5000
632ae6cc2e1a0ebb7f46f9fd,50200023535069,3332679,60ec41ba55c00300382672d9,HDFC,Transfer in/Revenue-other,5eecc6d6449e4f7cfb1c2708,2022-07-08T00:00:00.000Z,"IMPS-218916822075-GOKWIK COMMERCE SOLU-I CIC-XXXXXXXX0630-PAYOUT FOR JULY 6, 2022",,,net_banking_transfer,118360.11
632ae6cc2e1a0ebb7f46f9ff,50200023535069,3335413.1,60ec41ba55c00300382672d9,HDFC,Revenue-PG-split enabled,5eecc6d6449e4f7cfb1c2708,2022-07-08T00:00:00.000Z,NEFT CR-UTIB0001506-RAZORPAY SOFTWARE PR,,,net_banking_transfer,2734.1
632ae6cc2e1a0ebb7f46fa01,50200023535069,3338589.1,60ec41ba55c00300382672d9,HDFC,Revenue-Mktplace,5eecc6d6449e4f7cfb1c2708,2022-07-08T00:00:00.000Z,NEFT CR-ICIC0000104-MANASH LIFESTYLE PRI VATE LIMITED-SLICK ORGANICS PRIVATE LIMI TED MP MUM-CMS2693056353,shopping,,net_banking_transfer,3176
632ae6cc2e1a0ebb7f46fa03,50200023535069,3345286.03,60ec41ba55c00300382672d9,HDFC,Revenue-PG-non-split,5eecc6d6449e4f7cfb1c2708,2022-07-09T00:00:00.000Z,NEFT CR-PYTM0123456-PAYTM PAYMENTS SERVI CES LIMITED-SLICK ORGANICS PVT LTD-PYTM2 21902085971,insurance,insurance,net_banking_transfer,6696.93
632ae6cc2e1a0ebb7f46fa05,50200023535069,3324226.03,60ec41ba55c00300382672d9,HDFC,direct expenses,5eecc6d6449e4f7cfb1c2708,2022-07-09T00:00:00.000Z,POS 514834XXXXXX9486 PTM*PAYTM,ewallet,,debit_card,-21060
632ae6cc2e1a0ebb7f46fa07,50200023535069,3379085.02,60ec41ba55c00300382672d9,HDFC,Transfer in/Revenue-other,5eecc6d6449e4f7cfb1c2708,2022-07-09T00:00:00.000Z,"IMPS-219016073572-GOKWIK COMMERCE SOLU-I CIC-XXXXXXXX0630-PAYOUT FOR JULY 7, 2022",,,net_banking_transfer,54858.99
632ae6cc2e1a0ebb7f46fa09,50200023535069,3397231.94,60ec41ba55c00300382672d9,HDFC,Revenue-PG-non-split,5eecc6d6449e4f7cfb1c2708,2022-07-10T00:00:00.000Z,IMPS-219106182521-PAYTM PAYMENTS SERVI-P YTM-XXXXXXXXXX0008-ALL202207102168200003 30830668628,ewallet,,net_banking_transfer,18146.92
632ae6cc2e1a0ebb7f46fa0b,50200023535069,3142231.94,60ec41ba55c00300382672d9,HDFC,SAAS/tech expense,5eecc6d6449e4f7cfb1c2708,2022-07-10T00:00:00.000Z,POS 514834XXXXXX9486 AMAZON,shopping,,debit_card,-255000
632ae6cc2e1a0ebb7f46fa0d,50200023535069,3149080.9,60ec41ba55c00300382672d9,HDFC,Revenue-UPI,5eecc6d6449e4f7cfb1c2708,2022-07-10T00:00:00.000Z,"UPI-GOKWIK-GOKWIK@YESBANK-YESB0000340-21 9164511510-PAYOUT FOR JULY 6,",,,upi,6848.96
632ae6cc2e1a0ebb7f46fa0f,50200023535069,3168477.19,60ec41ba55c00300382672d9,HDFC,Transfer in/Revenue-other,5eecc6d6449e4f7cfb1c2708,2022-07-10T00:00:00.000Z,"IMPS-219116953001-GOKWIK COMMERCE SOLU-I CIC-XXXXXXXX0630-PAYOUT FOR JULY 8, 2022",,,net_banking_transfer,19396.29
632ae6cc2e1a0ebb7f46fa11,50200023535069,3181486.2,60ec41ba55c00300382672d9,HDFC,Revenue-PG-non-split,5eecc6d6449e4f7cfb1c2708,2022-07-11T00:00:00.000Z,IMPS-219204315678-PAYTM PAYMENTS SERVI-P YTM-XXXXXXXXXX0008-ALL202207112168200003 30830668628,ewallet,,net_banking_transfer,13009.01
632ae6cc2e1a0ebb7f46fa13,50200023535069,3084286.2,60ec41ba55c00300382672d9,HDFC,direct expenses,5eecc6d6449e4f7cfb1c2708,2022-07-11T00:00:00.000Z,00321000085687-TPT-97200-SAMEER AHUJA,,,net_banking_transfer,-97200
632ae6cc2e1a0ebb7f46fa15,50200023535069,2976286.2,60ec41ba55c00300382672d9,HDFC,direct expenses,5eecc6d6449e4f7cfb1c2708,2022-07-11T00:00:00.000Z,"NEFT DR-ICIC0001944-TUNRAROUND CORPORATE ADVISORS PVT LTD-NETBANK, MUM-N19222203 3324382-108000",,,net_banking_transfer,-108000
632ae6cc2e1a0ebb7f46fa17,50200023535069,2982708.29,60ec41ba55c00300382672d9,HDFC,Revenue-Mktplace,5eecc6d6449e4f7cfb1c2708,2022-07-11T00:00:00.000Z,NEFT CR-DEUT0797BGL-FLIPKART INTERNET PR IVATE LIMITED-SLICK ORGANICS PVT LTD-219 200193GN00269,shopping,,net_banking_transfer,6422.09
632ae6cc2e1a0ebb7f46fa19,50200023535069,3038774.3,60ec41ba55c00300382672d9,HDFC,Revenue-PG-split enabled,5eecc6d6449e4f7cfb1c2708,2022-07-11T00:00:00.000Z,NEFT CR-UTIB0001506-RAZORPAY SOFTWARE PR,,,net_banking_transfer,56066.01
632ae6cc2e1a0ebb7f46fa1b,50200023535069,3036745.3,60ec41ba55c00300382672d9,HDFC,direct expenses,5eecc6d6449e4f7cfb1c2708,2022-07-11T00:00:00.000Z,POS 514834XXXXXX9486 ADOBE SFTW INR,,,debit_card,-2029
632ae6cc2e1a0ebb7f46fa1f,50200023535069,3039953.87,60ec41ba55c00300382672d9,HDFC,Revenue-Mktplace,5eecc6d6449e4f7cfb1c2708,2022-07-11T00:00:00.000Z,NEFT CR-DEUT0797BGL-MYNTRA DESIGNS PRIVA TE LIMITED-SLICK ORGANICS PVT. LTD.-2192 01191GN00042,shopping,,net_banking_transfer,3208.57
632ae6cc2e1a0ebb7f46fa21,50200023535069,3045231.63,60ec41ba55c00300382672d9,HDFC,Revenue-Mktplace,5eecc6d6449e4f7cfb1c2708,2022-07-11T00:00:00.000Z,NEFT CR-DEUT0797BGL-MYNTRA DESIGNS PRIVA TE LIMITED-SLICK ORGANICS PVT. LTD.-2192 01196GN00106,shopping,,net_banking_transfer,5277.76
632ae6cc2e1a0ebb7f46fa23,50200023535069,3035231.63,60ec41ba55c00300382672d9,HDFC,Refund,5eecc6d6449e4f7cfb1c2708,2022-07-11T00:00:00.000Z,"NEFT DR-RATN0VAAPIS-RAZORPAY REFUND CRED ITS TOPUP-NETBANK, MUM-N192222034135049- 10000",,,net_banking_transfer,-10000
632ae6cc2e1a0ebb7f46fa25,50200023535069,3035133.63,60ec41ba55c00300382672d9,HDFC,direct expenses,5eecc6d6449e4f7cfb1c2708,2022-07-11T00:00:00.000Z,POS 514834XXXXXX9486 SMARTSHIFT LOGIS,,,debit_card,-98
632ae6cc2e1a0ebb7f46fa27,50200023535069,3074981.09,60ec41ba55c00300382672d9,HDFC,Transfer in/Revenue-other,5eecc6d6449e4f7cfb1c2708,2022-07-11T00:00:00.000Z,"IMPS-219216771036-GOKWIK COMMERCE SOLU-I CIC-XXXXXXXX0630-PAYOUT FOR JULY 9, 2022",,,net_banking_transfer,39847.46
632ae6cc2e1a0ebb7f46fa29,50200023535069,3087653.92,60ec41ba55c00300382672d9,HDFC,Transfer in/Revenue-other,5eecc6d6449e4f7cfb1c2708,2022-07-11T00:00:00.000Z,NEFT CR-UTIB0000114-ONE SIGMA TECHNOLOGI ES PRIVATE LIM-SLICK ORGANICS PRIVATE LI MITED-AXISP00302922019,insurance,insurance,net_banking_transfer,12672.83
632ae6cc2e1a0ebb7f46fa2b,50200023535069,3095664.69,60ec41ba55c00300382672d9,HDFC,Transfer in/Revenue-other,5eecc6d6449e4f7cfb1c2708,2022-07-11T00:00:00.000Z,NEFT CR-UTIB0000114-ONE SIGMA TECHNOLOGI ES PRIVATE LIM-SLICK ORGANICS PRIVATE LI MITED-AXISP00302922245,insurance,insurance,net_banking_transfer,8010.77
632ae6cc2e1a0ebb7f46fa2d,50200023535069,3097436.81,60ec41ba55c00300382672d9,HDFC,Transfer in/Revenue-other,5eecc6d6449e4f7cfb1c2708,2022-07-11T00:00:00.000Z,NEFT CR-UTIB0000114-ONE SIGMA TECHNOLOGI ES PRIVATE LIM-SLICK ORGANICS PRIVATE LI MITED-AXISP00302921880,insurance,insurance,net_banking_transfer,1772.12
632ae6cc2e1a0ebb7f46fa2f,50200023535069,3097760.81,60ec41ba55c00300382672d9,HDFC,Transfer in/Revenue-other,5eecc6d6449e4f7cfb1c2708,2022-07-11T00:00:00.000Z,NEFT CR-HSBC0560002-INNOVATIVE RETAIL CO NCEPTS PRIVATE-SLICK ORGANICS PVT LTD-HS BCN22192864325,,,net_banking_transfer,324
632ae6cc2e1a0ebb7f46fa31,50200023535069,3098506.81,60ec41ba55c00300382672d9,HDFC,Transfer in/Revenue-other,5eecc6d6449e4f7cfb1c2708,2022-07-11T00:00:00.000Z,NEFT CR-HSBC0560002-INNOVATIVE RETAIL CO NCEPTS PRIVATE-SLICK ORGANICS PVT LTD-HS BCN22192864560,,,net_banking_transfer,746
632ae6cc2e1a0ebb7f46fa33,50200023535069,3100162.81,60ec41ba55c00300382672d9,HDFC,Transfer in/Revenue-other,5eecc6d6449e4f7cfb1c2708,2022-07-11T00:00:00.000Z,NEFT CR-HSBC0560002-INNOVATIVE RETAIL CO NCEPTS PRIVATE-SLICK ORGANICS PVT LTD-HS BCN22192865786,,,net_banking_transfer,1656
632ae6cc2e1a0ebb7f46fa35,50200023535069,3109811.88,60ec41ba55c00300382672d9,HDFC,Revenue-PG-split enabled,5eecc6d6449e4f7cfb1c2708,2022-07-11T00:00:00.000Z,NEFT CR-UTIB0001506-RAZORPAY SOFTWARE PR,,,net_banking_transfer,9649.07
632ae6cc2e1a0ebb7f46fa37,50200023535069,3173124.88,60ec41ba55c00300382672d9,HDFC,Revenue-COD,5eecc6d6449e4f7cfb1c2708,2022-07-11T00:00:00.000Z,NEFT CR-KKBK0000958-PICKRR TECHNOLOGIES PVT LTD-SLICKORGANICSPRIVATELIMITED-CMS1 922219672543,insurance,insurance,net_banking_transfer,63313
632ae6cc2e1a0ebb7f46fa39,50200023535069,3173126.88,60ec41ba55c00300382672d9,HDFC,Transfer in/Revenue-other,5eecc6d6449e4f7cfb1c2708,2022-07-11T00:00:00.000Z,CRV POS 514834******9486 LINKEDIN,,,refund,2
632ae6cc2e1a0ebb7f46fa3b,50200023535069,3329874.82,60ec41ba55c00300382672d9,HDFC,Revenue-Mktplace,5eecc6d6449e4f7cfb1c2708,2022-07-12T00:00:00.000Z,IMPS-219305084578-AMAZON SELLER SERVIC-H SBC-XXXXXXXX6004-2WCH0MCXWOFY5O3ESLICK O RGANICS PVT LTD,shopping,,net_banking_transfer,156747.94
632ae6cc2e1a0ebb7f46fa3d,50200023535069,3338682.86,60ec41ba55c00300382672d9,HDFC,Revenue-PG-non-split,5eecc6d6449e4f7cfb1c2708,2022-07-12T00:00:00.000Z,NEFT CR-PYTM0123456-PAYTM PAYMENTS SERVI CES LIMITED-SLICK ORGANICS PVT LTD-PYTM2 21935075546,insurance,insurance,net_banking_transfer,8808.04
632ae6cc2e1a0ebb7f46fa3f,50200023535069,3934368.86,60ec41ba55c00300382672d9,HDFC,Revenue-Mktplace,5eecc6d6449e4f7cfb1c2708,2022-07-12T00:00:00.000Z,NEFT CR-DEUT0797BGL-AMAZON PAY (INDIA) P RIVATE LIMITED-SLICK ORGANICS PVT LTD-21 9300132GN00324,shopping,,net_banking_transfer,595686
632ae6cc2e1a0ebb7f46fa41,50200023535069,3684368.86,60ec41ba55c00300382672d9,HDFC,direct expenses,5eecc6d6449e4f7cfb1c2708,2022-07-12T00:00:00.000Z,05892560000649-TPT-250000-DECORPAC INDIA PRIVATE LIMITED,,,net_banking_transfer,-250000
632ae6cc2e1a0ebb7f46fa43,50200023535069,3434368.86,60ec41ba55c00300382672d9,HDFC,direct expenses,5eecc6d6449e4f7cfb1c2708,2022-07-12T00:00:00.000Z,"NEFT DR-KKBK0000180-VEDIC COSMECEUTICALS PVT LTD-NETBANK, MUM-N193222035158159-2 50000",,,net_banking_transfer,-250000
632ae6cc2e1a0ebb7f46fa46,50200023535069,3184368.86,60ec41ba55c00300382672d9,HDFC,direct expenses,5eecc6d6449e4f7cfb1c2708,2022-07-12T00:00:00.000Z,"NEFT DR-ICIC0000024-TAKE MOTO YOHKI INDI A PRIVATE LIMITED-NETBANK, MUM-N19322203 5163440-250000",travel,,net_banking_transfer,-250000
632ae6cc2e1a0ebb7f46fa48,50200023535069,3159368.86,60ec41ba55c00300382672d9,HDFC,direct expenses,5eecc6d6449e4f7cfb1c2708,2022-07-12T00:00:00.000Z,"NEFT DR-ICIC0002451-SOUTH COURT CONDOMIN IUM ASSOCIATION-NETBANK, MUM-N1932220351 53891-25000",,,net_banking_transfer,-25000
632ae6cc2e1a0ebb7f46fa4a,50200023535069,3108068.86,60ec41ba55c00300382672d9,HDFC,direct expenses,5eecc6d6449e4f7cfb1c2708,2022-07-12T00:00:00.000Z,"NEFT DR-FDRL0001100-DURAIRAJBABU-NETBANK , MUM-N193222035193028-51300",,,net_banking_transfer,-51300
632ae6cc2e1a0ebb7f46fa4d,50200023535069,3117810.63,60ec41ba55c00300382672d9,HDFC,Revenue-PG-split enabled,5eecc6d6449e4f7cfb1c2708,2022-07-12T00:00:00.000Z,NEFT CR-UTIB0001506-RAZORPAY SOFTWARE PR,,,net_banking_transfer,9741.77
632ae6cc2e1a0ebb7f46fa4f,50200023535069,2923763.63,60ec41ba55c00300382672d9,HDFC,direct expenses,5eecc6d6449e4f7cfb1c2708,2022-07-12T00:00:00.000Z,"NEFT DR-KKBK0000261-TANVI TANEJA-NETBANK , MUM-N193222035256340-194047",,,net_banking_transfer,-194047
632ae6cd2e1a0ebb7f46fa51,50200023535069,2884951.52,60ec41ba55c00300382672d9,HDFC,N-ACH payments,5eecc6d6449e4f7cfb1c2708,2022-07-12T00:00:00.000Z,ACH D- 531381265-71PR22071206HARU,,unidentified obligation,auto_debit_payment,-38812.11
632ae6cd2e1a0ebb7f46fa53,50200023535069,2834951.52,60ec41ba55c00300382672d9,HDFC,N-ACH payments,5eecc6d6449e4f7cfb1c2708,2022-07-12T00:00:00.000Z,ACH D- 531381265A-71PR22071206HAS5,,unidentified obligation,auto_debit_payment,-50000
632ae6cd2e1a0ebb7f46fa55,50200023535069,2784951.52,60ec41ba55c00300382672d9,HDFC,N-ACH payments,5eecc6d6449e4f7cfb1c2708,2022-07-12T00:00:00.000Z,ACH D- 531381265D-71PR22071206HAST,,unidentified obligation,auto_debit_payment,-50000
632ae6cd2e1a0ebb7f46fa57,50200023535069,2734951.52,60ec41ba55c00300382672d9,HDFC,N-ACH payments,5eecc6d6449e4f7cfb1c2708,2022-07-12T00:00:00.000Z,ACH D- 531381265B-71PR22071206HASE,,unidentified obligation,auto_debit_payment,-50000
632ae6cd2e1a0ebb7f46fa5a,50200023535069,2684951.52,60ec41ba55c00300382672d9,HDFC,N-ACH payments,5eecc6d6449e4f7cfb1c2708,2022-07-12T00:00:00.000Z,ACH D- 531381265C-71PR22071206HASK,,unidentified obligation,auto_debit_payment,-50000
632ae6cd2e1a0ebb7f46fa5c,50200023535069,2584951.52,60ec41ba55c00300382672d9,HDFC,direct expenses,5eecc6d6449e4f7cfb1c2708,2022-07-12T00:00:00.000Z,"NEFT DR-YESB0000162-VINAY REDDY-NETBANK, MUM-N193222035362344-100000",,,net_banking_transfer,-100000
632ae6cd2e1a0ebb7f46fa5e,50200023535069,1634951.52,60ec41ba55c00300382672d9,HDFC,direct expenses,5eecc6d6449e4f7cfb1c2708,2022-07-12T00:00:00.000Z,"NEFT DR-ICIC0000369-BO INTERNATIONAL-NET BANK, MUM-N193222035470389-950000",,,net_banking_transfer,-950000
632ae6cd2e1a0ebb7f46fa60,50200023535069,1630147.52,60ec41ba55c00300382672d9,HDFC,direct expenses,5eecc6d6449e4f7cfb1c2708,2022-07-12T00:00:00.000Z,50100093802387-TPT-4804-ISSHANA MAHAJAN,,,net_banking_transfer,-4804
632ae6cd2e1a0ebb7f46fa62,50200023535069,1634931.47,60ec41ba55c00300382672d9,HDFC,Revenue-PG-non-split,5eecc6d6449e4f7cfb1c2708,2022-07-12T00:00:00.000Z,NEFT CR-SCBL0036001-STRIPE INDIA PRIVATE -SLICK ORGANICS PRIVATE LIMITED-SSG17413 Q0724242,insurance,insurance,net_banking_transfer,4783.95
632ae6cd2e1a0ebb7f46fa64,50200023535069,1556686.47,60ec41ba55c00300382672d9,HDFC,direct expenses,5eecc6d6449e4f7cfb1c2708,2022-07-12T00:00:00.000Z,POS 514834XXXXXX9486 E-COMMERCE RP,,,debit_card,-78245
632ae6cd2e1a0ebb7f46fa66,50200023535069,1478441.47,60ec41ba55c00300382672d9,HDFC,direct expenses,5eecc6d6449e4f7cfb1c2708,2022-07-12T00:00:00.000Z,POS 514834XXXXXX9486 RAZ*RAZORPAY SOF,,,debit_card,-78245
632ae6cd2e1a0ebb7f46fa68,50200023535069,1400196.47,60ec41ba55c00300382672d9,HDFC,direct expenses,5eecc6d6449e4f7cfb1c2708,2022-07-12T00:00:00.000Z,POS 514834XXXXXX9486 RAZ*RAZORPAY SOF,,,debit_card,-78245
632ae6cd2e1a0ebb7f46fa6a,50200023535069,1305634.47,60ec41ba55c00300382672d9,HDFC,direct expenses,5eecc6d6449e4f7cfb1c2708,2022-07-12T00:00:00.000Z,"NEFT DR-SBIN0011783-GALACTIC GRIP-NETBAN K, MUM-N193222035533085-94562",,,net_banking_transfer,-94562
632ae6cd2e1a0ebb7f46fa6c,50200023535069,1306213.17,60ec41ba55c00300382672d9,HDFC,Transfer in/Revenue-other,5eecc6d6449e4f7cfb1c2708,2022-07-12T00:00:00.000Z,NEFT CR-UTIB0000114-ONE SIGMA TECHNOLOGI ES PRIVATE LIM-SLICK ORGANICS PRIVATE LI MITED-AXISP00303183268,insurance,insurance,net_banking_transfer,578.7
632ae6cd2e1a0ebb7f46fa6e,50200023535069,1162703.17,60ec41ba55c00300382672d9,HDFC,direct expenses,5eecc6d6449e4f7cfb1c2708,2022-07-12T00:00:00.000Z,POS 514834XXXXXX9486 RAZ*RAZORPAY SOF,,,debit_card,-143510
632ae6cd2e1a0ebb7f46fa70,50200023535069,1208355.26,60ec41ba55c00300382672d9,HDFC,Transfer in/Revenue-other,5eecc6d6449e4f7cfb1c2708,2022-07-12T00:00:00.000Z,"IMPS-219316999214-GOKWIK COMMERCE SOLU-I CIC-XXXXXXXX0630-PAYOUT FOR JULY 10, 202 2",,,net_banking_transfer,45652.09
632ae6cd2e1a0ebb7f46fa72,50200023535069,1188355.26,60ec41ba55c00300382672d9,HDFC,Refund,5eecc6d6449e4f7cfb1c2708,2022-07-12T00:00:00.000Z,"NEFT DR-RATN0VAAPIS-RAZORPAY REFUND CRED ITS TOPUP-NETBANK, MUM-N193222036032114- 20000",,,net_banking_transfer,-20000
632ae6cd2e1a0ebb7f46fa74,50200023535069,1177025.18,60ec41ba55c00300382672d9,HDFC,bank charges,5eecc6d6449e4f7cfb1c2708,2022-07-12T00:00:00.000Z,.DC INTL POS TXN MARKUP+ST 200522 220522,,,international_transaction_arbitrage,-11330.08
632ae6cd2e1a0ebb7f46fa77,50200023535069,1182059.82,60ec41ba55c00300382672d9,HDFC,Revenue-PG-split enabled,5eecc6d6449e4f7cfb1c2708,2022-07-12T00:00:00.000Z,NEFT CR-UTIB0001506-RAZORPAY SOFTWARE PR IVATE LIMITED-SLICK ORGANICS PVT LITD-AX ISCN0154373245,insurance,insurance,net_banking_transfer,5034.64
632ae6cd2e1a0ebb7f46fa79,50200023535069,1182406.42,60ec41ba55c00300382672d9,HDFC,Revenue-Mktplace,5eecc6d6449e4f7cfb1c2708,2022-07-12T00:00:00.000Z,4060003045-TIMES INTERNET LIMITED NODAL,,,Other,346.6
632ae6cd2e1a0ebb7f46fa7b,50200023535069,1182182.14,60ec41ba55c00300382672d9,HDFC,bank charges,5eecc6d6449e4f7cfb1c2708,2022-07-12T00:00:00.000Z,.DC INTL POS TXN MARKUP+ST 190522 210522 -CDT2218609955197,,,international_transaction_arbitrage,-224.28
632ae6cd2e1a0ebb7f46fa7d,50200023535069,1184803.52,60ec41ba55c00300382672d9,HDFC,Revenue-UPI,5eecc6d6449e4f7cfb1c2708,2022-07-12T00:00:00.000Z,UPI-GOKWIK-GOKWIK@YESBANK-YESB0000340-21 9370323950-PAYOUT FOR JULY 10,,,upi,2621.38
632ae6cd2e1a0ebb7f46fa80,50200023535069,1180902.63,60ec41ba55c00300382672d9,HDFC,direct expenses,5eecc6d6449e4f7cfb1c2708,2022-07-12T00:00:00.000Z,POS 514834XXXXXX9486 WWW.FAQPRIME.COM,,,debit_card,-3900.89
632ae6cd2e1a0ebb7f46fa82,50200023535069,2180902.63,60ec41ba55c00300382672d9,HDFC,Internal Transfers,5eecc6d6449e4f7cfb1c2708,2022-07-12T00:00:00.000Z,IB FUNDS TRANSFER CR-50200035187206 -SL ICK ORGANICS PVT LTD,insurance,insurance,Other,1000000
632ae6cd2e1a0ebb7f46fa84,50200023535069,180902.63,60ec41ba55c00300382672d9,HDFC,Marketing Expense,5eecc6d6449e4f7cfb1c2708,2022-07-12T00:00:00.000Z,"NEFT DR-CITI0000006-FACEBOOK INDIA ONLIN E SERVICES PVT LTD-NETBANK, MUM-N1932220 36375760-2000000",,,net_banking_transfer,-2000000
632ae6cd2e1a0ebb7f46fa87,50200023535069,187176.78,60ec41ba55c00300382672d9,HDFC,Revenue-PG-non-split,5eecc6d6449e4f7cfb1c2708,2022-07-13T00:00:00.000Z,NEFT CR-PYTM0123456-PAYTM PAYMENTS SERVI CES LIMITED-SLICK ORGANICS PVT LTD-PYTM2 21946420972,insurance,insurance,net_banking_transfer,6274.15
632ae6cd2e1a0ebb7f46fa89,50200023535069,188662.28,60ec41ba55c00300382672d9,HDFC,Revenue-Mktplace,5eecc6d6449e4f7cfb1c2708,2022-07-13T00:00:00.000Z,NEFT CR-DEUT0797BGL-MYNTRA DESIGNS PRIVA TE LIMITED-SLICK ORGANICS PVT. LTD.-2194 00378GN00026,shopping,,net_banking_transfer,1485.5
632ae6cd2e1a0ebb7f46fa8b,50200023535069,194588.75,60ec41ba55c00300382672d9,HDFC,Revenue-Mktplace,5eecc6d6449e4f7cfb1c2708,2022-07-13T00:00:00.000Z,NEFT CR-DEUT0797BGL-MYNTRA DESIGNS PRIVA TE LIMITED-SLICK ORGANICS PVT. LTD.-2194 00377GN00076,shopping,,net_banking_transfer,5926.47
632ae6cd2e1a0ebb7f46fa8d,50200023535069,220452.92,60ec41ba55c00300382672d9,HDFC,Revenue-PG-split enabled,5eecc6d6449e4f7cfb1c2708,2022-07-13T00:00:00.000Z,NEFT CR-UTIB0001506-RAZORPAY SOFTWARE PR IVATE LIMITED-SLICK ORGANICS PVT LITD-AX ISCN0154446452,insurance,insurance,net_banking_transfer,25864.17
632ae6cd2e1a0ebb7f46fa8f,50200023535069,237400.14,60ec41ba55c00300382672d9,HDFC,Revenue-Mktplace,5eecc6d6449e4f7cfb1c2708,2022-07-13T00:00:00.000Z,NEFT CR-DEUT0797BGL-FLIPKART INTERNET PR IVATE LIMITED-SLICK ORGANICS PVT LTD-219 400795GN00144,shopping,,net_banking_transfer,16947.22
632ae6cd2e1a0ebb7f46fa91,50200023535069,240885.99,60ec41ba55c00300382672d9,HDFC,Transfer in/Revenue-other,5eecc6d6449e4f7cfb1c2708,2022-07-13T00:00:00.000Z,NEFT CR-UTIB0000114-ONE SIGMA TECHNOLOGI,,,net_banking_transfer,3485.85
632ae6cd2e1a0ebb7f46fa93,50200023535069,241796.99,60ec41ba55c00300382672d9,HDFC,Transfer in/Revenue-other,5eecc6d6449e4f7cfb1c2708,2022-07-13T00:00:00.000Z,FT - CR - 50200038726231 - HOUSE OF BEAU TY PRIVATE LIMITED,,,Other,911
632ae6cd2e1a0ebb7f46fa95,50200023535069,1241796.99,60ec41ba55c00300382672d9,HDFC,Internal Transfers,5eecc6d6449e4f7cfb1c2708,2022-07-13T00:00:00.000Z,IB FUNDS TRANSFER CR-50200035187206 -SL ICK ORGANICS PVT LTD,insurance,insurance,Other,1000000
632ae6cd2e1a0ebb7f46fa97,50200023535069,1109240.99,60ec41ba55c00300382672d9,HDFC,direct expenses,5eecc6d6449e4f7cfb1c2708,2022-07-13T00:00:00.000Z,"NEFT DR-ICIC0000024-TAKE MOTO YOHKI INDI A PRIVATE LIMITED-NETBANK, MUM-N19422203 7372415-132556",travel,,net_banking_transfer,-132556
632ae6cd2e1a0ebb7f46fa99,50200023535069,1059240.99,60ec41ba55c00300382672d9,HDFC,direct expenses,5eecc6d6449e4f7cfb1c2708,2022-07-13T00:00:00.000Z,"NEFT DR-KKBK0000173-MATRIX PRINTING SOLU TIONS PRIVATE LIMITE-NETBANK, MUM-N19422 2037373631-50000",,,net_banking_transfer,-50000
632ae6cd2e1a0ebb7f46fa9b,50200023535069,1559240.99,60ec41ba55c00300382672d9,HDFC,Internal Transfers,5eecc6d6449e4f7cfb1c2708,2022-07-13T00:00:00.000Z,IB FUNDS TRANSFER CR-50200035187206 -SL ICK ORGANICS PVT LTD,insurance,insurance,Other,500000
632ae6cd2e1a0ebb7f46fa9d,50200023535069,1059240.99,60ec41ba55c00300382672d9,HDFC,direct expenses,5eecc6d6449e4f7cfb1c2708,2022-07-13T00:00:00.000Z,POS 514834XXXXXX9486 RAZ*RAZORPAY SOF,,,debit_card,-500000
632ae6cd2e1a0ebb7f46fa9f,50200023535069,1090630.28,60ec41ba55c00300382672d9,HDFC,Transfer in/Revenue-other,5eecc6d6449e4f7cfb1c2708,2022-07-13T00:00:00.000Z,"IMPS-219416517627-GOKWIK COMMERCE SOLU-I CIC-XXXXXXXX0630-PAYOUT FOR JULY 11, 202 2",,,net_banking_transfer,31389.29
632ae6cd2e1a0ebb7f46faa1,50200023535069,972002.28,60ec41ba55c00300382672d9,HDFC,Salary/Emp/consultant Expense,5eecc6d6449e4f7cfb1c2708,2022-07-13T00:00:00.000Z,1844781204/EPFO,,,Other,-118628
632ae6cd2e1a0ebb7f46faa3,50200023535069,962833.28,60ec41ba55c00300382672d9,HDFC,direct expenses,5eecc6d6449e4f7cfb1c2708,2022-07-13T00:00:00.000Z,02022123088260/ESIC,,,Other,-9169
632ae6cd2e1a0ebb7f46faa5,50200023535069,918288.28,60ec41ba55c00300382672d9,HDFC,direct expenses,5eecc6d6449e4f7cfb1c2708,2022-07-13T00:00:00.000Z,"NEFT DR-ICIC0006643-KRISHNA PACKAGING CO MPANY-NETBANK, MUM-N194222037684604-4454 5",,,net_banking_transfer,-44545
632ae6cd2e1a0ebb7f46faa7,50200023535069,932400.5,60ec41ba55c00300382672d9,HDFC,Revenue-PG-split enabled,5eecc6d6449e4f7cfb1c2708,2022-07-13T00:00:00.000Z,NEFT CR-UTIB0001506-RAZORPAY SOFTWARE PR IVATE LIMITED-SLICK ORGANICS PVT LITD-AX ISCN0154573597,insurance,insurance,net_banking_transfer,14112.22
632ae6cd2e1a0ebb7f46faa9,50200023535069,917300.5,60ec41ba55c00300382672d9,HDFC,direct expenses,5eecc6d6449e4f7cfb1c2708,2022-07-13T00:00:00.000Z,"NEFT DR-ICIC0006956-LAKSHAY CARRYING COR PORATION-NETBANK, MUM-N194222037711899-1 5100",,,net_banking_transfer,-15100
632ae6cd2e1a0ebb7f46faab,50200023535069,912300.5,60ec41ba55c00300382672d9,HDFC,direct expenses,5eecc6d6449e4f7cfb1c2708,2022-07-13T00:00:00.000Z,"NEFT DR-ICIC0000021-AKHILESH DIXIT-NETBA NK, MUM-N194222037721177-5000",,,net_banking_transfer,-5000
632ae6cd2e1a0ebb7f46faad,50200023535069,919892.23,60ec41ba55c00300382672d9,HDFC,Revenue-PG-non-split,5eecc6d6449e4f7cfb1c2708,2022-07-14T00:00:00.000Z,NEFT CR-PYTM0123456-PAYTM PAYMENTS SERVI,ewallet,,net_banking_transfer,7591.73
632ae6cd2e1a0ebb7f46faaf,50200023535069,928207.79,60ec41ba55c00300382672d9,HDFC,Revenue-PG-split enabled,5eecc6d6449e4f7cfb1c2708,2022-07-14T00:00:00.000Z,NEFT CR-UTIB0001506-RAZORPAY SOFTWARE PR IVATE LIMITED-SLICK ORGANICS PVT LITD-AX ISCN0154644223,insurance,insurance,net_banking_transfer,8315.56
632ae6cd2e1a0ebb7f46fab1,50200023535069,728207.79,60ec41ba55c00300382672d9,HDFC,direct expenses,5eecc6d6449e4f7cfb1c2708,2022-07-14T00:00:00.000Z,POS 514834XXXXXX9486 RAZ*RAZORPAY SOF,,,debit_card,-200000
632ae6cd2e1a0ebb7f46fab3,50200023535069,528207.79,60ec41ba55c00300382672d9,HDFC,direct expenses,5eecc6d6449e4f7cfb1c2708,2022-07-14T00:00:00.000Z,POS 514834XXXXXX9486 RAZ*RAZORPAY SOF,,,debit_card,-200000
632ae6cd2e1a0ebb7f46fab5,50200023535069,508207.79,60ec41ba55c00300382672d9,HDFC,direct expenses,5eecc6d6449e4f7cfb1c2708,2022-07-14T00:00:00.000Z,POS 514834XXXXXX9486 RAZ*RAZORPAY SOF,,,debit_card,-20000
632ae6cd2e1a0ebb7f46fab7,50200023535069,499640.79,60ec41ba55c00300382672d9,HDFC,direct expenses,5eecc6d6449e4f7cfb1c2708,2022-07-14T00:00:00.000Z,"NEFT DR-PUNB0225800-PRAMOD KUMAR-NETBANK , MUM-N195222038441643-8567",,,net_banking_transfer,-8567
632ae6cd2e1a0ebb7f46faba,50200023535069,489180.79,60ec41ba55c00300382672d9,HDFC,direct expenses,5eecc6d6449e4f7cfb1c2708,2022-07-14T00:00:00.000Z,"NEFT DR-ICIC0002305-VIRAL MINT-NETBANK, MUM-N195222038448084-10460",,,net_banking_transfer,-10460
632ae6cd2e1a0ebb7f46fabc,50200023535069,491311.43,60ec41ba55c00300382672d9,HDFC,Transfer in/Revenue-other,5eecc6d6449e4f7cfb1c2708,2022-07-14T00:00:00.000Z,NEFT CR-UTIB0000114-ONE SIGMA TECHNOLOGI ES PRIVATE LIM-SLICK ORGANICS PRIVATE LI MITED-AXISP00303857229,insurance,insurance,net_banking_transfer,2130.64
632ae6cd2e1a0ebb7f46fabe,50200023535069,525603.64,60ec41ba55c00300382672d9,HDFC,Transfer in/Revenue-other,5eecc6d6449e4f7cfb1c2708,2022-07-14T00:00:00.000Z,"IMPS-219516602308-GOKWIK COMMERCE SOLU-I CIC-XXXXXXXX0630-PAYOUT FOR JULY 12, 202 2",,,net_banking_transfer,34292.21
632ae6cd2e1a0ebb7f46fac0,50200023535069,535902.34,60ec41ba55c00300382672d9,HDFC,Revenue-PG-split enabled,5eecc6d6449e4f7cfb1c2708,2022-07-14T00:00:00.000Z,NEFT CR-UTIB0001506-RAZORPAY SOFTWARE PR IVATE LIMITED-SLICK ORGANICS PVT LITD-AX ISCN0154778696,insurance,insurance,net_banking_transfer,10298.7
632ae6cd2e1a0ebb7f46fac2,50200023535069,570732.65,60ec41ba55c00300382672d9,HDFC,Transfer in/Revenue-other,5eecc6d6449e4f7cfb1c2708,2022-07-14T00:00:00.000Z,FT- REMITTANCE OG MAY22-50200050675669 - HOUZ OF NATURE PVT LTD -,,,Other,34830.31
632ae6cd2e1a0ebb7f46fac4,50200023535069,580467.65,60ec41ba55c00300382672d9,HDFC,Transfer in/Revenue-other,5eecc6d6449e4f7cfb1c2708,2022-07-14T00:00:00.000Z,50200050241205-TPT-ARATA-NAPSA PRIVATE L IMITED,,,net_banking_transfer,9735
632ae6cd2e1a0ebb7f46fac6,50200023535069,593703.95,60ec41ba55c00300382672d9,HDFC,Revenue-Mktplace,5eecc6d6449e4f7cfb1c2708,2022-07-15T00:00:00.000Z,NEFT CR-DEUT0797BGL-FLIPKART INTERNET PR IVATE LIMITED-SLICK ORGANICS PVT LTD-219 600124GN00026,shopping,,net_banking_transfer,13236.3
632ae6cd2e1a0ebb7f46fac8,50200023535069,600095.9,60ec41ba55c00300382672d9,HDFC,Revenue-PG-non-split,5eecc6d6449e4f7cfb1c2708,2022-07-15T00:00:00.000Z,NEFT CR-PYTM0123456-PAYTM PAYMENTS SERVI CES LIMITED-SLICK ORGANICS PVT LTD-PYTM2 21969094027,insurance,insurance,net_banking_transfer,6391.95
632ae6cd2e1a0ebb7f46faca,50200023535069,602552.72,60ec41ba55c00300382672d9,HDFC,Revenue-Mktplace,5eecc6d6449e4f7cfb1c2708,2022-07-15T00:00:00.000Z,NEFT CR-DEUT0797BGL-MYNTRA DESIGNS PRIVA,shopping,,net_banking_transfer,2456.82
632ae6cd2e1a0ebb7f46facc,50200023535069,619542.72,60ec41ba55c00300382672d9,HDFC,Revenue-Mktplace,5eecc6d6449e4f7cfb1c2708,2022-07-15T00:00:00.000Z,NEFT CR-DEUT0797BGL-MYNTRA DESIGNS PRIVA TE LIMITED-SLICK ORGANICS PVT. LTD.-2196 00549GN00075,shopping,,net_banking_transfer,16990
632ae6cd2e1a0ebb7f46facf,50200023535069,339542.72,60ec41ba55c00300382672d9,HDFC,direct expenses,5eecc6d6449e4f7cfb1c2708,2022-07-15T00:00:00.000Z,POS 514834XXXXXX9486 RAZ*RAZORPAY SOF,,,debit_card,-280000
632ae6cd2e1a0ebb7f46fad1,50200023535069,288512.72,60ec41ba55c00300382672d9,HDFC,direct expenses,5eecc6d6449e4f7cfb1c2708,2022-07-15T00:00:00.000Z,"NEFT DR-ICIC0000874-TRELION BUSINESS SOL UTIONS PVT LTD-NETBANK, MUM-N19622203945 5721-51030",,,net_banking_transfer,-51030
632ae6cd2e1a0ebb7f46fad3,50200023535069,303404.6,60ec41ba55c00300382672d9,HDFC,Revenue-PG-split enabled,5eecc6d6449e4f7cfb1c2708,2022-07-15T00:00:00.000Z,NEFT CR-UTIB0001506-RAZORPAY SOFTWARE PR IVATE LIMITED-SLICK ORGANICS PVT LITD-AX ISCN0154875377,insurance,insurance,net_banking_transfer,14891.88
632ae6cd2e1a0ebb7f46fad6,50200023535069,228404.6,60ec41ba55c00300382672d9,HDFC,direct expenses,5eecc6d6449e4f7cfb1c2708,2022-07-15T00:00:00.000Z,"NEFT DR-SCBL0036046-INDOLEADS TECHNOLOGI ES P LTD-NETBANK, MUM-N196222039455095-7 5000",,,net_banking_transfer,-75000
632ae6cd2e1a0ebb7f46fad8,50200023535069,213404.6,60ec41ba55c00300382672d9,HDFC,direct expenses,5eecc6d6449e4f7cfb1c2708,2022-07-15T00:00:00.000Z,"NEFT DR-KKBK0001393-MASCOT SPINCONTROL I NDIA PVT LTD-NETBANK, MUM-N1962220394629 39-15000",,,net_banking_transfer,-15000
632ae6cd2e1a0ebb7f46fadb,50200023535069,208404.6,60ec41ba55c00300382672d9,HDFC,direct expenses,5eecc6d6449e4f7cfb1c2708,2022-07-15T00:00:00.000Z,"NEFT DR-ICIC0000021-AKHILESH DIXIT-NETBA NK, MUM-N196222039463192-5000",,,net_banking_transfer,-5000
632ae6cd2e1a0ebb7f46fadd,50200023535069,239161.69,60ec41ba55c00300382672d9,HDFC,Transfer in/Revenue-other,5eecc6d6449e4f7cfb1c2708,2022-07-15T00:00:00.000Z,"IMPS-219616613569-GOKWIK COMMERCE SOLU-I CIC-XXXXXXXX0630-PAYOUT FOR JULY 13, 202 2",,,net_banking_transfer,30757.09
632ae6cd2e1a0ebb7f46fadf,50200023535069,239911.69,60ec41ba55c00300382672d9,HDFC,Revenue-Mktplace,5eecc6d6449e4f7cfb1c2708,2022-07-15T00:00:00.000Z,NEFT CR-SCBL0036001-M/S DREAMPLUG TECHNO -SLICK ORGANICS PRIVATE LIMITEDSLICK-SIN 31436Q0044782,insurance,insurance,net_banking_transfer,750
632ae6cd2e1a0ebb7f46fae1,50200023535069,255689.69,60ec41ba55c00300382672d9,HDFC,Transfer in/Revenue-other,5eecc6d6449e4f7cfb1c2708,2022-07-15T00:00:00.000Z,FT- ARATA-50200053251420 - OCTAVOS ENTER PRISE SOLUTIONS PVT LTD -,,,Other,15778
632ae6cd2e1a0ebb7f46fae3,50200023535069,275004.89,60ec41ba55c00300382672d9,HDFC,Revenue-PG-split enabled,5eecc6d6449e4f7cfb1c2708,2022-07-15T00:00:00.000Z,NEFT CR-UTIB0001506-RAZORPAY SOFTWARE PR IVATE LIMITED-SLICK ORGANICS PVT LITD-AX ISCN0155014875,insurance,insurance,net_banking_transfer,19315.2
632ae6cd2e1a0ebb7f46fae5,50200023535069,75004.89,60ec41ba55c00300382672d9,HDFC,direct expenses,5eecc6d6449e4f7cfb1c2708,2022-07-15T00:00:00.000Z,"NEFT DR-YESB0000162-VINAY REDDY-NETBANK, MUM-N196222040597330-200000",,,net_banking_transfer,-200000
632ae6cd2e1a0ebb7f46fae7,50200023535069,-4995.11,60ec41ba55c00300382672d9,HDFC,direct expenses,5eecc6d6449e4f7cfb1c2708,2022-07-15T00:00:00.000Z,NEFT DR-KKBK0005289-HILL GROOVE CONSULTI,,,net_banking_transfer,-80000
632ae6cd2e1a0ebb7f46fae9,50200023535069,-4728.65,60ec41ba55c00300382672d9,HDFC,Transfer in/Revenue-other,5eecc6d6449e4f7cfb1c2708,2022-07-16T00:00:00.000Z,INT. ON SWCR ON-50300498262188,,,Other,266.46
632ae6cd2e1a0ebb7f46faeb,50200023535069,267.35,60ec41ba55c00300382672d9,HDFC,Loan-in,5eecc6d6449e4f7cfb1c2708,2022-07-16T00:00:00.000Z,SWEEP-IN CREDIT - 50300498262188,,,self_transfer,4996
632ae6ce2e1a0ebb7f46faed,50200023535069,19147.02,60ec41ba55c00300382672d9,HDFC,Revenue-PG-non-split,5eecc6d6449e4f7cfb1c2708,2022-07-16T00:00:00.000Z,IMPS-219706489428-PAYTM PAYMENTS SERVI-P YTM-XXXXXXXXXX0008-ALL202207162168200003 30830668628,ewallet,,net_banking_transfer,18879.67
632ae6ce2e1a0ebb7f46faef,50200023535069,36317.99,60ec41ba55c00300382672d9,HDFC,Revenue-PG-split enabled,5eecc6d6449e4f7cfb1c2708,2022-07-16T00:00:00.000Z,NEFT CR-UTIB0001506-RAZORPAY SOFTWARE PR IVATE LIMITED-SLICK ORGANICS PVT LITD-AX ISCN0155076817,insurance,insurance,net_banking_transfer,17170.97
632ae6ce2e1a0ebb7f46faf2,50200023535069,75104.98,60ec41ba55c00300382672d9,HDFC,Transfer in/Revenue-other,5eecc6d6449e4f7cfb1c2708,2022-07-16T00:00:00.000Z,"IMPS-219716480974-GOKWIK COMMERCE SOLU-I CIC-XXXXXXXX0630-PAYOUT FOR JULY 14, 202 2",,,net_banking_transfer,38786.99
632ae6ce2e1a0ebb7f46faf4,50200023535069,79453.35,60ec41ba55c00300382672d9,HDFC,Revenue-PG-split enabled,5eecc6d6449e4f7cfb1c2708,2022-07-16T00:00:00.000Z,NEFT CR-UTIB0001506-RAZORPAY SOFTWARE PR IVATE LIMITED-SLICK ORGANICS PVT LITD-AX ISCN0155169054,insurance,insurance,net_banking_transfer,4348.37
632ae6ce2e1a0ebb7f46faf6,50200023535069,107228.35,60ec41ba55c00300382672d9,HDFC,Revenue-COD,5eecc6d6449e4f7cfb1c2708,2022-07-16T00:00:00.000Z,PICKRR TECHNOL-AKHILESHDIXIT85GMAIL,,,Other,27775
632ae6ce2e1a0ebb7f46faf8,50200023535069,113000.22,60ec41ba55c00300382672d9,HDFC,Revenue-PG-non-split,5eecc6d6449e4f7cfb1c2708,2022-07-17T00:00:00.000Z,NEFT CR-PYTM0123456-PAYTM PAYMENTS SERVI CES LIMITED-SLICK ORGANICS PVT LTD-PYTM2 21981800174,insurance,insurance,net_banking_transfer,5771.87
632ae6ce2e1a0ebb7f46fafa,50200023535069,154494.21,60ec41ba55c00300382672d9,HDFC,Transfer in/Revenue-other,5eecc6d6449e4f7cfb1c2708,2022-07-17T00:00:00.000Z,"IMPS-219816965889-GOKWIK COMMERCE SOLU-I CIC-XXXXXXXX0630-PAYOUT FOR JULY 15, 202 2",,,net_banking_transfer,41493.99
632ae6ce2e1a0ebb7f46fafc,50200023535069,164556.29,60ec41ba55c00300382672d9,HDFC,Revenue-Mktplace,5eecc6d6449e4f7cfb1c2708,2022-07-18T00:00:00.000Z,NEFT CR-DEUT0797BGL-FLIPKART INTERNET PR IVATE LIMITED-SLICK ORGANICS PVT LTD-219 900131GN00076,shopping,,net_banking_transfer,10062.08
632ae6ce2e1a0ebb7f46fafe,50200023535069,172501.49,60ec41ba55c00300382672d9,HDFC,Revenue-PG-non-split,5eecc6d6449e4f7cfb1c2708,2022-07-18T00:00:00.000Z,NEFT CR-PYTM0123456-PAYTM PAYMENTS SERVI CES LIMITED-SLICK ORGANICS PVT LTD-PYTM2 21993174151,insurance,insurance,net_banking_transfer,7945.2
632ae6ce2e1a0ebb7f46fb00,50200023535069,180017.99,60ec41ba55c00300382672d9,HDFC,Revenue-Mktplace,5eecc6d6449e4f7cfb1c2708,2022-07-18T00:00:00.000Z,NEFT CR-DEUT0797BGL-MYNTRA DESIGNS PRIVA,shopping,,net_banking_transfer,7516.5
632ae6ce2e1a0ebb7f46fb02,50200023535069,192734.47,60ec41ba55c00300382672d9,HDFC,Revenue-Mktplace,5eecc6d6449e4f7cfb1c2708,2022-07-18T00:00:00.000Z,NEFT CR-DEUT0797BGL-MYNTRA DESIGNS PRIVA TE LIMITED-SLICK ORGANICS PVT. LTD.-2199 00731GN00092,shopping,,net_banking_transfer,12716.48
632ae6ce2e1a0ebb7f46fb04,50200023535069,238788.57,60ec41ba55c00300382672d9,HDFC,Revenue-PG-split enabled,5eecc6d6449e4f7cfb1c2708,2022-07-18T00:00:00.000Z,NEFT CR-UTIB0001506-RAZORPAY SOFTWARE PR IVATE LIMITED-SLICK ORGANICS PVT LITD-AX ISCN0155274694,insurance,insurance,net_banking_transfer,46054.1
632ae6ce2e1a0ebb7f46fb07,50200023535069,38788.57,60ec41ba55c00300382672d9,HDFC,direct expenses,5eecc6d6449e4f7cfb1c2708,2022-07-18T00:00:00.000Z,"NEFT DR-YESB0000551-VISTTA COSMETICS-NET BANK, MUM-N199222042098820-200000",,,net_banking_transfer,-200000
632ae6ce2e1a0ebb7f46fb0a,50200023535069,38672.57,60ec41ba55c00300382672d9,HDFC,direct expenses,5eecc6d6449e4f7cfb1c2708,2022-07-18T00:00:00.000Z,POS 514834XXXXXX9486 SMARTSHIFT LOGIS,,,debit_card,-116
632ae6ce2e1a0ebb7f46fb0c,50200023535069,44022.9,60ec41ba55c00300382672d9,HDFC,Transfer in/Revenue-other,5eecc6d6449e4f7cfb1c2708,2022-07-18T00:00:00.000Z,NEFT CR-UTIB0000114-ONE SIGMA TECHNOLOGI ES PRIVATE LIM-SLICK ORGANICS PRIVATE LI MITED-AXISP00304506983,insurance,insurance,net_banking_transfer,5350.33
632ae6ce2e1a0ebb7f46fb0e,50200023535069,45398.23,60ec41ba55c00300382672d9,HDFC,Transfer in/Revenue-other,5eecc6d6449e4f7cfb1c2708,2022-07-18T00:00:00.000Z,NEFT CR-UTIB0000114-ONE SIGMA TECHNOLOGI ES PRIVATE LIM-SLICK ORGANICS PRIVATE LI MITED-AXISP00304506761,insurance,insurance,net_banking_transfer,1375.33
632ae6ce2e1a0ebb7f46fb10,50200023535069,42670.19,60ec41ba55c00300382672d9,HDFC,SAAS/tech expense,5eecc6d6449e4f7cfb1c2708,2022-07-18T00:00:00.000Z,POS 514834XXXXXX9486 AMZ*AMAZON PAYME,shopping,,debit_card,-2728.04
632ae6ce2e1a0ebb7f46fb12,50200023535069,49670.19,60ec41ba55c00300382672d9,HDFC,Internal Transfers,5eecc6d6449e4f7cfb1c2708,2022-07-18T00:00:00.000Z,IB FUNDS TRANSFER CR-50200050976833 -SL ICK ORGANICS PVT LTD,insurance,insurance,Other,7000
632ae6ce2e1a0ebb7f46fb14,50200023535069,-3760.81,60ec41ba55c00300382672d9,HDFC,direct expenses,5eecc6d6449e4f7cfb1c2708,2022-07-18T00:00:00.000Z,"NEFT DR-UTIB0CCH274-GO DIGIT GENERAL INS URANCE LIMITED-NETBANK, MUM-N19922204248 6526-53431",insurance,insurance,net_banking_transfer,-53431
632ae6ce2e1a0ebb7f46fb16,50200023535069,-3842.81,60ec41ba55c00300382672d9,HDFC,direct expenses,5eecc6d6449e4f7cfb1c2708,2022-07-18T00:00:00.000Z,POS 514834XXXXXX9486 SMARTSHIFT LOGIS,,,debit_card,-82
632ae6ce2e1a0ebb7f46fb18,50200023535069,3496157.19,60ec41ba55c00300382672d9,HDFC,Internal Transfers,5eecc6d6449e4f7cfb1c2708,2022-07-18T00:00:00.000Z,IB FUNDS TRANSFER CR-50200035187206 -SL ICK ORGANICS PVT LTD,insurance,insurance,Other,3500000
632ae6ce2e1a0ebb7f46fb1a,50200023535069,3419557.19,60ec41ba55c00300382672d9,HDFC,direct expenses,5eecc6d6449e4f7cfb1c2708,2022-07-18T00:00:00.000Z,"NEFT DR-KKBK0005289-HILL GROOVE CONSULTI NG LLP-NETBANK, MUM-N199222042616890-766 00",,,net_banking_transfer,-76600
632ae6ce2e1a0ebb7f46fb1c,50200023535069,419557.19,60ec41ba55c00300382672d9,HDFC,Marketing Expense,5eecc6d6449e4f7cfb1c2708,2022-07-18T00:00:00.000Z,"NEFT DR-CITI0000006-FACEBOOK INDIA ONLIN E SERVICES PVT LTD-NETBANK, MUM-N1992220 42617783-3000000",,,net_banking_transfer,-3000000
632ae6ce2e1a0ebb7f46fb1e,50200023535069,369557.19,60ec41ba55c00300382672d9,HDFC,direct expenses,5eecc6d6449e4f7cfb1c2708,2022-07-18T00:00:00.000Z,00918630000430-TPT-50000-UNICOMMERCE ESO,,,net_banking_transfer,-50000
632ae6ce2e1a0ebb7f46fb20,50200023535069,5369557.19,60ec41ba55c00300382672d9,HDFC,Internal Transfers,5eecc6d6449e4f7cfb1c2708,2022-07-18T00:00:00.000Z,IB FUNDS TRANSFER CR-50200035187206 -SL ICK ORGANICS PVT LTD,insurance,insurance,Other,5000000
632ae6ce2e1a0ebb7f46fb22,50200023535069,10369557.19,60ec41ba55c00300382672d9,HDFC,Internal Transfers,5eecc6d6449e4f7cfb1c2708,2022-07-18T00:00:00.000Z,IB FUNDS TRANSFER CR-50200035187206 -SL ICK ORGANICS PVT LTD,insurance,insurance,Other,5000000
632ae6ce2e1a0ebb7f46fb24,50200023535069,12869557.19,60ec41ba55c00300382672d9,HDFC,Internal Transfers,5eecc6d6449e4f7cfb1c2708,2022-07-18T00:00:00.000Z,IB FUNDS TRANSFER CR-50200035187206 -SL ICK ORGANICS PVT LTD,insurance,insurance,Other,2500000
632ae6ce2e1a0ebb7f46fb26,50200023535069,12833557.19,60ec41ba55c00300382672d9,HDFC,direct expenses,5eecc6d6449e4f7cfb1c2708,2022-07-18T00:00:00.000Z,"NEFT DR-IDFB0040101-ACTIVES ADDITIVES AP PLICATIONS LLP-NETBANK, MUM-N19922204275 4673-36000",insurance,insurance,net_banking_transfer,-36000
632ae6ce2e1a0ebb7f46fb2a,50200023535069,12887793.35,60ec41ba55c00300382672d9,HDFC,Transfer in/Revenue-other,5eecc6d6449e4f7cfb1c2708,2022-07-18T00:00:00.000Z,"IMPS-219916700339-GOKWIK COMMERCE SOLU-I CIC-XXXXXXXX0630-PAYOUT FOR JULY 16, 202 2",,,net_banking_transfer,54236.16
632ae6ce2e1a0ebb7f46fb2c,50200023535069,12886288.35,60ec41ba55c00300382672d9,HDFC,direct expenses,5eecc6d6449e4f7cfb1c2708,2022-07-18T00:00:00.000Z,POS 514834XXXXXX9486 SMARTSHIFT LOGIS,,,debit_card,-1505
632ae6ce2e1a0ebb7f46fb2e,50200023535069,386288.35,60ec41ba55c00300382672d9,HDFC,direct expenses,5eecc6d6449e4f7cfb1c2708,2022-07-18T00:00:00.000Z,FD BOOKED - 50300653995829 : SLICK ORGAN ICS PVT LTD,insurance,insurance,investment,-12500000
632ae6ce2e1a0ebb7f46fb30,50200023535069,423352.83,60ec41ba55c00300382672d9,HDFC,Revenue-COD,5eecc6d6449e4f7cfb1c2708,2022-07-18T00:00:00.000Z,NEFT CR-ICIC0000155-SHIPROCKET COD CRF I D 4619823-SLICK ORGANICS PVT LTD-CMS2711 003605,insurance,insurance,net_banking_transfer,37064.48
632ae6ce2e1a0ebb7f46fb32,50200023535069,435845.89,60ec41ba55c00300382672d9,HDFC,Revenue-PG-split enabled,5eecc6d6449e4f7cfb1c2708,2022-07-18T00:00:00.000Z,NEFT CR-UTIB0001506-RAZORPAY SOFTWARE PR IVATE LIMITED-SLICK ORGANICS PVT LITD-AX ISCN0155412073,insurance,insurance,net_banking_transfer,12493.06
632ae6ce2e1a0ebb7f46fb34,50200023535069,435846.89,60ec41ba55c00300382672d9,HDFC,Revenue-PG-split enabled,5eecc6d6449e4f7cfb1c2708,2022-07-18T00:00:00.000Z,IMPS-219917988337-CASHFREE PAYMENTS IN-I CIC-XXXXXXXX0293-XPEDIZE BANK DETAILS VA LIDATION CF,,,net_banking_transfer,1
632ae6ce2e1a0ebb7f46fb36,50200023535069,448232.89,60ec41ba55c00300382672d9,HDFC,Revenue-COD,5eecc6d6449e4f7cfb1c2708,2022-07-18T00:00:00.000Z,PICKRR TECHNOL-AKHILESHDIXIT85GMAIL,,,Other,12386
632ae6ce2e1a0ebb7f46fb38,50200023535069,447943.89,60ec41ba55c00300382672d9,HDFC,direct expenses,5eecc6d6449e4f7cfb1c2708,2022-07-18T00:00:00.000Z,POS 514834XXXXXX9486 SMARTSHIFT LOGIS,,,debit_card,-289
632ae6ce2e1a0ebb7f46fb3a,50200023535069,9631.75,60ec41ba55c00300382672d9,HDFC,Revenue-Mktplace,5eecc6d6449e4f7cfb1c2708,2022-08-01T00:00:00.000Z,NEFT CR-DEUT0797BGL-FLIPKART INTERNET PR IVATE LIMITED-SLICK ORGANICS PVT LTD-221 300119GN00245,shopping,,net_banking_transfer,9532.46
632ae6ce2e1a0ebb7f46fb3c,50200023535069,14506.78,60ec41ba55c00300382672d9,HDFC,Revenue-PG-non-split,5eecc6d6449e4f7cfb1c2708,2022-08-01T00:00:00.000Z,NEFT CR-PYTM0123456-PAYTM PAYMENTS SERVI CES LIMITED-SLICK ORGANICS PVT LTD-PYTM2 22131856928,insurance,insurance,net_banking_transfer,4875.03
632ae6ce2e1a0ebb7f46fb3e,50200023535069,-1453493.22,60ec41ba55c00300382672d9,HDFC,direct expenses,5eecc6d6449e4f7cfb1c2708,2022-08-01T00:00:00.000Z,02711600008220-TPT-1468000-VARUN SINGH,,,net_banking_transfer,-1468000
632ae6ce2e1a0ebb7f46fb40,50200023535069,-1446492.81,60ec41ba55c00300382672d9,HDFC,Revenue-Mktplace,5eecc6d6449e4f7cfb1c2708,2022-08-01T00:00:00.000Z,NEFT CR-DEUT0797BGL-MYNTRA DESIGNS PRIVA TE LIMITED-SLICK ORGANICS PVT. LTD.-2213 00678GN00118,shopping,,net_banking_transfer,7000.41
632ae6ce2e1a0ebb7f46fb42,50200023535069,-1433648.75,60ec41ba55c00300382672d9,HDFC,Revenue-Mktplace,5eecc6d6449e4f7cfb1c2708,2022-08-01T00:00:00.000Z,NEFT CR-DEUT0797BGL-MYNTRA DESIGNS PRIVA TE LIMITED-SLICK ORGANICS PVT. LTD.-2213 00679GN00220,shopping,,net_banking_transfer,12844.06
632ae6ce2e1a0ebb7f46fb44,50200023535069,-1398903.78,60ec41ba55c00300382672d9,HDFC,Revenue-PG-split enabled,5eecc6d6449e4f7cfb1c2708,2022-08-01T00:00:00.000Z,NEFT CR-UTIB0001506-RAZORPAY SOFTWARE PR IVATE LIMITED-SLICK ORGANICS PVT LITD-AX ISCN0158101562,insurance,insurance,net_banking_transfer,34744.97
632ae6ce2e1a0ebb7f46fb46,50200023535069,-1399352.78,60ec41ba55c00300382672d9,HDFC,direct expenses,5eecc6d6449e4f7cfb1c2708,2022-08-01T00:00:00.000Z,POS 514834XXXXXX9486 SMARTSHIFT LOGIS,,,debit_card,-449
632ae6ce2e1a0ebb7f46fb48,50200023535069,-1549352.78,60ec41ba55c00300382672d9,HDFC,direct expenses,5eecc6d6449e4f7cfb1c2708,2022-08-01T00:00:00.000Z,"NEFT DR-UTIB0000119-SAFEXPRESS-NETBANK, MUM-N213222059224060-150000",,,net_banking_transfer,-150000
632ae6ce2e1a0ebb7f46fb4a,50200023535069,-1599352.78,60ec41ba55c00300382672d9,HDFC,direct expenses,5eecc6d6449e4f7cfb1c2708,2022-08-01T00:00:00.000Z,"NEFT DR-KKBK0000173-MATRIX PRINTING SOLU TIONS PRIVATE LIMITE-NETBANK, MUM-N21322 2059233368-50000",,,net_banking_transfer,-50000
632ae6ce2e1a0ebb7f46fb4c,50200023535069,-1659652.78,60ec41ba55c00300382672d9,HDFC,direct expenses,5eecc6d6449e4f7cfb1c2708,2022-08-01T00:00:00.000Z,50100433068791-TPT-60300-NATHIYA KUBENDI RAN,,,net_banking_transfer,-60300
632ae6ce2e1a0ebb7f46fb4e,50200023535069,-1671452.78,60ec41ba55c00300382672d9,HDFC,direct expenses,5eecc6d6449e4f7cfb1c2708,2022-08-01T00:00:00.000Z,"NEFT DR-UTIB0000032-SKUMAR MULTIPRODUCTS PVT LTD-NETBANK, MUM-N213222059254596-1 1800",,,net_banking_transfer,-11800
632ae6ce2e1a0ebb7f46fb50,50200023535069,-1833452.78,60ec41ba55c00300382672d9,HDFC,direct expenses,5eecc6d6449e4f7cfb1c2708,2022-08-01T00:00:00.000Z,05722560002993-TPT-162000-M5 ENTERTAINME NT PRIVATE LIMITED,,,net_banking_transfer,-162000
632ae6ce2e1a0ebb7f46fb52,50200023535069,-1834501.78,60ec41ba55c00300382672d9,HDFC,direct expenses,5eecc6d6449e4f7cfb1c2708,2022-08-01T00:00:00.000Z,POS 514834XXXXXX9486 SMARTSHIFT LOGIS,,,debit_card,-1049
632ae6ce2e1a0ebb7f46fb54,50200023535069,-1835516.78,60ec41ba55c00300382672d9,HDFC,direct expenses,5eecc6d6449e4f7cfb1c2708,2022-08-01T00:00:00.000Z,POS 514834XXXXXX9486 SMARTSHIFT LOGIS,,,debit_card,-1015
632ae6ce2e1a0ebb7f46fb56,50200023535069,-1835518.78,60ec41ba55c00300382672d9,HDFC,Marketing Expense,5eecc6d6449e4f7cfb1c2708,2022-08-01T00:00:00.000Z,ME DC SI 514834XXXXXX9486 LINKEDIN,,,Other,-2
632ae6ce2e1a0ebb7f46fb58,50200023535069,-1834701.7,60ec41ba55c00300382672d9,HDFC,Transfer in/Revenue-other,5eecc6d6449e4f7cfb1c2708,2022-08-01T00:00:00.000Z,NEFT CR-UTIB0000114-ONE SIGMA TECHNOLOGI ES PRIVATE LIM-SLICK ORGANICS PRIVATE LI MITED-AXISP00308036442,insurance,insurance,net_banking_transfer,817.08
632ae6ce2e1a0ebb7f46fb5a,50200023535069,-1804787.53,60ec41ba55c00300382672d9,HDFC,Revenue-COD,5eecc6d6449e4f7cfb1c2708,2022-08-01T00:00:00.000Z,NEFT CR-ICIC0000155-SHIPROCKET COD CRF I D 4685327-SLICK ORGANICS PVT LTD-CMS2743 051993,insurance,insurance,net_banking_transfer,29914.17
632ae6ce2e1a0ebb7f46fb5c,50200023535069,-1825927.53,60ec41ba55c00300382672d9,HDFC,direct expenses,5eecc6d6449e4f7cfb1c2708,2022-08-01T00:00:00.000Z,"NEFT DR-KKBK0000173-NITISH KUMAR MANDAL- NETBANK, MUM-N213222059820735-21140",,,net_banking_transfer,-21140
632ae6ce2e1a0ebb7f46fb5e,50200023535069,-1801975.1,60ec41ba55c00300382672d9,HDFC,Transfer in/Revenue-other,5eecc6d6449e4f7cfb1c2708,2022-08-01T00:00:00.000Z,"IMPS-221316230659-GOKWIK COMMERCE SOLU-I CIC-XXXXXXXX0630-PAYOUT FOR JULY 30, 202 2",,,net_banking_transfer,23952.43
632ae6ce2e1a0ebb7f46fb63,50200023535069,-1951975.1,60ec41ba55c00300382672d9,HDFC,direct expenses,5eecc6d6449e4f7cfb1c2708,2022-08-01T00:00:00.000Z,"NEFT DR-SBIN0011783-GALACTIC GRIP-NETBAN K, MUM-N213222059832146-150000",,,net_banking_transfer,-150000
632ae6ce2e1a0ebb7f46fb66,50200023535069,-2822225.1,60ec41ba55c00300382672d9,HDFC,direct expenses,5eecc6d6449e4f7cfb1c2708,2022-08-01T00:00:00.000Z,"NEFT DR-ICIC0000024-TAKE MOTO YOHKI INDI A PRIVATE LIMITED-NETBANK, MUM-N21322205 9843296-870250",travel,,net_banking_transfer,-870250
632ae6ce2e1a0ebb7f46fb68,50200023535069,-2872225.1,60ec41ba55c00300382672d9,HDFC,direct expenses,5eecc6d6449e4f7cfb1c2708,2022-08-01T00:00:00.000Z,"NEFT DR-KKBK0000173-MATRIX PRINTING SOLU TIONS PRIVATE LIMITE-NETBANK, MUM-N21322 2059846342-50000",,,net_banking_transfer,-50000
632ae6ce2e1a0ebb7f46fb6a,50200023535069,-8924014.1,60ec41ba55c00300382672d9,HDFC,Marketing Expense,5eecc6d6449e4f7cfb1c2708,2022-08-01T00:00:00.000Z,"RTGS DR-CITI0000006-FACEBOOK INDIA ONLIN E SERVICES-KALKAJI, NEW-HDFCR52022080186 089184",,,net_banking_transfer,-6051789
632ae6ce2e1a0ebb7f46fb6d,50200023535069,-10544014.1,60ec41ba55c00300382672d9,HDFC,direct expenses,5eecc6d6449e4f7cfb1c2708,2022-08-01T00:00:00.000Z,"NEFT DR-UTIB0000371-TAPASEE PANNU-NETBAN K, MUM-N213222059913963-1620000",,,net_banking_transfer,-1620000
632ae6ce2e1a0ebb7f46fb6f,50200023535069,-10537575.49,60ec41ba55c00300382672d9,HDFC,Revenue-PG-split enabled,5eecc6d6449e4f7cfb1c2708,2022-08-01T00:00:00.000Z,NEFT CR-UTIB0001506-RAZORPAY SOFTWARE PR IVATE LIMITED-SLICK ORGANICS PVT LITD-AX ISCN0158305841,insurance,insurance,net_banking_transfer,6438.61
632ae6ce2e1a0ebb7f46fb71,50200023535069,-10536599.49,60ec41ba55c00300382672d9,HDFC,Transfer in/Revenue-other,5eecc6d6449e4f7cfb1c2708,2022-08-02T00:00:00.000Z,INT. ON SWCR ON-50300653995829,,,Other,976
632ae6ce2e1a0ebb7f46fb73,50200023535069,-9083105.49,60ec41ba55c00300382672d9,HDFC,Loan-in,5eecc6d6449e4f7cfb1c2708,2022-08-02T00:00:00.000Z,SWEEP-IN CREDIT - 50300653995829,,,self_transfer,1453494
632ae6ce2e1a0ebb7f46fb75,50200023535069,-9083104.49,60ec41ba55c00300382672d9,HDFC,Transfer in/Revenue-other,5eecc6d6449e4f7cfb1c2708,2022-08-02T00:00:00.000Z,INT. ON SWCR ON-50300653995829,,,Other,1
632ae6ce2e1a0ebb7f46fb78,50200023535069,-9082055.49,60ec41ba55c00300382672d9,HDFC,Loan-in,5eecc6d6449e4f7cfb1c2708,2022-08-02T00:00:00.000Z,SWEEP-IN CREDIT - 50300653995829,,,self_transfer,1049
632ae6ce2e1a0ebb7f46fb7a,50200023535069,-9082054.49,60ec41ba55c00300382672d9,HDFC,Transfer in/Revenue-other,5eecc6d6449e4f7cfb1c2708,2022-08-02T00:00:00.000Z,INT. ON SWCR ON-50300653995829,,,Other,1
632ae6ce2e1a0ebb7f46fb7c,50200023535069,-9081039.49,60ec41ba55c00300382672d9,HDFC,Loan-in,5eecc6d6449e4f7cfb1c2708,2022-08-02T00:00:00.000Z,SWEEP-IN CREDIT - 50300653995829,,,self_transfer,1015
632ae6ce2e1a0ebb7f46fb7e,50200023535069,-9081037.49,60ec41ba55c00300382672d9,HDFC,Loan-in,5eecc6d6449e4f7cfb1c2708,2022-08-02T00:00:00.000Z,SWEEP-IN CREDIT - 50300653995829,,,self_transfer,2
632ae6ce2e1a0ebb7f46fb80,50200023535069,-9080973.49,60ec41ba55c00300382672d9,HDFC,Transfer in/Revenue-other,5eecc6d6449e4f7cfb1c2708,2022-08-02T00:00:00.000Z,INT. ON SWCR ON-50300653995829,,,Other,64
632ae6ce2e1a0ebb7f46fb82,50200023535069,-8985113.49,60ec41ba55c00300382672d9,HDFC,Loan-in,5eecc6d6449e4f7cfb1c2708,2022-08-02T00:00:00.000Z,SWEEP-IN CREDIT - 50300653995829,,,self_transfer,95860
632ae6ce2e1a0ebb7f46fb84,50200023535069,-8985079.49,60ec41ba55c00300382672d9,HDFC,Transfer in/Revenue-other,5eecc6d6449e4f7cfb1c2708,2022-08-02T00:00:00.000Z,INT. ON SWCR ON-50300653995829,,,Other,34
632ae6ce2e1a0ebb7f46fb86,50200023535069,-8935079.49,60ec41ba55c00300382672d9,HDFC,Loan-in,5eecc6d6449e4f7cfb1c2708,2022-08-02T00:00:00.000Z,SWEEP-IN CREDIT - 50300653995829,,,self_transfer,50000
632ae6ce2e1a0ebb7f46fb88,50200023535069,-8935039.49,60ec41ba55c00300382672d9,HDFC,Transfer in/Revenue-other,5eecc6d6449e4f7cfb1c2708,2022-08-02T00:00:00.000Z,INT. ON SWCR ON-50300653995829,,,Other,40
632ae6ce2e1a0ebb7f46fb8b,50200023535069,-8874739.49,60ec41ba55c00300382672d9,HDFC,Loan-in,5eecc6d6449e4f7cfb1c2708,2022-08-02T00:00:00.000Z,SWEEP-IN CREDIT - 50300653995829,,,self_transfer,60300
632ae6ce2e1a0ebb7f46fb8d,50200023535069,-8874731.49,60ec41ba55c00300382672d9,HDFC,Transfer in/Revenue-other,5eecc6d6449e4f7cfb1c2708,2022-08-02T00:00:00.000Z,INT. ON SWCR ON-50300653995829,,,Other,8
632ae6cf2e1a0ebb7f46fb8f,50200023535069,-8862931.49,60ec41ba55c00300382672d9,HDFC,Loan-in,5eecc6d6449e4f7cfb1c2708,2022-08-02T00:00:00.000Z,SWEEP-IN CREDIT - 50300653995829,,,self_transfer,11800
632ae6cf2e1a0ebb7f46fb91,50200023535069,-8862822.49,60ec41ba55c00300382672d9,HDFC,Transfer in/Revenue-other,5eecc6d6449e4f7cfb1c2708,2022-08-02T00:00:00.000Z,INT. ON SWCR ON-50300653995829,,,Other,109
632ae6cf2e1a0ebb7f46fb93,50200023535069,-8700822.49,60ec41ba55c00300382672d9,HDFC,Loan-in,5eecc6d6449e4f7cfb1c2708,2022-08-02T00:00:00.000Z,SWEEP-IN CREDIT - 50300653995829,,,self_transfer,162000
632ae6cf2e1a0ebb7f46fb95,50200023535069,-8696766.49,60ec41ba55c00300382672d9,HDFC,Transfer in/Revenue-other,5eecc6d6449e4f7cfb1c2708,2022-08-02T00:00:00.000Z,INT. ON SWCR ON-50300653995829,,,Other,4056
632ae6cf2e1a0ebb7f46fb97,50200023535069,-2654568.49,60ec41ba55c00300382672d9,HDFC,Loan-in,5eecc6d6449e4f7cfb1c2708,2022-08-02T00:00:00.000Z,SWEEP-IN CREDIT - 50300653995829,,,self_transfer,6042198
632ae6cf2e1a0ebb7f46fb99,50200023535069,-2654483.49,60ec41ba55c00300382672d9,HDFC,Transfer in/Revenue-other,5eecc6d6449e4f7cfb1c2708,2022-08-02T00:00:00.000Z,INT. ON SWCR ON-50300653995829,,,Other,85
632ae6cf2e1a0ebb7f46fb9b,50200023535069,-2528435.49,60ec41ba55c00300382672d9,HDFC,Loan-in,5eecc6d6449e4f7cfb1c2708,2022-08-02T00:00:00.000Z,SWEEP-IN CREDIT - 50300653995829,,,self_transfer,126048
632ae6cf2e1a0ebb7f46fb9d,50200023535069,-2527851.49,60ec41ba55c00300382672d9,HDFC,Transfer in/Revenue-other,5eecc6d6449e4f7cfb1c2708,2022-08-02T00:00:00.000Z,INT. ON SWCR ON-50300653995829,,,Other,584
632ae6cf2e1a0ebb7f46fb9f,50200023535069,-1657601.49,60ec41ba55c00300382672d9,HDFC,Loan-in,5eecc6d6449e4f7cfb1c2708,2022-08-02T00:00:00.000Z,SWEEP-IN CREDIT - 50300653995829,,,self_transfer,870250
632ae6cf2e1a0ebb7f46fba1,50200023535069,-1657567.49,60ec41ba55c00300382672d9,HDFC,Transfer in/Revenue-other,5eecc6d6449e4f7cfb1c2708,2022-08-02T00:00:00.000Z,INT. ON SWCR ON-50300653995829,,,Other,34
632ae6cf2e1a0ebb7f46fba3,50200023535069,-1607567.49,60ec41ba55c00300382672d9,HDFC,Loan-in,5eecc6d6449e4f7cfb1c2708,2022-08-02T00:00:00.000Z,SWEEP-IN CREDIT - 50300653995829,,,self_transfer,50000
632ae6cf2e1a0ebb7f46fba5,50200023535069,-1606488.49,60ec41ba55c00300382672d9,HDFC,Transfer in/Revenue-other,5eecc6d6449e4f7cfb1c2708,2022-08-02T00:00:00.000Z,INT. ON SWCR ON-50300653995829,,,Other,1079
632ae6cf2e1a0ebb7f46fba8,50200023535069,1079.51,60ec41ba55c00300382672d9,HDFC,Loan-in,5eecc6d6449e4f7cfb1c2708,2022-08-02T00:00:00.000Z,SWEEP-IN CREDIT - 50300653995829,,,self_transfer,1607568
632ae6cf2e1a0ebb7f46fbaa,50200023535069,204831.13,60ec41ba55c00300382672d9,HDFC,Revenue-Mktplace,5eecc6d6449e4f7cfb1c2708,2022-08-02T00:00:00.000Z,IMPS-221405187723-AMAZON SELLER SERVIC-H SBC-XXXXXXXX6004-3L23TX2Z2H2F3IMBSLICK O RGANICS PVT LTD,shopping,,net_banking_transfer,203751.62
632ae6cf2e1a0ebb7f46fbac,50200023535069,213945.25,60ec41ba55c00300382672d9,HDFC,Revenue-PG-non-split,5eecc6d6449e4f7cfb1c2708,2022-08-02T00:00:00.000Z,NEFT CR-PYTM0123456-PAYTM PAYMENTS SERVI CES LIMITED-SLICK ORGANICS PVT LTD-PYTM2 22143413163,insurance,insurance,net_banking_transfer,9114.12
632ae6cf2e1a0ebb7f46fbae,50200023535069,203945.25,60ec41ba55c00300382672d9,HDFC,direct expenses,5eecc6d6449e4f7cfb1c2708,2022-08-02T00:00:00.000Z,NEFT DR-UTIB0004445-BUZZLER DIGITAL-NETB,,,net_banking_transfer,-10000
632ae6cf2e1a0ebb7f46fbb0,50200023535069,221958.84,60ec41ba55c00300382672d9,HDFC,Revenue-PG-split enabled,5eecc6d6449e4f7cfb1c2708,2022-08-02T00:00:00.000Z,NEFT CR-UTIB0001506-RAZORPAY SOFTWARE PR IVATE LIMITED-SLICK ORGANICS PVT LITD-AX ISCN0158396221,insurance,insurance,net_banking_transfer,18013.59
632ae6cf2e1a0ebb7f46fbb2,50200023535069,733085.56,60ec41ba55c00300382672d9,HDFC,Revenue-Mktplace,5eecc6d6449e4f7cfb1c2708,2022-08-02T00:00:00.000Z,NEFT CR-DEUT0797BGL-AMAZON PAY (INDIA) P RIVATE LIMITED-SLICK ORGANICS PVT LTD-22 1400127GN00090,shopping,,net_banking_transfer,511126.72
632ae6cf2e1a0ebb7f46fbb7,50200023535069,30561.56,60ec41ba55c00300382672d9,HDFC,Marketing Expense,5eecc6d6449e4f7cfb1c2708,2022-08-02T00:00:00.000Z,"NEFT DR-CITI0100000-GOOGLE INDIA PVT LTD -NETBANK, MUM-N214222060808302-702524",,,net_banking_transfer,-702524
632ae6cf2e1a0ebb7f46fbb9,50200023535069,12561.56,60ec41ba55c00300382672d9,HDFC,direct expenses,5eecc6d6449e4f7cfb1c2708,2022-08-02T00:00:00.000Z,"NEFT DR-BARB0GOPALP-TUSHAR BEDI-NETBANK, MUM-N214222060803965-18000",,,net_banking_transfer,-18000
632ae6cf2e1a0ebb7f46fbbb,50200023535069,-187438.44,60ec41ba55c00300382672d9,HDFC,direct expenses,5eecc6d6449e4f7cfb1c2708,2022-08-02T00:00:00.000Z,"NEFT DR-YESB0000551-VISTTA COSMETICS-NET BANK, MUM-N214222060924588-200000",,,net_banking_transfer,-200000
632ae6cf2e1a0ebb7f46fbbd,50200023535069,-185076.65,60ec41ba55c00300382672d9,HDFC,Transfer in/Revenue-other,5eecc6d6449e4f7cfb1c2708,2022-08-02T00:00:00.000Z,NEFT CR-UTIB0000114-ONE SIGMA TECHNOLOGI ES PRIVATE LIM-SLICK ORGANICS PRIVATE LI MITED-AXISP00308410331,insurance,insurance,net_banking_transfer,2361.79
632ae6cf2e1a0ebb7f46fbbf,50200023535069,-179858.46,60ec41ba55c00300382672d9,HDFC,Revenue-PG-non-split,5eecc6d6449e4f7cfb1c2708,2022-08-02T00:00:00.000Z,NEFT CR-SCBL0036001-STRIPE INDIA PRIVATE -SLICK ORGANICS PRIVATE LIMITED-SSG17413 Q0741331,insurance,insurance,net_banking_transfer,5218.19
632ae6cf2e1a0ebb7f46fbc1,50200023535069,-165474.46,60ec41ba55c00300382672d9,HDFC,Investment/FD redeem,5eecc6d6449e4f7cfb1c2708,2022-08-02T00:00:00.000Z,FD REDEEM INTEREST -50300653996950/1,,,Other,14384
632ae6cf2e1a0ebb7f46fbc3,50200023535069,19834525.54,60ec41ba55c00300382672d9,HDFC,Investment/FD redeem,5eecc6d6449e4f7cfb1c2708,2022-08-02T00:00:00.000Z,FD REDEEM PRINCIPAL -50300653996950/1,,,Other,20000000
632ae6cf2e1a0ebb7f46fbc5,50200023535069,19867515.09,60ec41ba55c00300382672d9,HDFC,Transfer in/Revenue-other,5eecc6d6449e4f7cfb1c2708,2022-08-02T00:00:00.000Z,"IMPS-221416831144-GOKWIK COMMERCE SOLU-I CIC-XXXXXXXX0630-PAYOUT FOR JULY 31, 202 2",,,net_banking_transfer,32989.55
632ae6cf2e1a0ebb7f46fbc7,50200023535069,19831515.09,60ec41ba55c00300382672d9,HDFC,direct expenses,5eecc6d6449e4f7cfb1c2708,2022-08-02T00:00:00.000Z,"NEFT DR-SCBL0036033-KAVITA GHAI-NETBANK, MUM-N214222061523945-36000",,,net_banking_transfer,-36000
632ae6cf2e1a0ebb7f46fbc9,50200023535069,19591344.09,60ec41ba55c00300382672d9,HDFC,direct expenses,5eecc6d6449e4f7cfb1c2708,2022-08-02T00:00:00.000Z,"NEFT DR-PUNB0100110-KRAUTER HEALTHCARE L TD-NETBANK, MUM-N214222061531574-240171",,,net_banking_transfer,-240171
632ae6cf2e1a0ebb7f46fbcb,50200023535069,19241344.09,60ec41ba55c00300382672d9,HDFC,direct expenses,5eecc6d6449e4f7cfb1c2708,2022-08-02T00:00:00.000Z,"NEFT DR-KKBK0000180-VEDIC COSMECEUTICALS PVT LTD-NETBANK, MUM-N214222061519606-3 50000",,,net_banking_transfer,-350000
632ae6cf2e1a0ebb7f46fbcd,50200023535069,18741344.09,60ec41ba55c00300382672d9,HDFC,direct expenses,5eecc6d6449e4f7cfb1c2708,2022-08-02T00:00:00.000Z,NEFT DR-ICIC0000369-BO INTERNATIONAL-NET,,,net_banking_transfer,-500000
632ae6cf2e1a0ebb7f46fbd2,50200023535069,18339817.28,60ec41ba55c00300382672d9,HDFC,direct expenses,5eecc6d6449e4f7cfb1c2708,2022-08-02T00:00:00.000Z,POS 514834XXXXXX9486 SHOPIFY* 1434698,,,debit_card,-401526.81
632ae6cf2e1a0ebb7f46fbd4,50200023535069,18362626.28,60ec41ba55c00300382672d9,HDFC,Revenue-PG-split enabled,5eecc6d6449e4f7cfb1c2708,2022-08-02T00:00:00.000Z,NEFT CR-UTIB0001506-RAZORPAY SOFTWARE PR IVATE LIMITED-SLICK ORGANICS PVT LITD-AX ISCN0158577820,insurance,insurance,net_banking_transfer,22809
632ae6cf2e1a0ebb7f46fbd6,50200023535069,18329110.8,60ec41ba55c00300382672d9,HDFC,SAAS/tech expense,5eecc6d6449e4f7cfb1c2708,2022-08-02T00:00:00.000Z,POS 514834XXXXXX9486 AMAZON.COM,shopping,,debit_card,-33515.48
632ae6cf2e1a0ebb7f46fbd8,50200023535069,18433505.8,60ec41ba55c00300382672d9,HDFC,Revenue-COD,5eecc6d6449e4f7cfb1c2708,2022-08-02T00:00:00.000Z,PICKRR TECHNOL-AKHILESHDIXIT85GMAIL,,,Other,104395
632ae6cf2e1a0ebb7f46fbda,50200023535069,18457349.53,60ec41ba55c00300382672d9,HDFC,Revenue-PG-non-split,5eecc6d6449e4f7cfb1c2708,2022-08-03T00:00:00.000Z,IMPS-221504017485-PAYTM PAYMENTS SERVI-P YTM-XXXXXXXXXX0008-ALL202208032168200003 30830668628,ewallet,,net_banking_transfer,23843.73
632ae6cf2e1a0ebb7f46fbdc,50200023535069,18476815.98,60ec41ba55c00300382672d9,HDFC,Revenue-Mktplace,5eecc6d6449e4f7cfb1c2708,2022-08-03T00:00:00.000Z,NEFT CR-DEUT0797BGL-FLIPKART INTERNET PR IVATE LIMITED-SLICK ORGANICS PVT LTD-221 500206GN00163,shopping,,net_banking_transfer,19466.45
632ae6cf2e1a0ebb7f46fbde,50200023535069,18484587.89,60ec41ba55c00300382672d9,HDFC,Revenue-Mktplace,5eecc6d6449e4f7cfb1c2708,2022-08-03T00:00:00.000Z,NEFT CR-DEUT0797BGL-MYNTRA DESIGNS PRIVA TE LIMITED-SLICK ORGANICS PVT. LTD.-2215 00730GN00092,shopping,,net_banking_transfer,7771.91
632ae6cf2e1a0ebb7f46fbe0,50200023535069,18490939.78,60ec41ba55c00300382672d9,HDFC,Revenue-Mktplace,5eecc6d6449e4f7cfb1c2708,2022-08-03T00:00:00.000Z,NEFT CR-DEUT0797BGL-MYNTRA DESIGNS PRIVA TE LIMITED-SLICK ORGANICS PVT. LTD.-2215 00731GN00193,shopping,,net_banking_transfer,6351.89
632ae6cf2e1a0ebb7f46fbe2,50200023535069,18520105.39,60ec41ba55c00300382672d9,HDFC,Revenue-PG-split enabled,5eecc6d6449e4f7cfb1c2708,2022-08-03T00:00:00.000Z,NEFT CR-UTIB0001506-RAZORPAY SOFTWARE PR IVATE LIMITED-SLICK ORGANICS PVT LITD-AX ISCN0158680545,insurance,insurance,net_banking_transfer,29165.61
632ae6cf2e1a0ebb7f46fbe4,50200023535069,18011479.39,60ec41ba55c00300382672d9,HDFC,direct expenses,5eecc6d6449e4f7cfb1c2708,2022-08-03T00:00:00.000Z,"NEFT DR-SRCB0000281-3D TECHNOPACK PRIVAT E LIMITED-NETBANK, MUM-N215222062326734- 508626",,,net_banking_transfer,-508626
632ae6cf2e1a0ebb7f46fbe6,50200023535069,17792369.39,60ec41ba55c00300382672d9,HDFC,direct expenses,5eecc6d6449e4f7cfb1c2708,2022-08-03T00:00:00.000Z,"NEFT DR-SCBL0036025-DHRUV MADHOK-NETBANK , MUM-N215222062318047-219110",,,net_banking_transfer,-219110
632ae6cf2e1a0ebb7f46fbe8,50200023535069,17542369.39,60ec41ba55c00300382672d9,HDFC,direct expenses,5eecc6d6449e4f7cfb1c2708,2022-08-03T00:00:00.000Z,02711930004579-TPT-250000-DHRUV BHASIN,,,net_banking_transfer,-250000
632ae6cf2e1a0ebb7f46fbea,50200023535069,17442369.39,60ec41ba55c00300382672d9,HDFC,direct expenses,5eecc6d6449e4f7cfb1c2708,2022-08-03T00:00:00.000Z,00918630000430-TPT-100000-UNICOMMERCE ES OLUTIONS PRIVATE LIMITED,,,net_banking_transfer,-100000
632ae6cf2e1a0ebb7f46fbec,50200023535069,17388369.39,60ec41ba55c00300382672d9,HDFC,direct expenses,5eecc6d6449e4f7cfb1c2708,2022-08-03T00:00:00.000Z,50200025384647-TPT-54000-AG POLY PACKS P,,,net_banking_transfer,-54000
632ae6cf2e1a0ebb7f46fbef,50200023535069,17038369.39,60ec41ba55c00300382672d9,HDFC,direct expenses,5eecc6d6449e4f7cfb1c2708,2022-08-03T00:00:00.000Z,57500000443889-TPT-350000-WEBKLIPPER TEC HNOLOGIES PRIVATE LIMITED,,,net_banking_transfer,-350000
632ae6cf2e1a0ebb7f46fbf1,50200023535069,17046901.56,60ec41ba55c00300382672d9,HDFC,Revenue-Mktplace,5eecc6d6449e4f7cfb1c2708,2022-08-03T00:00:00.000Z,NEFT CR-HSBC0400002-AMAZON SERVICES LLC- SLICK ORGANICS PRIVATE LIMITED-HSBCN2221 5669566,shopping,,net_banking_transfer,8532.17
632ae6cf2e1a0ebb7f46fbf3,50200023535069,17041901.56,60ec41ba55c00300382672d9,HDFC,direct expenses,5eecc6d6449e4f7cfb1c2708,2022-08-03T00:00:00.000Z,"NEFT DR-ICIC0000021-AKHILESH DIXIT-NETBA NK, MUM-N215222062579972-5000",,,net_banking_transfer,-5000
632ae6cf2e1a0ebb7f46fbf5,50200023535069,17041899.56,60ec41ba55c00300382672d9,HDFC,Marketing Expense,5eecc6d6449e4f7cfb1c2708,2022-08-03T00:00:00.000Z,ME DC SI 514834XXXXXX9486 LINKEDIN,,,Other,-2
632ae6cf2e1a0ebb7f46fbf7,50200023535069,17050659.06,60ec41ba55c00300382672d9,HDFC,Revenue-Mktplace,5eecc6d6449e4f7cfb1c2708,2022-08-03T00:00:00.000Z,NEFT CR-ICIC0000105-MANASH LIFESTYLE PRI VATE LIMITED NO-SLICK ORGANICS PRIVATE L IMITED MP M-ICIJ222150004175,shopping,,net_banking_transfer,8759.5
632ae6cf2e1a0ebb7f46fbf9,50200023535069,17052165.18,60ec41ba55c00300382672d9,HDFC,Transfer in/Revenue-other,5eecc6d6449e4f7cfb1c2708,2022-08-03T00:00:00.000Z,NEFT CR-UTIB0000114-ONE SIGMA TECHNOLOGI ES PRIVATE LIM-SLICK ORGANICS PRIVATE LI MITED-AXISP00308775438,insurance,insurance,net_banking_transfer,1506.12
632ae6cf2e1a0ebb7f46fbfb,50200023535069,17012604.18,60ec41ba55c00300382672d9,HDFC,direct expenses,5eecc6d6449e4f7cfb1c2708,2022-08-03T00:00:00.000Z,"NEFT DR-INDB0000007-UNITED INDIA INSURAN CE CO LTD-NETBANK, MUM-N215222062859994- 39561",insurance,insurance,net_banking_transfer,-39561
632ae6cf2e1a0ebb7f46fbfd,50200023535069,17020753.12,60ec41ba55c00300382672d9,HDFC,Revenue-PG-split enabled,5eecc6d6449e4f7cfb1c2708,2022-08-03T00:00:00.000Z,NEFT CR-UTIB0001506-RAZORPAY SOFTWARE PR IVATE LIMITED-SLICK ORGANICS PVT LITD-AX ISCN0158803539,insurance,insurance,net_banking_transfer,8148.94
632ae6cf2e1a0ebb7f46fbff,50200023535069,17081518.43,60ec41ba55c00300382672d9,HDFC,Revenue-COD,5eecc6d6449e4f7cfb1c2708,2022-08-03T00:00:00.000Z,NEFT CR-ICIC0000155-SHIPROCKET COD CRF I D 4697650-SLICK ORGANICS PVT LTD-CMS2748 481510,insurance,insurance,net_banking_transfer,60765.31
632ae6cf2e1a0ebb7f46fc01,50200023535069,17087024.32,60ec41ba55c00300382672d9,HDFC,Revenue-PG-non-split,5eecc6d6449e4f7cfb1c2708,2022-08-04T00:00:00.000Z,NEFT CR-PYTM0123456-PAYTM PAYMENTS SERVI CES LIMITED-SLICK ORGANICS PVT LTD-PYTM2 22166044590,insurance,insurance,net_banking_transfer,5505.89
632ae6cf2e1a0ebb7f46fc03,50200023535069,17098294,60ec41ba55c00300382672d9,HDFC,Revenue-PG-split enabled,5eecc6d6449e4f7cfb1c2708,2022-08-04T00:00:00.000Z,NEFT CR-UTIB0001506-RAZORPAY SOFTWARE PR IVATE LIMITED-SLICK ORGANICS PVT LITD-AX ISCN0158892721,insurance,insurance,net_banking_transfer,11269.68
632ae6cf2e1a0ebb7f46fc05,50200023535069,17081302,60ec41ba55c00300382672d9,HDFC,direct expenses,5eecc6d6449e4f7cfb1c2708,2022-08-04T00:00:00.000Z,POS 514834XXXXXX9486 SARVIN PRINTERS,,,debit_card,-16992
632ae6cf2e1a0ebb7f46fc07,50200023535069,17081076.2,60ec41ba55c00300382672d9,HDFC,bank charges,5eecc6d6449e4f7cfb1c2708,2022-08-04T00:00:00.000Z,.DC INTL POS TXN MARKUP+ST 190622 210622,,,international_transaction_arbitrage,-225.8
632ae6cf2e1a0ebb7f46fc09,50200023535069,17082367.01,60ec41ba55c00300382672d9,HDFC,Revenue-Mktplace,5eecc6d6449e4f7cfb1c2708,2022-08-04T00:00:00.000Z,NEFT CR-ICIC0000105-MANASH LIFESTYLE PRI VATE LIMITED NO-SLICK ORGANICS PRIVATE L IMITED MP G-ICIJ222160004370,shopping,,net_banking_transfer,1290.81
632ae6cf2e1a0ebb7f46fc0b,50200023535069,17083588.21,60ec41ba55c00300382672d9,HDFC,Revenue-Mktplace,5eecc6d6449e4f7cfb1c2708,2022-08-04T00:00:00.000Z,NEFT CR-ICIC0000105-MANASH LIFESTYLE PRI VATE LIMITED NO-SLICK ORGANICS PRIVATE L IMITED MP M-ICIJ222160004372,shopping,,net_banking_transfer,1221.2
632ae6cf2e1a0ebb7f46fc0d,50200023535069,17087201.57,60ec41ba55c00300382672d9,HDFC,Transfer in/Revenue-other,5eecc6d6449e4f7cfb1c2708,2022-08-04T00:00:00.000Z,NEFT CR-UTIB0000114-ONE SIGMA TECHNOLOGI ES PRIVATE LIM-SLICK ORGANICS PRIVATE LI MITED-AXISP00309091989,insurance,insurance,net_banking_transfer,3613.36
632ae6cf2e1a0ebb7f46fc0f,50200023535069,17060201.57,60ec41ba55c00300382672d9,HDFC,direct expenses,5eecc6d6449e4f7cfb1c2708,2022-08-04T00:00:00.000Z,"NEFT DR-KKBK0000654-NIHARIKA MISHRA-NETB ANK, MUM-N216222064434434-27000",,,net_banking_transfer,-27000
632ae6cf2e1a0ebb7f46fc12,50200023535069,17049401.57,60ec41ba55c00300382672d9,HDFC,direct expenses,5eecc6d6449e4f7cfb1c2708,2022-08-04T00:00:00.000Z,"NEFT DR-ICIC0000716-VAHDAM TEAS PRIVATE LIMITED-NETBANK, MUM-N216222064477324-10 800",,,net_banking_transfer,-10800
632ae6cf2e1a0ebb7f46fc14,50200023535069,16999401.57,60ec41ba55c00300382672d9,HDFC,direct expenses,5eecc6d6449e4f7cfb1c2708,2022-08-04T00:00:00.000Z,"NEFT DR-ICIC0002451-SOUTH COURT CONDOMIN IUM ASSOCIATION-NETBANK, MUM-N2162220646 05591-50000",,,net_banking_transfer,-50000
632ae6cf2e1a0ebb7f46fc16,50200023535069,16998218.57,60ec41ba55c00300382672d9,HDFC,direct expenses,5eecc6d6449e4f7cfb1c2708,2022-08-04T00:00:00.000Z,POS 514834XXXXXX9486 SMARTSHIFT LOGIS,,,debit_card,-1183
632ae6cf2e1a0ebb7f46fc18,50200023535069,16986970.57,60ec41ba55c00300382672d9,HDFC,direct expenses,5eecc6d6449e4f7cfb1c2708,2022-08-04T00:00:00.000Z,"NEFT DR-SBIN0001859-PARSHOTAM AND ASSOCI ATES-NETBANK, MUM-N216222064670842-11248",,,net_banking_transfer,-11248
632ae6cf2e1a0ebb7f46fc1a,50200023535069,17021685.42,60ec41ba55c00300382672d9,HDFC,Transfer in/Revenue-other,5eecc6d6449e4f7cfb1c2708,2022-08-04T00:00:00.000Z,"IMPS-221616601109-GOKWIK COMMERCE SOLU-I CIC-XXXXXXXX0630-PAYOUT FOR AUGUST 1, 20 22",,,net_banking_transfer,34714.85
632ae6cf2e1a0ebb7f46fc1c,50200023535069,17025280.42,60ec41ba55c00300382672d9,HDFC,Revenue-Mktplace,5eecc6d6449e4f7cfb1c2708,2022-08-04T00:00:00.000Z,NEFT CR-SCBL0036001-DREAMPLUG TECHNOLOGI ES PRIVATE LIMITED-SLICK ORGANICS PRIVAT E LIMITEDSLICK-IN1ON22080409WJR,,,net_banking_transfer,3595
632ae6cf2e1a0ebb7f46fc1e,50200023535069,17038030.27,60ec41ba55c00300382672d9,HDFC,Revenue-PG-split enabled,5eecc6d6449e4f7cfb1c2708,2022-08-04T00:00:00.000Z,NEFT CR-UTIB0001506-RAZORPAY SOFTWARE PR IVATE LIMITED-SLICK ORGANICS PVT LITD-AX ISCN0159057373,insurance,insurance,net_banking_transfer,12749.85
632ae6cf2e1a0ebb7f46fc20,50200023535069,17036988.27,60ec41ba55c00300382672d9,HDFC,direct expenses,5eecc6d6449e4f7cfb1c2708,2022-08-04T00:00:00.000Z,NEFT DR-SBIN0001859-PARSHOTAM AND ASSOCI,,,net_banking_transfer,-1042
632ae6cf2e1a0ebb7f46fc22,50200023535069,17021907.27,60ec41ba55c00300382672d9,HDFC,direct expenses,5eecc6d6449e4f7cfb1c2708,2022-08-04T00:00:00.000Z,"NEFT DR-SCBL0036028-SHUBHAM SINGH PANWAR -NETBANK, MUM-N216222065253686-15081",,,net_banking_transfer,-15081
632ae6cf2e1a0ebb7f46fc24,50200023535069,16821907.27,60ec41ba55c00300382672d9,HDFC,direct expenses,5eecc6d6449e4f7cfb1c2708,2022-08-04T00:00:00.000Z,"NEFT DR-SRCB0000281-3D TECHNOPACK PRIVAT E LIMITED-NETBANK, MUM-N216222065277582- 200000",,,net_banking_transfer,-200000
632ae6cf2e1a0ebb7f46fc26,50200023535069,16674084.27,60ec41ba55c00300382672d9,HDFC,direct expenses,5eecc6d6449e4f7cfb1c2708,2022-08-04T00:00:00.000Z,IMPS-221619182586-3D TECHNOPACK PRIVATE LIMITED-SRCB-XXXXXXXXXXX0017-147823,,,net_banking_transfer,-147823
632ae6cf2e1a0ebb7f46fc28,50200023535069,16688260.87,60ec41ba55c00300382672d9,HDFC,Revenue-Mktplace,5eecc6d6449e4f7cfb1c2708,2022-08-05T00:00:00.000Z,NEFT CR-DEUT0797BGL-FLIPKART INTERNET PR IVATE LIMITED-SLICK ORGANICS PVT LTD-221 700143GN00071,shopping,,net_banking_transfer,14176.6
632ae6d02e1a0ebb7f46fc2a,50200023535069,16716952.18,60ec41ba55c00300382672d9,HDFC,Revenue-PG-non-split,5eecc6d6449e4f7cfb1c2708,2022-08-05T00:00:00.000Z,NEFT CR-PYTM0123456-PAYTM PAYMENTS SERVI CES LIMITED-SLICK ORGANICS PVT LTD-PYTM2 22177681725,insurance,insurance,net_banking_transfer,28691.31
632ae6d02e1a0ebb7f46fc2c,50200023535069,16720623.91,60ec41ba55c00300382672d9,HDFC,Revenue-Mktplace,5eecc6d6449e4f7cfb1c2708,2022-08-05T00:00:00.000Z,NEFT CR-DEUT0797BGL-MYNTRA DESIGNS PRIVA TE LIMITED-SLICK ORGANICS PVT. LTD.-2217 00690GN00113,shopping,,net_banking_transfer,3671.73
632ae6d02e1a0ebb7f46fc2e,50200023535069,16727142.57,60ec41ba55c00300382672d9,HDFC,Revenue-Mktplace,5eecc6d6449e4f7cfb1c2708,2022-08-05T00:00:00.000Z,NEFT CR-DEUT0797BGL-MYNTRA DESIGNS PRIVA TE LIMITED-SLICK ORGANICS PVT. LTD.-2217 00689GN00229,shopping,,net_banking_transfer,6518.66
632ae6d02e1a0ebb7f46fc30,50200023535069,16750100.43,60ec41ba55c00300382672d9,HDFC,Revenue-PG-split enabled,5eecc6d6449e4f7cfb1c2708,2022-08-05T00:00:00.000Z,NEFT CR-UTIB0001506-RAZORPAY SOFTWARE PR IVATE LIMITED-SLICK ORGANICS PVT LITD-AX ISCN0159145012,insurance,insurance,net_banking_transfer,22957.86
632ae6d02e1a0ebb7f46fc32,50200023535069,16786093.28,60ec41ba55c00300382672d9,HDFC,Transfer in/Revenue-other,5eecc6d6449e4f7cfb1c2708,2022-08-05T00:00:00.000Z,FT- REMITTANCE OG JUN22-50200050675669 - HOUZ OF NATURE PVT LTD -,,,Other,35992.85
632ae6d02e1a0ebb7f46fc34,50200023535069,16531093.28,60ec41ba55c00300382672d9,HDFC,SAAS/tech expense,5eecc6d6449e4f7cfb1c2708,2022-08-05T00:00:00.000Z,POS 514834XXXXXX9486 AMAZON,shopping,,debit_card,-255000
632ae6d02e1a0ebb7f46fc36,50200023535069,16526093.28,60ec41ba55c00300382672d9,HDFC,direct expenses,5eecc6d6449e4f7cfb1c2708,2022-08-05T00:00:00.000Z,"NEFT DR-ICIC0000021-AKHILESH DIXIT-NETBA NK, MUM-N217222065881253-ADVANCE",,,net_banking_transfer,-5000
632ae6d02e1a0ebb7f46fc38,50200023535069,16396493.28,60ec41ba55c00300382672d9,HDFC,direct expenses,5eecc6d6449e4f7cfb1c2708,2022-08-05T00:00:00.000Z,"NEFT DR-UTIB0000015-EDWARD LALREMPUIA-NE TBANK, MUM-N217222066210264-129600",,,net_banking_transfer,-129600
632ae6d02e1a0ebb7f46fc3b,50200023535069,15896493.28,60ec41ba55c00300382672d9,HDFC,direct expenses,5eecc6d6449e4f7cfb1c2708,2022-08-05T00:00:00.000Z,"NEFT DR-ICIC0000369-BO INTERNATIONAL-NET BANK, MUM-N217222066224957-500000",,,net_banking_transfer,-500000
632ae6d02e1a0ebb7f46fc3d,50200023535069,15815493.28,60ec41ba55c00300382672d9,HDFC,direct expenses,5eecc6d6449e4f7cfb1c2708,2022-08-05T00:00:00.000Z,50200037442899-TPT-81000-THE FORMAL EDIT,,,net_banking_transfer,-81000
632ae6d02e1a0ebb7f46fc40,50200023535069,15806493.28,60ec41ba55c00300382672d9,HDFC,direct expenses,5eecc6d6449e4f7cfb1c2708,2022-08-05T00:00:00.000Z,"NEFT DR-INDB0000041-ANSHUL JAIN-NETBANK, MUM-N217222066265057-9000",,,net_banking_transfer,-9000
632ae6d02e1a0ebb7f46fc43,50200023535069,15748173.28,60ec41ba55c00300382672d9,HDFC,direct expenses,5eecc6d6449e4f7cfb1c2708,2022-08-05T00:00:00.000Z,"NEFT DR-ICIC0001211-RUNWAY LIFESTYLE EVE NTS PVT LTD-NETBANK, MUM-N21722206635397 7-58320",shopping,,net_banking_transfer,-58320
632ae6d02e1a0ebb7f46fc45,50200023535069,15448173.28,60ec41ba55c00300382672d9,HDFC,direct expenses,5eecc6d6449e4f7cfb1c2708,2022-08-05T00:00:00.000Z,05892560000649-TPT-300000-DECORPAC INDIA PRIVATE LIMITED,,,net_banking_transfer,-300000
632ae6d02e1a0ebb7f46fc47,50200023535069,15423673.28,60ec41ba55c00300382672d9,HDFC,direct expenses,5eecc6d6449e4f7cfb1c2708,2022-08-05T00:00:00.000Z,"NEFT DR-ICIC0000542-AVANTIKA SUKHIA-NETB ANK, MUM-N217222066393541-24500",,,net_banking_transfer,-24500
632ae6d02e1a0ebb7f46fc49,50200023535069,15323673.28,60ec41ba55c00300382672d9,HDFC,direct expenses,5eecc6d6449e4f7cfb1c2708,2022-08-05T00:00:00.000Z,"NEFT DR-KKBK0000173-MATRIX PRINTING SOLU TIONS PRIVATE LIMITE-NETBANK, MUM-N21722 2066443335-100000",,,net_banking_transfer,-100000
632ae6d02e1a0ebb7f46fc4b,50200023535069,15366723.11,60ec41ba55c00300382672d9,HDFC,Transfer in/Revenue-other,5eecc6d6449e4f7cfb1c2708,2022-08-05T00:00:00.000Z,"IMPS-221716127776-GOKWIK COMMERCE SOLU-I CIC-XXXXXXXX0630-PAYOUT FOR AUGUST 2, 20 22",,,net_banking_transfer,43049.83
632ae6d02e1a0ebb7f46fc4d,50200023535069,15366885.12,60ec41ba55c00300382672d9,HDFC,Revenue-Mktplace,5eecc6d6449e4f7cfb1c2708,2022-08-05T00:00:00.000Z,NEFT CR-ICIC0000105-MANASH LIFESTYLE PRI VATE LIMITED NO-SLICK ORGANICS PRIVATE L IMITED MP M-ICIJ222170007010,shopping,,net_banking_transfer,162.01
632ae6d02e1a0ebb7f46fc4f,50200023535069,15356885.12,60ec41ba55c00300382672d9,HDFC,Refund,5eecc6d6449e4f7cfb1c2708,2022-08-05T00:00:00.000Z,IMPS-221717329358-RAZORPAY REFUND CREDIT S TOPUP-RATN-XXXXXXXXXXXX8432-RAZOR,,,net_banking_transfer,-10000
632ae6d02e1a0ebb7f46fc51,50200023535069,15376234.78,60ec41ba55c00300382672d9,HDFC,Revenue-UPI,5eecc6d6449e4f7cfb1c2708,2022-08-05T00:00:00.000Z,UPI-GOKWIK-GOKWIK@YESBANK-YESB0000340-22 1726250974-PAYOUT FOR AUGUST,,,upi,19349.66
632ae6d02e1a0ebb7f46fc54,50200023535069,15388531.54,60ec41ba55c00300382672d9,HDFC,Revenue-PG-split enabled,5eecc6d6449e4f7cfb1c2708,2022-08-05T00:00:00.000Z,NEFT CR-UTIB0001506-RAZORPAY SOFTWARE PR IVATE LIMITED-SLICK ORGANICS PVT LITD-AX ISCN0159270837,insurance,insurance,net_banking_transfer,12296.76
632ae6d02e1a0ebb7f46fc56,50200023535069,15388533.54,60ec41ba55c00300382672d9,HDFC,Transfer in/Revenue-other,5eecc6d6449e4f7cfb1c2708,2022-08-05T00:00:00.000Z,CRV POS 514834******9486 LINKEDIN,,,refund,2
632ae6d02e1a0ebb7f46fc58,50200023535069,15393125.89,60ec41ba55c00300382672d9,HDFC,Revenue-PG-non-split,5eecc6d6449e4f7cfb1c2708,2022-08-06T00:00:00.000Z,NEFT CR-PYTM0123456-PAYTM PAYMENTS SERVI CES LIMITED-SLICK ORGANICS PVT LTD-PYTM2 22189249613,insurance,insurance,net_banking_transfer,4592.35
632ae6d02e1a0ebb7f46fc5a,50200023535069,15403292.44,60ec41ba55c00300382672d9,HDFC,Revenue-PG-split enabled,5eecc6d6449e4f7cfb1c2708,2022-08-06T00:00:00.000Z,NEFT CR-UTIB0001506-RAZORPAY SOFTWARE PR,,,net_banking_transfer,10166.55
632ae6d02e1a0ebb7f46fc5c,50200023535069,15416882.49,60ec41ba55c00300382672d9,HDFC,Revenue-PG-non-split,5eecc6d6449e4f7cfb1c2708,2022-08-06T00:00:00.000Z,NEFT CR-KKBK0000958-NODAL ACCOUNT BROKEN TUSK TECHNOL-SLICK ORGANICS PRIVATE LIMI TED-CMS2182221724488,insurance,insurance,net_banking_transfer,13590.05
632ae6d02e1a0ebb7f46fc5e,50200023535069,15416616.99,60ec41ba55c00300382672d9,HDFC,Marketing Expense,5eecc6d6449e4f7cfb1c2708,2022-08-06T00:00:00.000Z,ME DC SI 514834XXXXXX9486 LINKEDIN (PGSI ),,,Other,-265.5
632ae6d02e1a0ebb7f46fc60,50200023535069,15417783.99,60ec41ba55c00300382672d9,HDFC,Transfer in/Revenue-other,5eecc6d6449e4f7cfb1c2708,2022-08-06T00:00:00.000Z,NEFT CR-HSBC0560002-INNOVATIVE RETAIL CO NCEPTS PRIVATE-SLICK ORGANICS PVT LTD-HS BCN22218358915,,,net_banking_transfer,1167
632ae6d02e1a0ebb7f46fc62,50200023535069,15417945.99,60ec41ba55c00300382672d9,HDFC,Transfer in/Revenue-other,5eecc6d6449e4f7cfb1c2708,2022-08-06T00:00:00.000Z,NEFT CR-HSBC0560002-INNOVATIVE RETAIL CO NCEPTS PRIVATE-SLICK ORGANICS PVT LTD-HS BCN22218358621,,,net_banking_transfer,162
632ae6d02e1a0ebb7f46fc64,50200023535069,15418886.49,60ec41ba55c00300382672d9,HDFC,Transfer in/Revenue-other,5eecc6d6449e4f7cfb1c2708,2022-08-06T00:00:00.000Z,NEFT CR-HSBC0560002-INNOVATIVE RETAIL CO NCEPTS PRIVATE-SLICK ORGANICS PVT LTD-HS BCN22218359367,,,net_banking_transfer,940.5
632ae6d02e1a0ebb7f46fc66,50200023535069,15420732.11,60ec41ba55c00300382672d9,HDFC,Revenue-PG-split enabled,5eecc6d6449e4f7cfb1c2708,2022-08-06T00:00:00.000Z,NEFT CR-UTIB0001506-RAZORPAY SOFTWARE PR IVATE LIMITED-SLICK ORGANICS PVT LITD-AX ISCN0159460509,insurance,insurance,net_banking_transfer,1845.62
632ae6d02e1a0ebb7f46fc68,50200023535069,15296532.11,60ec41ba55c00300382672d9,HDFC,direct expenses,5eecc6d6449e4f7cfb1c2708,2022-08-07T00:00:00.000Z,50200063349422 NET BANKING SI -124200,,,Other,-124200
632ae6d02e1a0ebb7f46fc6a,50200023535069,15015300.11,60ec41ba55c00300382672d9,HDFC,direct expenses,5eecc6d6449e4f7cfb1c2708,2022-08-07T00:00:00.000Z,50200054531492 NET BANKING SI -281232,,,Other,-281232
632ae6d02e1a0ebb7f46fc6c,50200023535069,14855623.11,60ec41ba55c00300382672d9,HDFC,direct expenses,5eecc6d6449e4f7cfb1c2708,2022-08-07T00:00:00.000Z,50100370748619 NET BANKING SI -159677,,,Other,-159677
632ae6d02e1a0ebb7f46fc6e,50200023535069,14793123.11,60ec41ba55c00300382672d9,HDFC,direct expenses,5eecc6d6449e4f7cfb1c2708,2022-08-07T00:00:00.000Z,50100064106714 NET BANKING SI -62500,,,Other,-62500
632ae6d02e1a0ebb7f46fc70,50200023535069,14743123.11,60ec41ba55c00300382672d9,HDFC,direct expenses,5eecc6d6449e4f7cfb1c2708,2022-08-07T00:00:00.000Z,50100108772229 NET BANKING SI -50000,,,Other,-50000
632ae6d02e1a0ebb7f46fc72,50200023535069,14569604.11,60ec41ba55c00300382672d9,HDFC,direct expenses,5eecc6d6449e4f7cfb1c2708,2022-08-07T00:00:00.000Z,50100155115510 NET BANKING SI -173519,,,Other,-173519
632ae6d02e1a0ebb7f46fc74,50200023535069,14510474.11,60ec41ba55c00300382672d9,HDFC,direct expenses,5eecc6d6449e4f7cfb1c2708,2022-08-07T00:00:00.000Z,50100349886722 NET BANKING SI -59130,,,Other,-59130
632ae6d02e1a0ebb7f46fc76,50200023535069,14454309.11,60ec41ba55c00300382672d9,HDFC,direct expenses,5eecc6d6449e4f7cfb1c2708,2022-08-07T00:00:00.000Z,50100293329616 NET BANKING SI -56165,,,Other,-56165
632ae6d02e1a0ebb7f46fc78,50200023535069,14416293.11,60ec41ba55c00300382672d9,HDFC,direct expenses,5eecc6d6449e4f7cfb1c2708,2022-08-07T00:00:00.000Z,00901610080520 NET BANKING SI -38016,,,Other,-38016
632ae6d02e1a0ebb7f46fc7a,50200023535069,14348439.11,60ec41ba55c00300382672d9,HDFC,direct expenses,5eecc6d6449e4f7cfb1c2708,2022-08-07T00:00:00.000Z,50100179603876 NET BANKING SI -67854,,,Other,-67854
632ae6d02e1a0ebb7f46fc7c,50200023535069,14217350.11,60ec41ba55c00300382672d9,HDFC,direct expenses,5eecc6d6449e4f7cfb1c2708,2022-08-07T00:00:00.000Z,50100093802387 NET BANKING SI -131089,,,Other,-131089
632ae6d02e1a0ebb7f46fc7f,50200023535069,14199180.11,60ec41ba55c00300382672d9,HDFC,direct expenses,5eecc6d6449e4f7cfb1c2708,2022-08-07T00:00:00.000Z,02711600008220 NET BANKING SI -18170,,,Other,-18170
632ae6d02e1a0ebb7f46fc82,50200023535069,14038245.11,60ec41ba55c00300382672d9,HDFC,direct expenses,5eecc6d6449e4f7cfb1c2708,2022-08-07T00:00:00.000Z,09291610057185 NET BANKING SI -160935,,,Other,-160935
632ae6d02e1a0ebb7f46fc84,50200023535069,13963145.11,60ec41ba55c00300382672d9,HDFC,direct expenses,5eecc6d6449e4f7cfb1c2708,2022-08-07T00:00:00.000Z,NEFT DR-KKBK0000187-APPLIED LIFE PRIVATE,,,net_banking_transfer,-75100
632ae6d02e1a0ebb7f46fc86,50200023535069,13742329.11,60ec41ba55c00300382672d9,HDFC,direct expenses,5eecc6d6449e4f7cfb1c2708,2022-08-07T00:00:00.000Z,NEFT DR-BARB0VJMATU-ARTISTO DESIGNZ-SAND OZ - MUM-N219222069115219-NET BANKING SI -220816,,,net_banking_transfer,-220816
632ae6d02e1a0ebb7f46fc88,50200023535069,13548282.11,60ec41ba55c00300382672d9,HDFC,direct expenses,5eecc6d6449e4f7cfb1c2708,2022-08-07T00:00:00.000Z,NEFT DR-KKBK0000261-TANVI TANEJA-SANDOZ - MUM-N219222069115221-NET BANKING SI -1 94047,,,net_banking_transfer,-194047
632ae6d02e1a0ebb7f46fc8a,50200023535069,13444421.11,60ec41ba55c00300382672d9,HDFC,direct expenses,5eecc6d6449e4f7cfb1c2708,2022-08-07T00:00:00.000Z,NEFT DR-ICIC0000021-AKHILESH DIXIT-SANDO Z - MUM-N219222069115223-NET BANKING SI -103861,,,net_banking_transfer,-103861
632ae6d02e1a0ebb7f46fc8c,50200023535069,13409421.11,60ec41ba55c00300382672d9,HDFC,direct expenses,5eecc6d6449e4f7cfb1c2708,2022-08-07T00:00:00.000Z,NEFT DR-ICIC0003851-JITENDER KUMAR-SANDO Z - MUM-N219222069115225-NET BANKING SI -35000,,,net_banking_transfer,-35000
632ae6d02e1a0ebb7f46fc8e,50200023535069,13395872.11,60ec41ba55c00300382672d9,HDFC,direct expenses,5eecc6d6449e4f7cfb1c2708,2022-08-07T00:00:00.000Z,NEFT DR-KKBK0008365-SRIRAJ GUNDA-SANDOZ - MUM-N219222069115227-NET BANKING SI -1 3549,,,net_banking_transfer,-13549
632ae6d02e1a0ebb7f46fc90,50200023535069,13366872.11,60ec41ba55c00300382672d9,HDFC,direct expenses,5eecc6d6449e4f7cfb1c2708,2022-08-07T00:00:00.000Z,NEFT DR-SIBL0000555-JAIVEER KUMAR-SANDOZ - MUM-N219222069115229-NET BANKING SI - 29000,,,net_banking_transfer,-29000
632ae6d02e1a0ebb7f46fc92,50200023535069,13341872.11,60ec41ba55c00300382672d9,HDFC,direct expenses,5eecc6d6449e4f7cfb1c2708,2022-08-07T00:00:00.000Z,NEFT DR-BARB0VJGRKA-OM PRASAD PANDEY-SAN DOZ - MUM-N219222069115231-NET BANKING S I -25000,,,net_banking_transfer,-25000
632ae6d02e1a0ebb7f46fc94,50200023535069,13317872.11,60ec41ba55c00300382672d9,HDFC,direct expenses,5eecc6d6449e4f7cfb1c2708,2022-08-07T00:00:00.000Z,NEFT DR-PUNB0482100-RAM BHAVAN YADAV-SAN DOZ - MUM-N219222069115233-NET BANKING S I -24000,,,net_banking_transfer,-24000
632ae6d02e1a0ebb7f46fc96,50200023535069,13240747.11,60ec41ba55c00300382672d9,HDFC,direct expenses,5eecc6d6449e4f7cfb1c2708,2022-08-07T00:00:00.000Z,NEFT DR-SBIN0070392-APARNA MOHANAN KONAT -SANDOZ - MUM-N219222069115235-NET BANKI NG SI -77125,,,net_banking_transfer,-77125
632ae6d02e1a0ebb7f46fc98,50200023535069,13195428.11,60ec41ba55c00300382672d9,HDFC,direct expenses,5eecc6d6449e4f7cfb1c2708,2022-08-07T00:00:00.000Z,NEFT DR-UTIB0001720-ANUBHAV RAO-SANDOZ - MUM-N219222069115237-NET BANKING SI -45 319,,,net_banking_transfer,-45319
632ae6d02e1a0ebb7f46fc9a,50200023535069,13149028.11,60ec41ba55c00300382672d9,HDFC,direct expenses,5eecc6d6449e4f7cfb1c2708,2022-08-07T00:00:00.000Z,NEFT DR-KKBK0008066-KUSHAGRA SINGH-SANDO,,,net_banking_transfer,-46400
632ae6d02e1a0ebb7f46fc9c,50200023535069,13046066.11,60ec41ba55c00300382672d9,HDFC,direct expenses,5eecc6d6449e4f7cfb1c2708,2022-08-07T00:00:00.000Z,NEFT DR-KKBK0000261-AAYUSHI PAREEK-SANDO Z - MUM-N219222069115241-NET BANKING SI -102962,,,net_banking_transfer,-102962
632ae6d02e1a0ebb7f46fc9e,50200023535069,12957666.11,60ec41ba55c00300382672d9,HDFC,direct expenses,5eecc6d6449e4f7cfb1c2708,2022-08-07T00:00:00.000Z,NEFT DR-IOBA0001445-PRIYANKA GOPAL-SANDO Z - MUM-N219222069115243-NET BANKING SI -88400,,,net_banking_transfer,-88400
632ae6d02e1a0ebb7f46fca0,50200023535069,12916266.11,60ec41ba55c00300382672d9,HDFC,direct expenses,5eecc6d6449e4f7cfb1c2708,2022-08-07T00:00:00.000Z,NEFT DR-UTIB0000120-ADNAN ALI-SANDOZ - M UM-N219222069115245-NET BANKING SI -4140 0,,,net_banking_transfer,-41400
632ae6d02e1a0ebb7f46fca7,50200023535069,12897224.11,60ec41ba55c00300382672d9,HDFC,N-ACH payments,5eecc6d6449e4f7cfb1c2708,2022-08-07T00:00:00.000Z,NEFT DR-DBSS0IN0811-SACHIN SINGH-SANDOZ - MUM-N219222069115247-NET BANKING SI -1 9042,,,net_banking_transfer,-19042
632ae6d02e1a0ebb7f46fca9,50200023535069,12879174.11,60ec41ba55c00300382672d9,HDFC,direct expenses,5eecc6d6449e4f7cfb1c2708,2022-08-07T00:00:00.000Z,NEFT DR-PUNB0307800-SANJEEV NIRMANIA-SAN DOZ - MUM-N219222069115249-NET BANKING S I -18050,,,net_banking_transfer,-18050
632ae6d02e1a0ebb7f46fcab,50200023535069,12863730.11,60ec41ba55c00300382672d9,HDFC,direct expenses,5eecc6d6449e4f7cfb1c2708,2022-08-07T00:00:00.000Z,NEFT DR-SBIN0017746-MANOJ KUMAR-SANDOZ - MUM-N219222069115251-NET BANKING SI -15 444,,,net_banking_transfer,-15444
632ae6d02e1a0ebb7f46fcad,50200023535069,12848649.11,60ec41ba55c00300382672d9,HDFC,direct expenses,5eecc6d6449e4f7cfb1c2708,2022-08-07T00:00:00.000Z,NEFT DR-CNRB0019016-MANEESH-SANDOZ - MUM -N219222069115253-NET BANKING SI -15081,,,net_banking_transfer,-15081
632ae6d02e1a0ebb7f46fcaf,50200023535069,12833568.11,60ec41ba55c00300382672d9,HDFC,direct expenses,5eecc6d6449e4f7cfb1c2708,2022-08-07T00:00:00.000Z,NEFT DR-SCBL0036023-VIVEK YADAV-SANDOZ - MUM-N219222069115255-NET BANKING SI -15 081,,,net_banking_transfer,-15081
632ae6d02e1a0ebb7f46fcb1,50200023535069,12814490.11,60ec41ba55c00300382672d9,HDFC,direct expenses,5eecc6d6449e4f7cfb1c2708,2022-08-07T00:00:00.000Z,NEFT DR-KKBK0005032-DEEPAK YADAV-SANDOZ - MUM-N219222069115257-NET BANKING SI -1 9078,,,net_banking_transfer,-19078
632ae6d02e1a0ebb7f46fcb3,50200023535069,12796320.11,60ec41ba55c00300382672d9,HDFC,direct expenses,5eecc6d6449e4f7cfb1c2708,2022-08-07T00:00:00.000Z,NEFT DR-PUNB0494300-KUNDAN PRASAD-SANDOZ - MUM-N219222069115260-NET BANKING SI - 18170,,,net_banking_transfer,-18170
632ae6d02e1a0ebb7f46fcb5,50200023535069,12779059.11,60ec41ba55c00300382672d9,HDFC,direct expenses,5eecc6d6449e4f7cfb1c2708,2022-08-07T00:00:00.000Z,NEFT DR-PUNB0151400-BHUWAN CHANDER JOSHI,,,net_banking_transfer,-17261
632ae6d02e1a0ebb7f46fcb7,50200023535069,12761798.11,60ec41ba55c00300382672d9,HDFC,direct expenses,5eecc6d6449e4f7cfb1c2708,2022-08-07T00:00:00.000Z,NEFT DR-BARB0DINARA-MD ARIF RAZA-SANDOZ - MUM-N219222069115263-NET BANKING SI -1 7261,,,net_banking_transfer,-17261
632ae6d02e1a0ebb7f46fcb9,50200023535069,12713198.11,60ec41ba55c00300382672d9,HDFC,direct expenses,5eecc6d6449e4f7cfb1c2708,2022-08-07T00:00:00.000Z,NEFT DR-CNRB0015170-SNEHAL TAYDE-SANDOZ - MUM-N219222069115265-NET BANKING SI -4 8600,,,net_banking_transfer,-48600
632ae6d02e1a0ebb7f46fcbc,50200023535069,12641198.11,60ec41ba55c00300382672d9,HDFC,direct expenses,5eecc6d6449e4f7cfb1c2708,2022-08-07T00:00:00.000Z,NEFT DR-KKBK0000664-SHRADDHA DINESH SHU KLA-SANDOZ - MUM-N219222069115267-NET BA NKING SI -72000,,,net_banking_transfer,-72000
632ae6d02e1a0ebb7f46fcbe,50200023535069,12484598.11,60ec41ba55c00300382672d9,HDFC,direct expenses,5eecc6d6449e4f7cfb1c2708,2022-08-07T00:00:00.000Z,NEFT DR-KKBK0005289-HILL GROOVE CONSULTI NG LLP-SANDOZ - MUM-N219222069115269-NET BANKING SI -156600,,,net_banking_transfer,-156600
632ae6d02e1a0ebb7f46fcc0,50200023535069,12268598.11,60ec41ba55c00300382672d9,HDFC,direct expenses,5eecc6d6449e4f7cfb1c2708,2022-08-07T00:00:00.000Z,NEFT DR-UTIB0000514-NATS ASSOCIATES-SAND OZ - MUM-N219222069115271-NET BANKING SI -216000,,,net_banking_transfer,-216000
632ae6d02e1a0ebb7f46fcc2,50200023535069,12279024.87,60ec41ba55c00300382672d9,HDFC,Revenue-PG-non-split,5eecc6d6449e4f7cfb1c2708,2022-08-07T00:00:00.000Z,NEFT CR-PYTM0123456-PAYTM PAYMENTS SERVI CES LIMITED-SLICK ORGANICS PVT LTD-PYTM2 22190595922,insurance,insurance,net_banking_transfer,10426.76
632ae6d02e1a0ebb7f46fcc4,50200023535069,12079024.87,60ec41ba55c00300382672d9,HDFC,direct expenses,5eecc6d6449e4f7cfb1c2708,2022-08-07T00:00:00.000Z,"NEFT DR-DBSS0IN0811-SARANSH KULKARNI-NET BANK, MUM-N219222069152026-200000",,,net_banking_transfer,-200000
632ae6d02e1a0ebb7f46fcc6,50200023535069,12033864.87,60ec41ba55c00300382672d9,HDFC,direct expenses,5eecc6d6449e4f7cfb1c2708,2022-08-07T00:00:00.000Z,IMPS-221907108078-SARANSH KULKARNI-DBSS- XXXXXXXX2800-45160,,,net_banking_transfer,-45160
632ae6d12e1a0ebb7f46fcc8,50200023535069,11033864.87,60ec41ba55c00300382672d9,HDFC,Tax,5eecc6d6449e4f7cfb1c2708,2022-08-07T00:00:00.000Z,051030807082212678- CBDT TAX,,,Other,-1000000
632ae6d12e1a0ebb7f46fcca,50200023535069,10898864.87,60ec41ba55c00300382672d9,HDFC,direct expenses,5eecc6d6449e4f7cfb1c2708,2022-08-07T00:00:00.000Z,"NEFT DR-ICIC0001130-ARJIT TANEJA-NETBANK , MUM-N219222069195393-135000",,,net_banking_transfer,-135000
632ae6d12e1a0ebb7f46fccd,50200023535069,10871056.87,60ec41ba55c00300382672d9,HDFC,agency/vendor expense,5eecc6d6449e4f7cfb1c2708,2022-08-07T00:00:00.000Z,"NEFT DR-UTIB0003557-INCOSEC LEGAL-NETBAN K, MUM-N219222069152902-27808",,,net_banking_transfer,-27808
632ae6d12e1a0ebb7f46fccf,50200023535069,10886496.86,60ec41ba55c00300382672d9,HDFC,Revenue-Mktplace,5eecc6d6449e4f7cfb1c2708,2022-08-08T00:00:00.000Z,NEFT CR-DEUT0797BGL-FLIPKART INTERNET PR,shopping,,net_banking_transfer,15439.99
632ae6d12e1a0ebb7f46fcd2,50200023535069,10895205.17,60ec41ba55c00300382672d9,HDFC,Revenue-PG-non-split,5eecc6d6449e4f7cfb1c2708,2022-08-08T00:00:00.000Z,NEFT CR-PYTM0123456-PAYTM PAYMENTS SERVI CES LIMITED-SLICK ORGANICS PVT LTD-PYTM2 22201887677,insurance,insurance,net_banking_transfer,8708.31
632ae6d12e1a0ebb7f46fcd4,50200023535069,10902289.59,60ec41ba55c00300382672d9,HDFC,Revenue-Mktplace,5eecc6d6449e4f7cfb1c2708,2022-08-08T00:00:00.000Z,NEFT CR-DEUT0797BGL-MYNTRA DESIGNS PRIVA TE LIMITED-SLICK ORGANICS PVT. LTD.-2220 00510GN00285,shopping,,net_banking_transfer,7084.42
632ae6d12e1a0ebb7f46fcd6,50200023535069,10916853.19,60ec41ba55c00300382672d9,HDFC,Revenue-Mktplace,5eecc6d6449e4f7cfb1c2708,2022-08-08T00:00:00.000Z,NEFT CR-DEUT0797BGL-MYNTRA DESIGNS PRIVA TE LIMITED-SLICK ORGANICS PVT. LTD.-2220 00514GN00086,shopping,,net_banking_transfer,14563.6
632ae6d12e1a0ebb7f46fcd8,50200023535069,10941492.99,60ec41ba55c00300382672d9,HDFC,Revenue-PG-split enabled,5eecc6d6449e4f7cfb1c2708,2022-08-08T00:00:00.000Z,NEFT CR-UTIB0001506-RAZORPAY SOFTWARE PR IVATE LIMITED-SLICK ORGANICS PVT LITD-AX ISCN0159594352,insurance,insurance,net_banking_transfer,24639.8
632ae6d12e1a0ebb7f46fcda,50200023535069,10941490.99,60ec41ba55c00300382672d9,HDFC,Marketing Expense,5eecc6d6449e4f7cfb1c2708,2022-08-08T00:00:00.000Z,ME DC SI 514834XXXXXX9486 LINKEDIN,,,Other,-2
632ae6d12e1a0ebb7f46fcdc,50200023535069,10941488.99,60ec41ba55c00300382672d9,HDFC,Marketing Expense,5eecc6d6449e4f7cfb1c2708,2022-08-08T00:00:00.000Z,ME DC SI 514834XXXXXX9486 LINKEDIN,,,Other,-2
632ae6d12e1a0ebb7f46fcde,50200023535069,10859533.99,60ec41ba55c00300382672d9,HDFC,direct expenses,5eecc6d6449e4f7cfb1c2708,2022-08-08T00:00:00.000Z,"NEFT DR-INDB0000148-ACQUISORY INDIA CONS ULTING PVT LTD-NETBANK, MUM-N22022206984 0593-81955",,,net_banking_transfer,-81955
632ae6d12e1a0ebb7f46fce0,50200023535069,10859112.99,60ec41ba55c00300382672d9,HDFC,direct expenses,5eecc6d6449e4f7cfb1c2708,2022-08-08T00:00:00.000Z,50100108772229-TPT-421-HEMANT GUPTA,,,net_banking_transfer,-421
632ae6d12e1a0ebb7f46fce2,50200023535069,10847112.99,60ec41ba55c00300382672d9,HDFC,direct expenses,5eecc6d6449e4f7cfb1c2708,2022-08-08T00:00:00.000Z,"NEFT DR-ICIC0004109-ASHRAFI ASSOCIATES-N ETBANK, MUM-N220222069877370-12000",,,net_banking_transfer,-12000
632ae6d12e1a0ebb7f46fce4,50200023535069,10850882.84,60ec41ba55c00300382672d9,HDFC,Revenue-PG-non-split,5eecc6d6449e4f7cfb1c2708,2022-08-08T00:00:00.000Z,NEFT CR-SCBL0036001-STRIPE INDIA PRIVATE LIMITED-SLICK ORGANICS PRIVATE LIMITED- IN1ON22080807KLI,,,net_banking_transfer,3769.85
632ae6d12e1a0ebb7f46fce6,50200023535069,10852403.86,60ec41ba55c00300382672d9,HDFC,Revenue-Mktplace,5eecc6d6449e4f7cfb1c2708,2022-08-08T00:00:00.000Z,NEFT CR-ICIC0000105-MANASH LIFESTYLE PRI VATE LIMITED NO-SLICK ORGANICS PRIVATE L IMITED MP G-ICIJ222200000964,shopping,,net_banking_transfer,1521.02
632ae6d12e1a0ebb7f46fce8,50200023535069,10853876.49,60ec41ba55c00300382672d9,HDFC,Revenue-Mktplace,5eecc6d6449e4f7cfb1c2708,2022-08-08T00:00:00.000Z,NEFT CR-ICIC0000105-MANASH LIFESTYLE PRI VATE LIMITED NO-SLICK ORGANICS PRIVATE L IMITED MP M-ICIJ222200000966,shopping,,net_banking_transfer,1472.63
632ae6d12e1a0ebb7f46fcea,50200023535069,10858466.1,60ec41ba55c00300382672d9,HDFC,Transfer in/Revenue-other,5eecc6d6449e4f7cfb1c2708,2022-08-08T00:00:00.000Z,NEFT CR-UTIB0000114-ONE SIGMA TECHNOLOGI,,,net_banking_transfer,4589.61
632ae6d12e1a0ebb7f46fcec,50200023535069,10858221.1,60ec41ba55c00300382672d9,HDFC,direct expenses,5eecc6d6449e4f7cfb1c2708,2022-08-08T00:00:00.000Z,POS 514834XXXXXX9486 SMARTSHIFT LOGIS,,,debit_card,-245
632ae6d12e1a0ebb7f46fcee,50200023535069,10603221.1,60ec41ba55c00300382672d9,HDFC,SAAS/tech expense,5eecc6d6449e4f7cfb1c2708,2022-08-08T00:00:00.000Z,POS 514834XXXXXX9486 AMAZON,shopping,,debit_card,-255000
632ae6d12e1a0ebb7f46fcf0,50200023535069,10602204.1,60ec41ba55c00300382672d9,HDFC,direct expenses,5eecc6d6449e4f7cfb1c2708,2022-08-08T00:00:00.000Z,POS 514834XXXXXX9486 SMARTSHIFT LOGIS,,,debit_card,-1017
632ae6d12e1a0ebb7f46fcf3,50200023535069,10632543.5,60ec41ba55c00300382672d9,HDFC,Revenue-PG-non-split,5eecc6d6449e4f7cfb1c2708,2022-08-08T00:00:00.000Z,NEFT CR-KKBK0000958-NODAL ACCOUNT BROKEN TUSK TECHNOL-SLICK ORGANICS PRIVATE LIMI TED-CMS2202221980303,insurance,insurance,net_banking_transfer,30339.4
632ae6d12e1a0ebb7f46fcf5,50200023535069,10667159.49,60ec41ba55c00300382672d9,HDFC,Revenue-PG-non-split,5eecc6d6449e4f7cfb1c2708,2022-08-08T00:00:00.000Z,NEFT CR-KKBK0000958-NODAL ACCOUNT BROKEN TUSK TECHNOL-SLICK ORGANICS PRIVATE LIMI TED-CMS2202221988073,insurance,insurance,net_banking_transfer,34615.99
632ae6d12e1a0ebb7f46fcf7,50200023535069,10674028.52,60ec41ba55c00300382672d9,HDFC,Revenue-PG-split enabled,5eecc6d6449e4f7cfb1c2708,2022-08-08T00:00:00.000Z,NEFT CR-UTIB0001506-RAZORPAY SOFTWARE PR IVATE LIMITED-SLICK ORGANICS PVT LITD-AX ISCN0159743351,insurance,insurance,net_banking_transfer,6869.03
632ae6d12e1a0ebb7f46fcf9,50200023535069,10684855.52,60ec41ba55c00300382672d9,HDFC,Revenue-COD,5eecc6d6449e4f7cfb1c2708,2022-08-08T00:00:00.000Z,PICKRR TECHNOL-AKHILESHDIXIT85GMAIL,,,Other,10827
632ae6d12e1a0ebb7f46fcfb,50200023535069,10676855.52,60ec41ba55c00300382672d9,HDFC,direct expenses,5eecc6d6449e4f7cfb1c2708,2022-08-08T00:00:00.000Z,"NEFT DR-ICIC0002534-DISNY VARGHESE-NETBA NK, MUM-N220222071523259-8000",,,net_banking_transfer,-8000
632ae6d12e1a0ebb7f46fcfe,50200023535069,10676857.52,60ec41ba55c00300382672d9,HDFC,Transfer in/Revenue-other,5eecc6d6449e4f7cfb1c2708,2022-08-08T00:00:00.000Z,CRV POS 514834******9486 LINKEDIN,,,refund,2
632ae6d12e1a0ebb7f46fd00,50200023535069,10743688.44,60ec41ba55c00300382672d9,HDFC,Revenue-COD,5eecc6d6449e4f7cfb1c2708,2022-08-09T00:00:00.000Z,NEFT CR-ICIC0000155-SHIPROCKET COD CRF I D 4718091-SLICK ORGANICS PVT LTD-CMS2759 024892,insurance,insurance,net_banking_transfer,66830.92
632ae6d12e1a0ebb7f46fd02,50200023535069,10748156.02,60ec41ba55c00300382672d9,HDFC,Revenue-PG-non-split,5eecc6d6449e4f7cfb1c2708,2022-08-09T00:00:00.000Z,NEFT CR-PYTM0123456-PAYTM PAYMENTS SERVI CES LIMITED-SLICK ORGANICS PVT LTD-PYTM2 22213265381,insurance,insurance,net_banking_transfer,4467.58
632ae6d12e1a0ebb7f46fd04,50200023535069,10889954.8,60ec41ba55c00300382672d9,HDFC,Revenue-Mktplace,5eecc6d6449e4f7cfb1c2708,2022-08-09T00:00:00.000Z,IMPS-222105122740-AMAZON SELLER SERVIC-H SBC-XXXXXXXX6004-3EIQ71FBXOU7IBV0SLICK O RGANICS PVT LTD,shopping,,net_banking_transfer,141798.78
632ae6d12e1a0ebb7f46fd06,50200023535069,11404558,60ec41ba55c00300382672d9,HDFC,Revenue-Mktplace,5eecc6d6449e4f7cfb1c2708,2022-08-09T00:00:00.000Z,NEFT CR-DEUT0797BGL-AMAZON PAY (INDIA) P RIVATE LIMITED-SLICK ORGANICS PVT LTD-22 2100322GN00541,shopping,,net_banking_transfer,514603.2
632ae6d12e1a0ebb7f46fd08,50200023535069,11054558,60ec41ba55c00300382672d9,HDFC,direct expenses,5eecc6d6449e4f7cfb1c2708,2022-08-09T00:00:00.000Z,NEFT DR-KKBK0000180-VEDIC COSMECEUTICALS,,,net_banking_transfer,-350000
632ae6d12e1a0ebb7f46fd0b,50200023535069,11017553,60ec41ba55c00300382672d9,HDFC,direct expenses,5eecc6d6449e4f7cfb1c2708,2022-08-09T00:00:00.000Z,"NEFT DR-YESB0000236-DELIGHT VACATION PVT LTD-NETBANK, MUM-N221222071819630-37005",,,net_banking_transfer,-37005
632ae6d12e1a0ebb7f46fd0d,50200023535069,10817553,60ec41ba55c00300382672d9,HDFC,direct expenses,5eecc6d6449e4f7cfb1c2708,2022-08-09T00:00:00.000Z,"NEFT DR-ICIC0000369-BO INTERNATIONAL-NET BANK, MUM-N221222071819849-200000",,,net_banking_transfer,-200000
632ae6d12e1a0ebb7f46fd0f,50200023535069,10815242.32,60ec41ba55c00300382672d9,HDFC,direct expenses,5eecc6d6449e4f7cfb1c2708,2022-08-09T00:00:00.000Z,POS 514834XXXXXX9486 SEOPTIMER,,,debit_card,-2310.68
632ae6d12e1a0ebb7f46fd11,50200023535069,10822576.25,60ec41ba55c00300382672d9,HDFC,Transfer in/Revenue-other,5eecc6d6449e4f7cfb1c2708,2022-08-09T00:00:00.000Z,NEFT CR-UTIB0000114-ONE SIGMA TECHNOLOGI ES PRIVATE LIM-SLICK ORGANICS PRIVATE LI MITED-AXISP00310656596,insurance,insurance,net_banking_transfer,7333.93
632ae6d12e1a0ebb7f46fd13,50200023535069,10856812.86,60ec41ba55c00300382672d9,HDFC,Revenue-PG-non-split,5eecc6d6449e4f7cfb1c2708,2022-08-09T00:00:00.000Z,NEFT CR-KKBK0000958-NODAL ACCOUNT BROKEN TUSK TECHNOL-SLICK ORGANICS PRIVATE LIMI TED-CMS2212222135182,insurance,insurance,net_banking_transfer,34236.61
632ae6d12e1a0ebb7f46fd15,50200023535069,10883809.86,60ec41ba55c00300382672d9,HDFC,Transfer in/Revenue-other,5eecc6d6449e4f7cfb1c2708,2022-08-09T00:00:00.000Z,50200050241205-TPT-ARATA-NAPSA PRIVATE L IMITED,,,net_banking_transfer,26997
632ae6d12e1a0ebb7f46fd17,50200023535069,10903873.89,60ec41ba55c00300382672d9,HDFC,Revenue-PG-non-split,5eecc6d6449e4f7cfb1c2708,2022-08-10T00:00:00.000Z,IMPS-222204879283-PAYTM PAYMENTS SERVI-P YTM-XXXXXXXXXX0008-ALL202208102168200003 30830668628,ewallet,,net_banking_transfer,20064.03
632ae6d12e1a0ebb7f46fd19,50200023535069,10853873.89,60ec41ba55c00300382672d9,HDFC,direct expenses,5eecc6d6449e4f7cfb1c2708,2022-08-10T00:00:00.000Z,50200039508087-TPT-50000-SHREE PUNCHMUKH I LOGISTICS,,,net_banking_transfer,-50000
632ae6d12e1a0ebb7f46fd1b,50200023535069,10703873.89,60ec41ba55c00300382672d9,HDFC,direct expenses,5eecc6d6449e4f7cfb1c2708,2022-08-10T00:00:00.000Z,"NEFT DR-SRCB0000281-3D TECHNOPACK PRIVAT E LIMITED-NETBANK, MUM-N222222073036859- 150000",,,net_banking_transfer,-150000
632ae6d12e1a0ebb7f46fd1d,50200023535069,10726358.93,60ec41ba55c00300382672d9,HDFC,Revenue-Mktplace,5eecc6d6449e4f7cfb1c2708,2022-08-10T00:00:00.000Z,NEFT CR-DEUT0797BGL-FLIPKART INTERNET PR IVATE LIMITED-SLICK ORGANICS PVT LTD-222 200442GN00094,shopping,,net_banking_transfer,22485.04
632ae6d12e1a0ebb7f46fd20,50200023535069,10734502.59,60ec41ba55c00300382672d9,HDFC,Revenue-Mktplace,5eecc6d6449e4f7cfb1c2708,2022-08-10T00:00:00.000Z,NEFT CR-DEUT0797BGL-MYNTRA DESIGNS PRIVA TE LIMITED-SLICK ORGANICS PVT. LTD.-2222 00686GN00114,shopping,,net_banking_transfer,8143.66
632ae6d12e1a0ebb7f46fd22,50200023535069,10738946.81,60ec41ba55c00300382672d9,HDFC,Revenue-Mktplace,5eecc6d6449e4f7cfb1c2708,2022-08-10T00:00:00.000Z,NEFT CR-DEUT0797BGL-MYNTRA DESIGNS PRIVA TE LIMITED-SLICK ORGANICS PVT. LTD.-2222 00694GN00017,shopping,,net_banking_transfer,4444.22
632ae6d12e1a0ebb7f46fd24,50200023535069,10629769.81,60ec41ba55c00300382672d9,HDFC,direct expenses,5eecc6d6449e4f7cfb1c2708,2022-08-10T00:00:00.000Z,00921000075586-TPT-109177-ROET BINDRA,,,net_banking_transfer,-109177
632ae6d12e1a0ebb7f46fd26,50200023535069,10532569.81,60ec41ba55c00300382672d9,HDFC,direct expenses,5eecc6d6449e4f7cfb1c2708,2022-08-10T00:00:00.000Z,00321000085687-TPT-97200-SAMEER AHUJA,,,net_banking_transfer,-97200
632ae6d12e1a0ebb7f46fd28,50200023535069,10505670.81,60ec41ba55c00300382672d9,HDFC,direct expenses,5eecc6d6449e4f7cfb1c2708,2022-08-10T00:00:00.000Z,"NEFT DR-SCBL0036025-DHRUV MADHOK-NETBANK , MUM-N222222073104713-26899",,,net_banking_transfer,-26899
632ae6d12e1a0ebb7f46fd2a,50200023535069,10541313.41,60ec41ba55c00300382672d9,HDFC,Revenue-PG-split enabled,5eecc6d6449e4f7cfb1c2708,2022-08-10T00:00:00.000Z,NEFT CR-UTIB0001506-RAZORPAY SOFTWARE PR IVATE LIMITED-SLICK ORGANICS PVT LITD-AX ISCN0159911116,insurance,insurance,net_banking_transfer,35642.6
632ae6d12e1a0ebb7f46fd2c,50200023535069,10533037.41,60ec41ba55c00300382672d9,HDFC,direct expenses,5eecc6d6449e4f7cfb1c2708,2022-08-10T00:00:00.000Z,02022126102507/ESIC,,,Other,-8276
632ae6d12e1a0ebb7f46fd2e,50200023535069,10424412.41,60ec41ba55c00300382672d9,HDFC,Salary/Emp/consultant Expense,5eecc6d6449e4f7cfb1c2708,2022-08-10T00:00:00.000Z,1867974154/EPFO,,,Other,-108625
632ae6d12e1a0ebb7f46fd30,50200023535069,10424167.41,60ec41ba55c00300382672d9,HDFC,direct expenses,5eecc6d6449e4f7cfb1c2708,2022-08-10T00:00:00.000Z,POS 514834XXXXXX9486 SMARTSHIFT LOGIS,,,debit_card,-245
632ae6d12e1a0ebb7f46fd32,50200023535069,10404167.41,60ec41ba55c00300382672d9,HDFC,direct expenses,5eecc6d6449e4f7cfb1c2708,2022-08-10T00:00:00.000Z,10691610000016-TPT-20000-SHIPRA SHARMA,,,net_banking_transfer,-20000
632ae6d12e1a0ebb7f46fd34,50200023535069,10104167.41,60ec41ba55c00300382672d9,HDFC,direct expenses,5eecc6d6449e4f7cfb1c2708,2022-08-10T00:00:00.000Z,05892560000649-TPT-30000-DECORPAC INDIA PRIVATE LIMITED,,,net_banking_transfer,-300000
632ae6d12e1a0ebb7f46fd36,50200023535069,10079167.41,60ec41ba55c00300382672d9,HDFC,direct expenses,5eecc6d6449e4f7cfb1c2708,2022-08-10T00:00:00.000Z,"NEFT DR-SCBL0036042-SEJAL KUMAR-NETBANK, MUM-N222222073684279-25000",,,net_banking_transfer,-25000
632ae6d12e1a0ebb7f46fd38,50200023535069,10081507.66,60ec41ba55c00300382672d9,HDFC,Transfer in/Revenue-other,5eecc6d6449e4f7cfb1c2708,2022-08-10T00:00:00.000Z,NEFT CR-UTIB0000114-ONE SIGMA TECHNOLOGI ES PRIVATE LIM-SLICK ORGANICS PRIVATE LI MITED-AXISP00310910365,insurance,insurance,net_banking_transfer,2340.25
632ae6d12e1a0ebb7f46fd3a,50200023535069,10119721.83,60ec41ba55c00300382672d9,HDFC,Revenue-PG-non-split,5eecc6d6449e4f7cfb1c2708,2022-08-10T00:00:00.000Z,NEFT CR-KKBK0000958-NODAL ACCOUNT BROKEN TUSK TECHNOL-SLICK ORGANICS PRIVATE LIMI TED-CMS2222222316841,insurance,insurance,net_banking_transfer,38214.17
632ae6d12e1a0ebb7f46fd3c,50200023535069,10121066.15,60ec41ba55c00300382672d9,HDFC,Revenue-Mktplace,5eecc6d6449e4f7cfb1c2708,2022-08-10T00:00:00.000Z,NEFT CR-ICIC0000105-MANASH LIFESTYLE PRI VATE LIMITED NO-SLICK ORGANICS PRIVATE L IMITED MP M-ICIJ222220012182,shopping,,net_banking_transfer,1344.32
632ae6d12e1a0ebb7f46fd3e,50200023535069,10121629.83,60ec41ba55c00300382672d9,HDFC,Revenue-Mktplace,5eecc6d6449e4f7cfb1c2708,2022-08-10T00:00:00.000Z,NEFT CR-ICIC0000105-MANASH LIFESTYLE PRI VATE LIMITED NO-SLICK ORGANICS PRIVATE L IMITED MP G-ICIJ222220013875,shopping,,net_banking_transfer,563.68
632ae6d12e1a0ebb7f46fd40,50200023535069,1121629.83,60ec41ba55c00300382672d9,HDFC,direct expenses,5eecc6d6449e4f7cfb1c2708,2022-08-10T00:00:00.000Z,FD BOOKED - 50300663920102 : SLICK ORGAN ICS PVT LTD,insurance,insurance,investment,-9000000
632ae6d12e1a0ebb7f46fd42,50200023535069,1125412.2,60ec41ba55c00300382672d9,HDFC,Revenue-PG-split enabled,5eecc6d6449e4f7cfb1c2708,2022-08-10T00:00:00.000Z,NEFT CR-UTIB0001506-RAZORPAY SOFTWARE PR IVATE LIMITED-SLICK ORGANICS PVT LITD-AX ISCN0160029738,insurance,insurance,net_banking_transfer,3782.37
632ae6d12e1a0ebb7f46fd45,50200023535069,1125002.2,60ec41ba55c00300382672d9,HDFC,direct expenses,5eecc6d6449e4f7cfb1c2708,2022-08-10T00:00:00.000Z,POS 514834XXXXXX9486 SMARTSHIFT LOGIS,,,debit_card,-410
632ae6d12e1a0ebb7f46fd47,50200023535069,1197820.91,60ec41ba55c00300382672d9,HDFC,Revenue-COD,5eecc6d6449e4f7cfb1c2708,2022-08-10T00:00:00.000Z,NEFT CR-ICIC0000155-SHIPROCKET COD CRF I D 4730414-SLICK ORGANICS PVT LTD-CMS2763 005062,insurance,insurance,net_banking_transfer,72818.71
632ae6d12e1a0ebb7f46fd49,50200023535069,1201103.44,60ec41ba55c00300382672d9,HDFC,Revenue-PG-non-split,5eecc6d6449e4f7cfb1c2708,2022-08-11T00:00:00.000Z,NEFT CR-PYTM0123456-PAYTM PAYMENTS SERVI CES LIMITED-SLICK ORGANICS PVT LTD-PYTM2 22236212111,insurance,insurance,net_banking_transfer,3282.53
632ae6d12e1a0ebb7f46fd4b,50200023535069,1209101.27,60ec41ba55c00300382672d9,HDFC,Revenue-PG-split enabled,5eecc6d6449e4f7cfb1c2708,2022-08-11T00:00:00.000Z,NEFT CR-UTIB0001506-RAZORPAY SOFTWARE PR IVATE LIMITED-SLICK ORGANICS PVT LITD-AX ISCN0160103968,insurance,insurance,net_banking_transfer,7997.83
632ae6d12e1a0ebb7f46fd4d,50200023535069,1208942.66,60ec41ba55c00300382672d9,HDFC,bank charges,5eecc6d6449e4f7cfb1c2708,2022-08-11T00:00:00.000Z,.DC INTL POS TXN MARKUP+ST 250622 260622 -CDT2221510458023,,,international_transaction_arbitrage,-158.61
632ae6d12e1a0ebb7f46fd4f,50200023535069,1220455.97,60ec41ba55c00300382672d9,HDFC,Transfer in/Revenue-other,5eecc6d6449e4f7cfb1c2708,2022-08-11T00:00:00.000Z,NEFT CR-UTIB0000114-ONE SIGMA TECHNOLOGI ES PRIVATE LIM-SLICK ORGANICS PRIVATE LI MITED-AXISP00311361811,insurance,insurance,net_banking_transfer,11513.31
632ae6d12e1a0ebb7f46fd51,50200023535069,1221253.48,60ec41ba55c00300382672d9,HDFC,Revenue-Mktplace,5eecc6d6449e4f7cfb1c2708,2022-08-11T00:00:00.000Z,NEFT CR-ICIC0000105-MANASH LIFESTYLE PRI VATE LIMITED NO-SLICK ORGANICS PRIVATE L IMITED MP G-ICIJ222230004023,shopping,,net_banking_transfer,797.51
632ae6d12e1a0ebb7f46fd53,50200023535069,1222005.54,60ec41ba55c00300382672d9,HDFC,Revenue-Mktplace,5eecc6d6449e4f7cfb1c2708,2022-08-11T00:00:00.000Z,NEFT CR-ICIC0000105-MANASH LIFESTYLE PRI VATE LIMITED NO-SLICK ORGANICS PRIVATE L IMITED MP M-ICIJ222230004025,shopping,,net_banking_transfer,752.06
632ae6d12e1a0ebb7f46fd55,50200023535069,967005.54,60ec41ba55c00300382672d9,HDFC,SAAS/tech expense,5eecc6d6449e4f7cfb1c2708,2022-08-11T00:00:00.000Z,POS 514834XXXXXX9486 AMAZON,shopping,,debit_card,-255000
632ae6d12e1a0ebb7f46fd57,50200023535069,991876.52,60ec41ba55c00300382672d9,HDFC,Revenue-PG-non-split,5eecc6d6449e4f7cfb1c2708,2022-08-11T00:00:00.000Z,NEFT CR-KKBK0000958-NODAL ACCOUNT BROKEN TUSK TECHNOL-SLICK ORGANICS PRIVATE LIMI TED-CMS2232222693864,insurance,insurance,net_banking_transfer,24870.98
632ae6d12e1a0ebb7f46fd59,50200023535069,998266.2,60ec41ba55c00300382672d9,HDFC,Revenue-PG-split enabled,5eecc6d6449e4f7cfb1c2708,2022-08-11T00:00:00.000Z,NEFT CR-UTIB0001506-RAZORPAY SOFTWARE PR IVATE LIMITED-SLICK ORGANICS PVT LITD-AX ISCN0160203575,insurance,insurance,net_banking_transfer,6389.68
632ae6d12e1a0ebb7f46fd5b,50200023535069,1024066.43,60ec41ba55c00300382672d9,HDFC,Revenue-Mktplace,5eecc6d6449e4f7cfb1c2708,2022-08-12T00:00:00.000Z,NEFT CR-DEUT0797BGL-FLIPKART INTERNET PR IVATE LIMITED-SLICK ORGANICS PVT LTD-222 400153GN00188,shopping,,net_banking_transfer,25800.23
632ae6d12e1a0ebb7f46fd5d,50200023535069,1031480.57,60ec41ba55c00300382672d9,HDFC,Revenue-PG-non-split,5eecc6d6449e4f7cfb1c2708,2022-08-12T00:00:00.000Z,NEFT CR-PYTM0123456-PAYTM PAYMENTS SERVI,ewallet,,net_banking_transfer,7414.14
632ae6d12e1a0ebb7f46fd5f,50200023535069,831480.57,60ec41ba55c00300382672d9,HDFC,direct expenses,5eecc6d6449e4f7cfb1c2708,2022-08-12T00:00:00.000Z,05892560000649-TPT-200000-DECORPAC INDIA PRIVATE LIMITED,,,net_banking_transfer,-200000
632ae6d22e1a0ebb7f46fd61,50200023535069,631480.57,60ec41ba55c00300382672d9,HDFC,direct expenses,5eecc6d6449e4f7cfb1c2708,2022-08-12T00:00:00.000Z,"NEFT DR-SCBL0036031-PR PUNDIT PUBLIC REL ATIONS PRIVATE LIMIT-NETBANK, MUM-N22422 2076633163-200000",insurance,insurance,net_banking_transfer,-200000
632ae6d22e1a0ebb7f46fd63,50200023535069,636465.43,60ec41ba55c00300382672d9,HDFC,Revenue-Mktplace,5eecc6d6449e4f7cfb1c2708,2022-08-12T00:00:00.000Z,NEFT CR-DEUT0797BGL-MYNTRA DESIGNS PRIVA TE LIMITED-SLICK ORGANICS PVT. LTD.-2224 00782GN00277,shopping,,net_banking_transfer,4984.86
632ae6d22e1a0ebb7f46fd65,50200023535069,436465.43,60ec41ba55c00300382672d9,HDFC,direct expenses,5eecc6d6449e4f7cfb1c2708,2022-08-12T00:00:00.000Z,"NEFT DR-YESB0000551-VISTTA COSMETICS-NET BANK, MUM-N224222076672394-200000",,,net_banking_transfer,-200000
632ae6d22e1a0ebb7f46fd67,50200023535069,444489.32,60ec41ba55c00300382672d9,HDFC,Revenue-Mktplace,5eecc6d6449e4f7cfb1c2708,2022-08-12T00:00:00.000Z,NEFT CR-DEUT0797BGL-MYNTRA DESIGNS PRIVA TE LIMITED-SLICK ORGANICS PVT. LTD.-2224 00793GN00099,shopping,,net_banking_transfer,8023.89
632ae6d22e1a0ebb7f46fd69,50200023535069,453773.71,60ec41ba55c00300382672d9,HDFC,Revenue-PG-split enabled,5eecc6d6449e4f7cfb1c2708,2022-08-12T00:00:00.000Z,NEFT CR-UTIB0001506-RAZORPAY SOFTWARE PR IVATE LIMITED-SLICK ORGANICS PVT LITD-AX ISCN0160279697,insurance,insurance,net_banking_transfer,9284.39
632ae6d22e1a0ebb7f46fd6b,50200023535069,454165.64,60ec41ba55c00300382672d9,HDFC,Revenue-PG-split enabled,5eecc6d6449e4f7cfb1c2708,2022-08-12T00:00:00.000Z,NEFT CR-YESB0000001-CASHFREE PAYMENTS IN DIA PRIVATE LIM-SLICK ORGANICS PRIVATE L IMITED-YESB22242080157,,,net_banking_transfer,391.93
632ae6d22e1a0ebb7f46fd6d,50200023535069,395665.64,60ec41ba55c00300382672d9,HDFC,direct expenses,5eecc6d6449e4f7cfb1c2708,2022-08-12T00:00:00.000Z,50100433068791-TPT-58500-NATHIYA KUBENDI RAN,,,net_banking_transfer,-58500
632ae6d22e1a0ebb7f46fd6f,50200023535069,358065.64,60ec41ba55c00300382672d9,HDFC,direct expenses,5eecc6d6449e4f7cfb1c2708,2022-08-12T00:00:00.000Z,"NEFT DR-KKBK0001393-MASCOT SPINCONTROL I NDIA PVT LTD-NETBANK, MUM-N2242220770643 01-37600",,,net_banking_transfer,-37600
632ae6d22e1a0ebb7f46fd71,50200023535069,336465.64,60ec41ba55c00300382672d9,HDFC,direct expenses,5eecc6d6449e4f7cfb1c2708,2022-08-12T00:00:00.000Z,50200002902503-TPT-21600-MAISON TALENTS PRODUCTION,,,net_banking_transfer,-21600
632ae6d22e1a0ebb7f46fd73,50200023535069,309465.64,60ec41ba55c00300382672d9,HDFC,direct expenses,5eecc6d6449e4f7cfb1c2708,2022-08-12T00:00:00.000Z,"NEFT DR-KKBK0000654-NIHARIKA MISHRA-NETB ANK, MUM-N224222077095540-27000",,,net_banking_transfer,-27000
632ae6d22e1a0ebb7f46fd75,50200023535069,309904.7,60ec41ba55c00300382672d9,HDFC,Revenue-Mktplace,5eecc6d6449e4f7cfb1c2708,2022-08-12T00:00:00.000Z,NEFT CR-ICIC0000105-MANASH LIFESTYLE PRI,shopping,,net_banking_transfer,439.06
632ae6d22e1a0ebb7f46fd77,50200023535069,311099.47,60ec41ba55c00300382672d9,HDFC,Revenue-Mktplace,5eecc6d6449e4f7cfb1c2708,2022-08-12T00:00:00.000Z,NEFT CR-ICIC0000105-MANASH LIFESTYLE PRI VATE LIMITED NO-SLICK ORGANICS PRIVATE L IMITED MP M-ICIJ222240002781,shopping,,net_banking_transfer,1194.77
632ae6d22e1a0ebb7f46fd79,50200023535069,316412.47,60ec41ba55c00300382672d9,HDFC,Transfer in/Revenue-other,5eecc6d6449e4f7cfb1c2708,2022-08-12T00:00:00.000Z,NEFT CR-UTIB0000114-ONE SIGMA TECHNOLOGI ES PRIVATE LIM-SLICK ORGANICS PRIVATE LI MITED-AXISP00311625636,insurance,insurance,net_banking_transfer,5313
632ae6d22e1a0ebb7f46fd7b,50200023535069,329386.47,60ec41ba55c00300382672d9,HDFC,Revenue-Mktplace,5eecc6d6449e4f7cfb1c2708,2022-08-12T00:00:00.000Z,NEFT CR-ICIC0000985-DIGITAL AGE RETAIL P VT LTD-SLICK ORGANICS PVT LTD DS-CMS27 65946481,,,net_banking_transfer,12974
632ae6d22e1a0ebb7f46fd7d,50200023535069,288921.47,60ec41ba55c00300382672d9,HDFC,direct expenses,5eecc6d6449e4f7cfb1c2708,2022-08-12T00:00:00.000Z,50200014263098-TPT-40465-EMIZA SUPPLY CH AIN SERVICES PVT LTD,,,net_banking_transfer,-40465
632ae6d22e1a0ebb7f46fd7f,50200023535069,254921.47,60ec41ba55c00300382672d9,HDFC,direct expenses,5eecc6d6449e4f7cfb1c2708,2022-08-12T00:00:00.000Z,50100362612187-TPT-34000-BHUPESH JAKHAR,,,net_banking_transfer,-34000
632ae6d22e1a0ebb7f46fd81,50200023535069,257468.76,60ec41ba55c00300382672d9,HDFC,Revenue-PG-split enabled,5eecc6d6449e4f7cfb1c2708,2022-08-12T00:00:00.000Z,NEFT CR-UTIB0001506-RAZORPAY SOFTWARE PR IVATE LIMITED-SLICK ORGANICS PVT LITD-AX ISCN0160401465,insurance,insurance,net_banking_transfer,2547.29
632ae6d22e1a0ebb7f46fd83,50200023535069,253564.57,60ec41ba55c00300382672d9,HDFC,direct expenses,5eecc6d6449e4f7cfb1c2708,2022-08-12T00:00:00.000Z,POS 514834XXXXXX9486 WWW.FAQPRIME.COM,,,debit_card,-3904.19
632ae6d22e1a0ebb7f46fd85,50200023535069,-46435.43,60ec41ba55c00300382672d9,HDFC,direct expenses,5eecc6d6449e4f7cfb1c2708,2022-08-12T00:00:00.000Z,"NEFT DR-ICIC0000369-BO INTERNATIONAL-NET BANK, MUM-N224222077981903-300000",,,net_banking_transfer,-300000
632ae6d22e1a0ebb7f46fd87,50200023535069,-8955.95,60ec41ba55c00300382672d9,HDFC,Revenue-PG-non-split,5eecc6d6449e4f7cfb1c2708,2022-08-12T00:00:00.000Z,NEFT CR-KKBK0000958-NODAL ACCOUNT BROKEN TUSK TECHNOL-SLICK ORGANICS PRIVATE LIMI TED-CMS2242222815149,insurance,insurance,net_banking_transfer,37479.48
632ae6d22e1a0ebb7f46fd8a,50200023535069,0.05,60ec41ba55c00300382672d9,HDFC,Loan-in,5eecc6d6449e4f7cfb1c2708,2022-08-13T00:00:00.000Z,SWEEP-IN CREDIT - 50300663920102,,,self_transfer,8956
632ae6d22e1a0ebb7f46fd8c,50200023535069,14791.16,60ec41ba55c00300382672d9,HDFC,Revenue-PG-non-split,5eecc6d6449e4f7cfb1c2708,2022-08-13T00:00:00.000Z,NEFT CR-PYTM0123456-PAYTM PAYMENTS SERVI CES LIMITED-SLICK ORGANICS PVT LTD-PYTM2 22259243158,insurance,insurance,net_banking_transfer,14791.11
632ae6d22e1a0ebb7f46fd8e,50200023535069,14793.16,60ec41ba55c00300382672d9,HDFC,Transfer in/Revenue-other,5eecc6d6449e4f7cfb1c2708,2022-08-13T00:00:00.000Z,CRV POS 514834******9486 LINKEDIN,,,refund,2
632ae6d22e1a0ebb7f46fd90,50200023535069,14795.16,60ec41ba55c00300382672d9,HDFC,Transfer in/Revenue-other,5eecc6d6449e4f7cfb1c2708,2022-08-13T00:00:00.000Z,CRV POS 514834******9486 LINKEDIN,,,refund,2
632ae6d22e1a0ebb7f46fd92,50200023535069,29366.74,60ec41ba55c00300382672d9,HDFC,Revenue-PG-non-split,5eecc6d6449e4f7cfb1c2708,2022-08-14T00:00:00.000Z,NEFT CR-PYTM0123456-PAYTM PAYMENTS SERVI CES LIMITED-SLICK ORGANICS PVT LTD-PYTM2 22260865955,insurance,insurance,net_banking_transfer,14571.58
632ae6d22e1a0ebb7f46fd94,50200023535069,29012.75,60ec41ba55c00300382672d9,HDFC,Marketing Expense,5eecc6d6449e4f7cfb1c2708,2022-08-14T00:00:00.000Z,ME DC SI 514834XXXXXX9486 LINKEDIN (PGSI,,,Other,-353.99
632ae6d22e1a0ebb7f46fd96,50200023535069,66278.72,60ec41ba55c00300382672d9,HDFC,Revenue-PG-non-split,5eecc6d6449e4f7cfb1c2708,2022-08-15T00:00:00.000Z,NEFT CR-PYTM0123456-PAYTM PAYMENTS SERVI CES LIMITED-SLICK ORGANICS PVT LTD-PYTM2 22272184349,insurance,insurance,net_banking_transfer,37265.97
632ae6d22e1a0ebb7f46fd98,50200023535069,356075.54,60ec41ba55c00300382672d9,HDFC,Revenue-Mktplace,5eecc6d6449e4f7cfb1c2708,2022-08-16T00:00:00.000Z,IMPS-222805012943-AMAZON SELLER SERVIC-H SBC-XXXXXXXX6004-5TWV38FHCDI4RQ14SLICK O RGANICS PVT LTD,shopping,,net_banking_transfer,289796.82
632ae6d22e1a0ebb7f46fd9a,50200023535069,943786.17,60ec41ba55c00300382672d9,HDFC,Revenue-Mktplace,5eecc6d6449e4f7cfb1c2708,2022-08-16T00:00:00.000Z,NEFT CR-DEUT0797BGL-AMAZON PAY (INDIA) P RIVATE LIMITED-SLICK ORGANICS PVT LTD-22 2800168GN00175,shopping,,net_banking_transfer,587710.63
632ae6d22e1a0ebb7f46fd9c,50200023535069,990152.01,60ec41ba55c00300382672d9,HDFC,Revenue-PG-non-split,5eecc6d6449e4f7cfb1c2708,2022-08-16T00:00:00.000Z,NEFT CR-PYTM0123456-PAYTM PAYMENTS SERVI CES LIMITED-SLICK ORGANICS PVT LTD-PYTM2 22283600351,insurance,insurance,net_banking_transfer,46365.84
632ae6d22e1a0ebb7f46fd9e,50200023535069,995819.53,60ec41ba55c00300382672d9,HDFC,Revenue-Mktplace,5eecc6d6449e4f7cfb1c2708,2022-08-16T00:00:00.000Z,NEFT CR-DEUT0797BGL-MYNTRA DESIGNS PRIVA TE LIMITED-SLICK ORGANICS PVT. LTD.-2228 00481GN00192,shopping,,net_banking_transfer,5667.52
632ae6d22e1a0ebb7f46fda0,50200023535069,1013127.94,60ec41ba55c00300382672d9,HDFC,Revenue-Mktplace,5eecc6d6449e4f7cfb1c2708,2022-08-16T00:00:00.000Z,NEFT CR-DEUT0797BGL-MYNTRA DESIGNS PRIVA TE LIMITED-SLICK ORGANICS PVT. LTD.-2228 00482GN00289,shopping,,net_banking_transfer,17308.41
632ae6d22e1a0ebb7f46fda2,50200023535069,939097.94,60ec41ba55c00300382672d9,HDFC,direct expenses,5eecc6d6449e4f7cfb1c2708,2022-08-16T00:00:00.000Z,50200025384647-TPT-74030-AG POLY PACKS P VT LTD,,,net_banking_transfer,-74030
632ae6d22e1a0ebb7f46fda4,50200023535069,239097.94,60ec41ba55c00300382672d9,HDFC,direct expenses,5eecc6d6449e4f7cfb1c2708,2022-08-16T00:00:00.000Z,"NEFT DR-ICIC0000369-BO INTERNATIONAL-NET BANK, MUM-N228222079614535-700000",,,net_banking_transfer,-700000
632ae6d22e1a0ebb7f46fda6,50200023535069,239746.32,60ec41ba55c00300382672d9,HDFC,Transfer in/Revenue-other,5eecc6d6449e4f7cfb1c2708,2022-08-16T00:00:00.000Z,NEFT CR-UTIB0000114-ONE SIGMA TECHNOLOGI ES PRIVATE LIM-SLICK ORGANICS PRIVATE LI MITED-AXISP00311994570,insurance,insurance,net_banking_transfer,648.38
632ae6d22e1a0ebb7f46fda9,50200023535069,243416.49,60ec41ba55c00300382672d9,HDFC,Transfer in/Revenue-other,5eecc6d6449e4f7cfb1c2708,2022-08-16T00:00:00.000Z,NEFT CR-UTIB0000114-ONE SIGMA TECHNOLOGI ES PRIVATE LIM-SLICK ORGANICS PRIVATE LI MITED-AXISP00311994949,insurance,insurance,net_banking_transfer,3670.17
632ae6d22e1a0ebb7f46fdab,50200023535069,218416.49,60ec41ba55c00300382672d9,HDFC,direct expenses,5eecc6d6449e4f7cfb1c2708,2022-08-16T00:00:00.000Z,1872736290/TECHFLIPKARTPAYMENTS,shopping,,Other,-25000
632ae6d22e1a0ebb7f46fdae,50200023535069,206617.67,60ec41ba55c00300382672d9,HDFC,SAAS/tech expense,5eecc6d6449e4f7cfb1c2708,2022-08-16T00:00:00.000Z,POS 514834XXXXXX9486 RAZ*EXOTEL TECHC,,,debit_card,-11798.82
632ae6d22e1a0ebb7f46fdb0,50200023535069,206532.67,60ec41ba55c00300382672d9,HDFC,direct expenses,5eecc6d6449e4f7cfb1c2708,2022-08-16T00:00:00.000Z,POS 514834XXXXXX9486 SMARTSHIFT LOGIS,,,debit_card,-85
632ae6d22e1a0ebb7f46fdb2,50200023535069,106532.67,60ec41ba55c00300382672d9,HDFC,direct expenses,5eecc6d6449e4f7cfb1c2708,2022-08-16T00:00:00.000Z,09291610057185-TPT-100000-MANISH KUMAR,,,net_banking_transfer,-100000
632ae6d22e1a0ebb7f46fdb4,50200023535069,53482.67,60ec41ba55c00300382672d9,HDFC,direct expenses,5eecc6d6449e4f7cfb1c2708,2022-08-16T00:00:00.000Z,"NEFT DR-ICIC0000021-AKHILESH DIXIT-NETBA NK, MUM-N228222079836882-53050",,,net_banking_transfer,-53050
632ae6d22e1a0ebb7f46fdb7,50200023535069,34039.67,60ec41ba55c00300382672d9,HDFC,direct expenses,5eecc6d6449e4f7cfb1c2708,2022-08-16T00:00:00.000Z,"NEFT DR-SBIN0008078-PANDIT PLASTICS-NETB ANK, MUM-N228222079842861-19443",,,net_banking_transfer,-19443
632ae6d22e1a0ebb7f46fdbb,50200023535069,33769.67,60ec41ba55c00300382672d9,HDFC,direct expenses,5eecc6d6449e4f7cfb1c2708,2022-08-16T00:00:00.000Z,POS 514834XXXXXX9486 SMARTSHIFT LOGIS,,,debit_card,-270
632ae6d22e1a0ebb7f46fdbd,50200023535069,129866.08,60ec41ba55c00300382672d9,HDFC,Revenue-PG-non-split,5eecc6d6449e4f7cfb1c2708,2022-08-16T00:00:00.000Z,NEFT CR-KKBK0000958-NODAL ACCOUNT BROKEN TUSK TECHNOL-SLICK ORGANICS PRIVATE LIMI TED-CMS2282222893884,insurance,insurance,net_banking_transfer,96096.41
632ae6d22e1a0ebb7f46fdbf,50200023535069,302772.52,60ec41ba55c00300382672d9,HDFC,Revenue-PG-non-split,5eecc6d6449e4f7cfb1c2708,2022-08-16T00:00:00.000Z,NEFT CR-KKBK0000958-NODAL ACCOUNT BROKEN TUSK TECHNOL-SLICK ORGANICS PRIVATE LIMI TED-CMS2282222893801,insurance,insurance,net_banking_transfer,172906.44
632ae6d22e1a0ebb7f46fdc1,50200023535069,338823.98,60ec41ba55c00300382672d9,HDFC,Revenue-PG-non-split,5eecc6d6449e4f7cfb1c2708,2022-08-16T00:00:00.000Z,NEFT CR-KKBK0000958-NODAL ACCOUNT BROKEN TUSK TECHNOL-SLICK ORGANICS PRIVATE LIMI TED-CMS2282222894103,insurance,insurance,net_banking_transfer,36051.46
632ae6d22e1a0ebb7f46fdc3,50200023535069,372970.44,60ec41ba55c00300382672d9,HDFC,Revenue-PG-non-split,5eecc6d6449e4f7cfb1c2708,2022-08-16T00:00:00.000Z,NEFT CR-KKBK0000958-NODAL ACCOUNT BROKEN TUSK TECHNOL-SLICK ORGANICS PRIVATE LIMI TED-CMS2282222887779,insurance,insurance,net_banking_transfer,34146.46
632ae6d22e1a0ebb7f46fdc5,50200023535069,377120.44,60ec41ba55c00300382672d9,HDFC,Revenue-Mktplace,5eecc6d6449e4f7cfb1c2708,2022-08-16T00:00:00.000Z,NEFT CR-SCBL0036001-DREAMPLUG TECHNOLOGI ES PRIVATE LIMITED-SLICK ORGANICS PRIVAT E LIMITEDSLICK-IN1ON22081602KCU,,,net_banking_transfer,4150
632ae6d22e1a0ebb7f46fdcc,50200023535069,379037.24,60ec41ba55c00300382672d9,HDFC,Revenue-Mktplace,5eecc6d6449e4f7cfb1c2708,2022-08-16T00:00:00.000Z,NEFT CR-ICIC0000105-MANASH LIFESTYLE PRI VATE LIMITED NO-SLICK ORGANICS PRIVATE L IMITED MP M-ICIJ222280001595,shopping,,net_banking_transfer,1916.8
632ae6d22e1a0ebb7f46fdce,50200023535069,380556.75,60ec41ba55c00300382672d9,HDFC,Revenue-Mktplace,5eecc6d6449e4f7cfb1c2708,2022-08-16T00:00:00.000Z,NEFT CR-ICIC0000105-MANASH LIFESTYLE PRI VATE LIMITED NO-SLICK ORGANICS PRIVATE L IMITED MP G-ICIJ222280003723,shopping,,net_banking_transfer,1519.51
632ae6d22e1a0ebb7f46fdd0,50200023535069,438256.45,60ec41ba55c00300382672d9,HDFC,Revenue-COD,5eecc6d6449e4f7cfb1c2708,2022-08-16T00:00:00.000Z,NEFT CR-ICIC0000155-SHIPROCKET COD CRF I D 4750911-SLICK ORGANICS PVT LTD-CMS2771 151257,insurance,insurance,net_banking_transfer,57699.7
632ae6d22e1a0ebb7f46fdd2,50200023535069,238256.45,60ec41ba55c00300382672d9,HDFC,direct expenses,5eecc6d6449e4f7cfb1c2708,2022-08-16T00:00:00.000Z,NEFT DR-ICIC0000024-TAKE MOTO YOHKI INDI,travel,,net_banking_transfer,-200000
632ae6d22e1a0ebb7f46fdd4,50200023535069,249555.83,60ec41ba55c00300382672d9,HDFC,Revenue-Mktplace,5eecc6d6449e4f7cfb1c2708,2022-08-17T00:00:00.000Z,NEFT CR-DEUT0797BGL-FLIPKART INTERNET PR IVATE LIMITED-SLICK ORGANICS PVT LTD-222 900151GN00136,shopping,,net_banking_transfer,11299.38
632ae6d22e1a0ebb7f46fdd6,50200023535069,270013.86,60ec41ba55c00300382672d9,HDFC,Revenue-PG-non-split,5eecc6d6449e4f7cfb1c2708,2022-08-17T00:00:00.000Z,IMPS-222904201760-PAYTM PAYMENTS SERVI-P YTM-XXXXXXXXXX0008-ALL202208172168200003 30830668628,ewallet,,net_banking_transfer,20458.03
632ae6d22e1a0ebb7f46fdd8,50200023535069,270535.39,60ec41ba55c00300382672d9,HDFC,Revenue-Mktplace,5eecc6d6449e4f7cfb1c2708,2022-08-17T00:00:00.000Z,NEFT CR-DEUT0797BGL-MYNTRA DESIGNS PRIVA TE LIMITED-SLICK ORGANICS PVT. LTD.-2229 00463GN00227,shopping,,net_banking_transfer,521.53
632ae6d22e1a0ebb7f46fdda,50200023535069,278314.62,60ec41ba55c00300382672d9,HDFC,Revenue-Mktplace,5eecc6d6449e4f7cfb1c2708,2022-08-17T00:00:00.000Z,NEFT CR-DEUT0797BGL-MYNTRA DESIGNS PRIVA TE LIMITED-SLICK ORGANICS PVT. LTD.-2229 00464GN00037,shopping,,net_banking_transfer,7779.23
632ae6d22e1a0ebb7f46fddd,50200023535069,437325.89,60ec41ba55c00300382672d9,HDFC,Revenue-PG-split enabled,5eecc6d6449e4f7cfb1c2708,2022-08-17T00:00:00.000Z,NEFT CR-UTIB0001506-RAZORPAY SOFTWARE PR IVATE LIMITED-SLICK ORGANICS PVT LITD-AX ISCN0160735775,insurance,insurance,net_banking_transfer,159011.27
632ae6d22e1a0ebb7f46fddf,50200023535069,237325.89,60ec41ba55c00300382672d9,HDFC,direct expenses,5eecc6d6449e4f7cfb1c2708,2022-08-17T00:00:00.000Z,"NEFT DR-YESB0000551-VISTTA COSMETICS-NET BANK, MUM-N229222080933673-200000",,,net_banking_transfer,-200000
632ae6d22e1a0ebb7f46fde1,50200023535069,225325.89,60ec41ba55c00300382672d9,HDFC,direct expenses,5eecc6d6449e4f7cfb1c2708,2022-08-17T00:00:00.000Z,"NEFT DR-YESB0000236-DELIGHT VACATION PVT LTD-NETBANK, MUM-N229222080957525-12000",,,net_banking_transfer,-12000
632ae6d22e1a0ebb7f46fde3,50200023535069,25325.89,60ec41ba55c00300382672d9,HDFC,direct expenses,5eecc6d6449e4f7cfb1c2708,2022-08-17T00:00:00.000Z,"NEFT DR-KKBK0000180-VEDIC COSMECEUTICALS PVT LTD-NETBANK, MUM-N229222080958028-2 00000",,,net_banking_transfer,-200000
632ae6d22e1a0ebb7f46fde5,50200023535069,81379.25,60ec41ba55c00300382672d9,HDFC,Revenue-Mktplace,5eecc6d6449e4f7cfb1c2708,2022-08-17T00:00:00.000Z,NEFT CR-HSBC0400002-AMAZON SERVICES LLC- SLICK ORGANICS PRIVATE LIMITED-HSBCN2222 9686110,shopping,,net_banking_transfer,56053.36
632ae6d22e1a0ebb7f46fde7,50200023535069,31379.25,60ec41ba55c00300382672d9,HDFC,direct expenses,5eecc6d6449e4f7cfb1c2708,2022-08-17T00:00:00.000Z,POS 514834XXXXXX9486 E-COMMERCE RP,,,debit_card,-50000
632ae6d22e1a0ebb7f46fde9,50200023535069,9449.25,60ec41ba55c00300382672d9,HDFC,direct expenses,5eecc6d6449e4f7cfb1c2708,2022-08-17T00:00:00.000Z,"NEFT DR-KKBK0000173-NITISH KUMAR MANDAL- NETBANK, MUM-N229222081206895-21930",,,net_banking_transfer,-21930
632ae6d22e1a0ebb7f46fdeb,50200023535069,14676.37,60ec41ba55c00300382672d9,HDFC,Transfer in/Revenue-other,5eecc6d6449e4f7cfb1c2708,2022-08-17T00:00:00.000Z,NEFT CR-UTIB0000114-ONE SIGMA TECHNOLOGI ES PRIVATE LIM-SLICK ORGANICS PRIVATE LI MITED-AXISP00312278405,insurance,insurance,net_banking_transfer,5227.12
632ae6d22e1a0ebb7f46fded,50200023535069,11676.37,60ec41ba55c00300382672d9,HDFC,direct expenses,5eecc6d6449e4f7cfb1c2708,2022-08-17T00:00:00.000Z,50200070655402-TPT-3000-RIGHT VISION SEC,,,net_banking_transfer,-3000
632ae6d22e1a0ebb7f46fdef,50200023535069,16271.06,60ec41ba55c00300382672d9,HDFC,Revenue-PG-split enabled,5eecc6d6449e4f7cfb1c2708,2022-08-17T00:00:00.000Z,NEFT CR-UTIB0001506-RAZORPAY SOFTWARE PR IVATE LIMITED-SLICK ORGANICS PVT LITD-AX ISCN0160837604,insurance,insurance,net_banking_transfer,4594.69
632ae6d22e1a0ebb7f46fdf1,50200023535069,19764.59,60ec41ba55c00300382672d9,HDFC,Revenue-Mktplace,5eecc6d6449e4f7cfb1c2708,2022-08-17T00:00:00.000Z,NEFT CR-ICIC0000105-MANASH LIFESTYLE PRI VATE LIMITED NO-SLICK ORGANICS PRIVATE L IMITED MP G-ICIJ222290006170,shopping,,net_banking_transfer,3493.53
632ae6d22e1a0ebb7f46fdf3,50200023535069,19762.59,60ec41ba55c00300382672d9,HDFC,Marketing Expense,5eecc6d6449e4f7cfb1c2708,2022-08-17T00:00:00.000Z,ME DC SI 514834XXXXXX9486 LINKEDIN,,,Other,-2
632ae6d22e1a0ebb7f46fdf5,50200023535069,60027.85,60ec41ba55c00300382672d9,HDFC,Revenue-PG-non-split,5eecc6d6449e4f7cfb1c2708,2022-08-17T00:00:00.000Z,NEFT CR-KKBK0000958-NODAL ACCOUNT BROKEN TUSK TECHNOL-SLICK ORGANICS PRIVATE LIMI TED-CMS2292223003669,insurance,insurance,net_banking_transfer,40265.26
632ae6d22e1a0ebb7f46fdf7,50200023535069,61300.25,60ec41ba55c00300382672d9,HDFC,Revenue-PG-non-split,5eecc6d6449e4f7cfb1c2708,2022-08-18T00:00:00.000Z,NEFT CR-PYTM0123456-PAYTM PAYMENTS SERVI CES LIMITED-SLICK ORGANICS PVT LTD-PYTM2 22306380669,insurance,insurance,net_banking_transfer,1272.4
632ae6d22e1a0ebb7f46fdf9,50200023535069,61298.25,60ec41ba55c00300382672d9,HDFC,Marketing Expense,5eecc6d6449e4f7cfb1c2708,2022-08-18T00:00:00.000Z,ME DC SI 514834XXXXXX9486 LINKEDIN,,,Other,-2
632ae6d22e1a0ebb7f46fdfb,50200023535069,-4938701.75,60ec41ba55c00300382672d9,HDFC,Marketing Expense,5eecc6d6449e4f7cfb1c2708,2022-08-18T00:00:00.000Z,"NEFT DR-CITI0000006-FACEBOOK INDIA ONLIN E SERVICES PVT LTD-NETBANK, MUM-N2302220 82576726-5000000",,,net_banking_transfer,-5000000
632ae6d22e1a0ebb7f46fdfd,50200023535069,-5238701.75,60ec41ba55c00300382672d9,HDFC,direct expenses,5eecc6d6449e4f7cfb1c2708,2022-08-18T00:00:00.000Z,POS 514834XXXXXX9486 RAZ*RAZORPAY SOF,,,debit_card,-300000
632ae6d22e1a0ebb7f46fdff,50200023535069,-5238979.32,60ec41ba55c00300382672d9,HDFC,bank charges,5eecc6d6449e4f7cfb1c2708,2022-08-18T00:00:00.000Z,.DC INTL POS TXN MARKUP+ST 020722 040722 -CDT2221510458023,,,international_transaction_arbitrage,-277.57
632ae6d32e1a0ebb7f46fe02,50200023535069,-5237086.09,60ec41ba55c00300382672d9,HDFC,Transfer in/Revenue-other,5eecc6d6449e4f7cfb1c2708,2022-08-18T00:00:00.000Z,NEFT CR-UTIB0000114-ONE SIGMA TECHNOLOGI ES PRIVATE LIM-SLICK ORGANICS PRIVATE LI MITED-AXISP00312707525,insurance,insurance,net_banking_transfer,1893.23
632ae6d32e1a0ebb7f46fe04,50200023535069,-5259506.09,60ec41ba55c00300382672d9,HDFC,direct expenses,5eecc6d6449e4f7cfb1c2708,2022-08-18T00:00:00.000Z,POS 514834XXXXXX9486 CAS*INSTASPACES,,,debit_card,-22420
632ae6d32e1a0ebb7f46fe06,50200023535069,-5259919.09,60ec41ba55c00300382672d9,HDFC,direct expenses,5eecc6d6449e4f7cfb1c2708,2022-08-18T00:00:00.000Z,SI FAIL DUE TO INSUFF BAL 070722-CDT2222 910732661,,penalty_charge,bank_charge,-413
632ae6d32e1a0ebb7f46fe08,50200023535069,-5224672.7,60ec41ba55c00300382672d9,HDFC,Transfer in/Revenue-other,5eecc6d6449e4f7cfb1c2708,2022-08-18T00:00:00.000Z,NEFT CR-KKBK0000958-NODAL ACCOUNT BROKEN,,,net_banking_transfer,35246.39
632ae6d32e1a0ebb7f46fe0a,50200023535069,-5224767.46,60ec41ba55c00300382672d9,HDFC,bank charges,5eecc6d6449e4f7cfb1c2708,2022-08-18T00:00:00.000Z,.DC INTL POS TXN MARKUP+ST 010722 020722 -CDT2221510458023,,,international_transaction_arbitrage,-94.76
632ae6d32e1a0ebb7f46fe0c,50200023535069,-5224652.46,60ec41ba55c00300382672d9,HDFC,Transfer in/Revenue-other,5eecc6d6449e4f7cfb1c2708,2022-08-19T00:00:00.000Z,INT. ON SWCR ON-50300663920102,,,Other,115
632ae6d32e1a0ebb7f46fe0e,50200023535069,-4924652.46,60ec41ba55c00300382672d9,HDFC,Loan-in,5eecc6d6449e4f7cfb1c2708,2022-08-19T00:00:00.000Z,SWEEP-IN CREDIT - 50300663920102,,,self_transfer,300000
632ae6d32e1a0ebb7f46fe10,50200023535069,-4924644.46,60ec41ba55c00300382672d9,HDFC,Transfer in/Revenue-other,5eecc6d6449e4f7cfb1c2708,2022-08-19T00:00:00.000Z,INT. ON SWCR ON-50300663920102,,,Other,8
632ae6d32e1a0ebb7f46fe12,50200023535069,-4904117.46,60ec41ba55c00300382672d9,HDFC,Loan-in,5eecc6d6449e4f7cfb1c2708,2022-08-19T00:00:00.000Z,SWEEP-IN CREDIT - 50300663920102,,,self_transfer,20527
632ae6d32e1a0ebb7f46fe14,50200023535069,-4902236.46,60ec41ba55c00300382672d9,HDFC,Transfer in/Revenue-other,5eecc6d6449e4f7cfb1c2708,2022-08-19T00:00:00.000Z,INT. ON SWCR ON-50300663920102,,,Other,1881
632ae6d32e1a0ebb7f46fe16,50200023535069,1881.54,60ec41ba55c00300382672d9,HDFC,Loan-in,5eecc6d6449e4f7cfb1c2708,2022-08-19T00:00:00.000Z,SWEEP-IN CREDIT - 50300663920102,,,self_transfer,4904118
632ae6d32e1a0ebb7f46fe18,50200023535069,12639.54,60ec41ba55c00300382672d9,HDFC,Transfer in/Revenue-other,5eecc6d6449e4f7cfb1c2708,2022-08-19T00:00:00.000Z,NEFT CR-KKBK0000958-OCTAVOS ENTERPRISE S OLUTIONS PVT-SLICK ORGANICS PVT LTD-CMS2 312223149087,insurance,insurance,net_banking_transfer,10758
632ae6d32e1a0ebb7f46fe1a,50200023535069,31264.04,60ec41ba55c00300382672d9,HDFC,Revenue-Mktplace,5eecc6d6449e4f7cfb1c2708,2022-08-19T00:00:00.000Z,NEFT CR-DEUT0797BGL-FLIPKART INTERNET PR IVATE LIMITED-SLICK ORGANICS PVT LTD-223 100123GN00122,shopping,,net_banking_transfer,18624.5
632ae6d32e1a0ebb7f46fe1c,50200023535069,39997.14,60ec41ba55c00300382672d9,HDFC,Revenue-PG-non-split,5eecc6d6449e4f7cfb1c2708,2022-08-19T00:00:00.000Z,NEFT CR-PYTM0123456-PAYTM PAYMENTS SERVI CES LIMITED-SLICK ORGANICS PVT LTD-PYTM2 22318052792,insurance,insurance,net_banking_transfer,8733.1
632ae6d32e1a0ebb7f46fe1e,50200023535069,46016.86,60ec41ba55c00300382672d9,HDFC,Revenue-Mktplace,5eecc6d6449e4f7cfb1c2708,2022-08-19T00:00:00.000Z,NEFT CR-DEUT0797BGL-MYNTRA DESIGNS PRIVA TE LIMITED-SLICK ORGANICS PVT. LTD.-2231 00678GN00147,shopping,,net_banking_transfer,6019.72
632ae6d32e1a0ebb7f46fe20,50200023535069,48522.01,60ec41ba55c00300382672d9,HDFC,Revenue-Mktplace,5eecc6d6449e4f7cfb1c2708,2022-08-19T00:00:00.000Z,NEFT CR-DEUT0797BGL-MYNTRA DESIGNS PRIVA TE LIMITED-SLICK ORGANICS PVT. LTD.-2231 00679GN00019,shopping,,net_banking_transfer,2505.15
632ae6d32e1a0ebb7f46fe22,50200023535069,-129775.99,60ec41ba55c00300382672d9,HDFC,direct expenses,5eecc6d6449e4f7cfb1c2708,2022-08-19T00:00:00.000Z,"NEFT DR-ICIC0006643-KRISHNA PACKAGING CO MPANY-NETBANK, MUM-N231222083826075-1782 98",,,net_banking_transfer,-178298
632ae6d32e1a0ebb7f46fe24,50200023535069,-163923.99,60ec41ba55c00300382672d9,HDFC,direct expenses,5eecc6d6449e4f7cfb1c2708,2022-08-19T00:00:00.000Z,02711600008220-TPT-34148-VARUN SINGH,,,net_banking_transfer,-34148
632ae6d32e1a0ebb7f46fe26,50200023535069,-463923.99,60ec41ba55c00300382672d9,HDFC,direct expenses,5eecc6d6449e4f7cfb1c2708,2022-08-19T00:00:00.000Z,POS 514834XXXXXX9486 RAZ*RAZORPAY SOF,,,debit_card,-300000
632ae6d32e1a0ebb7f46fe28,50200023535069,-663923.99,60ec41ba55c00300382672d9,HDFC,direct expenses,5eecc6d6449e4f7cfb1c2708,2022-08-19T00:00:00.000Z,POS 514834XXXXXX9486 RAZ*RAZORPAY SOF,,,debit_card,-200000
632ae6d32e1a0ebb7f46fe2a,50200023535069,-1237454.99,60ec41ba55c00300382672d9,HDFC,Marketing Expense,5eecc6d6449e4f7cfb1c2708,2022-08-19T00:00:00.000Z,NEFT DR-CITI0000006-FACEBOOK INDIA ONLIN,,,net_banking_transfer,-573531
632ae6d32e1a0ebb7f46fe2c,50200023535069,-1287454.99,60ec41ba55c00300382672d9,HDFC,direct expenses,5eecc6d6449e4f7cfb1c2708,2022-08-19T00:00:00.000Z,"NEFT DR-UTIB0001326-MEHAK BAKSHI-NETBANK , MUM-N231222083898363-50000",,,net_banking_transfer,-50000
632ae6d32e1a0ebb7f46fe2f,50200023535069,-1297454.99,60ec41ba55c00300382672d9,HDFC,direct expenses,5eecc6d6449e4f7cfb1c2708,2022-08-19T00:00:00.000Z,50100110669502-TPT-10000-VRITI MALHOTRA,,,net_banking_transfer,-10000
632ae6d32e1a0ebb7f46fe31,50200023535069,-1307454.99,60ec41ba55c00300382672d9,HDFC,direct expenses,5eecc6d6449e4f7cfb1c2708,2022-08-19T00:00:00.000Z,"NEFT DR-SBIN0010650-CHETAN MEHRA-NETBANK , MUM-N231222083923805-10000",,,net_banking_transfer,-10000
632ae6d32e1a0ebb7f46fe33,50200023535069,-1276591.36,60ec41ba55c00300382672d9,HDFC,Revenue-PG-non-split,5eecc6d6449e4f7cfb1c2708,2022-08-19T00:00:00.000Z,NEFT CR-KKBK0000958-NODAL ACCOUNT BROKEN TUSK TECHNOL-SLICK ORGANICS PRIVATE LIMI TED-CMS2312223163864,insurance,insurance,net_banking_transfer,30863.63
632ae6d32e1a0ebb7f46fe37,50200023535069,-1336591.36,60ec41ba55c00300382672d9,HDFC,direct expenses,5eecc6d6449e4f7cfb1c2708,2022-08-19T00:00:00.000Z,50200039508087-TPT-60000-SHREE PUNCHMUKH I LOGISTICS,,,net_banking_transfer,-60000
632ae6d32e1a0ebb7f46fe39,50200023535069,-1334369.57,60ec41ba55c00300382672d9,HDFC,Transfer in/Revenue-other,5eecc6d6449e4f7cfb1c2708,2022-08-19T00:00:00.000Z,NEFT CR-UTIB0000114-ONE SIGMA TECHNOLOGI ES PRIVATE LIM-SLICK ORGANICS PRIVATE LI MITED-AXISP00312932320,insurance,insurance,net_banking_transfer,2221.79
632ae6d32e1a0ebb7f46fe3b,50200023535069,-1335350.54,60ec41ba55c00300382672d9,HDFC,bank charges,5eecc6d6449e4f7cfb1c2708,2022-08-19T00:00:00.000Z,.DC INTL POS TXN MARKUP+ST 070722 090722 -CDT2221510458023,,,international_transaction_arbitrage,-980.97
632ae6d32e1a0ebb7f46fe3d,50200023535069,-1398827.54,60ec41ba55c00300382672d9,HDFC,direct expenses,5eecc6d6449e4f7cfb1c2708,2022-08-19T00:00:00.000Z,"NEFT DR-ICIC0002451-SOUTH COURT CONDOMIN IUM ASSOCIATION-NETBANK, MUM-N2312220843 13231-63477",,,net_banking_transfer,-63477
632ae6d32e1a0ebb7f46fe3f,50200023535069,-1394772.31,60ec41ba55c00300382672d9,HDFC,Revenue-PG-split enabled,5eecc6d6449e4f7cfb1c2708,2022-08-19T00:00:00.000Z,NEFT CR-UTIB0001506-RAZORPAY SOFTWARE PR IVATE LIMITED-SLICK ORGANICS PVT LITD-AX ISCN0161176298,insurance,insurance,net_banking_transfer,4055.23
632ae6d32e1a0ebb7f46fe41,50200023535069,-1394643.31,60ec41ba55c00300382672d9,HDFC,Transfer in/Revenue-other,5eecc6d6449e4f7cfb1c2708,2022-08-20T00:00:00.000Z,INT. ON SWCR ON-50300663920102,,,Other,129
632ae6d32e1a0ebb7f46fe43,50200023535069,-1094643.31,60ec41ba55c00300382672d9,HDFC,Loan-in,5eecc6d6449e4f7cfb1c2708,2022-08-20T00:00:00.000Z,SWEEP-IN CREDIT - 50300663920102,,,self_transfer,300000
632ae6d32e1a0ebb7f46fe45,50200023535069,-1094557.31,60ec41ba55c00300382672d9,HDFC,Transfer in/Revenue-other,5eecc6d6449e4f7cfb1c2708,2022-08-20T00:00:00.000Z,INT. ON SWCR ON-50300663920102,,,Other,86
632ae6d32e1a0ebb7f46fe47,50200023535069,-894557.31,60ec41ba55c00300382672d9,HDFC,Loan-in,5eecc6d6449e4f7cfb1c2708,2022-08-20T00:00:00.000Z,SWEEP-IN CREDIT - 50300663920102,,,self_transfer,200000
632ae6d32e1a0ebb7f46fe49,50200023535069,-894501.31,60ec41ba55c00300382672d9,HDFC,Transfer in/Revenue-other,5eecc6d6449e4f7cfb1c2708,2022-08-20T00:00:00.000Z,INT. ON SWCR ON-50300663920102,,,Other,56
632ae6d32e1a0ebb7f46fe4b,50200023535069,-764725.31,60ec41ba55c00300382672d9,HDFC,Loan-in,5eecc6d6449e4f7cfb1c2708,2022-08-20T00:00:00.000Z,SWEEP-IN CREDIT - 50300663920102,,,self_transfer,129776
632ae6d32e1a0ebb7f46fe4d,50200023535069,-764710.31,60ec41ba55c00300382672d9,HDFC,Transfer in/Revenue-other,5eecc6d6449e4f7cfb1c2708,2022-08-20T00:00:00.000Z,INT. ON SWCR ON-50300663920102,,,Other,15
632ae6d32e1a0ebb7f46fe4f,50200023535069,-730562.31,60ec41ba55c00300382672d9,HDFC,Loan-in,5eecc6d6449e4f7cfb1c2708,2022-08-20T00:00:00.000Z,SWEEP-IN CREDIT - 50300663920102,,,self_transfer,34148
632ae6d32e1a0ebb7f46fe52,50200023535069,-730315.31,60ec41ba55c00300382672d9,HDFC,Transfer in/Revenue-other,5eecc6d6449e4f7cfb1c2708,2022-08-20T00:00:00.000Z,INT. ON SWCR ON-50300663920102,,,Other,247
632ae6d32e1a0ebb7f46fe54,50200023535069,-156784.31,60ec41ba55c00300382672d9,HDFC,Loan-in,5eecc6d6449e4f7cfb1c2708,2022-08-20T00:00:00.000Z,SWEEP-IN CREDIT - 50300663920102,,,self_transfer,573531
632ae6d32e1a0ebb7f46fe56,50200023535069,-156762.31,60ec41ba55c00300382672d9,HDFC,Transfer in/Revenue-other,5eecc6d6449e4f7cfb1c2708,2022-08-20T00:00:00.000Z,INT. ON SWCR ON-50300663920102,,,Other,22
632ae6d32e1a0ebb7f46fe58,50200023535069,-106762.31,60ec41ba55c00300382672d9,HDFC,Loan-in,5eecc6d6449e4f7cfb1c2708,2022-08-20T00:00:00.000Z,SWEEP-IN CREDIT - 50300663920102,,,self_transfer,50000
632ae6d32e1a0ebb7f46fe5a,50200023535069,-106758.31,60ec41ba55c00300382672d9,HDFC,Transfer in/Revenue-other,5eecc6d6449e4f7cfb1c2708,2022-08-20T00:00:00.000Z,INT. ON SWCR ON-50300663920102,,,Other,4
632ae6d32e1a0ebb7f46fe5c,50200023535069,-96758.31,60ec41ba55c00300382672d9,HDFC,Loan-in,5eecc6d6449e4f7cfb1c2708,2022-08-20T00:00:00.000Z,SWEEP-IN CREDIT - 50300663920102,,,self_transfer,10000
632ae6d32e1a0ebb7f46fe5e,50200023535069,-96754.31,60ec41ba55c00300382672d9,HDFC,Transfer in/Revenue-other,5eecc6d6449e4f7cfb1c2708,2022-08-20T00:00:00.000Z,INT. ON SWCR ON-50300663920102,,,Other,4
632ae6d32e1a0ebb7f46fe60,50200023535069,-86754.31,60ec41ba55c00300382672d9,HDFC,Loan-in,5eecc6d6449e4f7cfb1c2708,2022-08-20T00:00:00.000Z,SWEEP-IN CREDIT - 50300663920102,,,self_transfer,10000
632ae6d32e1a0ebb7f46fe62,50200023535069,-86741.31,60ec41ba55c00300382672d9,HDFC,Transfer in/Revenue-other,5eecc6d6449e4f7cfb1c2708,2022-08-20T00:00:00.000Z,INT. ON SWCR ON-50300663920102,,,Other,13
632ae6d32e1a0ebb7f46fe64,50200023535069,-57604.31,60ec41ba55c00300382672d9,HDFC,Loan-in,5eecc6d6449e4f7cfb1c2708,2022-08-20T00:00:00.000Z,SWEEP-IN CREDIT - 50300663920102,,,self_transfer,29137
632ae6d32e1a0ebb7f46fe66,50200023535069,-57579.31,60ec41ba55c00300382672d9,HDFC,Transfer in/Revenue-other,5eecc6d6449e4f7cfb1c2708,2022-08-20T00:00:00.000Z,INT. ON SWCR ON-50300663920102,,,Other,25
632ae6d32e1a0ebb7f46fe68,50200023535069,25.69,60ec41ba55c00300382672d9,HDFC,Loan-in,5eecc6d6449e4f7cfb1c2708,2022-08-20T00:00:00.000Z,SWEEP-IN CREDIT - 50300663920102,,,self_transfer,57605
632ae6d32e1a0ebb7f46fe6a,50200023535069,8196.17,60ec41ba55c00300382672d9,HDFC,Revenue-PG-non-split,5eecc6d6449e4f7cfb1c2708,2022-08-20T00:00:00.000Z,NEFT CR-PYTM0123456-PAYTM PAYMENTS SERVI CES LIMITED-SLICK ORGANICS PVT LTD-PYTM2 22329580406,insurance,insurance,net_banking_transfer,8170.48
632ae6d32e1a0ebb7f46fe6e,50200023535069,7397.31,60ec41ba55c00300382672d9,HDFC,direct expenses,5eecc6d6449e4f7cfb1c2708,2022-08-20T00:00:00.000Z,POS 514834XXXXXX9486 ECOMENGINE* FEED,,,debit_card,-798.86
632ae6d32e1a0ebb7f46fe70,50200023535069,7236.2,60ec41ba55c00300382672d9,HDFC,bank charges,5eecc6d6449e4f7cfb1c2708,2022-08-20T00:00:00.000Z,.DC INTL POS TXN MARKUP+ST 120722 140722 -CDT2221510458023,,,international_transaction_arbitrage,-161.11
632ae6d32e1a0ebb7f46fe73,50200023535069,-39073.8,60ec41ba55c00300382672d9,HDFC,Tax,5eecc6d6449e4f7cfb1c2708,2022-08-20T00:00:00.000Z,GST/BANK REFERENCE NO: R2223237075088/CI N NO: HDFC22080700198412,,,Other,-46310
632ae6d32e1a0ebb7f46fe76,50200023535069,-5273.87,60ec41ba55c00300382672d9,HDFC,Revenue-PG-non-split,5eecc6d6449e4f7cfb1c2708,2022-08-20T00:00:00.000Z,NEFT CR-KKBK0000958-NODAL ACCOUNT BROKEN TUSK TECHNOL-SLICK ORGANICS PRIVATE LIMI TED-CMS2322223249434,insurance,insurance,net_banking_transfer,33799.93
632ae6d32e1a0ebb7f46fe78,50200023535069,-5270.87,60ec41ba55c00300382672d9,HDFC,Transfer in/Revenue-other,5eecc6d6449e4f7cfb1c2708,2022-08-21T00:00:00.000Z,INT. ON SWCR ON-50300663920102,,,Other,3
632ae6d32e1a0ebb7f46fe7a,50200023535069,3.13,60ec41ba55c00300382672d9,HDFC,Loan-in,5eecc6d6449e4f7cfb1c2708,2022-08-21T00:00:00.000Z,SWEEP-IN CREDIT - 50300663920102,,,self_transfer,5274
632ae6d32e1a0ebb7f46fe7d,50200023535069,16037.92,60ec41ba55c00300382672d9,HDFC,Revenue-PG-non-split,5eecc6d6449e4f7cfb1c2708,2022-08-21T00:00:00.000Z,NEFT CR-PYTM0123456-PAYTM PAYMENTS SERVI CES LIMITED-SLICK ORGANICS PVT LTD-PYTM2 22331048436,insurance,insurance,net_banking_transfer,16034.79
632ae6d32e1a0ebb7f46fe7f,50200023535069,-374251.03,60ec41ba55c00300382672d9,HDFC,direct expenses,5eecc6d6449e4f7cfb1c2708,2022-08-21T00:00:00.000Z,POS 514834XXXXXX9486 RAZ*RAZORPAY SOF,,,debit_card,-390288.95
632ae6d32e1a0ebb7f46fe81,50200023535069,-411751.03,60ec41ba55c00300382672d9,HDFC,direct expenses,5eecc6d6449e4f7cfb1c2708,2022-08-21T00:00:00.000Z,"NEFT DR-ICIC0000399-NAYANTARA PARIKH-NET BANK, MUM-N233222086010975-37500",,,net_banking_transfer,-37500
632ae6d32e1a0ebb7f46fe83,50200023535069,-411554.03,60ec41ba55c00300382672d9,HDFC,Transfer in/Revenue-other,5eecc6d6449e4f7cfb1c2708,2022-08-22T00:00:00.000Z,INT. ON SWCR ON-50300663920102,,,Other,197
632ae6d32e1a0ebb7f46fe85,50200023535069,-37302.03,60ec41ba55c00300382672d9,HDFC,Loan-in,5eecc6d6449e4f7cfb1c2708,2022-08-22T00:00:00.000Z,SWEEP-IN CREDIT - 50300663920102,,,self_transfer,374252
632ae6d32e1a0ebb7f46fe87,50200023535069,-37282.03,60ec41ba55c00300382672d9,HDFC,Transfer in/Revenue-other,5eecc6d6449e4f7cfb1c2708,2022-08-22T00:00:00.000Z,INT. ON SWCR ON-50300663920102,,,Other,20
632ae6d32e1a0ebb7f46fe89,50200023535069,20.97,60ec41ba55c00300382672d9,HDFC,Loan-in,5eecc6d6449e4f7cfb1c2708,2022-08-22T00:00:00.000Z,SWEEP-IN CREDIT - 50300663920102,,,self_transfer,37303
632ae6d32e1a0ebb7f46fe8b,50200023535069,24057.66,60ec41ba55c00300382672d9,HDFC,Revenue-Mktplace,5eecc6d6449e4f7cfb1c2708,2022-08-22T00:00:00.000Z,NEFT CR-DEUT0797BGL-FLIPKART INTERNET PR IVATE LIMITED-SLICK ORGANICS PVT LTD-223 400162GN00095,shopping,,net_banking_transfer,24036.69
632ae6d32e1a0ebb7f46fe8d,50200023535069,33398.32,60ec41ba55c00300382672d9,HDFC,Revenue-PG-non-split,5eecc6d6449e4f7cfb1c2708,2022-08-22T00:00:00.000Z,NEFT CR-PYTM0123456-PAYTM PAYMENTS SERVI CES LIMITED-SLICK ORGANICS PVT LTD-PYTM2 22343106394,insurance,insurance,net_banking_transfer,9340.66
632ae6d32e1a0ebb7f46fe8f,50200023535069,43273.74,60ec41ba55c00300382672d9,HDFC,Revenue-Mktplace,5eecc6d6449e4f7cfb1c2708,2022-08-22T00:00:00.000Z,NEFT CR-DEUT0797BGL-MYNTRA DESIGNS PRIVA TE LIMITED-SLICK ORGANICS PVT. LTD.-2234 00704GN00230,shopping,,net_banking_transfer,9875.42
632ae6d32e1a0ebb7f46fe92,50200023535069,47447.17,60ec41ba55c00300382672d9,HDFC,Revenue-Mktplace,5eecc6d6449e4f7cfb1c2708,2022-08-22T00:00:00.000Z,NEFT CR-DEUT0797BGL-MYNTRA DESIGNS PRIVA TE LIMITED-SLICK ORGANICS PVT. LTD.-2234 00705GN00104,shopping,,net_banking_transfer,4173.43
632ae6d32e1a0ebb7f46fe95,50200023535069,37447.17,60ec41ba55c00300382672d9,HDFC,direct expenses,5eecc6d6449e4f7cfb1c2708,2022-08-22T00:00:00.000Z,"NEFT DR-ICIC0004109-ASHRAFI ASSOCIATES-N ETBANK, MUM-N234222086343462-10000",,,net_banking_transfer,-10000
632ae6d32e1a0ebb7f46fe97,50200023535069,-12552.83,60ec41ba55c00300382672d9,HDFC,direct expenses,5eecc6d6449e4f7cfb1c2708,2022-08-22T00:00:00.000Z,"NEFT DR-KKBK0004583-PICKRR TECHNOLOGIES PVT LTD-NETBANK, MUM-N234222086343872-50 000",,,net_banking_transfer,-50000
632ae6d32e1a0ebb7f46fe99,50200023535069,2527.2,60ec41ba55c00300382672d9,HDFC,Revenue-PG-split enabled,5eecc6d6449e4f7cfb1c2708,2022-08-22T00:00:00.000Z,NEFT CR-UTIB0001506-RAZORPAY SOFTWARE PR IVATE LIMITED-SLICK ORGANICS PVT LITD-AX ISCN0161456711,insurance,insurance,net_banking_transfer,15080.03
632ae6d32e1a0ebb7f46fe9b,50200023535069,4527.37,60ec41ba55c00300382672d9,HDFC,Transfer in/Revenue-other,5eecc6d6449e4f7cfb1c2708,2022-08-22T00:00:00.000Z,NEFT CR-UTIB0000114-ONE SIGMA TECHNOLOGI ES PRIVATE LIM-SLICK ORGANICS PRIVATE LI MITED-AXISP00313292855,insurance,insurance,net_banking_transfer,2000.17
632ae6d32e1a0ebb7f46fe9d,50200023535069,84790.35,60ec41ba55c00300382672d9,HDFC,Revenue-PG-non-split,5eecc6d6449e4f7cfb1c2708,2022-08-22T00:00:00.000Z,NEFT CR-KKBK0000958-NODAL ACCOUNT BROKEN TUSK TECHNOL-SLICK ORGANICS PRIVATE LIMI TED-CMS2342223323554,insurance,insurance,net_banking_transfer,80262.98
632ae6d32e1a0ebb7f46fe9f,50200023535069,94209.25,60ec41ba55c00300382672d9,HDFC,Revenue-PG-split enabled,5eecc6d6449e4f7cfb1c2708,2022-08-22T00:00:00.000Z,NEFT CR-UTIB0001506-RAZORPAY SOFTWARE PR IVATE LIMITED-SLICK ORGANICS PVT LITD-AX ISCN0161597312,insurance,insurance,net_banking_transfer,9418.9
632ae6d32e1a0ebb7f46fea1,50200023535069,119399.81,60ec41ba55c00300382672d9,HDFC,Revenue-COD,5eecc6d6449e4f7cfb1c2708,2022-08-22T00:00:00.000Z,NEFT CR-ICIC0000155-SHIPROCKET COD CRF I,,,net_banking_transfer,25190.56
632ae6d42e1a0ebb7f46fea3,50200023535069,121416.81,60ec41ba55c00300382672d9,HDFC,Transfer in/Revenue-other,5eecc6d6449e4f7cfb1c2708,2022-08-22T00:00:00.000Z,50200059157776AKHILESHDIXIT85GMAIL,,,Other,2017
632ae6d42e1a0ebb7f46fea5,50200023535069,106616.81,60ec41ba55c00300382672d9,HDFC,direct expenses,5eecc6d6449e4f7cfb1c2708,2022-08-22T00:00:00.000Z,"NEFT DR-UTIB0001326-MEHAK BAKSHI-NETBANK , MUM-N234222087381205-14800",,,net_banking_transfer,-14800
632ae6d42e1a0ebb7f46fea7,50200023535069,-6783.19,60ec41ba55c00300382672d9,HDFC,direct expenses,5eecc6d6449e4f7cfb1c2708,2022-08-22T00:00:00.000Z,"NEFT DR-IDFB0040101-ACTIVES ADDITIVES AP PLICATIONS LLP-NETBANK, MUM-N23422208737 4054-113400",insurance,insurance,net_banking_transfer,-113400
632ae6d42e1a0ebb7f46fea9,50200023535069,-6781.19,60ec41ba55c00300382672d9,HDFC,Transfer in/Revenue-other,5eecc6d6449e4f7cfb1c2708,2022-08-22T00:00:00.000Z,CRV POS 514834******9486 LINKEDIN,,,refund,2
632ae6d42e1a0ebb7f46feab,50200023535069,-6777.19,60ec41ba55c00300382672d9,HDFC,Transfer in/Revenue-other,5eecc6d6449e4f7cfb1c2708,2022-08-23T00:00:00.000Z,INT. ON SWCR ON-50300663920102,,,Other,4
632ae6d42e1a0ebb7f46fead,50200023535069,4.81,60ec41ba55c00300382672d9,HDFC,Loan-in,5eecc6d6449e4f7cfb1c2708,2022-08-23T00:00:00.000Z,SWEEP-IN CREDIT - 50300663920102,,,self_transfer,6782
632ae6d42e1a0ebb7f46feaf,50200023535069,163670.2,60ec41ba55c00300382672d9,HDFC,Revenue-Mktplace,5eecc6d6449e4f7cfb1c2708,2022-08-23T00:00:00.000Z,IMPS-223505381040-AMAZON SELLER SERVIC-H SBC-XXXXXXXX6004-6RADABLJEK4RJBEBSLICK O RGANICS PVT LTD,shopping,,net_banking_transfer,163665.39
632ae6d42e1a0ebb7f46feb1,50200023535069,173301.82,60ec41ba55c00300382672d9,HDFC,Revenue-PG-non-split,5eecc6d6449e4f7cfb1c2708,2022-08-23T00:00:00.000Z,NEFT CR-PYTM0123456-PAYTM PAYMENTS SERVI CES LIMITED-SLICK ORGANICS PVT LTD-PYTM2 22354194539,insurance,insurance,net_banking_transfer,9631.62
632ae6d42e1a0ebb7f46feb3,50200023535069,181862.44,60ec41ba55c00300382672d9,HDFC,Revenue-PG-split enabled,5eecc6d6449e4f7cfb1c2708,2022-08-23T00:00:00.000Z,NEFT CR-UTIB0001506-RAZORPAY SOFTWARE PR IVATE LIMITED-SLICK ORGANICS PVT LITD-AX ISCN0161657422,insurance,insurance,net_banking_transfer,8560.62
632ae6d42e1a0ebb7f46feb5,50200023535069,743627.89,60ec41ba55c00300382672d9,HDFC,Revenue-Mktplace,5eecc6d6449e4f7cfb1c2708,2022-08-23T00:00:00.000Z,NEFT CR-DEUT0797BGL-AMAZON PAY (INDIA) P RIVATE LIMITED-SLICK ORGANICS PVT LTD-22 3500342GN00073,shopping,,net_banking_transfer,561765.45
632ae6d42e1a0ebb7f46feb7,50200023535069,742233.13,60ec41ba55c00300382672d9,HDFC,Marketing Expense,5eecc6d6449e4f7cfb1c2708,2022-08-23T00:00:00.000Z,ME DC SI 514834XXXXXX9486 LINKEDIN (PGSI ),,,Other,-1394.76
632ae6d42e1a0ebb7f46feb9,50200023535069,21420.13,60ec41ba55c00300382672d9,HDFC,direct expenses,5eecc6d6449e4f7cfb1c2708,2022-08-23T00:00:00.000Z,"NEFT DR-ICIC0000024-TAKE MOTO YOHKI INDI A PRIVATE LIMITED-NETBANK, MUM-N23522208 8148091-720813",travel,,net_banking_transfer,-720813
632ae6d42e1a0ebb7f46febb,50200023535069,-28579.87,60ec41ba55c00300382672d9,HDFC,direct expenses,5eecc6d6449e4f7cfb1c2708,2022-08-23T00:00:00.000Z,"NEFT DR-PUNB0062910-YADAVPACKAGING-NETBA NK, MUM-N235222088152245-50000",,,net_banking_transfer,-50000
632ae6d42e1a0ebb7f46febd,50200023535069,-528579.87,60ec41ba55c00300382672d9,HDFC,direct expenses,5eecc6d6449e4f7cfb1c2708,2022-08-23T00:00:00.000Z,"NEFT DR-ICIC0000369-BO INTERNATIONAL-NET BANK, MUM-N235222088152818-500000",,,net_banking_transfer,-500000
632ae6d42e1a0ebb7f46febf,50200023535069,-535999.87,60ec41ba55c00300382672d9,HDFC,direct expenses,5eecc6d6449e4f7cfb1c2708,2022-08-23T00:00:00.000Z,NEFT DR-ICIC0000715-GAJENDRA BAHADUR SIN,,,net_banking_transfer,-7420
632ae6d42e1a0ebb7f46fec1,50200023535069,-585999.87,60ec41ba55c00300382672d9,HDFC,direct expenses,5eecc6d6449e4f7cfb1c2708,2022-08-23T00:00:00.000Z,"NEFT DR-KKBK0000173-MATRIX PRINTING SOLU TIONS PRIVATE LIMITE-NETBANK, MUM-N23522 2088165264-50000",,,net_banking_transfer,-50000
632ae6d42e1a0ebb7f46fec3,50200023535069,-592999.87,60ec41ba55c00300382672d9,HDFC,direct expenses,5eecc6d6449e4f7cfb1c2708,2022-08-23T00:00:00.000Z,"NEFT DR-SIBL0000555-JAIVEER KUMAR-NETBAN K, MUM-N235222088194569-7000",,,net_banking_transfer,-7000
632ae6d42e1a0ebb7f46fec6,50200023535069,-563014.3,60ec41ba55c00300382672d9,HDFC,Revenue-PG-non-split,5eecc6d6449e4f7cfb1c2708,2022-08-23T00:00:00.000Z,NEFT CR-KKBK0000958-NODAL ACCOUNT BROKEN TUSK TECHNOL-SLICK ORGANICS PRIVATE LIMI TED-CMS2352223413476,insurance,insurance,net_banking_transfer,29985.57
632ae6d42e1a0ebb7f46fecc,50200023535069,-573014.3,60ec41ba55c00300382672d9,HDFC,Refund,5eecc6d6449e4f7cfb1c2708,2022-08-23T00:00:00.000Z,"NEFT DR-RATN0VAAPIS-RAZORPAY REFUND CRED ITS TOPUP-NETBANK, MUM-N235222088535670- 10000",,,net_banking_transfer,-10000
632ae6d42e1a0ebb7f46fecf,50200023535069,-573218.3,60ec41ba55c00300382672d9,HDFC,direct expenses,5eecc6d6449e4f7cfb1c2708,2022-08-23T00:00:00.000Z,POS 514834XXXXXX9486 SMARTSHIFT LOGIS,,,debit_card,-204
632ae6d42e1a0ebb7f46fed2,50200023535069,-568249.37,60ec41ba55c00300382672d9,HDFC,Revenue-PG-split enabled,5eecc6d6449e4f7cfb1c2708,2022-08-23T00:00:00.000Z,NEFT CR-UTIB0001506-RAZORPAY SOFTWARE PR IVATE LIMITED-SLICK ORGANICS PVT LITD-AX ISCN0161818832,insurance,insurance,net_banking_transfer,4968.93
632ae6d42e1a0ebb7f46fed4,50200023535069,-562749.37,60ec41ba55c00300382672d9,HDFC,Transfer in/Revenue-other,5eecc6d6449e4f7cfb1c2708,2022-08-23T00:00:00.000Z,NEFT CR-HSBC0560002-INNOVATIVE RETAIL CO NCEPTS PRIVATE-SLICK ORGANICS P L-HSBCN2 2235471465,,,net_banking_transfer,5500
632ae6d42e1a0ebb7f46fed6,50200023535069,-559212.37,60ec41ba55c00300382672d9,HDFC,Transfer in/Revenue-other,5eecc6d6449e4f7cfb1c2708,2022-08-23T00:00:00.000Z,NEFT CR-HSBC0560002-INNOVATIVE RETAIL CO NCEPTS PRIVATE-SLICK ORGANICS P L-HSBCN2 2235471468,,,net_banking_transfer,3537
632ae6d42e1a0ebb7f46fed8,50200023535069,-552723.37,60ec41ba55c00300382672d9,HDFC,Transfer in/Revenue-other,5eecc6d6449e4f7cfb1c2708,2022-08-23T00:00:00.000Z,NEFT CR-HSBC0560002-INNOVATIVE RETAIL CO NCEPTS PRIVATE-SLICK ORGANICS P L-HSBCN2 2235471470,,,net_banking_transfer,6489
632ae6d42e1a0ebb7f46feda,50200023535069,-552705.37,60ec41ba55c00300382672d9,HDFC,Transfer in/Revenue-other,5eecc6d6449e4f7cfb1c2708,2022-08-24T00:00:00.000Z,INT. ON SWCR ON-50300663920102,,,Other,18
632ae6d42e1a0ebb7f46fedc,50200023535069,-524125.37,60ec41ba55c00300382672d9,HDFC,Loan-in,5eecc6d6449e4f7cfb1c2708,2022-08-24T00:00:00.000Z,SWEEP-IN CREDIT - 50300663920102,,,self_transfer,28580
632ae6d42e1a0ebb7f46fedf,50200023535069,-523813.37,60ec41ba55c00300382672d9,HDFC,Transfer in/Revenue-other,5eecc6d6449e4f7cfb1c2708,2022-08-24T00:00:00.000Z,INT. ON SWCR ON-50300663920102,,,Other,312
632ae6d42e1a0ebb7f46fee1,50200023535069,-23813.37,60ec41ba55c00300382672d9,HDFC,Loan-in,5eecc6d6449e4f7cfb1c2708,2022-08-24T00:00:00.000Z,SWEEP-IN CREDIT - 50300663920102,,,self_transfer,500000
632ae6d42e1a0ebb7f46fee3,50200023535069,-23808.37,60ec41ba55c00300382672d9,HDFC,Transfer in/Revenue-other,5eecc6d6449e4f7cfb1c2708,2022-08-24T00:00:00.000Z,INT. ON SWCR ON-50300663920102,,,Other,5
632ae6d42e1a0ebb7f46fee5,50200023535069,-16388.37,60ec41ba55c00300382672d9,HDFC,Loan-in,5eecc6d6449e4f7cfb1c2708,2022-08-24T00:00:00.000Z,SWEEP-IN CREDIT - 50300663920102,,,self_transfer,7420
632ae6d42e1a0ebb7f46fee7,50200023535069,-16378.37,60ec41ba55c00300382672d9,HDFC,Transfer in/Revenue-other,5eecc6d6449e4f7cfb1c2708,2022-08-24T00:00:00.000Z,INT. ON SWCR ON-50300663920102,,,Other,10
632ae6d42e1a0ebb7f46fee9,50200023535069,10.63,60ec41ba55c00300382672d9,HDFC,Loan-in,5eecc6d6449e4f7cfb1c2708,2022-08-24T00:00:00.000Z,SWEEP-IN CREDIT - 50300663920102,,,self_transfer,16389
632ae6d42e1a0ebb7f46feec,50200023535069,22959.74,60ec41ba55c00300382672d9,HDFC,Revenue-Mktplace,5eecc6d6449e4f7cfb1c2708,2022-08-24T00:00:00.000Z,NEFT CR-DEUT0797BGL-FLIPKART INTERNET PR IVATE LIMITED-SLICK ORGANICS PVT LTD-223 600163GN00172,shopping,,net_banking_transfer,22949.11
632ae6d42e1a0ebb7f46feee,50200023535069,25389.59,60ec41ba55c00300382672d9,HDFC,Revenue-PG-non-split,5eecc6d6449e4f7cfb1c2708,2022-08-24T00:00:00.000Z,NEFT CR-PYTM0123456-PAYTM PAYMENTS SERVI CES LIMITED-SLICK ORGANICS PVT LTD-PYTM2 22365388765,insurance,insurance,net_banking_transfer,2429.85
632ae6d42e1a0ebb7f46fef0,50200023535069,25892.97,60ec41ba55c00300382672d9,HDFC,Revenue-Mktplace,5eecc6d6449e4f7cfb1c2708,2022-08-24T00:00:00.000Z,NEFT CR-DEUT0797BGL-MYNTRA DESIGNS PRIVA TE LIMITED-SLICK ORGANICS PVT. LTD.-2236 00708GN00130,shopping,,net_banking_transfer,503.38
632ae6d42e1a0ebb7f46fef2,50200023535069,31384.4,60ec41ba55c00300382672d9,HDFC,Revenue-Mktplace,5eecc6d6449e4f7cfb1c2708,2022-08-24T00:00:00.000Z,NEFT CR-DEUT0797BGL-MYNTRA DESIGNS PRIVA TE LIMITED-SLICK ORGANICS PVT. LTD.-2236 00724GN00118,shopping,,net_banking_transfer,5491.43
632ae6d42e1a0ebb7f46fef4,50200023535069,54172.5,60ec41ba55c00300382672d9,HDFC,Revenue-PG-split enabled,5eecc6d6449e4f7cfb1c2708,2022-08-24T00:00:00.000Z,NEFT CR-UTIB0001506-RAZORPAY SOFTWARE PR IVATE LIMITED-SLICK ORGANICS PVT LITD-AX ISCN0161973350,insurance,insurance,net_banking_transfer,22788.1
632ae6d42e1a0ebb7f46fef6,50200023535069,54059.84,60ec41ba55c00300382672d9,HDFC,bank charges,5eecc6d6449e4f7cfb1c2708,2022-08-24T00:00:00.000Z,.DC INTL POS TXN MARKUP+ST 180722 190722 -CDT2221510458023,,,international_transaction_arbitrage,-112.66
632ae6d42e1a0ebb7f46fef8,50200023535069,1859.84,60ec41ba55c00300382672d9,HDFC,direct expenses,5eecc6d6449e4f7cfb1c2708,2022-08-24T00:00:00.000Z,50100052049836-TPT-52200-RAVI KULSRESHTH A,,,net_banking_transfer,-52200
632ae6d42e1a0ebb7f46fefa,50200023535069,-18140.16,60ec41ba55c00300382672d9,HDFC,direct expenses,5eecc6d6449e4f7cfb1c2708,2022-08-24T00:00:00.000Z,"NEFT DR-UTIB0001812-DEEPIKA DAS-NETBANK, MUM-N236222089118873-20000",,,net_banking_transfer,-20000
632ae6d42e1a0ebb7f46fefc,50200023535069,-118140.16,60ec41ba55c00300382672d9,HDFC,direct expenses,5eecc6d6449e4f7cfb1c2708,2022-08-24T00:00:00.000Z,"NEFT DR-ICIC0006643-KRISHNA PACKAGING CO MPANY-NETBANK, MUM-N236222089251497-1000 00",,,net_banking_transfer,-100000
632ae6d42e1a0ebb7f46fefe,50200023535069,-117667.66,60ec41ba55c00300382672d9,HDFC,Transfer in/Revenue-other,5eecc6d6449e4f7cfb1c2708,2022-08-24T00:00:00.000Z,NEFT CR-UTIB0000114-ONE SIGMA TECHNOLOGI ES PRIVATE LIM-SLICK ORGANICS PRIVATE LI MITED-AXISP00313840424,insurance,insurance,net_banking_transfer,472.5
632ae6d42e1a0ebb7f46ff00,50200023535069,-41067.83,60ec41ba55c00300382672d9,HDFC,Revenue-COD,5eecc6d6449e4f7cfb1c2708,2022-08-24T00:00:00.000Z,NEFT CR-ICIC0000155-SHIPROCKET COD CRF I D 4795932-SLICK ORGANICS PVT LTD-CMS2786 003199,insurance,insurance,net_banking_transfer,76599.83
632ae6d42e1a0ebb7f46ff08,50200023535069,-17293.82,60ec41ba55c00300382672d9,HDFC,Transfer in/Revenue-other,5eecc6d6449e4f7cfb1c2708,2022-08-24T00:00:00.000Z,NEFT CR-KKBK0000958-NODAL ACCOUNT BROKEN,,,net_banking_transfer,23774.01
632ae6d42e1a0ebb7f46ff0c,50200023535069,-27567.82,60ec41ba55c00300382672d9,HDFC,direct expenses,5eecc6d6449e4f7cfb1c2708,2022-08-24T00:00:00.000Z,"NEFT DR-BARB0SUSGUR-GREENIECAN INDIA-NET BANK, MUM-N236222089689118-10274",,,net_banking_transfer,-10274
632ae6d42e1a0ebb7f46ff0e,50200023535069,-24169.82,60ec41ba55c00300382672d9,HDFC,Revenue-Mktplace,5eecc6d6449e4f7cfb1c2708,2022-08-24T00:00:00.000Z,NEFT CR-SCBL0036001-DREAMPLUG TECHNOLOGI ES PRIVATE LIMITED-SLICK ORGANICS PRIVAT E LIMITEDSLICK-IN1ON22082405KCT,,,net_banking_transfer,3398
632ae6d42e1a0ebb7f46ff10,50200023535069,-15185.06,60ec41ba55c00300382672d9,HDFC,Revenue-PG-split enabled,5eecc6d6449e4f7cfb1c2708,2022-08-24T00:00:00.000Z,NEFT CR-UTIB0001506-RAZORPAY SOFTWARE PR IVATE LIMITED-SLICK ORGANICS PVT LITD-AX ISCN0162109115,insurance,insurance,net_banking_transfer,8984.76
632ae6d42e1a0ebb7f46ff13,50200023535069,-16854.06,60ec41ba55c00300382672d9,HDFC,direct expenses,5eecc6d6449e4f7cfb1c2708,2022-08-24T00:00:00.000Z,POS 514834XXXXXX9486 SMARTSHIFT LOGIS,,,debit_card,-1669
632ae6d42e1a0ebb7f46ff15,50200023535069,-16852.06,60ec41ba55c00300382672d9,HDFC,Transfer in/Revenue-other,5eecc6d6449e4f7cfb1c2708,2022-08-24T00:00:00.000Z,CRV POS 514834******9486 LINKEDIN,,,refund,2
632ae6d42e1a0ebb7f46ff18,50200023535069,-16841.06,60ec41ba55c00300382672d9,HDFC,Transfer in/Revenue-other,5eecc6d6449e4f7cfb1c2708,2022-08-25T00:00:00.000Z,INT. ON SWCR ON-50300663920102,,,Other,11
632ae6d42e1a0ebb7f46ff1a,50200023535069,11.94,60ec41ba55c00300382672d9,HDFC,Loan-in,5eecc6d6449e4f7cfb1c2708,2022-08-25T00:00:00.000Z,SWEEP-IN CREDIT - 50300663920102,,,self_transfer,16853
632ae6d42e1a0ebb7f46ff1c,50200023535069,10175.17,60ec41ba55c00300382672d9,HDFC,Revenue-PG-non-split,5eecc6d6449e4f7cfb1c2708,2022-08-25T00:00:00.000Z,NEFT CR-PYTM0123456-PAYTM PAYMENTS SERVI CES LIMITED-SLICK ORGANICS PVT LTD-PYTM2 22376745147,insurance,insurance,net_banking_transfer,10163.23
632ae6d42e1a0ebb7f46ff20,50200023535069,26025.14,60ec41ba55c00300382672d9,HDFC,Revenue-PG-split enabled,5eecc6d6449e4f7cfb1c2708,2022-08-25T00:00:00.000Z,NEFT CR-UTIB0001506-RAZORPAY SOFTWARE PR IVATE LIMITED-SLICK ORGANICS PVT LITD-AX ISCN0162186935,insurance,insurance,net_banking_transfer,15849.97
632ae6d42e1a0ebb7f46ff27,50200023535069,51357.44,60ec41ba55c00300382672d9,HDFC,Revenue-PG-non-split,5eecc6d6449e4f7cfb1c2708,2022-08-25T00:00:00.000Z,NEFT CR-KKBK0000958-NODAL ACCOUNT BROKEN TUSK TECHNOL-SLICK ORGANICS PRIVATE LIMI TED-CMS2372223555392,insurance,insurance,net_banking_transfer,25332.3
632ae6d42e1a0ebb7f46ff29,50200023535069,50375.44,60ec41ba55c00300382672d9,HDFC,direct expenses,5eecc6d6449e4f7cfb1c2708,2022-08-25T00:00:00.000Z,POS 514834XXXXXX9486 SMARTSHIFT LOGIS,,,debit_card,-982
632ae6d42e1a0ebb7f46ff2c,50200023535069,51766.72,60ec41ba55c00300382672d9,HDFC,Transfer in/Revenue-other,5eecc6d6449e4f7cfb1c2708,2022-08-25T00:00:00.000Z,NEFT CR-UTIB0000114-ONE SIGMA TECHNOLOGI ES PRIVATE LIM-SLICK ORGANICS PRIVATE LI MITED-AXISP00314145385,insurance,insurance,net_banking_transfer,1391.28
632ae6d42e1a0ebb7f46ff2e,50200023535069,51681.72,60ec41ba55c00300382672d9,HDFC,direct expenses,5eecc6d6449e4f7cfb1c2708,2022-08-25T00:00:00.000Z,POS 514834XXXXXX9486 SMARTSHIFT LOGIS,,,debit_card,-85
632ae6d42e1a0ebb7f46ff30,50200023535069,74404.25,60ec41ba55c00300382672d9,HDFC,Revenue-PG-split enabled,5eecc6d6449e4f7cfb1c2708,2022-08-25T00:00:00.000Z,NEFT CR-UTIB0001506-RAZORPAY SOFTWARE PR IVATE LIMITED-SLICK ORGANICS PVT LITD-AX ISCN0162309276,insurance,insurance,net_banking_transfer,22722.53
632ae6d42e1a0ebb7f46ff32,50200023535069,85015.49,60ec41ba55c00300382672d9,HDFC,Revenue-Mktplace,5eecc6d6449e4f7cfb1c2708,2022-08-26T00:00:00.000Z,NEFT CR-DEUT0797BGL-FLIPKART INTERNET PR,shopping,,net_banking_transfer,10611.24
632ae6d42e1a0ebb7f46ff34,50200023535069,114178.7,60ec41ba55c00300382672d9,HDFC,Revenue-PG-non-split,5eecc6d6449e4f7cfb1c2708,2022-08-26T00:00:00.000Z,NEFT CR-PYTM0123456-PAYTM PAYMENTS SERVI CES LIMITED-SLICK ORGANICS PVT LTD-PYTM2 22388320749,insurance,insurance,net_banking_transfer,29163.21
632ae6d42e1a0ebb7f46ff36,50200023535069,117478.64,60ec41ba55c00300382672d9,HDFC,Revenue-Mktplace,5eecc6d6449e4f7cfb1c2708,2022-08-26T00:00:00.000Z,NEFT CR-DEUT0797BGL-MYNTRA DESIGNS PRIVA TE LIMITED-SLICK ORGANICS PVT. LTD.-2238 00673GN00030,shopping,,net_banking_transfer,3299.94
632ae6d42e1a0ebb7f46ff3a,50200023535069,123183.41,60ec41ba55c00300382672d9,HDFC,Revenue-Mktplace,5eecc6d6449e4f7cfb1c2708,2022-08-26T00:00:00.000Z,NEFT CR-DEUT0797BGL-MYNTRA DESIGNS PRIVA TE LIMITED-SLICK ORGANICS PVT. LTD.-2238 00674GN00221,shopping,,net_banking_transfer,5704.77
632ae6d42e1a0ebb7f46ff3c,50200023535069,144862,60ec41ba55c00300382672d9,HDFC,Revenue-PG-split enabled,5eecc6d6449e4f7cfb1c2708,2022-08-26T00:00:00.000Z,NEFT CR-UTIB0001506-RAZORPAY SOFTWARE PR IVATE LIMITED-SLICK ORGANICS PVT LITD-AX ISCN0162364300,insurance,insurance,net_banking_transfer,21678.59
632ae6d42e1a0ebb7f46ff3e,50200023535069,239669.42,60ec41ba55c00300382672d9,HDFC,Revenue-PG-non-split,5eecc6d6449e4f7cfb1c2708,2022-08-26T00:00:00.000Z,NEFT CR-KKBK0000958-NODAL ACCOUNT BROKEN TUSK TECHNOL-SLICK ORGANICS PRIVATE LIMI TED-CMS2382223642716,insurance,insurance,net_banking_transfer,94807.42
632ae6d42e1a0ebb7f46ff40,50200023535069,221969.42,60ec41ba55c00300382672d9,HDFC,direct expenses,5eecc6d6449e4f7cfb1c2708,2022-08-26T00:00:00.000Z,"NEFT DR-ICIC0000020-MANASH LIFESTYLE PRI VATE LIMITED-NETBANK, MUM-N2382220919525 45-17700",shopping,,net_banking_transfer,-17700
632ae6d42e1a0ebb7f46ff42,50200023535069,204269.42,60ec41ba55c00300382672d9,HDFC,direct expenses,5eecc6d6449e4f7cfb1c2708,2022-08-26T00:00:00.000Z,"NEFT DR-ICIC0000020-MANASH LIFESTYLE PRI VATE LIMITED-NETBANK, MUM-N2382220919683 29-17700",shopping,,net_banking_transfer,-17700
632ae6d42e1a0ebb7f46ff44,50200023535069,202860.42,60ec41ba55c00300382672d9,HDFC,SAAS/tech expense,5eecc6d6449e4f7cfb1c2708,2022-08-26T00:00:00.000Z,POS 514834XXXXXX9486 AMAZON,shopping,,debit_card,-1409
632ae6d42e1a0ebb7f46ff46,50200023535069,205388.72,60ec41ba55c00300382672d9,HDFC,Transfer in/Revenue-other,5eecc6d6449e4f7cfb1c2708,2022-08-26T00:00:00.000Z,NEFT CR-UTIB0000114-ONE SIGMA TECHNOLOGI ES PRIVATE LIM-SLICK ORGANICS PRIVATE LI MITED-AXISP00314336607,insurance,insurance,net_banking_transfer,2528.3
632ae6d42e1a0ebb7f46ff48,50200023535069,208399.1,60ec41ba55c00300382672d9,HDFC,Revenue-PG-non-split,5eecc6d6449e4f7cfb1c2708,2022-08-26T00:00:00.000Z,NEFT CR-SCBL0036001-STRIPE INDIA PRIVATE LIMITED-SLICK ORGANICS PRIVATE LIMITED- IN1ON220826017EG,insurance,insurance,net_banking_transfer,3010.38
632ae6d42e1a0ebb7f46ff4a,50200023535069,206370.1,60ec41ba55c00300382672d9,HDFC,direct expenses,5eecc6d6449e4f7cfb1c2708,2022-08-26T00:00:00.000Z,ME DC SI 514834XXXXXX9486 ADOBE SYSTEMS SOFTWARE,,,Other,-2029
632ae6d42e1a0ebb7f46ff4c,50200023535069,220609.66,60ec41ba55c00300382672d9,HDFC,Revenue-PG-split enabled,5eecc6d6449e4f7cfb1c2708,2022-08-26T00:00:00.000Z,NEFT CR-UTIB0001506-RAZORPAY SOFTWARE PR,,,net_banking_transfer,14239.56
632ae6d42e1a0ebb7f46ff4e,50200023535069,229873.66,60ec41ba55c00300382672d9,HDFC,Revenue-Mktplace,5eecc6d6449e4f7cfb1c2708,2022-08-26T00:00:00.000Z,NEFT CR-ICIC0000985-DIGITAL AGE RETAIL P VT LTD-SLICK ORGANICS PVT LTD DS-CMS27 89948032,,,net_banking_transfer,9264
632ae6d42e1a0ebb7f46ff50,50200023535069,232386.93,60ec41ba55c00300382672d9,HDFC,Revenue-COD,5eecc6d6449e4f7cfb1c2708,2022-08-26T00:00:00.000Z,NEFT CR-ICIC0000155-SHIPROCKET COD CRF I D 4808146-SLICK ORGANICS PVT LTD-CMS2790 229004,insurance,insurance,net_banking_transfer,2513.27
632ae6d52e1a0ebb7f46ff52,50200023535069,261986.61,60ec41ba55c00300382672d9,HDFC,Revenue-PG-non-split,5eecc6d6449e4f7cfb1c2708,2022-08-27T00:00:00.000Z,NEFT CR-PYTM0123456-PAYTM PAYMENTS SERVI CES LIMITED-SLICK ORGANICS PVT LTD-PYTM2 22399767368,insurance,insurance,net_banking_transfer,29599.68
632ae6d52e1a0ebb7f46ff54,50200023535069,280304.53,60ec41ba55c00300382672d9,HDFC,Revenue-PG-non-split,5eecc6d6449e4f7cfb1c2708,2022-08-28T00:00:00.000Z,NEFT CR-PYTM0123456-PAYTM PAYMENTS SERVI CES LIMITED-SLICK ORGANICS PVT LTD-PYTM2 22401447855,insurance,insurance,net_banking_transfer,18317.92
632ae6d52e1a0ebb7f46ff56,50200023535069,426033.36,60ec41ba55c00300382672d9,HDFC,Revenue-UPI,5eecc6d6449e4f7cfb1c2708,2022-08-28T00:00:00.000Z,UPI-GOKWIK-GOKWIK@YESBANK-YESB0000340-22 4076808550-PAYOUT FOR AUGUST,,,upi,145728.83
632ae6d52e1a0ebb7f46ff58,50200023535069,443619.45,60ec41ba55c00300382672d9,HDFC,Revenue-Mktplace,5eecc6d6449e4f7cfb1c2708,2022-08-29T00:00:00.000Z,NEFT CR-DEUT0797BGL-FLIPKART INTERNET PR IVATE LIMITED-SLICK ORGANICS PVT LTD-224 100179GN00278,shopping,,net_banking_transfer,17586.09
632ae6d52e1a0ebb7f46ff5a,50200023535069,455861.31,60ec41ba55c00300382672d9,HDFC,Revenue-PG-non-split,5eecc6d6449e4f7cfb1c2708,2022-08-29T00:00:00.000Z,NEFT CR-PYTM0123456-PAYTM PAYMENTS SERVI CES LIMITED-SLICK ORGANICS PVT LTD-PYTM2 22413092660,insurance,insurance,net_banking_transfer,12241.86
632ae6d52e1a0ebb7f46ff5c,50200023535069,454982.31,60ec41ba55c00300382672d9,HDFC,direct expenses,5eecc6d6449e4f7cfb1c2708,2022-08-29T00:00:00.000Z,POS 514834XXXXXX9486 ADOBE SOFTWARE,,,debit_card,-879
632ae6d52e1a0ebb7f46ff5e,50200023535069,452953.31,60ec41ba55c00300382672d9,HDFC,direct expenses,5eecc6d6449e4f7cfb1c2708,2022-08-29T00:00:00.000Z,POS 514834XXXXXX9486 ADOBE SOFTWARE,,,debit_card,-2029
632ae6d52e1a0ebb7f46ff60,50200023535069,523623.29,60ec41ba55c00300382672d9,HDFC,Revenue-PG-split enabled,5eecc6d6449e4f7cfb1c2708,2022-08-29T00:00:00.000Z,NEFT CR-UTIB0001506-RAZORPAY SOFTWARE PR IVATE LIMITED-SLICK ORGANICS PVT LITD-AX ISCN0162640450,insurance,insurance,net_banking_transfer,70669.98
632ae6d52e1a0ebb7f46ff63,50200023535069,522749.29,60ec41ba55c00300382672d9,HDFC,direct expenses,5eecc6d6449e4f7cfb1c2708,2022-08-29T00:00:00.000Z,POS 514834XXXXXX9486 SMARTSHIFT LOGIS,,,debit_card,-874
632ae6d52e1a0ebb7f46ff65,50200023535069,487749.29,60ec41ba55c00300382672d9,HDFC,direct expenses,5eecc6d6449e4f7cfb1c2708,2022-08-29T00:00:00.000Z,POS 514834XXXXXX9486 FLIPKART,shopping,,debit_card,-35000
632ae6d52e1a0ebb7f46ff68,50200023535069,413434.29,60ec41ba55c00300382672d9,HDFC,direct expenses,5eecc6d6449e4f7cfb1c2708,2022-08-29T00:00:00.000Z,NEFT DR-ICIC0006643-KRISHNA PACKAGING CO,,,net_banking_transfer,-74315
632ae6d52e1a0ebb7f46ff6a,50200023535069,601518.05,60ec41ba55c00300382672d9,HDFC,Revenue-PG-non-split,5eecc6d6449e4f7cfb1c2708,2022-08-29T00:00:00.000Z,NEFT CR-KKBK0000958-NODAL ACCOUNT BROKEN TUSK TECHNOL-SLICK ORGANICS PRIVATE LIMI TED-CMS2412223771099,insurance,insurance,net_banking_transfer,188083.76
632ae6d52e1a0ebb7f46ff6c,50200023535069,566118.05,60ec41ba55c00300382672d9,HDFC,direct expenses,5eecc6d6449e4f7cfb1c2708,2022-08-29T00:00:00.000Z,"NEFT DR-ICIC0000024-TAKE MOTO YOHKI INDI A PRIVATE LIMITED-NETBANK, MUM-N24122209 4586878-35400",travel,,net_banking_transfer,-35400
632ae6d52e1a0ebb7f46ff6e,50200023535069,565118.05,60ec41ba55c00300382672d9,HDFC,direct expenses,5eecc6d6449e4f7cfb1c2708,2022-08-29T00:00:00.000Z,POS 514834XXXXXX9486 NYKAA,,,debit_card,-1000
632ae6d52e1a0ebb7f46ff70,50200023535069,570615.18,60ec41ba55c00300382672d9,HDFC,Revenue-Mktplace,5eecc6d6449e4f7cfb1c2708,2022-08-29T00:00:00.000Z,NEFT CR-DEUT0797BGL-MYNTRA DESIGNS PRIVA TE LIMITED-SLICK ORGANICS PVT. LTD.-2241 00913GN00102,shopping,,net_banking_transfer,5497.13
632ae6d52e1a0ebb7f46ff72,50200023535069,584914.04,60ec41ba55c00300382672d9,HDFC,Revenue-Mktplace,5eecc6d6449e4f7cfb1c2708,2022-08-29T00:00:00.000Z,NEFT CR-DEUT0797BGL-MYNTRA DESIGNS PRIVA TE LIMITED-SLICK ORGANICS PVT. LTD.-2241 00917GN00253,shopping,,net_banking_transfer,14298.86
632ae6d52e1a0ebb7f46ff74,50200023535069,584897.04,60ec41ba55c00300382672d9,HDFC,direct expenses,5eecc6d6449e4f7cfb1c2708,2022-08-29T00:00:00.000Z,1883128550/EPFO,,,Other,-17
632ae6d52e1a0ebb7f46ff76,50200023535069,595654.23,60ec41ba55c00300382672d9,HDFC,Transfer in/Revenue-other,5eecc6d6449e4f7cfb1c2708,2022-08-29T00:00:00.000Z,NEFT CR-UTIB0000114-ONE SIGMA TECHNOLOGI ES PRIVATE LIM-SLICK ORGANICS PRIVATE LI MITED-AXISP00314751090,insurance,insurance,net_banking_transfer,10757.19
632ae6d52e1a0ebb7f46ff78,50200023535069,596754.23,60ec41ba55c00300382672d9,HDFC,Transfer in/Revenue-other,5eecc6d6449e4f7cfb1c2708,2022-08-29T00:00:00.000Z,NEFT CR-UTIB0000114-ONE SIGMA TECHNOLOGI ES PRIVATE LIM-SLICK ORGANICS PRIVATE LI MITED-AXISP00314751434,insurance,insurance,net_banking_transfer,1100
632ae6d52e1a0ebb7f46ff7a,50200023535069,595432.23,60ec41ba55c00300382672d9,HDFC,direct expenses,5eecc6d6449e4f7cfb1c2708,2022-08-29T00:00:00.000Z,POS 514834XXXXXX9486 RAZ*SMARTSHIFT L,,,debit_card,-1322
632ae6d52e1a0ebb7f46ff7e,50200023535069,595201.25,60ec41ba55c00300382672d9,HDFC,bank charges,5eecc6d6449e4f7cfb1c2708,2022-08-29T00:00:00.000Z,.DC INTL POS TXN MARKUP+ST 190722 210722 -CDT2221510458023,,,international_transaction_arbitrage,-230.98
632ae6d52e1a0ebb7f46ff80,50200023535069,593718.25,60ec41ba55c00300382672d9,HDFC,direct expenses,5eecc6d6449e4f7cfb1c2708,2022-08-29T00:00:00.000Z,POS 514834XXXXXX9486 SMARTSHIFT LOGIS,,,debit_card,-1483
632ae6d52e1a0ebb7f46ff82,50200023535069,667645.74,60ec41ba55c00300382672d9,HDFC,Revenue-COD,5eecc6d6449e4f7cfb1c2708,2022-08-29T00:00:00.000Z,NEFT CR-ICIC0000155-SHIPROCKET COD CRF I D 4816379-SLICK ORGANICS PVT LTD-CMS2794 866825,insurance,insurance,net_banking_transfer,73927.49
632ae6d52e1a0ebb7f46ff84,50200023535069,666323.74,60ec41ba55c00300382672d9,HDFC,direct expenses,5eecc6d6449e4f7cfb1c2708,2022-08-29T00:00:00.000Z,POS 514834XXXXXX9486 SMARTSHIFT LOGIS,,,debit_card,-1322
632ae6d52e1a0ebb7f46ff86,50200023535069,626316.66,60ec41ba55c00300382672d9,HDFC,SAAS/tech expense,5eecc6d6449e4f7cfb1c2708,2022-08-29T00:00:00.000Z,POS 514834XXXXXX9486 AMAZON.COM,shopping,,debit_card,-40007.08
632ae6d52e1a0ebb7f46ff88,50200023535069,629366.12,60ec41ba55c00300382672d9,HDFC,Revenue-PG-split enabled,5eecc6d6449e4f7cfb1c2708,2022-08-29T00:00:00.000Z,NEFT CR-UTIB0001506-RAZORPAY SOFTWARE PR,,,net_banking_transfer,3049.46
632ae6d52e1a0ebb7f46ff8a,50200023535069,773827.46,60ec41ba55c00300382672d9,HDFC,Revenue-Mktplace,5eecc6d6449e4f7cfb1c2708,2022-08-30T00:00:00.000Z,IMPS-224205362105-AMAZON SELLER SERVIC-H SBC-XXXXXXXX6004-1ONB52D6B1O5ZLTVSLICK O RGANICS PVT LTD,shopping,,net_banking_transfer,144461.34
632ae6d52e1a0ebb7f46ff8c,50200023535069,787229.1,60ec41ba55c00300382672d9,HDFC,Revenue-PG-non-split,5eecc6d6449e4f7cfb1c2708,2022-08-30T00:00:00.000Z,NEFT CR-PYTM0123456-PAYTM PAYMENTS SERVI CES LIMITED-SLICK ORGANICS PVT LTD-PYTM2 22424438245,insurance,insurance,net_banking_transfer,13401.64
632ae6d52e1a0ebb7f46ff8e,50200023535069,1295026.59,60ec41ba55c00300382672d9,HDFC,Revenue-Mktplace,5eecc6d6449e4f7cfb1c2708,2022-08-30T00:00:00.000Z,NEFT CR-DEUT0797BGL-AMAZON PAY (INDIA) P RIVATE LIMITED-SLICK ORGANICS PVT LTD-22 4200121GN00236,shopping,,net_banking_transfer,507797.49
632ae6d52e1a0ebb7f46ff90,50200023535069,1294526.59,60ec41ba55c00300382672d9,HDFC,direct expenses,5eecc6d6449e4f7cfb1c2708,2022-08-30T00:00:00.000Z,POS 514834XXXXXX9486 PTM*PAYTM WALLET,ewallet,,debit_card,-500
632ae6d52e1a0ebb7f46ff92,50200023535069,1264526.59,60ec41ba55c00300382672d9,HDFC,direct expenses,5eecc6d6449e4f7cfb1c2708,2022-08-30T00:00:00.000Z,"NEFT DR-ICIC0000399-NAYANTARA PARIKH-NET BANK, MUM-N242222096181427-30000",,,net_banking_transfer,-30000
632ae6d52e1a0ebb7f46ff94,50200023535069,1269741.86,60ec41ba55c00300382672d9,HDFC,Revenue-PG-split enabled,5eecc6d6449e4f7cfb1c2708,2022-08-30T00:00:00.000Z,NEFT CR-UTIB0001506-RAZORPAY SOFTWARE PR IVATE LIMITED-SLICK ORGANICS PVT LITD-AX ISCN0162891957,insurance,insurance,net_banking_transfer,5215.27
632ae6d52e1a0ebb7f46ff96,50200023535069,1260741.86,60ec41ba55c00300382672d9,HDFC,direct expenses,5eecc6d6449e4f7cfb1c2708,2022-08-30T00:00:00.000Z,"NEFT DR-ICIC0000399-NAYANTARA PARIKH-NET BANK, MUM-N242222096272466-9000",,,net_banking_transfer,-9000
632ae6d52e1a0ebb7f46ff98,50200023535069,870097.86,60ec41ba55c00300382672d9,HDFC,Marketing Expense,5eecc6d6449e4f7cfb1c2708,2022-08-30T00:00:00.000Z,"NEFT DR-CITI0100000-GOOGLE INDIA PVT LTD -NETBANK, MUM-N242222096263685-390644",,,net_banking_transfer,-390644
632ae6d52e1a0ebb7f46ff9a,50200023535069,370097.86,60ec41ba55c00300382672d9,HDFC,direct expenses,5eecc6d6449e4f7cfb1c2708,2022-08-30T00:00:00.000Z,"NEFT DR-ICIC0000369-BO INTERNATIONAL-NET BANK, MUM-N242222096270231-500000",,,net_banking_transfer,-500000
632ae6d52e1a0ebb7f46ff9c,50200023535069,356854.52,60ec41ba55c00300382672d9,HDFC,N-ACH payments,5eecc6d6449e4f7cfb1c2708,2022-08-30T00:00:00.000Z,ACH D- 531381265-71PR22083001F6GS,,unidentified obligation,auto_debit_payment,-13243.34
632ae6d52e1a0ebb7f46ff9e,50200023535069,306854.52,60ec41ba55c00300382672d9,HDFC,N-ACH payments,5eecc6d6449e4f7cfb1c2708,2022-08-30T00:00:00.000Z,ACH D- 531381265F-71PR22083001F6I5,,unidentified obligation,auto_debit_payment,-50000
632ae6d52e1a0ebb7f46ffa0,50200023535069,256854.52,60ec41ba55c00300382672d9,HDFC,N-ACH payments,5eecc6d6449e4f7cfb1c2708,2022-08-30T00:00:00.000Z,ACH D- 531381265A-71PR22083001F6H5,,unidentified obligation,auto_debit_payment,-50000
632ae6d52e1a0ebb7f46ffa2,50200023535069,206854.52,60ec41ba55c00300382672d9,HDFC,N-ACH payments,5eecc6d6449e4f7cfb1c2708,2022-08-30T00:00:00.000Z,ACH D- 531381265D-71PR22083001F6HQ,,unidentified obligation,auto_debit_payment,-50000
632ae6d52e1a0ebb7f46ffa4,50200023535069,156854.52,60ec41ba55c00300382672d9,HDFC,N-ACH payments,5eecc6d6449e4f7cfb1c2708,2022-08-30T00:00:00.000Z,ACH D- 531381265B-71PR22083001F6HC,,unidentified obligation,auto_debit_payment,-50000
632ae6d52e1a0ebb7f46ffa6,50200023535069,106854.52,60ec41ba55c00300382672d9,HDFC,N-ACH payments,5eecc6d6449e4f7cfb1c2708,2022-08-30T00:00:00.000Z,ACH D- 531381265H-71PR22083001F6HA,,unidentified obligation,auto_debit_payment,-50000
632ae6d52e1a0ebb7f46ffa8,50200023535069,56854.52,60ec41ba55c00300382672d9,HDFC,N-ACH payments,5eecc6d6449e4f7cfb1c2708,2022-08-30T00:00:00.000Z,ACH D- 531381265C-71PR22083001F6HI,,unidentified obligation,auto_debit_payment,-50000
632ae6d52e1a0ebb7f46ffaa,50200023535069,6854.52,60ec41ba55c00300382672d9,HDFC,N-ACH payments,5eecc6d6449e4f7cfb1c2708,2022-08-30T00:00:00.000Z,ACH D- 531381265E-71PR22083001F6I0,,unidentified obligation,auto_debit_payment,-50000
632ae6d52e1a0ebb7f46ffac,50200023535069,-43145.48,60ec41ba55c00300382672d9,HDFC,N-ACH payments,5eecc6d6449e4f7cfb1c2708,2022-08-30T00:00:00.000Z,ACH D- 531381265G-71PR22083001F6H0,,unidentified obligation,auto_debit_payment,-50000
632ae6d52e1a0ebb7f46ffae,50200023535069,-44325.48,60ec41ba55c00300382672d9,HDFC,Marketing Expense,5eecc6d6449e4f7cfb1c2708,2022-08-30T00:00:00.000Z,ME DC SI 514834XXXXXX9486 LINKEDIN (PGSI,,,Other,-1180
632ae6d52e1a0ebb7f46ffb0,50200023535069,-45356.48,60ec41ba55c00300382672d9,HDFC,direct expenses,5eecc6d6449e4f7cfb1c2708,2022-08-30T00:00:00.000Z,POS 514834XXXXXX9486 SMARTSHIFT LOGIS,,,debit_card,-1031
632ae6d52e1a0ebb7f46ffb3,50200023535069,-36950.53,60ec41ba55c00300382672d9,HDFC,Transfer in/Revenue-other,5eecc6d6449e4f7cfb1c2708,2022-08-30T00:00:00.000Z,NEFT CR-UTIB0000114-ONE SIGMA TECHNOLOGI ES PRIVATE LIM-SLICK ORGANICS PRIVATE LI MITED-AXISP00315164465,insurance,insurance,net_banking_transfer,8405.95
632ae6d52e1a0ebb7f46ffb5,50200023535069,-7988.97,60ec41ba55c00300382672d9,HDFC,Revenue-PG-non-split,5eecc6d6449e4f7cfb1c2708,2022-08-30T00:00:00.000Z,NEFT CR-KKBK0000958-NODAL ACCOUNT BROKEN TUSK TECHNOL-SLICK ORGANICS PRIVATE LIMI TED-CMS2422223950933,insurance,insurance,net_banking_transfer,28961.56
632ae6d52e1a0ebb7f46ffb7,50200023535069,20430.33,60ec41ba55c00300382672d9,HDFC,Transfer in/Revenue-other,5eecc6d6449e4f7cfb1c2708,2022-08-30T00:00:00.000Z,59209873901899-TPT-INV 2222294-NYNM ORGA NICS PVT LTD,,,net_banking_transfer,28419.3
632ae6d52e1a0ebb7f46ffba,50200023535069,-79569.67,60ec41ba55c00300382672d9,HDFC,direct expenses,5eecc6d6449e4f7cfb1c2708,2022-08-30T00:00:00.000Z,"NEFT DR-ICIC0006566-MARKETING MANTRA-NET BANK, MUM-N242222097507656-100000",,,net_banking_transfer,-100000
632ae6d52e1a0ebb7f46ffbc,50200023535069,-66501.99,60ec41ba55c00300382672d9,HDFC,Revenue-PG-split enabled,5eecc6d6449e4f7cfb1c2708,2022-08-30T00:00:00.000Z,NEFT CR-UTIB0001506-RAZORPAY SOFTWARE PR IVATE LIMITED-SLICK ORGANICS PVT LITD-AX ISCN0163039250,insurance,insurance,net_banking_transfer,13067.68
632ae6d52e1a0ebb7f46ffbe,50200023535069,-195241.07,60ec41ba55c00300382672d9,HDFC,direct expenses,5eecc6d6449e4f7cfb1c2708,2022-08-30T00:00:00.000Z,FCY OUTWARD REMITTANCE,,,Other,-128739.08
632ae6d52e1a0ebb7f46ffc0,50200023535069,-195420.07,60ec41ba55c00300382672d9,HDFC,SAAS/tech expense,5eecc6d6449e4f7cfb1c2708,2022-08-30T00:00:00.000Z,ME DC SI 514834XXXXXX9486 AMAZON,shopping,,Other,-179
632ae6d52e1a0ebb7f46ffc2,50200023535069,-195419.07,60ec41ba55c00300382672d9,HDFC,Transfer in/Revenue-other,5eecc6d6449e4f7cfb1c2708,2022-08-31T00:00:00.000Z,INT. ON SWCR ON-50300663920102,,,Other,1
632ae6d52e1a0ebb7f46ffc4,50200023535069,-194239.07,60ec41ba55c00300382672d9,HDFC,Loan-in,5eecc6d6449e4f7cfb1c2708,2022-08-31T00:00:00.000Z,SWEEP-IN CREDIT - 50300663920102,,,self_transfer,1180
632ae6d52e1a0ebb7f46ffc7,50200023535069,-194238.07,60ec41ba55c00300382672d9,HDFC,Transfer in/Revenue-other,5eecc6d6449e4f7cfb1c2708,2022-08-31T00:00:00.000Z,INT. ON SWCR ON-50300663920102,,,Other,1
632ae6d52e1a0ebb7f46ffc9,50200023535069,-193207.07,60ec41ba55c00300382672d9,HDFC,Loan-in,5eecc6d6449e4f7cfb1c2708,2022-08-31T00:00:00.000Z,SWEEP-IN CREDIT - 50300663920102,,,self_transfer,1031
632ae6d52e1a0ebb7f46ffcb,50200023535069,-193166.07,60ec41ba55c00300382672d9,HDFC,Transfer in/Revenue-other,5eecc6d6449e4f7cfb1c2708,2022-08-31T00:00:00.000Z,INT. ON SWCR ON-50300663920102,,,Other,41
632ae6d52e1a0ebb7f46ffce,50200023535069,-150020.07,60ec41ba55c00300382672d9,HDFC,Loan-in,5eecc6d6449e4f7cfb1c2708,2022-08-31T00:00:00.000Z,SWEEP-IN CREDIT - 50300663920102,,,self_transfer,43146
632ae6d52e1a0ebb7f46ffd0,50200023535069,-149841.07,60ec41ba55c00300382672d9,HDFC,Loan-in,5eecc6d6449e4f7cfb1c2708,2022-08-31T00:00:00.000Z,SWEEP-IN CREDIT - 50300663920102,,,self_transfer,179
632ae6d52e1a0ebb7f46ffd2,50200023535069,-149808.07,60ec41ba55c00300382672d9,HDFC,Transfer in/Revenue-other,5eecc6d6449e4f7cfb1c2708,2022-08-31T00:00:00.000Z,INT. ON SWCR ON-50300663920102,,,Other,33
632ae6d52e1a0ebb7f46ffd4,50200023535069,-115594.07,60ec41ba55c00300382672d9,HDFC,Loan-in,5eecc6d6449e4f7cfb1c2708,2022-08-31T00:00:00.000Z,SWEEP-IN CREDIT - 50300663920102,,,self_transfer,34214
632ae6d52e1a0ebb7f46ffd6,50200023535069,-115483.07,60ec41ba55c00300382672d9,HDFC,Transfer in/Revenue-other,5eecc6d6449e4f7cfb1c2708,2022-08-31T00:00:00.000Z,INT. ON SWCR ON-50300663920102,,,Other,111
632ae6d52e1a0ebb7f46ffd8,50200023535069,111.93,60ec41ba55c00300382672d9,HDFC,Loan-in,5eecc6d6449e4f7cfb1c2708,2022-08-31T00:00:00.000Z,SWEEP-IN CREDIT - 50300663920102,,,self_transfer,115595
632ae6d52e1a0ebb7f46ffda,50200023535069,8493.21,60ec41ba55c00300382672d9,HDFC,Revenue-PG-non-split,5eecc6d6449e4f7cfb1c2708,2022-08-31T00:00:00.000Z,NEFT CR-PYTM0123456-PAYTM PAYMENTS SERVI CES LIMITED-SLICK ORGANICS PVT LTD-PYTM2 22436637380,insurance,insurance,net_banking_transfer,8381.28
632ae6d52e1a0ebb7f46ffdc,50200023535069,32232.52,60ec41ba55c00300382672d9,HDFC,Revenue-COD,5eecc6d6449e4f7cfb1c2708,2022-08-31T00:00:00.000Z,NEFT CR-ICIC0000155-SHIPROCKET COD CRF I,,,net_banking_transfer,23739.31
632ae6d52e1a0ebb7f46ffde,50200023535069,43663.85,60ec41ba55c00300382672d9,HDFC,Revenue-PG-non-split,5eecc6d6449e4f7cfb1c2708,2022-09-01T00:00:00.000Z,NEFT CR-PYTM0123456-PAYTM PAYMENTS SERVI CES LIMITED-SLICK ORGANICS PVT LTD-PYTM2 22447630153,insurance,insurance,net_banking_transfer,11431.33
632ae6d52e1a0ebb7f46ffe0,50200023535069,49555.13,60ec41ba55c00300382672d9,HDFC,Revenue-Mktplace,5eecc6d6449e4f7cfb1c2708,2022-09-01T00:00:00.000Z,NEFT CR-DEUT0797BGL-MYNTRA DESIGNS PRIVA TE LIMITED-SLICK ORGANICS PVT. LTD.-2244 00477GN00167,shopping,,net_banking_transfer,5891.28
632ae6d52e1a0ebb7f46ffe2,50200023535069,62522.44,60ec41ba55c00300382672d9,HDFC,Revenue-Mktplace,5eecc6d6449e4f7cfb1c2708,2022-09-01T00:00:00.000Z,NEFT CR-DEUT0797BGL-MYNTRA DESIGNS PRIVA TE LIMITED-SLICK ORGANICS PVT. LTD.-2244 00481GN00040,shopping,,net_banking_transfer,12967.31
632ae6d52e1a0ebb7f46ffe4,50200023535069,99811.79,60ec41ba55c00300382672d9,HDFC,Revenue-PG-split enabled,5eecc6d6449e4f7cfb1c2708,2022-09-01T00:00:00.000Z,NEFT CR-UTIB0001506-RAZORPAY SOFTWARE PR IVATE LIMITED-SLICK ORGANICS PVT LITD-AX ISCN0163225997,insurance,insurance,net_banking_transfer,37289.35
632ae6d52e1a0ebb7f46ffe6,50200023535069,89811.79,60ec41ba55c00300382672d9,HDFC,Refund,5eecc6d6449e4f7cfb1c2708,2022-09-01T00:00:00.000Z,"NEFT DR-RATN0VAAPIS-RAZORPAY REFUND CRED ITS TOPUP-NETBANK, MUM-N244222099949923- 10000",,,net_banking_transfer,-10000
632ae6d62e1a0ebb7f46ffe8,50200023535069,90142.49,60ec41ba55c00300382672d9,HDFC,Transfer in/Revenue-other,5eecc6d6449e4f7cfb1c2708,2022-09-01T00:00:00.000Z,NEFT CR-UTIB0000114-ONE SIGMA TECHNOLOGI ES PRIVATE LIM-SLICK ORGANICS PRIVATE LI MITED-AXISP00316210342,insurance,insurance,net_banking_transfer,330.7
632ae6d62e1a0ebb7f46ffea,50200023535069,97021.2,60ec41ba55c00300382672d9,HDFC,Transfer in/Revenue-other,5eecc6d6449e4f7cfb1c2708,2022-09-01T00:00:00.000Z,NEFT CR-UTIB0000114-ONE SIGMA TECHNOLOGI ES PRIVATE LIM-SLICK ORGANICS PRIVATE LI MITED-AXISP00316210451,insurance,insurance,net_banking_transfer,6878.71
632ae6d62e1a0ebb7f46ffec,50200023535069,81021.2,60ec41ba55c00300382672d9,HDFC,direct expenses,5eecc6d6449e4f7cfb1c2708,2022-09-01T00:00:00.000Z,10691610000016-TPT-16000-SHIPRA SHARMA,,,net_banking_transfer,-16000
632ae6d62e1a0ebb7f46ffee,50200023535069,78651.2,60ec41ba55c00300382672d9,HDFC,direct expenses,5eecc6d6449e4f7cfb1c2708,2022-09-01T00:00:00.000Z,POS 514834XXXXXX9486 SMARTSHIFT LOGIS,,,debit_card,-2370
632ae6d62e1a0ebb7f46fff1,50200023535069,-87052.8,60ec41ba55c00300382672d9,HDFC,direct expenses,5eecc6d6449e4f7cfb1c2708,2022-09-01T00:00:00.000Z,"NEFT DR-UTIB0000119-SAFEXPRESS-NETBANK, MUM-N244222100106122-165704",,,net_banking_transfer,-165704
632ae6d62e1a0ebb7f46fff3,50200023535069,-88393.8,60ec41ba55c00300382672d9,HDFC,direct expenses,5eecc6d6449e4f7cfb1c2708,2022-09-01T00:00:00.000Z,POS 514834XXXXXX9486 SMARTSHIFT LOGIS,,,debit_card,-1341
632ae6d62e1a0ebb7f46fff6,50200023535069,-89750.8,60ec41ba55c00300382672d9,HDFC,direct expenses,5eecc6d6449e4f7cfb1c2708,2022-09-01T00:00:00.000Z,POS 514834XXXXXX9486 SMARTSHIFT LOGIS,,,debit_card,-1357
632ae6d62e1a0ebb7f46fff8,50200023535069,-189750.8,60ec41ba55c00300382672d9,HDFC,direct expenses,5eecc6d6449e4f7cfb1c2708,2022-09-01T00:00:00.000Z,NEFT DR-KKBK0000173-MATRIX PRINTING SOLU,,,net_banking_transfer,-100000
632ae6d62e1a0ebb7f46fffa,50200023535069,-189808.8,60ec41ba55c00300382672d9,HDFC,direct expenses,5eecc6d6449e4f7cfb1c2708,2022-09-01T00:00:00.000Z,POS 514834XXXXXX9486 SMARTSHIFT LOGIS,,,debit_card,-58
632ae6d62e1a0ebb7f46fffc,50200023535069,-689808.8,60ec41ba55c00300382672d9,HDFC,direct expenses,5eecc6d6449e4f7cfb1c2708,2022-09-01T00:00:00.000Z,05892560000649-TPT-500000-DECORPAC INDIA PRIVATE LIMITED,,,net_banking_transfer,-500000
632ae6d62e1a0ebb7f46ffff,50200023535069,-690773.8,60ec41ba55c00300382672d9,HDFC,direct expenses,5eecc6d6449e4f7cfb1c2708,2022-09-01T00:00:00.000Z,POS 514834XXXXXX9486 RAZ*SMARTSHIFT L,,,debit_card,-965
632ae6d62e1a0ebb7f470001,50200023535069,-705773.8,60ec41ba55c00300382672d9,HDFC,direct expenses,5eecc6d6449e4f7cfb1c2708,2022-09-01T00:00:00.000Z,"NEFT DR-ICIC0000314-UPASANA KOCHHAR-NETB ANK, MUM-N244222100315377-15000",,,net_banking_transfer,-15000
632ae6d62e1a0ebb7f470003,50200023535069,-702577.36,60ec41ba55c00300382672d9,HDFC,Revenue-PG-non-split,5eecc6d6449e4f7cfb1c2708,2022-09-01T00:00:00.000Z,NEFT CR-KKBK0000958-NODAL ACCOUNT BROKEN TUSK TECHNOL-SLICK ORGANICS PRIVATE LIMI TED-CMS2442224186793,insurance,insurance,net_banking_transfer,3196.44
632ae6d62e1a0ebb7f470005,50200023535069,-610013.81,60ec41ba55c00300382672d9,HDFC,Revenue-PG-non-split,5eecc6d6449e4f7cfb1c2708,2022-09-01T00:00:00.000Z,NEFT CR-KKBK0000958-NODAL ACCOUNT BROKEN TUSK TECHNOL-SLICK ORGANICS PRIVATE LIMI TED-CMS2442224186924,insurance,insurance,net_banking_transfer,92563.55
632ae6d62e1a0ebb7f470007,50200023535069,-610064.81,60ec41ba55c00300382672d9,HDFC,direct expenses,5eecc6d6449e4f7cfb1c2708,2022-09-01T00:00:00.000Z,POS 514834XXXXXX9486 SMARTSHIFT LOGIS,,,debit_card,-51
632ae6d62e1a0ebb7f470009,50200023535069,-607341.31,60ec41ba55c00300382672d9,HDFC,Revenue-PG-split enabled,5eecc6d6449e4f7cfb1c2708,2022-09-01T00:00:00.000Z,NEFT CR-UTIB0001506-RAZORPAY SOFTWARE PR IVATE LIMITED-SLICK ORGANICS PVT LITD-AX ISCN0163358032,insurance,insurance,net_banking_transfer,2723.5
632ae6d62e1a0ebb7f47000c,50200023535069,-607828.27,60ec41ba55c00300382672d9,HDFC,bank charges,5eecc6d6449e4f7cfb1c2708,2022-09-01T00:00:00.000Z,S0701 FB CHARGES 027FT01222420097,,,bank_charge,-486.96
632ae6d62e1a0ebb7f47000e,50200023535069,-607827.27,60ec41ba55c00300382672d9,HDFC,Transfer in/Revenue-other,5eecc6d6449e4f7cfb1c2708,2022-09-02T00:00:00.000Z,INT. ON SWCR ON-50300663920102,,,Other,1
632ae6d62e1a0ebb7f470010,50200023535069,-606486.27,60ec41ba55c00300382672d9,HDFC,Loan-in,5eecc6d6449e4f7cfb1c2708,2022-09-02T00:00:00.000Z,SWEEP-IN CREDIT - 50300663920102,,,self_transfer,1341
632ae6d62e1a0ebb7f470013,50200023535069,-606485.27,60ec41ba55c00300382672d9,HDFC,Transfer in/Revenue-other,5eecc6d6449e4f7cfb1c2708,2022-09-02T00:00:00.000Z,INT. ON SWCR ON-50300663920102,,,Other,1
632ae6d62e1a0ebb7f470016,50200023535069,-605128.27,60ec41ba55c00300382672d9,HDFC,Loan-in,5eecc6d6449e4f7cfb1c2708,2022-09-02T00:00:00.000Z,SWEEP-IN CREDIT - 50300663920102,,,self_transfer,1357
632ae6d62e1a0ebb7f470018,50200023535069,-605070.27,60ec41ba55c00300382672d9,HDFC,Loan-in,5eecc6d6449e4f7cfb1c2708,2022-09-02T00:00:00.000Z,SWEEP-IN CREDIT - 50300663920102,,,self_transfer,58
632ae6d62e1a0ebb7f47001a,50200023535069,-605069.27,60ec41ba55c00300382672d9,HDFC,Transfer in/Revenue-other,5eecc6d6449e4f7cfb1c2708,2022-09-02T00:00:00.000Z,INT. ON SWCR ON-50300663920102,,,Other,1
632ae6d62e1a0ebb7f47001c,50200023535069,-604104.27,60ec41ba55c00300382672d9,HDFC,Loan-in,5eecc6d6449e4f7cfb1c2708,2022-09-02T00:00:00.000Z,SWEEP-IN CREDIT - 50300663920102,,,self_transfer,965
632ae6d62e1a0ebb7f47001e,50200023535069,-604012.27,60ec41ba55c00300382672d9,HDFC,Transfer in/Revenue-other,5eecc6d6449e4f7cfb1c2708,2022-09-02T00:00:00.000Z,INT. ON SWCR ON-50300663920102,,,Other,92
632ae6d62e1a0ebb7f470020,50200023535069,-516959.27,60ec41ba55c00300382672d9,HDFC,Loan-in,5eecc6d6449e4f7cfb1c2708,2022-09-02T00:00:00.000Z,SWEEP-IN CREDIT - 50300663920102,,,self_transfer,87053
632ae6d62e1a0ebb7f470023,50200023535069,-516854.27,60ec41ba55c00300382672d9,HDFC,Transfer in/Revenue-other,5eecc6d6449e4f7cfb1c2708,2022-09-02T00:00:00.000Z,INT. ON SWCR ON-50300663920102,,,Other,105
632ae6d62e1a0ebb7f470025,50200023535069,-416854.27,60ec41ba55c00300382672d9,HDFC,Loan-in,5eecc6d6449e4f7cfb1c2708,2022-09-02T00:00:00.000Z,SWEEP-IN CREDIT - 50300663920102,,,self_transfer,100000
632ae6d62e1a0ebb7f470027,50200023535069,-416414.27,60ec41ba55c00300382672d9,HDFC,Transfer in/Revenue-other,5eecc6d6449e4f7cfb1c2708,2022-09-02T00:00:00.000Z,INT. ON SWCR ON-50300663920102,,,Other,440
632ae6d62e1a0ebb7f470029,50200023535069,440.73,60ec41ba55c00300382672d9,HDFC,Loan-in,5eecc6d6449e4f7cfb1c2708,2022-09-02T00:00:00.000Z,SWEEP-IN CREDIT - 50300663920102,,,self_transfer,416855
632ae6d62e1a0ebb7f47002b,50200023535069,13152.23,60ec41ba55c00300382672d9,HDFC,Revenue-PG-non-split,5eecc6d6449e4f7cfb1c2708,2022-09-02T00:00:00.000Z,NEFT CR-PYTM0123456-PAYTM PAYMENTS SERVI,ewallet,,net_banking_transfer,12711.5
632ae6d62e1a0ebb7f47002d,50200023535069,15413.89,60ec41ba55c00300382672d9,HDFC,Revenue-Mktplace,5eecc6d6449e4f7cfb1c2708,2022-09-02T00:00:00.000Z,NEFT CR-DEUT0797BGL-MYNTRA DESIGNS PRIVA TE LIMITED-SLICK ORGANICS PVT. LTD.-2245 00178GN00141,shopping,,net_banking_transfer,2261.66
632ae6d62e1a0ebb7f47002f,50200023535069,13483.82,60ec41ba55c00300382672d9,HDFC,direct expenses,5eecc6d6449e4f7cfb1c2708,2022-09-02T00:00:00.000Z,POS 514834XXXXXX9486 AMZ*MARKETING SV,,,debit_card,-1930.07
632ae6d62e1a0ebb7f470031,50200023535069,16306.38,60ec41ba55c00300382672d9,HDFC,Revenue-Mktplace,5eecc6d6449e4f7cfb1c2708,2022-09-02T00:00:00.000Z,NEFT CR-DEUT0797BGL-MYNTRA DESIGNS PRIVA TE LIMITED-SLICK ORGANICS PVT. LTD.-2245 00194GN00065,shopping,,net_banking_transfer,2822.56
632ae6d62e1a0ebb7f470033,50200023535069,26183.09,60ec41ba55c00300382672d9,HDFC,Revenue-PG-split enabled,5eecc6d6449e4f7cfb1c2708,2022-09-02T00:00:00.000Z,NEFT CR-UTIB0001506-RAZORPAY SOFTWARE PR IVATE LIMITED-SLICK ORGANICS PVT LITD-AX ISCN0163440124,insurance,insurance,net_banking_transfer,9876.71
632ae6d62e1a0ebb7f470036,50200023535069,23478.09,60ec41ba55c00300382672d9,HDFC,direct expenses,5eecc6d6449e4f7cfb1c2708,2022-09-02T00:00:00.000Z,"NEFT DR-UTIB0CCH274-GO DIGIT GENERAL INS URANCE LIMITED-NETBANK, MUM-N24522210145 4368-2705",insurance,insurance,net_banking_transfer,-2705
632ae6d62e1a0ebb7f470038,50200023535069,1628.09,60ec41ba55c00300382672d9,HDFC,direct expenses,5eecc6d6449e4f7cfb1c2708,2022-09-02T00:00:00.000Z,"NEFT DR-KKBK0000173-NITISH KUMAR MANDAL- NETBANK, MUM-N245222101461272-21850",,,net_banking_transfer,-21850
632ae6d62e1a0ebb7f47003a,50200023535069,1306.09,60ec41ba55c00300382672d9,HDFC,direct expenses,5eecc6d6449e4f7cfb1c2708,2022-09-02T00:00:00.000Z,"NEFT DR-SIBL0000555-JAIVEER KUMAR-NETBAN K, MUM-N245222101465179-322",,,net_banking_transfer,-322
632ae6d62e1a0ebb7f47003c,50200023535069,71545.46,60ec41ba55c00300382672d9,HDFC,Revenue-Mktplace,5eecc6d6449e4f7cfb1c2708,2022-09-02T00:00:00.000Z,NEFT CR-DEUT0797BGL-FLIPKART INTERNET PR IVATE LIMITED-SLICK ORGANICS PVT LTD-224 402091GN00034,shopping,,net_banking_transfer,70239.37
632ae6d62e1a0ebb7f47003e,50200023535069,-22825.54,60ec41ba55c00300382672d9,HDFC,direct expenses,5eecc6d6449e4f7cfb1c2708,2022-09-02T00:00:00.000Z,"NEFT DR-ICIC0006643-KRISHNA PACKAGING CO MPANY-NETBANK, MUM-N245222101716576-9437 1",,,net_banking_transfer,-94371
632ae6d62e1a0ebb7f470040,50200023535069,-29305.54,60ec41ba55c00300382672d9,HDFC,direct expenses,5eecc6d6449e4f7cfb1c2708,2022-09-02T00:00:00.000Z,50200016295776-TPT-6480-V KESHRI AND ASS OCIATES,,,net_banking_transfer,-6480
632ae6d62e1a0ebb7f470042,50200023535069,-79305.54,60ec41ba55c00300382672d9,HDFC,direct expenses,5eecc6d6449e4f7cfb1c2708,2022-09-02T00:00:00.000Z,02712120000086-TPT-50000-SPOTON LOGISTIC S PVT LTD,,,net_banking_transfer,-50000
632ae6d62e1a0ebb7f470044,50200023535069,-80460.54,60ec41ba55c00300382672d9,HDFC,direct expenses,5eecc6d6449e4f7cfb1c2708,2022-09-02T00:00:00.000Z,POS 514834XXXXXX9486 SMARTSHIFT LOGIS,,,debit_card,-1155
632ae6d62e1a0ebb7f470046,50200023535069,-79503.4,60ec41ba55c00300382672d9,HDFC,Transfer in/Revenue-other,5eecc6d6449e4f7cfb1c2708,2022-09-02T00:00:00.000Z,NEFT CR-UTIB0000114-ONE SIGMA TECHNOLOGI,,,net_banking_transfer,957.14
632ae6d62e1a0ebb7f470048,50200023535069,-291853.4,60ec41ba55c00300382672d9,HDFC,direct expenses,5eecc6d6449e4f7cfb1c2708,2022-09-02T00:00:00.000Z,"NEFT DR-SBIN0011783-GALACTIC GRIP-NETBAN K, MUM-N245222101918694-212350",,,net_banking_transfer,-212350
632ae6d62e1a0ebb7f47004a,50200023535069,-423375.4,60ec41ba55c00300382672d9,HDFC,direct expenses,5eecc6d6449e4f7cfb1c2708,2022-09-02T00:00:00.000Z,"NEFT DR-PUNB0100110-KRAUTER HEALTHCARE L TD-NETBANK, MUM-N245222101932806-131522",,,net_banking_transfer,-131522
632ae6d62e1a0ebb7f47004c,50200023535069,-390900.36,60ec41ba55c00300382672d9,HDFC,Revenue-PG-non-split,5eecc6d6449e4f7cfb1c2708,2022-09-02T00:00:00.000Z,NEFT CR-KKBK0000958-NODAL ACCOUNT BROKEN TUSK TECHNOL-SLICK ORGANICS PRIVATE LIMI TED-CMS2452224307338,insurance,insurance,net_banking_transfer,32475.04
632ae6d62e1a0ebb7f47004e,50200023535069,-394659.12,60ec41ba55c00300382672d9,HDFC,SAAS/tech expense,5eecc6d6449e4f7cfb1c2708,2022-09-02T00:00:00.000Z,POS 514834XXXXXX9486 AMAZON.COM,shopping,,debit_card,-3758.76
632ae6d62e1a0ebb7f470050,50200023535069,-395737.12,60ec41ba55c00300382672d9,HDFC,direct expenses,5eecc6d6449e4f7cfb1c2708,2022-09-02T00:00:00.000Z,POS 514834XXXXXX9486 SMARTSHIFT LOGIS,,,debit_card,-1078
632ae6d62e1a0ebb7f470053,50200023535069,-359286.51,60ec41ba55c00300382672d9,HDFC,Revenue-COD,5eecc6d6449e4f7cfb1c2708,2022-09-02T00:00:00.000Z,NEFT CR-ICIC0000155-SHIPROCKET COD CRF I D 4840961-SLICK ORGANICS PVT LTD-CMS2805 962124,insurance,insurance,net_banking_transfer,36450.61
632ae6d62e1a0ebb7f470055,50200023535069,-356475.73,60ec41ba55c00300382672d9,HDFC,Revenue-UPI,5eecc6d6449e4f7cfb1c2708,2022-09-02T00:00:00.000Z,UPI-GOKWIK-GOKWIK@YESBANK-YESB0000340-22 4590165042-PAYOUT FOR AUGUST,,,upi,2810.78
632ae6d62e1a0ebb7f470057,50200023535069,-350650.2,60ec41ba55c00300382672d9,HDFC,Revenue-PG-split enabled,5eecc6d6449e4f7cfb1c2708,2022-09-02T00:00:00.000Z,NEFT CR-UTIB0001506-RAZORPAY SOFTWARE PR IVATE LIMITED-SLICK ORGANICS PVT LITD-AX ISCN0163632321,insurance,insurance,net_banking_transfer,5825.53
632ae6d62e1a0ebb7f470059,50200023535069,-350649.2,60ec41ba55c00300382672d9,HDFC,Transfer in/Revenue-other,5eecc6d6449e4f7cfb1c2708,2022-09-03T00:00:00.000Z,INT. ON SWCR ON-50300663920102,,,Other,1
632ae6d62e1a0ebb7f47005b,50200023535069,-349494.2,60ec41ba55c00300382672d9,HDFC,Loan-in,5eecc6d6449e4f7cfb1c2708,2022-09-03T00:00:00.000Z,SWEEP-IN CREDIT - 50300663920102,,,self_transfer,1155
632ae6d62e1a0ebb7f47005d,50200023535069,-349469.2,60ec41ba55c00300382672d9,HDFC,Transfer in/Revenue-other,5eecc6d6449e4f7cfb1c2708,2022-09-03T00:00:00.000Z,INT. ON SWCR ON-50300663920102,,,Other,25
632ae6d62e1a0ebb7f47005f,50200023535069,-326643.2,60ec41ba55c00300382672d9,HDFC,Loan-in,5eecc6d6449e4f7cfb1c2708,2022-09-03T00:00:00.000Z,SWEEP-IN CREDIT - 50300663920102,,,self_transfer,22826
632ae6d62e1a0ebb7f470061,50200023535069,-326636.2,60ec41ba55c00300382672d9,HDFC,Transfer in/Revenue-other,5eecc6d6449e4f7cfb1c2708,2022-09-03T00:00:00.000Z,INT. ON SWCR ON-50300663920102,,,Other,7
632ae6d62e1a0ebb7f470063,50200023535069,-320156.2,60ec41ba55c00300382672d9,HDFC,Loan-in,5eecc6d6449e4f7cfb1c2708,2022-09-03T00:00:00.000Z,SWEEP-IN CREDIT - 50300663920102,,,self_transfer,6480
632ae6d62e1a0ebb7f470065,50200023535069,-320101.2,60ec41ba55c00300382672d9,HDFC,Transfer in/Revenue-other,5eecc6d6449e4f7cfb1c2708,2022-09-03T00:00:00.000Z,INT. ON SWCR ON-50300663920102,,,Other,55
632ae6d62e1a0ebb7f470067,50200023535069,-270101.2,60ec41ba55c00300382672d9,HDFC,Loan-in,5eecc6d6449e4f7cfb1c2708,2022-09-03T00:00:00.000Z,SWEEP-IN CREDIT - 50300663920102,,,self_transfer,50000
632ae6d62e1a0ebb7f470069,50200023535069,-269868.2,60ec41ba55c00300382672d9,HDFC,Transfer in/Revenue-other,5eecc6d6449e4f7cfb1c2708,2022-09-03T00:00:00.000Z,INT. ON SWCR ON-50300663920102,,,Other,233
632ae6d62e1a0ebb7f47006b,50200023535069,-58475.2,60ec41ba55c00300382672d9,HDFC,Loan-in,5eecc6d6449e4f7cfb1c2708,2022-09-03T00:00:00.000Z,SWEEP-IN CREDIT - 50300663920102,,,self_transfer,211393
632ae6d62e1a0ebb7f47006d,50200023535069,-58411.2,60ec41ba55c00300382672d9,HDFC,Transfer in/Revenue-other,5eecc6d6449e4f7cfb1c2708,2022-09-03T00:00:00.000Z,INT. ON SWCR ON-50300663920102,,,Other,64
632ae6d62e1a0ebb7f47006f,50200023535069,64.8,60ec41ba55c00300382672d9,HDFC,Loan-in,5eecc6d6449e4f7cfb1c2708,2022-09-03T00:00:00.000Z,SWEEP-IN CREDIT - 50300663920102,,,self_transfer,58476
632ae6d62e1a0ebb7f470071,50200023535069,15232.53,60ec41ba55c00300382672d9,HDFC,Revenue-PG-non-split,5eecc6d6449e4f7cfb1c2708,2022-09-03T00:00:00.000Z,NEFT CR-PYTM0123456-PAYTM PAYMENTS SERVI,ewallet,,net_banking_transfer,15167.73
632ae6d62e1a0ebb7f470073,50200023535069,23286.84,60ec41ba55c00300382672d9,HDFC,Revenue-PG-split enabled,5eecc6d6449e4f7cfb1c2708,2022-09-03T00:00:00.000Z,NEFT CR-UTIB0001506-RAZORPAY SOFTWARE PR IVATE LIMITED-SLICK ORGANICS PVT LITD-AX ISCN0163680601,insurance,insurance,net_banking_transfer,8054.31
632ae6d62e1a0ebb7f470075,50200023535069,41087.4,60ec41ba55c00300382672d9,HDFC,Revenue-PG-non-split,5eecc6d6449e4f7cfb1c2708,2022-09-03T00:00:00.000Z,NEFT CR-KKBK0000958-NODAL ACCOUNT BROKEN TUSK TECHNOL-SLICK ORGANICS PRIVATE LIMI TED-CMS2462224400164,insurance,insurance,net_banking_transfer,17800.56
632ae6d62e1a0ebb7f470077,50200023535069,79303.85,60ec41ba55c00300382672d9,HDFC,Revenue-PG-non-split,5eecc6d6449e4f7cfb1c2708,2022-09-03T00:00:00.000Z,NEFT CR-KKBK0000958-NODAL ACCOUNT BROKEN TUSK TECHNOL-SLICK ORGANICS PRIVATE LIMI TED-CMS2462224404990,insurance,insurance,net_banking_transfer,38216.45
632ae6d62e1a0ebb7f47007a,50200023535069,-207467.15,60ec41ba55c00300382672d9,HDFC,direct expenses,5eecc6d6449e4f7cfb1c2708,2022-09-03T00:00:00.000Z,"NEFT DR-PUNB0100110-KRAUTER HEALTHCARE L TD-NETBANK, MUM-N246222103482265-286771",,,net_banking_transfer,-286771
632ae6d62e1a0ebb7f47007c,50200023535069,-207512.15,60ec41ba55c00300382672d9,HDFC,direct expenses,5eecc6d6449e4f7cfb1c2708,2022-09-03T00:00:00.000Z,CVC2324674087604 GOODS AND SERVICE TAX02 -CVC2324674087604,,,Other,-45
632ae6d62e1a0ebb7f47007f,50200023535069,-204792.88,60ec41ba55c00300382672d9,HDFC,Revenue-PG-split enabled,5eecc6d6449e4f7cfb1c2708,2022-09-03T00:00:00.000Z,NEFT CR-UTIB0001506-RAZORPAY SOFTWARE PR IVATE LIMITED-SLICK ORGANICS PVT LITD-AX ISCN0163785252,insurance,insurance,net_banking_transfer,2719.27
632ae6d62e1a0ebb7f470081,50200023535069,-168331.88,60ec41ba55c00300382672d9,HDFC,Revenue-Mktplace,5eecc6d6449e4f7cfb1c2708,2022-09-03T00:00:00.000Z,NEFT CR-KKBK0000958-THREPSI SOLUTIONS PV T LTD CHENNAI-SLICK ORGANICS PRIVATE LI MITED-KKBK222464511716,insurance,insurance,net_banking_transfer,36461
632ae6d72e1a0ebb7f470083,50200023535069,-131988.88,60ec41ba55c00300382672d9,HDFC,Transfer in/Revenue-other,5eecc6d6449e4f7cfb1c2708,2022-09-03T00:00:00.000Z,FT- REMITTANCE OG JUL22-50200050675669 - HOUZ OF NATURE PVT LTD -,,,Other,36343
632ae6d72e1a0ebb7f470085,50200023535069,-131836.88,60ec41ba55c00300382672d9,HDFC,Transfer in/Revenue-other,5eecc6d6449e4f7cfb1c2708,2022-09-04T00:00:00.000Z,INT. ON SWCR ON-50300663920102,,,Other,152
632ae6d72e1a0ebb7f470087,50200023535069,152.12,60ec41ba55c00300382672d9,HDFC,Loan-in,5eecc6d6449e4f7cfb1c2708,2022-09-04T00:00:00.000Z,SWEEP-IN CREDIT - 50300663920102,,,self_transfer,131989
632ae6d72e1a0ebb7f47008b,50200023535069,11459.4,60ec41ba55c00300382672d9,HDFC,Revenue-PG-non-split,5eecc6d6449e4f7cfb1c2708,2022-09-04T00:00:00.000Z,NEFT CR-PYTM0123456-PAYTM PAYMENTS SERVI CES LIMITED-SLICK ORGANICS PVT LTD-PYTM2 22472227139,insurance,insurance,net_banking_transfer,11307.28
632ae6d72e1a0ebb7f47008d,50200023535069,-88725.6,60ec41ba55c00300382672d9,HDFC,direct expenses,5eecc6d6449e4f7cfb1c2708,2022-09-04T00:00:00.000Z,"NEFT DR-UTIB0000119-SAFEXPRESS-NETBANK, MUM-N247222104362917-100185",,,net_banking_transfer,-100185
632ae6d72e1a0ebb7f47008f,50200023535069,-88619.6,60ec41ba55c00300382672d9,HDFC,Transfer in/Revenue-other,5eecc6d6449e4f7cfb1c2708,2022-09-05T00:00:00.000Z,INT. ON SWCR ON-50300663920102,,,Other,106
632ae6d72e1a0ebb7f470092,50200023535069,106.4,60ec41ba55c00300382672d9,HDFC,Loan-in,5eecc6d6449e4f7cfb1c2708,2022-09-05T00:00:00.000Z,SWEEP-IN CREDIT - 50300663920102,,,self_transfer,88726
632ae6d72e1a0ebb7f470094,50200023535069,11745.71,60ec41ba55c00300382672d9,HDFC,Revenue-Mktplace,5eecc6d6449e4f7cfb1c2708,2022-09-05T00:00:00.000Z,NEFT CR-DEUT0797BGL-FLIPKART INTERNET PR,shopping,,net_banking_transfer,11639.31
632ae6d72e1a0ebb7f470096,50200023535069,25022.89,60ec41ba55c00300382672d9,HDFC,Revenue-PG-non-split,5eecc6d6449e4f7cfb1c2708,2022-09-05T00:00:00.000Z,NEFT CR-PYTM0123456-PAYTM PAYMENTS SERVI CES LIMITED-SLICK ORGANICS PVT LTD-PYTM2 22484163909,insurance,insurance,net_banking_transfer,13277.18
632ae6d72e1a0ebb7f470098,50200023535069,33635.14,60ec41ba55c00300382672d9,HDFC,Revenue-Mktplace,5eecc6d6449e4f7cfb1c2708,2022-09-05T00:00:00.000Z,NEFT CR-DEUT0797BGL-MYNTRA DESIGNS PRIVA TE LIMITED-SLICK ORGANICS PVT. LTD.-2248 00726GN00158,shopping,,net_banking_transfer,8612.25
632ae6d72e1a0ebb7f47009a,50200023535069,55801.69,60ec41ba55c00300382672d9,HDFC,Revenue-Mktplace,5eecc6d6449e4f7cfb1c2708,2022-09-05T00:00:00.000Z,NEFT CR-DEUT0797BGL-MYNTRA DESIGNS PRIVA TE LIMITED-SLICK ORGANICS PVT. LTD.-2248 00738GN00052,shopping,,net_banking_transfer,22166.55
632ae6d72e1a0ebb7f47009c,50200023535069,86337.73,60ec41ba55c00300382672d9,HDFC,Revenue-PG-split enabled,5eecc6d6449e4f7cfb1c2708,2022-09-05T00:00:00.000Z,NEFT CR-UTIB0001506-RAZORPAY SOFTWARE PR IVATE LIMITED-SLICK ORGANICS PVT LITD-AX ISCN0163926808,insurance,insurance,net_banking_transfer,30536.04
632ae6d72e1a0ebb7f47009e,50200023535069,5086337.73,60ec41ba55c00300382672d9,HDFC,Internal Transfers,5eecc6d6449e4f7cfb1c2708,2022-09-05T00:00:00.000Z,IB FUNDS TRANSFER CR-50200035187206 -SL ICK ORGANICS PVT LTD,insurance,insurance,Other,5000000
632ae6d72e1a0ebb7f4700a0,50200023535069,3812645.73,60ec41ba55c00300382672d9,HDFC,direct expenses,5eecc6d6449e4f7cfb1c2708,2022-09-05T00:00:00.000Z,"NEFT DR-ICIC0000024-TAKE MOTO YOHKI INDI A PRIVATE LIMITED-NETBANK, MUM-N24822210 4748176-1273692",travel,,net_banking_transfer,-1273692
632ae6d72e1a0ebb7f4700a2,50200023535069,3312645.73,60ec41ba55c00300382672d9,HDFC,direct expenses,5eecc6d6449e4f7cfb1c2708,2022-09-05T00:00:00.000Z,"NEFT DR-PUNB0100110-KRAUTER HEALTHCARE L TD-NETBANK, MUM-N248222104749348-500000",,,net_banking_transfer,-500000
632ae6d72e1a0ebb7f4700a4,50200023535069,3325845.73,60ec41ba55c00300382672d9,HDFC,Revenue-Mktplace,5eecc6d6449e4f7cfb1c2708,2022-09-05T00:00:00.000Z,NEFT CR-ICIC0000104-MANASH LIFESTYLE PRI VATE LIMITED-SLICK ORGANICS PRIVATE LIMI TED MP MUM-CMS2806503777,shopping,,net_banking_transfer,13200
632ae6d72e1a0ebb7f4700a6,50200023535069,4567179.51,60ec41ba55c00300382672d9,HDFC,Revenue-Mktplace,5eecc6d6449e4f7cfb1c2708,2022-09-05T00:00:00.000Z,NEFT CR-KKBK0000958-NYKAA E RETAIL PRIVA TE LIMITED NYKAA-SLICK ORGANICS PVT LTD- KKBK222484827869,insurance,insurance,net_banking_transfer,1241333.78
632ae6d72e1a0ebb7f4700a8,50200023535069,16137433.51,60ec41ba55c00300382672d9,HDFC,Internal Transfers,5eecc6d6449e4f7cfb1c2708,2022-09-05T00:00:00.000Z,IB FUNDS TRANSFER CR-50200035187206 -SL ICK ORGANICS PVT LTD,insurance,insurance,Other,11570254
632ae6d72e1a0ebb7f4700aa,50200023535069,16143215.73,60ec41ba55c00300382672d9,HDFC,Revenue-PG-non-split,5eecc6d6449e4f7cfb1c2708,2022-09-05T00:00:00.000Z,NEFT CR-SCBL0036001-STRIPE INDIA PRIVATE LIMITED-SLICK ORGANICS PRIVATE LIMITED- IN1ON22090500NAH,insurance,insurance,net_banking_transfer,5782.22
632ae6d72e1a0ebb7f4700ac,50200023535069,16111215.73,60ec41ba55c00300382672d9,HDFC,direct expenses,5eecc6d6449e4f7cfb1c2708,2022-09-05T00:00:00.000Z,NEFT DR-HSBC0400004-A LITTLE FLY-NETBANK,,,net_banking_transfer,-32000
632ae6d72e1a0ebb7f4700ae,50200023535069,16110259.73,60ec41ba55c00300382672d9,HDFC,direct expenses,5eecc6d6449e4f7cfb1c2708,2022-09-05T00:00:00.000Z,POS 514834XXXXXX9486 SMARTSHIFT LOGIS,,,debit_card,-956
632ae6d72e1a0ebb7f4700b0,50200023535069,16111025.57,60ec41ba55c00300382672d9,HDFC,Transfer in/Revenue-other,5eecc6d6449e4f7cfb1c2708,2022-09-05T00:00:00.000Z,NEFT CR-UTIB0000114-ONE SIGMA TECHNOLOGI ES PRIVATE LIM-SLICK ORGANICS PRIVATE LI MITED-AXISP00317253263,insurance,insurance,net_banking_transfer,765.84
632ae6d72e1a0ebb7f4700b2,50200023535069,16113633.45,60ec41ba55c00300382672d9,HDFC,Transfer in/Revenue-other,5eecc6d6449e4f7cfb1c2708,2022-09-05T00:00:00.000Z,NEFT CR-UTIB0000114-ONE SIGMA TECHNOLOGI ES PRIVATE LIM-SLICK ORGANICS PRIVATE LI MITED-AXISP00317253455,insurance,insurance,net_banking_transfer,2607.88
632ae6d72e1a0ebb7f4700b4,50200023535069,16117295.26,60ec41ba55c00300382672d9,HDFC,Transfer in/Revenue-other,5eecc6d6449e4f7cfb1c2708,2022-09-05T00:00:00.000Z,NEFT CR-UTIB0000114-ONE SIGMA TECHNOLOGI ES PRIVATE LIM-SLICK ORGANICS PRIVATE LI MITED-AXISP00317253210,insurance,insurance,net_banking_transfer,3661.81
632ae6d72e1a0ebb7f4700b6,50200023535069,16116996.26,60ec41ba55c00300382672d9,HDFC,SAAS/tech expense,5eecc6d6449e4f7cfb1c2708,2022-09-05T00:00:00.000Z,POS 514834XXXXXX9486 AMAZON,shopping,,debit_card,-299
632ae6d72e1a0ebb7f4700b9,50200023535069,16120406.56,60ec41ba55c00300382672d9,HDFC,Revenue-PG-non-split,5eecc6d6449e4f7cfb1c2708,2022-09-05T00:00:00.000Z,NEFT CR-KKBK0000958-NODAL ACCOUNT BROKEN TUSK TECHNOL-SLICK ORGANICS PRIVATE LIMI TED-CMS2482224541433,insurance,insurance,net_banking_transfer,3410.3
632ae6d72e1a0ebb7f4700bb,50200023535069,16175056.21,60ec41ba55c00300382672d9,HDFC,Revenue-PG-non-split,5eecc6d6449e4f7cfb1c2708,2022-09-05T00:00:00.000Z,NEFT CR-KKBK0000958-NODAL ACCOUNT BROKEN TUSK TECHNOL-SLICK ORGANICS PRIVATE LIMI TED-CMS2482224548261,insurance,insurance,net_banking_transfer,54649.65
632ae6d72e1a0ebb7f4700bd,50200023535069,16155056.21,60ec41ba55c00300382672d9,HDFC,direct expenses,5eecc6d6449e4f7cfb1c2708,2022-09-05T00:00:00.000Z,"NEFT DR-CBIN0280291-SAURABH BHILWARA-NET BANK, MUM-N248222105269164-20000",,,net_banking_transfer,-20000
632ae6d72e1a0ebb7f4700bf,50200023535069,16154165.21,60ec41ba55c00300382672d9,HDFC,direct expenses,5eecc6d6449e4f7cfb1c2708,2022-09-05T00:00:00.000Z,POS 514834XXXXXX9486 SMARTSHIFT LOGIS,,,debit_card,-891
632ae6d72e1a0ebb7f4700c1,50200023535069,16162679.08,60ec41ba55c00300382672d9,HDFC,Revenue-PG-split enabled,5eecc6d6449e4f7cfb1c2708,2022-09-05T00:00:00.000Z,NEFT CR-UTIB0001506-RAZORPAY SOFTWARE PR IVATE LIMITED-SLICK ORGANICS PVT LITD-AX ISCN0164119009,insurance,insurance,net_banking_transfer,8513.87
632ae6d72e1a0ebb7f4700c3,50200023535069,16173807.7,60ec41ba55c00300382672d9,HDFC,Revenue-COD,5eecc6d6449e4f7cfb1c2708,2022-09-05T00:00:00.000Z,NEFT CR-ICIC0000155-SHIPROCKET COD CRF I D 4849100-SLICK ORGANICS PVT LTD-CMS2810 612343,insurance,insurance,net_banking_transfer,11128.62
632ae6d72e1a0ebb7f4700c5,50200023535069,16180943.4,60ec41ba55c00300382672d9,HDFC,Revenue-PG-non-split,5eecc6d6449e4f7cfb1c2708,2022-09-06T00:00:00.000Z,NEFT CR-PYTM0123456-PAYTM PAYMENTS SERVI CES LIMITED-SLICK ORGANICS PVT LTD-PYTM2 22495505939,insurance,insurance,net_banking_transfer,7135.7
632ae6d72e1a0ebb7f4700c7,50200023535069,16360780.71,60ec41ba55c00300382672d9,HDFC,Revenue-Mktplace,5eecc6d6449e4f7cfb1c2708,2022-09-06T00:00:00.000Z,IMPS-224905081483-AMAZON SELLER SERVIC-H,shopping,,net_banking_transfer,179837.31
632ae6d72e1a0ebb7f4700c9,50200023535069,15860780.71,60ec41ba55c00300382672d9,HDFC,direct expenses,5eecc6d6449e4f7cfb1c2708,2022-09-06T00:00:00.000Z,05892560000649-TPT-500000-DECORPAC INDIA PRIVATE LIMITED,,,net_banking_transfer,-500000
632ae6d72e1a0ebb7f4700cb,50200023535069,15360780.71,60ec41ba55c00300382672d9,HDFC,direct expenses,5eecc6d6449e4f7cfb1c2708,2022-09-06T00:00:00.000Z,"NEFT DR-ICIC0000369-BO INTERNATIONAL-NET BANK, MUM-N249222106733147-500000",,,net_banking_transfer,-500000
632ae6d72e1a0ebb7f4700cd,50200023535069,15377417.6,60ec41ba55c00300382672d9,HDFC,Revenue-PG-split enabled,5eecc6d6449e4f7cfb1c2708,2022-09-06T00:00:00.000Z,NEFT CR-UTIB0001506-RAZORPAY SOFTWARE PR IVATE LIMITED-SLICK ORGANICS PVT LITD-AX ISCN0164208332,insurance,insurance,net_banking_transfer,16636.89
632ae6d72e1a0ebb7f4700cf,50200023535069,14877417.6,60ec41ba55c00300382672d9,HDFC,direct expenses,5eecc6d6449e4f7cfb1c2708,2022-09-06T00:00:00.000Z,"NEFT DR-KKBK0000180-VEDIC COSMECEUTICALS PVT LTD-NETBANK, MUM-N249222106880443-5 00000",,,net_banking_transfer,-500000
632ae6d72e1a0ebb7f4700d2,50200023535069,15337575.15,60ec41ba55c00300382672d9,HDFC,Revenue-Mktplace,5eecc6d6449e4f7cfb1c2708,2022-09-06T00:00:00.000Z,NEFT CR-DEUT0797BGL-AMAZON PAY (INDIA) P RIVATE LIMITED-SLICK ORGANICS PVT LTD-22 4900110GN00497,shopping,,net_banking_transfer,460157.55
632ae6d72e1a0ebb7f4700d4,50200023535069,15037575.15,60ec41ba55c00300382672d9,HDFC,direct expenses,5eecc6d6449e4f7cfb1c2708,2022-09-06T00:00:00.000Z,"NEFT DR-ICIC0006566-MARKETING MANTRA-NET BANK, MUM-N249222106881355-300000",,,net_banking_transfer,-300000
632ae6d72e1a0ebb7f4700d6,50200023535069,14844241.15,60ec41ba55c00300382672d9,HDFC,direct expenses,5eecc6d6449e4f7cfb1c2708,2022-09-06T00:00:00.000Z,"NEFT DR-KKBK0004581-MJ GLOBAL PVT LTD-NE TBANK, MUM-N249222106900685-193334",,,net_banking_transfer,-193334
632ae6d72e1a0ebb7f4700d8,50200023535069,14553758.15,60ec41ba55c00300382672d9,HDFC,direct expenses,5eecc6d6449e4f7cfb1c2708,2022-09-06T00:00:00.000Z,"NEFT DR-SCBL0036031-PR PUNDIT PUBLIC REL ATIONS PRIVATE LIMIT-NETBANK, MUM-N24922 2106998590-290483",insurance,insurance,net_banking_transfer,-290483
632ae6d72e1a0ebb7f4700da,50200023535069,14552686.15,60ec41ba55c00300382672d9,HDFC,direct expenses,5eecc6d6449e4f7cfb1c2708,2022-09-06T00:00:00.000Z,POS 514834XXXXXX9486 SMARTSHIFT LOGIS,,,debit_card,-1072
632ae6d72e1a0ebb7f4700dc,50200023535069,14588352.66,60ec41ba55c00300382672d9,HDFC,Revenue-PG-non-split,5eecc6d6449e4f7cfb1c2708,2022-09-06T00:00:00.000Z,NEFT CR-KKBK0000958-NODAL ACCOUNT BROKEN TUSK TECHNOL-SLICK ORGANICS PRIVATE LIMI TED-CMS2492224675548,insurance,insurance,net_banking_transfer,35666.51
632ae6d72e1a0ebb7f4700e2,50200023535069,14590196.87,60ec41ba55c00300382672d9,HDFC,Transfer in/Revenue-other,5eecc6d6449e4f7cfb1c2708,2022-09-06T00:00:00.000Z,NEFT CR-UTIB0000114-ONE SIGMA TECHNOLOGI ES PRIVATE LIM-SLICK ORGANICS PRIVATE LI MITED-AXISP00317654387,insurance,insurance,net_banking_transfer,1844.21
632ae6d72e1a0ebb7f4700e4,50200023535069,14240196.87,60ec41ba55c00300382672d9,HDFC,direct expenses,5eecc6d6449e4f7cfb1c2708,2022-09-06T00:00:00.000Z,57500000443889-TPT-350000-WEBKLIPPER TEC HNOLOGIES PRIVATE LIMITED,,,net_banking_transfer,-350000
632ae6d72e1a0ebb7f4700e6,50200023535069,13240196.87,60ec41ba55c00300382672d9,HDFC,Tax,5eecc6d6449e4f7cfb1c2708,2022-09-06T00:00:00.000Z,051030806092252434- CBDT TAX,,,Other,-1000000
632ae6d72e1a0ebb7f4700e8,50200023535069,3240196.87,60ec41ba55c00300382672d9,HDFC,direct expenses,5eecc6d6449e4f7cfb1c2708,2022-09-06T00:00:00.000Z,FD BOOKED - 50300675642152 : SLICK ORGAN,insurance,insurance,investment,-10000000
632ae6d72e1a0ebb7f4700eb,50200023535069,3243560.87,60ec41ba55c00300382672d9,HDFC,Revenue-Mktplace,5eecc6d6449e4f7cfb1c2708,2022-09-06T00:00:00.000Z,NEFT CR-SCBL0036001-DREAMPLUG TECHNOLOGI ES PRIVATE LIMITED-SLICK ORGANICS PRIVAT E LIMITEDSLICK-IN1ON22090609GI0,,,net_banking_transfer,3364
632ae6d72e1a0ebb7f4700ed,50200023535069,3260468.8,60ec41ba55c00300382672d9,HDFC,Revenue-PG-split enabled,5eecc6d6449e4f7cfb1c2708,2022-09-06T00:00:00.000Z,NEFT CR-UTIB0001506-RAZORPAY SOFTWARE PR IVATE LIMITED-SLICK ORGANICS PVT LITD-AX ISCN0164348367,insurance,insurance,net_banking_transfer,16907.93
632ae6d72e1a0ebb7f4700ef,50200023535069,3197968.8,60ec41ba55c00300382672d9,HDFC,direct expenses,5eecc6d6449e4f7cfb1c2708,2022-09-07T00:00:00.000Z,50100064106714 NET BANKING SI -62500,,,Other,-62500
632ae6d72e1a0ebb7f4700f1,50200023535069,3147968.8,60ec41ba55c00300382672d9,HDFC,direct expenses,5eecc6d6449e4f7cfb1c2708,2022-09-07T00:00:00.000Z,50100108772229 NET BANKING SI -50000,,,Other,-50000
632ae6d72e1a0ebb7f4700f3,50200023535069,3088838.8,60ec41ba55c00300382672d9,HDFC,direct expenses,5eecc6d6449e4f7cfb1c2708,2022-09-07T00:00:00.000Z,50100349886722 NET BANKING SI -59130,,,Other,-59130
632ae6d72e1a0ebb7f4700f5,50200023535069,3032673.8,60ec41ba55c00300382672d9,HDFC,direct expenses,5eecc6d6449e4f7cfb1c2708,2022-09-07T00:00:00.000Z,50100293329616 NET BANKING SI -56165,,,Other,-56165
632ae6d72e1a0ebb7f4700f7,50200023535069,2987055.8,60ec41ba55c00300382672d9,HDFC,direct expenses,5eecc6d6449e4f7cfb1c2708,2022-09-07T00:00:00.000Z,00901610080520 NET BANKING SI -45618,,,Other,-45618
632ae6d72e1a0ebb7f4700f9,50200023535069,2889855.8,60ec41ba55c00300382672d9,HDFC,direct expenses,5eecc6d6449e4f7cfb1c2708,2022-09-07T00:00:00.000Z,00321000085687 NET BANKING SI -97200,,,Other,-97200
632ae6d72e1a0ebb7f4700fb,50200023535069,2716336.8,60ec41ba55c00300382672d9,HDFC,direct expenses,5eecc6d6449e4f7cfb1c2708,2022-09-07T00:00:00.000Z,50100155115510 NET BANKING SI -173519,,,Other,-173519
632ae6d72e1a0ebb7f4700fd,50200023535069,2506896.8,60ec41ba55c00300382672d9,HDFC,direct expenses,5eecc6d6449e4f7cfb1c2708,2022-09-07T00:00:00.000Z,02711930004579 NET BANKING SI -209440,,,Other,-209440
632ae6d72e1a0ebb7f4700ff,50200023535069,2387869.8,60ec41ba55c00300382672d9,HDFC,direct expenses,5eecc6d6449e4f7cfb1c2708,2022-09-07T00:00:00.000Z,50100093802387 NET BANKING SI -119027,,,Other,-119027
632ae6d72e1a0ebb7f470101,50200023535069,2366339.8,60ec41ba55c00300382672d9,HDFC,direct expenses,5eecc6d6449e4f7cfb1c2708,2022-09-07T00:00:00.000Z,02711600008220 NET BANKING SI -21530,,,Other,-21530
632ae6d72e1a0ebb7f470104,50200023535069,2205404.8,60ec41ba55c00300382672d9,HDFC,direct expenses,5eecc6d6449e4f7cfb1c2708,2022-09-07T00:00:00.000Z,09291610057185 NET BANKING SI -160935,,,Other,-160935
632ae6d72e1a0ebb7f470106,50200023535069,2043404.8,60ec41ba55c00300382672d9,HDFC,direct expenses,5eecc6d6449e4f7cfb1c2708,2022-09-07T00:00:00.000Z,50200054531492 NET BANKING SI -162000,,,Other,-162000
632ae6d72e1a0ebb7f470108,50200023535069,1951604.8,60ec41ba55c00300382672d9,HDFC,direct expenses,5eecc6d6449e4f7cfb1c2708,2022-09-07T00:00:00.000Z,50200063349422 NET BANKING SI -91800,,,Other,-91800
632ae6d72e1a0ebb7f47010a,50200023535069,1982331.06,60ec41ba55c00300382672d9,HDFC,Revenue-Mktplace,5eecc6d6449e4f7cfb1c2708,2022-09-07T00:00:00.000Z,NEFT CR-DEUT0797BGL-FLIPKART INTERNET PR IVATE LIMITED-SLICK ORGANICS PVT LTD-225 000150GN00201,shopping,,net_banking_transfer,30726.26
632ae6d72e1a0ebb7f47010c,50200023535069,1947331.06,60ec41ba55c00300382672d9,HDFC,direct expenses,5eecc6d6449e4f7cfb1c2708,2022-09-07T00:00:00.000Z,NEFT DR-ICIC0003851-JITENDER KUMAR-SANDO Z - MUM-N250222108509948-NET BANKING SI -35000,,,net_banking_transfer,-35000
632ae6d72e1a0ebb7f47010e,50200023535069,1918331.06,60ec41ba55c00300382672d9,HDFC,direct expenses,5eecc6d6449e4f7cfb1c2708,2022-09-07T00:00:00.000Z,NEFT DR-SIBL0000555-JAIVEER KUMAR-SANDOZ - MUM-N250222108509949-NET BANKING SI - 29000,,,net_banking_transfer,-29000
632ae6d72e1a0ebb7f470110,50200023535069,1893331.06,60ec41ba55c00300382672d9,HDFC,direct expenses,5eecc6d6449e4f7cfb1c2708,2022-09-07T00:00:00.000Z,NEFT DR-BARB0VJGRKA-OM PRASAD PANDEY-SAN,,,net_banking_transfer,-25000
632ae6d72e1a0ebb7f470112,50200023535069,1869331.06,60ec41ba55c00300382672d9,HDFC,direct expenses,5eecc6d6449e4f7cfb1c2708,2022-09-07T00:00:00.000Z,NEFT DR-PUNB0482100-RAM BHAVAN YADAV-SAN DOZ - MUM-N250222108509951-NET BANKING S I -24000,,,net_banking_transfer,-24000
632ae6d72e1a0ebb7f470114,50200023535069,1826931.06,60ec41ba55c00300382672d9,HDFC,direct expenses,5eecc6d6449e4f7cfb1c2708,2022-09-07T00:00:00.000Z,NEFT DR-UTIB0001720-ANUBHAV RAO-SANDOZ - MUM-N250222108509952-NET BANKING SI -42 400,,,net_banking_transfer,-42400
632ae6d82e1a0ebb7f470116,50200023535069,1785531.06,60ec41ba55c00300382672d9,HDFC,direct expenses,5eecc6d6449e4f7cfb1c2708,2022-09-07T00:00:00.000Z,NEFT DR-UTIB0000120-ADNAN ALI-SANDOZ - M UM-N250222108509953-NET BANKING SI -4140 0,,,net_banking_transfer,-41400
632ae6d82e1a0ebb7f470118,50200023535069,1766453.06,60ec41ba55c00300382672d9,HDFC,N-ACH payments,5eecc6d6449e4f7cfb1c2708,2022-09-07T00:00:00.000Z,NEFT DR-DBSS0IN0811-SACHIN SINGH-SANDOZ - MUM-N250222108509954-NET BANKING SI -1 9078,,,net_banking_transfer,-19078
632ae6d82e1a0ebb7f47011a,50200023535069,1748283.06,60ec41ba55c00300382672d9,HDFC,direct expenses,5eecc6d6449e4f7cfb1c2708,2022-09-07T00:00:00.000Z,NEFT DR-PUNB0307800-SANJEEV NIRMANIA-SAN DOZ - MUM-N250222108509955-NET BANKING S I -18170,,,net_banking_transfer,-18170
632ae6d82e1a0ebb7f47011c,50200023535069,1725067.06,60ec41ba55c00300382672d9,HDFC,direct expenses,5eecc6d6449e4f7cfb1c2708,2022-09-07T00:00:00.000Z,NEFT DR-SBIN0017746-MANOJ KUMAR-SANDOZ - MUM-N250222108509956-NET BANKING SI -23 216,,,net_banking_transfer,-23216
632ae6d82e1a0ebb7f47011f,50200023535069,1709986.06,60ec41ba55c00300382672d9,HDFC,direct expenses,5eecc6d6449e4f7cfb1c2708,2022-09-07T00:00:00.000Z,NEFT DR-SCBL0036023-VIVEK YADAV-SANDOZ - MUM-N250222108509957-NET BANKING SI -15 081,,,net_banking_transfer,-15081
632ae6d82e1a0ebb7f470121,50200023535069,1694905.06,60ec41ba55c00300382672d9,HDFC,direct expenses,5eecc6d6449e4f7cfb1c2708,2022-09-07T00:00:00.000Z,NEFT DR-SCBL0036028-SHUBHAM SINGH PANWAR -SANDOZ - MUM-N250222108509958-NET BANKI NG SI -15081,,,net_banking_transfer,-15081
632ae6d82e1a0ebb7f470123,50200023535069,1672299.06,60ec41ba55c00300382672d9,HDFC,direct expenses,5eecc6d6449e4f7cfb1c2708,2022-09-07T00:00:00.000Z,NEFT DR-KKBK0005032-DEEPAK YADAV-SANDOZ - MUM-N250222108509959-NET BANKING SI -2 2606,,,net_banking_transfer,-22606
632ae6d82e1a0ebb7f470125,50200023535069,1650769.06,60ec41ba55c00300382672d9,HDFC,direct expenses,5eecc6d6449e4f7cfb1c2708,2022-09-07T00:00:00.000Z,NEFT DR-PUNB0494300-KUNDAN PRASAD-SANDOZ - MUM-N250222108509960-NET BANKING SI - 21530,,,net_banking_transfer,-21530
632ae6d82e1a0ebb7f470127,50200023535069,1630316.06,60ec41ba55c00300382672d9,HDFC,direct expenses,5eecc6d6449e4f7cfb1c2708,2022-09-07T00:00:00.000Z,NEFT DR-PUNB0151400-BHUWAN CHANDER JOSHI,,,net_banking_transfer,-20453
632ae6d82e1a0ebb7f47012a,50200023535069,1609863.06,60ec41ba55c00300382672d9,HDFC,direct expenses,5eecc6d6449e4f7cfb1c2708,2022-09-07T00:00:00.000Z,NEFT DR-BARB0DINARA-MD ARIF RAZA-SANDOZ - MUM-N250222108509962-NET BANKING SI -2 0453,,,net_banking_transfer,-20453
632ae6d82e1a0ebb7f470132,50200023535069,1547648.06,60ec41ba55c00300382672d9,HDFC,direct expenses,5eecc6d6449e4f7cfb1c2708,2022-09-07T00:00:00.000Z,NEFT DR-KKBK0000187-APPLIED LIFE PRIVATE LIMITED-SANDOZ - MUM-N250222108509963-N ET BANKING SI -62215,,,net_banking_transfer,-62215
632ae6d82e1a0ebb7f470134,50200023535069,1331648.06,60ec41ba55c00300382672d9,HDFC,direct expenses,5eecc6d6449e4f7cfb1c2708,2022-09-07T00:00:00.000Z,NEFT DR-UTIB0000514-NATS ASSOCIATES-SAND OZ - MUM-N250222108509964-NET BANKING SI -216000,,,net_banking_transfer,-216000
632ae6d82e1a0ebb7f470138,50200023535069,1113488.06,60ec41ba55c00300382672d9,HDFC,direct expenses,5eecc6d6449e4f7cfb1c2708,2022-09-07T00:00:00.000Z,NEFT DR-BARB0VJMATU-ARTISTO DESIGNZ-SAND OZ - MUM-N250222108509965-NET BANKING SI -218160,,,net_banking_transfer,-218160
632ae6d82e1a0ebb7f47013a,50200023535069,1009627.06,60ec41ba55c00300382672d9,HDFC,direct expenses,5eecc6d6449e4f7cfb1c2708,2022-09-07T00:00:00.000Z,NEFT DR-ICIC0000021-AKHILESH DIXIT-SANDO Z - MUM-N250222108509966-NET BANKING SI -103861,,,net_banking_transfer,-103861
632ae6d82e1a0ebb7f47013c,50200023535069,815580.06,60ec41ba55c00300382672d9,HDFC,direct expenses,5eecc6d6449e4f7cfb1c2708,2022-09-07T00:00:00.000Z,NEFT DR-KKBK0000261-TANVI TANEJA-SANDOZ - MUM-N250222108509967-NET BANKING SI -1 94047,,,net_banking_transfer,-194047
632ae6d82e1a0ebb7f47013e,50200023535069,738455.06,60ec41ba55c00300382672d9,HDFC,direct expenses,5eecc6d6449e4f7cfb1c2708,2022-09-07T00:00:00.000Z,NEFT DR-SBIN0070392-APARNA MOHANAN KONAT -SANDOZ - MUM-N250222108509968-NET BANKI NG SI -77125,,,net_banking_transfer,-77125
632ae6d82e1a0ebb7f470140,50200023535069,519345.06,60ec41ba55c00300382672d9,HDFC,direct expenses,5eecc6d6449e4f7cfb1c2708,2022-09-07T00:00:00.000Z,NEFT DR-SCBL0036025-DHRUV MADHOK-SANDOZ - MUM-N250222108509969-NET BANKING SI -2 19110,,,net_banking_transfer,-219110
632ae6d82e1a0ebb7f470142,50200023535069,472945.06,60ec41ba55c00300382672d9,HDFC,direct expenses,5eecc6d6449e4f7cfb1c2708,2022-09-07T00:00:00.000Z,NEFT DR-KKBK0008066-KUSHAGRA SINGH-SANDO Z - MUM-N250222108509970-NET BANKING SI -46400,,,net_banking_transfer,-46400
632ae6d82e1a0ebb7f470144,50200023535069,449720.06,60ec41ba55c00300382672d9,HDFC,direct expenses,5eecc6d6449e4f7cfb1c2708,2022-09-07T00:00:00.000Z,NEFT DR-ICIC0000314-ATUL VAISHNAV-SANDOZ - MUM-N250222108509971-NET BANKING SI - 23225,,,net_banking_transfer,-23225
632ae6d82e1a0ebb7f470146,50200023535069,430795.06,60ec41ba55c00300382672d9,HDFC,direct expenses,5eecc6d6449e4f7cfb1c2708,2022-09-07T00:00:00.000Z,NEFT DR-PUNB0150400-SAGARIKA DEBNATH-SA,,,net_banking_transfer,-18925
632ae6d82e1a0ebb7f470148,50200023535069,327833.06,60ec41ba55c00300382672d9,HDFC,direct expenses,5eecc6d6449e4f7cfb1c2708,2022-09-07T00:00:00.000Z,NEFT DR-KKBK0000261-AAYUSHI PAREEK-SANDO Z - MUM-N250222108509973-NET BANKING SI -102962,,,net_banking_transfer,-102962
632ae6d82e1a0ebb7f47014a,50200023535069,239433.06,60ec41ba55c00300382672d9,HDFC,direct expenses,5eecc6d6449e4f7cfb1c2708,2022-09-07T00:00:00.000Z,NEFT DR-IOBA0001445-PRIYANKA GOPAL-SANDO Z - MUM-N250222108509974-NET BANKING SI -88400,,,net_banking_transfer,-88400
632ae6d82e1a0ebb7f47014c,50200023535069,224352.06,60ec41ba55c00300382672d9,HDFC,direct expenses,5eecc6d6449e4f7cfb1c2708,2022-09-07T00:00:00.000Z,NEFT DR-CNRB0019016-MANEESH-SANDOZ - MUM -N250222108509975-NET BANKING SI -15081,,,net_banking_transfer,-15081
632ae6d82e1a0ebb7f47014e,50200023535069,183852.06,60ec41ba55c00300382672d9,HDFC,agency/vendor expense,5eecc6d6449e4f7cfb1c2708,2022-09-07T00:00:00.000Z,NEFT DR-UTIB0003557-INCOSEC LEGAL-SANDOZ - MUM-N250222108509976-NET BANKING SI - 40500,,,net_banking_transfer,-40500
632ae6d82e1a0ebb7f470150,50200023535069,168722.06,60ec41ba55c00300382672d9,HDFC,direct expenses,5eecc6d6449e4f7cfb1c2708,2022-09-07T00:00:00.000Z,NEFT DR-KKBK0004632-DOLLY JAIN-SANDOZ - MUM-N250222108509977-NET BANKING SI -151 30,,,net_banking_transfer,-15130
632ae6d82e1a0ebb7f470152,50200023535069,9962.06,60ec41ba55c00300382672d9,HDFC,direct expenses,5eecc6d6449e4f7cfb1c2708,2022-09-07T00:00:00.000Z,NEFT DR-DBSS0IN0811-SARANSH KULKARNI-SAN DOZ - MUM-N250222108509978-NET BANKING S I -158760,,,net_banking_transfer,-158760
632ae6d82e1a0ebb7f470156,50200023535069,-170089.94,60ec41ba55c00300382672d9,HDFC,direct expenses,5eecc6d6449e4f7cfb1c2708,2022-09-07T00:00:00.000Z,NEFT DR-PUNB0100110-KRAUTER HEALTHCARE L TD-SANDOZ - MUM-N250222108509979-NET BAN KING SI -180052,,,net_banking_transfer,-180052
632ae6d82e1a0ebb7f470158,50200023535069,-149989.65,60ec41ba55c00300382672d9,HDFC,Revenue-PG-non-split,5eecc6d6449e4f7cfb1c2708,2022-09-07T00:00:00.000Z,NEFT CR-PYTM0123456-PAYTM PAYMENTS SERVI CES LIMITED-SLICK ORGANICS PVT LTD-PYTM2 22507113306,insurance,insurance,net_banking_transfer,20100.29
632ae6d82e1a0ebb7f47015a,50200023535069,-146544.01,60ec41ba55c00300382672d9,HDFC,Revenue-Mktplace,5eecc6d6449e4f7cfb1c2708,2022-09-07T00:00:00.000Z,NEFT CR-DEUT0797BGL-MYNTRA DESIGNS PRIVA TE LIMITED-SLICK ORGANICS PVT. LTD.-2250 00718GN00146,shopping,,net_banking_transfer,3445.64
632ae6d82e1a0ebb7f47015c,50200023535069,-138696.99,60ec41ba55c00300382672d9,HDFC,Revenue-Mktplace,5eecc6d6449e4f7cfb1c2708,2022-09-07T00:00:00.000Z,NEFT CR-DEUT0797BGL-MYNTRA DESIGNS PRIVA TE LIMITED-SLICK ORGANICS PVT. LTD.-2250 00734GN00005,shopping,,net_banking_transfer,7847.02
632ae6d82e1a0ebb7f47015e,50200023535069,-119295.87,60ec41ba55c00300382672d9,HDFC,Revenue-PG-split enabled,5eecc6d6449e4f7cfb1c2708,2022-09-07T00:00:00.000Z,NEFT CR-UTIB0001506-RAZORPAY SOFTWARE PR,,,net_banking_transfer,19401.12
632ae6d82e1a0ebb7f470160,50200023535069,-42122.28,60ec41ba55c00300382672d9,HDFC,Revenue-PG-non-split,5eecc6d6449e4f7cfb1c2708,2022-09-07T00:00:00.000Z,NEFT CR-KKBK0000958-NODAL ACCOUNT BROKEN TUSK TECHNOL-SLICK ORGANICS PRIVATE LIMI TED-CMS2502225058540,insurance,insurance,net_banking_transfer,77173.59
632ae6d82e1a0ebb7f470162,50200023535069,-46122.28,60ec41ba55c00300382672d9,HDFC,direct expenses,5eecc6d6449e4f7cfb1c2708,2022-09-07T00:00:00.000Z,"NEFT DR-ICIC0001130-THE UMBRELLA STORE-N ETBANK, MUM-N250222109510645-4000",,,net_banking_transfer,-4000
632ae6d82e1a0ebb7f470164,50200023535069,-53122.28,60ec41ba55c00300382672d9,HDFC,direct expenses,5eecc6d6449e4f7cfb1c2708,2022-09-07T00:00:00.000Z,"NEFT DR-SBIN0008132-VIKASH KUMAR-NETBANK , MUM-N250222109512383-7000",,,net_banking_transfer,-7000
632ae6d82e1a0ebb7f470166,50200023535069,-84997.28,60ec41ba55c00300382672d9,HDFC,direct expenses,5eecc6d6449e4f7cfb1c2708,2022-09-07T00:00:00.000Z,50100362612187-TPT-31875-BHUPESH JAKHAR,,,net_banking_transfer,-31875
632ae6d82e1a0ebb7f470168,50200023535069,-241597.28,60ec41ba55c00300382672d9,HDFC,direct expenses,5eecc6d6449e4f7cfb1c2708,2022-09-07T00:00:00.000Z,"NEFT DR-KKBK0005289-HILL GROOVE CONSULTI NG LLP-NETBANK, MUM-N250222109638551-156 600",,,net_banking_transfer,-156600
632ae6d82e1a0ebb7f47016a,50200023535069,-227530.97,60ec41ba55c00300382672d9,HDFC,Revenue-PG-split enabled,5eecc6d6449e4f7cfb1c2708,2022-09-07T00:00:00.000Z,NEFT CR-UTIB0001506-RAZORPAY SOFTWARE PR IVATE LIMITED-SLICK ORGANICS PVT LITD-AX ISCN0164559029,insurance,insurance,net_banking_transfer,14066.31
632ae6d82e1a0ebb7f47016c,50200023535069,-187606.47,60ec41ba55c00300382672d9,HDFC,Revenue-COD,5eecc6d6449e4f7cfb1c2708,2022-09-07T00:00:00.000Z,NEFT CR-ICIC0000155-SHIPROCKET COD CRF I D 4861431-SLICK ORGANICS PVT LTD-CMS2816 787879,insurance,insurance,net_banking_transfer,39924.5
632ae6d82e1a0ebb7f47016e,50200023535069,-487606.47,60ec41ba55c00300382672d9,HDFC,direct expenses,5eecc6d6449e4f7cfb1c2708,2022-09-07T00:00:00.000Z,"NEFT DR-YESB0000551-VISTTA COSMETICS-NET BANK, MUM-N250222110558062-300000",,,net_banking_transfer,-300000
632ae6d82e1a0ebb7f470170,50200023535069,-483793.47,60ec41ba55c00300382672d9,HDFC,Transfer in/Revenue-other,5eecc6d6449e4f7cfb1c2708,2022-09-07T00:00:00.000Z,NEFT CR-HSBC0560002-INNOVATIVE RETAIL CO NCEPTS PRIVATE-SLICK ORGANICS PVT LTD-HS BCN22250654428,,,net_banking_transfer,3813
632ae6d82e1a0ebb7f470172,50200023535069,-477594.47,60ec41ba55c00300382672d9,HDFC,Transfer in/Revenue-other,5eecc6d6449e4f7cfb1c2708,2022-09-07T00:00:00.000Z,NEFT CR-HSBC0560002-INNOVATIVE RETAIL CO NCEPTS PRIVATE-SLICK ORGANICS PVT LTD-HS BCN22250654535,,,net_banking_transfer,6199
632ae6d82e1a0ebb7f470174,50200023535069,-473150.47,60ec41ba55c00300382672d9,HDFC,Transfer in/Revenue-other,5eecc6d6449e4f7cfb1c2708,2022-09-07T00:00:00.000Z,NEFT CR-HSBC0560002-INNOVATIVE RETAIL CO NCEPTS PRIVATE-SLICK ORGANICS PVT LTD-HS BCN22250655048,,,net_banking_transfer,4444
632ae6d82e1a0ebb7f470176,50200023535069,-303060.47,60ec41ba55c00300382672d9,HDFC,Loan-in,5eecc6d6449e4f7cfb1c2708,2022-09-08T00:00:00.000Z,SWEEP-IN CREDIT - 50300675642152,,,self_transfer,170090
632ae6d82e1a0ebb7f470178,50200023535069,-231552.47,60ec41ba55c00300382672d9,HDFC,Loan-in,5eecc6d6449e4f7cfb1c2708,2022-09-08T00:00:00.000Z,SWEEP-IN CREDIT - 50300675642152,,,self_transfer,71508
632ae6d82e1a0ebb7f47017a,50200023535069,0.53,60ec41ba55c00300382672d9,HDFC,Loan-in,5eecc6d6449e4f7cfb1c2708,2022-09-08T00:00:00.000Z,SWEEP-IN CREDIT - 50300675642152,,,self_transfer,231553
632ae6d82e1a0ebb7f47017c,50200023535069,23320.5,60ec41ba55c00300382672d9,HDFC,Revenue-PG-non-split,5eecc6d6449e4f7cfb1c2708,2022-09-08T00:00:00.000Z,IMPS-225104917039-PAYTM PAYMENTS SERVI-P YTM-XXXXXXXXXX0008-ALL202209082168200003 30830668628,ewallet,,net_banking_transfer,23319.97
632ae6d82e1a0ebb7f47017e,50200023535069,-1679.5,60ec41ba55c00300382672d9,HDFC,direct expenses,5eecc6d6449e4f7cfb1c2708,2022-09-08T00:00:00.000Z,POS 514834XXXXXX9486 FLIPKART,shopping,,debit_card,-25000
632ae6d82e1a0ebb7f470180,50200023535069,8236.15,60ec41ba55c00300382672d9,HDFC,Revenue-PG-split enabled,5eecc6d6449e4f7cfb1c2708,2022-09-08T00:00:00.000Z,NEFT CR-UTIB0001506-RAZORPAY SOFTWARE PR IVATE LIMITED-SLICK ORGANICS PVT LITD-AX ISCN0164664448,insurance,insurance,net_banking_transfer,9915.65
632ae6d82e1a0ebb7f470182,50200023535069,-246763.85,60ec41ba55c00300382672d9,HDFC,SAAS/tech expense,5eecc6d6449e4f7cfb1c2708,2022-09-08T00:00:00.000Z,POS 514834XXXXXX9486 AMAZON,shopping,,debit_card,-255000
632ae6d82e1a0ebb7f470184,50200023535069,-248016.85,60ec41ba55c00300382672d9,HDFC,SAAS/tech expense,5eecc6d6449e4f7cfb1c2708,2022-09-08T00:00:00.000Z,POS 514834XXXXXX9486 AMAZON,shopping,,debit_card,-1253
632ae6d82e1a0ebb7f470186,50200023535069,-498016.85,60ec41ba55c00300382672d9,HDFC,direct expenses,5eecc6d6449e4f7cfb1c2708,2022-09-08T00:00:00.000Z,"NEFT DR-INDB0000148-ACQUISORY INDIA CONS ULTING PVT LTD-NETBANK, MUM-N25122211138 0549-250000",,,net_banking_transfer,-250000
632ae6d82e1a0ebb7f470188,50200023535069,-548016.85,60ec41ba55c00300382672d9,HDFC,direct expenses,5eecc6d6449e4f7cfb1c2708,2022-09-08T00:00:00.000Z,"NEFT DR-KKBK0000173-MATRIX PRINTING SOLU TIONS PRIVATE LIMITE-NETBANK, MUM-N25122 2111391509-50000",,,net_banking_transfer,-50000
632ae6d82e1a0ebb7f47018a,50200023535069,-550559.85,60ec41ba55c00300382672d9,HDFC,SAAS/tech expense,5eecc6d6449e4f7cfb1c2708,2022-09-08T00:00:00.000Z,POS 514834XXXXXX9486 AMAZON,shopping,,debit_card,-2543
632ae6d82e1a0ebb7f47018d,50200023535069,-554721.85,60ec41ba55c00300382672d9,HDFC,direct expenses,5eecc6d6449e4f7cfb1c2708,2022-09-08T00:00:00.000Z,"NEFT DR-ICIC0000021-AKHILESH DIXIT-NETBA NK, MUM-N251222111417939-4162",,,net_banking_transfer,-4162
632ae6d82e1a0ebb7f47018f,50200023535069,-561173.85,60ec41ba55c00300382672d9,HDFC,direct expenses,5eecc6d6449e4f7cfb1c2708,2022-09-08T00:00:00.000Z,50100162216680-TPT-6452-ARUSHE BHARDWAJ,,,net_banking_transfer,-6452
632ae6d82e1a0ebb7f470192,50200023535069,-480676.01,60ec41ba55c00300382672d9,HDFC,Revenue-PG-non-split,5eecc6d6449e4f7cfb1c2708,2022-09-08T00:00:00.000Z,NEFT CR-KKBK0000958-NODAL ACCOUNT BROKEN TUSK TECHNOL-SLICK ORGANICS PRIVATE LIMI TED-CMS2512225274049,insurance,insurance,net_banking_transfer,80497.84
632ae6d82e1a0ebb7f470194,50200023535069,-521176.01,60ec41ba55c00300382672d9,HDFC,direct expenses,5eecc6d6449e4f7cfb1c2708,2022-09-08T00:00:00.000Z,50100433068791-TPT-40500-NATHIYA KUBENDI RAN,,,net_banking_transfer,-40500
632ae6d82e1a0ebb7f470196,50200023535069,-515035.36,60ec41ba55c00300382672d9,HDFC,Revenue-PG-split enabled,5eecc6d6449e4f7cfb1c2708,2022-09-08T00:00:00.000Z,NEFT CR-UTIB0001506-RAZORPAY SOFTWARE PR IVATE LIMITED-SLICK ORGANICS PVT LITD-AX ISCN0164803107,insurance,insurance,net_banking_transfer,6140.65
632ae6d82e1a0ebb7f470198,50200023535069,-513355.36,60ec41ba55c00300382672d9,HDFC,Loan-in,5eecc6d6449e4f7cfb1c2708,2022-09-09T00:00:00.000Z,SWEEP-IN CREDIT - 50300675642152,,,self_transfer,1680
632ae6d82e1a0ebb7f47019a,50200023535069,-268270.36,60ec41ba55c00300382672d9,HDFC,Loan-in,5eecc6d6449e4f7cfb1c2708,2022-09-09T00:00:00.000Z,SWEEP-IN CREDIT - 50300675642152,,,self_transfer,245085
632ae6d82e1a0ebb7f47019c,50200023535069,-267017.36,60ec41ba55c00300382672d9,HDFC,Loan-in,5eecc6d6449e4f7cfb1c2708,2022-09-09T00:00:00.000Z,SWEEP-IN CREDIT - 50300675642152,,,self_transfer,1253
632ae6d82e1a0ebb7f47019f,50200023535069,-264474.36,60ec41ba55c00300382672d9,HDFC,Loan-in,5eecc6d6449e4f7cfb1c2708,2022-09-09T00:00:00.000Z,SWEEP-IN CREDIT - 50300675642152,,,self_transfer,2543
632ae6d82e1a0ebb7f4701a1,50200023535069,-14474.36,60ec41ba55c00300382672d9,HDFC,Loan-in,5eecc6d6449e4f7cfb1c2708,2022-09-09T00:00:00.000Z,SWEEP-IN CREDIT - 50300675642152,,,self_transfer,250000
632ae6d82e1a0ebb7f4701a3,50200023535069,0.64,60ec41ba55c00300382672d9,HDFC,Loan-in,5eecc6d6449e4f7cfb1c2708,2022-09-09T00:00:00.000Z,SWEEP-IN CREDIT - 50300675642152,,,self_transfer,14475
632ae6d82e1a0ebb7f4701a5,50200023535069,12515.4,60ec41ba55c00300382672d9,HDFC,Revenue-Mktplace,5eecc6d6449e4f7cfb1c2708,2022-09-09T00:00:00.000Z,NEFT CR-DEUT0797BGL-FLIPKART INTERNET PR IVATE LIMITED-SLICK ORGANICS PVT LTD-225 200151GN00116,shopping,,net_banking_transfer,12514.76
632ae6d82e1a0ebb7f4701a7,50200023535069,18559.27,60ec41ba55c00300382672d9,HDFC,Revenue-PG-non-split,5eecc6d6449e4f7cfb1c2708,2022-09-09T00:00:00.000Z,NEFT CR-PYTM0123456-PAYTM PAYMENTS SERVI CES LIMITED-SLICK ORGANICS PVT LTD-PYTM2 22520132404,insurance,insurance,net_banking_transfer,6043.87
632ae6d82e1a0ebb7f4701a9,50200023535069,-6440.73,60ec41ba55c00300382672d9,HDFC,direct expenses,5eecc6d6449e4f7cfb1c2708,2022-09-09T00:00:00.000Z,"NEFT DR-UTIB0000120-ADNAN ALI-NETBANK, M UM-N252222112724765-25000",,,net_banking_transfer,-25000
632ae6d82e1a0ebb7f4701ab,50200023535069,-206440.73,60ec41ba55c00300382672d9,HDFC,direct expenses,5eecc6d6449e4f7cfb1c2708,2022-09-09T00:00:00.000Z,50100370748619-TPT-200000-RITIKA SAXENA,,,net_banking_transfer,-200000
632ae6d82e1a0ebb7f4701ad,50200023535069,-506440.73,60ec41ba55c00300382672d9,HDFC,direct expenses,5eecc6d6449e4f7cfb1c2708,2022-09-09T00:00:00.000Z,"NEFT DR-ICIC0000369-BO INTERNATIONAL-NET BANK, MUM-N252222112744352-300000",,,net_banking_transfer,-300000
632ae6d82e1a0ebb7f4701af,50200023535069,-539773.73,60ec41ba55c00300382672d9,HDFC,direct expenses,5eecc6d6449e4f7cfb1c2708,2022-09-09T00:00:00.000Z,50100362612187-TPT-33333-BHUPESH JAKHAR,,,net_banking_transfer,-33333
632ae6d92e1a0ebb7f4701b2,50200023535069,-559773.73,60ec41ba55c00300382672d9,HDFC,direct expenses,5eecc6d6449e4f7cfb1c2708,2022-09-09T00:00:00.000Z,"NEFT DR-ICIC0003851-JITENDER KUMAR-NETBA NK, MUM-N252222112725344-20000",,,net_banking_transfer,-20000
632ae6d92e1a0ebb7f4701b4,50200023535069,-550830.85,60ec41ba55c00300382672d9,HDFC,Revenue-PG-split enabled,5eecc6d6449e4f7cfb1c2708,2022-09-09T00:00:00.000Z,NEFT CR-UTIB0001506-RAZORPAY SOFTWARE PR IVATE LIMITED-SLICK ORGANICS PVT LITD-AX ISCN0164874129,insurance,insurance,net_banking_transfer,8942.88
632ae6d92e1a0ebb7f4701b6,50200023535069,-522852.85,60ec41ba55c00300382672d9,HDFC,Transfer in/Revenue-other,5eecc6d6449e4f7cfb1c2708,2022-09-09T00:00:00.000Z,NEFT CR-HSBC0110002-NAPSA PRIVATE LIMITE D-SLICK ORGANICS PVT. LTD.-HSBCN22252852 054,,,net_banking_transfer,27978
632ae6d92e1a0ebb7f4701b8,50200023535069,-528542.85,60ec41ba55c00300382672d9,HDFC,direct expenses,5eecc6d6449e4f7cfb1c2708,2022-09-09T00:00:00.000Z,"NEFT DR-ICIC0001130-THE UMBRELLA STORE-N ETBANK, MUM-N252222112958403-5690",,,net_banking_transfer,-5690
632ae6d92e1a0ebb7f4701ba,50200023535069,-554592.85,60ec41ba55c00300382672d9,HDFC,direct expenses,5eecc6d6449e4f7cfb1c2708,2022-09-09T00:00:00.000Z,POS 514834XXXXXX9486 PTM*PAYTM,ewallet,,debit_card,-26050
632ae6d92e1a0ebb7f4701bc,50200023535069,-588045.84,60ec41ba55c00300382672d9,HDFC,N-ACH payments,5eecc6d6449e4f7cfb1c2708,2022-09-09T00:00:00.000Z,ACH D- 531381265-71PR220909025FV6,,unidentified obligation,auto_debit_payment,-33452.99
632ae6d92e1a0ebb7f4701be,50200023535069,-638045.84,60ec41ba55c00300382672d9,HDFC,N-ACH payments,5eecc6d6449e4f7cfb1c2708,2022-09-09T00:00:00.000Z,ACH D- 531381265B-71PR220909025FVM,,unidentified obligation,auto_debit_payment,-50000
632ae6d92e1a0ebb7f4701c0,50200023535069,-688045.84,60ec41ba55c00300382672d9,HDFC,N-ACH payments,5eecc6d6449e4f7cfb1c2708,2022-09-09T00:00:00.000Z,ACH D- 531381265C-71PR220909025FVQ,,unidentified obligation,auto_debit_payment,-50000
632ae6d92e1a0ebb7f4701c2,50200023535069,-738045.84,60ec41ba55c00300382672d9,HDFC,N-ACH payments,5eecc6d6449e4f7cfb1c2708,2022-09-09T00:00:00.000Z,ACH D- 531381265D-71PR220909025FVU,,unidentified obligation,auto_debit_payment,-50000
632ae6d92e1a0ebb7f4701c4,50200023535069,-788045.84,60ec41ba55c00300382672d9,HDFC,N-ACH payments,5eecc6d6449e4f7cfb1c2708,2022-09-09T00:00:00.000Z,ACH D- 531381265F-71PR220909025FT0,,unidentified obligation,auto_debit_payment,-50000
632ae6d92e1a0ebb7f4701c6,50200023535069,-838045.84,60ec41ba55c00300382672d9,HDFC,N-ACH payments,5eecc6d6449e4f7cfb1c2708,2022-09-09T00:00:00.000Z,ACH D- 531381265E-71PR220909025FST,,unidentified obligation,auto_debit_payment,-50000
632ae6d92e1a0ebb7f4701c8,50200023535069,-888045.84,60ec41ba55c00300382672d9,HDFC,N-ACH payments,5eecc6d6449e4f7cfb1c2708,2022-09-09T00:00:00.000Z,ACH D- 531381265A-71PR220909025FVC,,unidentified obligation,auto_debit_payment,-50000
632ae6d92e1a0ebb7f4701cb,50200023535069,-938045.84,60ec41ba55c00300382672d9,HDFC,N-ACH payments,5eecc6d6449e4f7cfb1c2708,2022-09-09T00:00:00.000Z,ACH D- 531381265G-71PR220909025FT5,,unidentified obligation,auto_debit_payment,-50000
632ae6d92e1a0ebb7f4701cd,50200023535069,-963045.84,60ec41ba55c00300382672d9,HDFC,direct expenses,5eecc6d6449e4f7cfb1c2708,2022-09-09T00:00:00.000Z,50200008269056-TPT-25000-ARTISAN FURNISH INGS PRIVATE LIMITED,,,net_banking_transfer,-25000
632ae6d92e1a0ebb7f4701cf,50200023535069,-998445.84,60ec41ba55c00300382672d9,HDFC,direct expenses,5eecc6d6449e4f7cfb1c2708,2022-09-09T00:00:00.000Z,"NEFT DR-ICIC0000024-TAKE MOTO YOHKI INDI A PRIVATE LIMITED-NETBANK, MUM-N25222211 3241161-35400",travel,,net_banking_transfer,-35400
632ae6d92e1a0ebb7f4701d1,50200023535069,-993710.25,60ec41ba55c00300382672d9,HDFC,Revenue-Mktplace,5eecc6d6449e4f7cfb1c2708,2022-09-09T00:00:00.000Z,NEFT CR-DEUT0797BGL-MYNTRA DESIGNS PRIVA TE LIMITED-SLICK ORGANICS PVT. LTD.-2252 00858GN00049,shopping,,net_banking_transfer,4735.59
632ae6d92e1a0ebb7f4701d3,50200023535069,-988645.96,60ec41ba55c00300382672d9,HDFC,Revenue-Mktplace,5eecc6d6449e4f7cfb1c2708,2022-09-09T00:00:00.000Z,NEFT CR-DEUT0797BGL-MYNTRA DESIGNS PRIVA TE LIMITED-SLICK ORGANICS PVT. LTD.-2252 00870GN00223,shopping,,net_banking_transfer,5064.29
632ae6d92e1a0ebb7f4701d5,50200023535069,-1038645.96,60ec41ba55c00300382672d9,HDFC,direct expenses,5eecc6d6449e4f7cfb1c2708,2022-09-09T00:00:00.000Z,50200039508087-TPT-50000-SHREE PUNCHMUKH I LOGISTICS,,,net_banking_transfer,-50000
632ae6d92e1a0ebb7f4701da,50200023535069,-1029560.22,60ec41ba55c00300382672d9,HDFC,Transfer in/Revenue-other,5eecc6d6449e4f7cfb1c2708,2022-09-09T00:00:00.000Z,NEFT CR-UTIB0000114-ONE SIGMA TECHNOLOGI ES PRIVATE LIM-SLICK ORGANICS PRIVATE LI MITED-AXISP00318901335,insurance,insurance,net_banking_transfer,9085.74
632ae6d92e1a0ebb7f4701dc,50200023535069,-1018758.29,60ec41ba55c00300382672d9,HDFC,Revenue-PG-non-split,5eecc6d6449e4f7cfb1c2708,2022-09-09T00:00:00.000Z,NEFT CR-KKBK0000958-NODAL ACCOUNT BROKEN TUSK TECHNOL-SLICK ORGANICS PRIVATE LIMI TED-CMS2522225482519,insurance,insurance,net_banking_transfer,10801.93
632ae6d92e1a0ebb7f4701de,50200023535069,-1015030.61,60ec41ba55c00300382672d9,HDFC,Revenue-PG-split enabled,5eecc6d6449e4f7cfb1c2708,2022-09-09T00:00:00.000Z,NEFT CR-UTIB0001506-RAZORPAY SOFTWARE PR IVATE LIMITED-SLICK ORGANICS PVT LITD-AX ISCN0165024502,insurance,insurance,net_banking_transfer,3727.68
632ae6d92e1a0ebb7f4701e0,50200023535069,-1008589.61,60ec41ba55c00300382672d9,HDFC,Loan-in,5eecc6d6449e4f7cfb1c2708,2022-09-10T00:00:00.000Z,SWEEP-IN CREDIT - 50300675642152,,,self_transfer,6441
632ae6d92e1a0ebb7f4701e2,50200023535069,-808589.61,60ec41ba55c00300382672d9,HDFC,Loan-in,5eecc6d6449e4f7cfb1c2708,2022-09-10T00:00:00.000Z,SWEEP-IN CREDIT - 50300675642152,,,self_transfer,200000
632ae6d92e1a0ebb7f4701e4,50200023535069,-508589.61,60ec41ba55c00300382672d9,HDFC,Loan-in,5eecc6d6449e4f7cfb1c2708,2022-09-10T00:00:00.000Z,SWEEP-IN CREDIT - 50300675642152,,,self_transfer,300000
632ae6d92e1a0ebb7f4701e6,50200023535069,-475256.61,60ec41ba55c00300382672d9,HDFC,Loan-in,5eecc6d6449e4f7cfb1c2708,2022-09-10T00:00:00.000Z,SWEEP-IN CREDIT - 50300675642152,,,self_transfer,33333
632ae6d92e1a0ebb7f4701e8,50200023535069,-455256.61,60ec41ba55c00300382672d9,HDFC,Loan-in,5eecc6d6449e4f7cfb1c2708,2022-09-10T00:00:00.000Z,SWEEP-IN CREDIT - 50300675642152,,,self_transfer,20000
632ae6d92e1a0ebb7f4701ea,50200023535069,-426983.61,60ec41ba55c00300382672d9,HDFC,Loan-in,5eecc6d6449e4f7cfb1c2708,2022-09-10T00:00:00.000Z,SWEEP-IN CREDIT - 50300675642152,,,self_transfer,28273
632ae6d92e1a0ebb7f4701ec,50200023535069,-376983.61,60ec41ba55c00300382672d9,HDFC,Loan-in,5eecc6d6449e4f7cfb1c2708,2022-09-10T00:00:00.000Z,SWEEP-IN CREDIT - 50300675642152,,,self_transfer,50000
632ae6d92e1a0ebb7f4701f0,50200023535069,-326983.61,60ec41ba55c00300382672d9,HDFC,Loan-in,5eecc6d6449e4f7cfb1c2708,2022-09-10T00:00:00.000Z,SWEEP-IN CREDIT - 50300675642152,,,self_transfer,50000
632ae6d92e1a0ebb7f4701f3,50200023535069,-276983.61,60ec41ba55c00300382672d9,HDFC,Loan-in,5eecc6d6449e4f7cfb1c2708,2022-09-10T00:00:00.000Z,SWEEP-IN CREDIT - 50300675642152,,,self_transfer,50000
632ae6d92e1a0ebb7f4701f7,50200023535069,-226983.61,60ec41ba55c00300382672d9,HDFC,Loan-in,5eecc6d6449e4f7cfb1c2708,2022-09-10T00:00:00.000Z,SWEEP-IN CREDIT - 50300675642152,,,self_transfer,50000
632ae6d92e1a0ebb7f4701f9,50200023535069,-176983.61,60ec41ba55c00300382672d9,HDFC,Loan-in,5eecc6d6449e4f7cfb1c2708,2022-09-10T00:00:00.000Z,SWEEP-IN CREDIT - 50300675642152,,,self_transfer,50000
632ae6d92e1a0ebb7f4701fb,50200023535069,-126983.61,60ec41ba55c00300382672d9,HDFC,Loan-in,5eecc6d6449e4f7cfb1c2708,2022-09-10T00:00:00.000Z,SWEEP-IN CREDIT - 50300675642152,,,self_transfer,50000
632ae6d92e1a0ebb7f4701fd,50200023535069,-76983.61,60ec41ba55c00300382672d9,HDFC,Loan-in,5eecc6d6449e4f7cfb1c2708,2022-09-10T00:00:00.000Z,SWEEP-IN CREDIT - 50300675642152,,,self_transfer,50000
632ae6d92e1a0ebb7f4701ff,50200023535069,-51983.61,60ec41ba55c00300382672d9,HDFC,Loan-in,5eecc6d6449e4f7cfb1c2708,2022-09-10T00:00:00.000Z,SWEEP-IN CREDIT - 50300675642152,,,self_transfer,25000
632ae6d92e1a0ebb7f470201,50200023535069,-16583.61,60ec41ba55c00300382672d9,HDFC,Loan-in,5eecc6d6449e4f7cfb1c2708,2022-09-10T00:00:00.000Z,SWEEP-IN CREDIT - 50300675642152,,,self_transfer,35400
632ae6d92e1a0ebb7f470203,50200023535069,0.39,60ec41ba55c00300382672d9,HDFC,Loan-in,5eecc6d6449e4f7cfb1c2708,2022-09-10T00:00:00.000Z,SWEEP-IN CREDIT - 50300675642152,,,self_transfer,16584
632ae6d92e1a0ebb7f470205,50200023535069,7081.18,60ec41ba55c00300382672d9,HDFC,Revenue-PG-non-split,5eecc6d6449e4f7cfb1c2708,2022-09-10T00:00:00.000Z,NEFT CR-PYTM0123456-PAYTM PAYMENTS SERVI CES LIMITED-SLICK ORGANICS PVT LTD-PYTM2 22531995158,insurance,insurance,net_banking_transfer,7080.79
632ae6d92e1a0ebb7f470207,50200023535069,7082.18,60ec41ba55c00300382672d9,HDFC,Transfer in/Revenue-other,5eecc6d6449e4f7cfb1c2708,2022-09-10T00:00:00.000Z,IMPS-225314651951-WUNDERBAKED TECHNOLO-Y ESB-XXXXXXXXXXX0066-VERIFICATION,,,net_banking_transfer,1
632ae6d92e1a0ebb7f470209,50200023535069,5053.18,60ec41ba55c00300382672d9,HDFC,direct expenses,5eecc6d6449e4f7cfb1c2708,2022-09-10T00:00:00.000Z,POS 514834XXXXXX9486 ADOBE CREATIVE C,,,debit_card,-2029
632ae6d92e1a0ebb7f47020b,50200023535069,-394946.82,60ec41ba55c00300382672d9,HDFC,direct expenses,5eecc6d6449e4f7cfb1c2708,2022-09-10T00:00:00.000Z,POS 514834XXXXXX9486 E-COMMERCE RP,,,debit_card,-400000
632ae6d92e1a0ebb7f47020d,50200023535069,-494946.82,60ec41ba55c00300382672d9,HDFC,direct expenses,5eecc6d6449e4f7cfb1c2708,2022-09-10T00:00:00.000Z,"NEFT DR-YESB0000551-VISTTA COSMETICS-NET BANK, MUM-N253222115271001-100000",,,net_banking_transfer,-100000
632ae6d92e1a0ebb7f47020f,50200023535069,-99999.82,60ec41ba55c00300382672d9,HDFC,Loan-in,5eecc6d6449e4f7cfb1c2708,2022-09-11T00:00:00.000Z,SWEEP-IN CREDIT - 50300675642152,,,self_transfer,394947
632ae6d92e1a0ebb7f470211,50200023535069,0.18,60ec41ba55c00300382672d9,HDFC,Loan-in,5eecc6d6449e4f7cfb1c2708,2022-09-11T00:00:00.000Z,SWEEP-IN CREDIT - 50300675642152,,,self_transfer,100000
632ae6d92e1a0ebb7f470213,50200023535069,9038.24,60ec41ba55c00300382672d9,HDFC,Revenue-PG-non-split,5eecc6d6449e4f7cfb1c2708,2022-09-11T00:00:00.000Z,NEFT CR-PYTM0123456-PAYTM PAYMENTS SERVI CES LIMITED-SLICK ORGANICS PVT LTD-PYTM2 22543557252,insurance,insurance,net_banking_transfer,9038.06
632ae6d92e1a0ebb7f470215,50200023535069,24394.53,60ec41ba55c00300382672d9,HDFC,Revenue-Mktplace,5eecc6d6449e4f7cfb1c2708,2022-09-12T00:00:00.000Z,NEFT CR-DEUT0797BGL-FLIPKART INTERNET PR IVATE LIMITED-SLICK ORGANICS PVT LTD-225 500172GN00203,shopping,,net_banking_transfer,15356.29
632ae6d92e1a0ebb7f470217,50200023535069,32969.35,60ec41ba55c00300382672d9,HDFC,Revenue-Mktplace,5eecc6d6449e4f7cfb1c2708,2022-09-12T00:00:00.000Z,NEFT CR-DEUT0797BGL-MYNTRA DESIGNS PRIVA TE LIMITED-SLICK ORGANICS PVT. LTD.-2255 00693GN00244,shopping,,net_banking_transfer,8574.82
632ae6d92e1a0ebb7f470219,50200023535069,45838.33,60ec41ba55c00300382672d9,HDFC,Revenue-Mktplace,5eecc6d6449e4f7cfb1c2708,2022-09-12T00:00:00.000Z,NEFT CR-DEUT0797BGL-MYNTRA DESIGNS PRIVA TE LIMITED-SLICK ORGANICS PVT. LTD.-2255 00708GN00082,shopping,,net_banking_transfer,12868.98
632ae6d92e1a0ebb7f47021b,50200023535069,36898.33,60ec41ba55c00300382672d9,HDFC,direct expenses,5eecc6d6449e4f7cfb1c2708,2022-09-12T00:00:00.000Z,02022129150165/ESIC,,,Other,-8940
632ae6d92e1a0ebb7f47021d,50200023535069,47378.49,60ec41ba55c00300382672d9,HDFC,Revenue-PG-non-split,5eecc6d6449e4f7cfb1c2708,2022-09-12T00:00:00.000Z,NEFT CR-PYTM0123456-PAYTM PAYMENTS SERVI,ewallet,,net_banking_transfer,10480.16
632ae6d92e1a0ebb7f47021f,50200023535069,69058.91,60ec41ba55c00300382672d9,HDFC,Revenue-PG-split enabled,5eecc6d6449e4f7cfb1c2708,2022-09-12T00:00:00.000Z,NEFT CR-UTIB0001506-RAZORPAY SOFTWARE PR IVATE LIMITED-SLICK ORGANICS PVT LITD-AX ISCN0165219547,insurance,insurance,net_banking_transfer,21680.42
632ae6d92e1a0ebb7f470221,50200023535069,-42111.09,60ec41ba55c00300382672d9,HDFC,Salary/Emp/consultant Expense,5eecc6d6449e4f7cfb1c2708,2022-09-12T00:00:00.000Z,1894620287/EPFO,,,Other,-111170
632ae6d92e1a0ebb7f470223,50200023535069,-193127.09,60ec41ba55c00300382672d9,HDFC,direct expenses,5eecc6d6449e4f7cfb1c2708,2022-09-12T00:00:00.000Z,"NEFT DR-UTIB0000723-VEDIC COMECEUTICALS PVT LTD-NETBANK, MUM-N255222116161263-15 1016",,,net_banking_transfer,-151016
632ae6d92e1a0ebb7f470225,50200023535069,-193490.09,60ec41ba55c00300382672d9,HDFC,direct expenses,5eecc6d6449e4f7cfb1c2708,2022-09-12T00:00:00.000Z,POS 514834XXXXXX9486 SMARTSHIFT LOGIS,,,debit_card,-363
632ae6d92e1a0ebb7f470227,50200023535069,-42474.09,60ec41ba55c00300382672d9,HDFC,Adjustments/Reversal,5eecc6d6449e4f7cfb1c2708,2022-09-12T00:00:00.000Z,NEFT RETURN-ACCOUNT CLOSED-VEDIC COMECEU TICALS PVT LTD-AXRJ222558896147,,neft_return,refund,151016
632ae6d92e1a0ebb7f470229,50200023535069,-409464.09,60ec41ba55c00300382672d9,HDFC,direct expenses,5eecc6d6449e4f7cfb1c2708,2022-09-12T00:00:00.000Z,POS 514834XXXXXX9486 E-COMMERCE RP,,,debit_card,-366990
632ae6d92e1a0ebb7f47022b,50200023535069,-560480.09,60ec41ba55c00300382672d9,HDFC,direct expenses,5eecc6d6449e4f7cfb1c2708,2022-09-12T00:00:00.000Z,"NEFT DR-KKBK0000180-VEDIC COSMECEUTICALS PVT LTD-NETBANK, MUM-N255222116298310-1 51016",,,net_banking_transfer,-151016
632ae6d92e1a0ebb7f47022e,50200023535069,-552338.7,60ec41ba55c00300382672d9,HDFC,Transfer in/Revenue-other,5eecc6d6449e4f7cfb1c2708,2022-09-12T00:00:00.000Z,NEFT CR-UTIB0000114-ONE SIGMA TECHNOLOGI ES PRIVATE LIM-SLICK ORGANICS PRIVATE LI MITED-AXISP00319271866,insurance,insurance,net_banking_transfer,8141.39
632ae6d92e1a0ebb7f470230,50200023535069,-551620.92,60ec41ba55c00300382672d9,HDFC,Transfer in/Revenue-other,5eecc6d6449e4f7cfb1c2708,2022-09-12T00:00:00.000Z,NEFT CR-UTIB0000114-ONE SIGMA TECHNOLOGI ES PRIVATE LIM-SLICK ORGANICS PRIVATE LI MITED-AXISP00319271915,insurance,insurance,net_banking_transfer,717.78
632ae6d92e1a0ebb7f470232,50200023535069,-549323.38,60ec41ba55c00300382672d9,HDFC,Transfer in/Revenue-other,5eecc6d6449e4f7cfb1c2708,2022-09-12T00:00:00.000Z,NEFT CR-UTIB0000114-ONE SIGMA TECHNOLOGI ES PRIVATE LIM-SLICK ORGANICS PRIVATE LI MITED-AXISP00319271651,insurance,insurance,net_banking_transfer,2297.54
632ae6d92e1a0ebb7f470234,50200023535069,-423878.41,60ec41ba55c00300382672d9,HDFC,Revenue-PG-non-split,5eecc6d6449e4f7cfb1c2708,2022-09-12T00:00:00.000Z,NEFT CR-KKBK0000958-NODAL ACCOUNT BROKEN TUSK TECHNOL-SLICK ORGANICS PRIVATE LIMI TED-CMS2552225643531,insurance,insurance,net_banking_transfer,125444.97
632ae6d92e1a0ebb7f470236,50200023535069,-443878.41,60ec41ba55c00300382672d9,HDFC,direct expenses,5eecc6d6449e4f7cfb1c2708,2022-09-12T00:00:00.000Z,POS 514834XXXXXX9486 FLIPKART,shopping,,debit_card,-20000
632ae6d92e1a0ebb7f470238,50200023535069,-444314.41,60ec41ba55c00300382672d9,HDFC,direct expenses,5eecc6d6449e4f7cfb1c2708,2022-09-12T00:00:00.000Z,POS 514834XXXXXX9486 SMARTSHIFT LOGIS,,,debit_card,-436
632ae6d92e1a0ebb7f47023a,50200023535069,-444090.41,60ec41ba55c00300382672d9,HDFC,Transfer in/Revenue-other,5eecc6d6449e4f7cfb1c2708,2022-09-12T00:00:00.000Z,FT - CR - 50200038726231 - HOUSE OF BEAU,,,Other,224
632ae6d92e1a0ebb7f47023c,50200023535069,-392621.64,60ec41ba55c00300382672d9,HDFC,Revenue-COD,5eecc6d6449e4f7cfb1c2708,2022-09-12T00:00:00.000Z,NEFT CR-ICIC0000155-SHIPROCKET COD CRF I D 4881910-SLICK ORGANICS PVT LTD-CMS2826 576929,insurance,insurance,net_banking_transfer,51468.77
632ae6d92e1a0ebb7f47023e,50200023535069,-367621.64,60ec41ba55c00300382672d9,HDFC,Revenue-Mktplace,5eecc6d6449e4f7cfb1c2708,2022-09-12T00:00:00.000Z,CRV POS-514834******9486-0909-FLIPKART,shopping,,refund,25000
632ae6d92e1a0ebb7f470240,50200023535069,-367258.64,60ec41ba55c00300382672d9,HDFC,Loan-in,5eecc6d6449e4f7cfb1c2708,2022-09-13T00:00:00.000Z,SWEEP-IN CREDIT - 50300675642152,,,self_transfer,363
632ae6d92e1a0ebb7f470243,50200023535069,-151284.64,60ec41ba55c00300382672d9,HDFC,Loan-in,5eecc6d6449e4f7cfb1c2708,2022-09-13T00:00:00.000Z,SWEEP-IN CREDIT - 50300675642152,,,self_transfer,215974
632ae6d92e1a0ebb7f470247,50200023535069,-109172.64,60ec41ba55c00300382672d9,HDFC,Loan-in,5eecc6d6449e4f7cfb1c2708,2022-09-13T00:00:00.000Z,SWEEP-IN CREDIT - 50300675642152,,,self_transfer,42112
632ae6da2e1a0ebb7f470249,50200023535069,0.36,60ec41ba55c00300382672d9,HDFC,Loan-in,5eecc6d6449e4f7cfb1c2708,2022-09-13T00:00:00.000Z,SWEEP-IN CREDIT - 50300675642152,,,self_transfer,109173
632ae6da2e1a0ebb7f47024b,50200023535069,540548.76,60ec41ba55c00300382672d9,HDFC,Revenue-Mktplace,5eecc6d6449e4f7cfb1c2708,2022-09-13T00:00:00.000Z,NEFT CR-DEUT0797BGL-AMAZON PAY (INDIA) P RIVATE LIMITED-SLICK ORGANICS PVT LTD-22 5600117GN00341,shopping,,net_banking_transfer,540548.4
632ae6da2e1a0ebb7f47024d,50200023535069,551263.66,60ec41ba55c00300382672d9,HDFC,Revenue-PG-non-split,5eecc6d6449e4f7cfb1c2708,2022-09-13T00:00:00.000Z,NEFT CR-PYTM0123456-PAYTM PAYMENTS SERVI CES LIMITED-SLICK ORGANICS PVT LTD-PYTM2 22567527032,insurance,insurance,net_banking_transfer,10714.9
632ae6da2e1a0ebb7f47024f,50200023535069,554446.05,60ec41ba55c00300382672d9,HDFC,Revenue-PG-split enabled,5eecc6d6449e4f7cfb1c2708,2022-09-13T00:00:00.000Z,NEFT CR-UTIB0001506-RAZORPAY SOFTWARE PR IVATE LIMITED-SLICK ORGANICS PVT LITD-AX ISCN0165454663,insurance,insurance,net_banking_transfer,3182.39
632ae6da2e1a0ebb7f470251,50200023535069,354446.05,60ec41ba55c00300382672d9,HDFC,direct expenses,5eecc6d6449e4f7cfb1c2708,2022-09-13T00:00:00.000Z,"NEFT DR-YESB0000551-VISTTA COSMETICS-NET BANK, MUM-N256222117753412-200000",,,net_banking_transfer,-200000
632ae6da2e1a0ebb7f470253,50200023535069,-145553.95,60ec41ba55c00300382672d9,HDFC,direct expenses,5eecc6d6449e4f7cfb1c2708,2022-09-13T00:00:00.000Z,05892560000649-TPT-500000-DECORPAC INDIA PRIVATE LIMITED,,,net_banking_transfer,-500000
632ae6da2e1a0ebb7f470255,50200023535069,-445553.95,60ec41ba55c00300382672d9,HDFC,direct expenses,5eecc6d6449e4f7cfb1c2708,2022-09-13T00:00:00.000Z,"NEFT DR-KKBK0000180-VEDIC COSMECEUTICALS PVT LTD-NETBANK, MUM-N256222117754588-3 00000",,,net_banking_transfer,-300000
632ae6da2e1a0ebb7f470258,50200023535069,-945553.95,60ec41ba55c00300382672d9,HDFC,direct expenses,5eecc6d6449e4f7cfb1c2708,2022-09-13T00:00:00.000Z,"NEFT DR-ICIC0000369-BO INTERNATIONAL-NET BANK, MUM-N256222117765432-500000",,,net_banking_transfer,-500000
632ae6da2e1a0ebb7f47025a,50200023535069,-1662453.95,60ec41ba55c00300382672d9,HDFC,direct expenses,5eecc6d6449e4f7cfb1c2708,2022-09-13T00:00:00.000Z,"NEFT DR-ICIC0000024-TAKE MOTO YOHKI INDI A PRIVATE LIMITED-NETBANK, MUM-N25622211 7792990-716900",travel,,net_banking_transfer,-716900
632ae6da2e1a0ebb7f47025c,50200023535069,-1771631.95,60ec41ba55c00300382672d9,HDFC,direct expenses,5eecc6d6449e4f7cfb1c2708,2022-09-13T00:00:00.000Z,00921000075586-TPT-109178-ROET BINDRA,,,net_banking_transfer,-109178
632ae6da2e1a0ebb7f47025e,50200023535069,-1796545.95,60ec41ba55c00300382672d9,HDFC,direct expenses,5eecc6d6449e4f7cfb1c2708,2022-09-13T00:00:00.000Z,50200008269056-TPT-24914-ARTISAN FURNISH,,,net_banking_transfer,-24914
632ae6da2e1a0ebb7f470260,50200023535069,-1798335.31,60ec41ba55c00300382672d9,HDFC,direct expenses,5eecc6d6449e4f7cfb1c2708,2022-09-13T00:00:00.000Z,POS 514834XXXXXX9486 ONE97 COMMUNICAT,ewallet,,debit_card,-1789.36
632ae6da2e1a0ebb7f470263,50200023535069,-1806980.31,60ec41ba55c00300382672d9,HDFC,direct expenses,5eecc6d6449e4f7cfb1c2708,2022-09-13T00:00:00.000Z,"NEFT DR-UTIB0003142-ELIZABETH THALEX-NET BANK, MUM-N256222118020135-8645",,,net_banking_transfer,-8645
632ae6da2e1a0ebb7f470265,50200023535069,-1823780.31,60ec41ba55c00300382672d9,HDFC,direct expenses,5eecc6d6449e4f7cfb1c2708,2022-09-13T00:00:00.000Z,"NEFT DR-ICIC0000020-MANASH LIFESTYLE PRI VATE LIMITED-NETBANK, MUM-N2562221180616 86-16800",shopping,,net_banking_transfer,-16800
632ae6da2e1a0ebb7f470267,50200023535069,-1801801.13,60ec41ba55c00300382672d9,HDFC,Revenue-PG-non-split,5eecc6d6449e4f7cfb1c2708,2022-09-13T00:00:00.000Z,NEFT CR-KKBK0000958-NODAL ACCOUNT BROKEN TUSK TECHNOL-SLICK ORGANICS PRIVATE LIMI TED-CMS2562225796765,insurance,insurance,net_banking_transfer,21979.18
632ae6da2e1a0ebb7f470269,50200023535069,-1803870.13,60ec41ba55c00300382672d9,HDFC,SAAS/tech expense,5eecc6d6449e4f7cfb1c2708,2022-09-13T00:00:00.000Z,POS 514834XXXXXX9486 AMAZON,shopping,,debit_card,-2069
632ae6da2e1a0ebb7f47026b,50200023535069,-1805990.59,60ec41ba55c00300382672d9,HDFC,direct expenses,5eecc6d6449e4f7cfb1c2708,2022-09-13T00:00:00.000Z,POS 514834XXXXXX9486 PAYTM_PAYTMBILL,bills,,debit_card,-2120.46
632ae6da2e1a0ebb7f47026d,50200023535069,-1794625.34,60ec41ba55c00300382672d9,HDFC,Revenue-PG-split enabled,5eecc6d6449e4f7cfb1c2708,2022-09-13T00:00:00.000Z,NEFT CR-UTIB0001506-RAZORPAY SOFTWARE PR IVATE LIMITED-SLICK ORGANICS PVT LITD-AX ISCN0165613612,insurance,insurance,net_banking_transfer,11365.25
632ae6da2e1a0ebb7f470270,50200023535069,-1794624.34,60ec41ba55c00300382672d9,HDFC,Transfer in/Revenue-other,5eecc6d6449e4f7cfb1c2708,2022-09-14T00:00:00.000Z,INT. ON SWCR ON-50300675642152,,,Other,1
632ae6da2e1a0ebb7f470272,50200023535069,-1792834.34,60ec41ba55c00300382672d9,HDFC,Loan-in,5eecc6d6449e4f7cfb1c2708,2022-09-14T00:00:00.000Z,SWEEP-IN CREDIT - 50300675642152,,,self_transfer,1790
632ae6da2e1a0ebb7f470274,50200023535069,-1792785.34,60ec41ba55c00300382672d9,HDFC,Transfer in/Revenue-other,5eecc6d6449e4f7cfb1c2708,2022-09-14T00:00:00.000Z,INT. ON SWCR ON-50300675642152,,,Other,49
632ae6da2e1a0ebb7f470276,50200023535069,-1647231.34,60ec41ba55c00300382672d9,HDFC,Loan-in,5eecc6d6449e4f7cfb1c2708,2022-09-14T00:00:00.000Z,SWEEP-IN CREDIT - 50300675642152,,,self_transfer,145554
632ae6da2e1a0ebb7f470278,50200023535069,-1647130.34,60ec41ba55c00300382672d9,HDFC,Transfer in/Revenue-other,5eecc6d6449e4f7cfb1c2708,2022-09-14T00:00:00.000Z,INT. ON SWCR ON-50300675642152,,,Other,101
632ae6da2e1a0ebb7f47027a,50200023535069,-1347130.34,60ec41ba55c00300382672d9,HDFC,Loan-in,5eecc6d6449e4f7cfb1c2708,2022-09-14T00:00:00.000Z,SWEEP-IN CREDIT - 50300675642152,,,self_transfer,300000
632ae6da2e1a0ebb7f47027c,50200023535069,-1346962.34,60ec41ba55c00300382672d9,HDFC,Transfer in/Revenue-other,5eecc6d6449e4f7cfb1c2708,2022-09-14T00:00:00.000Z,INT. ON SWCR ON-50300675642152,,,Other,168
632ae6da2e1a0ebb7f47027e,50200023535069,-846962.34,60ec41ba55c00300382672d9,HDFC,Loan-in,5eecc6d6449e4f7cfb1c2708,2022-09-14T00:00:00.000Z,SWEEP-IN CREDIT - 50300675642152,,,self_transfer,500000
632ae6da2e1a0ebb7f470280,50200023535069,-846721.34,60ec41ba55c00300382672d9,HDFC,Transfer in/Revenue-other,5eecc6d6449e4f7cfb1c2708,2022-09-14T00:00:00.000Z,INT. ON SWCR ON-50300675642152,,,Other,241
632ae6da2e1a0ebb7f470282,50200023535069,-129821.34,60ec41ba55c00300382672d9,HDFC,Loan-in,5eecc6d6449e4f7cfb1c2708,2022-09-14T00:00:00.000Z,SWEEP-IN CREDIT - 50300675642152,,,self_transfer,716900
632ae6da2e1a0ebb7f470284,50200023535069,-129784.34,60ec41ba55c00300382672d9,HDFC,Transfer in/Revenue-other,5eecc6d6449e4f7cfb1c2708,2022-09-14T00:00:00.000Z,INT. ON SWCR ON-50300675642152,,,Other,37
632ae6da2e1a0ebb7f470286,50200023535069,-20606.34,60ec41ba55c00300382672d9,HDFC,Loan-in,5eecc6d6449e4f7cfb1c2708,2022-09-14T00:00:00.000Z,SWEEP-IN CREDIT - 50300675642152,,,self_transfer,109178
632ae6da2e1a0ebb7f470288,50200023535069,-20599.34,60ec41ba55c00300382672d9,HDFC,Transfer in/Revenue-other,5eecc6d6449e4f7cfb1c2708,2022-09-14T00:00:00.000Z,INT. ON SWCR ON-50300675642152,,,Other,7
632ae6da2e1a0ebb7f47028a,50200023535069,7.66,60ec41ba55c00300382672d9,HDFC,Loan-in,5eecc6d6449e4f7cfb1c2708,2022-09-14T00:00:00.000Z,SWEEP-IN CREDIT - 50300675642152,,,self_transfer,20607
632ae6da2e1a0ebb7f47028c,50200023535069,138925.02,60ec41ba55c00300382672d9,HDFC,Revenue-Mktplace,5eecc6d6449e4f7cfb1c2708,2022-09-14T00:00:00.000Z,NEFT CR-DEUT0797BGL-FLIPKART INTERNET PR IVATE LIMITED-SLICK ORGANICS PVT LTD-225 700141GN00105,shopping,,net_banking_transfer,138917.36
632ae6da2e1a0ebb7f47028e,50200023535069,151123.94,60ec41ba55c00300382672d9,HDFC,Revenue-PG-non-split,5eecc6d6449e4f7cfb1c2708,2022-09-14T00:00:00.000Z,NEFT CR-PYTM0123456-PAYTM PAYMENTS SERVI,ewallet,,net_banking_transfer,12198.92
632ae6da2e1a0ebb7f470290,50200023535069,181098.06,60ec41ba55c00300382672d9,HDFC,Revenue-Mktplace,5eecc6d6449e4f7cfb1c2708,2022-09-14T00:00:00.000Z,NEFT CR-DEUT0797BGL-MYNTRA DESIGNS PRIVA TE LIMITED-SLICK ORGANICS PVT. LTD.-2257 00717GN00185,shopping,,net_banking_transfer,29974.12
632ae6da2e1a0ebb7f470292,50200023535069,-7571.94,60ec41ba55c00300382672d9,HDFC,direct expenses,5eecc6d6449e4f7cfb1c2708,2022-09-14T00:00:00.000Z,"NEFT DR-SRCB0000281-3D TECHNOPACK PRIVAT E LIMITED-NETBANK, MUM-N257222119303312- 188670",,,net_banking_transfer,-188670
632ae6da2e1a0ebb7f470294,50200023535069,-274775.94,60ec41ba55c00300382672d9,HDFC,direct expenses,5eecc6d6449e4f7cfb1c2708,2022-09-14T00:00:00.000Z,"NEFT DR-SRCB0000281-3D TECHNOPACK PRIVAT E LIMITED-NETBANK, MUM-N257222119307143- 267204",,,net_banking_transfer,-267204
632ae6da2e1a0ebb7f470296,50200023535069,-324775.94,60ec41ba55c00300382672d9,HDFC,direct expenses,5eecc6d6449e4f7cfb1c2708,2022-09-14T00:00:00.000Z,"NEFT DR-PUNB0062910-YADAVPACKAGING-NETBA NK, MUM-N257222119304385-50000",,,net_banking_transfer,-50000
632ae6da2e1a0ebb7f470298,50200023535069,-481542.94,60ec41ba55c00300382672d9,HDFC,direct expenses,5eecc6d6449e4f7cfb1c2708,2022-09-14T00:00:00.000Z,"NEFT DR-KKBK0004581-MJ GLOBAL PVT LTD-NE TBANK, MUM-N257222119317206-156767",,,net_banking_transfer,-156767
632ae6da2e1a0ebb7f47029b,50200023535069,-473657.9,60ec41ba55c00300382672d9,HDFC,Revenue-Mktplace,5eecc6d6449e4f7cfb1c2708,2022-09-14T00:00:00.000Z,NEFT CR-DEUT0797BGL-MYNTRA DESIGNS PRIVA TE LIMITED-SLICK ORGANICS PVT. LTD.-2257 00728GN00033,shopping,,net_banking_transfer,7885.04
632ae6da2e1a0ebb7f4702a0,50200023535069,-460342.43,60ec41ba55c00300382672d9,HDFC,Revenue-PG-split enabled,5eecc6d6449e4f7cfb1c2708,2022-09-14T00:00:00.000Z,NEFT CR-UTIB0001506-RAZORPAY SOFTWARE PR IVATE LIMITED-SLICK ORGANICS PVT LITD-AX ISCN0165687126,insurance,insurance,net_banking_transfer,13315.47
632ae6da2e1a0ebb7f4702a3,50200023535069,-461726.61,60ec41ba55c00300382672d9,HDFC,bank charges,5eecc6d6449e4f7cfb1c2708,2022-09-14T00:00:00.000Z,.DC INTL POS TXN MARKUP+ST 020822 040822 -CDT2225311069883,,,international_transaction_arbitrage,-1384.18
632ae6da2e1a0ebb7f4702a5,50200023535069,-478309.67,60ec41ba55c00300382672d9,HDFC,bank charges,5eecc6d6449e4f7cfb1c2708,2022-09-14T00:00:00.000Z,.DC INTL POS TXN MARKUP+ST 020822 040822 -CDT2225311069883,,,international_transaction_arbitrage,-16583.06
632ae6da2e1a0ebb7f4702a7,50200023535069,-478311.67,60ec41ba55c00300382672d9,HDFC,Marketing Expense,5eecc6d6449e4f7cfb1c2708,2022-09-14T00:00:00.000Z,ME DC SI 514834XXXXXX9486 LINKEDIN,,,Other,-2
632ae6da2e1a0ebb7f4702a9,50200023535069,-474083.92,60ec41ba55c00300382672d9,HDFC,Revenue-PG-non-split,5eecc6d6449e4f7cfb1c2708,2022-09-14T00:00:00.000Z,NEFT CR-SCBL0036001-STRIPE INDIA PRIVATE LIMITED-SLICK ORGANICS PRIVATE LIMITED- IN1ON22091400JD5,insurance,insurance,net_banking_transfer,4227.75
632ae6da2e1a0ebb7f4702ab,50200023535069,-474802.92,60ec41ba55c00300382672d9,HDFC,direct expenses,5eecc6d6449e4f7cfb1c2708,2022-09-14T00:00:00.000Z,POS 514834XXXXXX9486 ONE97 COMMUNICAT,ewallet,,debit_card,-719
632ae6da2e1a0ebb7f4702ad,50200023535069,-487546.92,60ec41ba55c00300382672d9,HDFC,direct expenses,5eecc6d6449e4f7cfb1c2708,2022-09-14T00:00:00.000Z,NEFT DR-SBIN0008078-PANDIT PLASTICS-NETB,,,net_banking_transfer,-12744
632ae6da2e1a0ebb7f4702af,50200023535069,-787546.92,60ec41ba55c00300382672d9,HDFC,direct expenses,5eecc6d6449e4f7cfb1c2708,2022-09-14T00:00:00.000Z,"NEFT DR-YESB0000551-VISTTA COSMETICS-NET BANK, MUM-N257222119511601-300000",,,net_banking_transfer,-300000
632ae6da2e1a0ebb7f4702b1,50200023535069,-775673.45,60ec41ba55c00300382672d9,HDFC,Revenue-Mktplace,5eecc6d6449e4f7cfb1c2708,2022-09-14T00:00:00.000Z,NEFT CR-HSBC0400002-AMAZON SERVICES LLC- SLICK ORGANICS PRIVATE LIMITED-HSBCN2225 7479742,shopping,,net_banking_transfer,11873.47
632ae6da2e1a0ebb7f4702b3,50200023535069,-776133.64,60ec41ba55c00300382672d9,HDFC,direct expenses,5eecc6d6449e4f7cfb1c2708,2022-09-14T00:00:00.000Z,POS 514834XXXXXX9486 PTM*PAYTM WALLET,ewallet,,debit_card,-460.19
632ae6da2e1a0ebb7f4702b5,50200023535069,-777468.64,60ec41ba55c00300382672d9,HDFC,direct expenses,5eecc6d6449e4f7cfb1c2708,2022-09-14T00:00:00.000Z,POS 514834XXXXXX9486 SMARTSHIFT LOGIS,,,debit_card,-1335
632ae6da2e1a0ebb7f4702b7,50200023535069,-784943.64,60ec41ba55c00300382672d9,HDFC,direct expenses,5eecc6d6449e4f7cfb1c2708,2022-09-14T00:00:00.000Z,"NEFT DR-SBIN0070392-APARNA MOHANAN KONAT -NETBANK, MUM-N257222119785798-7475",,,net_banking_transfer,-7475
632ae6da2e1a0ebb7f4702b9,50200023535069,-785039.07,60ec41ba55c00300382672d9,HDFC,bank charges,5eecc6d6449e4f7cfb1c2708,2022-09-14T00:00:00.000Z,.DC INTL POS TXN MARKUP+ST 090822 100822 -CDT2225311069883,,,international_transaction_arbitrage,-95.43
632ae6da2e1a0ebb7f4702bb,50200023535069,-747335.01,60ec41ba55c00300382672d9,HDFC,Revenue-UPI,5eecc6d6449e4f7cfb1c2708,2022-09-14T00:00:00.000Z,UPI-GOKWIK-GOKWIK@YESBANK-YESB0000340-22 5722756185-PAYOUT FOR SEPTEMB,,,upi,37704.06
632ae6da2e1a0ebb7f4702bd,50200023535069,-740903.89,60ec41ba55c00300382672d9,HDFC,Transfer in/Revenue-other,5eecc6d6449e4f7cfb1c2708,2022-09-14T00:00:00.000Z,NEFT CR-UTIB0000114-ONE SIGMA TECHNOLOGI ES PRIVATE LIM-SLICK ORGANICS PRIVATE LI MITED-AXISP00319849088,insurance,insurance,net_banking_transfer,6431.12
632ae6da2e1a0ebb7f4702bf,50200023535069,-718937.36,60ec41ba55c00300382672d9,HDFC,Revenue-COD,5eecc6d6449e4f7cfb1c2708,2022-09-14T00:00:00.000Z,NEFT CR-ICIC0000155-SHIPROCKET COD CRF I D 4894207-SLICK ORGANICS PVT LTD-CMS2831 682273,insurance,insurance,net_banking_transfer,21966.53
632ae6da2e1a0ebb7f4702c1,50200023535069,-717074.36,60ec41ba55c00300382672d9,HDFC,Revenue-Mktplace,5eecc6d6449e4f7cfb1c2708,2022-09-14T00:00:00.000Z,NEFT CR-SCBL0036001-DREAMPLUG TECHNOLOGI ES PRIVATE LIMITED-SLICK ORGANICS PRIVAT E LIMITEDSLICK-IN1ON22091402E3W,,,net_banking_transfer,1863
632ae6da2e1a0ebb7f4702c3,50200023535069,-717235.61,60ec41ba55c00300382672d9,HDFC,bank charges,5eecc6d6449e4f7cfb1c2708,2022-09-14T00:00:00.000Z,.DC INTL POS TXN MARKUP+ST 120822 140822 -CDT2225311069883,,,international_transaction_arbitrage,-161.25
632ae6da2e1a0ebb7f4702c5,50200023535069,-678102.38,60ec41ba55c00300382672d9,HDFC,Revenue-PG-non-split,5eecc6d6449e4f7cfb1c2708,2022-09-14T00:00:00.000Z,NEFT CR-KKBK0000958-NODAL ACCOUNT BROKEN TUSK TECHNOL-SLICK ORGANICS PRIVATE LIMI TED-CMS2572225937925,insurance,insurance,net_banking_transfer,39133.23
632ae6da2e1a0ebb7f4702c7,50200023535069,-672667.9,60ec41ba55c00300382672d9,HDFC,Revenue-PG-split enabled,5eecc6d6449e4f7cfb1c2708,2022-09-14T00:00:00.000Z,NEFT CR-UTIB0001506-RAZORPAY SOFTWARE PR IVATE LIMITED-SLICK ORGANICS PVT LITD-AX ISCN0165823033,insurance,insurance,net_banking_transfer,5434.48
632ae6da2e1a0ebb7f4702c9,50200023535069,-672664.9,60ec41ba55c00300382672d9,HDFC,Transfer in/Revenue-other,5eecc6d6449e4f7cfb1c2708,2022-09-15T00:00:00.000Z,INT. ON SWCR ON-50300675642152,,,Other,3
632ae6da2e1a0ebb7f4702cb,50200023535069,-665092.9,60ec41ba55c00300382672d9,HDFC,Loan-in,5eecc6d6449e4f7cfb1c2708,2022-09-15T00:00:00.000Z,SWEEP-IN CREDIT - 50300675642152,,,self_transfer,7572
632ae6da2e1a0ebb7f4702cd,50200023535069,-664990.9,60ec41ba55c00300382672d9,HDFC,Transfer in/Revenue-other,5eecc6d6449e4f7cfb1c2708,2022-09-15T00:00:00.000Z,INT. ON SWCR ON-50300675642152,,,Other,102
632ae6da2e1a0ebb7f4702cf,50200023535069,-397786.9,60ec41ba55c00300382672d9,HDFC,Loan-in,5eecc6d6449e4f7cfb1c2708,2022-09-15T00:00:00.000Z,SWEEP-IN CREDIT - 50300675642152,,,self_transfer,267204
632ae6da2e1a0ebb7f4702d2,50200023535069,-397767.9,60ec41ba55c00300382672d9,HDFC,Transfer in/Revenue-other,5eecc6d6449e4f7cfb1c2708,2022-09-15T00:00:00.000Z,INT. ON SWCR ON-50300675642152,,,Other,19
632ae6da2e1a0ebb7f4702d4,50200023535069,-347767.9,60ec41ba55c00300382672d9,HDFC,Loan-in,5eecc6d6449e4f7cfb1c2708,2022-09-15T00:00:00.000Z,SWEEP-IN CREDIT - 50300675642152,,,self_transfer,50000
632ae6da2e1a0ebb7f4702d6,50200023535069,-347707.9,60ec41ba55c00300382672d9,HDFC,Transfer in/Revenue-other,5eecc6d6449e4f7cfb1c2708,2022-09-15T00:00:00.000Z,INT. ON SWCR ON-50300675642152,,,Other,60
632ae6da2e1a0ebb7f4702d8,50200023535069,-190940.9,60ec41ba55c00300382672d9,HDFC,Loan-in,5eecc6d6449e4f7cfb1c2708,2022-09-15T00:00:00.000Z,SWEEP-IN CREDIT - 50300675642152,,,self_transfer,156767
632ae6da2e1a0ebb7f4702da,50200023535069,-190938.9,60ec41ba55c00300382672d9,HDFC,Transfer in/Revenue-other,5eecc6d6449e4f7cfb1c2708,2022-09-15T00:00:00.000Z,INT. ON SWCR ON-50300675642152,,,Other,2
632ae6db2e1a0ebb7f4702dc,50200023535069,-184934.9,60ec41ba55c00300382672d9,HDFC,Loan-in,5eecc6d6449e4f7cfb1c2708,2022-09-15T00:00:00.000Z,SWEEP-IN CREDIT - 50300675642152,,,self_transfer,6004
632ae6db2e1a0ebb7f4702de,50200023535069,-184863.9,60ec41ba55c00300382672d9,HDFC,Transfer in/Revenue-other,5eecc6d6449e4f7cfb1c2708,2022-09-15T00:00:00.000Z,INT. ON SWCR ON-50300675642152,,,Other,71
632ae6db2e1a0ebb7f4702e1,50200023535069,71.1,60ec41ba55c00300382672d9,HDFC,Loan-in,5eecc6d6449e4f7cfb1c2708,2022-09-15T00:00:00.000Z,SWEEP-IN CREDIT - 50300675642152,,,self_transfer,184935
632ae6db2e1a0ebb7f4702e3,50200023535069,15719.09,60ec41ba55c00300382672d9,HDFC,Revenue-PG-non-split,5eecc6d6449e4f7cfb1c2708,2022-09-15T00:00:00.000Z,NEFT CR-PYTM0123456-PAYTM PAYMENTS SERVI CES LIMITED-SLICK ORGANICS PVT LTD-PYTM2 22580541289,insurance,insurance,net_banking_transfer,15647.99
632ae6db2e1a0ebb7f4702e5,50200023535069,-134280.91,60ec41ba55c00300382672d9,HDFC,direct expenses,5eecc6d6449e4f7cfb1c2708,2022-09-15T00:00:00.000Z,"NEFT DR-IDFB0040101-ACTIVES ADDITIVES AP PLICATIONS LLP-NETBANK, MUM-N25822212116 1243-150000",insurance,insurance,net_banking_transfer,-150000
632ae6db2e1a0ebb7f4702e8,50200023535069,-258642.91,60ec41ba55c00300382672d9,HDFC,direct expenses,5eecc6d6449e4f7cfb1c2708,2022-09-15T00:00:00.000Z,"NEFT DR-SBIN0011783-GALACTIC GRIP-NETBAN K, MUM-N258222121162048-124362",,,net_banking_transfer,-124362
632ae6db2e1a0ebb7f4702ea,50200023535069,-258644.91,60ec41ba55c00300382672d9,HDFC,Marketing Expense,5eecc6d6449e4f7cfb1c2708,2022-09-15T00:00:00.000Z,ME DC SI 514834XXXXXX9486 LINKEDIN,,,Other,-2
632ae6db2e1a0ebb7f4702ec,50200023535069,-258816.91,60ec41ba55c00300382672d9,HDFC,direct expenses,5eecc6d6449e4f7cfb1c2708,2022-09-15T00:00:00.000Z,POS 514834XXXXXX9486 SMARTSHIFT LOGIS,,,debit_card,-172
632ae6db2e1a0ebb7f4702ee,50200023535069,-245370.35,60ec41ba55c00300382672d9,HDFC,Revenue-PG-split enabled,5eecc6d6449e4f7cfb1c2708,2022-09-15T00:00:00.000Z,NEFT CR-UTIB0001506-RAZORPAY SOFTWARE PR IVATE LIMITED-SLICK ORGANICS PVT LITD-AX ISCN0165914085,insurance,insurance,net_banking_transfer,13446.56
632ae6db2e1a0ebb7f4702f0,50200023535069,-245670.35,60ec41ba55c00300382672d9,HDFC,direct expenses,5eecc6d6449e4f7cfb1c2708,2022-09-15T00:00:00.000Z,POS 514834XXXXXX9486 SMARTSHIFT LOGIS,,,debit_card,-300
632ae6db2e1a0ebb7f4702f2,50200023535069,-244028.27,60ec41ba55c00300382672d9,HDFC,Transfer in/Revenue-other,5eecc6d6449e4f7cfb1c2708,2022-09-15T00:00:00.000Z,NEFT CR-UTIB0000114-ONE SIGMA TECHNOLOGI ES PRIVATE LIM-SLICK ORGANICS PRIVATE LI MITED-AXISP00320181380,insurance,insurance,net_banking_transfer,1642.08
632ae6db2e1a0ebb7f4702f4,50200023535069,-218814.73,60ec41ba55c00300382672d9,HDFC,Revenue-PG-split enabled,5eecc6d6449e4f7cfb1c2708,2022-09-15T00:00:00.000Z,NEFT CR-UTIB0001506-RAZORPAY SOFTWARE PR,,,net_banking_transfer,25213.54
632ae6db2e1a0ebb7f4702f6,50200023535069,-187742.74,60ec41ba55c00300382672d9,HDFC,Revenue-PG-non-split,5eecc6d6449e4f7cfb1c2708,2022-09-15T00:00:00.000Z,NEFT CR-KKBK0000958-NODAL ACCOUNT BROKEN TUSK TECHNOL-SLICK ORGANICS PRIVATE LIMI TED-CMS2582226059041,insurance,insurance,net_banking_transfer,31071.99
632ae6db2e1a0ebb7f4702fa,50200023535069,-178400.74,60ec41ba55c00300382672d9,HDFC,Revenue-Mktplace,5eecc6d6449e4f7cfb1c2708,2022-09-15T00:00:00.000Z,NEFT CR-ICIC0000985-DIGITAL AGE RETAIL P VT LTD-SLICK ORGANICS PVT LTD DS-CMS28 34738090,,,net_banking_transfer,9342
632ae6db2e1a0ebb7f4702fc,50200023535069,-178398.74,60ec41ba55c00300382672d9,HDFC,Loan-in,5eecc6d6449e4f7cfb1c2708,2022-09-16T00:00:00.000Z,SWEEP-IN CREDIT - 50300675642152,,,self_transfer,2
632ae6db2e1a0ebb7f4702fe,50200023535069,-178226.74,60ec41ba55c00300382672d9,HDFC,Loan-in,5eecc6d6449e4f7cfb1c2708,2022-09-16T00:00:00.000Z,SWEEP-IN CREDIT - 50300675642152,,,self_transfer,172
632ae6db2e1a0ebb7f470300,50200023535069,-178168.74,60ec41ba55c00300382672d9,HDFC,Transfer in/Revenue-other,5eecc6d6449e4f7cfb1c2708,2022-09-16T00:00:00.000Z,INT. ON SWCR ON-50300675642152,,,Other,58
632ae6db2e1a0ebb7f470302,50200023535069,-43887.74,60ec41ba55c00300382672d9,HDFC,Loan-in,5eecc6d6449e4f7cfb1c2708,2022-09-16T00:00:00.000Z,SWEEP-IN CREDIT - 50300675642152,,,self_transfer,134281
632ae6db2e1a0ebb7f470304,50200023535069,-43868.74,60ec41ba55c00300382672d9,HDFC,Transfer in/Revenue-other,5eecc6d6449e4f7cfb1c2708,2022-09-16T00:00:00.000Z,INT. ON SWCR ON-50300675642152,,,Other,19
632ae6db2e1a0ebb7f470306,50200023535069,19.26,60ec41ba55c00300382672d9,HDFC,Loan-in,5eecc6d6449e4f7cfb1c2708,2022-09-16T00:00:00.000Z,SWEEP-IN CREDIT - 50300675642152,,,self_transfer,43888
632ae9292e1a0ebb7f4883f1,50200035187206,-500000,60ec419255c00300382671a5,HDFC,Internal Transfers,5eecc6d6449e4f7cfb1c2708,2022-04-01T00:00:00.000Z,IB FUNDS TRANSFER DR-50200023535069 -SL ICK ORGANICS PVT LTD,insurance,insurance,net_banking_transfer,-500000
632ae9292e1a0ebb7f4883f3,50200035187206,-1000000,60ec419255c00300382671a5,HDFC,Internal Transfers,5eecc6d6449e4f7cfb1c2708,2022-04-01T00:00:00.000Z,IB FUNDS TRANSFER DR-50200023535069 -SL ICK ORGANICS PVT LTD,insurance,insurance,net_banking_transfer,-500000
632ae9292e1a0ebb7f4883f5,50200035187206,-1500000,60ec419255c00300382671a5,HDFC,Internal Transfers,5eecc6d6449e4f7cfb1c2708,2022-04-01T00:00:00.000Z,IB FUNDS TRANSFER DR-50200023535069 -SL ICK ORGANICS PVT LTD,insurance,insurance,net_banking_transfer,-500000
632ae9292e1a0ebb7f4883f7,50200035187206,-1499607.96,60ec419255c00300382671a5,HDFC,Transfer in/Revenue-other,5eecc6d6449e4f7cfb1c2708,2022-04-02T00:00:00.000Z,INT. ON SWCR ON-50300599981225,,,Other,392.04
632ae9292e1a0ebb7f4883f9,50200035187206,-999607.96,60ec419255c00300382671a5,HDFC,Loan-in,5eecc6d6449e4f7cfb1c2708,2022-04-02T00:00:00.000Z,SWEEP-IN CREDIT - 50300599981225,,,self_transfer,500000
632ae9292e1a0ebb7f4883fb,50200035187206,-499215.92,60ec419255c00300382671a5,HDFC,Transfer in/Revenue-other,5eecc6d6449e4f7cfb1c2708,2022-04-02T00:00:00.000Z,INT. ON SWCR ON-50300599981225,,,Other,392.04
632ae9292e1a0ebb7f4883fd,50200035187206,-499607.96,60ec419255c00300382671a5,HDFC,Loan-in,5eecc6d6449e4f7cfb1c2708,2022-04-02T00:00:00.000Z,SWEEP-IN CREDIT - 50300599981225,,,self_transfer,500000
632ae9292e1a0ebb7f4883ff,50200035187206,-96001.39,60ec419255c00300382671a5,HDFC,Transfer in/Revenue-other,5eecc6d6449e4f7cfb1c2708,2022-04-02T00:00:00.000Z,INT. ON SWCR ON-50300599981225,,,Other,316.53
632ae9292e1a0ebb7f488401,50200035187206,-96317.92,60ec419255c00300382671a5,HDFC,Loan-in,5eecc6d6449e4f7cfb1c2708,2022-04-02T00:00:00.000Z,SWEEP-IN CREDIT - 50300599981225,,,self_transfer,402898
632ae9292e1a0ebb7f488403,50200035187206,75.61,60ec419255c00300382671a5,HDFC,Transfer in/Revenue-other,5eecc6d6449e4f7cfb1c2708,2022-04-02T00:00:00.000Z,INT. ON SWCR ON-50300599982076,,,Other,75
632ae9292e1a0ebb7f488405,50200035187206,0.61,60ec419255c00300382671a5,HDFC,Loan-in,5eecc6d6449e4f7cfb1c2708,2022-04-02T00:00:00.000Z,SWEEP-IN CREDIT - 50300599982076,,,self_transfer,96002
632ae9292e1a0ebb7f488407,50200035187206,-999924.39,60ec419255c00300382671a5,HDFC,Internal Transfers,5eecc6d6449e4f7cfb1c2708,2022-04-06T00:00:00.000Z,IB FUNDS TRANSFER DR-50200023535069 -SL ICK ORGANICS PVT LTD,insurance,insurance,net_banking_transfer,-1000000
632ae9292e1a0ebb7f488409,50200035187206,-998454.3,60ec419255c00300382671a5,HDFC,Transfer in/Revenue-other,5eecc6d6449e4f7cfb1c2708,2022-04-07T00:00:00.000Z,INT. ON SWCR ON-50300599982076,,,Other,1470.09
632ae9292e1a0ebb7f48840b,50200035187206,1470.7,60ec419255c00300382671a5,HDFC,Loan-in,5eecc6d6449e4f7cfb1c2708,2022-04-07T00:00:00.000Z,SWEEP-IN CREDIT - 50300599982076,,,self_transfer,999925
632ae9292e1a0ebb7f48840d,50200035187206,-998529.3,60ec419255c00300382671a5,HDFC,Internal Transfers,5eecc6d6449e4f7cfb1c2708,2022-04-07T00:00:00.000Z,IB FUNDS TRANSFER DR-50200023535069 -SL ICK ORGANICS PVT LTD,insurance,insurance,net_banking_transfer,-1000000
632ae9292e1a0ebb7f48840f,50200035187206,-1998529.3,60ec419255c00300382671a5,HDFC,Internal Transfers,5eecc6d6449e4f7cfb1c2708,2022-04-07T00:00:00.000Z,IB FUNDS TRANSFER DR-50200023535069 -SL ICK ORGANICS PVT LTD,insurance,insurance,net_banking_transfer,-1000000
632ae9292e1a0ebb7f488411,50200035187206,-998476.58,60ec419255c00300382671a5,HDFC,Transfer in/Revenue-other,5eecc6d6449e4f7cfb1c2708,2022-04-08T00:00:00.000Z,INT. ON SWCR ON-50300599982076,,,Other,1522.72
632ae9292e1a0ebb7f488413,50200035187206,-999999.3,60ec419255c00300382671a5,HDFC,Loan-in,5eecc6d6449e4f7cfb1c2708,2022-04-08T00:00:00.000Z,SWEEP-IN CREDIT - 50300599982076,,,self_transfer,998530
632ae9292e1a0ebb7f488415,50200035187206,1523.16,60ec419255c00300382671a5,HDFC,Transfer in/Revenue-other,5eecc6d6449e4f7cfb1c2708,2022-04-08T00:00:00.000Z,INT. ON SWCR ON-50300599982076,,,Other,1522.74
632ae9292e1a0ebb7f488417,50200035187206,0.42,60ec419255c00300382671a5,HDFC,Loan-in,5eecc6d6449e4f7cfb1c2708,2022-04-08T00:00:00.000Z,SWEEP-IN CREDIT - 50300599982076,,,self_transfer,998477
632ae9292e1a0ebb7f488419,50200035187206,-498476.84,60ec419255c00300382671a5,HDFC,Internal Transfers,5eecc6d6449e4f7cfb1c2708,2022-04-09T00:00:00.000Z,IB FUNDS TRANSFER DR-50200023535069 -SL ICK ORGANICS PVT LTD,insurance,insurance,net_banking_transfer,-500000
632ae9292e1a0ebb7f48841b,50200035187206,814.87,60ec419255c00300382671a5,HDFC,Transfer in/Revenue-other,5eecc6d6449e4f7cfb1c2708,2022-04-09T00:00:00.000Z,INT. ON SWCR ON-50300599982076,,,Other,814.71
632ae9292e1a0ebb7f48841d,50200035187206,0.16,60ec419255c00300382671a5,HDFC,Loan-in,5eecc6d6449e4f7cfb1c2708,2022-04-09T00:00:00.000Z,SWEEP-IN CREDIT - 50300599982076,,,self_transfer,498477
632ae9292e1a0ebb7f48841f,50200035187206,-499185.13,60ec419255c00300382671a5,HDFC,Internal Transfers,5eecc6d6449e4f7cfb1c2708,2022-04-10T00:00:00.000Z,IB FUNDS TRANSFER DR-50200023535069 -SL ICK ORGANICS PVT LTD,insurance,insurance,net_banking_transfer,-500000
632ae9292e1a0ebb7f488421,50200035187206,-498314.74,60ec419255c00300382671a5,HDFC,Transfer in/Revenue-other,5eecc6d6449e4f7cfb1c2708,2022-04-12T00:00:00.000Z,INT. ON SWCR ON-50300599982076,,,Other,870.39
632ae9292e1a0ebb7f488423,50200035187206,871.26,60ec419255c00300382671a5,HDFC,Loan-in,5eecc6d6449e4f7cfb1c2708,2022-04-12T00:00:00.000Z,SWEEP-IN CREDIT - 50300599982076,,,self_transfer,499186
632ae9292e1a0ebb7f488425,50200035187206,-499128.74,60ec419255c00300382671a5,HDFC,Internal Transfers,5eecc6d6449e4f7cfb1c2708,2022-04-15T00:00:00.000Z,IB FUNDS TRANSFER DR-50200023535069 -SL ICK ORGANICS PVT LTD,insurance,insurance,net_banking_transfer,-500000
632ae9292e1a0ebb7f488427,50200035187206,-498149.32,60ec419255c00300382671a5,HDFC,Transfer in/Revenue-other,5eecc6d6449e4f7cfb1c2708,2022-04-16T00:00:00.000Z,INT. ON SWCR ON-50300599982076,,,Other,979.42
632ae9292e1a0ebb7f488429,50200035187206,979.68,60ec419255c00300382671a5,HDFC,Loan-in,5eecc6d6449e4f7cfb1c2708,2022-04-16T00:00:00.000Z,SWEEP-IN CREDIT - 50300599982076,,,self_transfer,499129
632ae9292e1a0ebb7f48842b,50200035187206,-999020.32,60ec419255c00300382671a5,HDFC,Internal Transfers,5eecc6d6449e4f7cfb1c2708,2022-04-16T00:00:00.000Z,IB FUNDS TRANSFER DR-50200023535069 -SL ICK ORGANICS PVT LTD,insurance,insurance,net_banking_transfer,-1000000
632ae9292e1a0ebb7f48842d,50200035187206,-1499020.32,60ec419255c00300382671a5,HDFC,Internal Transfers,5eecc6d6449e4f7cfb1c2708,2022-04-16T00:00:00.000Z,IB FUNDS TRANSFER DR-50200023535069,,,net_banking_transfer,-500000
632ae9292e1a0ebb7f48842f,50200035187206,-497983.82,60ec419255c00300382671a5,HDFC,Transfer in/Revenue-other,5eecc6d6449e4f7cfb1c2708,2022-04-16T00:00:00.000Z,INT. ON SWCR ON-50300599982076,,,Other,2015.5
632ae9292e1a0ebb7f488431,50200035187206,-499999.32,60ec419255c00300382671a5,HDFC,Loan-in,5eecc6d6449e4f7cfb1c2708,2022-04-16T00:00:00.000Z,SWEEP-IN CREDIT - 50300599982076,,,self_transfer,999021
632ae9292e1a0ebb7f488433,50200035187206,1005.11,60ec419255c00300382671a5,HDFC,Transfer in/Revenue-other,5eecc6d6449e4f7cfb1c2708,2022-04-16T00:00:00.000Z,INT. ON SWCR ON-50300599982076,,,Other,1004.93
632ae9292e1a0ebb7f488435,50200035187206,0.18,60ec419255c00300382671a5,HDFC,Loan-in,5eecc6d6449e4f7cfb1c2708,2022-04-16T00:00:00.000Z,SWEEP-IN CREDIT - 50300599982076,,,self_transfer,497984
632ae9292e1a0ebb7f488437,50200035187206,-498994.89,60ec419255c00300382671a5,HDFC,Internal Transfers,5eecc6d6449e4f7cfb1c2708,2022-04-17T00:00:00.000Z,IB FUNDS TRANSFER DR-50200023535069 -SL ICK ORGANICS PVT LTD,insurance,insurance,net_banking_transfer,-500000
632ae9292e1a0ebb7f48843a,50200035187206,1034.59,60ec419255c00300382671a5,HDFC,Transfer in/Revenue-other,5eecc6d6449e4f7cfb1c2708,2022-04-18T00:00:00.000Z,INT. ON SWCR ON-50300599982076,,,Other,1034.48
632ae9292e1a0ebb7f48843d,50200035187206,0.11,60ec419255c00300382671a5,HDFC,Loan-in,5eecc6d6449e4f7cfb1c2708,2022-04-18T00:00:00.000Z,SWEEP-IN CREDIT - 50300599982076,,,self_transfer,498995
632ae9292e1a0ebb7f488440,50200035187206,-998965.41,60ec419255c00300382671a5,HDFC,Internal Transfers,5eecc6d6449e4f7cfb1c2708,2022-04-22T00:00:00.000Z,IB FUNDS TRANSFER DR-50200023535069 -SL ICK ORGANICS PVT LTD,insurance,insurance,net_banking_transfer,-1000000
632ae9292e1a0ebb7f488442,50200035187206,-1498965.41,60ec419255c00300382671a5,HDFC,Internal Transfers,5eecc6d6449e4f7cfb1c2708,2022-04-22T00:00:00.000Z,IB FUNDS TRANSFER DR-50200023535069 -SL ICK ORGANICS PVT LTD,insurance,insurance,net_banking_transfer,-500000
632ae9292e1a0ebb7f488444,50200035187206,-1497992.98,60ec419255c00300382671a5,HDFC,Transfer in/Revenue-other,5eecc6d6449e4f7cfb1c2708,2022-04-23T00:00:00.000Z,INT. ON SWCR ON-50300599982076,,,Other,972.43
632ae9292e1a0ebb7f488446,50200035187206,-1083718.98,60ec419255c00300382671a5,HDFC,Loan-in,5eecc6d6449e4f7cfb1c2708,2022-04-23T00:00:00.000Z,SWEEP-IN CREDIT - 50300599982076,,,self_transfer,414274
632ae9292e1a0ebb7f488448,50200035187206,-499026.79,60ec419255c00300382671a5,HDFC,direct expenses,5eecc6d6449e4f7cfb1c2708,2022-04-23T00:00:00.000Z,INT. ON SWCR ON-50300571891040,,,Other,-1579.81
632ae9292e1a0ebb7f48844a,50200035187206,-497446.98,60ec419255c00300382671a5,HDFC,Loan-in,5eecc6d6449e4f7cfb1c2708,2022-04-23T00:00:00.000Z,SWEEP-IN CREDIT - 50300571891040,,,self_transfer,586272
632ae9292e1a0ebb7f48844c,50200035187206,-500378.73,60ec419255c00300382671a5,HDFC,direct expenses,5eecc6d6449e4f7cfb1c2708,2022-04-23T00:00:00.000Z,INT. ON SWCR ON-50300571891040,,,Other,-1351.94
632ae9292e1a0ebb7f48844e,50200035187206,1349.27,60ec419255c00300382671a5,HDFC,Loan-in,5eecc6d6449e4f7cfb1c2708,2022-04-23T00:00:00.000Z,SWEEP-IN CREDIT - 50300571891040,,,self_transfer,501728
632ae9292e1a0ebb7f488450,50200035187206,-498650.73,60ec419255c00300382671a5,HDFC,Internal Transfers,5eecc6d6449e4f7cfb1c2708,2022-04-27T00:00:00.000Z,IB FUNDS TRANSFER DR-50200023535069 -SL ICK ORGANICS PVT LTD,insurance,insurance,net_banking_transfer,-500000
632ae9292e1a0ebb7f488452,50200035187206,2.11,60ec419255c00300382671a5,HDFC,direct expenses,5eecc6d6449e4f7cfb1c2708,2022-04-28T00:00:00.000Z,INT. ON SWCR ON-50300571891040,,,Other,-1175.16
632ae9292e1a0ebb7f488454,50200035187206,1177.27,60ec419255c00300382671a5,HDFC,Loan-in,5eecc6d6449e4f7cfb1c2708,2022-04-28T00:00:00.000Z,SWEEP-IN CREDIT - 50300571891040,,,self_transfer,499828
632ae9292e1a0ebb7f488456,50200035187206,-999997.89,60ec419255c00300382671a5,HDFC,Internal Transfers,5eecc6d6449e4f7cfb1c2708,2022-04-30T00:00:00.000Z,IB FUNDS TRANSFER DR-50200023535069 -SL ICK ORGANICS PVT LTD,insurance,insurance,net_banking_transfer,-1000000
632ae9292e1a0ebb7f488458,50200035187206,1.77,60ec419255c00300382671a5,HDFC,direct expenses,5eecc6d6449e4f7cfb1c2708,2022-05-01T00:00:00.000Z,INT. ON SWCR ON-50300571891040,,,Other,-2151.34
632ae9292e1a0ebb7f48845a,50200035187206,2153.11,60ec419255c00300382671a5,HDFC,Loan-in,5eecc6d6449e4f7cfb1c2708,2022-05-01T00:00:00.000Z,SWEEP-IN CREDIT - 50300571891040,,,self_transfer,1002151
632ae9292e1a0ebb7f48845c,50200035187206,-999998.23,60ec419255c00300382671a5,HDFC,Internal Transfers,5eecc6d6449e4f7cfb1c2708,2022-05-06T00:00:00.000Z,IB FUNDS TRANSFER DR-50200023535069 -SL ICK ORGANICS PVT LTD,insurance,insurance,net_banking_transfer,-1000000
632ae9292e1a0ebb7f48845e,50200035187206,1.6,60ec419255c00300382671a5,HDFC,direct expenses,5eecc6d6449e4f7cfb1c2708,2022-05-07T00:00:00.000Z,INT. ON SWCR ON-50300571891040,,,Other,-1739.17
632ae9292e1a0ebb7f488460,50200035187206,1740.77,60ec419255c00300382671a5,HDFC,Loan-in,5eecc6d6449e4f7cfb1c2708,2022-05-07T00:00:00.000Z,SWEEP-IN CREDIT - 50300571891040,,,self_transfer,1001739
632ae9292e1a0ebb7f488462,50200035187206,-999998.4,60ec419255c00300382671a5,HDFC,Internal Transfers,5eecc6d6449e4f7cfb1c2708,2022-05-07T00:00:00.000Z,IB FUNDS TRANSFER DR-50200023535069 -SL ICK ORGANICS PVT LTD,insurance,insurance,net_banking_transfer,-1000000
632ae9292e1a0ebb7f488464,50200035187206,-1999998.4,60ec419255c00300382671a5,HDFC,Internal Transfers,5eecc6d6449e4f7cfb1c2708,2022-05-07T00:00:00.000Z,IB FUNDS TRANSFER DR-50200023535069 -SL ICK ORGANICS PVT LTD,insurance,insurance,net_banking_transfer,-1000000
632ae9292e1a0ebb7f488466,50200035187206,-2001667.54,60ec419255c00300382671a5,HDFC,direct expenses,5eecc6d6449e4f7cfb1c2708,2022-05-08T00:00:00.000Z,INT. ON SWCR ON-50300571891040,,,Other,-1669.14
632ae9292e1a0ebb7f488468,50200035187206,-999997.54,60ec419255c00300382671a5,HDFC,Loan-in,5eecc6d6449e4f7cfb1c2708,2022-05-08T00:00:00.000Z,SWEEP-IN CREDIT - 50300571891040,,,self_transfer,1001670
632ae9292e1a0ebb7f48846a,50200035187206,2.32,60ec419255c00300382671a5,HDFC,direct expenses,5eecc6d6449e4f7cfb1c2708,2022-05-08T00:00:00.000Z,INT. ON SWCR ON-50300571891040,,,Other,-1669.14
632ae9292e1a0ebb7f48846c,50200035187206,1671.46,60ec419255c00300382671a5,HDFC,Loan-in,5eecc6d6449e4f7cfb1c2708,2022-05-08T00:00:00.000Z,SWEEP-IN CREDIT - 50300571891040,,,self_transfer,1001669
632ae9292e1a0ebb7f48846e,50200035187206,-999997.68,60ec419255c00300382671a5,HDFC,Internal Transfers,5eecc6d6449e4f7cfb1c2708,2022-05-09T00:00:00.000Z,IB FUNDS TRANSFER DR-50200023535069 -SL ICK ORGANICS PVT LTD,insurance,insurance,net_banking_transfer,-1000000
632ae9292e1a0ebb7f488470,50200035187206,-1001530.76,60ec419255c00300382671a5,HDFC,direct expenses,5eecc6d6449e4f7cfb1c2708,2022-05-10T00:00:00.000Z,INT. ON SWCR ON-50300571891040,,,Other,-1533.08
632ae9292e1a0ebb7f488472,50200035187206,1.24,60ec419255c00300382671a5,HDFC,Loan-in,5eecc6d6449e4f7cfb1c2708,2022-05-10T00:00:00.000Z,SWEEP-IN CREDIT - 50300571891040,,,self_transfer,1001532
632ae9292e1a0ebb7f488474,50200035187206,-499998.76,60ec419255c00300382671a5,HDFC,Internal Transfers,5eecc6d6449e4f7cfb1c2708,2022-05-14T00:00:00.000Z,IB FUNDS TRANSFER DR-50200023535069 -SL ICK ORGANICS PVT LTD,insurance,insurance,net_banking_transfer,-500000
632ae9292e1a0ebb7f488476,50200035187206,595.52,60ec419255c00300382671a5,HDFC,direct expenses,5eecc6d6449e4f7cfb1c2708,2022-05-14T00:00:00.000Z,INT. ON SWCR ON-50300571891040,,,Other,-595.72
632ae9292e1a0ebb7f488478,50200035187206,1191.24,60ec419255c00300382671a5,HDFC,Loan-in,5eecc6d6449e4f7cfb1c2708,2022-05-14T00:00:00.000Z,SWEEP-IN CREDIT - 50300571891040,,,self_transfer,501190
632ae9292e1a0ebb7f48847a,50200035187206,-1499404.48,60ec419255c00300382671a5,HDFC,Internal Transfers,5eecc6d6449e4f7cfb1c2708,2022-05-23T00:00:00.000Z,IB FUNDS TRANSFER DR-50200023535069 -SL ICK ORGANICS PVT LTD,insurance,insurance,net_banking_transfer,-1500000
632ae9292e1a0ebb7f48847c,50200035187206,1.73,60ec419255c00300382671a5,HDFC,direct expenses,5eecc6d6449e4f7cfb1c2708,2022-05-24T00:00:00.000Z,INT. ON SWCR ON-50300571891040,,,Other,-856.79
632ae9292e1a0ebb7f48847e,50200035187206,858.52,60ec419255c00300382671a5,HDFC,Loan-in,5eecc6d6449e4f7cfb1c2708,2022-05-24T00:00:00.000Z,SWEEP-IN CREDIT - 50300571891040,,,self_transfer,1500263
632ae9292e1a0ebb7f488480,50200035187206,-49998.27,60ec419255c00300382671a5,HDFC,Internal Transfers,5eecc6d6449e4f7cfb1c2708,2022-05-24T00:00:00.000Z,IB FUNDS TRANSFER DR-50200023535069 -SL ICK ORGANICS PVT LTD,insurance,insurance,net_banking_transfer,-50000
632ae9292e1a0ebb7f488482,50200035187206,1.1,60ec419255c00300382671a5,HDFC,direct expenses,5eecc6d6449e4f7cfb1c2708,2022-05-25T00:00:00.000Z,INT. ON SWCR ON-50300571891040,,,Other,-25.63
632ae9292e1a0ebb7f488484,50200035187206,26.73,60ec419255c00300382671a5,HDFC,Loan-in,5eecc6d6449e4f7cfb1c2708,2022-05-25T00:00:00.000Z,SWEEP-IN CREDIT - 50300571891040,,,self_transfer,50025
632ae9292e1a0ebb7f488486,50200035187206,40763.1,60ec419255c00300382671a5,HDFC,interest income,5eecc6d6449e4f7cfb1c2708,2022-05-26T00:00:00.000Z,QUARTERLY INTEREST CREDIT 50300571891040,,,Other,40762
632ae9292e1a0ebb7f488488,50200035187206,-459236.9,60ec419255c00300382671a5,HDFC,Internal Transfers,5eecc6d6449e4f7cfb1c2708,2022-05-26T00:00:00.000Z,IB FUNDS TRANSFER DR-50200023535069 -SL ICK ORGANICS PVT LTD,insurance,insurance,net_banking_transfer,-500000
632ae9292e1a0ebb7f48848a,50200035187206,-464767.9,60ec419255c00300382671a5,HDFC,direct expenses,5eecc6d6449e4f7cfb1c2708,2022-05-27T00:00:00.000Z,INT. ON SWCR ON-50300571891040,,,Other,-5531
632ae9292e1a0ebb7f48848c,50200035187206,1.1,60ec419255c00300382671a5,HDFC,Loan-in,5eecc6d6449e4f7cfb1c2708,2022-05-27T00:00:00.000Z,SWEEP-IN CREDIT - 50300571891040,,,self_transfer,464769
632ae9292e1a0ebb7f48848e,50200035187206,-549998.9,60ec419255c00300382671a5,HDFC,Internal Transfers,5eecc6d6449e4f7cfb1c2708,2022-05-27T00:00:00.000Z,IB FUNDS TRANSFER DR-50200023535069 -SL ICK ORGANICS PVT LTD,insurance,insurance,net_banking_transfer,-550000
632ae9292e1a0ebb7f488490,50200035187206,-799998.9,60ec419255c00300382671a5,HDFC,Internal Transfers,5eecc6d6449e4f7cfb1c2708,2022-05-27T00:00:00.000Z,IB FUNDS TRANSFER DR-50200023535069 -SL ICK ORGANICS PVT LTD,insurance,insurance,net_banking_transfer,-250000
632ae9292e1a0ebb7f488492,50200035187206,-249999.9,60ec419255c00300382671a5,HDFC,direct expenses,5eecc6d6449e4f7cfb1c2708,2022-05-28T00:00:00.000Z,INT. ON SWCR ON-50300571891040,,,Other,-4070
632ae9292e1a0ebb7f488494,50200035187206,-245929.9,60ec419255c00300382671a5,HDFC,Loan-in,5eecc6d6449e4f7cfb1c2708,2022-05-28T00:00:00.000Z,SWEEP-IN CREDIT - 50300571891040,,,self_transfer,554069
632ae9292e1a0ebb7f488496,50200035187206,0.1,60ec419255c00300382671a5,HDFC,direct expenses,5eecc6d6449e4f7cfb1c2708,2022-05-28T00:00:00.000Z,INT. ON SWCR ON-50300571891040,,,Other,-1851
632ae9292e1a0ebb7f488499,50200035187206,1851.1,60ec419255c00300382671a5,HDFC,Loan-in,5eecc6d6449e4f7cfb1c2708,2022-05-28T00:00:00.000Z,SWEEP-IN CREDIT - 50300571891040,,,self_transfer,251851
632ae9292e1a0ebb7f48849b,50200035187206,-1499999.9,60ec419255c00300382671a5,HDFC,Internal Transfers,5eecc6d6449e4f7cfb1c2708,2022-05-30T00:00:00.000Z,IB FUNDS TRANSFER DR-50200023535069 -SL ICK ORGANICS PVT LTD,insurance,insurance,net_banking_transfer,-1500000
632ae9292e1a0ebb7f48849d,50200035187206,-1510750.9,60ec419255c00300382671a5,HDFC,direct expenses,5eecc6d6449e4f7cfb1c2708,2022-05-31T00:00:00.000Z,INT. ON SWCR ON-50300571891040,,,Other,-10751
632ae9292e1a0ebb7f48849f,50200035187206,10674.1,60ec419255c00300382671a5,HDFC,Loan-in,5eecc6d6449e4f7cfb1c2708,2022-05-31T00:00:00.000Z,SWEEP-IN CREDIT - 50300571891040,,,self_transfer,1521425
632ae9292e1a0ebb7f4884a1,50200035187206,-729325.9,60ec419255c00300382671a5,HDFC,Internal Transfers,5eecc6d6449e4f7cfb1c2708,2022-06-06T00:00:00.000Z,IB FUNDS TRANSFER DR-50200023535069 -SL ICK ORGANICS PVT LTD,insurance,insurance,net_banking_transfer,-740000
632ae9292e1a0ebb7f4884a3,50200035187206,2.1,60ec419255c00300382671a5,HDFC,direct expenses,5eecc6d6449e4f7cfb1c2708,2022-06-07T00:00:00.000Z,INT. ON SWCR ON-50300571891040,,,Other,-4708
632ae9292e1a0ebb7f4884a5,50200035187206,4710.1,60ec419255c00300382671a5,HDFC,Loan-in,5eecc6d6449e4f7cfb1c2708,2022-06-07T00:00:00.000Z,SWEEP-IN CREDIT - 50300571891040,,,self_transfer,734036
632ae9292e1a0ebb7f4884a7,50200035187206,-4997.9,60ec419255c00300382671a5,HDFC,Internal Transfers,5eecc6d6449e4f7cfb1c2708,2022-06-08T00:00:00.000Z,IB FUNDS TRANSFER DR-50200023535069 -SL ICK ORGANICS PVT LTD,insurance,insurance,net_banking_transfer,-5000
632ae9292e1a0ebb7f4884a9,50200035187206,2.1,60ec419255c00300382671a5,HDFC,direct expenses,5eecc6d6449e4f7cfb1c2708,2022-06-09T00:00:00.000Z,INT. ON SWCR ON-50300571891040,,,Other,-31
632ae9292e1a0ebb7f4884ab,50200035187206,33.1,60ec419255c00300382671a5,HDFC,Loan-in,5eecc6d6449e4f7cfb1c2708,2022-06-09T00:00:00.000Z,SWEEP-IN CREDIT - 50300571891040,,,self_transfer,5031
632ae9292e1a0ebb7f4884ad,50200035187206,3.1,60ec419255c00300382671a5,HDFC,interest income,5eecc6d6449e4f7cfb1c2708,2022-06-23T00:00:00.000Z,QUARTERLY INTEREST CREDIT 50300462137427,,,Other,1
632ae9292e1a0ebb7f4884af,50200035187206,2109352.54,60ec419255c00300382671a5,HDFC,Investments-New,5eecc6d6449e4f7cfb1c2708,2022-06-30T00:00:00.000Z,FT-57500000115294-AL TRUST,,,Other,2109349.44
632ae9292e1a0ebb7f4884d0,50200035187206,21570254,60ec419255c00300382671a5,HDFC,Internal Transfers,5eecc6d6449e4f7cfb1c2708,2022-09-05T00:00:00.000Z,IB FUNDS TRANSFER DR-50200023535069 -SL ICK ORGANICS PVT LTD,,,net_banking_transfer,-5000000
632ae9292e1a0ebb7f4884d2,50200035187206,10000000,60ec419255c00300382671a5,HDFC,Internal Transfers,5eecc6d6449e4f7cfb1c2708,2022-09-05T00:00:00.000Z,IB FUNDS TRANSFER DR-50200023535069 -SL,,,net_banking_transfer,-11570254
632ae9e22e1a0ebb7f490ad9,50200050976833,56165.33,60ec41a455c0030038267236,HDFC,Revenue-PG-non-split,5eecc6d6449e4f7cfb1c2708,2021-07-30T00:00:00.000Z,NEFT CR-CITI0100000-PAYPAL PAYMENTS PL-O PGSP COLL AC-SLICK ORGANICS PRIVATE LIMI TED-CITIN21211979997,insurance,,net_banking_transfer,3846.89
632ae9e22e1a0ebb7f490ae2,50200050976833,6807.02,60ec41a455c0030038267236,HDFC,Revenue-PG-non-split,5eecc6d6449e4f7cfb1c2708,2021-11-22T00:00:00.000Z,NEFT CR-CITI0100000-PAYPAL PAYMENTS PL-O PGSP COLL AC-SLICK ORGANICS PRIVATE LIMI TED-CITIN21274506437,insurance,,net_banking_transfer,3495.49
632ae9e22e1a0ebb7f490ae9,50200050976833,35251.63,60ec41a455c0030038267236,HDFC,Revenue-PG-non-split,5eecc6d6449e4f7cfb1c2708,2022-05-09T00:00:00.000Z,NEFT CR-CITI0100000-PAYPAL PAYMENTS PL-O PGSP COLL AC-SLICK ORGANICS PRIVATE LIMI TED-CITIN22272538147,insurance,insurance,net_banking_transfer,4379.73
632ae9e22e1a0ebb7f490aeb,50200050976833,38908.39,60ec41a455c0030038267236,HDFC,Revenue-PG-non-split,5eecc6d6449e4f7cfb1c2708,2022-05-10T00:00:00.000Z,NEFT CR-CITI0100000-PAYPAL PAYMENTS PL-O PGSP COLL AC-SLICK ORGANICS PRIVATE LIMI TED-CITIN22272970946,insurance,insurance,net_banking_transfer,3656.76
632ae9e22e1a0ebb7f490aed,50200050976833,41936.49,60ec41a455c0030038267236,HDFC,Revenue-PG-non-split,5eecc6d6449e4f7cfb1c2708,2022-05-18T00:00:00.000Z,NEFT CR-CITI0100000-PAYPAL PAYMENTS PL-O PGSP COLL AC-SLICK ORGANICS PRIVATE LIMI TED-CITIN22276232494,insurance,insurance,net_banking_transfer,3028.1
632ae9e22e1a0ebb7f490aef,50200050976833,11936.49,60ec41a455c0030038267236,HDFC,Internal Transfers,5eecc6d6449e4f7cfb1c2708,2022-05-24T00:00:00.000Z,IB FUNDS TRANSFER DR-50200023535069 -SL ICK ORGANICS PVT LTD,insurance,insurance,net_banking_transfer,-30000
632ae9e22e1a0ebb7f490af1,50200050976833,15477.09,60ec41a455c0030038267236,HDFC,Revenue-PG-non-split,5eecc6d6449e4f7cfb1c2708,2022-06-02T00:00:00.000Z,NEFT CR-CITI0100000-PAYPAL PAYMENTS PL-O PGSP COLL AC-SLICK ORGANICS PRIVATE LIMI TED-CITIN22285321542,insurance,insurance,net_banking_transfer,3540.6
632ae9e22e1a0ebb7f490af3,50200050976833,19028.99,60ec41a455c0030038267236,HDFC,Revenue-PG-non-split,5eecc6d6449e4f7cfb1c2708,2022-06-13T00:00:00.000Z,NEFT CR-CITI0100000-PAYPAL PAYMENTS PL-O PGSP COLL AC-SLICK ORGANICS PRIVATE LIMI TED-CITIN22289848132,insurance,insurance,net_banking_transfer,3551.9
632ae9e22e1a0ebb7f490af5,50200050976833,4028.99,60ec41a455c0030038267236,HDFC,Internal Transfers,5eecc6d6449e4f7cfb1c2708,2022-06-24T00:00:00.000Z,IB FUNDS TRANSFER DR-50200023535069 -SL ICK ORGANICS PVT LTD,insurance,insurance,net_banking_transfer,-15000
632ae9e22e1a0ebb7f490af7,50200050976833,7850.46,60ec41a455c0030038267236,HDFC,Revenue-PG-non-split,5eecc6d6449e4f7cfb1c2708,2022-07-05T00:00:00.000Z,NEFT CR-CITI0100000-PAYPAL PAYMENTS PL-O PGSP COLL AC-SLICK ORGANICS PRIVATE LIMI TED-CITIN22301533784,insurance,insurance,net_banking_transfer,3821.47
632ae9e22e1a0ebb7f490af9,50200050976833,850.46,60ec41a455c0030038267236,HDFC,Internal Transfers,5eecc6d6449e4f7cfb1c2708,2022-07-18T00:00:00.000Z,IB FUNDS TRANSFER DR-50200023535069 -SL ICK ORGANICS PVT LTD,insurance,insurance,net_banking_transfer,-7000
632ae9e22e1a0ebb7f490afb,50200050976833,5065.86,60ec41a455c0030038267236,HDFC,Revenue-PG-non-split,5eecc6d6449e4f7cfb1c2708,2022-08-30T00:00:00.000Z,NEFT CR-CITI0100000-PAYPAL PAYMENTS PL-O PGSP COLL AC-SLICK ORGANICS PRIVATE LIMI TED-CITIN22328866398,insurance,insurance,net_banking_transfer,4215.4
632ae9e22e1a0ebb7f490afd,50200050976833,7981.1,60ec41a455c0030038267236,HDFC,Revenue-PG-non-split,5eecc6d6449e4f7cfb1c2708,2022-09-07T00:00:00.000Z,NEFT CR-CITI0100000-PAYPAL PAYMENTS PL-O,,,net_banking_transfer,2915.24
632af8122e1a0ebb7f4a7a86,50200023535069,422033.81,60ec41ba55c00300382672d9,HDFC,Revenue-PG-non-split,5eecc6d6449e4f7cfb1c2708,2022-05-01T00:00:00.000Z,NEFT CR-PYTM0123456-PAYTM PAYMENTS SERVI CES LIMITED-SLICK ORGANICS PVT LTD-PYTM2 21210824795,insurance,insurance,net_banking_transfer,37360.14
632af8122e1a0ebb7f4a7a88,50200023535069,419811.26,60ec41ba55c00300382672d9,HDFC,direct expenses,5eecc6d6449e4f7cfb1c2708,2022-05-01T00:00:00.000Z,POS 514834XXXXXX9486 SEOPTIMER,,,debit_card,-2222.55
632af8122e1a0ebb7f4a7a8a,50200023535069,164811.26,60ec41ba55c00300382672d9,HDFC,SAAS/tech expense,5eecc6d6449e4f7cfb1c2708,2022-05-01T00:00:00.000Z,POS 514834XXXXXX9486 AMAZON,shopping,,debit_card,-255000
632af8122e1a0ebb7f4a7a8c,50200023535069,267363.24,60ec41ba55c00300382672d9,HDFC,Transfer in/Revenue-other,5eecc6d6449e4f7cfb1c2708,2022-05-01T00:00:00.000Z,"IMPS-212117438719-GOKWIK COMMERCE SOLU-I CIC-XXXXXXXX0630-PAYOUT FOR APRIL 29, 20 22",,,net_banking_transfer,102551.98
632af8122e1a0ebb7f4a7a8e,50200023535069,257370.79,60ec41ba55c00300382672d9,HDFC,direct expenses,5eecc6d6449e4f7cfb1c2708,2022-05-01T00:00:00.000Z,50100155115510-TPT-9992.45-MUKESH GOYAL,,,net_banking_transfer,-9992.45
632af8122e1a0ebb7f4a7a90,50200023535069,262581.42,60ec41ba55c00300382672d9,HDFC,Revenue-Mktplace,5eecc6d6449e4f7cfb1c2708,2022-05-02T00:00:00.000Z,NEFT CR-DEUT0797BGL-FLIPKART INTERNET PR IVATE LIMITED-SLICK ORGANICS PVT LTD-212 200142GN00087,shopping,,net_banking_transfer,5210.63
632af8122e1a0ebb7f4a7a92,50200023535069,304413.43,60ec41ba55c00300382672d9,HDFC,Revenue-PG-non-split,5eecc6d6449e4f7cfb1c2708,2022-05-02T00:00:00.000Z,NEFT CR-PYTM0123456-PAYTM PAYMENTS SERVI CES LIMITED-SLICK ORGANICS PVT LTD-PYTM2 21221271901,insurance,insurance,net_banking_transfer,41832.01
632af8122e1a0ebb7f4a7a94,50200023535069,307095.09,60ec41ba55c00300382672d9,HDFC,Revenue-Mktplace,5eecc6d6449e4f7cfb1c2708,2022-05-02T00:00:00.000Z,NEFT CR-DEUT0797BGL-MYNTRA DESIGNS PRIVA TE LIMITED-SLICK ORGANICS PVT. LTD.-2122 00579GN00145,shopping,,net_banking_transfer,2681.66
632af8122e1a0ebb7f4a7a96,50200023535069,314046.77,60ec41ba55c00300382672d9,HDFC,Revenue-Mktplace,5eecc6d6449e4f7cfb1c2708,2022-05-02T00:00:00.000Z,NEFT CR-DEUT0797BGL-MYNTRA DESIGNS PRIVA TE LIMITED-SLICK ORGANICS PVT. LTD.-2122 00577GN00219,shopping,,net_banking_transfer,6951.68
632af8122e1a0ebb7f4a7a98,50200023535069,369468.06,60ec41ba55c00300382672d9,HDFC,Revenue-PG-split enabled,5eecc6d6449e4f7cfb1c2708,2022-05-02T00:00:00.000Z,NEFT CR-UTIB0001506-RAZORPAY SOFTWARE PR IVATE LIMITED-SLICK ORGANICS PVT LITD-AX ISCN0134623744,insurance,insurance,net_banking_transfer,55421.29
632af8122e1a0ebb7f4a7a9b,50200023535069,144468.06,60ec41ba55c00300382672d9,HDFC,direct expenses,5eecc6d6449e4f7cfb1c2708,2022-05-02T00:00:00.000Z,"NEFT DR-SCBL0036025-DHRUV MADHOK-NETBANK , MUM-N122221939906786-225000",,,net_banking_transfer,-225000
632af8122e1a0ebb7f4a7a9d,50200023535069,114087.06,60ec41ba55c00300382672d9,HDFC,direct expenses,5eecc6d6449e4f7cfb1c2708,2022-05-02T00:00:00.000Z,"NEFT DR-KKBK0000424-NATARAJAN RANGANATHA N-NETBANK, MUM-N122221939907445-30381",,,net_banking_transfer,-30381
632af8122e1a0ebb7f4a7a9f,50200023535069,56421.06,60ec41ba55c00300382672d9,HDFC,direct expenses,5eecc6d6449e4f7cfb1c2708,2022-05-02T00:00:00.000Z,NEFT DR-KKBK0000180-VIMAL PLASTICS-NETBA,,,net_banking_transfer,-57666
632af8122e1a0ebb7f4a7aa1,50200023535069,748291.6,60ec41ba55c00300382672d9,HDFC,Revenue-Mktplace,5eecc6d6449e4f7cfb1c2708,2022-05-02T00:00:00.000Z,NEFT CR-DEUT0797BGL-AMAZON PAY (INDIA) P RIVATE LIMITED-SLICK ORGANICS PVT LTD-21 2200781GN00043,shopping,,net_banking_transfer,691870.54
632af8122e1a0ebb7f4a7aa3,50200023535069,968428.47,60ec41ba55c00300382672d9,HDFC,Revenue-Mktplace,5eecc6d6449e4f7cfb1c2708,2022-05-02T00:00:00.000Z,NEFT CR-HSBC0560002-AMAZON SELLER SERVIC ES PRIVATE LIMI-SLICK ORGANICS PVT L-HSB CN22122402669,shopping,,net_banking_transfer,220136.87
632af8122e1a0ebb7f4a7aa5,50200023535069,743428.47,60ec41ba55c00300382672d9,HDFC,direct expenses,5eecc6d6449e4f7cfb1c2708,2022-05-02T00:00:00.000Z,02711930004579-TPT-225000-DHRUV BHASIN,,,net_banking_transfer,-225000
632af8122e1a0ebb7f4a7aa7,50200023535069,488428.47,60ec41ba55c00300382672d9,HDFC,SAAS/tech expense,5eecc6d6449e4f7cfb1c2708,2022-05-02T00:00:00.000Z,POS 514834XXXXXX9486 AMAZON,shopping,,debit_card,-255000
632af8122e1a0ebb7f4a7aa9,50200023535069,490774.31,60ec41ba55c00300382672d9,HDFC,Transfer in/Revenue-other,5eecc6d6449e4f7cfb1c2708,2022-05-02T00:00:00.000Z,NEFT CR-UTIB0000114-ONE SIGMA TECHNOLOGI ES PRIVATE LIM-SLICK ORGANICS PRIVATE LI MITED-AXISP00285057492,insurance,insurance,net_banking_transfer,2345.84
632af8122e1a0ebb7f4a7aab,50200023535069,498202.78,60ec41ba55c00300382672d9,HDFC,Transfer in/Revenue-other,5eecc6d6449e4f7cfb1c2708,2022-05-02T00:00:00.000Z,NEFT CR-UTIB0000114-ONE SIGMA TECHNOLOGI ES PRIVATE LIM-SLICK ORGANICS PRIVATE LI MITED-AXISP00285057454,insurance,insurance,net_banking_transfer,7428.47
632af8122e1a0ebb7f4a7aad,50200023535069,575444.53,60ec41ba55c00300382672d9,HDFC,Transfer in/Revenue-other,5eecc6d6449e4f7cfb1c2708,2022-05-02T00:00:00.000Z,"IMPS-212217238045-GOKWIK COMMERCE SOLU-I CIC-XXXXXXXX0630-PAYOUT FOR APRIL 30, 20 22",,,net_banking_transfer,77241.75
632af8122e1a0ebb7f4a7aaf,50200023535069,575619.71,60ec41ba55c00300382672d9,HDFC,Revenue-Mktplace,5eecc6d6449e4f7cfb1c2708,2022-05-02T00:00:00.000Z,NEFT CR-ICIC0000105-MANASH LIFESTYLE PRI VATE LIMITED NO-SLICK ORGANICS PRIVATE L IMITED KOLK-ICIJ221220001930,shopping,,net_banking_transfer,175.18
632af8122e1a0ebb7f4a7ab1,50200023535069,575794.89,60ec41ba55c00300382672d9,HDFC,Revenue-Mktplace,5eecc6d6449e4f7cfb1c2708,2022-05-02T00:00:00.000Z,NEFT CR-ICIC0000105-MANASH LIFESTYLE PRI VATE LIMITED NO-SLICK ORGANICS PRIVATE L IMITED MP M-ICIJ221220001929,shopping,,net_banking_transfer,175.18
632af8122e1a0ebb7f4a7ab3,50200023535069,576291.11,60ec41ba55c00300382672d9,HDFC,Revenue-Mktplace,5eecc6d6449e4f7cfb1c2708,2022-05-02T00:00:00.000Z,NEFT CR-ICIC0000105-MANASH LIFESTYLE PRI VATE LIMITED NO-SLICK ORGANICS PRIVATE L IMITED BANG-ICIJ221220001931,shopping,,net_banking_transfer,496.22
632af8122e1a0ebb7f4a7ab5,50200023535069,540319.56,60ec41ba55c00300382672d9,HDFC,SAAS/tech expense,5eecc6d6449e4f7cfb1c2708,2022-05-02T00:00:00.000Z,POS 514834XXXXXX9486 AMAZON.COM,shopping,,debit_card,-35971.55
632af8122e1a0ebb7f4a7ab7,50200023535069,567125.18,60ec41ba55c00300382672d9,HDFC,Revenue-PG-split enabled,5eecc6d6449e4f7cfb1c2708,2022-05-02T00:00:00.000Z,NEFT CR-UTIB0001506-RAZORPAY SOFTWARE PR IVATE LIMITED-SLICK ORGANICS PVT LITD-AX ISCN0134870466,insurance,insurance,net_banking_transfer,26805.62
632af8122e1a0ebb7f4a7abb,50200023535069,655027.54,60ec41ba55c00300382672d9,HDFC,Revenue-COD,5eecc6d6449e4f7cfb1c2708,2022-05-02T00:00:00.000Z,NEFT CR-ICIC0000155-SHIPROCKET COD CRF I,,,net_banking_transfer,87902.36
632af8122e1a0ebb7f4a7abe,50200023535069,455027.54,60ec41ba55c00300382672d9,HDFC,direct expenses,5eecc6d6449e4f7cfb1c2708,2022-05-02T00:00:00.000Z,05892560000649-TPT-200000-DECORPAC INDIA PRIVATE LIMITED,,,net_banking_transfer,-200000
632af8122e1a0ebb7f4a7ac0,50200023535069,509163.94,60ec41ba55c00300382672d9,HDFC,Revenue-PG-non-split,5eecc6d6449e4f7cfb1c2708,2022-05-03T00:00:00.000Z,NEFT CR-PYTM0123456-PAYTM PAYMENTS SERVI CES LIMITED-SLICK ORGANICS PVT LTD-PYTM2 21231773169,insurance,insurance,net_banking_transfer,54136.4
632af8122e1a0ebb7f4a7ac4,50200023535069,507863.94,60ec41ba55c00300382672d9,HDFC,Marketing Expense,5eecc6d6449e4f7cfb1c2708,2022-05-03T00:00:00.000Z,ME DC SI 514834XXXXXX9486 GOOGLEPLAY,entertainment,,Other,-1300
632af8122e1a0ebb7f4a7ac6,50200023535069,426443.94,60ec41ba55c00300382672d9,HDFC,direct expenses,5eecc6d6449e4f7cfb1c2708,2022-05-03T00:00:00.000Z,POS 514834XXXXXX9486 CAS*INSTASPACES,,,debit_card,-81420
632af8122e1a0ebb7f4a7ac8,50200023535069,446981.39,60ec41ba55c00300382672d9,HDFC,Transfer in/Revenue-other,5eecc6d6449e4f7cfb1c2708,2022-05-03T00:00:00.000Z,"IMPS-212317846406-GOKWIK COMMERCE SOLU-I CIC-XXXXXXXX0630-PAYOUT FOR MAY 1, 2022",,,net_banking_transfer,20537.45
632af8122e1a0ebb7f4a7aca,50200023535069,413748.39,60ec41ba55c00300382672d9,HDFC,direct expenses,5eecc6d6449e4f7cfb1c2708,2022-05-03T00:00:00.000Z,02711600008220-TPT-33233-VARUN SINGH,,,net_banking_transfer,-33233
632af8122e1a0ebb7f4a7acc,50200023535069,460573.07,60ec41ba55c00300382672d9,HDFC,Revenue-UPI,5eecc6d6449e4f7cfb1c2708,2022-05-03T00:00:00.000Z,"UPI-GOKWIK-GOKWIK@YESBANK-YESB0000340-21 2321342510-PAYOUT FOR MAY 1,",,,upi,46824.68
632af8122e1a0ebb7f4a7acf,50200023535069,463276.95,60ec41ba55c00300382672d9,HDFC,Revenue-Mktplace,5eecc6d6449e4f7cfb1c2708,2022-05-04T00:00:00.000Z,NEFT CR-DEUT0797BGL-FLIPKART INTERNET PR IVATE LIMITED-SLICK ORGANICS PVT LTD-212 400143GN00249,shopping,,net_banking_transfer,2703.88
632af8122e1a0ebb7f4a7ad1,50200023535069,511138.28,60ec41ba55c00300382672d9,HDFC,Revenue-PG-non-split,5eecc6d6449e4f7cfb1c2708,2022-05-04T00:00:00.000Z,NEFT CR-PYTM0123456-PAYTM PAYMENTS SERVI CES LIMITED-SLICK ORGANICS PVT LTD-PYTM2 21242217498,insurance,insurance,net_banking_transfer,47861.33
632af8122e1a0ebb7f4a7ad3,50200023535069,512076.27,60ec41ba55c00300382672d9,HDFC,Revenue-Mktplace,5eecc6d6449e4f7cfb1c2708,2022-05-04T00:00:00.000Z,NEFT CR-DEUT0797BGL-MYNTRA DESIGNS PRIVA TE LIMITED-SLICK ORGANICS PVT. LTD.-2124 00579GN00144,shopping,,net_banking_transfer,937.99
632af8122e1a0ebb7f4a7ad5,50200023535069,519910.07,60ec41ba55c00300382672d9,HDFC,Revenue-Mktplace,5eecc6d6449e4f7cfb1c2708,2022-05-04T00:00:00.000Z,NEFT CR-DEUT0797BGL-MYNTRA DESIGNS PRIVA TE LIMITED-SLICK ORGANICS PVT. LTD.-2124 00578GN00210,shopping,,net_banking_transfer,7833.8
632af8122e1a0ebb7f4a7ad7,50200023535069,609970.88,60ec41ba55c00300382672d9,HDFC,Revenue-PG-split enabled,5eecc6d6449e4f7cfb1c2708,2022-05-04T00:00:00.000Z,NEFT CR-UTIB0001506-RAZORPAY SOFTWARE PR IVATE LIMITED-SLICK ORGANICS PVT LITD-AX ISCN0135225079,insurance,insurance,net_banking_transfer,90060.81
632af8122e1a0ebb7f4a7ad9,50200023535069,598170.88,60ec41ba55c00300382672d9,HDFC,direct expenses,5eecc6d6449e4f7cfb1c2708,2022-05-04T00:00:00.000Z,POS 514834XXXXXX9486 RAZ*SHARECHAT,,,debit_card,-11800
632af8122e1a0ebb7f4a7adb,50200023535069,593170.88,60ec41ba55c00300382672d9,HDFC,direct expenses,5eecc6d6449e4f7cfb1c2708,2022-05-04T00:00:00.000Z,NEFT DR-SIBL0000555-JAIVEER KUMAR-NETBAN,,,net_banking_transfer,-5000
632af8132e1a0ebb7f4a7ade,50200023535069,596545.43,60ec41ba55c00300382672d9,HDFC,Transfer in/Revenue-other,5eecc6d6449e4f7cfb1c2708,2022-05-04T00:00:00.000Z,NEFT CR-UTIB0000114-ONE SIGMA TECHNOLOGI ES PRIVATE LIM-SLICK ORGANICS PRIVATE LI MITED-AXISP00285456714,insurance,insurance,net_banking_transfer,3374.55
632af8132e1a0ebb7f4a7ae0,50200023535069,596731.21,60ec41ba55c00300382672d9,HDFC,Transfer in/Revenue-other,5eecc6d6449e4f7cfb1c2708,2022-05-04T00:00:00.000Z,NEFT CR-UTIB0000114-ONE SIGMA TECHNOLOGI ES PRIVATE LIM-SLICK ORGANICS PRIVATE LI MITED-AXISP00285456615,insurance,insurance,net_banking_transfer,185.78
632af8132e1a0ebb7f4a7ae2,50200023535069,648100.7,60ec41ba55c00300382672d9,HDFC,Transfer in/Revenue-other,5eecc6d6449e4f7cfb1c2708,2022-05-04T00:00:00.000Z,"IMPS-212417217806-GOKWIK COMMERCE SOLU-I CIC-XXXXXXXX0630-PAYOUT FOR MAY 2, 2022",,,net_banking_transfer,51369.49
632af8132e1a0ebb7f4a7ae4,50200023535069,680501.35,60ec41ba55c00300382672d9,HDFC,Transfer in/Revenue-other,5eecc6d6449e4f7cfb1c2708,2022-05-04T00:00:00.000Z,FT- REMITTANCE OG APR22-50200050675669 - HOUZ OF NATURE PVT LTD -,,,Other,32400.65
632af8132e1a0ebb7f4a7ae6,50200023535069,686628.48,60ec41ba55c00300382672d9,HDFC,Revenue-PG-split enabled,5eecc6d6449e4f7cfb1c2708,2022-05-04T00:00:00.000Z,NEFT CR-UTIB0001506-RAZORPAY SOFTWARE PR IVATE LIMITED-SLICK ORGANICS PVT LITD-AX ISCN0135466710,insurance,insurance,net_banking_transfer,6127.13
632af8132e1a0ebb7f4a7ae8,50200023535069,712771.87,60ec41ba55c00300382672d9,HDFC,Revenue-COD,5eecc6d6449e4f7cfb1c2708,2022-05-04T00:00:00.000Z,NEFT CR-ICIC0000155-SHIPROCKET COD CRF I D 4271684-SLICK ORGANICS PVT LTD-CMS2560 375736,insurance,insurance,net_banking_transfer,26143.39
632af8132e1a0ebb7f4a7aea,50200023535069,770226.57,60ec41ba55c00300382672d9,HDFC,Revenue-UPI,5eecc6d6449e4f7cfb1c2708,2022-05-04T00:00:00.000Z,"UPI-GOKWIK-GOKWIK@YESBANK-YESB0000340-21 2423468925-PAYOUT FOR MAY 2,",,,upi,57454.7
632af8132e1a0ebb7f4a7aec,50200023535069,515226.57,60ec41ba55c00300382672d9,HDFC,SAAS/tech expense,5eecc6d6449e4f7cfb1c2708,2022-05-05T00:00:00.000Z,POS 514834XXXXXX9486 AMAZON,shopping,,debit_card,-255000
632af8132e1a0ebb7f4a7aee,50200023535069,524096.87,60ec41ba55c00300382672d9,HDFC,Revenue-PG-non-split,5eecc6d6449e4f7cfb1c2708,2022-05-05T00:00:00.000Z,IMPS-212505955470-PAYTM PAYMENTS SERVI-P YTM-XXXXXXXXXX0008-ALL202205052168200003 30830668628,ewallet,,net_banking_transfer,8870.3
632af8132e1a0ebb7f4a7af0,50200023535069,374096.87,60ec41ba55c00300382672d9,HDFC,SAAS/tech expense,5eecc6d6449e4f7cfb1c2708,2022-05-05T00:00:00.000Z,"NEFT DR-UTIB0000020-MCANVAS ADVERTISING PRIVATE LIMITED-NETBANK, MUM-N1252219440 49605-150000",,,net_banking_transfer,-150000
632af8132e1a0ebb7f4a7af2,50200023535069,374640.9,60ec41ba55c00300382672d9,HDFC,Revenue-Mktplace,5eecc6d6449e4f7cfb1c2708,2022-05-05T00:00:00.000Z,4060000766-TIMES INTERNET LIMITED NODAL,,,Other,544.03
632af8132e1a0ebb7f4a7af4,50200023535069,373421.9,60ec41ba55c00300382672d9,HDFC,direct expenses,5eecc6d6449e4f7cfb1c2708,2022-05-05T00:00:00.000Z,"NEFT DR-BARB0SHIBOM-BHIMLA JAYRAJ BENYDI N-NETBANK, MUM-N125221944071014-1219",,,net_banking_transfer,-1219
632af8132e1a0ebb7f4a7af6,50200023535069,379407.37,60ec41ba55c00300382672d9,HDFC,Revenue-PG-split enabled,5eecc6d6449e4f7cfb1c2708,2022-05-05T00:00:00.000Z,NEFT CR-UTIB0001506-RAZORPAY SOFTWARE PR IVATE LIMITED-SLICK ORGANICS PVT LITD-AX ISCN0135600820,insurance,insurance,net_banking_transfer,5985.47
632af8132e1a0ebb7f4a7af8,50200023535069,378428.37,60ec41ba55c00300382672d9,HDFC,SAAS/tech expense,5eecc6d6449e4f7cfb1c2708,2022-05-05T00:00:00.000Z,POS 514834XXXXXX9486 AMAZON,shopping,,debit_card,-979
632af8132e1a0ebb7f4a7afb,50200023535069,377529.37,60ec41ba55c00300382672d9,HDFC,SAAS/tech expense,5eecc6d6449e4f7cfb1c2708,2022-05-05T00:00:00.000Z,POS 514834XXXXXX9486 AMAZON,shopping,,debit_card,-899
632af8132e1a0ebb7f4a7afd,50200023535069,377527.37,60ec41ba55c00300382672d9,HDFC,Marketing Expense,5eecc6d6449e4f7cfb1c2708,2022-05-05T00:00:00.000Z,POS 514834XXXXXX9486 LINKEDIN,,,debit_card,-2
632af8132e1a0ebb7f4a7aff,50200023535069,379572.84,60ec41ba55c00300382672d9,HDFC,Transfer in/Revenue-other,5eecc6d6449e4f7cfb1c2708,2022-05-05T00:00:00.000Z,NEFT CR-UTIB0000114-ONE SIGMA TECHNOLOGI ES PRIVATE LIM-SLICK ORGANICS PRIVATE LI MITED-AXISP00285825217,insurance,insurance,net_banking_transfer,2045.47
632af8132e1a0ebb7f4a7b01,50200023535069,458003.42,60ec41ba55c00300382672d9,HDFC,Transfer in/Revenue-other,5eecc6d6449e4f7cfb1c2708,2022-05-05T00:00:00.000Z,"IMPS-212517940035-GOKWIK COMMERCE SOLU-I CIC-XXXXXXXX0630-PAYOUT FOR MAY 3, 2022",,,net_banking_transfer,78430.58
632af8132e1a0ebb7f4a7b04,50200023535069,468935.83,60ec41ba55c00300382672d9,HDFC,Revenue-PG-split enabled,5eecc6d6449e4f7cfb1c2708,2022-05-05T00:00:00.000Z,NEFT CR-UTIB0001506-RAZORPAY SOFTWARE PR IVATE LIMITED-SLICK ORGANICS PVT LITD-AX ISCN0135793206,insurance,insurance,net_banking_transfer,10932.41
632af8132e1a0ebb7f4a7b06,50200023535069,469832.3,60ec41ba55c00300382672d9,HDFC,Revenue-Mktplace,5eecc6d6449e4f7cfb1c2708,2022-05-05T00:00:00.000Z,NEFT CR-ICIC0000105-MANASH LIFESTYLE PRI VATE LIMITED NO-SLICK ORGANICS PRIVATE L IMITED MP G-ICIJ221250012253,shopping,,net_banking_transfer,896.47
632af8132e1a0ebb7f4a7b09,50200023535069,481398.3,60ec41ba55c00300382672d9,HDFC,Revenue-Mktplace,5eecc6d6449e4f7cfb1c2708,2022-05-05T00:00:00.000Z,NEFT CR-SCBL0036001-M/S DREAMPLUG TECHNO -SLICK ORGANICS PRIVATE LIMITEDSLICK-SIN 31436Q0038850,insurance,insurance,net_banking_transfer,11566
632af8132e1a0ebb7f4a7b0b,50200023535069,481534.3,60ec41ba55c00300382672d9,HDFC,Revenue-COD,5eecc6d6449e4f7cfb1c2708,2022-05-05T00:00:00.000Z,NEFT CR-KKBK0000958-PICKRR TECHNOLOGIES PVT LTD-SLICKORGANICSPRIVATELIMITED-CMS1 252214015161,insurance,insurance,net_banking_transfer,136
632af8132e1a0ebb7f4a7b0d,50200023535069,569943.23,60ec41ba55c00300382672d9,HDFC,Revenue-UPI,5eecc6d6449e4f7cfb1c2708,2022-05-05T00:00:00.000Z,"UPI-GOKWIK-GOKWIK@YESBANK-YESB0000340-21 2525717310-PAYOUT FOR MAY 3,",,,upi,88408.93
632af8132e1a0ebb7f4a7b0f,50200023535069,572058.57,60ec41ba55c00300382672d9,HDFC,Revenue-Mktplace,5eecc6d6449e4f7cfb1c2708,2022-05-06T00:00:00.000Z,NEFT CR-DEUT0797BGL-FLIPKART INTERNET PR IVATE LIMITED-SLICK ORGANICS PVT LTD-212 600119GN00250,shopping,,net_banking_transfer,2115.34
632af8132e1a0ebb7f4a7b11,50200023535069,591683.04,60ec41ba55c00300382672d9,HDFC,Revenue-PG-non-split,5eecc6d6449e4f7cfb1c2708,2022-05-06T00:00:00.000Z,IMPS-212605513551-PAYTM PAYMENTS SERVI-P YTM-XXXXXXXXXX0008-ALL202205062168200003 30830668628,ewallet,,net_banking_transfer,19624.47
632af8132e1a0ebb7f4a7b14,50200023535069,386975.04,60ec41ba55c00300382672d9,HDFC,direct expenses,5eecc6d6449e4f7cfb1c2708,2022-05-06T00:00:00.000Z,"NEFT DR-KKBK0000180-VEDIC COSMECEUTICALS PVT LTD-NETBANK, MUM-N126221945907467-2 04708",,,net_banking_transfer,-204708
632af8132e1a0ebb7f4a7b16,50200023535069,396260.26,60ec41ba55c00300382672d9,HDFC,Revenue-PG-split enabled,5eecc6d6449e4f7cfb1c2708,2022-05-06T00:00:00.000Z,NEFT CR-UTIB0001506-RAZORPAY SOFTWARE PR,,,net_banking_transfer,9285.22
632af8132e1a0ebb7f4a7b18,50200023535069,391260.26,60ec41ba55c00300382672d9,HDFC,direct expenses,5eecc6d6449e4f7cfb1c2708,2022-05-06T00:00:00.000Z,"NEFT DR-CNRB0019016-MANEESH-NETBANK, MUM -N126221946043541-5000",,,net_banking_transfer,-5000
632af8132e1a0ebb7f4a7b1a,50200023535069,396137.45,60ec41ba55c00300382672d9,HDFC,Revenue-Mktplace,5eecc6d6449e4f7cfb1c2708,2022-05-06T00:00:00.000Z,NEFT CR-DEUT0797BGL-MYNTRA DESIGNS PRIVA TE LIMITED-SLICK ORGANICS PVT. LTD.-2126 00520GN00224,shopping,,net_banking_transfer,4877.19
632af8132e1a0ebb7f4a7b1c,50200023535069,397512.96,60ec41ba55c00300382672d9,HDFC,Revenue-Mktplace,5eecc6d6449e4f7cfb1c2708,2022-05-06T00:00:00.000Z,NEFT CR-DEUT0797BGL-MYNTRA DESIGNS PRIVA TE LIMITED-SLICK ORGANICS PVT. LTD.-2126 00523GN00150,shopping,,net_banking_transfer,1375.51
632af8132e1a0ebb7f4a7b1e,50200023535069,1397512.96,60ec41ba55c00300382672d9,HDFC,Internal Transfers,5eecc6d6449e4f7cfb1c2708,2022-05-06T00:00:00.000Z,IB FUNDS TRANSFER CR-50200035187206 -SL ICK ORGANICS PVT LTD,insurance,insurance,Other,1000000
632af8132e1a0ebb7f4a7b20,50200023535069,1404430.38,60ec41ba55c00300382672d9,HDFC,Transfer in/Revenue-other,5eecc6d6449e4f7cfb1c2708,2022-05-06T00:00:00.000Z,NEFT CR-UTIB0000114-ONE SIGMA TECHNOLOGI ES PRIVATE LIM-SLICK ORGANICS PRIVATE LI MITED-AXISP00286094801,insurance,insurance,net_banking_transfer,6917.42
632af8132e1a0ebb7f4a7b22,50200023535069,1405217.02,60ec41ba55c00300382672d9,HDFC,Revenue-Mktplace,5eecc6d6449e4f7cfb1c2708,2022-05-06T00:00:00.000Z,NEFT CR-DEUT0784BBY-TATA UNISTORE LTD-NO DAL-SLICK ORGANICS PVT LTD-212602261GN00 353,insurance,insurance,net_banking_transfer,786.64
632af8132e1a0ebb7f4a7b24,50200023535069,1411793.7,60ec41ba55c00300382672d9,HDFC,Revenue-PG-split enabled,5eecc6d6449e4f7cfb1c2708,2022-05-06T00:00:00.000Z,NEFT CR-UTIB0001506-RAZORPAY SOFTWARE PR IVATE LIMITED-SLICK ORGANICS PVT LITD-AX ISCN0136110747,insurance,insurance,net_banking_transfer,6576.68
632af8132e1a0ebb7f4a7b26,50200023535069,1474344.79,60ec41ba55c00300382672d9,HDFC,Revenue-UPI,5eecc6d6449e4f7cfb1c2708,2022-05-06T00:00:00.000Z,"UPI-GOKWIK-GOKWIK@YESBANK-YESB0000340-21 2627901488-PAYOUT FOR MAY 4,",,,upi,62551.09
632af8132e1a0ebb7f4a7b28,50200023535069,1474827.1,60ec41ba55c00300382672d9,HDFC,Revenue-Mktplace,5eecc6d6449e4f7cfb1c2708,2022-05-06T00:00:00.000Z,NEFT CR-ICIC0000105-MANASH LIFESTYLE PRI VATE LIMITED NO-SLICK ORGANICS PRIVATE L IMITED KOLK-ICIJ221260009283,shopping,,net_banking_transfer,482.31
632af8132e1a0ebb7f4a7b2a,50200023535069,1475416.44,60ec41ba55c00300382672d9,HDFC,Revenue-Mktplace,5eecc6d6449e4f7cfb1c2708,2022-05-06T00:00:00.000Z,NEFT CR-ICIC0000105-MANASH LIFESTYLE PRI VATE LIMITED NO-SLICK ORGANICS PRIVATE L IMITED BANG-ICIJ221260008587,shopping,,net_banking_transfer,589.34
632af8132e1a0ebb7f4a7b2c,50200023535069,1509102.57,60ec41ba55c00300382672d9,HDFC,Revenue-COD,5eecc6d6449e4f7cfb1c2708,2022-05-06T00:00:00.000Z,NEFT CR-ICIC0000155-SHIPROCKET COD CRF I D 4284026-SLICK ORGANICS PVT LTD-CMS2564 712584,insurance,insurance,net_banking_transfer,33686.13
632af8132e1a0ebb7f4a7b2e,50200023535069,1493123.57,60ec41ba55c00300382672d9,HDFC,direct expenses,5eecc6d6449e4f7cfb1c2708,2022-05-07T00:00:00.000Z,02711600008220 NET BANKING SI -15979,,,Other,-15979
632af8132e1a0ebb7f4a7b30,50200023535069,1457123.57,60ec41ba55c00300382672d9,HDFC,direct expenses,5eecc6d6449e4f7cfb1c2708,2022-05-07T00:00:00.000Z,00901610080520 NET BANKING SI -36000,,,Other,-36000
632af8132e1a0ebb7f4a7b32,50200023535069,1424723.57,60ec41ba55c00300382672d9,HDFC,direct expenses,5eecc6d6449e4f7cfb1c2708,2022-05-07T00:00:00.000Z,50200039330521 NET BANKING SI -32400,,,Other,-32400
632af8132e1a0ebb7f4a7b37,50200023535069,1316723.57,60ec41ba55c00300382672d9,HDFC,direct expenses,5eecc6d6449e4f7cfb1c2708,2022-05-07T00:00:00.000Z,50200054531492 NET BANKING SI -108000,,,Other,-108000
632af8132e1a0ebb7f4a7b3a,50200023535069,1224923.57,60ec41ba55c00300382672d9,HDFC,direct expenses,5eecc6d6449e4f7cfb1c2708,2022-05-07T00:00:00.000Z,50200063349422 NET BANKING SI -91800,,,Other,-91800
632af8132e1a0ebb7f4a7b3c,50200023535069,1174923.57,60ec41ba55c00300382672d9,HDFC,direct expenses,5eecc6d6449e4f7cfb1c2708,2022-05-07T00:00:00.000Z,50100064106714 NET BANKING SI -50000,,,Other,-50000
632af8132e1a0ebb7f4a7b3e,50200023535069,1153423.57,60ec41ba55c00300382672d9,HDFC,direct expenses,5eecc6d6449e4f7cfb1c2708,2022-05-07T00:00:00.000Z,NEFT DR-SIBL0000555-JAIVEER KUMAR-SANDOZ - MUM-N127221947700803-NET BANKING SI - 21500,,,net_banking_transfer,-21500
632af8132e1a0ebb7f4a7b40,50200023535069,1131923.57,60ec41ba55c00300382672d9,HDFC,direct expenses,5eecc6d6449e4f7cfb1c2708,2022-05-07T00:00:00.000Z,NEFT DR-BARB0VJGRKA-OM PRASAD PANDEY-SAN DOZ - MUM-N127221947700805-NET BANKING S I -21500,,,net_banking_transfer,-21500
632af8132e1a0ebb7f4a7b42,50200023535069,1110423.57,60ec41ba55c00300382672d9,HDFC,direct expenses,5eecc6d6449e4f7cfb1c2708,2022-05-07T00:00:00.000Z,NEFT DR-PUNB0482100-RAM BHAVAN YADAV-SAN DOZ - MUM-N127221947700808-NET BANKING S I -21500,,,net_banking_transfer,-21500
632af8132e1a0ebb7f4a7b44,50200023535069,1094444.57,60ec41ba55c00300382672d9,HDFC,direct expenses,5eecc6d6449e4f7cfb1c2708,2022-05-07T00:00:00.000Z,NEFT DR-PUNB0151400-BHUWAN CHANDER JOSHI -SANDOZ - MUM-N127221947700810-NET BANKI NG SI -15979,,,net_banking_transfer,-15979
632af8132e1a0ebb7f4a7b46,50200023535069,878444.57,60ec41ba55c00300382672d9,HDFC,direct expenses,5eecc6d6449e4f7cfb1c2708,2022-05-07T00:00:00.000Z,NEFT DR-UTIB0000514-NATS ASSOCIATES-SAND OZ - MUM-N127221947700812-NET BANKING SI -216000,,,net_banking_transfer,-216000
632af8132e1a0ebb7f4a7b48,50200023535069,842444.57,60ec41ba55c00300382672d9,HDFC,direct expenses,5eecc6d6449e4f7cfb1c2708,2022-05-07T00:00:00.000Z,NEFT DR-KKBK0000664-SHRADDHA DINESH SHU KLA-SANDOZ - MUM-N127221947700813-NET BA NKING SI -36000,,,net_banking_transfer,-36000
632af8132e1a0ebb7f4a7b4a,50200023535069,776356.57,60ec41ba55c00300382672d9,HDFC,direct expenses,5eecc6d6449e4f7cfb1c2708,2022-05-07T00:00:00.000Z,NEFT DR-KKBK0000187-APPLIED LIFE PRIVATE LIMITED-SANDOZ - MUM-N127221947700815-N ET BANKING SI -66088,,,net_banking_transfer,-66088
632af8132e1a0ebb7f4a7b4c,50200023535069,619756.57,60ec41ba55c00300382672d9,HDFC,direct expenses,5eecc6d6449e4f7cfb1c2708,2022-05-07T00:00:00.000Z,NEFT DR-KKBK0005289-HILL GROOVE CONSULTI NG LLP-SANDOZ - MUM-N127221947700818-NET BANKING SI -156600,,,net_banking_transfer,-156600
632af8132e1a0ebb7f4a7b4e,50200023535069,531196.57,60ec41ba55c00300382672d9,HDFC,direct expenses,5eecc6d6449e4f7cfb1c2708,2022-05-07T00:00:00.000Z,NEFT DR-DBSS0IN0811-SARANSH KULKARNI-SAN,,,net_banking_transfer,-88560
632af8132e1a0ebb7f4a7b50,50200023535069,314026.57,60ec41ba55c00300382672d9,HDFC,direct expenses,5eecc6d6449e4f7cfb1c2708,2022-05-07T00:00:00.000Z,NEFT DR-BARB0VJMATU-ARTISTO DESIGNZ-SAND OZ - MUM-N127221947700822-NET BANKING SI -217170,,,net_banking_transfer,-217170
632af8132e1a0ebb7f4a7b52,50200023535069,296161.57,60ec41ba55c00300382672d9,HDFC,direct expenses,5eecc6d6449e4f7cfb1c2708,2022-05-07T00:00:00.000Z,NEFT DR-KKBK0005032-DEEPAK YADAV-SANDOZ - MUM-N127221947700824-NET BANKING SI -1 7865,,,net_banking_transfer,-17865
632af8132e1a0ebb7f4a7b55,50200023535069,280182.57,60ec41ba55c00300382672d9,HDFC,direct expenses,5eecc6d6449e4f7cfb1c2708,2022-05-07T00:00:00.000Z,NEFT DR-PUNB0494300-KUNDAN PRASAD-SANDOZ - MUM-N127221947700826-NET BANKING SI - 15979,,,net_banking_transfer,-15979
632af8132e1a0ebb7f4a7b57,50200023535069,263829.57,60ec41ba55c00300382672d9,HDFC,N-ACH payments,5eecc6d6449e4f7cfb1c2708,2022-05-07T00:00:00.000Z,NEFT DR-DBSS0IN0811-SACHIN SINGH-SANDOZ - MUM-N127221947700828-NET BANKING SI -1 6353,,,net_banking_transfer,-16353
632af8132e1a0ebb7f4a7b59,50200023535069,249202.57,60ec41ba55c00300382672d9,HDFC,direct expenses,5eecc6d6449e4f7cfb1c2708,2022-05-07T00:00:00.000Z,NEFT DR-PUNB0307800-SANJEEV NIRMANIA-SAN DOZ - MUM-N127221947700829-NET BANKING S I -14627,,,net_banking_transfer,-14627
632af8132e1a0ebb7f4a7b5b,50200023535069,234575.57,60ec41ba55c00300382672d9,HDFC,direct expenses,5eecc6d6449e4f7cfb1c2708,2022-05-07T00:00:00.000Z,NEFT DR-CNRB0019016-MANEESH-SANDOZ - MUM -N127221947700831-NET BANKING SI -14627,,,net_banking_transfer,-14627
632af8132e1a0ebb7f4a7b5d,50200023535069,263668.23,60ec41ba55c00300382672d9,HDFC,Revenue-PG-non-split,5eecc6d6449e4f7cfb1c2708,2022-05-07T00:00:00.000Z,NEFT CR-PYTM0123456-PAYTM PAYMENTS SERVI CES LIMITED-SLICK ORGANICS PVT LTD-PYTM2 21273649735,insurance,insurance,net_banking_transfer,29092.66
632af8132e1a0ebb7f4a7b5f,50200023535069,81792.23,60ec41ba55c00300382672d9,HDFC,direct expenses,5eecc6d6449e4f7cfb1c2708,2022-05-07T00:00:00.000Z,50100370748619-TPT-181876-RITIKA SAXENA,,,net_banking_transfer,-181876
632af8132e1a0ebb7f4a7b61,50200023535069,4667.23,60ec41ba55c00300382672d9,HDFC,direct expenses,5eecc6d6449e4f7cfb1c2708,2022-05-07T00:00:00.000Z,"NEFT DR-SBIN0070392-APARNA MOHANAN KONAT -NETBANK, MUM-N127221947703789-77125",,,net_banking_transfer,-77125
632af8132e1a0ebb7f4a7b63,50200023535069,1004667.23,60ec41ba55c00300382672d9,HDFC,Internal Transfers,5eecc6d6449e4f7cfb1c2708,2022-05-07T00:00:00.000Z,IB FUNDS TRANSFER CR-50200035187206 -SL ICK ORGANICS PVT LTD,insurance,insurance,Other,1000000
632af8132e1a0ebb7f4a7b65,50200023535069,810620.23,60ec41ba55c00300382672d9,HDFC,direct expenses,5eecc6d6449e4f7cfb1c2708,2022-05-07T00:00:00.000Z,"NEFT DR-KKBK0000261-TANVI TANEJA-NETBANK , MUM-N127221947689054-194047",,,net_banking_transfer,-194047
632af8132e1a0ebb7f4a7b68,50200023535069,637101.23,60ec41ba55c00300382672d9,HDFC,direct expenses,5eecc6d6449e4f7cfb1c2708,2022-05-07T00:00:00.000Z,50100155115510-TPT-173519-MUKESH GOYAL,,,net_banking_transfer,-173519
632af8132e1a0ebb7f4a7b6c,50200023535069,455986.23,60ec41ba55c00300382672d9,HDFC,direct expenses,5eecc6d6449e4f7cfb1c2708,2022-05-07T00:00:00.000Z,50100179603876-TPT-181115-APURBA NAYAK,,,net_banking_transfer,-181115
632af8132e1a0ebb7f4a7b6e,50200023535069,345204.23,60ec41ba55c00300382672d9,HDFC,direct expenses,5eecc6d6449e4f7cfb1c2708,2022-05-07T00:00:00.000Z,50100093802387-TPT-110782-ISSHANA MAHAJA N,,,net_banking_transfer,-110782
632af8132e1a0ebb7f4a7b70,50200023535069,236871.23,60ec41ba55c00300382672d9,HDFC,direct expenses,5eecc6d6449e4f7cfb1c2708,2022-05-07T00:00:00.000Z,NEFT DR-ICIC0000396-SURABHI SARUP-NETBAN,,,net_banking_transfer,-108333
632af8132e1a0ebb7f4a7b72,50200023535069,142899.23,60ec41ba55c00300382672d9,HDFC,direct expenses,5eecc6d6449e4f7cfb1c2708,2022-05-07T00:00:00.000Z,"NEFT DR-ICIC0000021-AKHILESH DIXIT-NETBA NK, MUM-N127221947704318-93972",,,net_banking_transfer,-93972
632af8132e1a0ebb7f4a7b74,50200023535069,90493.23,60ec41ba55c00300382672d9,HDFC,direct expenses,5eecc6d6449e4f7cfb1c2708,2022-05-07T00:00:00.000Z,50100293329616-TPT-52406-SADIYA BANO,,,net_banking_transfer,-52406
632af8132e1a0ebb7f4a7b76,50200023535069,36326.23,60ec41ba55c00300382672d9,HDFC,direct expenses,5eecc6d6449e4f7cfb1c2708,2022-05-07T00:00:00.000Z,50100362612187-TPT-54167-BHUPESH JAKHAR,,,net_banking_transfer,-54167
632af8142e1a0ebb7f4a7b78,50200023535069,1036326.23,60ec41ba55c00300382672d9,HDFC,Internal Transfers,5eecc6d6449e4f7cfb1c2708,2022-05-07T00:00:00.000Z,IB FUNDS TRANSFER CR-50200035187206 -SL ICK ORGANICS PVT LTD,insurance,insurance,Other,1000000
632af8142e1a0ebb7f4a7b7a,50200023535069,983276.23,60ec41ba55c00300382672d9,HDFC,direct expenses,5eecc6d6449e4f7cfb1c2708,2022-05-07T00:00:00.000Z,"NEFT DR-ICIC0003851-JITENDER KUMAR-NETBA NK, MUM-N127221947695135-53050",,,net_banking_transfer,-53050
632af8142e1a0ebb7f4a7b7c,50200023535069,974500.23,60ec41ba55c00300382672d9,HDFC,direct expenses,5eecc6d6449e4f7cfb1c2708,2022-05-07T00:00:00.000Z,"NEFT DR-IPOS0000001-PANKAJ KUMAR-NETBANK , MUM-N127221947705327-8776",,,net_banking_transfer,-8776
632af8142e1a0ebb7f4a7b7e,50200023535069,944500.23,60ec41ba55c00300382672d9,HDFC,direct expenses,5eecc6d6449e4f7cfb1c2708,2022-05-07T00:00:00.000Z,"NEFT DR-KKBK0008365-SRIRAJ GUNDA-NETBANK , MUM-N127221947749399-30000",,,net_banking_transfer,-30000
632af8142e1a0ebb7f4a7b80,50200023535069,928521.23,60ec41ba55c00300382672d9,HDFC,direct expenses,5eecc6d6449e4f7cfb1c2708,2022-05-07T00:00:00.000Z,"NEFT DR-BARB0DINARA-MD ARIF RAZA-NETBANK , MUM-N127221947755476-15979",,,net_banking_transfer,-15979
632af8142e1a0ebb7f4a7b82,50200023535069,940647.25,60ec41ba55c00300382672d9,HDFC,Revenue-PG-split enabled,5eecc6d6449e4f7cfb1c2708,2022-05-07T00:00:00.000Z,NEFT CR-UTIB0001506-RAZORPAY SOFTWARE PR IVATE LIMITED-SLICK ORGANICS PVT LITD-AX ISCN0136208056,insurance,insurance,net_banking_transfer,12126.02
632af8142e1a0ebb7f4a7b84,50200023535069,685647.25,60ec41ba55c00300382672d9,HDFC,SAAS/tech expense,5eecc6d6449e4f7cfb1c2708,2022-05-07T00:00:00.000Z,POS 514834XXXXXX9486 AMAZON,shopping,,debit_card,-255000
632af8142e1a0ebb7f4a7b86,50200023535069,576605.25,60ec41ba55c00300382672d9,HDFC,direct expenses,5eecc6d6449e4f7cfb1c2708,2022-05-07T00:00:00.000Z,"NEFT DR-YESB0000162-VINAY REDDY-NETBANK, MUM-N127221948136673-109042",,,net_banking_transfer,-109042
632af8142e1a0ebb7f4a7b88,50200023535069,528405.25,60ec41ba55c00300382672d9,HDFC,direct expenses,5eecc6d6449e4f7cfb1c2708,2022-05-07T00:00:00.000Z,"NEFT DR-UTIB0000120-ADNAN ALI-NETBANK, M UM-N127221948206199-48200",,,net_banking_transfer,-48200
632af8142e1a0ebb7f4a7b8a,50200023535069,518405.25,60ec41ba55c00300382672d9,HDFC,Refund,5eecc6d6449e4f7cfb1c2708,2022-05-07T00:00:00.000Z,"NEFT DR-RATN0VAAPIS-RAZORPAY REFUND CRED ITS TOPUP-NETBANK, MUM-N127221948546463- 10000",,,net_banking_transfer,-10000
632af8142e1a0ebb7f4a7b8c,50200023535069,522737.25,60ec41ba55c00300382672d9,HDFC,Transfer in/Revenue-other,5eecc6d6449e4f7cfb1c2708,2022-05-07T00:00:00.000Z,POS REF 514834******9486-05/07 HTTPS://S,,,refund,4332
632af8142e1a0ebb7f4a7b8e,50200023535069,537189.5,60ec41ba55c00300382672d9,HDFC,Revenue-PG-split enabled,5eecc6d6449e4f7cfb1c2708,2022-05-07T00:00:00.000Z,NEFT CR-UTIB0001506-RAZORPAY SOFTWARE PR IVATE LIMITED-SLICK ORGANICS PVT LITD-AX ISCN0136355354,insurance,insurance,net_banking_transfer,14452.25
632af8142e1a0ebb7f4a7b92,50200023535069,581365.46,60ec41ba55c00300382672d9,HDFC,Revenue-UPI,5eecc6d6449e4f7cfb1c2708,2022-05-07T00:00:00.000Z,UPI-GOKWIK-GOKWIK@YESBANK-YESB0000340-21,,,upi,44175.96
632af8142e1a0ebb7f4a7b95,50200023535069,602547.63,60ec41ba55c00300382672d9,HDFC,Revenue-PG-non-split,5eecc6d6449e4f7cfb1c2708,2022-05-08T00:00:00.000Z,IMPS-212805715769-PAYTM PAYMENTS SERVI-P YTM-XXXXXXXXXX0008-ALL202205082168200003 30830668628,ewallet,,net_banking_transfer,21182.17
632af8142e1a0ebb7f4a7b97,50200023535069,580047.63,60ec41ba55c00300382672d9,HDFC,direct expenses,5eecc6d6449e4f7cfb1c2708,2022-05-08T00:00:00.000Z,00321000085687-TPT-22500-SAMEER AHUJA,,,net_banking_transfer,-22500
632af8142e1a0ebb7f4a7b99,50200023535069,571047.63,60ec41ba55c00300382672d9,HDFC,agency/vendor expense,5eecc6d6449e4f7cfb1c2708,2022-05-08T00:00:00.000Z,"NEFT DR-UTIB0003557-INCOSEC LEGAL-NETBAN K, MUM-N128221949767214-9000",,,net_banking_transfer,-9000
632af8142e1a0ebb7f4a7b9b,50200023535069,622875.88,60ec41ba55c00300382672d9,HDFC,Revenue-UPI,5eecc6d6449e4f7cfb1c2708,2022-05-08T00:00:00.000Z,"UPI-GOKWIK-GOKWIK@YESBANK-YESB0000340-21 2832048140-PAYOUT FOR MAY 6,",,,upi,51828.25
632af8142e1a0ebb7f4a7b9d,50200023535069,367875.88,60ec41ba55c00300382672d9,HDFC,SAAS/tech expense,5eecc6d6449e4f7cfb1c2708,2022-05-08T00:00:00.000Z,POS 514834XXXXXX9486 AMAZON,shopping,,debit_card,-255000
632af8142e1a0ebb7f4a7b9f,50200023535069,372828.26,60ec41ba55c00300382672d9,HDFC,Revenue-Mktplace,5eecc6d6449e4f7cfb1c2708,2022-05-09T00:00:00.000Z,NEFT CR-DEUT0797BGL-FLIPKART INTERNET PR IVATE LIMITED-SLICK ORGANICS PVT LTD-212 900126GN00210,shopping,,net_banking_transfer,4952.38
632af8142e1a0ebb7f4a7ba1,50200023535069,404345.38,60ec41ba55c00300382672d9,HDFC,Revenue-PG-non-split,5eecc6d6449e4f7cfb1c2708,2022-05-09T00:00:00.000Z,NEFT CR-PYTM0123456-PAYTM PAYMENTS SERVI CES LIMITED-SLICK ORGANICS PVT LTD-PYTM2 21294590077,insurance,insurance,net_banking_transfer,31517.12
632af8142e1a0ebb7f4a7ba6,50200023535069,409249.05,60ec41ba55c00300382672d9,HDFC,Revenue-Mktplace,5eecc6d6449e4f7cfb1c2708,2022-05-09T00:00:00.000Z,NEFT CR-DEUT0797BGL-MYNTRA DESIGNS PRIVA TE LIMITED-SLICK ORGANICS PVT. LTD.-2129 00575GN00211,shopping,,net_banking_transfer,4903.67
632af8142e1a0ebb7f4a7ba8,50200023535069,414739.13,60ec41ba55c00300382672d9,HDFC,Revenue-Mktplace,5eecc6d6449e4f7cfb1c2708,2022-05-09T00:00:00.000Z,NEFT CR-DEUT0797BGL-MYNTRA DESIGNS PRIVA TE LIMITED-SLICK ORGANICS PVT. LTD.-2129 00576GN00264,shopping,,net_banking_transfer,5490.08
632af8142e1a0ebb7f4a7baa,50200023535069,415483.13,60ec41ba55c00300382672d9,HDFC,Revenue-COD,5eecc6d6449e4f7cfb1c2708,2022-05-09T00:00:00.000Z,NEFT CR-KKBK0000958-PICKRR TECHNOLOGIES PVT LTD-SLICKORGANICSPRIVATELIMITED-CMS1 292214342933,insurance,insurance,net_banking_transfer,744
632af8142e1a0ebb7f4a7bac,50200023535069,466626.22,60ec41ba55c00300382672d9,HDFC,Revenue-PG-split enabled,5eecc6d6449e4f7cfb1c2708,2022-05-09T00:00:00.000Z,NEFT CR-UTIB0001506-RAZORPAY SOFTWARE PR IVATE LIMITED-SLICK ORGANICS PVT LITD-AX ISCN0136577994,insurance,insurance,net_banking_transfer,51143.09
632af8142e1a0ebb7f4a7bae,50200023535069,416626.22,60ec41ba55c00300382672d9,HDFC,Marketing Expense,5eecc6d6449e4f7cfb1c2708,2022-05-09T00:00:00.000Z,ME DC SI 514834XXXXXX9486 GOOGLEWORKSP,,,Other,-50000
632af8142e1a0ebb7f4a7bb1,50200023535069,281626.22,60ec41ba55c00300382672d9,HDFC,direct expenses,5eecc6d6449e4f7cfb1c2708,2022-05-09T00:00:00.000Z,NEFT DR-INDB0000332-OML ENTERTAINMENT PR,,,net_banking_transfer,-135000
632af8142e1a0ebb7f4a7bb4,50200023535069,263246.22,60ec41ba55c00300382672d9,HDFC,direct expenses,5eecc6d6449e4f7cfb1c2708,2022-05-09T00:00:00.000Z,"NEFT DR-CNRB0000349-USHA ENGINEERING WOR KS-NETBANK, MUM-N129221950116690-18380",,,net_banking_transfer,-18380
632af8142e1a0ebb7f4a7bb6,50200023535069,200246.22,60ec41ba55c00300382672d9,HDFC,direct expenses,5eecc6d6449e4f7cfb1c2708,2022-05-09T00:00:00.000Z,"NEFT DR-ICIC0001937-SAUMITRA PANDEY-NETB ANK, MUM-N129221950129702-63000",,,net_banking_transfer,-63000
632af8142e1a0ebb7f4a7bb8,50200023535069,1200246.22,60ec41ba55c00300382672d9,HDFC,Internal Transfers,5eecc6d6449e4f7cfb1c2708,2022-05-09T00:00:00.000Z,IB FUNDS TRANSFER CR-50200035187206 -SL ICK ORGANICS PVT LTD,insurance,insurance,Other,1000000
632af8142e1a0ebb7f4a7bbb,50200023535069,1192013.22,60ec41ba55c00300382672d9,HDFC,direct expenses,5eecc6d6449e4f7cfb1c2708,2022-05-09T00:00:00.000Z,50100221217622-TPT-8233-NIKHIL KUMAR,,,net_banking_transfer,-8233
632af8142e1a0ebb7f4a7bbd,50200023535069,192013.22,60ec41ba55c00300382672d9,HDFC,Marketing Expense,5eecc6d6449e4f7cfb1c2708,2022-05-09T00:00:00.000Z,"NEFT DR-CITI0000006-FACEBOOK INDIA ONLIN E SERVICES PVT LTD-NETBANK, MUM-N1292219 50172461-1000000",,,net_banking_transfer,-1000000
632af8142e1a0ebb7f4a7bbf,50200023535069,405448.38,60ec41ba55c00300382672d9,HDFC,Revenue-Mktplace,5eecc6d6449e4f7cfb1c2708,2022-05-09T00:00:00.000Z,IMPS-212912203253-AMAZON SELLER SERVIC-H SBC-XXXXXXXX6004-3E9B79I624XMTEM0SLICK O RGANICS PVT LTD,shopping,,net_banking_transfer,213435.16
632af8142e1a0ebb7f4a7bc1,50200023535069,1106867.19,60ec41ba55c00300382672d9,HDFC,Revenue-Mktplace,5eecc6d6449e4f7cfb1c2708,2022-05-09T00:00:00.000Z,NEFT CR-DEUT0797BGL-AMAZON PAY (INDIA) P RIVATE LIMITED-SLICK ORGANICS PVT LTD-21 2900773GN00556,shopping,,net_banking_transfer,701418.81
632af8142e1a0ebb7f4a7bc3,50200023535069,851867.19,60ec41ba55c00300382672d9,HDFC,SAAS/tech expense,5eecc6d6449e4f7cfb1c2708,2022-05-09T00:00:00.000Z,POS 514834XXXXXX9486 AMAZON,shopping,,debit_card,-255000
632af8142e1a0ebb7f4a7bc5,50200023535069,855059.56,60ec41ba55c00300382672d9,HDFC,Transfer in/Revenue-other,5eecc6d6449e4f7cfb1c2708,2022-05-09T00:00:00.000Z,NEFT CR-UTIB0000114-ONE SIGMA TECHNOLOGI ES PRIVATE LIM-SLICK ORGANICS PRIVATE LI MITED-AXISP00286881584,insurance,insurance,net_banking_transfer,3192.37
632af8142e1a0ebb7f4a7bc7,50200023535069,867573.35,60ec41ba55c00300382672d9,HDFC,Transfer in/Revenue-other,5eecc6d6449e4f7cfb1c2708,2022-05-09T00:00:00.000Z,NEFT CR-UTIB0000114-ONE SIGMA TECHNOLOGI ES PRIVATE LIM-SLICK ORGANICS PRIVATE LI MITED-AXISP00286881750,insurance,insurance,net_banking_transfer,12513.79
632af8142e1a0ebb7f4a7bc9,50200023535069,872394.01,60ec41ba55c00300382672d9,HDFC,Transfer in/Revenue-other,5eecc6d6449e4f7cfb1c2708,2022-05-09T00:00:00.000Z,NEFT CR-UTIB0000114-ONE SIGMA TECHNOLOGI ES PRIVATE LIM-SLICK ORGANICS PRIVATE LI MITED-AXISP00286881800,insurance,insurance,net_banking_transfer,4820.66
632af8142e1a0ebb7f4a7bcb,50200023535069,876726.01,60ec41ba55c00300382672d9,HDFC,Transfer in/Revenue-other,5eecc6d6449e4f7cfb1c2708,2022-05-09T00:00:00.000Z,NEFT CR-HSBC0560002-INNOVATIVE RETAIL CO NCEPTS PRIVATE-SLICK ORGANICS PVT LTD-HS BCN22129804693,,,net_banking_transfer,4332
632af8142e1a0ebb7f4a7bce,50200023535069,888293.01,60ec41ba55c00300382672d9,HDFC,Transfer in/Revenue-other,5eecc6d6449e4f7cfb1c2708,2022-05-09T00:00:00.000Z,NEFT CR-HSBC0560002-INNOVATIVE RETAIL CO,,,net_banking_transfer,11567
632af8142e1a0ebb7f4a7bd0,50200023535069,889331.01,60ec41ba55c00300382672d9,HDFC,Transfer in/Revenue-other,5eecc6d6449e4f7cfb1c2708,2022-05-09T00:00:00.000Z,NEFT CR-HSBC0560002-INNOVATIVE RETAIL CO NCEPTS PRIVATE-SLICK ORGANICS PVT LTD-HS BCN22129805188,,,net_banking_transfer,1038
632af8142e1a0ebb7f4a7bd2,50200023535069,889476.87,60ec41ba55c00300382672d9,HDFC,Revenue-Mktplace,5eecc6d6449e4f7cfb1c2708,2022-05-09T00:00:00.000Z,NEFT CR-ICIC0000105-MANASH LIFESTYLE PRI VATE LIMITED NO-SLICK ORGANICS PRIVATE L IMITED KOLK-ICIJ221290007253,shopping,,net_banking_transfer,145.86
632af8142e1a0ebb7f4a7bd4,50200023535069,889663.06,60ec41ba55c00300382672d9,HDFC,Revenue-Mktplace,5eecc6d6449e4f7cfb1c2708,2022-05-09T00:00:00.000Z,NEFT CR-ICIC0000105-MANASH LIFESTYLE PRI VATE LIMITED NO-SLICK ORGANICS PRIVATE L IMITED BANG-ICIJ221290007254,shopping,,net_banking_transfer,186.19
632af8142e1a0ebb7f4a7bd6,50200023535069,889903.47,60ec41ba55c00300382672d9,HDFC,Revenue-Mktplace,5eecc6d6449e4f7cfb1c2708,2022-05-09T00:00:00.000Z,NEFT CR-ICIC0000105-MANASH LIFESTYLE PRI VATE LIMITED NO-SLICK ORGANICS PRIVATE L IMITED MP M-ICIJ221290007251,shopping,,net_banking_transfer,240.41
632af8142e1a0ebb7f4a7bd8,50200023535069,905438.43,60ec41ba55c00300382672d9,HDFC,Revenue-PG-split enabled,5eecc6d6449e4f7cfb1c2708,2022-05-09T00:00:00.000Z,NEFT CR-UTIB0001506-RAZORPAY SOFTWARE PR IVATE LIMITED-SLICK ORGANICS PVT LITD-AX ISCN0136799561,insurance,insurance,net_banking_transfer,15534.96
632af8142e1a0ebb7f4a7bda,50200023535069,1093534.79,60ec41ba55c00300382672d9,HDFC,Revenue-COD,5eecc6d6449e4f7cfb1c2708,2022-05-09T00:00:00.000Z,NEFT CR-ICIC0000155-SHIPROCKET COD CRF I D 4292202-SLICK ORGANICS PVT LTD-CMS2570 336915,insurance,insurance,net_banking_transfer,188096.36
632af8142e1a0ebb7f4a7bdc,50200023535069,1162385.97,60ec41ba55c00300382672d9,HDFC,Revenue-UPI,5eecc6d6449e4f7cfb1c2708,2022-05-09T00:00:00.000Z,"UPI-GOKWIK-GOKWIK@YESBANK-YESB0000340-21 2934233297-PAYOUT FOR MAY 7,",,,upi,68851.18
632af8142e1a0ebb7f4a7bde,50200023535069,1162387.97,60ec41ba55c00300382672d9,HDFC,Transfer in/Revenue-other,5eecc6d6449e4f7cfb1c2708,2022-05-09T00:00:00.000Z,CRV POS 514834******9486 LINKEDIN,,,refund,2
632af8142e1a0ebb7f4a7be0,50200023535069,1183108.82,60ec41ba55c00300382672d9,HDFC,Revenue-PG-non-split,5eecc6d6449e4f7cfb1c2708,2022-05-10T00:00:00.000Z,IMPS-213005005616-PAYTM PAYMENTS SERVI-P YTM-XXXXXXXXXX0008-ALL202205102168200003 30830668628,ewallet,,net_banking_transfer,20720.85
632af8142e1a0ebb7f4a7be2,50200023535069,1177833.82,60ec41ba55c00300382672d9,HDFC,direct expenses,5eecc6d6449e4f7cfb1c2708,2022-05-10T00:00:00.000Z,"NEFT DR-SIBL0000555-JAIVEER KUMAR-NETBAN K, MUM-N130221951946142-5275",,,net_banking_transfer,-5275
632af8142e1a0ebb7f4a7be4,50200023535069,1192861.87,60ec41ba55c00300382672d9,HDFC,Revenue-PG-split enabled,5eecc6d6449e4f7cfb1c2708,2022-05-10T00:00:00.000Z,NEFT CR-UTIB0001506-RAZORPAY SOFTWARE PR IVATE LIMITED-SLICK ORGANICS PVT LITD-AX ISCN0136971119,insurance,insurance,net_banking_transfer,15028.05
632af8142e1a0ebb7f4a7be8,50200023535069,1234813.35,60ec41ba55c00300382672d9,HDFC,Revenue-Mktplace,5eecc6d6449e4f7cfb1c2708,2022-05-10T00:00:00.000Z,NEFT CR-HSBC0400002-AMAZON SERVICES LLC-,shopping,,net_banking_transfer,41951.48
632af8142e1a0ebb7f4a7bea,50200023535069,1225963.35,60ec41ba55c00300382672d9,HDFC,direct expenses,5eecc6d6449e4f7cfb1c2708,2022-05-10T00:00:00.000Z,POS 514834XXXXXX9486 RAZ*TAGNPIN WEB,,,debit_card,-8850
632af8142e1a0ebb7f4a7bec,50200023535069,1127081.35,60ec41ba55c00300382672d9,HDFC,Tax,5eecc6d6449e4f7cfb1c2708,2022-05-10T00:00:00.000Z,051030810052211755- CBDT TAX,,,Other,-98882
632af8142e1a0ebb7f4a7bee,50200023535069,1133140.35,60ec41ba55c00300382672d9,HDFC,Revenue-Mktplace,5eecc6d6449e4f7cfb1c2708,2022-05-10T00:00:00.000Z,NEFT CR-ICIC0000985-DIGITAL AGE RETAIL P VT LTD-SLICK ORGANICS PVT LTD-CMS2567367 402,,,net_banking_transfer,6059
632af8142e1a0ebb7f4a7bf0,50200023535069,1135509.03,60ec41ba55c00300382672d9,HDFC,Transfer in/Revenue-other,5eecc6d6449e4f7cfb1c2708,2022-05-10T00:00:00.000Z,NEFT CR-UTIB0000114-ONE SIGMA TECHNOLOGI ES PRIVATE LIM-SLICK ORGANICS PRIVATE LI MITED-AXISP00287205647,insurance,insurance,net_banking_transfer,2368.68
632af8142e1a0ebb7f4a7bf2,50200023535069,1135508.03,60ec41ba55c00300382672d9,HDFC,direct expenses,5eecc6d6449e4f7cfb1c2708,2022-05-10T00:00:00.000Z,POS 514834XXXXXX9486 HOO*HOOTSUITE IN,,,debit_card,-1
632af8142e1a0ebb7f4a7bf4,50200023535069,1124340.4,60ec41ba55c00300382672d9,HDFC,direct expenses,5eecc6d6449e4f7cfb1c2708,2022-05-10T00:00:00.000Z,POS 514834XXXXXX9486 GRAMMARLY CO*IHS,,,debit_card,-11167.63
632af8142e1a0ebb7f4a7bf6,50200023535069,1098340.4,60ec41ba55c00300382672d9,HDFC,direct expenses,5eecc6d6449e4f7cfb1c2708,2022-05-10T00:00:00.000Z,POS 514834XXXXXX9486 DEPANSUM SOLUTIO,,,debit_card,-26000
632af8142e1a0ebb7f4a7bf8,50200023535069,1103399.08,60ec41ba55c00300382672d9,HDFC,Revenue-PG-split enabled,5eecc6d6449e4f7cfb1c2708,2022-05-10T00:00:00.000Z,NEFT CR-UTIB0001506-RAZORPAY SOFTWARE PR IVATE LIMITED-SLICK ORGANICS PVT LITD-AX ISCN0137203833,insurance,insurance,net_banking_transfer,5058.68
632af8142e1a0ebb7f4a7bfa,50200023535069,1104219.32,60ec41ba55c00300382672d9,HDFC,Revenue-Mktplace,5eecc6d6449e4f7cfb1c2708,2022-05-10T00:00:00.000Z,NEFT CR-ICIC0000105-MANASH LIFESTYLE PRI VATE LIMITED NO-SLICK ORGANICS PRIVATE L IMITED MP G-ICIJ221300010390,shopping,,net_banking_transfer,820.24
632af8142e1a0ebb7f4a7bfc,50200023535069,1104988.24,60ec41ba55c00300382672d9,HDFC,Revenue-Mktplace,5eecc6d6449e4f7cfb1c2708,2022-05-10T00:00:00.000Z,NEFT CR-ICIC0000105-MANASH LIFESTYLE PRI VATE LIMITED NO-SLICK ORGANICS PRIVATE L IMITED BANG-ICIJ221300010391,shopping,,net_banking_transfer,768.92
632af8142e1a0ebb7f4a7bfe,50200023535069,1104989.24,60ec41ba55c00300382672d9,HDFC,Revenue-PG-split enabled,5eecc6d6449e4f7cfb1c2708,2022-05-10T00:00:00.000Z,IMPS-213019672515-CASHFREE-ICIC-XXXXXXXX 0175-MINIS BANK DETAILS VALIDATION CF,,,net_banking_transfer,1
632af8142e1a0ebb7f4a7c00,50200023535069,1266572.99,60ec41ba55c00300382672d9,HDFC,Revenue-UPI,5eecc6d6449e4f7cfb1c2708,2022-05-10T00:00:00.000Z,"UPI-GOKWIK-GOKWIK@YESBANK-YESB0000340-21 3036461599-PAYOUT FOR MAY 8,",,,upi,161583.75
632af8142e1a0ebb7f4a7c02,50200023535069,1270889.4,60ec41ba55c00300382672d9,HDFC,Revenue-Mktplace,5eecc6d6449e4f7cfb1c2708,2022-05-11T00:00:00.000Z,NEFT CR-DEUT0797BGL-FLIPKART INTERNET PR IVATE LIMITED-SLICK ORGANICS PVT LTD-213 100112GN00076,shopping,,net_banking_transfer,4316.41
632af8142e1a0ebb7f4a7c04,50200023535069,1290711.87,60ec41ba55c00300382672d9,HDFC,Revenue-PG-non-split,5eecc6d6449e4f7cfb1c2708,2022-05-11T00:00:00.000Z,IMPS-213105673782-PAYTM PAYMENTS SERVI-P YTM-XXXXXXXXXX0008-ALL202205112168200003 30830668628,ewallet,,net_banking_transfer,19822.47
632af8142e1a0ebb7f4a7c07,50200023535069,1297248.21,60ec41ba55c00300382672d9,HDFC,Revenue-Mktplace,5eecc6d6449e4f7cfb1c2708,2022-05-11T00:00:00.000Z,NEFT CR-DEUT0797BGL-MYNTRA DESIGNS PRIVA,shopping,,net_banking_transfer,6536.34
632af8142e1a0ebb7f4a7c09,50200023535069,1300547.13,60ec41ba55c00300382672d9,HDFC,Revenue-Mktplace,5eecc6d6449e4f7cfb1c2708,2022-05-11T00:00:00.000Z,NEFT CR-DEUT0797BGL-MYNTRA DESIGNS PRIVA TE LIMITED-SLICK ORGANICS PVT. LTD.-2131 00559GN00197,shopping,,net_banking_transfer,3298.92
632af8152e1a0ebb7f4a7c0b,50200023535069,1213257.13,60ec41ba55c00300382672d9,HDFC,direct expenses,5eecc6d6449e4f7cfb1c2708,2022-05-11T00:00:00.000Z,"NEFT DR-ICIC0006643-KRISHNA PACKAGING CO MPANY-NETBANK, MUM-N131221953944344-8729 0",,,net_banking_transfer,-87290
632af8152e1a0ebb7f4a7c0d,50200023535069,1226118.86,60ec41ba55c00300382672d9,HDFC,Revenue-PG-split enabled,5eecc6d6449e4f7cfb1c2708,2022-05-11T00:00:00.000Z,NEFT CR-UTIB0001506-RAZORPAY SOFTWARE PR IVATE LIMITED-SLICK ORGANICS PVT LITD-AX ISCN0137358782,insurance,insurance,net_banking_transfer,12861.73
632af8152e1a0ebb7f4a7c0f,50200023535069,1118963.86,60ec41ba55c00300382672d9,HDFC,direct expenses,5eecc6d6449e4f7cfb1c2708,2022-05-11T00:00:00.000Z,00921000075586-TPT-107155-ROET BINDRA,,,net_banking_transfer,-107155
632af8152e1a0ebb7f4a7c11,50200023535069,1113859.86,60ec41ba55c00300382672d9,HDFC,agency/vendor expense,5eecc6d6449e4f7cfb1c2708,2022-05-11T00:00:00.000Z,"NEFT DR-ICIC0001352-AFFNET MARKETING MED IA PVT LTD-NETBANK, MUM-N131221954030719 -5104",,,net_banking_transfer,-5104
632af8152e1a0ebb7f4a7c13,50200023535069,1103030.86,60ec41ba55c00300382672d9,HDFC,direct expenses,5eecc6d6449e4f7cfb1c2708,2022-05-11T00:00:00.000Z,"NEFT DR-ICIC0000021-AKHILESH DIXIT-NETBA NK, MUM-N131221954026689-10829",,,net_banking_transfer,-10829
632af8152e1a0ebb7f4a7c16,50200023535069,848030.86,60ec41ba55c00300382672d9,HDFC,SAAS/tech expense,5eecc6d6449e4f7cfb1c2708,2022-05-11T00:00:00.000Z,POS 514834XXXXXX9486 AMAZON,shopping,,debit_card,-255000
632af8152e1a0ebb7f4a7c18,50200023535069,799430.86,60ec41ba55c00300382672d9,HDFC,direct expenses,5eecc6d6449e4f7cfb1c2708,2022-05-11T00:00:00.000Z,"NEFT DR-CNRB0015170-SNEHAL TAYDE-NETBANK , MUM-N131221954123593-48600",,,net_banking_transfer,-48600
632af8152e1a0ebb7f4a7c1a,50200023535069,789430.86,60ec41ba55c00300382672d9,HDFC,direct expenses,5eecc6d6449e4f7cfb1c2708,2022-05-11T00:00:00.000Z,"NEFT DR-ICIC0003851-JITENDER KUMAR-NETBA NK, MUM-N131221954127381-10000",,,net_banking_transfer,-10000
632af8152e1a0ebb7f4a7c1c,50200023535069,786930.86,60ec41ba55c00300382672d9,HDFC,direct expenses,5eecc6d6449e4f7cfb1c2708,2022-05-11T00:00:00.000Z,POS 514834XXXXXX9486 DIGITAL MART,,,debit_card,-2500
632af8152e1a0ebb7f4a7c1e,50200023535069,550600.86,60ec41ba55c00300382672d9,HDFC,direct expenses,5eecc6d6449e4f7cfb1c2708,2022-05-11T00:00:00.000Z,"NEFT DR-YESB0000058-SIXTEENBY9 VIDEO WOR KS-NETBANK, MUM-N131221954141880-236330",,,net_banking_transfer,-236330
632af8152e1a0ebb7f4a7c20,50200023535069,549984.32,60ec41ba55c00300382672d9,HDFC,direct expenses,5eecc6d6449e4f7cfb1c2708,2022-05-11T00:00:00.000Z,POS 514834XXXXXX9486 RAZ*MAN MATTERS,,,debit_card,-616.54
632af8152e1a0ebb7f4a7c22,50200023535069,550084.32,60ec41ba55c00300382672d9,HDFC,Transfer in/Revenue-other,5eecc6d6449e4f7cfb1c2708,2022-05-11T00:00:00.000Z,BP1022210980-10 05 2022-HD00713732,,,Other,100
632af8152e1a0ebb7f4a7c24,50200023535069,250084.32,60ec41ba55c00300382672d9,HDFC,direct expenses,5eecc6d6449e4f7cfb1c2708,2022-05-11T00:00:00.000Z,"NEFT DR-YESB0000551-VISTTA COSMETICS-NET BANK, MUM-N131221954287742-300000",,,net_banking_transfer,-300000
632af8152e1a0ebb7f4a7c26,50200023535069,230084.32,60ec41ba55c00300382672d9,HDFC,Refund,5eecc6d6449e4f7cfb1c2708,2022-05-11T00:00:00.000Z,"NEFT DR-RATN0VAAPIS-RAZORPAY REFUND CRED ITS TOPUP-NETBANK, MUM-N131221954316319- 20000",,,net_banking_transfer,-20000
632af8152e1a0ebb7f4a7c28,50200023535069,122084.32,60ec41ba55c00300382672d9,HDFC,agency/vendor expense,5eecc6d6449e4f7cfb1c2708,2022-05-11T00:00:00.000Z,NEFT DR-KKBK0000187-VCOMMISSION MEDIA PV,,,net_banking_transfer,-108000
632af8152e1a0ebb7f4a7c2a,50200023535069,142680.31,60ec41ba55c00300382672d9,HDFC,Transfer in/Revenue-other,5eecc6d6449e4f7cfb1c2708,2022-05-11T00:00:00.000Z,NEFT CR-UTIB0000114-ONE SIGMA TECHNOLOGI ES PRIVATE LIM-SLICK ORGANICS PRIVATE LI MITED-AXISP00287625254,insurance,insurance,net_banking_transfer,20595.99
632af8152e1a0ebb7f4a7c2c,50200023535069,143052.69,60ec41ba55c00300382672d9,HDFC,Revenue-Mktplace,5eecc6d6449e4f7cfb1c2708,2022-05-11T00:00:00.000Z,NEFT CR-ICIC0000105-MANASH LIFESTYLE PRI VATE LIMITED NO-SLICK ORGANICS PRIVATE L IMITED MP G-ICIJ221310001601,shopping,,net_banking_transfer,372.38
632af8152e1a0ebb7f4a7c2e,50200023535069,143497.61,60ec41ba55c00300382672d9,HDFC,Revenue-Mktplace,5eecc6d6449e4f7cfb1c2708,2022-05-11T00:00:00.000Z,NEFT CR-ICIC0000105-MANASH LIFESTYLE PRI VATE LIMITED NO-SLICK ORGANICS PRIVATE L IMITED BANG-ICIJ221310003599,shopping,,net_banking_transfer,444.92
632af8152e1a0ebb7f4a7c30,50200023535069,150433.46,60ec41ba55c00300382672d9,HDFC,Revenue-PG-split enabled,5eecc6d6449e4f7cfb1c2708,2022-05-11T00:00:00.000Z,NEFT CR-UTIB0001506-RAZORPAY SOFTWARE PR IVATE LIMITED-SLICK ORGANICS PVT LITD-AX ISCN0137580358,insurance,insurance,net_banking_transfer,6935.85
632af8152e1a0ebb7f4a7c32,50200023535069,286982.45,60ec41ba55c00300382672d9,HDFC,Revenue-COD,5eecc6d6449e4f7cfb1c2708,2022-05-11T00:00:00.000Z,NEFT CR-ICIC0000155-SHIPROCKET COD CRF I D 4304504-SLICK ORGANICS PVT LTD-CMS2575 472892,insurance,insurance,net_banking_transfer,136548.99
632af8152e1a0ebb7f4a7c34,50200023535069,331293.91,60ec41ba55c00300382672d9,HDFC,Revenue-UPI,5eecc6d6449e4f7cfb1c2708,2022-05-11T00:00:00.000Z,"UPI-GOKWIK-GOKWIK@YESBANK-YESB0000340-21 3138762088-PAYOUT FOR MAY 9,",,,upi,44311.46
632af8152e1a0ebb7f4a7c36,50200023535069,341797.92,60ec41ba55c00300382672d9,HDFC,Revenue-PG-non-split,5eecc6d6449e4f7cfb1c2708,2022-05-12T00:00:00.000Z,IMPS-213205338551-PAYTM PAYMENTS SERVI-P YTM-XXXXXXXXXX0008-ALL202205122168200003 30830668628,ewallet,,net_banking_transfer,10504.01
632af8152e1a0ebb7f4a7c38,50200023535069,278033.92,60ec41ba55c00300382672d9,HDFC,Salary/Emp/consultant Expense,5eecc6d6449e4f7cfb1c2708,2022-05-12T00:00:00.000Z,1791511835/EPFO,,,Other,-63764
632af8152e1a0ebb7f4a7c3a,50200023535069,228033.92,60ec41ba55c00300382672d9,HDFC,direct expenses,5eecc6d6449e4f7cfb1c2708,2022-05-12T00:00:00.000Z,50100362612187-TPT-50000-BHUPESH JAKHAR,,,net_banking_transfer,-50000
632af8152e1a0ebb7f4a7c3c,50200023535069,236556.96,60ec41ba55c00300382672d9,HDFC,Revenue-PG-split enabled,5eecc6d6449e4f7cfb1c2708,2022-05-12T00:00:00.000Z,NEFT CR-UTIB0001506-RAZORPAY SOFTWARE PR IVATE LIMITED-SLICK ORGANICS PVT LITD-AX ISCN0137746918,insurance,insurance,net_banking_transfer,8523.04
632af8152e1a0ebb7f4a7c3e,50200023535069,236554.96,60ec41ba55c00300382672d9,HDFC,Marketing Expense,5eecc6d6449e4f7cfb1c2708,2022-05-12T00:00:00.000Z,POS 514834XXXXXX9486 LINKEDIN,,,debit_card,-2
632af8152e1a0ebb7f4a7c40,50200023535069,245351.64,60ec41ba55c00300382672d9,HDFC,Transfer in/Revenue-other,5eecc6d6449e4f7cfb1c2708,2022-05-12T00:00:00.000Z,NEFT CR-UTIB0000114-ONE SIGMA TECHNOLOGI ES PRIVATE LIM-SLICK ORGANICS PRIVATE LI MITED-AXISP00287892366,insurance,insurance,net_banking_transfer,8796.68
632af8152e1a0ebb7f4a7c42,50200023535069,245554.15,60ec41ba55c00300382672d9,HDFC,Transfer in/Revenue-other,5eecc6d6449e4f7cfb1c2708,2022-05-12T00:00:00.000Z,4060001478-11 05 2022-HDFAZCUR1,,,Other,202.51
632af8152e1a0ebb7f4a7c45,50200023535069,260942.15,60ec41ba55c00300382672d9,HDFC,Transfer in/Revenue-other,5eecc6d6449e4f7cfb1c2708,2022-05-12T00:00:00.000Z,50200050241205-TPT-ARATA-NAPSA PRIVATE L IMITED,,,net_banking_transfer,15388
632af8152e1a0ebb7f4a7c47,50200023535069,261336.51,60ec41ba55c00300382672d9,HDFC,Revenue-Mktplace,5eecc6d6449e4f7cfb1c2708,2022-05-12T00:00:00.000Z,NEFT CR-ICIC0000105-MANASH LIFESTYLE PRI VATE LIMITED NO-SLICK ORGANICS PRIVATE L IMITED BANG-ICIJ221320005186,shopping,,net_banking_transfer,394.36
632af8152e1a0ebb7f4a7c49,50200023535069,268024.01,60ec41ba55c00300382672d9,HDFC,Revenue-PG-split enabled,5eecc6d6449e4f7cfb1c2708,2022-05-12T00:00:00.000Z,NEFT CR-UTIB0001506-RAZORPAY SOFTWARE PR IVATE LIMITED-SLICK ORGANICS PVT LITD-AX ISCN0137936047,insurance,insurance,net_banking_transfer,6687.5
632af8152e1a0ebb7f4a7c4b,50200023535069,315270.54,60ec41ba55c00300382672d9,HDFC,Revenue-UPI,5eecc6d6449e4f7cfb1c2708,2022-05-12T00:00:00.000Z,"UPI-GOKWIK-GOKWIK@YESBANK-YESB0000340-21 3240785229-PAYOUT FOR MAY 10,",,,upi,47246.53
632af8152e1a0ebb7f4a7c4e,50200023535069,333210.98,60ec41ba55c00300382672d9,HDFC,Revenue-PG-non-split,5eecc6d6449e4f7cfb1c2708,2022-05-13T00:00:00.000Z,IMPS-213306932804-PAYTM PAYMENTS SERVI-P YTM-XXXXXXXXXX0008-ALL202205132168200003 30830668628,ewallet,,net_banking_transfer,17940.44
632af8152e1a0ebb7f4a7c50,50200023535069,33210.98,60ec41ba55c00300382672d9,HDFC,direct expenses,5eecc6d6449e4f7cfb1c2708,2022-05-13T00:00:00.000Z,"NEFT DR-SCBL0036046-INDOLEADS TECHNOLOGI ES P LTD-NETBANK, MUM-N133221957012711-3 00000",,,net_banking_transfer,-300000
632af8152e1a0ebb7f4a7c52,50200023535069,40534.9,60ec41ba55c00300382672d9,HDFC,Revenue-Mktplace,5eecc6d6449e4f7cfb1c2708,2022-05-13T00:00:00.000Z,NEFT CR-DEUT0797BGL-MYNTRA DESIGNS PRIVA TE LIMITED-SLICK ORGANICS PVT. LTD.-2133 00331GN00032,shopping,,net_banking_transfer,7323.92
632af8152e1a0ebb7f4a7c54,50200023535069,54030.47,60ec41ba55c00300382672d9,HDFC,Revenue-PG-split enabled,5eecc6d6449e4f7cfb1c2708,2022-05-13T00:00:00.000Z,NEFT CR-UTIB0001506-RAZORPAY SOFTWARE PR IVATE LIMITED-SLICK ORGANICS PVT LITD-AX ISCN0138075693,insurance,insurance,net_banking_transfer,13495.57
632af8152e1a0ebb7f4a7c56,50200023535069,56422.61,60ec41ba55c00300382672d9,HDFC,Revenue-Mktplace,5eecc6d6449e4f7cfb1c2708,2022-05-13T00:00:00.000Z,NEFT CR-DEUT0797BGL-FLIPKART INTERNET PR IVATE LIMITED-SLICK ORGANICS PVT LTD-213 300551GN00158,shopping,,net_banking_transfer,2392.14
632af8152e1a0ebb7f4a7c58,50200023535069,62002.43,60ec41ba55c00300382672d9,HDFC,Revenue-Mktplace,5eecc6d6449e4f7cfb1c2708,2022-05-13T00:00:00.000Z,NEFT CR-DEUT0797BGL-FLIPKART INTERNET PR IVATE LIMITED-SLICK ORGANICS PVT LTD-213 300564GN00250,shopping,,net_banking_transfer,5579.82
632af8152e1a0ebb7f4a7c5a,50200023535069,56309.43,60ec41ba55c00300382672d9,HDFC,direct expenses,5eecc6d6449e4f7cfb1c2708,2022-05-13T00:00:00.000Z,02022115470918/ESIC,,,Other,-5693
632af8152e1a0ebb7f4a7c5c,50200023535069,61311.92,60ec41ba55c00300382672d9,HDFC,Transfer in/Revenue-other,5eecc6d6449e4f7cfb1c2708,2022-05-13T00:00:00.000Z,NEFT CR-UTIB0000114-ONE SIGMA TECHNOLOGI,,,net_banking_transfer,5002.49
632af8152e1a0ebb7f4a7c5e,50200023535069,61312.92,60ec41ba55c00300382672d9,HDFC,Transfer in/Revenue-other,5eecc6d6449e4f7cfb1c2708,2022-05-13T00:00:00.000Z,IMPS-213313393436-RELIANCE RETAIL VENT-S CBL-XXXXXXX4531-,,,net_banking_transfer,1
632af8152e1a0ebb7f4a7c60,50200023535069,11312.92,60ec41ba55c00300382672d9,HDFC,direct expenses,5eecc6d6449e4f7cfb1c2708,2022-05-13T00:00:00.000Z,"NEFT DR-PUNB0062910-YADAVPACKAGING-NETBA NK, MUM-N133221957660155-50000",,,net_banking_transfer,-50000
632af8152e1a0ebb7f4a7c62,50200023535069,8312.92,60ec41ba55c00300382672d9,HDFC,direct expenses,5eecc6d6449e4f7cfb1c2708,2022-05-13T00:00:00.000Z,"NEFT DR-SIBL0000555-JAIVEER KUMAR-NETBAN K, MUM-N133221957689052-3000",,,net_banking_transfer,-3000
632af8152e1a0ebb7f4a7c65,50200023535069,17359.92,60ec41ba55c00300382672d9,HDFC,Revenue-Mktplace,5eecc6d6449e4f7cfb1c2708,2022-05-13T00:00:00.000Z,NEFT CR-SCBL0036001-M/S DREAMPLUG TECHNO -SLICK ORGANICS PRIVATE LIMITEDSLICK-SIN 31436Q0039744,insurance,insurance,net_banking_transfer,9047
632af8152e1a0ebb7f4a7c67,50200023535069,24817.92,60ec41ba55c00300382672d9,HDFC,Transfer in/Revenue-other,5eecc6d6449e4f7cfb1c2708,2022-05-13T00:00:00.000Z,FT - CR - 50200038726231 - HOUSE OF BEAU TY PRIVATE LIMITED,,,Other,7458
632af8152e1a0ebb7f4a7c6a,50200023535069,31356.08,60ec41ba55c00300382672d9,HDFC,Revenue-PG-split enabled,5eecc6d6449e4f7cfb1c2708,2022-05-13T00:00:00.000Z,NEFT CR-UTIB0001506-RAZORPAY SOFTWARE PR IVATE LIMITED-SLICK ORGANICS PVT LITD-AX ISCN0138274557,insurance,insurance,net_banking_transfer,6538.16
632af8152e1a0ebb7f4a7c6c,50200023535069,32267.95,60ec41ba55c00300382672d9,HDFC,Revenue-Mktplace,5eecc6d6449e4f7cfb1c2708,2022-05-13T00:00:00.000Z,NEFT CR-ICIC0000105-MANASH LIFESTYLE PRI VATE LIMITED NO-SLICK ORGANICS PRIVATE L IMITED MP M-ICIJ221330008561,shopping,,net_banking_transfer,911.87
632af8152e1a0ebb7f4a7c6e,50200023535069,33584.43,60ec41ba55c00300382672d9,HDFC,Revenue-Mktplace,5eecc6d6449e4f7cfb1c2708,2022-05-13T00:00:00.000Z,NEFT CR-ICIC0000105-MANASH LIFESTYLE PRI VATE LIMITED NO-SLICK ORGANICS PRIVATE L IMITED KOLK-ICIJ221330008563,shopping,,net_banking_transfer,1316.48
632af8152e1a0ebb7f4a7c70,50200023535069,34203.08,60ec41ba55c00300382672d9,HDFC,Revenue-Mktplace,5eecc6d6449e4f7cfb1c2708,2022-05-13T00:00:00.000Z,NEFT CR-ICIC0000105-MANASH LIFESTYLE PRI VATE LIMITED NO-SLICK ORGANICS PRIVATE L IMITED MP G-ICIJ221330007344,shopping,,net_banking_transfer,618.65
632af8152e1a0ebb7f4a7c72,50200023535069,40243.05,60ec41ba55c00300382672d9,HDFC,Revenue-COD,5eecc6d6449e4f7cfb1c2708,2022-05-13T00:00:00.000Z,NEFT CR-ICIC0000155-SHIPROCKET COD CRF I D 4316711-SLICK ORGANICS PVT LTD-CMS2579 756812,insurance,insurance,net_banking_transfer,6039.97
632af8152e1a0ebb7f4a7c74,50200023535069,41054.89,60ec41ba55c00300382672d9,HDFC,Revenue-Mktplace,5eecc6d6449e4f7cfb1c2708,2022-05-13T00:00:00.000Z,NEFT CR-DEUT0784BBY-TATA UNISTORE LTD-NO DAL-SLICK ORGANICS PVT LTD-213302210GN00 328,insurance,insurance,net_banking_transfer,811.84
632af8152e1a0ebb7f4a7c76,50200023535069,66732.22,60ec41ba55c00300382672d9,HDFC,Revenue-UPI,5eecc6d6449e4f7cfb1c2708,2022-05-13T00:00:00.000Z,"UPI-GOKWIK-GOKWIK@YESBANK-YESB0000340-21 3343001421-PAYOUT FOR MAY 11,",,,upi,25677.33
632af8152e1a0ebb7f4a7c78,50200023535069,83383.93,60ec41ba55c00300382672d9,HDFC,Revenue-PG-non-split,5eecc6d6449e4f7cfb1c2708,2022-05-14T00:00:00.000Z,IMPS-213406463240-PAYTM PAYMENTS SERVI-P,ewallet,,net_banking_transfer,16651.71
632af8152e1a0ebb7f4a7c7a,50200023535069,583383.93,60ec41ba55c00300382672d9,HDFC,Internal Transfers,5eecc6d6449e4f7cfb1c2708,2022-05-14T00:00:00.000Z,IB FUNDS TRANSFER CR-50200035187206 -SL ICK ORGANICS PVT LTD,insurance,insurance,Other,500000
632af8152e1a0ebb7f4a7c7d,50200023535069,328383.93,60ec41ba55c00300382672d9,HDFC,SAAS/tech expense,5eecc6d6449e4f7cfb1c2708,2022-05-14T00:00:00.000Z,POS 514834XXXXXX9486 AMAZON,shopping,,debit_card,-255000
632af8152e1a0ebb7f4a7c7f,50200023535069,428383.93,60ec41ba55c00300382672d9,HDFC,Transfer in/Revenue-other,5eecc6d6449e4f7cfb1c2708,2022-05-14T00:00:00.000Z,NEFT CR-IDFB0010204-GETVANTAGE TECH PRIV ATE LIMITED-SLICK ORGANICS PVT LTD-IDFBH 22134636879,,,net_banking_transfer,100000
632af8152e1a0ebb7f4a7c81,50200023535069,428384.93,60ec41ba55c00300382672d9,HDFC,Transfer in/Revenue-other,5eecc6d6449e4f7cfb1c2708,2022-05-14T00:00:00.000Z,POS 514834******9486 RVSL DT - 10/05/22,,,Other,1
632af8152e1a0ebb7f4a7c83,50200023535069,450554.82,60ec41ba55c00300382672d9,HDFC,Revenue-UPI,5eecc6d6449e4f7cfb1c2708,2022-05-14T00:00:00.000Z,"UPI-GOKWIK-GOKWIK@YESBANK-YESB0000340-21 3445125323-PAYOUT FOR MAY 12,",,,upi,22169.89
632af8152e1a0ebb7f4a7c85,50200023535069,467514.38,60ec41ba55c00300382672d9,HDFC,Revenue-PG-non-split,5eecc6d6449e4f7cfb1c2708,2022-05-15T00:00:00.000Z,IMPS-213506938431-PAYTM PAYMENTS SERVI-P YTM-XXXXXXXXXX0008-ALL202205152168200003 30830668628,ewallet,,net_banking_transfer,16959.56
632af8152e1a0ebb7f4a7c87,50200023535069,548204.83,60ec41ba55c00300382672d9,HDFC,Revenue-UPI,5eecc6d6449e4f7cfb1c2708,2022-05-15T00:00:00.000Z,"UPI-GOKWIK-GOKWIK@YESBANK-YESB0000340-21 3547080449-PAYOUT FOR MAY 13,",,,upi,80690.45
632af8152e1a0ebb7f4a7c89,50200023535069,559167.34,60ec41ba55c00300382672d9,HDFC,Revenue-Mktplace,5eecc6d6449e4f7cfb1c2708,2022-05-16T00:00:00.000Z,NEFT CR-DEUT0797BGL-FLIPKART INTERNET PR IVATE LIMITED-SLICK ORGANICS PVT LTD-213 600139GN00194,shopping,,net_banking_transfer,10962.51
632af8152e1a0ebb7f4a7c8b,50200023535069,581146.35,60ec41ba55c00300382672d9,HDFC,Revenue-PG-non-split,5eecc6d6449e4f7cfb1c2708,2022-05-16T00:00:00.000Z,IMPS-213605452608-PAYTM PAYMENTS SERVI-P YTM-XXXXXXXXXX0008-ALL202205162168200003 30830668628,ewallet,,net_banking_transfer,21979.01
632af8152e1a0ebb7f4a7c8d,50200023535069,594161.99,60ec41ba55c00300382672d9,HDFC,Revenue-Mktplace,5eecc6d6449e4f7cfb1c2708,2022-05-16T00:00:00.000Z,NEFT CR-DEUT0797BGL-FLIPKART INTERNET PR IVATE LIMITED-SLICK ORGANICS PVT LTD-213 600239GN00166,shopping,,net_banking_transfer,13015.64
632af8152e1a0ebb7f4a7c8f,50200023535069,598498.12,60ec41ba55c00300382672d9,HDFC,Revenue-Mktplace,5eecc6d6449e4f7cfb1c2708,2022-05-16T00:00:00.000Z,NEFT CR-DEUT0797BGL-MYNTRA DESIGNS PRIVA TE LIMITED-SLICK ORGANICS PVT. LTD.-2136 00583GN00057,shopping,,net_banking_transfer,4336.13
632af8152e1a0ebb7f4a7c94,50200023535069,591555.12,60ec41ba55c00300382672d9,HDFC,direct expenses,5eecc6d6449e4f7cfb1c2708,2022-05-16T00:00:00.000Z,50100093802387-TPT-6943-ISSHANA MAHAJAN,,,net_banking_transfer,-6943
632af8152e1a0ebb7f4a7c96,50200023535069,593859.94,60ec41ba55c00300382672d9,HDFC,Revenue-Mktplace,5eecc6d6449e4f7cfb1c2708,2022-05-16T00:00:00.000Z,NEFT CR-DEUT0797BGL-MYNTRA DESIGNS PRIVA,shopping,,net_banking_transfer,2304.82
632af8152e1a0ebb7f4a7c98,50200023535069,338859.94,60ec41ba55c00300382672d9,HDFC,SAAS/tech expense,5eecc6d6449e4f7cfb1c2708,2022-05-16T00:00:00.000Z,POS 514834XXXXXX9486 AMAZON,shopping,,debit_card,-255000
632af8152e1a0ebb7f4a7c9a,50200023535069,333859.94,60ec41ba55c00300382672d9,HDFC,direct expenses,5eecc6d6449e4f7cfb1c2708,2022-05-16T00:00:00.000Z,"NEFT DR-CNRB0019016-MANEESH-NETBANK, MUM -N136221960465251-5000",,,net_banking_transfer,-5000
632af8152e1a0ebb7f4a7c9c,50200023535069,334136.53,60ec41ba55c00300382672d9,HDFC,Transfer in/Revenue-other,5eecc6d6449e4f7cfb1c2708,2022-05-16T00:00:00.000Z,NEFT CR-UTIB0000114-ONE SIGMA TECHNOLOGI ES PRIVATE LIM-SLICK ORGANICS PRIVATE LI MITED-AXISP00288663176,insurance,insurance,net_banking_transfer,276.59
632af8162e1a0ebb7f4a7c9e,50200023535069,347175.83,60ec41ba55c00300382672d9,HDFC,Transfer in/Revenue-other,5eecc6d6449e4f7cfb1c2708,2022-05-16T00:00:00.000Z,NEFT CR-UTIB0000114-ONE SIGMA TECHNOLOGI ES PRIVATE LIM-SLICK ORGANICS PRIVATE LI MITED-AXISP00288663510,insurance,insurance,net_banking_transfer,13039.3
632af8162e1a0ebb7f4a7ca0,50200023535069,353318.79,60ec41ba55c00300382672d9,HDFC,Transfer in/Revenue-other,5eecc6d6449e4f7cfb1c2708,2022-05-16T00:00:00.000Z,NEFT CR-UTIB0000114-ONE SIGMA TECHNOLOGI ES PRIVATE LIM-SLICK ORGANICS PRIVATE LI MITED-AXISP00288663371,insurance,insurance,net_banking_transfer,6142.96
632af8162e1a0ebb7f4a7ca2,50200023535069,355163.73,60ec41ba55c00300382672d9,HDFC,Revenue-Mktplace,5eecc6d6449e4f7cfb1c2708,2022-05-16T00:00:00.000Z,NEFT CR-ICIC0000105-MANASH LIFESTYLE PRI VATE LIMITED NO-SLICK ORGANICS PRIVATE L IMITED MP G-ICIJ221360002910,shopping,,net_banking_transfer,1844.94
632af8162e1a0ebb7f4a7ca4,50200023535069,356165.05,60ec41ba55c00300382672d9,HDFC,Revenue-Mktplace,5eecc6d6449e4f7cfb1c2708,2022-05-16T00:00:00.000Z,NEFT CR-ICIC0000105-MANASH LIFESTYLE PRI VATE LIMITED NO-SLICK ORGANICS PRIVATE L IMITED BANG-ICIJ221360004786,shopping,,net_banking_transfer,1001.32
632af8162e1a0ebb7f4a7ca6,50200023535069,375316.41,60ec41ba55c00300382672d9,HDFC,Transfer in/Revenue-other,5eecc6d6449e4f7cfb1c2708,2022-05-16T00:00:00.000Z,FT- ARATA-50200053251420 - OCTAVOS ENTER PRISE SOLUTIONS PVT LTD -,,,Other,19151.36
632af8162e1a0ebb7f4a7ca8,50200023535069,430843.63,60ec41ba55c00300382672d9,HDFC,Revenue-UPI,5eecc6d6449e4f7cfb1c2708,2022-05-16T00:00:00.000Z,"UPI-GOKWIK-GOKWIK@YESBANK-YESB0000340-21 3649320622-PAYOUT FOR MAY 14,",,,upi,55527.22
632af8162e1a0ebb7f4a7cab,50200023535069,658414.42,60ec41ba55c00300382672d9,HDFC,Revenue-Mktplace,5eecc6d6449e4f7cfb1c2708,2022-05-17T00:00:00.000Z,IMPS-213705176858-AMAZON SELLER SERVIC-H SBC-XXXXXXXX6004-7CNPWYUPRZ2MO7UNSLICK O RGANICS PVT LTD,shopping,,net_banking_transfer,227570.79
632af8162e1a0ebb7f4a7cad,50200023535069,1398700.6,60ec41ba55c00300382672d9,HDFC,Revenue-Mktplace,5eecc6d6449e4f7cfb1c2708,2022-05-17T00:00:00.000Z,NEFT CR-DEUT0797BGL-AMAZON PAY (INDIA) P RIVATE LIMITED-SLICK ORGANICS PVT LTD-21 3700137GN00031,shopping,,net_banking_transfer,740286.18
632af8162e1a0ebb7f4a7caf,50200023535069,1427750.32,60ec41ba55c00300382672d9,HDFC,Revenue-PG-non-split,5eecc6d6449e4f7cfb1c2708,2022-05-17T00:00:00.000Z,NEFT CR-PYTM0123456-PAYTM PAYMENTS SERVI CES LIMITED-SLICK ORGANICS PVT LTD-PYTM2 21379132587,insurance,insurance,net_banking_transfer,29049.72
632af8162e1a0ebb7f4a7cb2,50200023535069,1509742.76,60ec41ba55c00300382672d9,HDFC,Revenue-PG-split enabled,5eecc6d6449e4f7cfb1c2708,2022-05-17T00:00:00.000Z,NEFT CR-UTIB0001506-RAZORPAY SOFTWARE PR,,,net_banking_transfer,81992.44
632af8162e1a0ebb7f4a7cb4,50200023535069,509742.76,60ec41ba55c00300382672d9,HDFC,Marketing Expense,5eecc6d6449e4f7cfb1c2708,2022-05-17T00:00:00.000Z,"NEFT DR-CITI0000006-FACEBOOK INDIA ONLIN E SERVICES PVT LTD-NETBANK, MUM-N1372219 61512645-1000000",,,net_banking_transfer,-1000000
632af8162e1a0ebb7f4a7cb6,50200023535069,507541.76,60ec41ba55c00300382672d9,HDFC,direct expenses,5eecc6d6449e4f7cfb1c2708,2022-05-17T00:00:00.000Z,"NEFT DR-ICIC0000004-ICICI LOMBARD GIC LT D-NETBANK, MUM-N137221961599745-2201",insurance,insurance,net_banking_transfer,-2201
632af8162e1a0ebb7f4a7cb8,50200023535069,511230.81,60ec41ba55c00300382672d9,HDFC,Transfer in/Revenue-other,5eecc6d6449e4f7cfb1c2708,2022-05-17T00:00:00.000Z,NEFT CR-UTIB0000114-ONE SIGMA TECHNOLOGI ES PRIVATE LIM-SLICK ORGANICS PRIVATE LI MITED-AXISP00288866183,insurance,insurance,net_banking_transfer,3689.05
632af8162e1a0ebb7f4a7cba,50200023535069,241230.81,60ec41ba55c00300382672d9,HDFC,direct expenses,5eecc6d6449e4f7cfb1c2708,2022-05-17T00:00:00.000Z,00321000085687-TPT-270000-SAMEER AHUJA,,,net_banking_transfer,-270000
632af8162e1a0ebb7f4a7cbd,50200023535069,240731.81,60ec41ba55c00300382672d9,HDFC,direct expenses,5eecc6d6449e4f7cfb1c2708,2022-05-17T00:00:00.000Z,POS 514834XXXXXX9486 URBAN COMPANY,,,debit_card,-499
632af8162e1a0ebb7f4a7cbf,50200023535069,241945.05,60ec41ba55c00300382672d9,HDFC,Revenue-Mktplace,5eecc6d6449e4f7cfb1c2708,2022-05-17T00:00:00.000Z,4060001404-TIMES INTERNET LIMITED NODAL,,,Other,1213.24
632af8162e1a0ebb7f4a7cc1,50200023535069,376401.43,60ec41ba55c00300382672d9,HDFC,Revenue-COD,5eecc6d6449e4f7cfb1c2708,2022-05-17T00:00:00.000Z,NEFT CR-ICIC0000155-SHIPROCKET COD CRF I D 4324916-SLICK ORGANICS PVT LTD-CMS2586 269866,insurance,insurance,net_banking_transfer,134456.38
632af8162e1a0ebb7f4a7cc3,50200023535069,389579.67,60ec41ba55c00300382672d9,HDFC,Revenue-PG-split enabled,5eecc6d6449e4f7cfb1c2708,2022-05-17T00:00:00.000Z,NEFT CR-UTIB0001506-RAZORPAY SOFTWARE PR IVATE LIMITED-SLICK ORGANICS PVT LITD-AX ISCN0139201247,insurance,insurance,net_banking_transfer,13178.24
632af8162e1a0ebb7f4a7cc5,50200023535069,389930.03,60ec41ba55c00300382672d9,HDFC,Revenue-Mktplace,5eecc6d6449e4f7cfb1c2708,2022-05-17T00:00:00.000Z,NEFT CR-ICIC0000105-MANASH LIFESTYLE PRI VATE LIMITED NO-SLICK ORGANICS PRIVATE L IMITED MP G-ICIJ221370008055,shopping,,net_banking_transfer,350.36
632af8162e1a0ebb7f4a7cc7,50200023535069,390291.4,60ec41ba55c00300382672d9,HDFC,Revenue-Mktplace,5eecc6d6449e4f7cfb1c2708,2022-05-17T00:00:00.000Z,NEFT CR-ICIC0000105-MANASH LIFESTYLE PRI VATE LIMITED NO-SLICK ORGANICS PRIVATE L IMITED BANG-ICIJ221370008059,shopping,,net_banking_transfer,361.37
632af8162e1a0ebb7f4a7cc9,50200023535069,390395.49,60ec41ba55c00300382672d9,HDFC,Revenue-Mktplace,5eecc6d6449e4f7cfb1c2708,2022-05-17T00:00:00.000Z,NEFT CR-ICIC0000105-MANASH LIFESTYLE PRI VATE LIMITED NO-SLICK ORGANICS PRIVATE L IMITED KOLK-ICIJ221370008057,shopping,,net_banking_transfer,104.09
632af8162e1a0ebb7f4a7ccb,50200023535069,388246.49,60ec41ba55c00300382672d9,HDFC,direct expenses,5eecc6d6449e4f7cfb1c2708,2022-05-17T00:00:00.000Z,POS 514834XXXXXX9486 URBAN COMPANY,,,debit_card,-2149
632af8162e1a0ebb7f4a7ccd,50200023535069,452897.49,60ec41ba55c00300382672d9,HDFC,Investments-New,5eecc6d6449e4f7cfb1c2708,2022-05-17T00:00:00.000Z,FT 1908 E-VENTURES PRIVATE LIMITED,,,Other,64651
632af8162e1a0ebb7f4a7cd0,50200023535069,500236.01,60ec41ba55c00300382672d9,HDFC,Revenue-UPI,5eecc6d6449e4f7cfb1c2708,2022-05-17T00:00:00.000Z,UPI-GOKWIK-GOKWIK@YESBANK-YESB0000340-21,,,upi,47338.52
632af8162e1a0ebb7f4a7cd2,50200023535069,518560.87,60ec41ba55c00300382672d9,HDFC,Revenue-PG-non-split,5eecc6d6449e4f7cfb1c2708,2022-05-18T00:00:00.000Z,IMPS-213805640330-PAYTM PAYMENTS SERVI-P YTM-XXXXXXXXXX0008-ALL202205182168200003 30830668628,ewallet,,net_banking_transfer,18324.86
632af8162e1a0ebb7f4a7cd4,50200023535069,541907.31,60ec41ba55c00300382672d9,HDFC,Revenue-Mktplace,5eecc6d6449e4f7cfb1c2708,2022-05-18T00:00:00.000Z,NEFT CR-DEUT0797BGL-FLIPKART INTERNET PR IVATE LIMITED-SLICK ORGANICS PVT LTD-213 800385GN00202,shopping,,net_banking_transfer,23346.44
632af8162e1a0ebb7f4a7cd6,50200023535069,553470.03,60ec41ba55c00300382672d9,HDFC,Revenue-Mktplace,5eecc6d6449e4f7cfb1c2708,2022-05-18T00:00:00.000Z,NEFT CR-DEUT0797BGL-FLIPKART INTERNET PR IVATE LIMITED-SLICK ORGANICS PVT LTD-213 800406GN00267,shopping,,net_banking_transfer,11562.72
632af8162e1a0ebb7f4a7cd8,50200023535069,558388.77,60ec41ba55c00300382672d9,HDFC,Revenue-Mktplace,5eecc6d6449e4f7cfb1c2708,2022-05-18T00:00:00.000Z,NEFT CR-DEUT0797BGL-MYNTRA DESIGNS PRIVA TE LIMITED-SLICK ORGANICS PVT. LTD.-2138 00409GN00253,shopping,,net_banking_transfer,4918.74
632af8162e1a0ebb7f4a7cda,50200023535069,563893.37,60ec41ba55c00300382672d9,HDFC,Revenue-Mktplace,5eecc6d6449e4f7cfb1c2708,2022-05-18T00:00:00.000Z,NEFT CR-DEUT0797BGL-MYNTRA DESIGNS PRIVA TE LIMITED-SLICK ORGANICS PVT. LTD.-2138 00416GN00044,shopping,,net_banking_transfer,5504.6
632af8162e1a0ebb7f4a7cdc,50200023535069,582311.41,60ec41ba55c00300382672d9,HDFC,Revenue-PG-split enabled,5eecc6d6449e4f7cfb1c2708,2022-05-18T00:00:00.000Z,NEFT CR-UTIB0001506-RAZORPAY SOFTWARE PR IVATE LIMITED-SLICK ORGANICS PVT LITD-AX ISCN0139330507,insurance,insurance,net_banking_transfer,18418.04
632af8162e1a0ebb7f4a7cde,50200023535069,564311.41,60ec41ba55c00300382672d9,HDFC,direct expenses,5eecc6d6449e4f7cfb1c2708,2022-05-18T00:00:00.000Z,"NEFT DR-SBIN0001266-RAVINDRA J YADAV-NET BANK, MUM-N138221963030936-18000",,,net_banking_transfer,-18000
632af8162e1a0ebb7f4a7ce0,50200023535069,557561.41,60ec41ba55c00300382672d9,HDFC,direct expenses,5eecc6d6449e4f7cfb1c2708,2022-05-18T00:00:00.000Z,"NEFT DR-ICIC0000558-ANJANA MURALIDHARAN- NETBANK, MUM-N138221963045509-6750",,,net_banking_transfer,-6750
632af8162e1a0ebb7f4a7ce2,50200023535069,572758.37,60ec41ba55c00300382672d9,HDFC,Transfer in/Revenue-other,5eecc6d6449e4f7cfb1c2708,2022-05-18T00:00:00.000Z,NEFT CR-UTIB0000114-ONE SIGMA TECHNOLOGI ES PRIVATE LIM-SLICK ORGANICS PRIVATE LI MITED-AXISP00289173626,insurance,insurance,net_banking_transfer,15196.96
632af8162e1a0ebb7f4a7ce4,50200023535069,317758.37,60ec41ba55c00300382672d9,HDFC,SAAS/tech expense,5eecc6d6449e4f7cfb1c2708,2022-05-18T00:00:00.000Z,POS 514834XXXXXX9486 AMAZON,shopping,,debit_card,-255000
632af8162e1a0ebb7f4a7ce7,50200023535069,318284.65,60ec41ba55c00300382672d9,HDFC,Revenue-Mktplace,5eecc6d6449e4f7cfb1c2708,2022-05-18T00:00:00.000Z,NEFT CR-ICIC0000105-MANASH LIFESTYLE PRI VATE LIMITED NO-SLICK ORGANICS PRIVATE L IMITED BANG-ICIJ221380007689,shopping,,net_banking_transfer,526.28
632af8162e1a0ebb7f4a7ce9,50200023535069,318722.98,60ec41ba55c00300382672d9,HDFC,Revenue-Mktplace,5eecc6d6449e4f7cfb1c2708,2022-05-18T00:00:00.000Z,NEFT CR-ICIC0000105-MANASH LIFESTYLE PRI,shopping,,net_banking_transfer,438.33
632af8162e1a0ebb7f4a7ceb,50200023535069,346963.99,60ec41ba55c00300382672d9,HDFC,Revenue-PG-split enabled,5eecc6d6449e4f7cfb1c2708,2022-05-18T00:00:00.000Z,NEFT CR-UTIB0001506-RAZORPAY SOFTWARE PR IVATE LIMITED-SLICK ORGANICS PVT LITD-AX ISCN0139515159,insurance,insurance,net_banking_transfer,28241.01
632af8162e1a0ebb7f4a7ced,50200023535069,416060.78,60ec41ba55c00300382672d9,HDFC,Revenue-UPI,5eecc6d6449e4f7cfb1c2708,2022-05-18T00:00:00.000Z,"UPI-GOKWIK-GOKWIK@YESBANK-YESB0000340-21 3853493438-PAYOUT FOR MAY 16,",,,upi,69096.79
632af8162e1a0ebb7f4a7cf0,50200023535069,454491.86,60ec41ba55c00300382672d9,HDFC,Revenue-PG-non-split,5eecc6d6449e4f7cfb1c2708,2022-05-19T00:00:00.000Z,NEFT CR-PYTM0123456-PAYTM PAYMENTS SERVI CES LIMITED-SLICK ORGANICS PVT LTD-PYTM2 21390511876,insurance,insurance,net_banking_transfer,38431.08
632af8162e1a0ebb7f4a7cf2,50200023535069,486015.55,60ec41ba55c00300382672d9,HDFC,Revenue-PG-split enabled,5eecc6d6449e4f7cfb1c2708,2022-05-19T00:00:00.000Z,NEFT CR-UTIB0001506-RAZORPAY SOFTWARE PR IVATE LIMITED-SLICK ORGANICS PVT LITD-AX ISCN0139651983,insurance,insurance,net_banking_transfer,31523.69
632af8162e1a0ebb7f4a7cf4,50200023535069,490683.13,60ec41ba55c00300382672d9,HDFC,Transfer in/Revenue-other,5eecc6d6449e4f7cfb1c2708,2022-05-19T00:00:00.000Z,NEFT CR-UTIB0000114-ONE SIGMA TECHNOLOGI ES PRIVATE LIM-SLICK ORGANICS PRIVATE LI MITED-AXISP00289409050,insurance,insurance,net_banking_transfer,4667.58
632af8162e1a0ebb7f4a7cf6,50200023535069,509246.51,60ec41ba55c00300382672d9,HDFC,Transfer in/Revenue-other,5eecc6d6449e4f7cfb1c2708,2022-05-19T00:00:00.000Z,"IMPS-213917010166-GOKWIK COMMERCE SOLU-I CIC-XXXXXXXX0630-PAYOUT FOR MAY 17, 2022",,,net_banking_transfer,18563.38
632af8162e1a0ebb7f4a7cf8,50200023535069,509805.08,60ec41ba55c00300382672d9,HDFC,Revenue-Mktplace,5eecc6d6449e4f7cfb1c2708,2022-05-19T00:00:00.000Z,NEFT CR-ICIC0000105-MANASH LIFESTYLE PRI VATE LIMITED NO-SLICK ORGANICS PRIVATE L IMITED BANG-ICIJ221390004031,shopping,,net_banking_transfer,558.57
632af8162e1a0ebb7f4a7cfa,50200023535069,509991.27,60ec41ba55c00300382672d9,HDFC,Revenue-Mktplace,5eecc6d6449e4f7cfb1c2708,2022-05-19T00:00:00.000Z,NEFT CR-ICIC0000105-MANASH LIFESTYLE PRI VATE LIMITED NO-SLICK ORGANICS PRIVATE L IMITED KOLK-ICIJ221390004030,shopping,,net_banking_transfer,186.19
632af8162e1a0ebb7f4a7cfc,50200023535069,510363.65,60ec41ba55c00300382672d9,HDFC,Revenue-Mktplace,5eecc6d6449e4f7cfb1c2708,2022-05-19T00:00:00.000Z,NEFT CR-ICIC0000105-MANASH LIFESTYLE PRI VATE LIMITED NO-SLICK ORGANICS PRIVATE L IMITED MP G-ICIJ221390004028,shopping,,net_banking_transfer,372.38
632af8162e1a0ebb7f4a7cfe,50200023535069,535869.5,60ec41ba55c00300382672d9,HDFC,Revenue-PG-split enabled,5eecc6d6449e4f7cfb1c2708,2022-05-19T00:00:00.000Z,NEFT CR-UTIB0001506-RAZORPAY SOFTWARE PR IVATE LIMITED-SLICK ORGANICS PVT LITD-AX ISCN0139836112,insurance,insurance,net_banking_transfer,25505.85
632af8162e1a0ebb7f4a7d00,50200023535069,502778.5,60ec41ba55c00300382672d9,HDFC,direct expenses,5eecc6d6449e4f7cfb1c2708,2022-05-19T00:00:00.000Z,00918630000430-TPT-33091-UNICOMMERCE ESO LUTIONS PRIVATE LIMITED,,,net_banking_transfer,-33091
632af8162e1a0ebb7f4a7d02,50200023535069,452778.5,60ec41ba55c00300382672d9,HDFC,direct expenses,5eecc6d6449e4f7cfb1c2708,2022-05-19T00:00:00.000Z,NEFT DR-PUNB0062910-YADAVPACKAGING-NETBA,,,net_banking_transfer,-50000
632af8162e1a0ebb7f4a7d04,50200023535069,429536.5,60ec41ba55c00300382672d9,HDFC,direct expenses,5eecc6d6449e4f7cfb1c2708,2022-05-19T00:00:00.000Z,"NEFT DR-SBIN0008078-PANDIT PLASTICS-NETB ANK, MUM-N139221965393043-23242",,,net_banking_transfer,-23242
632af8162e1a0ebb7f4a7d06,50200023535069,304419.5,60ec41ba55c00300382672d9,HDFC,Tax,5eecc6d6449e4f7cfb1c2708,2022-05-19T00:00:00.000Z,GST/BANK REFERENCE NO: R2213934780191/CI N NO: HDFC22050700151843,,,Other,-125117
632af8162e1a0ebb7f4a7d0a,50200023535069,329794.54,60ec41ba55c00300382672d9,HDFC,Revenue-UPI,5eecc6d6449e4f7cfb1c2708,2022-05-19T00:00:00.000Z,"UPI-GOKWIK-GOKWIK@YESBANK-YESB0000340-21 3955657982-PAYOUT FOR MAY 17,",,,upi,25375.04
632af8162e1a0ebb7f4a7d0c,50200023535069,329796.54,60ec41ba55c00300382672d9,HDFC,Transfer in/Revenue-other,5eecc6d6449e4f7cfb1c2708,2022-05-19T00:00:00.000Z,CRV POS 514834******9486 LINKEDIN,,,refund,2
632af8162e1a0ebb7f4a7d0e,50200023535069,372233.47,60ec41ba55c00300382672d9,HDFC,Revenue-PG-non-split,5eecc6d6449e4f7cfb1c2708,2022-05-20T00:00:00.000Z,NEFT CR-PYTM0123456-PAYTM PAYMENTS SERVI CES LIMITED-SLICK ORGANICS PVT LTD-PYTM2 21401086805,insurance,insurance,net_banking_transfer,42436.93
632af8162e1a0ebb7f4a7d10,50200023535069,229949.47,60ec41ba55c00300382672d9,HDFC,direct expenses,5eecc6d6449e4f7cfb1c2708,2022-05-20T00:00:00.000Z,"NEFT DR-UTIB0000430-SUPERTECH INDIA PVT LTD-NETBANK, MUM-N140221965623754-142284",,,net_banking_transfer,-142284
632af8162e1a0ebb7f4a7d12,50200023535069,232019.17,60ec41ba55c00300382672d9,HDFC,Revenue-Mktplace,5eecc6d6449e4f7cfb1c2708,2022-05-20T00:00:00.000Z,NEFT CR-DEUT0797BGL-FLIPKART INTERNET PR IVATE LIMITED-SLICK ORGANICS PVT LTD-214 000211GN00261,shopping,,net_banking_transfer,2069.7
632af8162e1a0ebb7f4a7d14,50200023535069,234162.61,60ec41ba55c00300382672d9,HDFC,Revenue-Mktplace,5eecc6d6449e4f7cfb1c2708,2022-05-20T00:00:00.000Z,NEFT CR-DEUT0797BGL-MYNTRA DESIGNS PRIVA TE LIMITED-SLICK ORGANICS PVT. LTD.-2140 00486GN00018,shopping,,net_banking_transfer,2143.44
632af8162e1a0ebb7f4a7d16,50200023535069,240173.52,60ec41ba55c00300382672d9,HDFC,Revenue-Mktplace,5eecc6d6449e4f7cfb1c2708,2022-05-20T00:00:00.000Z,NEFT CR-DEUT0797BGL-MYNTRA DESIGNS PRIVA TE LIMITED-SLICK ORGANICS PVT. LTD.-2140 00484GN00073,shopping,,net_banking_transfer,6010.91
632af8162e1a0ebb7f4a7d18,50200023535069,262432.81,60ec41ba55c00300382672d9,HDFC,Revenue-PG-split enabled,5eecc6d6449e4f7cfb1c2708,2022-05-20T00:00:00.000Z,NEFT CR-UTIB0001506-RAZORPAY SOFTWARE PR IVATE LIMITED-SLICK ORGANICS PVT LITD-AX ISCN0139949084,insurance,insurance,net_banking_transfer,22259.29
632af8162e1a0ebb7f4a7d1a,50200023535069,257002.64,60ec41ba55c00300382672d9,HDFC,direct expenses,5eecc6d6449e4f7cfb1c2708,2022-05-20T00:00:00.000Z,POS 514834XXXXXX9486 ECOMENGINE* FEED,,,debit_card,-5430.17
632af8162e1a0ebb7f4a7d1c,50200023535069,257000.64,60ec41ba55c00300382672d9,HDFC,Marketing Expense,5eecc6d6449e4f7cfb1c2708,2022-05-20T00:00:00.000Z,POS 514834XXXXXX9486 LINKEDIN,,,debit_card,-2
632af8162e1a0ebb7f4a7d1e,50200023535069,211567.92,60ec41ba55c00300382672d9,HDFC,direct expenses,5eecc6d6449e4f7cfb1c2708,2022-05-20T00:00:00.000Z,POS 514834XXXXXX9486 THE ROCKET SCIEN,,,debit_card,-45432.72
632af8162e1a0ebb7f4a7d20,50200023535069,206567.92,60ec41ba55c00300382672d9,HDFC,direct expenses,5eecc6d6449e4f7cfb1c2708,2022-05-20T00:00:00.000Z,15871050016759-TPT-5000-SIVAKAMI R,,,net_banking_transfer,-5000
632af8162e1a0ebb7f4a7d22,50200023535069,208469.48,60ec41ba55c00300382672d9,HDFC,Transfer in/Revenue-other,5eecc6d6449e4f7cfb1c2708,2022-05-20T00:00:00.000Z,NEFT CR-UTIB0000114-ONE SIGMA TECHNOLOGI ES PRIVATE LIM-SLICK ORGANICS PRIVATE LI MITED-AXISP00289633422,insurance,insurance,net_banking_transfer,1901.56
632af8162e1a0ebb7f4a7d24,50200023535069,209458.32,60ec41ba55c00300382672d9,HDFC,Revenue-Mktplace,5eecc6d6449e4f7cfb1c2708,2022-05-20T00:00:00.000Z,NEFT CR-ICIC0000105-MANASH LIFESTYLE PRI,shopping,,net_banking_transfer,988.84
632af8162e1a0ebb7f4a7d26,50200023535069,209644.51,60ec41ba55c00300382672d9,HDFC,Revenue-Mktplace,5eecc6d6449e4f7cfb1c2708,2022-05-20T00:00:00.000Z,NEFT CR-ICIC0000105-MANASH LIFESTYLE PRI VATE LIMITED NO-SLICK ORGANICS PRIVATE L IMITED KOLK-ICIJ221400005119,shopping,,net_banking_transfer,186.19
632af8162e1a0ebb7f4a7d28,50200023535069,207284.51,60ec41ba55c00300382672d9,HDFC,direct expenses,5eecc6d6449e4f7cfb1c2708,2022-05-20T00:00:00.000Z,59209810462595-TPT-2360-INDIAN HARNESS,,,net_banking_transfer,-2360
632af8162e1a0ebb7f4a7d2a,50200023535069,366977.64,60ec41ba55c00300382672d9,HDFC,Transfer in/Revenue-other,5eecc6d6449e4f7cfb1c2708,2022-05-20T00:00:00.000Z,"IMPS-214017107891-GOKWIK COMMERCE SOLU-I CIC-XXXXXXXX0630-PAYOUT FOR MAY 18, 2022",,,net_banking_transfer,159693.13
632af8172e1a0ebb7f4a7d2c,50200023535069,92641.64,60ec41ba55c00300382672d9,HDFC,direct expenses,5eecc6d6449e4f7cfb1c2708,2022-05-20T00:00:00.000Z,POS 514834XXXXXX9486 SHOPIFY* 1408012,,,debit_card,-274336
632af8172e1a0ebb7f4a7d2e,50200023535069,115070.51,60ec41ba55c00300382672d9,HDFC,Revenue-PG-split enabled,5eecc6d6449e4f7cfb1c2708,2022-05-20T00:00:00.000Z,NEFT CR-UTIB0001506-RAZORPAY SOFTWARE PR IVATE LIMITED-SLICK ORGANICS PVT LITD-AX ISCN0140146296,insurance,insurance,net_banking_transfer,22428.87
632af8172e1a0ebb7f4a7d30,50200023535069,146180.01,60ec41ba55c00300382672d9,HDFC,Revenue-PG-non-split,5eecc6d6449e4f7cfb1c2708,2022-05-21T00:00:00.000Z,NEFT CR-PYTM0123456-PAYTM PAYMENTS SERVI CES LIMITED-SLICK ORGANICS PVT LTD-PYTM2 21411871696,insurance,insurance,net_banking_transfer,31109.5
632af8172e1a0ebb7f4a7d32,50200023535069,156033.62,60ec41ba55c00300382672d9,HDFC,Revenue-PG-split enabled,5eecc6d6449e4f7cfb1c2708,2022-05-21T00:00:00.000Z,NEFT CR-UTIB0001506-RAZORPAY SOFTWARE PR IVATE LIMITED-SLICK ORGANICS PVT LITD-AX ISCN0140261257,insurance,insurance,net_banking_transfer,9853.61
632af8172e1a0ebb7f4a7d34,50200023535069,159538.12,60ec41ba55c00300382672d9,HDFC,Transfer in/Revenue-other,5eecc6d6449e4f7cfb1c2708,2022-05-21T00:00:00.000Z,NEFT CR-HSBC0560002-INNOVATIVE RETAIL CO NCEPTS PRIVATE-SLICK ORGANICS PVT LTD-HS BCN22141468788,,,net_banking_transfer,3504.5
632af8172e1a0ebb7f4a7d36,50200023535069,168704.12,60ec41ba55c00300382672d9,HDFC,Transfer in/Revenue-other,5eecc6d6449e4f7cfb1c2708,2022-05-21T00:00:00.000Z,NEFT CR-HSBC0560002-INNOVATIVE RETAIL CO NCEPTS PRIVATE-SLICK ORGANICS PVT LTD-HS BCN22141469616,,,net_banking_transfer,9166
632af8172e1a0ebb7f4a7d38,50200023535069,171868.12,60ec41ba55c00300382672d9,HDFC,Transfer in/Revenue-other,5eecc6d6449e4f7cfb1c2708,2022-05-21T00:00:00.000Z,NEFT CR-HSBC0560002-INNOVATIVE RETAIL CO NCEPTS PRIVATE-SLICK ORGANICS PVT LTD-HS BCN22141468859,,,net_banking_transfer,3164
632af8172e1a0ebb7f4a7d3a,50200023535069,173286.68,60ec41ba55c00300382672d9,HDFC,Transfer in/Revenue-other,5eecc6d6449e4f7cfb1c2708,2022-05-21T00:00:00.000Z,4060001801-21 05 2022-HDFAZCUR1,,,Other,1418.56
632af8172e1a0ebb7f4a7d3c,50200023535069,325760.72,60ec41ba55c00300382672d9,HDFC,Transfer in/Revenue-other,5eecc6d6449e4f7cfb1c2708,2022-05-21T00:00:00.000Z,"IMPS-214117147810-GOKWIK COMMERCE SOLU-I CIC-XXXXXXXX0630-PAYOUT FOR MAY 19, 2022",,,net_banking_transfer,152474.04
632af8172e1a0ebb7f4a7d3e,50200023535069,332682.93,60ec41ba55c00300382672d9,HDFC,Revenue-PG-split enabled,5eecc6d6449e4f7cfb1c2708,2022-05-21T00:00:00.000Z,NEFT CR-UTIB0001506-RAZORPAY SOFTWARE PR,,,net_banking_transfer,6922.21
632af8172e1a0ebb7f4a7d40,50200023535069,77682.93,60ec41ba55c00300382672d9,HDFC,SAAS/tech expense,5eecc6d6449e4f7cfb1c2708,2022-05-21T00:00:00.000Z,POS 514834XXXXXX9486 AMAZON,shopping,,debit_card,-255000
632af8172e1a0ebb7f4a7d42,50200023535069,88721.88,60ec41ba55c00300382672d9,HDFC,Revenue-PG-non-split,5eecc6d6449e4f7cfb1c2708,2022-05-22T00:00:00.000Z,IMPS-214206351488-PAYTM PAYMENTS SERVI-P YTM-XXXXXXXXXX0008-ALL202205222168200003 30830668628,ewallet,,net_banking_transfer,11038.95
632af8172e1a0ebb7f4a7d44,50200023535069,111067.03,60ec41ba55c00300382672d9,HDFC,Transfer in/Revenue-other,5eecc6d6449e4f7cfb1c2708,2022-05-22T00:00:00.000Z,"IMPS-214217891086-GOKWIK COMMERCE SOLU-I CIC-XXXXXXXX0630-PAYOUT FOR MAY 20, 2022",,,net_banking_transfer,22345.15
632af8172e1a0ebb7f4a7d46,50200023535069,127187.57,60ec41ba55c00300382672d9,HDFC,Revenue-Mktplace,5eecc6d6449e4f7cfb1c2708,2022-05-23T00:00:00.000Z,NEFT CR-DEUT0797BGL-FLIPKART INTERNET PR IVATE LIMITED-SLICK ORGANICS PVT LTD-214 300084GN00024,shopping,,net_banking_transfer,16120.54
632af8172e1a0ebb7f4a7d48,50200023535069,131550.34,60ec41ba55c00300382672d9,HDFC,Revenue-Mktplace,5eecc6d6449e4f7cfb1c2708,2022-05-23T00:00:00.000Z,NEFT CR-DEUT0797BGL-FLIPKART INTERNET PR IVATE LIMITED-SLICK ORGANICS PVT LTD-214 300170GN00126,shopping,,net_banking_transfer,4362.77
632af8172e1a0ebb7f4a7d4b,50200023535069,149885.55,60ec41ba55c00300382672d9,HDFC,Revenue-PG-non-split,5eecc6d6449e4f7cfb1c2708,2022-05-23T00:00:00.000Z,IMPS-214305721719-PAYTM PAYMENTS SERVI-P YTM-XXXXXXXXXX0008-ALL202205232168200003 30830668628,ewallet,,net_banking_transfer,18335.21
632af8172e1a0ebb7f4a7d4d,50200023535069,172446.31,60ec41ba55c00300382672d9,HDFC,Revenue-PG-split enabled,5eecc6d6449e4f7cfb1c2708,2022-05-23T00:00:00.000Z,NEFT CR-UTIB0001506-RAZORPAY SOFTWARE PR IVATE LIMITED-SLICK ORGANICS PVT LITD-AX ISCN0140738204,insurance,insurance,net_banking_transfer,22560.76
632af8172e1a0ebb7f4a7d4f,50200023535069,171946.31,60ec41ba55c00300382672d9,HDFC,direct expenses,5eecc6d6449e4f7cfb1c2708,2022-05-23T00:00:00.000Z,POS 514834XXXXXX9486 MINISTRY OF COMP,,,debit_card,-500
632af8172e1a0ebb7f4a7d51,50200023535069,172347.37,60ec41ba55c00300382672d9,HDFC,Revenue-Mktplace,5eecc6d6449e4f7cfb1c2708,2022-05-23T00:00:00.000Z,NEFT CR-DEUT0784BBY-TATA UNISTORE LTD-NO DAL-SLICK ORGANICS PVT LTD-214300973GN00 370,insurance,insurance,net_banking_transfer,401.06
632af8172e1a0ebb7f4a7d53,50200023535069,168068.37,60ec41ba55c00300382672d9,HDFC,direct expenses,5eecc6d6449e4f7cfb1c2708,2022-05-23T00:00:00.000Z,"NEFT DR-ICIC0000021-AKHILESH DIXIT-NETBA NK, MUM-N143221968332066-4279",,,net_banking_transfer,-4279
632af8172e1a0ebb7f4a7d55,50200023535069,1668068.37,60ec41ba55c00300382672d9,HDFC,Internal Transfers,5eecc6d6449e4f7cfb1c2708,2022-05-23T00:00:00.000Z,IB FUNDS TRANSFER CR-50200035187206 -SL ICK ORGANICS PVT LTD,insurance,insurance,Other,1500000
632af8172e1a0ebb7f4a7d57,50200023535069,134011.37,60ec41ba55c00300382672d9,HDFC,Marketing Expense,5eecc6d6449e4f7cfb1c2708,2022-05-23T00:00:00.000Z,"NEFT DR-CITI0000006-FACEBOOK INDIA ONLIN E SERVICES PVT LTD-NETBANK, MUM-N1432219 68411256-1534057",,,net_banking_transfer,-1534057
632af8172e1a0ebb7f4a7d59,50200023535069,138593.16,60ec41ba55c00300382672d9,HDFC,Revenue-Mktplace,5eecc6d6449e4f7cfb1c2708,2022-05-23T00:00:00.000Z,NEFT CR-DEUT0797BGL-MYNTRA DESIGNS PRIVA,shopping,,net_banking_transfer,4581.79
632af8172e1a0ebb7f4a7d5b,50200023535069,146017.97,60ec41ba55c00300382672d9,HDFC,Revenue-Mktplace,5eecc6d6449e4f7cfb1c2708,2022-05-23T00:00:00.000Z,NEFT CR-DEUT0797BGL-MYNTRA DESIGNS PRIVA TE LIMITED-SLICK ORGANICS PVT. LTD.-2143 00884GN00104,shopping,,net_banking_transfer,7424.81
632af8172e1a0ebb7f4a7d5d,50200023535069,147123.28,60ec41ba55c00300382672d9,HDFC,Transfer in/Revenue-other,5eecc6d6449e4f7cfb1c2708,2022-05-23T00:00:00.000Z,NEFT CR-UTIB0000114-ONE SIGMA TECHNOLOGI ES PRIVATE LIM-SLICK ORGANICS PRIVATE LI MITED-AXISP00290046887,insurance,insurance,net_banking_transfer,1105.31
632af8172e1a0ebb7f4a7d5f,50200023535069,156215.02,60ec41ba55c00300382672d9,HDFC,Transfer in/Revenue-other,5eecc6d6449e4f7cfb1c2708,2022-05-23T00:00:00.000Z,NEFT CR-UTIB0000114-ONE SIGMA TECHNOLOGI ES PRIVATE LIM-SLICK ORGANICS PRIVATE LI MITED-AXISP00290046650,insurance,insurance,net_banking_transfer,9091.74
632af8172e1a0ebb7f4a7d61,50200023535069,156997.16,60ec41ba55c00300382672d9,HDFC,Revenue-Mktplace,5eecc6d6449e4f7cfb1c2708,2022-05-23T00:00:00.000Z,NEFT CR-ICIC0000105-MANASH LIFESTYLE PRI VATE LIMITED NO-SLICK ORGANICS PRIVATE L IMITED BANG-ICIJ221430004038,shopping,,net_banking_transfer,782.14
632af8172e1a0ebb7f4a7d64,50200023535069,207679.72,60ec41ba55c00300382672d9,HDFC,Transfer in/Revenue-other,5eecc6d6449e4f7cfb1c2708,2022-05-23T00:00:00.000Z,"IMPS-214317773870-GOKWIK COMMERCE SOLU-I CIC-XXXXXXXX0630-PAYOUT FOR MAY 21, 2022",,,net_banking_transfer,50682.56
632af8172e1a0ebb7f4a7d66,50200023535069,224222.31,60ec41ba55c00300382672d9,HDFC,Revenue-PG-split enabled,5eecc6d6449e4f7cfb1c2708,2022-05-23T00:00:00.000Z,NEFT CR-UTIB0001506-RAZORPAY SOFTWARE PR IVATE LIMITED-SLICK ORGANICS PVT LITD-AX ISCN0140957652,insurance,insurance,net_banking_transfer,16542.59
632af8172e1a0ebb7f4a7d68,50200023535069,226641.31,60ec41ba55c00300382672d9,HDFC,Transfer in/Revenue-other,5eecc6d6449e4f7cfb1c2708,2022-05-23T00:00:00.000Z,POS REF 514834******9486-05/22 HTTPS://S,,,refund,2419
632af8172e1a0ebb7f4a7d6a,50200023535069,309496.67,60ec41ba55c00300382672d9,HDFC,Revenue-COD,5eecc6d6449e4f7cfb1c2708,2022-05-23T00:00:00.000Z,NEFT CR-ICIC0000155-SHIPROCKET COD CRF I D 4357714-SLICK ORGANICS PVT LTD-CMS2597 433327,insurance,insurance,net_banking_transfer,82855.36
632af8172e1a0ebb7f4a7d6c,50200023535069,309973.45,60ec41ba55c00300382672d9,HDFC,Revenue-PG-non-split,5eecc6d6449e4f7cfb1c2708,2022-05-24T00:00:00.000Z,NEFT CR-YESB0000001-RZPX PVT LTD NODAL A CCOUNT-SLICKORGANICS-N144221227109756,insurance,insurance,net_banking_transfer,476.78
632af8172e1a0ebb7f4a7d6e,50200023535069,541917.88,60ec41ba55c00300382672d9,HDFC,Revenue-Mktplace,5eecc6d6449e4f7cfb1c2708,2022-05-24T00:00:00.000Z,IMPS-214405027186-AMAZON SELLER SERVIC-H SBC-XXXXXXXX6004-MLNWSFW80QMK4FRKSLICK O RGANICS PVT LTD,shopping,,net_banking_transfer,231944.43
632af8172e1a0ebb7f4a7d70,50200023535069,1347852.01,60ec41ba55c00300382672d9,HDFC,Revenue-Mktplace,5eecc6d6449e4f7cfb1c2708,2022-05-24T00:00:00.000Z,NEFT CR-DEUT0797BGL-AMAZON PAY (INDIA) P RIVATE LIMITED-SLICK ORGANICS PVT LTD-21 4400136GN00487,shopping,,net_banking_transfer,805934.13
632af8172e1a0ebb7f4a7d72,50200023535069,1376469.05,60ec41ba55c00300382672d9,HDFC,Revenue-PG-non-split,5eecc6d6449e4f7cfb1c2708,2022-05-24T00:00:00.000Z,NEFT CR-PYTM0123456-PAYTM PAYMENTS SERVI,ewallet,,net_banking_transfer,28617.04
632af8172e1a0ebb7f4a7d74,50200023535069,785732.05,60ec41ba55c00300382672d9,HDFC,direct expenses,5eecc6d6449e4f7cfb1c2708,2022-05-24T00:00:00.000Z,50200020787428-TPT-590737-SHRI AKSHARA F ILMS,,,net_banking_transfer,-590737
632af8172e1a0ebb7f4a7d76,50200023535069,485732.05,60ec41ba55c00300382672d9,HDFC,direct expenses,5eecc6d6449e4f7cfb1c2708,2022-05-24T00:00:00.000Z,05892560000649-TPT-300000-DECORPAC INDIA PRIVATE LIMITED,,,net_banking_transfer,-300000
632af8172e1a0ebb7f4a7d78,50200023535069,185732.05,60ec41ba55c00300382672d9,HDFC,direct expenses,5eecc6d6449e4f7cfb1c2708,2022-05-24T00:00:00.000Z,"NEFT DR-ICIC0000369-BO INTERNATIONAL-NET BANK, MUM-N144221969427703-300000",,,net_banking_transfer,-300000
632af8172e1a0ebb7f4a7d7a,50200023535069,218437.53,60ec41ba55c00300382672d9,HDFC,Revenue-PG-split enabled,5eecc6d6449e4f7cfb1c2708,2022-05-24T00:00:00.000Z,NEFT CR-UTIB0001506-RAZORPAY SOFTWARE PR IVATE LIMITED-SLICK ORGANICS PVT LITD-AX ISCN0141179757,insurance,insurance,net_banking_transfer,32705.48
632af8172e1a0ebb7f4a7d7c,50200023535069,215437.53,60ec41ba55c00300382672d9,HDFC,direct expenses,5eecc6d6449e4f7cfb1c2708,2022-05-24T00:00:00.000Z,"NEFT DR-CNRB0019016-MANEESH-NETBANK, MUM -N144221969514783-3000",,,net_banking_transfer,-3000
632af8172e1a0ebb7f4a7d7e,50200023535069,210437.53,60ec41ba55c00300382672d9,HDFC,direct expenses,5eecc6d6449e4f7cfb1c2708,2022-05-24T00:00:00.000Z,"NEFT DR-ICIC0000021-AKHILESH DIXIT-NETBA NK, MUM-N144221969654217-5000",,,net_banking_transfer,-5000
632af8172e1a0ebb7f4a7d80,50200023535069,232930.27,60ec41ba55c00300382672d9,HDFC,Revenue-Mktplace,5eecc6d6449e4f7cfb1c2708,2022-05-24T00:00:00.000Z,NEFT CR-KKBK0000958-NYKAA E RETAIL PRIVA TE LIMITED NYKAA-SLICK ORGANICS PVT LTD- KKBK221447256099,insurance,insurance,net_banking_transfer,22492.74
632af8172e1a0ebb7f4a7d82,50200023535069,233871.34,60ec41ba55c00300382672d9,HDFC,Revenue-Mktplace,5eecc6d6449e4f7cfb1c2708,2022-05-24T00:00:00.000Z,4060001735-TIMES INTERNET LIMITED NODAL,,,Other,941.07
632af8172e1a0ebb7f4a7d84,50200023535069,263871.34,60ec41ba55c00300382672d9,HDFC,Internal Transfers,5eecc6d6449e4f7cfb1c2708,2022-05-24T00:00:00.000Z,IB FUNDS TRANSFER CR-50200050976833 -SL ICK ORGANICS PVT LTD,insurance,insurance,Other,30000
632af8172e1a0ebb7f4a7d86,50200023535069,8871.34,60ec41ba55c00300382672d9,HDFC,SAAS/tech expense,5eecc6d6449e4f7cfb1c2708,2022-05-24T00:00:00.000Z,POS 514834XXXXXX9486 AMAZON,shopping,,debit_card,-255000
632af8172e1a0ebb7f4a7d88,50200023535069,51439.23,60ec41ba55c00300382672d9,HDFC,Transfer in/Revenue-other,5eecc6d6449e4f7cfb1c2708,2022-05-24T00:00:00.000Z,"IMPS-214417035584-GOKWIK COMMERCE SOLU-I CIC-XXXXXXXX0630-PAYOUT FOR MAY 22, 2022",,,net_banking_transfer,42567.89
632af8172e1a0ebb7f4a7d8a,50200023535069,70800.24,60ec41ba55c00300382672d9,HDFC,Revenue-PG-split enabled,5eecc6d6449e4f7cfb1c2708,2022-05-24T00:00:00.000Z,NEFT CR-UTIB0001506-RAZORPAY SOFTWARE PR IVATE LIMITED-SLICK ORGANICS PVT LITD-AX ISCN0141384366,insurance,insurance,net_banking_transfer,19361.01
632af8172e1a0ebb7f4a7d8c,50200023535069,120800.24,60ec41ba55c00300382672d9,HDFC,Internal Transfers,5eecc6d6449e4f7cfb1c2708,2022-05-24T00:00:00.000Z,IB FUNDS TRANSFER CR-50200035187206 -SL ICK ORGANICS PVT LTD,insurance,insurance,Other,50000
632af8172e1a0ebb7f4a7d8e,50200023535069,11758.24,60ec41ba55c00300382672d9,HDFC,direct expenses,5eecc6d6449e4f7cfb1c2708,2022-05-24T00:00:00.000Z,"NEFT DR-YESB0000162-VINAY REDDY-NETBANK, MUM-N144221970591600-109042",,,net_banking_transfer,-109042
632af8172e1a0ebb7f4a7d90,50200023535069,26875.74,60ec41ba55c00300382672d9,HDFC,Revenue-Mktplace,5eecc6d6449e4f7cfb1c2708,2022-05-25T00:00:00.000Z,NEFT CR-DEUT0797BGL-FLIPKART INTERNET PR,shopping,,net_banking_transfer,15117.5
632af8172e1a0ebb7f4a7d92,50200023535069,39499.39,60ec41ba55c00300382672d9,HDFC,Revenue-Mktplace,5eecc6d6449e4f7cfb1c2708,2022-05-25T00:00:00.000Z,NEFT CR-DEUT0797BGL-FLIPKART INTERNET PR IVATE LIMITED-SLICK ORGANICS PVT LTD-214 500145GN00064,shopping,,net_banking_transfer,12623.65
632af8172e1a0ebb7f4a7d94,50200023535069,96524.58,60ec41ba55c00300382672d9,HDFC,Revenue-PG-non-split,5eecc6d6449e4f7cfb1c2708,2022-05-25T00:00:00.000Z,NEFT CR-PYTM0123456-PAYTM PAYMENTS SERVI CES LIMITED-SLICK ORGANICS PVT LTD-PYTM2 21454660794,insurance,insurance,net_banking_transfer,57025.19
632af8172e1a0ebb7f4a7d96,50200023535069,92524.58,60ec41ba55c00300382672d9,HDFC,direct expenses,5eecc6d6449e4f7cfb1c2708,2022-05-25T00:00:00.000Z,"NEFT DR-SIBL0000555-JAIVEER KUMAR-NETBAN K, MUM-N145221970755139-4000",,,net_banking_transfer,-4000
632af8172e1a0ebb7f4a7d98,50200023535069,97188.46,60ec41ba55c00300382672d9,HDFC,Revenue-Mktplace,5eecc6d6449e4f7cfb1c2708,2022-05-25T00:00:00.000Z,NEFT CR-DEUT0797BGL-MYNTRA DESIGNS PRIVA TE LIMITED-SLICK ORGANICS PVT. LTD.-2145 00557GN00071,shopping,,net_banking_transfer,4663.88
632af8172e1a0ebb7f4a7d9a,50200023535069,100549.63,60ec41ba55c00300382672d9,HDFC,Revenue-Mktplace,5eecc6d6449e4f7cfb1c2708,2022-05-25T00:00:00.000Z,NEFT CR-DEUT0797BGL-MYNTRA DESIGNS PRIVA TE LIMITED-SLICK ORGANICS PVT. LTD.-2145 00558GN00024,shopping,,net_banking_transfer,3361.17
632af8172e1a0ebb7f4a7d9c,50200023535069,114668.69,60ec41ba55c00300382672d9,HDFC,Revenue-PG-split enabled,5eecc6d6449e4f7cfb1c2708,2022-05-25T00:00:00.000Z,NEFT CR-UTIB0001506-RAZORPAY SOFTWARE PR IVATE LIMITED-SLICK ORGANICS PVT LITD-AX ISCN0141549080,insurance,insurance,net_banking_transfer,14119.06
632af8172e1a0ebb7f4a7d9e,50200023535069,125652.34,60ec41ba55c00300382672d9,HDFC,Revenue-Mktplace,5eecc6d6449e4f7cfb1c2708,2022-05-25T00:00:00.000Z,NEFT CR-HSBC0400002-AMAZON SERVICES LLC- SLICK ORGANICS PRIVATE LIMITED-HSBCN2214 5931593,shopping,,net_banking_transfer,10983.65
632af8172e1a0ebb7f4a7da0,50200023535069,127062.54,60ec41ba55c00300382672d9,HDFC,Transfer in/Revenue-other,5eecc6d6449e4f7cfb1c2708,2022-05-25T00:00:00.000Z,NEFT CR-UTIB0000114-ONE SIGMA TECHNOLOGI ES PRIVATE LIM-SLICK ORGANICS PRIVATE LI MITED-AXISP00290490986,insurance,insurance,net_banking_transfer,1410.2
632af8172e1a0ebb7f4a7da2,50200023535069,127374.8,60ec41ba55c00300382672d9,HDFC,Revenue-Mktplace,5eecc6d6449e4f7cfb1c2708,2022-05-25T00:00:00.000Z,NEFT CR-ICIC0000105-MANASH LIFESTYLE PRI VATE LIMITED NO-SLICK ORGANICS PRIVATE L IMITED BANG-ICIJ221450002466,shopping,,net_banking_transfer,312.26
632af8172e1a0ebb7f4a7da4,50200023535069,129003.55,60ec41ba55c00300382672d9,HDFC,Revenue-Mktplace,5eecc6d6449e4f7cfb1c2708,2022-05-25T00:00:00.000Z,NEFT CR-ICIC0000105-MANASH LIFESTYLE PRI VATE LIMITED NO-SLICK ORGANICS PRIVATE L IMITED MP G-ICIJ221450001041,shopping,,net_banking_transfer,1628.75
632af8172e1a0ebb7f4a7da6,50200023535069,119453.55,60ec41ba55c00300382672d9,HDFC,direct expenses,5eecc6d6449e4f7cfb1c2708,2022-05-25T00:00:00.000Z,NEFT DR-ICIC0006986-ASHWINI SHARMA-NETBA,,,net_banking_transfer,-9550
632af8172e1a0ebb7f4a7da8,50200023535069,127395.55,60ec41ba55c00300382672d9,HDFC,Transfer in/Revenue-other,5eecc6d6449e4f7cfb1c2708,2022-05-25T00:00:00.000Z,50200050241205-TPT-ARATA-NAPSA PRIVATE L IMITED,,,net_banking_transfer,7942
632af8172e1a0ebb7f4a7daa,50200023535069,203894.35,60ec41ba55c00300382672d9,HDFC,Transfer in/Revenue-other,5eecc6d6449e4f7cfb1c2708,2022-05-25T00:00:00.000Z,"IMPS-214517244340-GOKWIK COMMERCE SOLU-I CIC-XXXXXXXX0630-PAYOUT FOR MAY 23, 2022",,,net_banking_transfer,76498.8
632af8172e1a0ebb7f4a7dac,50200023535069,217893.64,60ec41ba55c00300382672d9,HDFC,Revenue-PG-split enabled,5eecc6d6449e4f7cfb1c2708,2022-05-25T00:00:00.000Z,NEFT CR-UTIB0001506-RAZORPAY SOFTWARE PR IVATE LIMITED-SLICK ORGANICS PVT LITD-AX ISCN0141760470,insurance,insurance,net_banking_transfer,13999.29
632af8172e1a0ebb7f4a7dae,50200023535069,234317.21,60ec41ba55c00300382672d9,HDFC,Revenue-COD,5eecc6d6449e4f7cfb1c2708,2022-05-25T00:00:00.000Z,NEFT CR-ICIC0000155-SHIPROCKET COD CRF I D 4370017-SLICK ORGANICS PVT LTD-CMS2601 140536,insurance,insurance,net_banking_transfer,16423.57
632af8172e1a0ebb7f4a7db0,50200023535069,234699.47,60ec41ba55c00300382672d9,HDFC,Revenue-Mktplace,5eecc6d6449e4f7cfb1c2708,2022-05-25T00:00:00.000Z,NEFT CR-DEUT0784BBY-TATA UNISTORE LTD-NO DAL-SLICK ORGANICS PVT LTD-214501819GN00 293,insurance,insurance,net_banking_transfer,382.26
632af8172e1a0ebb7f4a7db3,50200023535069,234697.11,60ec41ba55c00300382672d9,HDFC,bank charges,5eecc6d6449e4f7cfb1c2708,2022-05-25T00:00:00.000Z,DEBIT CARD PUR ADJ DT 23/05/22,,,Other,-2.36
632af8172e1a0ebb7f4a7db5,50200023535069,287140.71,60ec41ba55c00300382672d9,HDFC,Revenue-PG-non-split,5eecc6d6449e4f7cfb1c2708,2022-05-26T00:00:00.000Z,NEFT CR-PYTM0123456-PAYTM PAYMENTS SERVI CES LIMITED-SLICK ORGANICS PVT LTD-PYTM2 21465487757,insurance,insurance,net_banking_transfer,52443.6
632af8182e1a0ebb7f4a7db7,50200023535069,248962.71,60ec41ba55c00300382672d9,HDFC,direct expenses,5eecc6d6449e4f7cfb1c2708,2022-05-26T00:00:00.000Z,"NEFT DR-YESB0000058-SIXTEENBY9 VIDEO WOR KS-NETBANK, MUM-N146221972250762-38178",,,net_banking_transfer,-38178
632af8182e1a0ebb7f4a7db9,50200023535069,270398.72,60ec41ba55c00300382672d9,HDFC,Revenue-PG-split enabled,5eecc6d6449e4f7cfb1c2708,2022-05-26T00:00:00.000Z,NEFT CR-UTIB0001506-RAZORPAY SOFTWARE PR IVATE LIMITED-SLICK ORGANICS PVT LITD-AX ISCN0141905536,insurance,insurance,net_banking_transfer,21436.01
632af8182e1a0ebb7f4a7dbb,50200023535069,240898.72,60ec41ba55c00300382672d9,HDFC,direct expenses,5eecc6d6449e4f7cfb1c2708,2022-05-26T00:00:00.000Z,"NEFT DR-ICIC0002305-VIRAL MINT-NETBANK, MUM-N146221972287114-29500",,,net_banking_transfer,-29500
632af8182e1a0ebb7f4a7dbd,50200023535069,140898.72,60ec41ba55c00300382672d9,HDFC,direct expenses,5eecc6d6449e4f7cfb1c2708,2022-05-26T00:00:00.000Z,"NEFT DR-YESB0000162-VINAY REDDY-NETBANK, MUM-N146221972389227-100000",,,net_banking_transfer,-100000
632af8182e1a0ebb7f4a7dbf,50200023535069,-9101.28,60ec41ba55c00300382672d9,HDFC,direct expenses,5eecc6d6449e4f7cfb1c2708,2022-05-26T00:00:00.000Z,"NEFT DR-SCBL0036046-INDOLEADS TECHNOLOGI ES P LTD-NETBANK, MUM-N146221972407637-1 50000",,,net_banking_transfer,-150000
632af8182e1a0ebb7f4a7dc1,50200023535069,-13669.28,60ec41ba55c00300382672d9,HDFC,direct expenses,5eecc6d6449e4f7cfb1c2708,2022-05-26T00:00:00.000Z,NEFT DR-ICIC0000021-AKHILESH DIXIT-NETBA,,,net_banking_transfer,-4568
632af8182e1a0ebb7f4a7dc3,50200023535069,486330.72,60ec41ba55c00300382672d9,HDFC,Internal Transfers,5eecc6d6449e4f7cfb1c2708,2022-05-26T00:00:00.000Z,IB FUNDS TRANSFER CR-50200035187206 -SL ICK ORGANICS PVT LTD,insurance,insurance,Other,500000
632af8182e1a0ebb7f4a7dc5,50200023535069,286330.72,60ec41ba55c00300382672d9,HDFC,Salary/Emp/consultant Expense,5eecc6d6449e4f7cfb1c2708,2022-05-26T00:00:00.000Z,"NEFT DR-ICIC0003851-JITENDER KUMAR-NETBA NK, MUM-N146221972587681-ADVANCE SALARY",,,net_banking_transfer,-200000
632af8182e1a0ebb7f4a7dc8,50200023535069,288745.24,60ec41ba55c00300382672d9,HDFC,Revenue-Mktplace,5eecc6d6449e4f7cfb1c2708,2022-05-26T00:00:00.000Z,NEFT CR-ICIC0000105-MANASH LIFESTYLE PRI VATE LIMITED NO-SLICK ORGANICS PRIVATE L IMITED MP G-ICIJ221460002903,shopping,,net_banking_transfer,2414.52
632af8182e1a0ebb7f4a7dca,50200023535069,363841.17,60ec41ba55c00300382672d9,HDFC,Transfer in/Revenue-other,5eecc6d6449e4f7cfb1c2708,2022-05-26T00:00:00.000Z,"IMPS-214617473367-GOKWIK COMMERCE SOLU-I CIC-XXXXXXXX0630-PAYOUT FOR MAY 24, 2022",,,net_banking_transfer,75095.93
632af8182e1a0ebb7f4a7dcc,50200023535069,381156,60ec41ba55c00300382672d9,HDFC,Revenue-PG-split enabled,5eecc6d6449e4f7cfb1c2708,2022-05-26T00:00:00.000Z,NEFT CR-UTIB0001506-RAZORPAY SOFTWARE PR IVATE LIMITED-SLICK ORGANICS PVT LITD-AX ISCN0142103749,insurance,insurance,net_banking_transfer,17314.83
632af8182e1a0ebb7f4a7dce,50200023535069,385179,60ec41ba55c00300382672d9,HDFC,Revenue-Mktplace,5eecc6d6449e4f7cfb1c2708,2022-05-26T00:00:00.000Z,NEFT CR-ICIC0000985-DIGITAL AGE RETAIL P VT LTD-SLICK ORGANICS PVT LTD DS-CMS26 03820545,,,net_banking_transfer,4023
632af8182e1a0ebb7f4a7dd0,50200023535069,390002.28,60ec41ba55c00300382672d9,HDFC,Revenue-Mktplace,5eecc6d6449e4f7cfb1c2708,2022-05-27T00:00:00.000Z,NEFT CR-DEUT0797BGL-FLIPKART INTERNET PR IVATE LIMITED-SLICK ORGANICS PVT LTD-214 700153GN00117,shopping,,net_banking_transfer,4823.28
632af8182e1a0ebb7f4a7dd2,50200023535069,398845.59,60ec41ba55c00300382672d9,HDFC,Revenue-Mktplace,5eecc6d6449e4f7cfb1c2708,2022-05-27T00:00:00.000Z,NEFT CR-DEUT0797BGL-FLIPKART INTERNET PR IVATE LIMITED-SLICK ORGANICS PVT LTD-214 700158GN00192,shopping,,net_banking_transfer,8843.31
632af8182e1a0ebb7f4a7dd4,50200023535069,446580.15,60ec41ba55c00300382672d9,HDFC,Revenue-PG-non-split,5eecc6d6449e4f7cfb1c2708,2022-05-27T00:00:00.000Z,NEFT CR-PYTM0123456-PAYTM PAYMENTS SERVI CES LIMITED-SLICK ORGANICS PVT LTD-PYTM2 21476288168,insurance,insurance,net_banking_transfer,47734.56
632af8182e1a0ebb7f4a7dd6,50200023535069,449848.95,60ec41ba55c00300382672d9,HDFC,Revenue-Mktplace,5eecc6d6449e4f7cfb1c2708,2022-05-27T00:00:00.000Z,NEFT CR-DEUT0797BGL-MYNTRA DESIGNS PRIVA TE LIMITED-SLICK ORGANICS PVT. LTD.-2147 00534GN00259,shopping,,net_banking_transfer,3268.8
632af8182e1a0ebb7f4a7dd8,50200023535069,455483.77,60ec41ba55c00300382672d9,HDFC,Revenue-Mktplace,5eecc6d6449e4f7cfb1c2708,2022-05-27T00:00:00.000Z,NEFT CR-DEUT0797BGL-MYNTRA DESIGNS PRIVA TE LIMITED-SLICK ORGANICS PVT. LTD.-2147 00553GN00040,shopping,,net_banking_transfer,5634.82
632af8182e1a0ebb7f4a7dda,50200023535069,448853.77,60ec41ba55c00300382672d9,HDFC,direct expenses,5eecc6d6449e4f7cfb1c2708,2022-05-27T00:00:00.000Z,POS 514834XXXXXX9486 PTM*PAYTM,ewallet,,debit_card,-6630
632af8182e1a0ebb7f4a7ddc,50200023535069,469028.24,60ec41ba55c00300382672d9,HDFC,Revenue-PG-split enabled,5eecc6d6449e4f7cfb1c2708,2022-05-27T00:00:00.000Z,NEFT CR-UTIB0001506-RAZORPAY SOFTWARE PR,,,net_banking_transfer,20174.47
632af8182e1a0ebb7f4a7de0,50200023535069,1019028.24,60ec41ba55c00300382672d9,HDFC,Internal Transfers,5eecc6d6449e4f7cfb1c2708,2022-05-27T00:00:00.000Z,IB FUNDS TRANSFER CR-50200035187206 -SL ICK ORGANICS PVT LTD,insurance,insurance,Other,550000
632af8182e1a0ebb7f4a7de2,50200023535069,69028.24,60ec41ba55c00300382672d9,HDFC,Tax,5eecc6d6449e4f7cfb1c2708,2022-05-27T00:00:00.000Z,051030827052210377- CBDT TAX,,,Other,-950000
632af8182e1a0ebb7f4a7de4,50200023535069,70317.91,60ec41ba55c00300382672d9,HDFC,Transfer in/Revenue-other,5eecc6d6449e4f7cfb1c2708,2022-05-27T00:00:00.000Z,NEFT CR-UTIB0000114-ONE SIGMA TECHNOLOGI ES PRIVATE LIM-SLICK ORGANICS PRIVATE LI MITED-AXISP00290935346,insurance,insurance,net_banking_transfer,1289.67
632af8182e1a0ebb7f4a7de6,50200023535069,320317.91,60ec41ba55c00300382672d9,HDFC,Internal Transfers,5eecc6d6449e4f7cfb1c2708,2022-05-27T00:00:00.000Z,IB FUNDS TRANSFER CR-50200035187206 -SL ICK ORGANICS PVT LTD,insurance,insurance,Other,250000
632af8182e1a0ebb7f4a7de8,50200023535069,65317.91,60ec41ba55c00300382672d9,HDFC,SAAS/tech expense,5eecc6d6449e4f7cfb1c2708,2022-05-27T00:00:00.000Z,POS 514834XXXXXX9486 AMAZON,shopping,,debit_card,-255000
632af8182e1a0ebb7f4a7dea,50200023535069,70773.91,60ec41ba55c00300382672d9,HDFC,Revenue-Mktplace,5eecc6d6449e4f7cfb1c2708,2022-05-27T00:00:00.000Z,NEFT CR-SCBL0036001-M/S DREAMPLUG TECHNO -SLICK ORGANICS PRIVATE LIMITEDSLICK-SIN 31436Q0040645,insurance,insurance,net_banking_transfer,5456
632af8182e1a0ebb7f4a7dec,50200023535069,174778.82,60ec41ba55c00300382672d9,HDFC,Transfer in/Revenue-other,5eecc6d6449e4f7cfb1c2708,2022-05-27T00:00:00.000Z,"IMPS-214717547982-GOKWIK COMMERCE SOLU-I CIC-XXXXXXXX0630-PAYOUT FOR MAY 25, 2022",,,net_banking_transfer,104004.91
632af8182e1a0ebb7f4a7dee,50200023535069,192583.19,60ec41ba55c00300382672d9,HDFC,Revenue-PG-split enabled,5eecc6d6449e4f7cfb1c2708,2022-05-27T00:00:00.000Z,NEFT CR-UTIB0001506-RAZORPAY SOFTWARE PR IVATE LIMITED-SLICK ORGANICS PVT LITD-AX ISCN0142430754,insurance,insurance,net_banking_transfer,17804.37
632af8182e1a0ebb7f4a7df0,50200023535069,213548.2,60ec41ba55c00300382672d9,HDFC,Revenue-PG-non-split,5eecc6d6449e4f7cfb1c2708,2022-05-28T00:00:00.000Z,IMPS-214806480259-PAYTM PAYMENTS SERVI-P YTM-XXXXXXXXXX0008-ALL202205282168200003 30830668628,ewallet,,net_banking_transfer,20965.01
632af8182e1a0ebb7f4a7df2,50200023535069,335108.39,60ec41ba55c00300382672d9,HDFC,Transfer in/Revenue-other,5eecc6d6449e4f7cfb1c2708,2022-05-28T00:00:00.000Z,"IMPS-214817835767-GOKWIK COMMERCE SOLU-I CIC-XXXXXXXX0630-PAYOUT FOR MAY 26, 2022",,,net_banking_transfer,121560.19
632af8182e1a0ebb7f4a7df4,50200023535069,335110.39,60ec41ba55c00300382672d9,HDFC,Transfer in/Revenue-other,5eecc6d6449e4f7cfb1c2708,2022-05-28T00:00:00.000Z,CRV POS 514834******9486 LINKEDIN,,,refund,2
632af8182e1a0ebb7f4a7df6,50200023535069,366485.05,60ec41ba55c00300382672d9,HDFC,Revenue-PG-non-split,5eecc6d6449e4f7cfb1c2708,2022-05-29T00:00:00.000Z,NEFT CR-PYTM0123456-PAYTM PAYMENTS SERVI CES LIMITED-SLICK ORGANICS PVT LTD-PYTM2 21497947110,insurance,insurance,net_banking_transfer,31374.66
632af8182e1a0ebb7f4a7df8,50200023535069,446189.92,60ec41ba55c00300382672d9,HDFC,Transfer in/Revenue-other,5eecc6d6449e4f7cfb1c2708,2022-05-29T00:00:00.000Z,"IMPS-214917652363-GOKWIK COMMERCE SOLU-I CIC-XXXXXXXX0630-PAYOUT FOR MAY 27, 2022",,,net_banking_transfer,79704.87
632af8182e1a0ebb7f4a7dfa,50200023535069,454370.41,60ec41ba55c00300382672d9,HDFC,Revenue-UPI,5eecc6d6449e4f7cfb1c2708,2022-05-29T00:00:00.000Z,UPI-GOKWIK-GOKWIK@YESBANK-YESB0000340-21,,,upi,8180.49
632af8182e1a0ebb7f4a7dfc,50200023535069,462201.16,60ec41ba55c00300382672d9,HDFC,Revenue-Mktplace,5eecc6d6449e4f7cfb1c2708,2022-05-30T00:00:00.000Z,NEFT CR-DEUT0797BGL-FLIPKART INTERNET PR IVATE LIMITED-SLICK ORGANICS PVT LTD-215 000118GN00038,shopping,,net_banking_transfer,7830.75
632af8182e1a0ebb7f4a7dfe,50200023535069,483125.83,60ec41ba55c00300382672d9,HDFC,Revenue-PG-non-split,5eecc6d6449e4f7cfb1c2708,2022-05-30T00:00:00.000Z,IMPS-215006995412-PAYTM PAYMENTS SERVI-P YTM-XXXXXXXXXX0008-ALL202205302168200003 30830668628,ewallet,,net_banking_transfer,20924.67
632af8182e1a0ebb7f4a7e00,50200023535069,1983125.83,60ec41ba55c00300382672d9,HDFC,Internal Transfers,5eecc6d6449e4f7cfb1c2708,2022-05-30T00:00:00.000Z,IB FUNDS TRANSFER CR-50200035187206 -SL ICK ORGANICS PVT LTD,insurance,insurance,Other,1500000
632af8182e1a0ebb7f4a7e02,50200023535069,872899.83,60ec41ba55c00300382672d9,HDFC,Marketing Expense,5eecc6d6449e4f7cfb1c2708,2022-05-30T00:00:00.000Z,"NEFT DR-CITI0100000-GOOGLE INDIA PVT LTD -NETBANK, MUM-N150221975630478-1110226",,,net_banking_transfer,-1110226
632af8182e1a0ebb7f4a7e05,50200023535069,573649.83,60ec41ba55c00300382672d9,HDFC,direct expenses,5eecc6d6449e4f7cfb1c2708,2022-05-30T00:00:00.000Z,50200016751567-TPT-299250-HUMANS OF BOMB AY STORIES PRIVATE LIMITED,,,net_banking_transfer,-299250
632af8182e1a0ebb7f4a7e07,50200023535069,560649.83,60ec41ba55c00300382672d9,HDFC,direct expenses,5eecc6d6449e4f7cfb1c2708,2022-05-30T00:00:00.000Z,50100188500931-TPT-13000-DEEPIKA JOSHI,,,net_banking_transfer,-13000
632af8182e1a0ebb7f4a7e09,50200023535069,260649.83,60ec41ba55c00300382672d9,HDFC,direct expenses,5eecc6d6449e4f7cfb1c2708,2022-05-30T00:00:00.000Z,"NEFT DR-ICIC0000369-BO INTERNATIONAL-NET BANK, MUM-N150221975646131-300000",,,net_banking_transfer,-300000
632af8182e1a0ebb7f4a7e0b,50200023535069,152929.83,60ec41ba55c00300382672d9,HDFC,direct expenses,5eecc6d6449e4f7cfb1c2708,2022-05-30T00:00:00.000Z,"NEFT DR-ICIC0000874-TRELION BUSINESS SOL UTIONS PVT LTD-NETBANK, MUM-N15022197565 2679-107720",,,net_banking_transfer,-107720
632af8182e1a0ebb7f4a7e0d,50200023535069,159513.84,60ec41ba55c00300382672d9,HDFC,Revenue-Mktplace,5eecc6d6449e4f7cfb1c2708,2022-05-30T00:00:00.000Z,NEFT CR-DEUT0797BGL-MYNTRA DESIGNS PRIVA TE LIMITED-SLICK ORGANICS PVT. LTD.-2150 00473GN00279,shopping,,net_banking_transfer,6584.01
632af8182e1a0ebb7f4a7e0f,50200023535069,171132.26,60ec41ba55c00300382672d9,HDFC,Revenue-Mktplace,5eecc6d6449e4f7cfb1c2708,2022-05-30T00:00:00.000Z,NEFT CR-DEUT0797BGL-MYNTRA DESIGNS PRIVA TE LIMITED-SLICK ORGANICS PVT. LTD.-2150 00483GN00011,shopping,,net_banking_transfer,11618.42
632af8182e1a0ebb7f4a7e11,50200023535069,291405.76,60ec41ba55c00300382672d9,HDFC,Revenue-PG-split enabled,5eecc6d6449e4f7cfb1c2708,2022-05-30T00:00:00.000Z,NEFT CR-UTIB0001506-RAZORPAY SOFTWARE PR IVATE LIMITED-SLICK ORGANICS PVT LITD-AX ISCN0142959816,insurance,insurance,net_banking_transfer,120273.5
632af8182e1a0ebb7f4a7e13,50200023535069,36405.76,60ec41ba55c00300382672d9,HDFC,SAAS/tech expense,5eecc6d6449e4f7cfb1c2708,2022-05-30T00:00:00.000Z,POS 514834XXXXXX9486 AMAZON,shopping,,debit_card,-255000
632af8182e1a0ebb7f4a7e15,50200023535069,31405.76,60ec41ba55c00300382672d9,HDFC,direct expenses,5eecc6d6449e4f7cfb1c2708,2022-05-30T00:00:00.000Z,"NEFT DR-ICIC0000021-AKHILESH DIXIT-NETBA NK, MUM-N150221976095971-5000",,,net_banking_transfer,-5000
632af8182e1a0ebb7f4a7e17,50200023535069,21405.76,60ec41ba55c00300382672d9,HDFC,Refund,5eecc6d6449e4f7cfb1c2708,2022-05-30T00:00:00.000Z,NEFT DR-YESB0CMSNOC-RAZORPAY REFUND CRED,,,net_banking_transfer,-10000
632af8182e1a0ebb7f4a7e19,50200023535069,1405.76,60ec41ba55c00300382672d9,HDFC,direct expenses,5eecc6d6449e4f7cfb1c2708,2022-05-30T00:00:00.000Z,SARVAN KUMAR - CHQ PAID - SAKET II,,,chq,-20000
632af8182e1a0ebb7f4a7e1b,50200023535069,11405.76,60ec41ba55c00300382672d9,HDFC,Revenue-PG-split enabled,5eecc6d6449e4f7cfb1c2708,2022-05-30T00:00:00.000Z,IMPS-215015446867-RAZORPAYSOFTWAREPR-UTI B-XXXXXXXXXXX6002-RAZORPAYREFUN150221976 168251,,,net_banking_transfer,10000
632af8182e1a0ebb7f4a7e1d,50200023535069,11679.92,60ec41ba55c00300382672d9,HDFC,Revenue-Mktplace,5eecc6d6449e4f7cfb1c2708,2022-05-30T00:00:00.000Z,NEFT CR-ICIC0000105-MANASH LIFESTYLE PRI VATE LIMITED NO-SLICK ORGANICS PRIVATE L IMITED MP G-ICIJ221500001520,shopping,,net_banking_transfer,274.16
632af8182e1a0ebb7f4a7e1f,50200023535069,12331.53,60ec41ba55c00300382672d9,HDFC,Revenue-Mktplace,5eecc6d6449e4f7cfb1c2708,2022-05-30T00:00:00.000Z,NEFT CR-ICIC0000105-MANASH LIFESTYLE PRI VATE LIMITED NO-SLICK ORGANICS PRIVATE L IMITED BANG-ICIJ221500001523,shopping,,net_banking_transfer,651.61
632af8182e1a0ebb7f4a7e21,50200023535069,13591.59,60ec41ba55c00300382672d9,HDFC,Revenue-Mktplace,5eecc6d6449e4f7cfb1c2708,2022-05-30T00:00:00.000Z,NEFT CR-ICIC0000105-MANASH LIFESTYLE PRI VATE LIMITED NO-SLICK ORGANICS PRIVATE L IMITED MP M-ICIJ221500001522,shopping,,net_banking_transfer,1260.06
632af8182e1a0ebb7f4a7e23,50200023535069,16682.43,60ec41ba55c00300382672d9,HDFC,Transfer in/Revenue-other,5eecc6d6449e4f7cfb1c2708,2022-05-30T00:00:00.000Z,NEFT CR-UTIB0000114-ONE SIGMA TECHNOLOGI ES PRIVATE LIM-SLICK ORGANICS PRIVATE LI MITED-AXISP00291327644,insurance,insurance,net_banking_transfer,3090.84
632af8182e1a0ebb7f4a7e25,50200023535069,18916.31,60ec41ba55c00300382672d9,HDFC,Transfer in/Revenue-other,5eecc6d6449e4f7cfb1c2708,2022-05-30T00:00:00.000Z,NEFT CR-UTIB0000114-ONE SIGMA TECHNOLOGI ES PRIVATE LIM-SLICK ORGANICS PRIVATE LI MITED-AXISP00291327832,insurance,insurance,net_banking_transfer,2233.88
632af8182e1a0ebb7f4a7e27,50200023535069,20542.14,60ec41ba55c00300382672d9,HDFC,Transfer in/Revenue-other,5eecc6d6449e4f7cfb1c2708,2022-05-30T00:00:00.000Z,NEFT CR-UTIB0000114-ONE SIGMA TECHNOLOGI ES PRIVATE LIM-SLICK ORGANICS PRIVATE LI MITED-AXISP00291327694,insurance,insurance,net_banking_transfer,1625.83
632af8182e1a0ebb7f4a7e2b,50200023535069,44603.41,60ec41ba55c00300382672d9,HDFC,Revenue-PG-split enabled,5eecc6d6449e4f7cfb1c2708,2022-05-30T00:00:00.000Z,NEFT CR-UTIB0001506-RAZORPAY SOFTWARE PR IVATE LIMITED-SLICK ORGANICS PVT LITD-AX ISCN0143213045,insurance,insurance,net_banking_transfer,24061.27
632af8182e1a0ebb7f4a7e2d,50200023535069,139060.09,60ec41ba55c00300382672d9,HDFC,Revenue-COD,5eecc6d6449e4f7cfb1c2708,2022-05-30T00:00:00.000Z,NEFT CR-ICIC0000155-SHIPROCKET COD CRF I D 4390470-SLICK ORGANICS PVT LTD-CMS2612 447885,insurance,insurance,net_banking_transfer,94456.68
632af8182e1a0ebb7f4a7e2f,50200023535069,234579.38,60ec41ba55c00300382672d9,HDFC,Revenue-UPI,5eecc6d6449e4f7cfb1c2708,2022-05-30T00:00:00.000Z,"UPI-GOKWIK-GOKWIK@YESBANK-YESB0000340-21 5079772070-PAYOUT FOR MAY 28,",,,upi,95519.29
632af8182e1a0ebb7f4a7e31,50200023535069,234400.38,60ec41ba55c00300382672d9,HDFC,SAAS/tech expense,5eecc6d6449e4f7cfb1c2708,2022-05-30T00:00:00.000Z,ME DC SI 514834XXXXXX9486 AMAZON,shopping,,Other,-179
632af8182e1a0ebb7f4a7e33,50200023535069,451199.56,60ec41ba55c00300382672d9,HDFC,Revenue-Mktplace,5eecc6d6449e4f7cfb1c2708,2022-05-31T00:00:00.000Z,IMPS-215105013443-AMAZON SELLER SERVIC-H SBC-XXXXXXXX6004-18IYOXR0WPBGXD45SLICK O RGANICS PVT LTD,shopping,,net_banking_transfer,216799.18
632af8182e1a0ebb7f4a7e35,50200023535069,469402.71,60ec41ba55c00300382672d9,HDFC,Revenue-PG-non-split,5eecc6d6449e4f7cfb1c2708,2022-05-31T00:00:00.000Z,IMPS-215106380300-PAYTM PAYMENTS SERVI-P YTM-XXXXXXXXXX0008-ALL202205312168200003 30830668628,ewallet,,net_banking_transfer,18203.15
632af8182e1a0ebb7f4a7e37,50200023535069,420802.71,60ec41ba55c00300382672d9,HDFC,direct expenses,5eecc6d6449e4f7cfb1c2708,2022-05-31T00:00:00.000Z,00321000085687-TPT-48600-SAMEER AHUJA,,,net_banking_transfer,-48600
632af8182e1a0ebb7f4a7e39,50200023535069,1100525.71,60ec41ba55c00300382672d9,HDFC,Revenue-Mktplace,5eecc6d6449e4f7cfb1c2708,2022-05-31T00:00:00.000Z,NEFT CR-DEUT0797BGL-AMAZON PAY (INDIA) P RIVATE LIMITED-SLICK ORGANICS PVT LTD-21 5100132GN00208,shopping,,net_banking_transfer,679723
632af8182e1a0ebb7f4a7e3c,50200023535069,1082633.71,60ec41ba55c00300382672d9,HDFC,direct expenses,5eecc6d6449e4f7cfb1c2708,2022-05-31T00:00:00.000Z,"NEFT DR-ICIC0001087-SARVIN PRINTERS PVT LTD-NETBANK, MUM-N151221977492120-17892",,,net_banking_transfer,-17892
632af8182e1a0ebb7f4a7e3e,50200023535069,1118457.03,60ec41ba55c00300382672d9,HDFC,Revenue-PG-split enabled,5eecc6d6449e4f7cfb1c2708,2022-05-31T00:00:00.000Z,NEFT CR-UTIB0001506-RAZORPAY SOFTWARE PR IVATE LIMITED-SLICK ORGANICS PVT LITD-AX ISCN0143370055,insurance,insurance,net_banking_transfer,35823.32
632af8182e1a0ebb7f4a7e40,50200023535069,918457.03,60ec41ba55c00300382672d9,HDFC,direct expenses,5eecc6d6449e4f7cfb1c2708,2022-05-31T00:00:00.000Z,"NEFT DR-YESB0000551-VISTTA COSMETICS-NET BANK, MUM-N151221977569401-200000",,,net_banking_transfer,-200000
632af8182e1a0ebb7f4a7e42,50200023535069,568457.03,60ec41ba55c00300382672d9,HDFC,direct expenses,5eecc6d6449e4f7cfb1c2708,2022-05-31T00:00:00.000Z,57500000443889-TPT-350000-WEBKLIPPER TEC HNOLOGIES PRIVATE LIMITED,,,net_banking_transfer,-350000
632af8182e1a0ebb7f4a7e44,50200023535069,468457.03,60ec41ba55c00300382672d9,HDFC,direct expenses,5eecc6d6449e4f7cfb1c2708,2022-05-31T00:00:00.000Z,"NEFT DR-INDB0000148-ACQUISORY INDIA CONS ULTING PVT LTD-NETBANK, MUM-N15122197760 9071-100000",,,net_banking_transfer,-100000
632af8192e1a0ebb7f4a7e46,50200023535069,459018.03,60ec41ba55c00300382672d9,HDFC,direct expenses,5eecc6d6449e4f7cfb1c2708,2022-05-31T00:00:00.000Z,50200026821910-TPT-9439-BITQIT PRIVATE L IMITED,,,net_banking_transfer,-9439
632af8192e1a0ebb7f4a7e48,50200023535069,448518.03,60ec41ba55c00300382672d9,HDFC,direct expenses,5eecc6d6449e4f7cfb1c2708,2022-05-31T00:00:00.000Z,POS 514834XXXXXX9486 PAYU GURGAON,,,debit_card,-10500
632af8192e1a0ebb7f4a7e4a,50200023535069,447128.03,60ec41ba55c00300382672d9,HDFC,direct expenses,5eecc6d6449e4f7cfb1c2708,2022-05-31T00:00:00.000Z,"NEFT DR-SBIN0000478-RICHA SHRIVASTAVA-NE TBANK, MUM-N151221977875567-1390",,,net_banking_transfer,-1390
632af8192e1a0ebb7f4a7e4c,50200023535069,437128.03,60ec41ba55c00300382672d9,HDFC,Refund,5eecc6d6449e4f7cfb1c2708,2022-05-31T00:00:00.000Z,"NEFT DR-RATN0VAAPIS-RAZORPAY REFUND CRED ITS TOPUP-NETBANK, MUM-N151221977882351- 10000",,,net_banking_transfer,-10000
632af8192e1a0ebb7f4a7e4f,50200023535069,432548.03,60ec41ba55c00300382672d9,HDFC,direct expenses,5eecc6d6449e4f7cfb1c2708,2022-05-31T00:00:00.000Z,NEFT DR-SIBL0000555-JAIVEER KUMAR-NETBAN,,,net_banking_transfer,-4580
632af8192e1a0ebb7f4a7e51,50200023535069,432855.16,60ec41ba55c00300382672d9,HDFC,Revenue-Mktplace,5eecc6d6449e4f7cfb1c2708,2022-05-31T00:00:00.000Z,NEFT CR-ICIC0000105-MANASH LIFESTYLE PRI VATE LIMITED NO-SLICK ORGANICS PRIVATE L IMITED MP G-ICIJ221510007119,shopping,,net_banking_transfer,307.13
632af8192e1a0ebb7f4a7e53,50200023535069,433444.5,60ec41ba55c00300382672d9,HDFC,Revenue-Mktplace,5eecc6d6449e4f7cfb1c2708,2022-05-31T00:00:00.000Z,NEFT CR-ICIC0000105-MANASH LIFESTYLE PRI VATE LIMITED NO-SLICK ORGANICS PRIVATE L IMITED MP M-ICIJ221510007121,shopping,,net_banking_transfer,589.34
632af8192e1a0ebb7f4a7e55,50200023535069,458392.21,60ec41ba55c00300382672d9,HDFC,Revenue-PG-split enabled,5eecc6d6449e4f7cfb1c2708,2022-05-31T00:00:00.000Z,NEFT CR-UTIB0001506-RAZORPAY SOFTWARE PR IVATE LIMITED-SLICK ORGANICS PVT LITD-AX ISCN0143694952,insurance,insurance,net_banking_transfer,24947.71
632af8192e1a0ebb7f4a7e58,50200023535069,574147.43,60ec41ba55c00300382672d9,HDFC,Revenue-UPI,5eecc6d6449e4f7cfb1c2708,2022-05-31T00:00:00.000Z,UPI-GOKWIK-GOKWIK@YESBANK-YESB0000340-21,,,upi,115755.22
633d58682e1a0ebb7f199301,50200050976833,11081.63,60ec41a455c0030038267236,HDFC,Revenue-PG-non-split,5eecc6d6449e4f7cfb1c2708,2022-09-19T00:00:00.000Z,NEFT CR-CITI0100000-PAYPAL PAYMENTS PL-O,,,net_banking_transfer,3100.53
633d58d02e1a0ebb7f19e1aa,50200035187206,10000001,60ec419255c00300382671a5,HDFC,interest income,5eecc6d6449e4f7cfb1c2708,2022-09-23T00:00:00.000Z,QUARTERLY INTEREST CREDIT 50300462137427,,,Other,1
633d58d02e1a0ebb7f19e1ac,50200035187206,9000001,60ec419255c00300382671a5,HDFC,Internal Transfers,5eecc6d6449e4f7cfb1c2708,2022-09-28T00:00:00.000Z,IB FUNDS TRANSFER DR-50200023535069 -SL ICK ORGANICS PVT LTD,,,net_banking_transfer,-1000000
633d58d02e1a0ebb7f19e1ae,50200035187206,200001,60ec419255c00300382671a5,HDFC,Internal Transfers,5eecc6d6449e4f7cfb1c2708,2022-09-28T00:00:00.000Z,IB FUNDS TRANSFER DR-50200023535069 -SL ICK ORGANICS PVT LTD,,,net_banking_transfer,-8800000
633d58d02e1a0ebb7f19e1b0,50200035187206,50001,60ec419255c00300382671a5,HDFC,Internal Transfers,5eecc6d6449e4f7cfb1c2708,2022-09-28T00:00:00.000Z,IB FUNDS TRANSFER DR-50200023535069 -SL,,,net_banking_transfer,-150000
633d598a2e1a0ebb7f1a5f5a,50200023535069,296408.52,60ec41ba55c00300382672d9,HDFC,Revenue-Mktplace,5eecc6d6449e4f7cfb1c2708,2022-09-16T00:00:00.000Z,NEFT CR-DEUT0797BGL-FLIPKART INTERNET PR IVATE LIMITED-SLICK ORGANICS PVT LTD-225 900111GN00193,shopping,,net_banking_transfer,296389.26
633d598a2e1a0ebb7f1a5f5c,50200023535069,331130.65,60ec41ba55c00300382672d9,HDFC,Revenue-PG-non-split,5eecc6d6449e4f7cfb1c2708,2022-09-16T00:00:00.000Z,NEFT CR-PYTM0123456-PAYTM PAYMENTS SERVI CES LIMITED-SLICK ORGANICS PVT LTD-PYTM2 22591787650,insurance,insurance,net_banking_transfer,34722.13
633d598a2e1a0ebb7f1a5f5f,50200023535069,62222.13,60ec41ba55c00300382672d9,HDFC,direct expenses,5eecc6d6449e4f7cfb1c2708,2022-09-16T00:00:00.000Z,POS 514834XXXXXX9486 SHOPIFY* 1518970,,,debit_card,-268908.52
633d598a2e1a0ebb7f1a5f61,50200023535069,68377.68,60ec41ba55c00300382672d9,HDFC,Revenue-Mktplace,5eecc6d6449e4f7cfb1c2708,2022-09-16T00:00:00.000Z,NEFT CR-DEUT0797BGL-MYNTRA DESIGNS PRIVA TE LIMITED-SLICK ORGANICS PVT. LTD.-2259 00655GN00284,shopping,,net_banking_transfer,6155.55
633d598a2e1a0ebb7f1a5f64,50200023535069,75640.84,60ec41ba55c00300382672d9,HDFC,Revenue-Mktplace,5eecc6d6449e4f7cfb1c2708,2022-09-16T00:00:00.000Z,NEFT CR-DEUT0797BGL-MYNTRA DESIGNS PRIVA TE LIMITED-SLICK ORGANICS PVT. LTD.-2259 00659GN00012,shopping,,net_banking_transfer,7263.16
633d598a2e1a0ebb7f1a5f66,50200023535069,103542,60ec41ba55c00300382672d9,HDFC,Revenue-PG-split enabled,5eecc6d6449e4f7cfb1c2708,2022-09-16T00:00:00.000Z,NEFT CR-UTIB0001506-RAZORPAY SOFTWARE PR IVATE LIMITED-SLICK ORGANICS PVT LITD-AX ISCN0166116734,insurance,insurance,net_banking_transfer,27901.16
633d598a2e1a0ebb7f1a5f68,50200023535069,78542,60ec41ba55c00300382672d9,HDFC,direct expenses,5eecc6d6449e4f7cfb1c2708,2022-09-16T00:00:00.000Z,POS 514834XXXXXX9486 FLIPKART,shopping,,debit_card,-25000
633d598a2e1a0ebb7f1a5f6b,50200023535069,-1852050,60ec41ba55c00300382672d9,HDFC,Marketing Expense,5eecc6d6449e4f7cfb1c2708,2022-09-16T00:00:00.000Z,NEFT DR-CITI0000006-FACEBOOK INDIA ONLIN,,,net_banking_transfer,-1930592
633d598a2e1a0ebb7f1a5f6e,50200023535069,-1862050,60ec41ba55c00300382672d9,HDFC,Refund,5eecc6d6449e4f7cfb1c2708,2022-09-16T00:00:00.000Z,"NEFT DR-RATN0VAAPIS-RAZORPAY REFUND CRED ITS TOPUP-NETBANK, MUM-N259222122800394- 10000",,,net_banking_transfer,-10000
633d598a2e1a0ebb7f1a5f71,50200023535069,-1912050,60ec41ba55c00300382672d9,HDFC,direct expenses,5eecc6d6449e4f7cfb1c2708,2022-09-16T00:00:00.000Z,"NEFT DR-KKBK0000173-MATRIX PRINTING SOLU TIONS PRIVATE LIMITE-NETBANK, MUM-N25922 2122793100-50000",,,net_banking_transfer,-50000
633d598a2e1a0ebb7f1a5f73,50200023535069,-1914365.8,60ec41ba55c00300382672d9,HDFC,direct expenses,5eecc6d6449e4f7cfb1c2708,2022-09-16T00:00:00.000Z,POS 514834XXXXXX9486 SEOPTIMER,,,debit_card,-2315.8
633d598a2e1a0ebb7f1a5f76,50200023535069,-1882820.8,60ec41ba55c00300382672d9,HDFC,Transfer in/Revenue-other,5eecc6d6449e4f7cfb1c2708,2022-09-16T00:00:00.000Z,NEFT CR-KKBK0000958-OCTAVOS ENTERPRISE S OLUTIONS PVT-SLICK ORGANICS PVT LTD-CMS2 592226115505,insurance,insurance,net_banking_transfer,31545
633d598a2e1a0ebb7f1a5f78,50200023535069,-1880645.96,60ec41ba55c00300382672d9,HDFC,Revenue-Mktplace,5eecc6d6449e4f7cfb1c2708,2022-09-16T00:00:00.000Z,NEFT CR-ICIC0000105-MANASH LIFESTYLE PRI VATE LIMITED NO-SLICK ORGANICS PRIVATE L IMITED MP G-ICIJ222590002838,shopping,,net_banking_transfer,2174.84
633d598a2e1a0ebb7f1a5f7b,50200023535069,-1879603.64,60ec41ba55c00300382672d9,HDFC,Revenue-Mktplace,5eecc6d6449e4f7cfb1c2708,2022-09-16T00:00:00.000Z,NEFT CR-ICIC0000105-MANASH LIFESTYLE PRI VATE LIMITED NO-SLICK ORGANICS PRIVATE L IMITED MP M-ICIJ222590004451,shopping,,net_banking_transfer,1042.32
633d598a2e1a0ebb7f1a5f7e,50200023535069,-1876950.42,60ec41ba55c00300382672d9,HDFC,Transfer in/Revenue-other,5eecc6d6449e4f7cfb1c2708,2022-09-16T00:00:00.000Z,NEFT CR-UTIB0000114-ONE SIGMA TECHNOLOGI ES PRIVATE LIM-SLICK ORGANICS PRIVATE LI MITED-AXISP00320612681,insurance,insurance,net_banking_transfer,2653.22
633d598a2e1a0ebb7f1a5f80,50200023535069,-1771329.02,60ec41ba55c00300382672d9,HDFC,Revenue-PG-non-split,5eecc6d6449e4f7cfb1c2708,2022-09-16T00:00:00.000Z,NEFT CR-KKBK0000958-NODAL ACCOUNT BROKEN TUSK TECHNOL-SLICK ORGANICS PRIVATE LIMI TED-CMS2592226126070,insurance,insurance,net_banking_transfer,105621.4
633d598a2e1a0ebb7f1a5f83,50200023535069,-1748509.8,60ec41ba55c00300382672d9,HDFC,Revenue-PG-split enabled,5eecc6d6449e4f7cfb1c2708,2022-09-16T00:00:00.000Z,NEFT CR-UTIB0001506-RAZORPAY SOFTWARE PR IVATE LIMITED-SLICK ORGANICS PVT LITD-AX ISCN0166256793,insurance,insurance,net_banking_transfer,22819.22
633d598a2e1a0ebb7f1a5f85,50200023535069,-1741249.23,60ec41ba55c00300382672d9,HDFC,Revenue-COD,5eecc6d6449e4f7cfb1c2708,2022-09-16T00:00:00.000Z,NEFT CR-ICIC0000155-SHIPROCKET COD CRF I D 4906448-SLICK ORGANICS PVT LTD-CMS2836 634922,insurance,insurance,net_banking_transfer,7260.57
633d598a2e1a0ebb7f1a5f88,50200023535069,-1741248.23,60ec41ba55c00300382672d9,HDFC,Transfer in/Revenue-other,5eecc6d6449e4f7cfb1c2708,2022-09-17T00:00:00.000Z,INT. ON SWCR ON-50300675642152,,,Other,1
633d598a2e1a0ebb7f1a5f8a,50200023535069,-1738932.23,60ec41ba55c00300382672d9,HDFC,Loan-in,5eecc6d6449e4f7cfb1c2708,2022-09-17T00:00:00.000Z,SWEEP-IN CREDIT - 50300675642152,,,self_transfer,2316
633d598a2e1a0ebb7f1a5f8c,50200023535069,-1738098.23,60ec41ba55c00300382672d9,HDFC,Transfer in/Revenue-other,5eecc6d6449e4f7cfb1c2708,2022-09-17T00:00:00.000Z,INT. ON SWCR ON-50300675642152,,,Other,834
633d598a2e1a0ebb7f1a5f8f,50200023535069,834.77,60ec41ba55c00300382672d9,HDFC,Loan-in,5eecc6d6449e4f7cfb1c2708,2022-09-17T00:00:00.000Z,SWEEP-IN CREDIT - 50300675642152,,,self_transfer,1738933
633d598a2e1a0ebb7f1a5f91,50200023535069,4275.47,60ec41ba55c00300382672d9,HDFC,Revenue-PG-non-split,5eecc6d6449e4f7cfb1c2708,2022-09-17T00:00:00.000Z,NEFT CR-PYTM0123456-PAYTM PAYMENTS SERVI CES LIMITED-SLICK ORGANICS PVT LTD-PYTM2 22603147771,insurance,insurance,net_banking_transfer,3440.7
633d598a2e1a0ebb7f1a5f93,50200023535069,15774.61,60ec41ba55c00300382672d9,HDFC,Revenue-PG-split enabled,5eecc6d6449e4f7cfb1c2708,2022-09-17T00:00:00.000Z,NEFT CR-UTIB0001506-RAZORPAY SOFTWARE PR IVATE LIMITED-SLICK ORGANICS PVT LITD-AX ISCN0166317313,insurance,insurance,net_banking_transfer,11499.14
633d598a2e1a0ebb7f1a5f96,50200023535069,15693.61,60ec41ba55c00300382672d9,HDFC,direct expenses,5eecc6d6449e4f7cfb1c2708,2022-09-17T00:00:00.000Z,POS 514834XXXXXX9486 SMARTSHIFT LOGIS,,,debit_card,-81
633d598a2e1a0ebb7f1a5f98,50200023535069,-84306.39,60ec41ba55c00300382672d9,HDFC,direct expenses,5eecc6d6449e4f7cfb1c2708,2022-09-17T00:00:00.000Z,"NEFT DR-UBIN0820296-HITESH ARORA-NETBANK , MUM-N260222124230056-100000",,,net_banking_transfer,-100000
633d598a2e1a0ebb7f1a5f9a,50200023535069,-99897.39,60ec41ba55c00300382672d9,HDFC,Tax,5eecc6d6449e4f7cfb1c2708,2022-09-17T00:00:00.000Z,GST/BANK REFERENCE NO: R2226037494113/CI N NO: HDFC22090700103034,,,Other,-15591
633d598a2e1a0ebb7f1a5f9e,50200023535069,-199897.39,60ec41ba55c00300382672d9,HDFC,direct expenses,5eecc6d6449e4f7cfb1c2708,2022-09-17T00:00:00.000Z,00918630000430-TPT-100000-UNICOMMERCE ES OLUTIONS PRIVATE LIMITED,,,net_banking_transfer,-100000
633d598a2e1a0ebb7f1a5fa0,50200023535069,-549897.39,60ec41ba55c00300382672d9,HDFC,direct expenses,5eecc6d6449e4f7cfb1c2708,2022-09-17T00:00:00.000Z,57500000443889-TPT-350000-WEBKLIPPER TEC HNOLOGIES PRIVATE LIMITED,,,net_banking_transfer,-350000
633d598a2e1a0ebb7f1a5fa2,50200023535069,-549969.39,60ec41ba55c00300382672d9,HDFC,direct expenses,5eecc6d6449e4f7cfb1c2708,2022-09-17T00:00:00.000Z,POS 514834XXXXXX9486 SMARTSHIFT LOGIS,,,debit_card,-72
633d598a2e1a0ebb7f1a5fa5,50200023535069,-480048.17,60ec41ba55c00300382672d9,HDFC,Revenue-PG-non-split,5eecc6d6449e4f7cfb1c2708,2022-09-17T00:00:00.000Z,NEFT CR-KKBK0000958-NODAL ACCOUNT BROKEN TUSK TECHNOL-SLICK ORGANICS PRIVATE LIMI TED-CMS2602226220328,insurance,insurance,net_banking_transfer,69921.22
633d598a2e1a0ebb7f1a5fa7,50200023535069,-469272.96,60ec41ba55c00300382672d9,HDFC,Revenue-PG-split enabled,5eecc6d6449e4f7cfb1c2708,2022-09-17T00:00:00.000Z,NEFT CR-UTIB0001506-RAZORPAY SOFTWARE PR IVATE LIMITED-SLICK ORGANICS PVT LITD-AX ISCN0166420472,insurance,insurance,net_banking_transfer,10775.21
633d598a2e1a0ebb7f1a5fa9,50200023535069,-469270.96,60ec41ba55c00300382672d9,HDFC,Transfer in/Revenue-other,5eecc6d6449e4f7cfb1c2708,2022-09-17T00:00:00.000Z,CRV POS 514834******9486 LINKEDIN,,,refund,2
633d598a2e1a0ebb7f1a5fac,50200023535069,-469198.96,60ec41ba55c00300382672d9,HDFC,Loan-in,5eecc6d6449e4f7cfb1c2708,2022-09-18T00:00:00.000Z,SWEEP-IN CREDIT - 50300675642152,,,self_transfer,72
633d598a2e1a0ebb7f1a5fae,50200023535069,-469154.96,60ec41ba55c00300382672d9,HDFC,Transfer in/Revenue-other,5eecc6d6449e4f7cfb1c2708,2022-09-18T00:00:00.000Z,INT. ON SWCR ON-50300675642152,,,Other,44
633d598a2e1a0ebb7f1a5fb0,50200023535069,-384847.96,60ec41ba55c00300382672d9,HDFC,Loan-in,5eecc6d6449e4f7cfb1c2708,2022-09-18T00:00:00.000Z,SWEEP-IN CREDIT - 50300675642152,,,self_transfer,84307
633d598a2e1a0ebb7f1a5fb3,50200023535069,-384839.96,60ec41ba55c00300382672d9,HDFC,Transfer in/Revenue-other,5eecc6d6449e4f7cfb1c2708,2022-09-18T00:00:00.000Z,INT. ON SWCR ON-50300675642152,,,Other,8
633d598b2e1a0ebb7f1a5fb5,50200023535069,-369248.96,60ec41ba55c00300382672d9,HDFC,Loan-in,5eecc6d6449e4f7cfb1c2708,2022-09-18T00:00:00.000Z,SWEEP-IN CREDIT - 50300675642152,,,self_transfer,15591
633d598b2e1a0ebb7f1a5fb7,50200023535069,-369195.96,60ec41ba55c00300382672d9,HDFC,Transfer in/Revenue-other,5eecc6d6449e4f7cfb1c2708,2022-09-18T00:00:00.000Z,INT. ON SWCR ON-50300675642152,,,Other,53
633d598b2e1a0ebb7f1a5fba,50200023535069,-269195.96,60ec41ba55c00300382672d9,HDFC,Loan-in,5eecc6d6449e4f7cfb1c2708,2022-09-18T00:00:00.000Z,SWEEP-IN CREDIT - 50300675642152,,,self_transfer,100000
633d598b2e1a0ebb7f1a5fbc,50200023535069,-269053.96,60ec41ba55c00300382672d9,HDFC,Transfer in/Revenue-other,5eecc6d6449e4f7cfb1c2708,2022-09-18T00:00:00.000Z,INT. ON SWCR ON-50300675642152,,,Other,142
633d598b2e1a0ebb7f1a5fbe,50200023535069,142.04,60ec41ba55c00300382672d9,HDFC,Loan-in,5eecc6d6449e4f7cfb1c2708,2022-09-18T00:00:00.000Z,SWEEP-IN CREDIT - 50300675642152,,,self_transfer,269196
633d598b2e1a0ebb7f1a5fc2,50200023535069,21629.5,60ec41ba55c00300382672d9,HDFC,Revenue-PG-non-split,5eecc6d6449e4f7cfb1c2708,2022-09-18T00:00:00.000Z,NEFT CR-PYTM0123456-PAYTM PAYMENTS SERVI CES LIMITED-SLICK ORGANICS PVT LTD-PYTM2 22614938382,insurance,insurance,net_banking_transfer,21487.46
633d598b2e1a0ebb7f1a5fc4,50200023535069,75020.34,60ec41ba55c00300382672d9,HDFC,Revenue-Mktplace,5eecc6d6449e4f7cfb1c2708,2022-09-19T00:00:00.000Z,NEFT CR-DEUT0797BGL-FLIPKART INTERNET PR IVATE LIMITED-SLICK ORGANICS PVT LTD-226 200154GN00032,shopping,,net_banking_transfer,53390.84
633d598b2e1a0ebb7f1a5fc6,50200023535069,90594.38,60ec41ba55c00300382672d9,HDFC,Revenue-PG-non-split,5eecc6d6449e4f7cfb1c2708,2022-09-19T00:00:00.000Z,NEFT CR-PYTM0123456-PAYTM PAYMENTS SERVI CES LIMITED-SLICK ORGANICS PVT LTD-PYTM2 22626764035,insurance,insurance,net_banking_transfer,15574.04
633d598b2e1a0ebb7f1a5fc9,50200023535069,66824.38,60ec41ba55c00300382672d9,HDFC,direct expenses,5eecc6d6449e4f7cfb1c2708,2022-09-19T00:00:00.000Z,"NEFT DR-KKBK0000173-NITISH KUMAR MANDAL- NETBANK, MUM-N262222125120610-23770",,,net_banking_transfer,-23770
633d598b2e1a0ebb7f1a5fcb,50200023535069,73993.05,60ec41ba55c00300382672d9,HDFC,Revenue-Mktplace,5eecc6d6449e4f7cfb1c2708,2022-09-19T00:00:00.000Z,NEFT CR-DEUT0797BGL-MYNTRA DESIGNS PRIVA TE LIMITED-SLICK ORGANICS PVT. LTD.-2262 00565GN00254,shopping,,net_banking_transfer,7168.67
633d598b2e1a0ebb7f1a5fcd,50200023535069,91291.61,60ec41ba55c00300382672d9,HDFC,Revenue-Mktplace,5eecc6d6449e4f7cfb1c2708,2022-09-19T00:00:00.000Z,NEFT CR-DEUT0797BGL-MYNTRA DESIGNS PRIVA TE LIMITED-SLICK ORGANICS PVT. LTD.-2262 00574GN00073,shopping,,net_banking_transfer,17298.56
633d598b2e1a0ebb7f1a5fd0,50200023535069,116475.28,60ec41ba55c00300382672d9,HDFC,Revenue-PG-split enabled,5eecc6d6449e4f7cfb1c2708,2022-09-19T00:00:00.000Z,NEFT CR-UTIB0001506-RAZORPAY SOFTWARE PR IVATE LIMITED-SLICK ORGANICS PVT LITD-AX ISCN0166518997,insurance,insurance,net_banking_transfer,25183.67
633d598b2e1a0ebb7f1a5fd2,50200023535069,-141374.72,60ec41ba55c00300382672d9,HDFC,direct expenses,5eecc6d6449e4f7cfb1c2708,2022-09-19T00:00:00.000Z,"NEFT DR-KKBK0004581-MJ GLOBAL PVT LTD-NE TBANK, MUM-N262222125233485-257850",,,net_banking_transfer,-257850
633d598b2e1a0ebb7f1a5fd4,50200023535069,-155090.38,60ec41ba55c00300382672d9,HDFC,direct expenses,5eecc6d6449e4f7cfb1c2708,2022-09-19T00:00:00.000Z,POS 514834XXXXXX9486 PYU*GS1 INDIA,,,debit_card,-13715.66
633d598b2e1a0ebb7f1a5fd7,50200023535069,-175811.38,60ec41ba55c00300382672d9,HDFC,direct expenses,5eecc6d6449e4f7cfb1c2708,2022-09-19T00:00:00.000Z,"NEFT DR-SBIN0001859-PARSHOTAM AND ASSOCI ATES-NETBANK, MUM-N262222125348249-20721",,,net_banking_transfer,-20721
633d598b2e1a0ebb7f1a5fd9,50200023535069,-186663.53,60ec41ba55c00300382672d9,HDFC,Marketing Expense,5eecc6d6449e4f7cfb1c2708,2022-09-19T00:00:00.000Z,POS 514834XXXXXX9486 GOOGLEWORKSP,,,debit_card,-10852.15
633d598b2e1a0ebb7f1a5fdc,50200023535069,-185048,60ec41ba55c00300382672d9,HDFC,Revenue-Mktplace,5eecc6d6449e4f7cfb1c2708,2022-09-19T00:00:00.000Z,NEFT CR-ICIC0000105-MANASH LIFESTYLE PRI VATE LIMITED NO-SLICK ORGANICS PRIVATE L IMITED MP M-ICIJ222620004619,shopping,,net_banking_transfer,1615.53
633d598b2e1a0ebb7f1a5fde,50200023535069,-183500.61,60ec41ba55c00300382672d9,HDFC,Revenue-Mktplace,5eecc6d6449e4f7cfb1c2708,2022-09-19T00:00:00.000Z,NEFT CR-ICIC0000105-MANASH LIFESTYLE PRI,shopping,,net_banking_transfer,1547.39
633d598b2e1a0ebb7f1a5fe0,50200023535069,-185044.61,60ec41ba55c00300382672d9,HDFC,direct expenses,5eecc6d6449e4f7cfb1c2708,2022-09-19T00:00:00.000Z,POS 514834XXXXXX9486 SMARTSHIFT LOGIS,,,debit_card,-1544
633d598b2e1a0ebb7f1a5fe3,50200023535069,-185486.61,60ec41ba55c00300382672d9,HDFC,direct expenses,5eecc6d6449e4f7cfb1c2708,2022-09-19T00:00:00.000Z,POS 514834XXXXXX9486 SMARTSHIFT LOGIS,,,debit_card,-442
633d598b2e1a0ebb7f1a5fe5,50200023535069,-183765.83,60ec41ba55c00300382672d9,HDFC,Transfer in/Revenue-other,5eecc6d6449e4f7cfb1c2708,2022-09-19T00:00:00.000Z,NEFT CR-UTIB0000114-ONE SIGMA TECHNOLOGI ES PRIVATE LIM-SLICK ORGANICS PRIVATE LI MITED-AXISP00320992185,insurance,insurance,net_banking_transfer,1720.78
633d598b2e1a0ebb7f1a5fe7,50200023535069,-182234.41,60ec41ba55c00300382672d9,HDFC,Transfer in/Revenue-other,5eecc6d6449e4f7cfb1c2708,2022-09-19T00:00:00.000Z,NEFT CR-UTIB0000114-ONE SIGMA TECHNOLOGI ES PRIVATE LIM-SLICK ORGANICS PRIVATE LI MITED-AXISP00320992042,insurance,insurance,net_banking_transfer,1531.42
633d598b2e1a0ebb7f1a5fea,50200023535069,-202234.41,60ec41ba55c00300382672d9,HDFC,direct expenses,5eecc6d6449e4f7cfb1c2708,2022-09-19T00:00:00.000Z,50200039508087-TPT-20000-SHREE PUNCHMUKH I LOGISTICS,,,net_banking_transfer,-20000
633d598b2e1a0ebb7f1a5fec,50200023535069,-247594.41,60ec41ba55c00300382672d9,HDFC,direct expenses,5eecc6d6449e4f7cfb1c2708,2022-09-19T00:00:00.000Z,"NEFT DR-KKBK0001393-MASCOT SPINCONTROL I NDIA PVT LTD-NETBANK, MUM-N2622221256401 68-45360",,,net_banking_transfer,-45360
633d598b2e1a0ebb7f1a5fef,50200023535069,-219830.47,60ec41ba55c00300382672d9,HDFC,Revenue-COD,5eecc6d6449e4f7cfb1c2708,2022-09-19T00:00:00.000Z,NEFT CR-ICIC0000155-SHIPROCKET COD CRF I D 4914685-SLICK ORGANICS PVT LTD-CMS2841 156316,insurance,insurance,net_banking_transfer,27763.94
633d598b2e1a0ebb7f1a5ff1,50200023535069,-206115.31,60ec41ba55c00300382672d9,HDFC,Revenue-PG-split enabled,5eecc6d6449e4f7cfb1c2708,2022-09-19T00:00:00.000Z,NEFT CR-UTIB0001506-RAZORPAY SOFTWARE PR IVATE LIMITED-SLICK ORGANICS PVT LITD-AX ISCN0166655813,insurance,insurance,net_banking_transfer,13715.16
633d598b2e1a0ebb7f1a5ff3,50200023535069,-206113.31,60ec41ba55c00300382672d9,HDFC,Transfer in/Revenue-other,5eecc6d6449e4f7cfb1c2708,2022-09-19T00:00:00.000Z,CRV POS 514834******9486 LINKEDIN,,,refund,2
633d598b2e1a0ebb7f1a5ff6,50200023535069,-206104.31,60ec41ba55c00300382672d9,HDFC,Transfer in/Revenue-other,5eecc6d6449e4f7cfb1c2708,2022-09-20T00:00:00.000Z,INT. ON SWCR ON-50300675642152,,,Other,9
633d598b2e1a0ebb7f1a5ff8,50200023535069,-192388.31,60ec41ba55c00300382672d9,HDFC,Loan-in,5eecc6d6449e4f7cfb1c2708,2022-09-20T00:00:00.000Z,SWEEP-IN CREDIT - 50300675642152,,,self_transfer,13716
633d598b2e1a0ebb7f1a5ffa,50200023535069,-192381.31,60ec41ba55c00300382672d9,HDFC,Transfer in/Revenue-other,5eecc6d6449e4f7cfb1c2708,2022-09-20T00:00:00.000Z,INT. ON SWCR ON-50300675642152,,,Other,7
633d598b2e1a0ebb7f1a5ffd,50200023535069,-181528.31,60ec41ba55c00300382672d9,HDFC,Loan-in,5eecc6d6449e4f7cfb1c2708,2022-09-20T00:00:00.000Z,SWEEP-IN CREDIT - 50300675642152,,,self_transfer,10853
633d598b2e1a0ebb7f1a5fff,50200023535069,-181440.31,60ec41ba55c00300382672d9,HDFC,Transfer in/Revenue-other,5eecc6d6449e4f7cfb1c2708,2022-09-20T00:00:00.000Z,INT. ON SWCR ON-50300675642152,,,Other,88
633d598b2e1a0ebb7f1a6001,50200023535069,-40065.31,60ec41ba55c00300382672d9,HDFC,Loan-in,5eecc6d6449e4f7cfb1c2708,2022-09-20T00:00:00.000Z,SWEEP-IN CREDIT - 50300675642152,,,self_transfer,141375
633d598b2e1a0ebb7f1a6004,50200023535069,-40052.31,60ec41ba55c00300382672d9,HDFC,Transfer in/Revenue-other,5eecc6d6449e4f7cfb1c2708,2022-09-20T00:00:00.000Z,INT. ON SWCR ON-50300675642152,,,Other,13
633d598b2e1a0ebb7f1a6006,50200023535069,-19331.31,60ec41ba55c00300382672d9,HDFC,Loan-in,5eecc6d6449e4f7cfb1c2708,2022-09-20T00:00:00.000Z,SWEEP-IN CREDIT - 50300675642152,,,self_transfer,20721
633d598b2e1a0ebb7f1a6009,50200023535069,-19321.31,60ec41ba55c00300382672d9,HDFC,Transfer in/Revenue-other,5eecc6d6449e4f7cfb1c2708,2022-09-20T00:00:00.000Z,INT. ON SWCR ON-50300675642152,,,Other,10
633d598b2e1a0ebb7f1a600c,50200023535069,-3750.31,60ec41ba55c00300382672d9,HDFC,Loan-in,5eecc6d6449e4f7cfb1c2708,2022-09-20T00:00:00.000Z,SWEEP-IN CREDIT - 50300675642152,,,self_transfer,15571
633d598b2e1a0ebb7f1a600e,50200023535069,-3748.31,60ec41ba55c00300382672d9,HDFC,Transfer in/Revenue-other,5eecc6d6449e4f7cfb1c2708,2022-09-20T00:00:00.000Z,INT. ON SWCR ON-50300675642152,,,Other,2
633d598b2e1a0ebb7f1a6011,50200023535069,2.69,60ec41ba55c00300382672d9,HDFC,Loan-in,5eecc6d6449e4f7cfb1c2708,2022-09-20T00:00:00.000Z,SWEEP-IN CREDIT - 50300675642152,,,self_transfer,3751
633d598b2e1a0ebb7f1a6014,50200023535069,158559.12,60ec41ba55c00300382672d9,HDFC,Revenue-Mktplace,5eecc6d6449e4f7cfb1c2708,2022-09-20T00:00:00.000Z,IMPS-226305038551-AMAZON SELLER SERVIC-H SBC-XXXXXXXX6004-4RWS3HREXLL94RTWSLICK O RGANICS PVT LTD,shopping,,net_banking_transfer,158556.43
633d598b2e1a0ebb7f1a6016,50200023535069,255031.84,60ec41ba55c00300382672d9,HDFC,Revenue-Mktplace,5eecc6d6449e4f7cfb1c2708,2022-09-20T00:00:00.000Z,NEFT CR-DEUT0797BGL-AMAZON PAY (INDIA) P RIVATE LIMITED-SLICK ORGANICS PVT LTD-22 6300112GN00395,shopping,,net_banking_transfer,96472.72
633d598b2e1a0ebb7f1a6019,50200023535069,264979.83,60ec41ba55c00300382672d9,HDFC,Revenue-PG-non-split,5eecc6d6449e4f7cfb1c2708,2022-09-20T00:00:00.000Z,NEFT CR-PYTM0123456-PAYTM PAYMENTS SERVI CES LIMITED-SLICK ORGANICS PVT LTD-PYTM2 22638177254,insurance,insurance,net_banking_transfer,9947.99
633d598b2e1a0ebb7f1a601b,50200023535069,-235020.17,60ec41ba55c00300382672d9,HDFC,direct expenses,5eecc6d6449e4f7cfb1c2708,2022-09-20T00:00:00.000Z,05892560000649-TPT-500000-DECORPAC INDIA PRIVATE LIMITED,,,net_banking_transfer,-500000
633d598b2e1a0ebb7f1a601e,50200023535069,-735020.17,60ec41ba55c00300382672d9,HDFC,direct expenses,5eecc6d6449e4f7cfb1c2708,2022-09-20T00:00:00.000Z,"NEFT DR-ICIC0000369-BO INTERNATIONAL-NET BANK, MUM-N263222126431889-50000",,,net_banking_transfer,-500000
633d598b2e1a0ebb7f1a6021,50200023535069,-724458.7,60ec41ba55c00300382672d9,HDFC,Revenue-PG-split enabled,5eecc6d6449e4f7cfb1c2708,2022-09-20T00:00:00.000Z,NEFT CR-UTIB0001506-RAZORPAY SOFTWARE PR IVATE LIMITED-SLICK ORGANICS PVT LITD-AX ISCN0166737628,insurance,insurance,net_banking_transfer,10561.47
633d598b2e1a0ebb7f1a6023,50200023535069,-773058.7,60ec41ba55c00300382672d9,HDFC,direct expenses,5eecc6d6449e4f7cfb1c2708,2022-09-20T00:00:00.000Z,"NEFT DR-CNRB0015170-SNEHAL TAYDE-NETBANK , MUM-N263222126528615-48600",,,net_banking_transfer,-48600
633d598b2e1a0ebb7f1a6026,50200023535069,-783557.7,60ec41ba55c00300382672d9,HDFC,SAAS/tech expense,5eecc6d6449e4f7cfb1c2708,2022-09-20T00:00:00.000Z,POS 514834XXXXXX9486 AMAZON,shopping,,debit_card,-10499
633d598b2e1a0ebb7f1a6028,50200023535069,-793557.7,60ec41ba55c00300382672d9,HDFC,direct expenses,5eecc6d6449e4f7cfb1c2708,2022-09-20T00:00:00.000Z,"NEFT DR-UBIN0531944-URVI SHAH-NETBANK, M UM-N263222126678429-10000",,,net_banking_transfer,-10000
633d598b2e1a0ebb7f1a602a,50200023535069,-796597.7,60ec41ba55c00300382672d9,HDFC,N-ACH payments,5eecc6d6449e4f7cfb1c2708,2022-09-20T00:00:00.000Z,50100029125472-TPT-3040-NIKKY SACHDEV,,,net_banking_transfer,-3040
633d598b2e1a0ebb7f1a602d,50200023535069,-781214.28,60ec41ba55c00300382672d9,HDFC,Revenue-PG-non-split,5eecc6d6449e4f7cfb1c2708,2022-09-20T00:00:00.000Z,NEFT CR-KKBK0000958-NODAL ACCOUNT BROKEN TUSK TECHNOL-SLICK ORGANICS PRIVATE LIMI TED-CMS2632226364841,insurance,insurance,net_banking_transfer,15383.42
633d598b2e1a0ebb7f1a602f,50200023535069,-781656.28,60ec41ba55c00300382672d9,HDFC,direct expenses,5eecc6d6449e4f7cfb1c2708,2022-09-20T00:00:00.000Z,POS 514834XXXXXX9486 SMARTSHIFT LOGIS,,,debit_card,-442
633d598b2e1a0ebb7f1a6031,50200023535069,-781363.36,60ec41ba55c00300382672d9,HDFC,Transfer in/Revenue-other,5eecc6d6449e4f7cfb1c2708,2022-09-20T00:00:00.000Z,NEFT CR-UTIB0000114-ONE SIGMA TECHNOLOGI ES PRIVATE LIM-SLICK ORGANICS PRIVATE LI MITED-AXISP00321194668,insurance,insurance,net_banking_transfer,292.92
633d598b2e1a0ebb7f1a6034,50200023535069,-781396.36,60ec41ba55c00300382672d9,HDFC,bank charges,5eecc6d6449e4f7cfb1c2708,2022-09-20T00:00:00.000Z,.DC INTL POS TXN MARKUP+ST 190822 210822 -CDT2225311069883,,,international_transaction_arbitrage,-33
633d598b2e1a0ebb7f1a6037,50200023535069,-826631.36,60ec41ba55c00300382672d9,HDFC,direct expenses,5eecc6d6449e4f7cfb1c2708,2022-09-20T00:00:00.000Z,NEFT DR-KKBK0000218-MONETIZE INFO LLP-NE,,,net_banking_transfer,-45235
633d598b2e1a0ebb7f1a603a,50200023535069,-1082792.36,60ec41ba55c00300382672d9,HDFC,direct expenses,5eecc6d6449e4f7cfb1c2708,2022-09-20T00:00:00.000Z,"NEFT DR-SRCB0000281-3D TECHNOPACK PRIVAT E LIMITED-NETBANK, MUM-N263222127210969- 256161",,,net_banking_transfer,-256161
633d598b2e1a0ebb7f1a603c,50200023535069,-1282792.36,60ec41ba55c00300382672d9,HDFC,direct expenses,5eecc6d6449e4f7cfb1c2708,2022-09-20T00:00:00.000Z,"NEFT DR-YESB0000551-VISTTA COSMETICS-NET BANK, MUM-N263222127199588-200000",,,net_banking_transfer,-200000
633d598b2e1a0ebb7f1a603e,50200023535069,-1782792.36,60ec41ba55c00300382672d9,HDFC,direct expenses,5eecc6d6449e4f7cfb1c2708,2022-09-20T00:00:00.000Z,"NEFT DR-ICIC0000024-TAKE MOTO YOHKI INDI A PRIVATE LIMITED-NETBANK, MUM-N26322212 7218630-500000",travel,,net_banking_transfer,-500000
633d598b2e1a0ebb7f1a6041,50200023535069,-1781681.13,60ec41ba55c00300382672d9,HDFC,Revenue-Mktplace,5eecc6d6449e4f7cfb1c2708,2022-09-20T00:00:00.000Z,NEFT CR-ICIC0000105-MANASH LIFESTYLE PRI VATE LIMITED NO-SLICK ORGANICS PRIVATE L IMITED MP G-ICIJ222630007057,shopping,,net_banking_transfer,1111.23
633d598b2e1a0ebb7f1a6043,50200023535069,-1777752.93,60ec41ba55c00300382672d9,HDFC,Revenue-Mktplace,5eecc6d6449e4f7cfb1c2708,2022-09-20T00:00:00.000Z,NEFT CR-ICIC0000105-MANASH LIFESTYLE PRI VATE LIMITED NO-SLICK ORGANICS PRIVATE L IMITED MP M-ICIJ222630007059,shopping,,net_banking_transfer,3928.2
633d598b2e1a0ebb7f1a6046,50200023535069,-1672075.33,60ec41ba55c00300382672d9,HDFC,Revenue-PG-non-split,5eecc6d6449e4f7cfb1c2708,2022-09-20T00:00:00.000Z,NEFT CR-KKBK0000958-NODAL ACCOUNT BROKEN TUSK TECHNOL-SLICK ORGANICS PRIVATE LIMI TED-CMS2632226391398,insurance,insurance,net_banking_transfer,105677.6
633d598c2e1a0ebb7f1a6048,50200023535069,-1665130.63,60ec41ba55c00300382672d9,HDFC,Revenue-PG-split enabled,5eecc6d6449e4f7cfb1c2708,2022-09-20T00:00:00.000Z,NEFT CR-UTIB0001506-RAZORPAY SOFTWARE PR IVATE LIMITED-SLICK ORGANICS PVT LITD-AX ISCN0166890532,insurance,insurance,net_banking_transfer,6944.7
633d598c2e1a0ebb7f1a604a,50200023535069,-1665129.63,60ec41ba55c00300382672d9,HDFC,Revenue-PG-non-split,5eecc6d6449e4f7cfb1c2708,2022-09-21T00:00:00.000Z,IMPS-226400093639-BROKENTUSK TECHNOLOG-K KBK-XXXXXX9773-NONE,,,net_banking_transfer,1
633d598c2e1a0ebb7f1a604d,50200023535069,-1665122.63,60ec41ba55c00300382672d9,HDFC,Transfer in/Revenue-other,5eecc6d6449e4f7cfb1c2708,2022-09-21T00:00:00.000Z,INT. ON SWCR ON-50300675642152,,,Other,7
633d598c2e1a0ebb7f1a604f,50200023535069,-1654623.63,60ec41ba55c00300382672d9,HDFC,Loan-in,5eecc6d6449e4f7cfb1c2708,2022-09-21T00:00:00.000Z,SWEEP-IN CREDIT - 50300675642152,,,self_transfer,10499
633d598c2e1a0ebb7f1a6051,50200023535069,-1654465.63,60ec41ba55c00300382672d9,HDFC,Transfer in/Revenue-other,5eecc6d6449e4f7cfb1c2708,2022-09-21T00:00:00.000Z,INT. ON SWCR ON-50300675642152,,,Other,158
633d598c2e1a0ebb7f1a6054,50200023535069,-1419444.63,60ec41ba55c00300382672d9,HDFC,Loan-in,5eecc6d6449e4f7cfb1c2708,2022-09-21T00:00:00.000Z,SWEEP-IN CREDIT - 50300675642152,,,self_transfer,235021
633d598c2e1a0ebb7f1a6056,50200023535069,-1419108.63,60ec41ba55c00300382672d9,HDFC,Transfer in/Revenue-other,5eecc6d6449e4f7cfb1c2708,2022-09-21T00:00:00.000Z,INT. ON SWCR ON-50300675642152,,,Other,336
633d598c2e1a0ebb7f1a6058,50200023535069,-919108.63,60ec41ba55c00300382672d9,HDFC,Loan-in,5eecc6d6449e4f7cfb1c2708,2022-09-21T00:00:00.000Z,SWEEP-IN CREDIT - 50300675642152,,,self_transfer,500000
633d598c2e1a0ebb7f1a605b,50200023535069,-919082.63,60ec41ba55c00300382672d9,HDFC,Transfer in/Revenue-other,5eecc6d6449e4f7cfb1c2708,2022-09-21T00:00:00.000Z,INT. ON SWCR ON-50300675642152,,,Other,26
633d598c2e1a0ebb7f1a605d,50200023535069,-881043.63,60ec41ba55c00300382672d9,HDFC,Loan-in,5eecc6d6449e4f7cfb1c2708,2022-09-21T00:00:00.000Z,SWEEP-IN CREDIT - 50300675642152,,,self_transfer,38039
633d598c2e1a0ebb7f1a605f,50200023535069,-881036.63,60ec41ba55c00300382672d9,HDFC,Transfer in/Revenue-other,5eecc6d6449e4f7cfb1c2708,2022-09-21T00:00:00.000Z,INT. ON SWCR ON-50300675642152,,,Other,7
633d598c2e1a0ebb7f1a6062,50200023535069,-871036.63,60ec41ba55c00300382672d9,HDFC,Loan-in,5eecc6d6449e4f7cfb1c2708,2022-09-21T00:00:00.000Z,SWEEP-IN CREDIT - 50300675642152,,,self_transfer,10000
633d598c2e1a0ebb7f1a6064,50200023535069,-871034.63,60ec41ba55c00300382672d9,HDFC,Transfer in/Revenue-other,5eecc6d6449e4f7cfb1c2708,2022-09-21T00:00:00.000Z,INT. ON SWCR ON-50300675642152,,,Other,2
633d598c2e1a0ebb7f1a6066,50200023535069,-867994.63,60ec41ba55c00300382672d9,HDFC,Loan-in,5eecc6d6449e4f7cfb1c2708,2022-09-21T00:00:00.000Z,SWEEP-IN CREDIT - 50300675642152,,,self_transfer,3040
633d598c2e1a0ebb7f1a6069,50200023535069,-867974.63,60ec41ba55c00300382672d9,HDFC,Transfer in/Revenue-other,5eecc6d6449e4f7cfb1c2708,2022-09-21T00:00:00.000Z,INT. ON SWCR ON-50300675642152,,,Other,20
633d598c2e1a0ebb7f1a606b,50200023535069,-837940.63,60ec41ba55c00300382672d9,HDFC,Loan-in,5eecc6d6449e4f7cfb1c2708,2022-09-21T00:00:00.000Z,SWEEP-IN CREDIT - 50300675642152,,,self_transfer,30034
633d598c2e1a0ebb7f1a606d,50200023535069,-837768.63,60ec41ba55c00300382672d9,HDFC,Transfer in/Revenue-other,5eecc6d6449e4f7cfb1c2708,2022-09-21T00:00:00.000Z,INT. ON SWCR ON-50300675642152,,,Other,172
633d598c2e1a0ebb7f1a6070,50200023535069,-581607.63,60ec41ba55c00300382672d9,HDFC,Loan-in,5eecc6d6449e4f7cfb1c2708,2022-09-21T00:00:00.000Z,SWEEP-IN CREDIT - 50300675642152,,,self_transfer,256161
633d598c2e1a0ebb7f1a6073,50200023535069,-581473.63,60ec41ba55c00300382672d9,HDFC,Transfer in/Revenue-other,5eecc6d6449e4f7cfb1c2708,2022-09-21T00:00:00.000Z,INT. ON SWCR ON-50300675642152,,,Other,134
633d598c2e1a0ebb7f1a6075,50200023535069,-381473.63,60ec41ba55c00300382672d9,HDFC,Loan-in,5eecc6d6449e4f7cfb1c2708,2022-09-21T00:00:00.000Z,SWEEP-IN CREDIT - 50300675642152,,,self_transfer,200000
633d598c2e1a0ebb7f1a6079,50200023535069,-381217.63,60ec41ba55c00300382672d9,HDFC,Transfer in/Revenue-other,5eecc6d6449e4f7cfb1c2708,2022-09-21T00:00:00.000Z,INT. ON SWCR ON-50300675642152,,,Other,256
633d598c2e1a0ebb7f1a607b,50200023535069,257.37,60ec41ba55c00300382672d9,HDFC,Loan-in,5eecc6d6449e4f7cfb1c2708,2022-09-21T00:00:00.000Z,SWEEP-IN CREDIT - 50300675642152,,,self_transfer,381475
633d598c2e1a0ebb7f1a607d,50200023535069,49484.87,60ec41ba55c00300382672d9,HDFC,Revenue-Mktplace,5eecc6d6449e4f7cfb1c2708,2022-09-21T00:00:00.000Z,NEFT CR-DEUT0797BGL-FLIPKART INTERNET PR IVATE LIMITED-SLICK ORGANICS PVT LTD-226 400162GN00216,shopping,,net_banking_transfer,49227.5
633d598c2e1a0ebb7f1a6080,50200023535069,56840.39,60ec41ba55c00300382672d9,HDFC,Revenue-Mktplace,5eecc6d6449e4f7cfb1c2708,2022-09-21T00:00:00.000Z,NEFT CR-DEUT0797BGL-MYNTRA DESIGNS PRIVA TE LIMITED-SLICK ORGANICS PVT. LTD.-2264 00671GN00168,shopping,,net_banking_transfer,7355.52
633d598c2e1a0ebb7f1a6082,50200023535069,67053.1,60ec41ba55c00300382672d9,HDFC,Revenue-Mktplace,5eecc6d6449e4f7cfb1c2708,2022-09-21T00:00:00.000Z,NEFT CR-DEUT0797BGL-MYNTRA DESIGNS PRIVA TE LIMITED-SLICK ORGANICS PVT. LTD.-2264 00680GN00015,shopping,,net_banking_transfer,10212.71
633d598c2e1a0ebb7f1a6084,50200023535069,75386.37,60ec41ba55c00300382672d9,HDFC,Revenue-PG-non-split,5eecc6d6449e4f7cfb1c2708,2022-09-21T00:00:00.000Z,NEFT CR-PYTM0123456-PAYTM PAYMENTS SERVI CES LIMITED-SLICK ORGANICS PVT LTD-PYTM2 22649995973,insurance,insurance,net_banking_transfer,8333.27
633d598c2e1a0ebb7f1a6087,50200023535069,80378.9,60ec41ba55c00300382672d9,HDFC,Revenue-PG-split enabled,5eecc6d6449e4f7cfb1c2708,2022-09-21T00:00:00.000Z,NEFT CR-UTIB0001506-RAZORPAY SOFTWARE PR IVATE LIMITED-SLICK ORGANICS PVT LITD-AX ISCN0166967073,insurance,insurance,net_banking_transfer,4992.53
633d598c2e1a0ebb7f1a6089,50200023535069,44378.9,60ec41ba55c00300382672d9,HDFC,direct expenses,5eecc6d6449e4f7cfb1c2708,2022-09-21T00:00:00.000Z,"NEFT DR-SCBL0036033-KAVITA GHAI-NETBANK, MUM-N264222128062121-36000",,,net_banking_transfer,-36000
633d598c2e1a0ebb7f1a608b,50200023535069,40892.9,60ec41ba55c00300382672d9,HDFC,direct expenses,5eecc6d6449e4f7cfb1c2708,2022-09-21T00:00:00.000Z,"NEFT DR-SCBL0036025-DHRUV MADHOK-NETBANK , MUM-N264222128062927-3486",,,net_banking_transfer,-3486
633d598c2e1a0ebb7f1a608e,50200023535069,32512.9,60ec41ba55c00300382672d9,HDFC,direct expenses,5eecc6d6449e4f7cfb1c2708,2022-09-21T00:00:00.000Z,NEFT DR-ICIC0000715-GAJENDRA BAHADUR SIN,,,net_banking_transfer,-8380
633d598c2e1a0ebb7f1a6090,50200023535069,22512.9,60ec41ba55c00300382672d9,HDFC,direct expenses,5eecc6d6449e4f7cfb1c2708,2022-09-21T00:00:00.000Z,"NEFT DR-ICIC0000021-AKHILESH DIXIT-NETBA NK, MUM-N264222128109358-10000",,,net_banking_transfer,-10000
633d598c2e1a0ebb7f1a6093,50200023535069,13074.08,60ec41ba55c00300382672d9,HDFC,direct expenses,5eecc6d6449e4f7cfb1c2708,2022-09-21T00:00:00.000Z,POS 514834XXXXXX9486 ONLINE PAYMENT,,,debit_card,-9438.82
633d598c2e1a0ebb7f1a6095,50200023535069,9164.08,60ec41ba55c00300382672d9,HDFC,direct expenses,5eecc6d6449e4f7cfb1c2708,2022-09-21T00:00:00.000Z,POS 514834XXXXXX9486 WWW.FAQPRIME.COM,,,debit_card,-3910
633d598c2e1a0ebb7f1a6097,50200023535069,9976.27,60ec41ba55c00300382672d9,HDFC,Revenue-Mktplace,5eecc6d6449e4f7cfb1c2708,2022-09-21T00:00:00.000Z,NEFT CR-ICIC0000105-MANASH LIFESTYLE PRI VATE LIMITED NO-SLICK ORGANICS PRIVATE L IMITED MP M-ICIJ222640003230,shopping,,net_banking_transfer,812.19
633d598c2e1a0ebb7f1a609a,50200023535069,11914.33,60ec41ba55c00300382672d9,HDFC,Revenue-Mktplace,5eecc6d6449e4f7cfb1c2708,2022-09-21T00:00:00.000Z,NEFT CR-ICIC0000105-MANASH LIFESTYLE PRI VATE LIMITED NO-SLICK ORGANICS PRIVATE L IMITED MP G-ICIJ222640003228,shopping,,net_banking_transfer,1938.06
633d598c2e1a0ebb7f1a609d,50200023535069,-5785.67,60ec41ba55c00300382672d9,HDFC,direct expenses,5eecc6d6449e4f7cfb1c2708,2022-09-21T00:00:00.000Z,"NEFT DR-SBIN0001706-TAGNPIN WEB SOLUTION S LLP-NETBANK, MUM-N264222128356495-1770 0",,,net_banking_transfer,-17700
633d598c2e1a0ebb7f1a60a0,50200023535069,-1173.42,60ec41ba55c00300382672d9,HDFC,Transfer in/Revenue-other,5eecc6d6449e4f7cfb1c2708,2022-09-21T00:00:00.000Z,NEFT CR-UTIB0000114-ONE SIGMA TECHNOLOGI ES PRIVATE LIM-SLICK ORGANICS PRIVATE LI MITED-AXISP00321434788,insurance,insurance,net_banking_transfer,4612.25
633d598c2e1a0ebb7f1a60a3,50200023535069,19452.82,60ec41ba55c00300382672d9,HDFC,Revenue-PG-non-split,5eecc6d6449e4f7cfb1c2708,2022-09-21T00:00:00.000Z,NEFT CR-KKBK0000958-NODAL ACCOUNT BROKEN TUSK TECHNOL-SLICK ORGANICS PRIVATE LIMI TED-CMS2642226485815,insurance,insurance,net_banking_transfer,20626.24
633d598c2e1a0ebb7f1a60a5,50200023535069,43220.17,60ec41ba55c00300382672d9,HDFC,Revenue-COD,5eecc6d6449e4f7cfb1c2708,2022-09-21T00:00:00.000Z,NEFT CR-ICIC0000155-SHIPROCKET COD CRF I D 4926975-SLICK ORGANICS PVT LTD-CMS2845 820321,insurance,insurance,net_banking_transfer,23767.35
633d598c2e1a0ebb7f1a60a8,50200023535069,57021.22,60ec41ba55c00300382672d9,HDFC,Revenue-PG-split enabled,5eecc6d6449e4f7cfb1c2708,2022-09-21T00:00:00.000Z,NEFT CR-UTIB0001506-RAZORPAY SOFTWARE PR IVATE LIMITED-SLICK ORGANICS PVT LITD-AX ISCN0167102531,insurance,insurance,net_banking_transfer,13801.05
633d598c2e1a0ebb7f1a60aa,50200023535069,60913.22,60ec41ba55c00300382672d9,HDFC,Transfer in/Revenue-other,5eecc6d6449e4f7cfb1c2708,2022-09-21T00:00:00.000Z,NEFT CR-HSBC0560002-INNOVATIVE RETAIL CO NCEPTS PRIVATE-SLICK ORGANICS PVT LTD-HS BCN22264864626,,,net_banking_transfer,3892
633d598c2e1a0ebb7f1a60ac,50200023535069,67874.22,60ec41ba55c00300382672d9,HDFC,Transfer in/Revenue-other,5eecc6d6449e4f7cfb1c2708,2022-09-21T00:00:00.000Z,NEFT CR-HSBC0560002-INNOVATIVE RETAIL CO NCEPTS PRIVATE-SLICK ORGANICS PVT LTD-HS BCN22264864628,,,net_banking_transfer,6961
633d598c2e1a0ebb7f1a60af,50200023535069,73667.22,60ec41ba55c00300382672d9,HDFC,Transfer in/Revenue-other,5eecc6d6449e4f7cfb1c2708,2022-09-21T00:00:00.000Z,NEFT CR-HSBC0560002-INNOVATIVE RETAIL CO,,,net_banking_transfer,5793
633d598c2e1a0ebb7f1a60b1,50200023535069,53667.22,60ec41ba55c00300382672d9,HDFC,direct expenses,5eecc6d6449e4f7cfb1c2708,2022-09-21T00:00:00.000Z,POS 514834XXXXXX9486 FLIPKART,shopping,,debit_card,-20000
633d598c2e1a0ebb7f1a60b4,50200023535069,3667.22,60ec41ba55c00300382672d9,HDFC,direct expenses,5eecc6d6449e4f7cfb1c2708,2022-09-21T00:00:00.000Z,"NEFT DR-SCBL0036085-HEALTH AND GLOW PRIV ATE LIMITED-NETBANK, MUM-N26422212899738 3-50000",,,net_banking_transfer,-50000
633d598c2e1a0ebb7f1a60b6,50200023535069,-171.97,60ec41ba55c00300382672d9,HDFC,direct expenses,5eecc6d6449e4f7cfb1c2708,2022-09-21T00:00:00.000Z,POS 514834XXXXXX9486 CAS*TRUKKY,,,debit_card,-3839.19
633d598c2e1a0ebb7f1a60b8,50200023535069,0.03,60ec41ba55c00300382672d9,HDFC,Loan-in,5eecc6d6449e4f7cfb1c2708,2022-09-22T00:00:00.000Z,SWEEP-IN CREDIT - 50300675642152,,,self_transfer,172
633d598c2e1a0ebb7f1a60bb,50200023535069,18508.49,60ec41ba55c00300382672d9,HDFC,Revenue-PG-non-split,5eecc6d6449e4f7cfb1c2708,2022-09-22T00:00:00.000Z,NEFT CR-PYTM0123456-PAYTM PAYMENTS SERVI CES LIMITED-SLICK ORGANICS PVT LTD-PYTM2 22651089531,insurance,insurance,net_banking_transfer,18508.46
633d598c2e1a0ebb7f1a60bd,50200023535069,-7091.51,60ec41ba55c00300382672d9,HDFC,direct expenses,5eecc6d6449e4f7cfb1c2708,2022-09-22T00:00:00.000Z,"NEFT DR-SCBL0036085-HEALTH AND GLOW PRIV ATE LIMITED-NETBANK, MUM-N26522212916981 9-25600",,,net_banking_transfer,-25600
633d598c2e1a0ebb7f1a60c0,50200023535069,3121.94,60ec41ba55c00300382672d9,HDFC,Revenue-PG-split enabled,5eecc6d6449e4f7cfb1c2708,2022-09-22T00:00:00.000Z,NEFT CR-UTIB0001506-RAZORPAY SOFTWARE PR IVATE LIMITED-SLICK ORGANICS PVT LITD-AX ISCN0167211089,insurance,insurance,net_banking_transfer,10213.45
633d598c2e1a0ebb7f1a60c2,50200023535069,-1878.06,60ec41ba55c00300382672d9,HDFC,direct expenses,5eecc6d6449e4f7cfb1c2708,2022-09-22T00:00:00.000Z,"NEFT DR-UTIB0000032-SKUMAR MULTIPRODUCTS PVT LTD-NETBANK, MUM-N265222129751394-5 000",,,net_banking_transfer,-5000
633d598c2e1a0ebb7f1a60c4,50200023535069,-1740.98,60ec41ba55c00300382672d9,HDFC,Revenue-Mktplace,5eecc6d6449e4f7cfb1c2708,2022-09-22T00:00:00.000Z,NEFT CR-ICIC0000105-MANASH LIFESTYLE PRI VATE LIMITED NO-SLICK ORGANICS PRIVATE L IMITED MP M-ICIJ222650002834,shopping,,net_banking_transfer,137.08
633d598c2e1a0ebb7f1a60c7,50200023535069,92.27,60ec41ba55c00300382672d9,HDFC,Revenue-Mktplace,5eecc6d6449e4f7cfb1c2708,2022-09-22T00:00:00.000Z,NEFT CR-ICIC0000105-MANASH LIFESTYLE PRI VATE LIMITED NO-SLICK ORGANICS PRIVATE L IMITED MP G-ICIJ222650002832,shopping,,net_banking_transfer,1833.25
633d598c2e1a0ebb7f1a60c9,50200023535069,-807.73,60ec41ba55c00300382672d9,HDFC,SAAS/tech expense,5eecc6d6449e4f7cfb1c2708,2022-09-22T00:00:00.000Z,POS 514834XXXXXX9486 AMAZON,shopping,,debit_card,-900
633d598c2e1a0ebb7f1a60cd,50200023535069,-7983.68,60ec41ba55c00300382672d9,HDFC,direct expenses,5eecc6d6449e4f7cfb1c2708,2022-09-22T00:00:00.000Z,POS 514834XXXXXX9486 CAS*TRUKKY,,,debit_card,-7175.95
633d598c2e1a0ebb7f1a60cf,50200023535069,-32983.68,60ec41ba55c00300382672d9,HDFC,direct expenses,5eecc6d6449e4f7cfb1c2708,2022-09-22T00:00:00.000Z,50200039508087-TPT-25000-SHREE PUNCHMUKH I LOGISTICS,,,net_banking_transfer,-25000
633d598c2e1a0ebb7f1a60d1,50200023535069,-2662.92,60ec41ba55c00300382672d9,HDFC,Transfer in/Revenue-other,5eecc6d6449e4f7cfb1c2708,2022-09-22T00:00:00.000Z,NEFT CR-KKBK0000958-NODAL ACCOUNT BROKEN,,,net_banking_transfer,30320.76
633d598c2e1a0ebb7f1a60d4,50200023535069,-1644.84,60ec41ba55c00300382672d9,HDFC,Transfer in/Revenue-other,5eecc6d6449e4f7cfb1c2708,2022-09-22T00:00:00.000Z,NEFT CR-UTIB0000114-ONE SIGMA TECHNOLOGI ES PRIVATE LIM-SLICK ORGANICS PRIVATE LI MITED-AXISP00321713086,insurance,insurance,net_banking_transfer,1018.08
633d598c2e1a0ebb7f1a60d6,50200023535069,5811.45,60ec41ba55c00300382672d9,HDFC,Revenue-PG-split enabled,5eecc6d6449e4f7cfb1c2708,2022-09-22T00:00:00.000Z,NEFT CR-UTIB0001506-RAZORPAY SOFTWARE PR IVATE LIMITED-SLICK ORGANICS PVT LITD-AX ISCN0167367463,insurance,insurance,net_banking_transfer,7456.29
633d598c2e1a0ebb7f1a60d9,50200023535069,-15309.18,60ec41ba55c00300382672d9,HDFC,direct expenses,5eecc6d6449e4f7cfb1c2708,2022-09-22T00:00:00.000Z,POS 514834XXXXXX9486 CAS*TRUKKY,,,debit_card,-21120.63
633d598c2e1a0ebb7f1a60dc,50200023535069,-15308.18,60ec41ba55c00300382672d9,HDFC,Transfer in/Revenue-other,5eecc6d6449e4f7cfb1c2708,2022-09-23T00:00:00.000Z,INT. ON SWCR ON-50300675642152,,,Other,1
633d598d2e1a0ebb7f1a60de,50200023535069,-14415.18,60ec41ba55c00300382672d9,HDFC,Loan-in,5eecc6d6449e4f7cfb1c2708,2022-09-23T00:00:00.000Z,SWEEP-IN CREDIT - 50300675642152,,,self_transfer,893
633d598d2e1a0ebb7f1a60e1,50200023535069,-14410.18,60ec41ba55c00300382672d9,HDFC,Transfer in/Revenue-other,5eecc6d6449e4f7cfb1c2708,2022-09-23T00:00:00.000Z,INT. ON SWCR ON-50300675642152,,,Other,5
633d598d2e1a0ebb7f1a60e3,50200023535069,-7318.18,60ec41ba55c00300382672d9,HDFC,Loan-in,5eecc6d6449e4f7cfb1c2708,2022-09-23T00:00:00.000Z,SWEEP-IN CREDIT - 50300675642152,,,self_transfer,7092
633d598d2e1a0ebb7f1a60e5,50200023535069,-7312.18,60ec41ba55c00300382672d9,HDFC,Transfer in/Revenue-other,5eecc6d6449e4f7cfb1c2708,2022-09-23T00:00:00.000Z,INT. ON SWCR ON-50300675642152,,,Other,6
633d598d2e1a0ebb7f1a60e8,50200023535069,6.82,60ec41ba55c00300382672d9,HDFC,Loan-in,5eecc6d6449e4f7cfb1c2708,2022-09-23T00:00:00.000Z,SWEEP-IN CREDIT - 50300675642152,,,self_transfer,7319
633d598d2e1a0ebb7f1a60ea,50200023535069,22328.89,60ec41ba55c00300382672d9,HDFC,Revenue-Mktplace,5eecc6d6449e4f7cfb1c2708,2022-09-23T00:00:00.000Z,NEFT CR-DEUT0797BGL-FLIPKART INTERNET PR IVATE LIMITED-SLICK ORGANICS PVT LTD-226 600133GN00235,shopping,,net_banking_transfer,22322.07
633d598d2e1a0ebb7f1a60ec,50200023535069,34846.36,60ec41ba55c00300382672d9,HDFC,Revenue-PG-non-split,5eecc6d6449e4f7cfb1c2708,2022-09-23T00:00:00.000Z,NEFT CR-PYTM0123456-PAYTM PAYMENTS SERVI CES LIMITED-SLICK ORGANICS PVT LTD-PYTM2 22662893765,insurance,insurance,net_banking_transfer,12517.47
633d598d2e1a0ebb7f1a60ef,50200023535069,40574.26,60ec41ba55c00300382672d9,HDFC,Revenue-Mktplace,5eecc6d6449e4f7cfb1c2708,2022-09-23T00:00:00.000Z,NEFT CR-DEUT0797BGL-MYNTRA DESIGNS PRIVA TE LIMITED-SLICK ORGANICS PVT. LTD.-2266 00688GN00161,shopping,,net_banking_transfer,5727.9
633d598d2e1a0ebb7f1a60f1,50200023535069,49021.74,60ec41ba55c00300382672d9,HDFC,Revenue-Mktplace,5eecc6d6449e4f7cfb1c2708,2022-09-23T00:00:00.000Z,NEFT CR-DEUT0797BGL-MYNTRA DESIGNS PRIVA TE LIMITED-SLICK ORGANICS PVT. LTD.-2266 00697GN00025,shopping,,net_banking_transfer,8447.48
633d598d2e1a0ebb7f1a60f3,50200023535069,63598.12,60ec41ba55c00300382672d9,HDFC,Revenue-PG-split enabled,5eecc6d6449e4f7cfb1c2708,2022-09-23T00:00:00.000Z,NEFT CR-UTIB0001506-RAZORPAY SOFTWARE PR IVATE LIMITED-SLICK ORGANICS PVT LITD-AX ISCN0167444402,insurance,insurance,net_banking_transfer,14576.38
633d598d2e1a0ebb7f1a60f6,50200023535069,-36401.88,60ec41ba55c00300382672d9,HDFC,direct expenses,5eecc6d6449e4f7cfb1c2708,2022-09-23T00:00:00.000Z,"NEFT DR-ICIC0006566-MARKETING MANTRA-NET BANK, MUM-N266222130986628-100000",,,net_banking_transfer,-100000
633d598d2e1a0ebb7f1a60f8,50200023535069,-144401.88,60ec41ba55c00300382672d9,HDFC,direct expenses,5eecc6d6449e4f7cfb1c2708,2022-09-23T00:00:00.000Z,NEFT DR-SCBL0036085-HEALTH AND GLOW PRIV,,,net_banking_transfer,-108000
633d598d2e1a0ebb7f1a60fb,50200023535069,-141557.84,60ec41ba55c00300382672d9,HDFC,Revenue-COD,5eecc6d6449e4f7cfb1c2708,2022-09-23T00:00:00.000Z,NEFT CR-ICIC0000155-SHIPROCKET COD CRF I D 4939228-SLICK ORGANICS PVT LTD-CMS2849 477831,insurance,insurance,net_banking_transfer,2844.04
633d598d2e1a0ebb7f1a60fd,50200023535069,-140558.02,60ec41ba55c00300382672d9,HDFC,Revenue-Mktplace,5eecc6d6449e4f7cfb1c2708,2022-09-23T00:00:00.000Z,NEFT CR-ICIC0000105-MANASH LIFESTYLE PRI VATE LIMITED NO-SLICK ORGANICS PRIVATE L IMITED MP G-ICIJ222660004755,shopping,,net_banking_transfer,999.82
633d598d2e1a0ebb7f1a60ff,50200023535069,-139712.87,60ec41ba55c00300382672d9,HDFC,Revenue-Mktplace,5eecc6d6449e4f7cfb1c2708,2022-09-23T00:00:00.000Z,NEFT CR-ICIC0000105-MANASH LIFESTYLE PRI VATE LIMITED NO-SLICK ORGANICS PRIVATE L IMITED MP M-ICIJ222660002781,shopping,,net_banking_transfer,845.15
633d598d2e1a0ebb7f1a6102,50200023535069,-138562.69,60ec41ba55c00300382672d9,HDFC,Transfer in/Revenue-other,5eecc6d6449e4f7cfb1c2708,2022-09-23T00:00:00.000Z,NEFT CR-UTIB0000114-ONE SIGMA TECHNOLOGI ES PRIVATE LIM-SLICK ORGANICS PRIVATE LI MITED-AXISP00322019125,insurance,insurance,net_banking_transfer,1150.18
633d598d2e1a0ebb7f1a6104,50200023535069,-90507.51,60ec41ba55c00300382672d9,HDFC,Revenue-PG-non-split,5eecc6d6449e4f7cfb1c2708,2022-09-23T00:00:00.000Z,NEFT CR-KKBK0000958-NODAL ACCOUNT BROKEN TUSK TECHNOL-SLICK ORGANICS PRIVATE LIMI TED-CMS2662226717888,insurance,insurance,net_banking_transfer,48055.18
633d598d2e1a0ebb7f1a6106,50200023535069,-89003.51,60ec41ba55c00300382672d9,HDFC,Revenue-Mktplace,5eecc6d6449e4f7cfb1c2708,2022-09-23T00:00:00.000Z,NEFT CR-SCBL0036001-DREAMPLUG TECHNOLOGI ES PRIVATE LIMITED-SLICK ORGANICS PRIVAT E LIMITEDSLICK-IN1ON22092304247,,,net_banking_transfer,1504
633d598d2e1a0ebb7f1a6109,50200023535069,-79112.22,60ec41ba55c00300382672d9,HDFC,Revenue-PG-split enabled,5eecc6d6449e4f7cfb1c2708,2022-09-23T00:00:00.000Z,NEFT CR-UTIB0001506-RAZORPAY SOFTWARE PR IVATE LIMITED-SLICK ORGANICS PVT LITD-AX ISCN0167598581,insurance,insurance,net_banking_transfer,9891.29
633d598d2e1a0ebb7f1a610b,50200023535069,-79082.22,60ec41ba55c00300382672d9,HDFC,Transfer in/Revenue-other,5eecc6d6449e4f7cfb1c2708,2022-09-24T00:00:00.000Z,INT. ON SWCR ON-50300675642152,,,Other,30
633d598d2e1a0ebb7f1a610e,50200023535069,-42680.22,60ec41ba55c00300382672d9,HDFC,Loan-in,5eecc6d6449e4f7cfb1c2708,2022-09-24T00:00:00.000Z,SWEEP-IN CREDIT - 50300675642152,,,self_transfer,36402
633d598d2e1a0ebb7f1a6110,50200023535069,-42645.22,60ec41ba55c00300382672d9,HDFC,Transfer in/Revenue-other,5eecc6d6449e4f7cfb1c2708,2022-09-24T00:00:00.000Z,INT. ON SWCR ON-50300675642152,,,Other,35
633d598d2e1a0ebb7f1a6112,50200023535069,35.78,60ec41ba55c00300382672d9,HDFC,Loan-in,5eecc6d6449e4f7cfb1c2708,2022-09-24T00:00:00.000Z,SWEEP-IN CREDIT - 50300675642152,,,self_transfer,42681
633d598d2e1a0ebb7f1a6115,50200023535069,16868.78,60ec41ba55c00300382672d9,HDFC,Revenue-PG-non-split,5eecc6d6449e4f7cfb1c2708,2022-09-24T00:00:00.000Z,NEFT CR-PYTM0123456-PAYTM PAYMENTS SERVI CES LIMITED-SLICK ORGANICS PVT LTD-PYTM2 22674472240,insurance,insurance,net_banking_transfer,16833
633d598d2e1a0ebb7f1a6117,50200023535069,66021.64,60ec41ba55c00300382672d9,HDFC,Revenue-UPI,5eecc6d6449e4f7cfb1c2708,2022-09-24T00:00:00.000Z,UPI-GOKWIK-GOKWIK@YESBANK-YESB0000340-22,,,upi,49152.86
633d598d2e1a0ebb7f1a611a,50200023535069,86496.14,60ec41ba55c00300382672d9,HDFC,Revenue-PG-non-split,5eecc6d6449e4f7cfb1c2708,2022-09-25T00:00:00.000Z,NEFT CR-PYTM0123456-PAYTM PAYMENTS SERVI CES LIMITED-SLICK ORGANICS PVT LTD-PYTM2 22686298735,insurance,insurance,net_banking_transfer,20474.5
633d598d2e1a0ebb7f1a611d,50200023535069,84843.85,60ec41ba55c00300382672d9,HDFC,bank charges,5eecc6d6449e4f7cfb1c2708,2022-09-25T00:00:00.000Z,.DC INTL POS TXN MARKUP+ST 290822 310822 -CDT2225311069883,,,international_transaction_arbitrage,-1652.29
633d598d2e1a0ebb7f1a611f,50200023535069,109470.42,60ec41ba55c00300382672d9,HDFC,Revenue-Mktplace,5eecc6d6449e4f7cfb1c2708,2022-09-26T00:00:00.000Z,NEFT CR-DEUT0797BGL-FLIPKART INTERNET PR IVATE LIMITED-SLICK ORGANICS PVT LTD-226 900116GN00084,shopping,,net_banking_transfer,24626.57
633d598d2e1a0ebb7f1a6122,50200023535069,160534.87,60ec41ba55c00300382672d9,HDFC,Revenue-PG-non-split,5eecc6d6449e4f7cfb1c2708,2022-09-26T00:00:00.000Z,NEFT CR-PYTM0123456-PAYTM PAYMENTS SERVI CES LIMITED-SLICK ORGANICS PVT LTD-PYTM2 22697858943,insurance,insurance,net_banking_transfer,51064.45
633d598d2e1a0ebb7f1a6124,50200023535069,172489.56,60ec41ba55c00300382672d9,HDFC,Revenue-Mktplace,5eecc6d6449e4f7cfb1c2708,2022-09-26T00:00:00.000Z,NEFT CR-DEUT0797BGL-MYNTRA DESIGNS PRIVA TE LIMITED-SLICK ORGANICS PVT. LTD.-2269 00720GN00134,shopping,,net_banking_transfer,11954.69
633d598d2e1a0ebb7f1a6126,50200023535069,288137.54,60ec41ba55c00300382672d9,HDFC,Revenue-PG-split enabled,5eecc6d6449e4f7cfb1c2708,2022-09-26T00:00:00.000Z,NEFT CR-UTIB0001506-RAZORPAY SOFTWARE PR IVATE LIMITED-SLICK ORGANICS PVT LITD-AX ISCN0168031879,insurance,insurance,net_banking_transfer,115647.98
633d598d2e1a0ebb7f1a6129,50200023535069,296186.7,60ec41ba55c00300382672d9,HDFC,Revenue-Mktplace,5eecc6d6449e4f7cfb1c2708,2022-09-26T00:00:00.000Z,NEFT CR-DEUT0797BGL-MYNTRA DESIGNS PRIVA TE LIMITED-SLICK ORGANICS PVT. LTD.-2269 00711GN00277,shopping,,net_banking_transfer,8049.16
633d598d2e1a0ebb7f1a612b,50200023535069,276186.7,60ec41ba55c00300382672d9,HDFC,direct expenses,5eecc6d6449e4f7cfb1c2708,2022-09-26T00:00:00.000Z,POS 514834XXXXXX9486 FLIPKART,shopping,,debit_card,-20000
633d598d2e1a0ebb7f1a612d,50200023535069,278204.24,60ec41ba55c00300382672d9,HDFC,Transfer in/Revenue-other,5eecc6d6449e4f7cfb1c2708,2022-09-26T00:00:00.000Z,NEFT CR-UTIB0000114-ONE SIGMA TECHNOLOGI ES PRIVATE LIM-SLICK ORGANICS PRIVATE LI MITED-AXISP00322310511,insurance,insurance,net_banking_transfer,2017.54
633d598d2e1a0ebb7f1a6130,50200023535069,281300.9,60ec41ba55c00300382672d9,HDFC,Transfer in/Revenue-other,5eecc6d6449e4f7cfb1c2708,2022-09-26T00:00:00.000Z,NEFT CR-UTIB0000114-ONE SIGMA TECHNOLOGI ES PRIVATE LIM-SLICK ORGANICS PRIVATE LI MITED-AXISP00322310714,insurance,insurance,net_banking_transfer,3096.66
633d598d2e1a0ebb7f1a6132,50200023535069,283268.04,60ec41ba55c00300382672d9,HDFC,Transfer in/Revenue-other,5eecc6d6449e4f7cfb1c2708,2022-09-26T00:00:00.000Z,NEFT CR-UTIB0000114-ONE SIGMA TECHNOLOGI ES PRIVATE LIM-SLICK ORGANICS PRIVATE LI MITED-AXISP00322310586,insurance,insurance,net_banking_transfer,1967.14
633d598d2e1a0ebb7f1a6135,50200023535069,286461.7,60ec41ba55c00300382672d9,HDFC,Revenue-PG-non-split,5eecc6d6449e4f7cfb1c2708,2022-09-26T00:00:00.000Z,NEFT CR-SCBL0036001-STRIPE INDIA PRIVATE,,,net_banking_transfer,3193.66
633d598d2e1a0ebb7f1a6137,50200023535069,488485.59,60ec41ba55c00300382672d9,HDFC,Revenue-PG-non-split,5eecc6d6449e4f7cfb1c2708,2022-09-26T00:00:00.000Z,NEFT CR-KKBK0000958-NODAL ACCOUNT BROKEN TUSK TECHNOL-SLICK ORGANICS PRIVATE LIMI TED-CMS2692226873020,insurance,insurance,net_banking_transfer,202023.89
633d598d2e1a0ebb7f1a6139,50200023535069,-11514.41,60ec41ba55c00300382672d9,HDFC,direct expenses,5eecc6d6449e4f7cfb1c2708,2022-09-26T00:00:00.000Z,"NEFT DR-ICIC0000024-TAKE MOTO YOHKI INDI A PRIVATE LIMITED-NETBANK, MUM-N26922213 3844433-500000",travel,,net_banking_transfer,-500000
633d598d2e1a0ebb7f1a613c,50200023535069,-260612.41,60ec41ba55c00300382672d9,HDFC,direct expenses,5eecc6d6449e4f7cfb1c2708,2022-09-26T00:00:00.000Z,"NEFT DR-ICIC0006643-KRISHNA PACKAGING CO MPANY-NETBANK, MUM-N269222133855949-2490 98",,,net_banking_transfer,-249098
633d598d2e1a0ebb7f1a613e,50200023535069,-515612.41,60ec41ba55c00300382672d9,HDFC,SAAS/tech expense,5eecc6d6449e4f7cfb1c2708,2022-09-26T00:00:00.000Z,POS 514834XXXXXX9486 AMAZON,shopping,,debit_card,-255000
633d598d2e1a0ebb7f1a6141,50200023535069,-510361.87,60ec41ba55c00300382672d9,HDFC,Revenue-Mktplace,5eecc6d6449e4f7cfb1c2708,2022-09-26T00:00:00.000Z,NEFT CR-ICIC0000105-MANASH LIFESTYLE PRI VATE LIMITED NO-SLICK ORGANICS PRIVATE L IMITED MP M-ICIJ222690003698,shopping,,net_banking_transfer,5250.54
633d598d2e1a0ebb7f1a6143,50200023535069,-507222.41,60ec41ba55c00300382672d9,HDFC,Revenue-Mktplace,5eecc6d6449e4f7cfb1c2708,2022-09-26T00:00:00.000Z,NEFT CR-ICIC0000105-MANASH LIFESTYLE PRI VATE LIMITED NO-SLICK ORGANICS PRIVATE L IMITED MP G-ICIJ222690001622,shopping,,net_banking_transfer,3139.46
633d598d2e1a0ebb7f1a6145,50200023535069,-464456.41,60ec41ba55c00300382672d9,HDFC,Revenue-COD,5eecc6d6449e4f7cfb1c2708,2022-09-26T00:00:00.000Z,NEFT CR-ICIC0000155-SHIPROCKET COD CRF I D 4947452-SLICK ORGANICS PVT LTD-CMS2854 105892,insurance,insurance,net_banking_transfer,42766
633d598d2e1a0ebb7f1a6149,50200023535069,-449690.76,60ec41ba55c00300382672d9,HDFC,Revenue-PG-split enabled,5eecc6d6449e4f7cfb1c2708,2022-09-26T00:00:00.000Z,NEFT CR-UTIB0001506-RAZORPAY SOFTWARE PR IVATE LIMITED-SLICK ORGANICS PVT LITD-AX ISCN0168237240,insurance,insurance,net_banking_transfer,14765.65
633d598d2e1a0ebb7f1a614b,50200023535069,-449639.76,60ec41ba55c00300382672d9,HDFC,Transfer in/Revenue-other,5eecc6d6449e4f7cfb1c2708,2022-09-27T00:00:00.000Z,INT. ON SWCR ON-50300675642152,,,Other,51
633d598d2e1a0ebb7f1a614e,50200023535069,-396123.76,60ec41ba55c00300382672d9,HDFC,Loan-in,5eecc6d6449e4f7cfb1c2708,2022-09-27T00:00:00.000Z,SWEEP-IN CREDIT - 50300675642152,,,self_transfer,53516
633d598d2e1a0ebb7f1a6150,50200023535069,-396108.76,60ec41ba55c00300382672d9,HDFC,Transfer in/Revenue-other,5eecc6d6449e4f7cfb1c2708,2022-09-27T00:00:00.000Z,INT. ON SWCR ON-50300663920102,,,Other,15
633d598d2e1a0ebb7f1a6152,50200023535069,-390778.76,60ec41ba55c00300382672d9,HDFC,Loan-in,5eecc6d6449e4f7cfb1c2708,2022-09-27T00:00:00.000Z,SWEEP-IN CREDIT - 50300663920102,,,self_transfer,5330
633d598d2e1a0ebb7f1a6155,50200023535069,-389932.76,60ec41ba55c00300382672d9,HDFC,Transfer in/Revenue-other,5eecc6d6449e4f7cfb1c2708,2022-09-27T00:00:00.000Z,INT. ON SWCR ON-50300653995829,,,Other,846
633d598d2e1a0ebb7f1a6157,50200023535069,-193778.76,60ec41ba55c00300382672d9,HDFC,Loan-in,5eecc6d6449e4f7cfb1c2708,2022-09-27T00:00:00.000Z,SWEEP-IN CREDIT - 50300653995829,,,self_transfer,196154
633d598d2e1a0ebb7f1a6159,50200023535069,-193767.76,60ec41ba55c00300382672d9,HDFC,Transfer in/Revenue-other,5eecc6d6449e4f7cfb1c2708,2022-09-27T00:00:00.000Z,INT. ON SWCR ON-50300675642152,,,Other,11
633d598d2e1a0ebb7f1a615c,50200023535069,-182252.76,60ec41ba55c00300382672d9,HDFC,Loan-in,5eecc6d6449e4f7cfb1c2708,2022-09-27T00:00:00.000Z,SWEEP-IN CREDIT - 50300675642152,,,self_transfer,11515
633d598d2e1a0ebb7f1a615e,50200023535069,-182077.76,60ec41ba55c00300382672d9,HDFC,Transfer in/Revenue-other,5eecc6d6449e4f7cfb1c2708,2022-09-27T00:00:00.000Z,INT. ON SWCR ON-50300675642152,,,Other,175
633d598d2e1a0ebb7f1a6161,50200023535069,175.24,60ec41ba55c00300382672d9,HDFC,Loan-in,5eecc6d6449e4f7cfb1c2708,2022-09-27T00:00:00.000Z,SWEEP-IN CREDIT - 50300675642152,,,self_transfer,182253
633d598d2e1a0ebb7f1a6163,50200023535069,414572.12,60ec41ba55c00300382672d9,HDFC,Revenue-Mktplace,5eecc6d6449e4f7cfb1c2708,2022-09-27T00:00:00.000Z,IMPS-227005241226-AMAZON SELLER SERVIC-H SBC-XXXXXXXX6004-26VZ8ICSZVDUJBRKSLICK O RGANICS PVT LTD,shopping,,net_banking_transfer,414396.88
633d598d2e1a0ebb7f1a6165,50200023535069,592600.95,60ec41ba55c00300382672d9,HDFC,Revenue-Mktplace,5eecc6d6449e4f7cfb1c2708,2022-09-27T00:00:00.000Z,NEFT CR-DEUT0797BGL-AMAZON PAY (INDIA) P RIVATE LIMITED-SLICK ORGANICS PVT LTD-22 7000110GN00356,shopping,,net_banking_transfer,178028.83
633d598d2e1a0ebb7f1a6168,50200023535069,635373.77,60ec41ba55c00300382672d9,HDFC,Revenue-PG-non-split,5eecc6d6449e4f7cfb1c2708,2022-09-27T00:00:00.000Z,NEFT CR-PYTM0123456-PAYTM PAYMENTS SERVI CES LIMITED-SLICK ORGANICS PVT LTD-PYTM2 22709308848,insurance,insurance,net_banking_transfer,42772.82
633d598d2e1a0ebb7f1a616a,50200023535069,135373.77,60ec41ba55c00300382672d9,HDFC,direct expenses,5eecc6d6449e4f7cfb1c2708,2022-09-27T00:00:00.000Z,05892560000649-TPT-500000-DECORPAC INDIA PRIVATE LIMITED,,,net_banking_transfer,-500000
633d598d2e1a0ebb7f1a616d,50200023535069,85373.77,60ec41ba55c00300382672d9,HDFC,direct expenses,5eecc6d6449e4f7cfb1c2708,2022-09-27T00:00:00.000Z,02712120000086-TPT-50000-SPOTON LOGISTIC S PVT LTD,,,net_banking_transfer,-50000
633d598d2e1a0ebb7f1a616f,50200023535069,35373.77,60ec41ba55c00300382672d9,HDFC,direct expenses,5eecc6d6449e4f7cfb1c2708,2022-09-27T00:00:00.000Z,"NEFT DR-PUNB0062910-YADAVPACKAGING-NETBA NK, MUM-N270222134811290-50000",,,net_banking_transfer,-50000
633d598e2e1a0ebb7f1a6172,50200023535069,65193.76,60ec41ba55c00300382672d9,HDFC,Revenue-PG-split enabled,5eecc6d6449e4f7cfb1c2708,2022-09-27T00:00:00.000Z,NEFT CR-UTIB0001506-RAZORPAY SOFTWARE PR IVATE LIMITED-SLICK ORGANICS PVT LITD-AX ISCN0168306280,insurance,insurance,net_banking_transfer,29819.99
633d598e2e1a0ebb7f1a6175,50200023535069,23193.76,60ec41ba55c00300382672d9,HDFC,direct expenses,5eecc6d6449e4f7cfb1c2708,2022-09-27T00:00:00.000Z,"NEFT DR-ICIC0002451-SOUTH COURT CONDOMIN IUM ASSOCIATION-NETBANK, MUM-N2702221350 75492-42000",,,net_banking_transfer,-42000
633d598e2e1a0ebb7f1a6177,50200023535069,22499.76,60ec41ba55c00300382672d9,HDFC,SAAS/tech expense,5eecc6d6449e4f7cfb1c2708,2022-09-27T00:00:00.000Z,POS 514834XXXXXX9486 AMAZON,shopping,,debit_card,-694
633d598e2e1a0ebb7f1a617a,50200023535069,20851.76,60ec41ba55c00300382672d9,HDFC,direct expenses,5eecc6d6449e4f7cfb1c2708,2022-09-27T00:00:00.000Z,POS 514834XXXXXX9486 SMARTSHIFT LOGIS,,,debit_card,-1648
633d598e2e1a0ebb7f1a617d,50200023535069,-10879.24,60ec41ba55c00300382672d9,HDFC,direct expenses,5eecc6d6449e4f7cfb1c2708,2022-09-27T00:00:00.000Z,50100221217622-TPT-31731-NIKHIL KUMAR,,,net_banking_transfer,-31731
633d598e2e1a0ebb7f1a617f,50200023535069,-25979.24,60ec41ba55c00300382672d9,HDFC,direct expenses,5eecc6d6449e4f7cfb1c2708,2022-09-27T00:00:00.000Z,"NEFT DR-ICIC0006956-LAKSHAY CARRYING COR PORATION-NETBANK, MUM-N270222135315494-1 5100",,,net_banking_transfer,-15100
633d598e2e1a0ebb7f1a6182,50200023535069,70837.25,60ec41ba55c00300382672d9,HDFC,Revenue-PG-non-split,5eecc6d6449e4f7cfb1c2708,2022-09-27T00:00:00.000Z,NEFT CR-KKBK0000958-NODAL ACCOUNT BROKEN TUSK TECHNOL-SLICK ORGANICS PRIVATE LIMI TED-CMS2702227023828,insurance,insurance,net_banking_transfer,96816.49
633d598e2e1a0ebb7f1a6184,50200023535069,69958.25,60ec41ba55c00300382672d9,HDFC,direct expenses,5eecc6d6449e4f7cfb1c2708,2022-09-27T00:00:00.000Z,POS 514834XXXXXX9486 ADOBE SFTW INR,,,debit_card,-879
633d598e2e1a0ebb7f1a6187,50200023535069,67929.25,60ec41ba55c00300382672d9,HDFC,direct expenses,5eecc6d6449e4f7cfb1c2708,2022-09-27T00:00:00.000Z,POS 514834XXXXXX9486 ADOBE SFTW INR,,,debit_card,-2029
633d598e2e1a0ebb7f1a6189,50200023535069,83511.15,60ec41ba55c00300382672d9,HDFC,Revenue-PG-split enabled,5eecc6d6449e4f7cfb1c2708,2022-09-27T00:00:00.000Z,NEFT CR-UTIB0001506-RAZORPAY SOFTWARE PR IVATE LIMITED-SLICK ORGANICS PVT LITD-AX ISCN0168466482,insurance,insurance,net_banking_transfer,15581.9
633d598e2e1a0ebb7f1a618b,50200023535069,-67688.85,60ec41ba55c00300382672d9,HDFC,direct expenses,5eecc6d6449e4f7cfb1c2708,2022-09-27T00:00:00.000Z,"NEFT DR-ICIC0006303-ALT SPACE STUDIO-NET BANK, MUM-N270222136059411-151200",,,net_banking_transfer,-151200
633d598e2e1a0ebb7f1a618e,50200023535069,-87688.85,60ec41ba55c00300382672d9,HDFC,direct expenses,5eecc6d6449e4f7cfb1c2708,2022-09-27T00:00:00.000Z,50200039508087-TPT-20000-SHREE PUNCHMUKH I LOGISTICS,,,net_banking_transfer,-20000
633d598e2e1a0ebb7f1a6191,50200023535069,-87687.85,60ec41ba55c00300382672d9,HDFC,Revenue-PG-non-split,5eecc6d6449e4f7cfb1c2708,2022-09-28T00:00:00.000Z,IMPS-227100907572-BROKENTUSK TECHNOLOG-K KBK-XXXXXX9773-BANK VERIFICATION,,,net_banking_transfer,1
633d598e2e1a0ebb7f1a6193,50200023535069,-87676.85,60ec41ba55c00300382672d9,HDFC,Transfer in/Revenue-other,5eecc6d6449e4f7cfb1c2708,2022-09-28T00:00:00.000Z,INT. ON SWCR ON-50300675642152,,,Other,11
633d598e2e1a0ebb7f1a6195,50200023535069,-76796.85,60ec41ba55c00300382672d9,HDFC,Loan-in,5eecc6d6449e4f7cfb1c2708,2022-09-28T00:00:00.000Z,SWEEP-IN CREDIT - 50300675642152,,,self_transfer,10880
633d598e2e1a0ebb7f1a6198,50200023535069,-76781.85,60ec41ba55c00300382672d9,HDFC,Transfer in/Revenue-other,5eecc6d6449e4f7cfb1c2708,2022-09-28T00:00:00.000Z,INT. ON SWCR ON-50300675642152,,,Other,15
633d598e2e1a0ebb7f1a619a,50200023535069,-61681.85,60ec41ba55c00300382672d9,HDFC,Loan-in,5eecc6d6449e4f7cfb1c2708,2022-09-28T00:00:00.000Z,SWEEP-IN CREDIT - 50300675642152,,,self_transfer,15100
633d598e2e1a0ebb7f1a619d,50200023535069,-61640.85,60ec41ba55c00300382672d9,HDFC,Transfer in/Revenue-other,5eecc6d6449e4f7cfb1c2708,2022-09-28T00:00:00.000Z,INT. ON SWCR ON-50300675642152,,,Other,41
633d598e2e1a0ebb7f1a619f,50200023535069,-20775.85,60ec41ba55c00300382672d9,HDFC,Loan-in,5eecc6d6449e4f7cfb1c2708,2022-09-28T00:00:00.000Z,SWEEP-IN CREDIT - 50300675642152,,,self_transfer,40865
633d598e2e1a0ebb7f1a61a1,50200023535069,-20771.85,60ec41ba55c00300382672d9,HDFC,Transfer in/Revenue-other,5eecc6d6449e4f7cfb1c2708,2022-09-28T00:00:00.000Z,INT. ON SWCR ON-50300653995829,,,Other,4
633d598e2e1a0ebb7f1a61a4,50200023535069,-19926.85,60ec41ba55c00300382672d9,HDFC,Loan-in,5eecc6d6449e4f7cfb1c2708,2022-09-28T00:00:00.000Z,SWEEP-IN CREDIT - 50300653995829,,,self_transfer,845
633d598e2e1a0ebb7f1a61a6,50200023535069,-19839.85,60ec41ba55c00300382672d9,HDFC,Transfer in/Revenue-other,5eecc6d6449e4f7cfb1c2708,2022-09-28T00:00:00.000Z,INT. ON SWCR ON-50300653995829,,,Other,87
633d598e2e1a0ebb7f1a61a8,50200023535069,88.15,60ec41ba55c00300382672d9,HDFC,Loan-in,5eecc6d6449e4f7cfb1c2708,2022-09-28T00:00:00.000Z,SWEEP-IN CREDIT - 50300653995829,,,self_transfer,19928
633d598e2e1a0ebb7f1a61ab,50200023535069,25799,60ec41ba55c00300382672d9,HDFC,Revenue-PG-non-split,5eecc6d6449e4f7cfb1c2708,2022-09-28T00:00:00.000Z,NEFT CR-PYTM0123456-PAYTM PAYMENTS SERVI CES LIMITED-SLICK ORGANICS PVT LTD-PYTM2 22710700808,insurance,insurance,net_banking_transfer,25710.85
633d598e2e1a0ebb7f1a61ad,50200023535069,89906.68,60ec41ba55c00300382672d9,HDFC,Revenue-Mktplace,5eecc6d6449e4f7cfb1c2708,2022-09-28T00:00:00.000Z,NEFT CR-DEUT0797BGL-FLIPKART INTERNET PR IVATE LIMITED-SLICK ORGANICS PVT LTD-227 100159GN00114,shopping,,net_banking_transfer,64107.68
633d598e2e1a0ebb7f1a61af,50200023535069,103780.68,60ec41ba55c00300382672d9,HDFC,Transfer in/Revenue-other,5eecc6d6449e4f7cfb1c2708,2022-09-28T00:00:00.000Z,NEFT CR-HSBC0110002-NAPSA PRIVATE LIMITE D-SLICK ORGANICS PVT. LTD.-HSBCN22271929 363,,,net_banking_transfer,13874
633d598e2e1a0ebb7f1a61b2,50200023535069,134371.36,60ec41ba55c00300382672d9,HDFC,Revenue-PG-split enabled,5eecc6d6449e4f7cfb1c2708,2022-09-28T00:00:00.000Z,NEFT CR-UTIB0001506-RAZORPAY SOFTWARE PR,,,net_banking_transfer,30590.68
633d598e2e1a0ebb7f1a61b4,50200023535069,142493.54,60ec41ba55c00300382672d9,HDFC,Revenue-Mktplace,5eecc6d6449e4f7cfb1c2708,2022-09-28T00:00:00.000Z,NEFT CR-DEUT0797BGL-MYNTRA DESIGNS PRIVA TE LIMITED-SLICK ORGANICS PVT. LTD.-2271 00760GN00077,shopping,,net_banking_transfer,8122.18
633d598e2e1a0ebb7f1a61b8,50200023535069,1142493.54,60ec41ba55c00300382672d9,HDFC,Internal Transfers,5eecc6d6449e4f7cfb1c2708,2022-09-28T00:00:00.000Z,IB FUNDS TRANSFER CR-50200035187206 -SL ICK ORGANICS PVT LTD,insurance,insurance,Other,1000000
633d598e2e1a0ebb7f1a61ba,50200023535069,1162234.33,60ec41ba55c00300382672d9,HDFC,Revenue-Mktplace,5eecc6d6449e4f7cfb1c2708,2022-09-28T00:00:00.000Z,NEFT CR-HSBC0400002-AMAZON SERVICES LLC- SLICK ORGANICS PRIVATE LIMITED-HSBCN2227 1943674,shopping,,net_banking_transfer,19740.79
633d598e2e1a0ebb7f1a61bd,50200023535069,662234.33,60ec41ba55c00300382672d9,HDFC,direct expenses,5eecc6d6449e4f7cfb1c2708,2022-09-28T00:00:00.000Z,"NEFT DR-ICIC0000369-BO INTERNATIONAL-NET BANK, MUM-N271222136516870-500000",,,net_banking_transfer,-500000
633d598e2e1a0ebb7f1a61c2,50200023535069,412234.33,60ec41ba55c00300382672d9,HDFC,direct expenses,5eecc6d6449e4f7cfb1c2708,2022-09-28T00:00:00.000Z,"NEFT DR-YESB0000551-VISTTA COSMETICS-NET BANK, MUM-N271222136526443-250000",,,net_banking_transfer,-250000
633d598e2e1a0ebb7f1a61c4,50200023535069,112234.33,60ec41ba55c00300382672d9,HDFC,direct expenses,5eecc6d6449e4f7cfb1c2708,2022-09-28T00:00:00.000Z,"NEFT DR-SRCB0000281-3D TECHNOPACK PRIVAT E LIMITED-NETBANK, MUM-N271222136519084- 300000",,,net_banking_transfer,-300000
633d598e2e1a0ebb7f1a61c7,50200023535069,182170.73,60ec41ba55c00300382672d9,HDFC,Revenue-PG-non-split,5eecc6d6449e4f7cfb1c2708,2022-09-28T00:00:00.000Z,NEFT CR-KKBK0000958-NODAL ACCOUNT BROKEN TUSK TECHNOL-SLICK ORGANICS PRIVATE LIMI TED-CMS2712227130660,insurance,insurance,net_banking_transfer,69936.4
633d598e2e1a0ebb7f1a61c9,50200023535069,8982170.73,60ec41ba55c00300382672d9,HDFC,Internal Transfers,5eecc6d6449e4f7cfb1c2708,2022-09-28T00:00:00.000Z,IB FUNDS TRANSFER CR-50200035187206 -SL ICK ORGANICS PVT LTD,insurance,insurance,Other,8800000
633d598e2e1a0ebb7f1a61cb,50200023535069,9132170.73,60ec41ba55c00300382672d9,HDFC,Internal Transfers,5eecc6d6449e4f7cfb1c2708,2022-09-28T00:00:00.000Z,IB FUNDS TRANSFER CR-50200035187206 -SL ICK ORGANICS PVT LTD,insurance,insurance,Other,150000
633d598e2e1a0ebb7f1a61ce,50200023535069,8817170.73,60ec41ba55c00300382672d9,HDFC,direct expenses,5eecc6d6449e4f7cfb1c2708,2022-09-28T00:00:00.000Z,"NEFT DR-IDFB0040101-ACTIVES ADDITIVES AP PLICATIONS LLP-NETBANK, MUM-N27122213662 4926-315000",insurance,insurance,net_banking_transfer,-315000
633d598e2e1a0ebb7f1a61d0,50200023535069,8817334.92,60ec41ba55c00300382672d9,HDFC,Revenue-Mktplace,5eecc6d6449e4f7cfb1c2708,2022-09-28T00:00:00.000Z,NEFT CR-ICIC0000105-MANASH LIFESTYLE PRI VATE LIMITED NO-SLICK ORGANICS PRIVATE L IMITED MP G-ICIJ222710002927,shopping,,net_banking_transfer,164.19
633d598e2e1a0ebb7f1a61d2,50200023535069,8819093.43,60ec41ba55c00300382672d9,HDFC,Revenue-Mktplace,5eecc6d6449e4f7cfb1c2708,2022-09-28T00:00:00.000Z,NEFT CR-ICIC0000105-MANASH LIFESTYLE PRI VATE LIMITED NO-SLICK ORGANICS PRIVATE L IMITED MP M-ICIJ222710002928,shopping,,net_banking_transfer,1758.51
633d598e2e1a0ebb7f1a61d5,50200023535069,8765993.43,60ec41ba55c00300382672d9,HDFC,direct expenses,5eecc6d6449e4f7cfb1c2708,2022-09-28T00:00:00.000Z,NEFT DR-KKBK0005033-AMBARISH CHATTEJEE-N,,,net_banking_transfer,-53100
633d598e2e1a0ebb7f1a61d7,50200023535069,8715993.43,60ec41ba55c00300382672d9,HDFC,direct expenses,5eecc6d6449e4f7cfb1c2708,2022-09-28T00:00:00.000Z,POS 514834XXXXXX9486 GO DIGIT GENERAL,,,debit_card,-50000
633d598e2e1a0ebb7f1a61da,50200023535069,8718379.54,60ec41ba55c00300382672d9,HDFC,Transfer in/Revenue-other,5eecc6d6449e4f7cfb1c2708,2022-09-28T00:00:00.000Z,NEFT CR-UTIB0000114-ONE SIGMA TECHNOLOGI ES PRIVATE LIM-SLICK ORGANICS PRIVATE LI MITED-AXISP00322954800,insurance,insurance,net_banking_transfer,2386.11
633d598e2e1a0ebb7f1a61dc,50200023535069,8741226.04,60ec41ba55c00300382672d9,HDFC,Revenue-COD,5eecc6d6449e4f7cfb1c2708,2022-09-28T00:00:00.000Z,NEFT CR-ICIC0000155-SHIPROCKET COD CRF I D 4959744-SLICK ORGANICS PVT LTD-CMS2858 277120,insurance,insurance,net_banking_transfer,22846.5
633d598e2e1a0ebb7f1a61de,50200023535069,8757119.05,60ec41ba55c00300382672d9,HDFC,Revenue-PG-split enabled,5eecc6d6449e4f7cfb1c2708,2022-09-28T00:00:00.000Z,NEFT CR-UTIB0001506-RAZORPAY SOFTWARE PR IVATE LIMITED-SLICK ORGANICS PVT LITD-AX ISCN0168685375,insurance,insurance,net_banking_transfer,15893.01
633d598e2e1a0ebb7f1a61e1,50200023535069,8778299.28,60ec41ba55c00300382672d9,HDFC,Revenue-PG-non-split,5eecc6d6449e4f7cfb1c2708,2022-09-29T00:00:00.000Z,NEFT CR-PYTM0123456-PAYTM PAYMENTS SERVI CES LIMITED-SLICK ORGANICS PVT LTD-PYTM2 22722550406,insurance,insurance,net_banking_transfer,21180.23
633d598e2e1a0ebb7f1a61e3,50200023535069,8719771.28,60ec41ba55c00300382672d9,HDFC,direct expenses,5eecc6d6449e4f7cfb1c2708,2022-09-29T00:00:00.000Z,50200043297657-TPT-58528-AIDC PRODUCTS I NDIA PRIVATE LIMITED,,,net_banking_transfer,-58528
633d598e2e1a0ebb7f1a61e5,50200023535069,8519771.28,60ec41ba55c00300382672d9,HDFC,direct expenses,5eecc6d6449e4f7cfb1c2708,2022-09-29T00:00:00.000Z,"NEFT DR-SCBL0036031-PR PUNDIT PUBLIC REL ATIONS PRIVATE LIMIT-NETBANK, MUM-N27222 2137888440-200000",insurance,insurance,net_banking_transfer,-200000
633d598e2e1a0ebb7f1a61e8,50200023535069,8264771.28,60ec41ba55c00300382672d9,HDFC,SAAS/tech expense,5eecc6d6449e4f7cfb1c2708,2022-09-29T00:00:00.000Z,POS 514834XXXXXX9486 AMAZON,shopping,,debit_card,-255000
633d598e2e1a0ebb7f1a61ea,50200023535069,8292779.89,60ec41ba55c00300382672d9,HDFC,Revenue-PG-split enabled,5eecc6d6449e4f7cfb1c2708,2022-09-29T00:00:00.000Z,NEFT CR-UTIB0001506-RAZORPAY SOFTWARE PR IVATE LIMITED-SLICK ORGANICS PVT LITD-AX ISCN0168784272,insurance,insurance,net_banking_transfer,28008.61
633d598e2e1a0ebb7f1a61ed,50200023535069,8297335.47,60ec41ba55c00300382672d9,HDFC,Revenue-Mktplace,5eecc6d6449e4f7cfb1c2708,2022-09-29T00:00:00.000Z,NEFT CR-DEUT0797BGL-MYNTRA DESIGNS PRIVA TE LIMITED-SLICK ORGANICS PVT. LTD.-2272 00456GN00168,shopping,,net_banking_transfer,4555.58
633d598e2e1a0ebb7f1a61ef,50200023535069,8279935.47,60ec41ba55c00300382672d9,HDFC,direct expenses,5eecc6d6449e4f7cfb1c2708,2022-09-29T00:00:00.000Z,"NEFT DR-ICIC0000020-MANASH LIFESTYLE PRI VATE LIMITED-NETBANK, MUM-N2722221379720 61-17400",shopping,,net_banking_transfer,-17400
633d598e2e1a0ebb7f1a61f1,50200023535069,8279936.47,60ec41ba55c00300382672d9,HDFC,Transfer in/Revenue-other,5eecc6d6449e4f7cfb1c2708,2022-09-29T00:00:00.000Z,IMPS-227212004610-APIBANKING-RATN-XXXXXX XXXXXX0168-ACCOUNT VALIDATION,,,net_banking_transfer,1
633d598e2e1a0ebb7f1a61f4,50200023535069,8263565.75,60ec41ba55c00300382672d9,HDFC,direct expenses,5eecc6d6449e4f7cfb1c2708,2022-09-29T00:00:00.000Z,POS 514834XXXXXX9486 GUPSHUP INC,,,debit_card,-16370.72
633d598e2e1a0ebb7f1a61f6,50200023535069,8264676.24,60ec41ba55c00300382672d9,HDFC,Transfer in/Revenue-other,5eecc6d6449e4f7cfb1c2708,2022-09-29T00:00:00.000Z,NEFT CR-UTIB0000114-ONE SIGMA TECHNOLOGI ES PRIVATE LIM-SLICK ORGANICS PRIVATE LI MITED-AXISP00323347309,insurance,insurance,net_banking_transfer,1110.49
633d598e2e1a0ebb7f1a61f9,50200023535069,8335095.47,60ec41ba55c00300382672d9,HDFC,Revenue-PG-non-split,5eecc6d6449e4f7cfb1c2708,2022-09-29T00:00:00.000Z,NEFT CR-KKBK0000958-NODAL ACCOUNT BROKEN TUSK TECHNOL-SLICK ORGANICS PRIVATE LIMI TED-CMS2722227260489,insurance,insurance,net_banking_transfer,70419.23
633d598e2e1a0ebb7f1a61fb,50200023535069,335095.47,60ec41ba55c00300382672d9,HDFC,direct expenses,5eecc6d6449e4f7cfb1c2708,2022-09-29T00:00:00.000Z,FD BOOKED - 50300684649760 : SLICK ORGAN ICS PVT LTD,insurance,insurance,investment,-8000000
633d598e2e1a0ebb7f1a61fd,50200023535069,342990.85,60ec41ba55c00300382672d9,HDFC,Revenue-PG-split enabled,5eecc6d6449e4f7cfb1c2708,2022-09-29T00:00:00.000Z,NEFT CR-UTIB0001506-RAZORPAY SOFTWARE PR IVATE LIMITED-SLICK ORGANICS PVT LITD-AX ISCN0168961979,insurance,insurance,net_banking_transfer,7895.38
633d598e2e1a0ebb7f1a6200,50200023535069,341017.85,60ec41ba55c00300382672d9,HDFC,direct expenses,5eecc6d6449e4f7cfb1c2708,2022-09-29T00:00:00.000Z,POS 514834XXXXXX9486 SMARTSHIFT LOGIS,,,debit_card,-1973
633d598e2e1a0ebb7f1a6202,50200023535069,365308.62,60ec41ba55c00300382672d9,HDFC,Revenue-PG-non-split,5eecc6d6449e4f7cfb1c2708,2022-09-30T00:00:00.000Z,NEFT CR-PYTM0123456-PAYTM PAYMENTS SERVI CES LIMITED-SLICK ORGANICS PVT LTD-PYTM2 22734092460,insurance,insurance,net_banking_transfer,24290.77
633d598e2e1a0ebb7f1a6204,50200023535069,403361.08,60ec41ba55c00300382672d9,HDFC,Revenue-PG-split enabled,5eecc6d6449e4f7cfb1c2708,2022-09-30T00:00:00.000Z,NEFT CR-UTIB0001506-RAZORPAY SOFTWARE PR IVATE LIMITED-SLICK ORGANICS PVT LITD-AX ISCN0169083370,insurance,insurance,net_banking_transfer,38052.46
633d598e2e1a0ebb7f1a6207,50200023535069,523812.88,60ec41ba55c00300382672d9,HDFC,Revenue-PG-non-split,5eecc6d6449e4f7cfb1c2708,2022-09-30T00:00:00.000Z,NEFT CR-KKBK0000958-NODAL ACCOUNT BROKEN TUSK TECHNOL-SLICK ORGANICS PRIVATE LIMI TED-CMS2732227415150,insurance,insurance,net_banking_transfer,120451.8
633d598e2e1a0ebb7f1a6209,50200023535069,514812.88,60ec41ba55c00300382672d9,HDFC,direct expenses,5eecc6d6449e4f7cfb1c2708,2022-09-30T00:00:00.000Z,50100230430674-TPT-9000-KRITI MODI,,,net_banking_transfer,-9000
633d598f2e1a0ebb7f1a620c,50200023535069,521135.25,60ec41ba55c00300382672d9,HDFC,Transfer in/Revenue-other,5eecc6d6449e4f7cfb1c2708,2022-09-30T00:00:00.000Z,NEFT CR-UTIB0000114-ONE SIGMA TECHNOLOGI ES PRIVATE LIM-SLICK ORGANICS PRIVATE LI MITED-AXISP00323712834,insurance,insurance,net_banking_transfer,6322.37
633d598f2e1a0ebb7f1a620e,50200023535069,496135.25,60ec41ba55c00300382672d9,HDFC,direct expenses,5eecc6d6449e4f7cfb1c2708,2022-09-30T00:00:00.000Z,POS 514834XXXXXX9486 FLIPKART,shopping,,debit_card,-25000
633d598f2e1a0ebb7f1a6210,50200023535069,476135.25,60ec41ba55c00300382672d9,HDFC,direct expenses,5eecc6d6449e4f7cfb1c2708,2022-09-30T00:00:00.000Z,POS 514834XXXXXX9486 FLIPKART,shopping,,debit_card,-20000
633d598f2e1a0ebb7f1a6213,50200023535069,492284.98,60ec41ba55c00300382672d9,HDFC,Revenue-PG-split enabled,5eecc6d6449e4f7cfb1c2708,2022-09-30T00:00:00.000Z,NEFT CR-UTIB0001506-RAZORPAY SOFTWARE PR IVATE LIMITED-SLICK ORGANICS PVT LITD-AX ISCN0169318113,insurance,insurance,net_banking_transfer,16149.73
633d598f2e1a0ebb7f1a6215,50200023535069,473277.98,60ec41ba55c00300382672d9,HDFC,direct expenses,5eecc6d6449e4f7cfb1c2708,2022-09-30T00:00:00.000Z,POS 514834XXXXXX9486 MAKEMYTRIP INDIA,travel,,debit_card,-19007
633d598f2e1a0ebb7f1a6218,50200023535069,473098.98,60ec41ba55c00300382672d9,HDFC,SAAS/tech expense,5eecc6d6449e4f7cfb1c2708,2022-09-30T00:00:00.000Z,ME DC SI 514834XXXXXX9486 AMAZON,shopping,,Other,-179
633ed7bb2e1a0ebb7f308cde,50200023535069,458572.54,60ec41ba55c00300382672d9,HDFC,Revenue-PG-non-split,5eecc6d6449e4f7cfb1c2708,2022-07-19T00:00:00.000Z,IMPS-220004833662-PAYTM PAYMENTS SERVI-P YTM-XXXXXXXXXX0008-ALL202207192168200003 30830668628,ewallet,,net_banking_transfer,10628.65
633ed7bb2e1a0ebb7f308ce1,50200023535069,625398.52,60ec41ba55c00300382672d9,HDFC,Revenue-Mktplace,5eecc6d6449e4f7cfb1c2708,2022-07-19T00:00:00.000Z,IMPS-220005258235-AMAZON SELLER SERVIC-H,shopping,,net_banking_transfer,166825.98
633ed7bb2e1a0ebb7f308ce4,50200023535069,637275.92,60ec41ba55c00300382672d9,HDFC,Revenue-PG-split enabled,5eecc6d6449e4f7cfb1c2708,2022-07-19T00:00:00.000Z,NEFT CR-UTIB0001506-RAZORPAY SOFTWARE PR IVATE LIMITED-SLICK ORGANICS PVT LITD-AX ISCN0155477429,insurance,insurance,net_banking_transfer,11877.4
633ed7bb2e1a0ebb7f308ce7,50200023535069,1167176.36,60ec41ba55c00300382672d9,HDFC,Revenue-Mktplace,5eecc6d6449e4f7cfb1c2708,2022-07-19T00:00:00.000Z,NEFT CR-DEUT0797BGL-AMAZON PAY (INDIA) P RIVATE LIMITED-SLICK ORGANICS PVT LTD-22 0000143GN00126,shopping,,net_banking_transfer,529900.44
633ed7bb2e1a0ebb7f308ceb,50200023535069,817176.36,60ec41ba55c00300382672d9,HDFC,direct expenses,5eecc6d6449e4f7cfb1c2708,2022-07-19T00:00:00.000Z,"NEFT DR-KKBK0000180-VEDIC COSMECEUTICALS PVT LTD-NETBANK, MUM-N200222043497951-3 50000",,,net_banking_transfer,-350000
633ed7bb2e1a0ebb7f308cee,50200023535069,796386.36,60ec41ba55c00300382672d9,HDFC,direct expenses,5eecc6d6449e4f7cfb1c2708,2022-07-19T00:00:00.000Z,"NEFT DR-KKBK0000173-NITISH KUMAR MANDAL- NETBANK, MUM-N200222043594176-20790",,,net_banking_transfer,-20790
633ed7bb2e1a0ebb7f308cf1,50200023535069,514679.36,60ec41ba55c00300382672d9,HDFC,direct expenses,5eecc6d6449e4f7cfb1c2708,2022-07-19T00:00:00.000Z,"NEFT DR-PUNB0100110-KRAUTER HEALTHCARE L TD-NETBANK, MUM-N200222043630479-281707",,,net_banking_transfer,-281707
633ed7bb2e1a0ebb7f308cf4,50200023535069,519486.64,60ec41ba55c00300382672d9,HDFC,Transfer in/Revenue-other,5eecc6d6449e4f7cfb1c2708,2022-07-19T00:00:00.000Z,NEFT CR-UTIB0000114-ONE SIGMA TECHNOLOGI ES PRIVATE LIM-SLICK ORGANICS PRIVATE LI MITED-AXISP00304777471,insurance,insurance,net_banking_transfer,4807.28
633ed7bb2e1a0ebb7f308cf7,50200023535069,518423.64,60ec41ba55c00300382672d9,HDFC,direct expenses,5eecc6d6449e4f7cfb1c2708,2022-07-19T00:00:00.000Z,POS 514834XXXXXX9486 SMARTSHIFT LOGIS,,,debit_card,-1063
633ed7bb2e1a0ebb7f308cfa,50200023535069,517019.64,60ec41ba55c00300382672d9,HDFC,direct expenses,5eecc6d6449e4f7cfb1c2708,2022-07-19T00:00:00.000Z,POS 514834XXXXXX9486 SMARTSHIFT LOGIS,,,debit_card,-1404
633ed7bb2e1a0ebb7f308cfd,50200023535069,542962.32,60ec41ba55c00300382672d9,HDFC,Transfer in/Revenue-other,5eecc6d6449e4f7cfb1c2708,2022-07-19T00:00:00.000Z,"IMPS-220016657833-GOKWIK COMMERCE SOLU-I CIC-XXXXXXXX0630-PAYOUT FOR JULY 17, 202 2",,,net_banking_transfer,25942.68
633ed7bb2e1a0ebb7f308d00,50200023535069,542877.32,60ec41ba55c00300382672d9,HDFC,direct expenses,5eecc6d6449e4f7cfb1c2708,2022-07-19T00:00:00.000Z,POS 514834XXXXXX9486 SMARTSHIFT LOGIS,,,debit_card,-85
633ed7bb2e1a0ebb7f308d03,50200023535069,555020.21,60ec41ba55c00300382672d9,HDFC,Revenue-PG-split enabled,5eecc6d6449e4f7cfb1c2708,2022-07-19T00:00:00.000Z,NEFT CR-UTIB0001506-RAZORPAY SOFTWARE PR IVATE LIMITED-SLICK ORGANICS PVT LITD-AX ISCN0155614504,insurance,insurance,net_banking_transfer,12142.89
633ed7bb2e1a0ebb7f308d05,50200023535069,567078.05,60ec41ba55c00300382672d9,HDFC,Revenue-UPI,5eecc6d6449e4f7cfb1c2708,2022-07-19T00:00:00.000Z,UPI-GOKWIK-GOKWIK@YESBANK-YESB0000340-22 0088627679-PAYOUT FOR JULY 17,,,upi,12057.84
633ed7bb2e1a0ebb7f308d09,50200023535069,578642.46,60ec41ba55c00300382672d9,HDFC,Revenue-Mktplace,5eecc6d6449e4f7cfb1c2708,2022-07-20T00:00:00.000Z,NEFT CR-DEUT0797BGL-FLIPKART INTERNET PR IVATE LIMITED-SLICK ORGANICS PVT LTD-220 100146GN00040,shopping,,net_banking_transfer,11564.41
633ed7bb2e1a0ebb7f308d0d,50200023535069,584882.49,60ec41ba55c00300382672d9,HDFC,Revenue-PG-non-split,5eecc6d6449e4f7cfb1c2708,2022-07-20T00:00:00.000Z,NEFT CR-PYTM0123456-PAYTM PAYMENTS SERVI,ewallet,,net_banking_transfer,6240.03
633ed7bb2e1a0ebb7f308d10,50200023535069,534882.49,60ec41ba55c00300382672d9,HDFC,direct expenses,5eecc6d6449e4f7cfb1c2708,2022-07-20T00:00:00.000Z,"NEFT DR-KKBK0000173-MATRIX PRINTING SOLU TIONS PRIVATE LIMITE-NETBANK, MUM-N20122 2044693482-50000",,,net_banking_transfer,-50000
633ed7bb2e1a0ebb7f308d14,50200023535069,528052.49,60ec41ba55c00300382672d9,HDFC,direct expenses,5eecc6d6449e4f7cfb1c2708,2022-07-20T00:00:00.000Z,"NEFT DR-SIBL0000555-JAIVEER KUMAR-NETBAN K, MUM-N201222044758174-6830",,,net_banking_transfer,-6830
633ed7bb2e1a0ebb7f308d17,50200023535069,529706.89,60ec41ba55c00300382672d9,HDFC,Revenue-Mktplace,5eecc6d6449e4f7cfb1c2708,2022-07-20T00:00:00.000Z,NEFT CR-DEUT0797BGL-MYNTRA DESIGNS PRIVA TE LIMITED-SLICK ORGANICS PVT. LTD.-2201 00733GN00067,shopping,,net_banking_transfer,1654.4
633ed7bb2e1a0ebb7f308d1a,50200023535069,532468.59,60ec41ba55c00300382672d9,HDFC,Revenue-Mktplace,5eecc6d6449e4f7cfb1c2708,2022-07-20T00:00:00.000Z,NEFT CR-DEUT0797BGL-MYNTRA DESIGNS PRIVA TE LIMITED-SLICK ORGANICS PVT. LTD.-2201 00731GN00300,shopping,,net_banking_transfer,2761.7
633ed7bb2e1a0ebb7f308d1d,50200023535069,1932468.59,60ec41ba55c00300382672d9,HDFC,Internal Transfers,5eecc6d6449e4f7cfb1c2708,2022-07-20T00:00:00.000Z,IB FUNDS TRANSFER CR-50200035187206 -SL ICK ORGANICS PVT LTD,insurance,insurance,Other,1400000
633ed7bb2e1a0ebb7f308d21,50200023535069,2032468.59,60ec41ba55c00300382672d9,HDFC,Internal Transfers,5eecc6d6449e4f7cfb1c2708,2022-07-20T00:00:00.000Z,IB FUNDS TRANSFER CR-50200035187206 -SL ICK ORGANICS PVT LTD,insurance,insurance,Other,100000
633ed7bb2e1a0ebb7f308d23,50200023535069,355872.59,60ec41ba55c00300382672d9,HDFC,Tax,5eecc6d6449e4f7cfb1c2708,2022-07-20T00:00:00.000Z,051030820072211440- CBDT TAX,,,Other,-1676596
633ed7bb2e1a0ebb7f308d26,50200023535069,246695.59,60ec41ba55c00300382672d9,HDFC,direct expenses,5eecc6d6449e4f7cfb1c2708,2022-07-20T00:00:00.000Z,00921000075586-TPT-109177-ROET BINDRA,,,net_banking_transfer,-109177
633ed7bb2e1a0ebb7f308d29,50200023535069,269461.96,60ec41ba55c00300382672d9,HDFC,Revenue-PG-split enabled,5eecc6d6449e4f7cfb1c2708,2022-07-20T00:00:00.000Z,NEFT CR-UTIB0001506-RAZORPAY SOFTWARE PR IVATE LIMITED-SLICK ORGANICS PVT LITD-AX ISCN0155691218,insurance,insurance,net_banking_transfer,22766.37
633ed7bb2e1a0ebb7f308d2c,50200023535069,263869.44,60ec41ba55c00300382672d9,HDFC,direct expenses,5eecc6d6449e4f7cfb1c2708,2022-07-20T00:00:00.000Z,POS 514834XXXXXX9486 ECOMENGINE* FEED,,,debit_card,-5592.52
633ed7bc2e1a0ebb7f308d2f,50200023535069,169649.44,60ec41ba55c00300382672d9,HDFC,direct expenses,5eecc6d6449e4f7cfb1c2708,2022-07-20T00:00:00.000Z,"NEFT DR-SCBL0036046-INDOLEADS TECHNOLOGI ES P LTD-NETBANK, MUM-N201222044928517-9 4220",,,net_banking_transfer,-94220
633ed7bc2e1a0ebb7f308d32,50200023535069,169647.44,60ec41ba55c00300382672d9,HDFC,Marketing Expense,5eecc6d6449e4f7cfb1c2708,2022-07-20T00:00:00.000Z,ME DC SI 514834XXXXXX9486 LINKEDIN,,,Other,-2
633ed7bc2e1a0ebb7f308d35,50200023535069,169645.44,60ec41ba55c00300382672d9,HDFC,Marketing Expense,5eecc6d6449e4f7cfb1c2708,2022-07-20T00:00:00.000Z,ME DC SI 514834XXXXXX9486 LINKEDIN,,,Other,-2
633ed7bc2e1a0ebb7f308d38,50200023535069,173886.58,60ec41ba55c00300382672d9,HDFC,Transfer in/Revenue-other,5eecc6d6449e4f7cfb1c2708,2022-07-20T00:00:00.000Z,NEFT CR-UTIB0000114-ONE SIGMA TECHNOLOGI,,,net_banking_transfer,4241.14
633ed7bc2e1a0ebb7f308d3b,50200023535069,160198.58,60ec41ba55c00300382672d9,HDFC,direct expenses,5eecc6d6449e4f7cfb1c2708,2022-07-20T00:00:00.000Z,02898140000116-TPT-13688-TAXSOFT MARKETI NG PVT LTD,,,net_banking_transfer,-13688
633ed7bc2e1a0ebb7f308d3f,50200023535069,158714.58,60ec41ba55c00300382672d9,HDFC,direct expenses,5eecc6d6449e4f7cfb1c2708,2022-07-20T00:00:00.000Z,POS 514834XXXXXX9486 RAZ*SMARTSHIFT L,,,debit_card,-1484
633ed7bc2e1a0ebb7f308d42,50200023535069,108714.58,60ec41ba55c00300382672d9,HDFC,direct expenses,5eecc6d6449e4f7cfb1c2708,2022-07-20T00:00:00.000Z,"NEFT DR-PUNB0062910-YADAVPACKAGING-NETBA NK, MUM-N201222045324951-50000",,,net_banking_transfer,-50000
633ed7bc2e1a0ebb7f308d44,50200023535069,110798.53,60ec41ba55c00300382672d9,HDFC,Transfer in/Revenue-other,5eecc6d6449e4f7cfb1c2708,2022-07-20T00:00:00.000Z,"IMPS-220116581956-GOKWIK COMMERCE SOLU-I CIC-XXXXXXXX0630-PAYOUT FOR JULY 18, 202 2",,,net_banking_transfer,2083.95
633ed7bc2e1a0ebb7f308d47,50200023535069,123414.77,60ec41ba55c00300382672d9,HDFC,Revenue-PG-split enabled,5eecc6d6449e4f7cfb1c2708,2022-07-20T00:00:00.000Z,NEFT CR-UTIB0001506-RAZORPAY SOFTWARE PR IVATE LIMITED-SLICK ORGANICS PVT LITD-AX ISCN0155826737,insurance,insurance,net_banking_transfer,12616.24
633ed7bc2e1a0ebb7f308d4b,50200023535069,-176585.23,60ec41ba55c00300382672d9,HDFC,direct expenses,5eecc6d6449e4f7cfb1c2708,2022-07-20T00:00:00.000Z,"NEFT DR-YESB0000551-VISTTA COSMETICS-NET BANK, MUM-N201222045757617-300000",,,net_banking_transfer,-300000
633ed7bc2e1a0ebb7f308d4e,50200023535069,-156814.49,60ec41ba55c00300382672d9,HDFC,Revenue-UPI,5eecc6d6449e4f7cfb1c2708,2022-07-20T00:00:00.000Z,UPI-GOKWIK-GOKWIK@YESBANK-YESB0000340-22 0190983990-PAYOUT FOR JULY 18,,,upi,19770.74
633ed7bc2e1a0ebb7f308d51,50200023535069,-138523.24,60ec41ba55c00300382672d9,HDFC,Revenue-COD,5eecc6d6449e4f7cfb1c2708,2022-07-20T00:00:00.000Z,NEFT CR-ICIC0000155-SHIPROCKET COD CRF I D 4632110-SLICK ORGANICS PVT LTD-CMS2715 867588,insurance,insurance,net_banking_transfer,18291.25
633ed7bc2e1a0ebb7f308d54,50200023535069,0.76,60ec41ba55c00300382672d9,HDFC,Loan-in,5eecc6d6449e4f7cfb1c2708,2022-07-21T00:00:00.000Z,SWEEP-IN CREDIT - 50300653995829,,,self_transfer,138524
633ed7bc2e1a0ebb7f308d57,50200023535069,7951.49,60ec41ba55c00300382672d9,HDFC,Revenue-PG-non-split,5eecc6d6449e4f7cfb1c2708,2022-07-21T00:00:00.000Z,NEFT CR-PYTM0123456-PAYTM PAYMENTS SERVI CES LIMITED-SLICK ORGANICS PVT LTD-PYTM2 22026952436,insurance,insurance,net_banking_transfer,7950.73
633ed7bc2e1a0ebb7f308d5a,50200023535069,22727.3,60ec41ba55c00300382672d9,HDFC,Revenue-PG-split enabled,5eecc6d6449e4f7cfb1c2708,2022-07-21T00:00:00.000Z,NEFT CR-UTIB0001506-RAZORPAY SOFTWARE PR IVATE LIMITED-SLICK ORGANICS PVT LITD-AX ISCN0155913000,insurance,insurance,net_banking_transfer,14775.81
633ed7bc2e1a0ebb7f308d5d,50200023535069,21848.3,60ec41ba55c00300382672d9,HDFC,direct expenses,5eecc6d6449e4f7cfb1c2708,2022-07-21T00:00:00.000Z,POS 514834XXXXXX9486 SMARTSHIFT LOGIS,,,debit_card,-879
633ed7bc2e1a0ebb7f308d5f,50200023535069,32404.32,60ec41ba55c00300382672d9,HDFC,Transfer in/Revenue-other,5eecc6d6449e4f7cfb1c2708,2022-07-21T00:00:00.000Z,NEFT CR-UTIB0000114-ONE SIGMA TECHNOLOGI ES PRIVATE LIM-SLICK ORGANICS PRIVATE LI MITED-AXISP00305270359,insurance,insurance,net_banking_transfer,10556.02
633ed7bc2e1a0ebb7f308d62,50200023535069,-16735.68,60ec41ba55c00300382672d9,HDFC,direct expenses,5eecc6d6449e4f7cfb1c2708,2022-07-21T00:00:00.000Z,"NEFT DR-HSBC0400004-A LITTLE FLY-NETBANK , MUM-N202222046642603-49140",,,net_banking_transfer,-49140
633ed7bc2e1a0ebb7f308d65,50200023535069,-10630.68,60ec41ba55c00300382672d9,HDFC,Revenue-Mktplace,5eecc6d6449e4f7cfb1c2708,2022-07-21T00:00:00.000Z,NEFT CR-ICIC0000985-DIGITAL AGE RETAIL P,,,net_banking_transfer,6105
633ed7bc2e1a0ebb7f308d68,50200023535069,-10629.68,60ec41ba55c00300382672d9,HDFC,Revenue-Mktplace,5eecc6d6449e4f7cfb1c2708,2022-07-21T00:00:00.000Z,NEFT CR-DEUT0797BGL-MYNTRA DESIGNS PRIVA TE LIMITED-SLICK ORGANICS - SJIT-2202007 37GN00002,shopping,,net_banking_transfer,1
633ed7bc2e1a0ebb7f308d6b,50200023535069,-10857.68,60ec41ba55c00300382672d9,HDFC,direct expenses,5eecc6d6449e4f7cfb1c2708,2022-07-21T00:00:00.000Z,POS 514834XXXXXX9486 RAZ*SMARTSHIFT L,,,debit_card,-228
633ed7bc2e1a0ebb7f308d6e,50200023535069,77300.11,60ec41ba55c00300382672d9,HDFC,Revenue-Mktplace,5eecc6d6449e4f7cfb1c2708,2022-07-21T00:00:00.000Z,NEFT CR-KKBK0000958-NYKAA E RETAIL PRIVA TE LIMITED NYKAA-SLICK ORGANICS PVT LTD- KKBK222023372280,insurance,insurance,net_banking_transfer,88157.79
633ed7bc2e1a0ebb7f308d71,50200023535069,116715.69,60ec41ba55c00300382672d9,HDFC,Revenue-UPI,5eecc6d6449e4f7cfb1c2708,2022-07-21T00:00:00.000Z,UPI-GOKWIK-GOKWIK@YESBANK-YESB0000340-22 0293575415-PAYOUT FOR JULY 19,,,upi,39415.58
633ed7bc2e1a0ebb7f308d74,50200023535069,125760.66,60ec41ba55c00300382672d9,HDFC,Revenue-PG-split enabled,5eecc6d6449e4f7cfb1c2708,2022-07-21T00:00:00.000Z,NEFT CR-UTIB0001506-RAZORPAY SOFTWARE PR IVATE LIMITED-SLICK ORGANICS PVT LITD-AX ISCN0156046311,insurance,insurance,net_banking_transfer,9044.97
633ed7bc2e1a0ebb7f308d76,50200023535069,-99239.34,60ec41ba55c00300382672d9,HDFC,direct expenses,5eecc6d6449e4f7cfb1c2708,2022-07-21T00:00:00.000Z,50200031284040-TPT-225000-BURGEON LAW LL P,,,net_banking_transfer,-225000
633ed7bc2e1a0ebb7f308d7a,50200023535069,-98346.34,60ec41ba55c00300382672d9,HDFC,Transfer in/Revenue-other,5eecc6d6449e4f7cfb1c2708,2022-07-21T00:00:00.000Z,NEFT CR-HSBC0560002-INNOVATIVE RETAIL CO NCEPTS PRIVATE-SLICK ORGANICS PVT LTD-HS BCN22202213194,,,net_banking_transfer,893
633ed7bc2e1a0ebb7f308d7d,50200023535069,-97763.34,60ec41ba55c00300382672d9,HDFC,Transfer in/Revenue-other,5eecc6d6449e4f7cfb1c2708,2022-07-21T00:00:00.000Z,NEFT CR-HSBC0560002-INNOVATIVE RETAIL CO NCEPTS PRIVATE-SLICK ORGANICS PVT LTD-HS BCN22202213075,,,net_banking_transfer,583
633ed7bc2e1a0ebb7f308d80,50200023535069,-96174.34,60ec41ba55c00300382672d9,HDFC,Transfer in/Revenue-other,5eecc6d6449e4f7cfb1c2708,2022-07-21T00:00:00.000Z,NEFT CR-HSBC0560002-INNOVATIVE RETAIL CO NCEPTS PRIVATE-SLICK ORGANICS PVT LTD-HS BCN22202213300,,,net_banking_transfer,1589
633ed7bc2e1a0ebb7f308d83,50200023535069,-79438.34,60ec41ba55c00300382672d9,HDFC,Loan-in,5eecc6d6449e4f7cfb1c2708,2022-07-22T00:00:00.000Z,SWEEP-IN CREDIT - 50300653995829,,,self_transfer,16736
633ed7bc2e1a0ebb7f308d86,50200023535069,0.66,60ec41ba55c00300382672d9,HDFC,Loan-in,5eecc6d6449e4f7cfb1c2708,2022-07-22T00:00:00.000Z,SWEEP-IN CREDIT - 50300653995829,,,self_transfer,79439
633ed7bc2e1a0ebb7f308d89,50200023535069,7698.06,60ec41ba55c00300382672d9,HDFC,Revenue-Mktplace,5eecc6d6449e4f7cfb1c2708,2022-07-22T00:00:00.000Z,NEFT CR-DEUT0797BGL-FLIPKART INTERNET PR IVATE LIMITED-SLICK ORGANICS PVT LTD-220 300101GN00161,shopping,,net_banking_transfer,7697.4
633ed7bc2e1a0ebb7f308d8c,50200023535069,27191.03,60ec41ba55c00300382672d9,HDFC,Revenue-PG-non-split,5eecc6d6449e4f7cfb1c2708,2022-07-22T00:00:00.000Z,IMPS-220304045556-PAYTM PAYMENTS SERVI-P,ewallet,,net_banking_transfer,19492.97
633ed7bc2e1a0ebb7f308d8f,50200023535069,31542.7,60ec41ba55c00300382672d9,HDFC,Revenue-Mktplace,5eecc6d6449e4f7cfb1c2708,2022-07-22T00:00:00.000Z,NEFT CR-DEUT0797BGL-MYNTRA DESIGNS PRIVA TE LIMITED-SLICK ORGANICS PVT. LTD.-2203 00709GN00269,shopping,,net_banking_transfer,4351.67
633ed7bc2e1a0ebb7f308d91,50200023535069,43107.01,60ec41ba55c00300382672d9,HDFC,Revenue-Mktplace,5eecc6d6449e4f7cfb1c2708,2022-07-22T00:00:00.000Z,NEFT CR-DEUT0797BGL-MYNTRA DESIGNS PRIVA TE LIMITED-SLICK ORGANICS PVT. LTD.-2203 00714GN00002,shopping,,net_banking_transfer,11564.31
633ed7bc2e1a0ebb7f308d94,50200023535069,61221.71,60ec41ba55c00300382672d9,HDFC,Revenue-PG-split enabled,5eecc6d6449e4f7cfb1c2708,2022-07-22T00:00:00.000Z,NEFT CR-UTIB0001506-RAZORPAY SOFTWARE PR IVATE LIMITED-SLICK ORGANICS PVT LITD-AX ISCN0156137452,insurance,insurance,net_banking_transfer,18114.7
633ed7bc2e1a0ebb7f308d97,50200023535069,-14378.29,60ec41ba55c00300382672d9,HDFC,direct expenses,5eecc6d6449e4f7cfb1c2708,2022-07-22T00:00:00.000Z,50200044693544-TPT-75600-POCKET ACES PIC TURES PRIVATE LIMITED,,,net_banking_transfer,-75600
633ed7bc2e1a0ebb7f308d9c,50200023535069,-16521.29,60ec41ba55c00300382672d9,HDFC,direct expenses,5eecc6d6449e4f7cfb1c2708,2022-07-22T00:00:00.000Z,POS 514834XXXXXX9486 SWIGGY,food,,debit_card,-2143
633ed7bc2e1a0ebb7f308d9f,50200023535069,-15661.3,60ec41ba55c00300382672d9,HDFC,Revenue-PG-non-split,5eecc6d6449e4f7cfb1c2708,2022-07-22T00:00:00.000Z,NEFT CR-YESB0000001-RZPX PVT LTD NODAL A CCOUNT-SLICKORGANICS-YESB22039912099,insurance,insurance,net_banking_transfer,859.99
633ed7bc2e1a0ebb7f308da4,50200023535069,-11553.02,60ec41ba55c00300382672d9,HDFC,Transfer in/Revenue-other,5eecc6d6449e4f7cfb1c2708,2022-07-22T00:00:00.000Z,NEFT CR-UTIB0000114-ONE SIGMA TECHNOLOGI ES PRIVATE LIM-SLICK ORGANICS PRIVATE LI MITED-AXISP00305614177,insurance,insurance,net_banking_transfer,4108.28
633ed7bc2e1a0ebb7f308da6,50200023535069,-11663.02,60ec41ba55c00300382672d9,HDFC,direct expenses,5eecc6d6449e4f7cfb1c2708,2022-07-22T00:00:00.000Z,POS 514834XXXXXX9486 SMARTSHIFT LOGIS,,,debit_card,-110
633ed7bc2e1a0ebb7f308da9,50200023535069,-511663.02,60ec41ba55c00300382672d9,HDFC,direct expenses,5eecc6d6449e4f7cfb1c2708,2022-07-22T00:00:00.000Z,"NEFT DR-ICIC0000369-BO INTERNATIONAL-NET BANK, MUM-N203222047824211-500000",,,net_banking_transfer,-500000
633ed7bc2e1a0ebb7f308dad,50200023535069,-1111663.02,60ec41ba55c00300382672d9,HDFC,Tax,5eecc6d6449e4f7cfb1c2708,2022-07-22T00:00:00.000Z,051030822072232201- CBDT TAX,,,Other,-600000
633ed7bc2e1a0ebb7f308db0,50200023535069,-1087075.29,60ec41ba55c00300382672d9,HDFC,Transfer in/Revenue-other,5eecc6d6449e4f7cfb1c2708,2022-07-22T00:00:00.000Z,"IMPS-220316276731-GOKWIK COMMERCE SOLU-I CIC-XXXXXXXX0630-PAYOUT FOR JULY 20, 202 2",,,net_banking_transfer,24587.73
633ed7bc2e1a0ebb7f308db3,50200023535069,-1081414.88,60ec41ba55c00300382672d9,HDFC,Revenue-PG-split enabled,5eecc6d6449e4f7cfb1c2708,2022-07-22T00:00:00.000Z,NEFT CR-UTIB0001506-RAZORPAY SOFTWARE PR IVATE LIMITED-SLICK ORGANICS PVT LITD-AX ISCN0156291708,insurance,insurance,net_banking_transfer,5660.41
633ed7bc2e1a0ebb7f308db5,50200023535069,-1077612.82,60ec41ba55c00300382672d9,HDFC,Revenue-UPI,5eecc6d6449e4f7cfb1c2708,2022-07-22T00:00:00.000Z,UPI-GOKWIK-GOKWIK@YESBANK-YESB0000340-22 0395942475-PAYOUT FOR JULY 20,,,upi,3802.06
633ed7bc2e1a0ebb7f308db8,50200023535069,-1056475.05,60ec41ba55c00300382672d9,HDFC,Revenue-COD,5eecc6d6449e4f7cfb1c2708,2022-07-22T00:00:00.000Z,NEFT CR-ICIC0000155-SHIPROCKET COD CRF I,,,net_banking_transfer,21137.77
633ed7bc2e1a0ebb7f308dbb,50200023535069,-1054332.05,60ec41ba55c00300382672d9,HDFC,Loan-in,5eecc6d6449e4f7cfb1c2708,2022-07-23T00:00:00.000Z,SWEEP-IN CREDIT - 50300653995829,,,self_transfer,2143
633ed7bc2e1a0ebb7f308dbe,50200023535069,-1039953.05,60ec41ba55c00300382672d9,HDFC,Loan-in,5eecc6d6449e4f7cfb1c2708,2022-07-23T00:00:00.000Z,SWEEP-IN CREDIT - 50300653995829,,,self_transfer,14379
633ed7bc2e1a0ebb7f308dc1,50200023535069,-544811.05,60ec41ba55c00300382672d9,HDFC,Loan-in,5eecc6d6449e4f7cfb1c2708,2022-07-23T00:00:00.000Z,SWEEP-IN CREDIT - 50300653995829,,,self_transfer,495142
633ed7bc2e1a0ebb7f308dc3,50200023535069,0.95,60ec41ba55c00300382672d9,HDFC,Loan-in,5eecc6d6449e4f7cfb1c2708,2022-07-23T00:00:00.000Z,SWEEP-IN CREDIT - 50300653995829,,,self_transfer,544812
633ed7bc2e1a0ebb7f308dc6,50200023535069,6437.32,60ec41ba55c00300382672d9,HDFC,Revenue-PG-non-split,5eecc6d6449e4f7cfb1c2708,2022-07-23T00:00:00.000Z,NEFT CR-PYTM0123456-PAYTM PAYMENTS SERVI CES LIMITED-SLICK ORGANICS PVT LTD-PYTM2 22040022893,insurance,insurance,net_banking_transfer,6436.37
633ed7bc2e1a0ebb7f308dc9,50200023535069,43680.67,60ec41ba55c00300382672d9,HDFC,Transfer in/Revenue-other,5eecc6d6449e4f7cfb1c2708,2022-07-23T00:00:00.000Z,"IMPS-220416084499-GOKWIK COMMERCE SOLU-I CIC-XXXXXXXX0630-PAYOUT FOR JULY 21, 202 2",,,net_banking_transfer,37243.35
633ed7bc2e1a0ebb7f308dcc,50200023535069,50374.41,60ec41ba55c00300382672d9,HDFC,Revenue-PG-non-split,5eecc6d6449e4f7cfb1c2708,2022-07-24T00:00:00.000Z,NEFT CR-PYTM0123456-PAYTM PAYMENTS SERVI CES LIMITED-SLICK ORGANICS PVT LTD-PYTM2 22051089141,insurance,insurance,net_banking_transfer,6693.74
633ed7bc2e1a0ebb7f308dcf,50200023535069,68118.22,60ec41ba55c00300382672d9,HDFC,Transfer in/Revenue-other,5eecc6d6449e4f7cfb1c2708,2022-07-24T00:00:00.000Z,"IMPS-220516400271-GOKWIK COMMERCE SOLU-I CIC-XXXXXXXX0630-PAYOUT FOR JULY 22, 202 2",,,net_banking_transfer,17743.81
633ed7bc2e1a0ebb7f308dd2,50200023535069,81937.3,60ec41ba55c00300382672d9,HDFC,Revenue-Mktplace,5eecc6d6449e4f7cfb1c2708,2022-07-25T00:00:00.000Z,NEFT CR-DEUT0797BGL-FLIPKART INTERNET PR IVATE LIMITED-SLICK ORGANICS PVT LTD-220 600134GN00024,shopping,,net_banking_transfer,13819.08
633ed7bc2e1a0ebb7f308dd5,50200023535069,84507.07,60ec41ba55c00300382672d9,HDFC,Revenue-PG-non-split,5eecc6d6449e4f7cfb1c2708,2022-07-25T00:00:00.000Z,NEFT CR-PYTM0123456-PAYTM PAYMENTS SERVI CES LIMITED-SLICK ORGANICS PVT LTD-PYTM2 22062375124,insurance,insurance,net_banking_transfer,2569.77
633ed7bc2e1a0ebb7f308dd8,50200023535069,99988.9,60ec41ba55c00300382672d9,HDFC,Revenue-Mktplace,5eecc6d6449e4f7cfb1c2708,2022-07-25T00:00:00.000Z,NEFT CR-DEUT0797BGL-MYNTRA DESIGNS PRIVA TE LIMITED-SLICK ORGANICS PVT. LTD.-2206 00736GN00071,shopping,,net_banking_transfer,15481.83
633ed7bc2e1a0ebb7f308ddb,50200023535069,105450.12,60ec41ba55c00300382672d9,HDFC,Revenue-Mktplace,5eecc6d6449e4f7cfb1c2708,2022-07-25T00:00:00.000Z,NEFT CR-DEUT0797BGL-MYNTRA DESIGNS PRIVA TE LIMITED-SLICK ORGANICS PVT. LTD.-2206 00735GN00010,shopping,,net_banking_transfer,5461.22
633ed7bc2e1a0ebb7f308ddd,50200023535069,180660.57,60ec41ba55c00300382672d9,HDFC,Revenue-PG-split enabled,5eecc6d6449e4f7cfb1c2708,2022-07-25T00:00:00.000Z,NEFT CR-UTIB0001506-RAZORPAY SOFTWARE PR,,,net_banking_transfer,75210.45
633ed7bd2e1a0ebb7f308de0,50200023535069,200660.57,60ec41ba55c00300382672d9,HDFC,Transfer in/Revenue-other,5eecc6d6449e4f7cfb1c2708,2022-07-25T00:00:00.000Z,NEFT CR-UTIB0000540-DETLACMA PRIVATE LIM ITED-SLICK ORGANICS PVT LTD-AXIC22206241 4389,,,net_banking_transfer,20000
633ed7bd2e1a0ebb7f308de3,50200023535069,204634.18,60ec41ba55c00300382672d9,HDFC,Revenue-PG-non-split,5eecc6d6449e4f7cfb1c2708,2022-07-25T00:00:00.000Z,NEFT CR-SCBL0036001-STRIPE INDIA PRIVATE -SLICK ORGANICS PRIVATE LIMITED-SSG17413 Q0733812,insurance,insurance,net_banking_transfer,3973.61
633ed7bd2e1a0ebb7f308de7,50200023535069,210471.24,60ec41ba55c00300382672d9,HDFC,Transfer in/Revenue-other,5eecc6d6449e4f7cfb1c2708,2022-07-25T00:00:00.000Z,NEFT CR-UTIB0000114-ONE SIGMA TECHNOLOGI ES PRIVATE LIM-SLICK ORGANICS PRIVATE LI MITED-AXISP00305967867,insurance,insurance,net_banking_transfer,5837.06
633ed7bd2e1a0ebb7f308dea,50200023535069,216534.98,60ec41ba55c00300382672d9,HDFC,Transfer in/Revenue-other,5eecc6d6449e4f7cfb1c2708,2022-07-25T00:00:00.000Z,NEFT CR-UTIB0000114-ONE SIGMA TECHNOLOGI ES PRIVATE LIM-SLICK ORGANICS PRIVATE LI MITED-AXISP00305967520,insurance,insurance,net_banking_transfer,6063.74
633ed7bd2e1a0ebb7f308ded,50200023535069,38291.98,60ec41ba55c00300382672d9,HDFC,direct expenses,5eecc6d6449e4f7cfb1c2708,2022-07-25T00:00:00.000Z,"NEFT DR-UTIB0000119-SAFEXPRESS-NETBANK, MUM-N206222050214294-178243",,,net_banking_transfer,-178243
633ed7bd2e1a0ebb7f308df0,50200023535069,-198808.02,60ec41ba55c00300382672d9,HDFC,Tax,5eecc6d6449e4f7cfb1c2708,2022-07-25T00:00:00.000Z,051030825072245354- CBDT TAX,,,Other,-237100
633ed7bd2e1a0ebb7f308df5,50200023535069,-155398.38,60ec41ba55c00300382672d9,HDFC,Transfer in/Revenue-other,5eecc6d6449e4f7cfb1c2708,2022-07-25T00:00:00.000Z,"IMPS-220616018762-GOKWIK COMMERCE SOLU-I CIC-XXXXXXXX0630-PAYOUT FOR JULY 23, 202 2",,,net_banking_transfer,43409.64
633ed7bd2e1a0ebb7f308df7,50200023535069,-152735.38,60ec41ba55c00300382672d9,HDFC,Revenue-Mktplace,5eecc6d6449e4f7cfb1c2708,2022-07-25T00:00:00.000Z,NEFT CR-SCBL0036001-DREAMPLUG TECHNOLOGI ES PRIVATE LIMITED-SLICK ORGANICS PRIVAT E LIMITEDSLICK-IN1ON22072503HTK,,,net_banking_transfer,2663
633ed7bd2e1a0ebb7f308dfa,50200023535069,-151394.38,60ec41ba55c00300382672d9,HDFC,Transfer in/Revenue-other,5eecc6d6449e4f7cfb1c2708,2022-07-25T00:00:00.000Z,FT - CR - 50200038726231 - HOUSE OF BEAU TY PRIVATE LIMITED,,,Other,1341
633ed7bd2e1a0ebb7f308dfd,50200023535069,-117360.54,60ec41ba55c00300382672d9,HDFC,Revenue-COD,5eecc6d6449e4f7cfb1c2708,2022-07-25T00:00:00.000Z,NEFT CR-ICIC0000155-SHIPROCKET COD CRF I D 4652575-SLICK ORGANICS PVT LTD-CMS2725 722478,insurance,insurance,net_banking_transfer,34033.84
633ed7bd2e1a0ebb7f308e01,50200023535069,-62816.2,60ec41ba55c00300382672d9,HDFC,Revenue-PG-split enabled,5eecc6d6449e4f7cfb1c2708,2022-07-25T00:00:00.000Z,NEFT CR-UTIB0001506-RAZORPAY SOFTWARE PR IVATE LIMITED-SLICK ORGANICS PVT LITD-AX ISCN0156791819,insurance,insurance,net_banking_transfer,54544.34
633ed7bd2e1a0ebb7f308e04,50200023535069,-62814.2,60ec41ba55c00300382672d9,HDFC,Transfer in/Revenue-other,5eecc6d6449e4f7cfb1c2708,2022-07-25T00:00:00.000Z,CRV POS 514834******9486 LINKEDIN,,,refund,2
633ed7bd2e1a0ebb7f308e07,50200023535069,-62812.2,60ec41ba55c00300382672d9,HDFC,Transfer in/Revenue-other,5eecc6d6449e4f7cfb1c2708,2022-07-25T00:00:00.000Z,CRV POS 514834******9486 LINKEDIN,,,refund,2
633ed7bd2e1a0ebb7f308e09,50200023535069,-62791.2,60ec41ba55c00300382672d9,HDFC,Transfer in/Revenue-other,5eecc6d6449e4f7cfb1c2708,2022-07-26T00:00:00.000Z,INT. ON SWCR ON-50300653995829,,,Other,21
633ed7bd2e1a0ebb7f308e0c,50200023535069,21.8,60ec41ba55c00300382672d9,HDFC,Loan-in,5eecc6d6449e4f7cfb1c2708,2022-07-26T00:00:00.000Z,SWEEP-IN CREDIT - 50300653995829,,,self_transfer,62813
633ed7bd2e1a0ebb7f308e0f,50200023535069,180616.28,60ec41ba55c00300382672d9,HDFC,Revenue-Mktplace,5eecc6d6449e4f7cfb1c2708,2022-07-26T00:00:00.000Z,IMPS-220705031303-AMAZON SELLER SERVIC-H SBC-XXXXXXXX6004-3A7RPBR6OQRA7PNMSLICK O RGANICS PVT LTD,shopping,,net_banking_transfer,180594.48
633ed7bd2e1a0ebb7f308e13,50200023535069,228064.58,60ec41ba55c00300382672d9,HDFC,Revenue-PG-non-split,5eecc6d6449e4f7cfb1c2708,2022-07-26T00:00:00.000Z,NEFT CR-PYTM0123456-PAYTM PAYMENTS SERVI CES LIMITED-SLICK ORGANICS PVT LTD-PYTM2 22073858141,insurance,insurance,net_banking_transfer,47448.3
633ed7bd2e1a0ebb7f308e16,50200023535069,268060.98,60ec41ba55c00300382672d9,HDFC,Revenue-PG-split enabled,5eecc6d6449e4f7cfb1c2708,2022-07-26T00:00:00.000Z,NEFT CR-UTIB0001506-RAZORPAY SOFTWARE PR IVATE LIMITED-SLICK ORGANICS PVT LITD-AX ISCN0156869760,insurance,insurance,net_banking_transfer,39996.4
633ed7bd2e1a0ebb7f308e1a,50200023535069,772041.66,60ec41ba55c00300382672d9,HDFC,Revenue-Mktplace,5eecc6d6449e4f7cfb1c2708,2022-07-26T00:00:00.000Z,NEFT CR-DEUT0797BGL-AMAZON PAY (INDIA) P RIVATE LIMITED-SLICK ORGANICS PVT LTD-22 0700145GN00149,shopping,,net_banking_transfer,503980.68
633ed7bd2e1a0ebb7f308e1c,50200023535069,272041.66,60ec41ba55c00300382672d9,HDFC,direct expenses,5eecc6d6449e4f7cfb1c2708,2022-07-26T00:00:00.000Z,"NEFT DR-ICIC0000369-BO INTERNATIONAL-NET BANK, MUM-N207222051313669-500000",,,net_banking_transfer,-500000
633ed7bd2e1a0ebb7f308e1f,50200023535069,-27958.34,60ec41ba55c00300382672d9,HDFC,direct expenses,5eecc6d6449e4f7cfb1c2708,2022-07-26T00:00:00.000Z,05892560000649-TPT-300000-DECORPAC INDIA PRIVATE LIMITED,,,net_banking_transfer,-300000
633ed7bd2e1a0ebb7f308e22,50200023535069,-302958.34,60ec41ba55c00300382672d9,HDFC,direct expenses,5eecc6d6449e4f7cfb1c2708,2022-07-26T00:00:00.000Z,05892560000649-TPT-275000-DECORPAC INDIA PRIVATE LIMITED,,,net_banking_transfer,-275000
633ed7bd2e1a0ebb7f308e25,50200023535069,-352958.34,60ec41ba55c00300382672d9,HDFC,direct expenses,5eecc6d6449e4f7cfb1c2708,2022-07-26T00:00:00.000Z,05892560000649-TPT-50000-DECORPAC INDIA PRIVATE LIMITED,,,net_banking_transfer,-50000
633ed7bd2e1a0ebb7f308e27,50200023535069,-375958.34,60ec41ba55c00300382672d9,HDFC,direct expenses,5eecc6d6449e4f7cfb1c2708,2022-07-26T00:00:00.000Z,"NEFT DR-KKBK0001393-MASCOT SPINCONTROL I NDIA PVT LTD-NETBANK, MUM-N2072220513272 50-23000",,,net_banking_transfer,-23000
633ed7bd2e1a0ebb7f308e2c,50200023535069,-377566.72,60ec41ba55c00300382672d9,HDFC,bank charges,5eecc6d6449e4f7cfb1c2708,2022-07-26T00:00:00.000Z,.DC INTL POS TXN MARKUP+ST 010622 030622 -CDT2218609955197,,,international_transaction_arbitrage,-1608.38
633ed7bd2e1a0ebb7f308e2f,50200023535069,1151743.22,60ec41ba55c00300382672d9,HDFC,Revenue-Mktplace,5eecc6d6449e4f7cfb1c2708,2022-07-26T00:00:00.000Z,NEFT CR-KKBK0000958-NYKAA E RETAIL PRIVA TE LIMITED NYKAA-SLICK ORGANICS PVT LTD- KKBK222074410482,insurance,insurance,net_banking_transfer,1529309.94
633ed7bd2e1a0ebb7f308e31,50200023535069,1152480.85,60ec41ba55c00300382672d9,HDFC,Transfer in/Revenue-other,5eecc6d6449e4f7cfb1c2708,2022-07-26T00:00:00.000Z,NEFT CR-UTIB0000114-ONE SIGMA TECHNOLOGI,,,net_banking_transfer,737.63
633ed7bd2e1a0ebb7f308e34,50200023535069,952480.85,60ec41ba55c00300382672d9,HDFC,direct expenses,5eecc6d6449e4f7cfb1c2708,2022-07-26T00:00:00.000Z,"NEFT DR-SBIN0011783-GALACTIC GRIP-NETBAN K, MUM-N207222051590971-200000",,,net_banking_transfer,-200000
633ed7bd2e1a0ebb7f308e37,50200023535069,988189.65,60ec41ba55c00300382672d9,HDFC,Transfer in/Revenue-other,5eecc6d6449e4f7cfb1c2708,2022-07-26T00:00:00.000Z,"IMPS-220716917950-GOKWIK COMMERCE SOLU-I CIC-XXXXXXXX0630-PAYOUT FOR JULY 24, 202 2",,,net_banking_transfer,35708.8
633ed7bd2e1a0ebb7f308e3a,50200023535069,1006333.25,60ec41ba55c00300382672d9,HDFC,Revenue-PG-split enabled,5eecc6d6449e4f7cfb1c2708,2022-07-26T00:00:00.000Z,NEFT CR-UTIB0001506-RAZORPAY SOFTWARE PR IVATE LIMITED-SLICK ORGANICS PVT LITD-AX ISCN0157025730,insurance,insurance,net_banking_transfer,18143.6
633ed7bd2e1a0ebb7f308e3d,50200023535069,1025393.78,60ec41ba55c00300382672d9,HDFC,Revenue-Mktplace,5eecc6d6449e4f7cfb1c2708,2022-07-27T00:00:00.000Z,NEFT CR-DEUT0797BGL-FLIPKART INTERNET PR IVATE LIMITED-SLICK ORGANICS PVT LTD-220 800149GN00097,shopping,,net_banking_transfer,19060.53
633ed7bd2e1a0ebb7f308e3f,50200023535069,1042039.88,60ec41ba55c00300382672d9,HDFC,Revenue-PG-non-split,5eecc6d6449e4f7cfb1c2708,2022-07-27T00:00:00.000Z,IMPS-220804746542-PAYTM PAYMENTS SERVI-P YTM-XXXXXXXXXX0008-ALL202207272168200003 30830668628,ewallet,,net_banking_transfer,16646.1
633ed7bd2e1a0ebb7f308e42,50200023535069,1044874.82,60ec41ba55c00300382672d9,HDFC,Revenue-Mktplace,5eecc6d6449e4f7cfb1c2708,2022-07-27T00:00:00.000Z,NEFT CR-DEUT0797BGL-MYNTRA DESIGNS PRIVA TE LIMITED-SLICK ORGANICS PVT. LTD.-2208 00749GN00256,shopping,,net_banking_transfer,2834.94
633ed7bd2e1a0ebb7f308e45,50200023535069,1053587.31,60ec41ba55c00300382672d9,HDFC,Revenue-Mktplace,5eecc6d6449e4f7cfb1c2708,2022-07-27T00:00:00.000Z,NEFT CR-DEUT0797BGL-MYNTRA DESIGNS PRIVA TE LIMITED-SLICK ORGANICS PVT. LTD.-2208 00757GN00109,shopping,,net_banking_transfer,8712.49
633ed7bd2e1a0ebb7f308e48,50200023535069,1070872.01,60ec41ba55c00300382672d9,HDFC,Revenue-PG-split enabled,5eecc6d6449e4f7cfb1c2708,2022-07-27T00:00:00.000Z,NEFT CR-UTIB0001506-RAZORPAY SOFTWARE PR IVATE LIMITED-SLICK ORGANICS PVT LITD-AX ISCN0157108342,insurance,insurance,net_banking_transfer,17284.7
633ed7bd2e1a0ebb7f308e4b,50200023535069,847419.01,60ec41ba55c00300382672d9,HDFC,direct expenses,5eecc6d6449e4f7cfb1c2708,2022-07-27T00:00:00.000Z,"NEFT DR-UTIB0000740-SUPARI STUDIOS-NETBA NK, MUM-N208222052483312-223453",,,net_banking_transfer,-223453
633ed7bd2e1a0ebb7f308e4e,50200023535069,837419.01,60ec41ba55c00300382672d9,HDFC,Refund,5eecc6d6449e4f7cfb1c2708,2022-07-27T00:00:00.000Z,"NEFT DR-RATN0VAAPIS-RAZORPAY REFUND CRED ITS TOPUP-NETBANK, MUM-N208222052477980- 10000",,,net_banking_transfer,-10000
633ed7bd2e1a0ebb7f308e51,50200023535069,487419.01,60ec41ba55c00300382672d9,HDFC,direct expenses,5eecc6d6449e4f7cfb1c2708,2022-07-27T00:00:00.000Z,"NEFT DR-KKBK0000180-VEDIC COSMECEUTICALS PVT LTD-NETBANK, MUM-N208222052492797-3 50000",,,net_banking_transfer,-350000
633ed7bd2e1a0ebb7f308e54,50200023535069,487261.81,60ec41ba55c00300382672d9,HDFC,bank charges,5eecc6d6449e4f7cfb1c2708,2022-07-27T00:00:00.000Z,.DC INTL POS TXN MARKUP+ST 020622 040622,,,international_transaction_arbitrage,-157.2
633ed7bd2e1a0ebb7f308e57,50200023535069,437261.81,60ec41ba55c00300382672d9,HDFC,direct expenses,5eecc6d6449e4f7cfb1c2708,2022-07-27T00:00:00.000Z,"NEFT DR-KKBK0000173-MATRIX PRINTING SOLU TIONS PRIVATE LIMITE-NETBANK, MUM-N20822 2052588206-50000",,,net_banking_transfer,-50000
633ed7bd2e1a0ebb7f308e5b,50200023535069,387261.81,60ec41ba55c00300382672d9,HDFC,direct expenses,5eecc6d6449e4f7cfb1c2708,2022-07-27T00:00:00.000Z,"NEFT DR-PUNB0062910-YADAVPACKAGING-NETBA NK, MUM-N208222052564536-50000",,,net_banking_transfer,-50000
633ed7bd2e1a0ebb7f308e5e,50200023535069,387168.8,60ec41ba55c00300382672d9,HDFC,bank charges,5eecc6d6449e4f7cfb1c2708,2022-07-27T00:00:00.000Z,.DC INTL POS TXN MARKUP+ST 040622 050622 -CDT2218609955197,,,international_transaction_arbitrage,-93.01
633ed7bd2e1a0ebb7f308e60,50200023535069,387764.39,60ec41ba55c00300382672d9,HDFC,Transfer in/Revenue-other,5eecc6d6449e4f7cfb1c2708,2022-07-27T00:00:00.000Z,NEFT CR-UTIB0000114-ONE SIGMA TECHNOLOGI ES PRIVATE LIM-SLICK ORGANICS PRIVATE LI MITED-AXISP00306365604,insurance,insurance,net_banking_transfer,595.59
633ed7bd2e1a0ebb7f308e64,50200023535069,87764.39,60ec41ba55c00300382672d9,HDFC,Tax,5eecc6d6449e4f7cfb1c2708,2022-07-27T00:00:00.000Z,051030827072242496- CBDT TAX,,,Other,-300000
633ed7bd2e1a0ebb7f308e67,50200023535069,-212235.61,60ec41ba55c00300382672d9,HDFC,Tax,5eecc6d6449e4f7cfb1c2708,2022-07-27T00:00:00.000Z,051030827072242890- CBDT TAX,,,Other,-300000
633ed7bd2e1a0ebb7f308e6a,50200023535069,-212877.14,60ec41ba55c00300382672d9,HDFC,bank charges,5eecc6d6449e4f7cfb1c2708,2022-07-27T00:00:00.000Z,.DC INTL POS TXN MARKUP+ST 060622 080622 -CDT2218609955197,,,international_transaction_arbitrage,-641.53
633ed7bd2e1a0ebb7f308e6c,50200023535069,-212878.14,60ec41ba55c00300382672d9,HDFC,direct expenses,5eecc6d6449e4f7cfb1c2708,2022-07-27T00:00:00.000Z,ME DC SI 514834XXXXXX9486 ADOBE SYSTEMS SOFTWARE,,,Other,-1
633ed7bd2e1a0ebb7f308e6f,50200023535069,-214907.14,60ec41ba55c00300382672d9,HDFC,direct expenses,5eecc6d6449e4f7cfb1c2708,2022-07-27T00:00:00.000Z,POS 514834XXXXXX9486 ADOBE,,,debit_card,-2029
633ed7bd2e1a0ebb7f308e72,50200023535069,-214908.14,60ec41ba55c00300382672d9,HDFC,direct expenses,5eecc6d6449e4f7cfb1c2708,2022-07-27T00:00:00.000Z,ME DC SI 514834XXXXXX9486 ADOBE SYSTEMS SOFTWARE,,,Other,-1
633ed7bd2e1a0ebb7f308e75,50200023535069,-215787.14,60ec41ba55c00300382672d9,HDFC,direct expenses,5eecc6d6449e4f7cfb1c2708,2022-07-27T00:00:00.000Z,POS 514834XXXXXX9486 ADOBE,,,debit_card,-879
633ed7bd2e1a0ebb7f308e78,50200023535069,-83765.63,60ec41ba55c00300382672d9,HDFC,Transfer in/Revenue-other,5eecc6d6449e4f7cfb1c2708,2022-07-27T00:00:00.000Z,"IMPS-220816808449-GOKWIK COMMERCE SOLU-I CIC-XXXXXXXX0630-PAYOUT FOR JULY 25, 202 2",,,net_banking_transfer,132021.51
633ed7bd2e1a0ebb7f308e7b,50200023535069,-58190.99,60ec41ba55c00300382672d9,HDFC,Revenue-PG-split enabled,5eecc6d6449e4f7cfb1c2708,2022-07-27T00:00:00.000Z,NEFT CR-UTIB0001506-RAZORPAY SOFTWARE PR IVATE LIMITED-SLICK ORGANICS PVT LITD-AX ISCN0157255525,insurance,insurance,net_banking_transfer,25574.64
633ed7bd2e1a0ebb7f308e7d,50200023535069,-35874.8,60ec41ba55c00300382672d9,HDFC,Revenue-COD,5eecc6d6449e4f7cfb1c2708,2022-07-27T00:00:00.000Z,NEFT CR-ICIC0000155-SHIPROCKET COD CRF I D 4664885-SLICK ORGANICS PVT LTD-CMS2729 949953,insurance,insurance,net_banking_transfer,22316.19
633ed7bd2e1a0ebb7f308e80,50200023535069,-35873.8,60ec41ba55c00300382672d9,HDFC,Loan-in,5eecc6d6449e4f7cfb1c2708,2022-07-28T00:00:00.000Z,SWEEP-IN CREDIT - 50300653995829,,,self_transfer,1
633ed7bd2e1a0ebb7f308e83,50200023535069,-35872.8,60ec41ba55c00300382672d9,HDFC,Transfer in/Revenue-other,5eecc6d6449e4f7cfb1c2708,2022-07-28T00:00:00.000Z,INT. ON SWCR ON-50300653995829,,,Other,1
633ed7bd2e1a0ebb7f308e86,50200023535069,-33843.8,60ec41ba55c00300382672d9,HDFC,Loan-in,5eecc6d6449e4f7cfb1c2708,2022-07-28T00:00:00.000Z,SWEEP-IN CREDIT - 50300653995829,,,self_transfer,2029
633ed7bd2e1a0ebb7f308e88,50200023535069,-33842.8,60ec41ba55c00300382672d9,HDFC,Loan-in,5eecc6d6449e4f7cfb1c2708,2022-07-28T00:00:00.000Z,SWEEP-IN CREDIT - 50300653995829,,,self_transfer,1
633ed7bd2e1a0ebb7f308e8b,50200023535069,-32963.8,60ec41ba55c00300382672d9,HDFC,Loan-in,5eecc6d6449e4f7cfb1c2708,2022-07-28T00:00:00.000Z,SWEEP-IN CREDIT - 50300653995829,,,self_transfer,879
633ed7bd2e1a0ebb7f308e8f,50200023535069,-32949.8,60ec41ba55c00300382672d9,HDFC,Transfer in/Revenue-other,5eecc6d6449e4f7cfb1c2708,2022-07-28T00:00:00.000Z,INT. ON SWCR ON-50300653995829,,,Other,14
633ed7bd2e1a0ebb7f308e92,50200023535069,14.2,60ec41ba55c00300382672d9,HDFC,Loan-in,5eecc6d6449e4f7cfb1c2708,2022-07-28T00:00:00.000Z,SWEEP-IN CREDIT - 50300653995829,,,self_transfer,32964
633ed7be2e1a0ebb7f308e94,50200023535069,34492.93,60ec41ba55c00300382672d9,HDFC,Revenue-PG-non-split,5eecc6d6449e4f7cfb1c2708,2022-07-28T00:00:00.000Z,NEFT CR-PYTM0123456-PAYTM PAYMENTS SERVI CES LIMITED-SLICK ORGANICS PVT LTD-PYTM2 22096585726,insurance,insurance,net_banking_transfer,34478.73
633ed7be2e1a0ebb7f308e97,50200023535069,80758.53,60ec41ba55c00300382672d9,HDFC,Revenue-PG-split enabled,5eecc6d6449e4f7cfb1c2708,2022-07-28T00:00:00.000Z,NEFT CR-UTIB0001506-RAZORPAY SOFTWARE PR IVATE LIMITED-SLICK ORGANICS PVT LITD-AX ISCN0157329521,insurance,insurance,net_banking_transfer,46265.6
633ed7be2e1a0ebb7f308e9a,50200023535069,79754.53,60ec41ba55c00300382672d9,HDFC,direct expenses,5eecc6d6449e4f7cfb1c2708,2022-07-28T00:00:00.000Z,POS 514834XXXXXX9486 SMARTSHIFT LOGIS,,,debit_card,-1004
633ed7be2e1a0ebb7f308e9d,50200023535069,78558.53,60ec41ba55c00300382672d9,HDFC,direct expenses,5eecc6d6449e4f7cfb1c2708,2022-07-28T00:00:00.000Z,POS 514834XXXXXX9486 SMARTSHIFT LOGIS,,,debit_card,-1196
633ed7be2e1a0ebb7f308e9f,50200023535069,79866.28,60ec41ba55c00300382672d9,HDFC,Transfer in/Revenue-other,5eecc6d6449e4f7cfb1c2708,2022-07-28T00:00:00.000Z,NEFT CR-UTIB0000114-ONE SIGMA TECHNOLOGI ES PRIVATE LIM-SLICK ORGANICS PRIVATE LI MITED-AXISP00306721998,insurance,insurance,net_banking_transfer,1307.75
633ed7be2e1a0ebb7f308ea2,50200023535069,78818.28,60ec41ba55c00300382672d9,HDFC,direct expenses,5eecc6d6449e4f7cfb1c2708,2022-07-28T00:00:00.000Z,POS 514834XXXXXX9486 SMARTSHIFT LOGIS,,,debit_card,-1048
633ed7be2e1a0ebb7f308ea5,50200023535069,143471.74,60ec41ba55c00300382672d9,HDFC,Transfer in/Revenue-other,5eecc6d6449e4f7cfb1c2708,2022-07-28T00:00:00.000Z,"IMPS-220916772269-GOKWIK COMMERCE SOLU-I CIC-XXXXXXXX0630-PAYOUT FOR JULY 26, 202 2",,,net_banking_transfer,64653.46
633ed7be2e1a0ebb7f308ea9,50200023535069,150849.68,60ec41ba55c00300382672d9,HDFC,Revenue-PG-split enabled,5eecc6d6449e4f7cfb1c2708,2022-07-28T00:00:00.000Z,NEFT CR-UTIB0001506-RAZORPAY SOFTWARE PR IVATE LIMITED-SLICK ORGANICS PVT LITD-AX ISCN0157482744,insurance,insurance,net_banking_transfer,7377.94
633ed7be2e1a0ebb7f308eac,50200023535069,163192.64,60ec41ba55c00300382672d9,HDFC,Revenue-Mktplace,5eecc6d6449e4f7cfb1c2708,2022-07-29T00:00:00.000Z,NEFT CR-DEUT0797BGL-FLIPKART INTERNET PR IVATE LIMITED-SLICK ORGANICS PVT LTD-221 000131GN00245,shopping,,net_banking_transfer,12342.96
633ed7be2e1a0ebb7f308eaf,50200023535069,169908.18,60ec41ba55c00300382672d9,HDFC,Revenue-PG-non-split,5eecc6d6449e4f7cfb1c2708,2022-07-29T00:00:00.000Z,NEFT CR-PYTM0123456-PAYTM PAYMENTS SERVI CES LIMITED-SLICK ORGANICS PVT LTD-PYTM2 22107748961,insurance,insurance,net_banking_transfer,6715.54
633ed7be2e1a0ebb7f308eb1,50200023535069,-330091.82,60ec41ba55c00300382672d9,HDFC,Marketing Expense,5eecc6d6449e4f7cfb1c2708,2022-07-29T00:00:00.000Z,"NEFT DR-CITI0100000-GOOGLE INDIA PVT LTD -NETBANK, MUM-N210222055129354-500000",,,net_banking_transfer,-500000
633ed7be2e1a0ebb7f308eb5,50200023535069,-321496.53,60ec41ba55c00300382672d9,HDFC,Revenue-PG-split enabled,5eecc6d6449e4f7cfb1c2708,2022-07-29T00:00:00.000Z,NEFT CR-UTIB0001506-RAZORPAY SOFTWARE PR,,,net_banking_transfer,8595.29
633ed7be2e1a0ebb7f308eb8,50200023535069,-314238.21,60ec41ba55c00300382672d9,HDFC,Revenue-Mktplace,5eecc6d6449e4f7cfb1c2708,2022-07-29T00:00:00.000Z,NEFT CR-DEUT0797BGL-MYNTRA DESIGNS PRIVA TE LIMITED-SLICK ORGANICS PVT. LTD.-2210 00738GN00150,shopping,,net_banking_transfer,7258.32
633ed7be2e1a0ebb7f308ebb,50200023535069,-311651.71,60ec41ba55c00300382672d9,HDFC,Revenue-Mktplace,5eecc6d6449e4f7cfb1c2708,2022-07-29T00:00:00.000Z,NEFT CR-DEUT0797BGL-MYNTRA DESIGNS PRIVA TE LIMITED-SLICK ORGANICS PVT. LTD.-2210 00739GN00017,shopping,,net_banking_transfer,2586.5
633ed7be2e1a0ebb7f308ebe,50200023535069,-332086.71,60ec41ba55c00300382672d9,HDFC,direct expenses,5eecc6d6449e4f7cfb1c2708,2022-07-29T00:00:00.000Z,POS 514834XXXXXX9486 PTM*PAYTM,ewallet,,debit_card,-20435
633ed7be2e1a0ebb7f308ec1,50200023535069,-342086.71,60ec41ba55c00300382672d9,HDFC,direct expenses,5eecc6d6449e4f7cfb1c2708,2022-07-29T00:00:00.000Z,"NEFT DR-ICIC0006986-ASHWINI SHARMA-NETBA NK, MUM-N210222055245311-10000",,,net_banking_transfer,-10000
633ed7be2e1a0ebb7f308ec3,50200023535069,-203101.07,60ec41ba55c00300382672d9,HDFC,Transfer in/Revenue-other,5eecc6d6449e4f7cfb1c2708,2022-07-29T00:00:00.000Z,"IMPS-221016858722-GOKWIK COMMERCE SOLU-I CIC-XXXXXXXX0630-PAYOUT FOR JULY 27, 202 2",,,net_banking_transfer,138985.64
633ed7be2e1a0ebb7f308ec6,50200023535069,-196776.99,60ec41ba55c00300382672d9,HDFC,Revenue-PG-split enabled,5eecc6d6449e4f7cfb1c2708,2022-07-29T00:00:00.000Z,NEFT CR-UTIB0001506-RAZORPAY SOFTWARE PR IVATE LIMITED-SLICK ORGANICS PVT LITD-AX ISCN0157706394,insurance,insurance,net_banking_transfer,6324.08
633ed7be2e1a0ebb7f308ec9,50200023535069,-196775.99,60ec41ba55c00300382672d9,HDFC,Transfer in/Revenue-other,5eecc6d6449e4f7cfb1c2708,2022-07-29T00:00:00.000Z,CRV POS 514834******9486 ADOBE SYSTEMS S,,,refund,1
633ed7be2e1a0ebb7f308ecc,50200023535069,-196774.99,60ec41ba55c00300382672d9,HDFC,Transfer in/Revenue-other,5eecc6d6449e4f7cfb1c2708,2022-07-29T00:00:00.000Z,CRV POS 514834******9486 ADOBE SYSTEMS S,,,refund,1
633ed7be2e1a0ebb7f308ecf,50200023535069,-196773.99,60ec41ba55c00300382672d9,HDFC,Transfer in/Revenue-other,5eecc6d6449e4f7cfb1c2708,2022-07-30T00:00:00.000Z,INT. ON SWCR ON-50300653995829,,,Other,1
633ed7be2e1a0ebb7f308ed2,50200023535069,-194778.99,60ec41ba55c00300382672d9,HDFC,Loan-in,5eecc6d6449e4f7cfb1c2708,2022-07-30T00:00:00.000Z,SWEEP-IN CREDIT - 50300653995829,,,self_transfer,1995
633ed7be2e1a0ebb7f308ed5,50200023535069,-194675.99,60ec41ba55c00300382672d9,HDFC,Transfer in/Revenue-other,5eecc6d6449e4f7cfb1c2708,2022-07-30T00:00:00.000Z,INT. ON SWCR ON-50300653995829,,,Other,103
633ed7be2e1a0ebb7f308ed8,50200023535069,103.01,60ec41ba55c00300382672d9,HDFC,Loan-in,5eecc6d6449e4f7cfb1c2708,2022-07-30T00:00:00.000Z,SWEEP-IN CREDIT - 50300653995829,,,self_transfer,194779
633ed7be2e1a0ebb7f308edb,50200023535069,804.84,60ec41ba55c00300382672d9,HDFC,Revenue-PG-non-split,5eecc6d6449e4f7cfb1c2708,2022-07-30T00:00:00.000Z,UPI-PAYTM-PPSL-PAYOUTS@PAYTM-PYTM0123456 -221106222794-ALL202207302168200,ewallet,,upi,701.83
633ed7be2e1a0ebb7f308edd,50200023535069,1449.29,60ec41ba55c00300382672d9,HDFC,Revenue-PG-split enabled,5eecc6d6449e4f7cfb1c2708,2022-07-30T00:00:00.000Z,NEFT CR-UTIB0001506-RAZORPAY SOFTWARE PR IVATE LIMITED-SLICK ORGANICS PVT LITD-AX ISCN0157779267,insurance,insurance,net_banking_transfer,644.45
633ed7be2e1a0ebb7f308ee0,50200023535069,41140.08,60ec41ba55c00300382672d9,HDFC,Transfer in/Revenue-other,5eecc6d6449e4f7cfb1c2708,2022-07-30T00:00:00.000Z,"IMPS-221116084585-GOKWIK COMMERCE SOLU-I CIC-XXXXXXXX0630-PAYOUT FOR JULY 28, 202 2",,,net_banking_transfer,39690.79
633ed7be2e1a0ebb7f308ee3,50200023535069,51750.32,60ec41ba55c00300382672d9,HDFC,Revenue-PG-split enabled,5eecc6d6449e4f7cfb1c2708,2022-07-30T00:00:00.000Z,NEFT CR-UTIB0001506-RAZORPAY SOFTWARE PR,,,net_banking_transfer,10610.24
633ed7be2e1a0ebb7f308ee6,50200023535069,51571.32,60ec41ba55c00300382672d9,HDFC,SAAS/tech expense,5eecc6d6449e4f7cfb1c2708,2022-07-30T00:00:00.000Z,ME DC SI 514834XXXXXX9486 AMAZON,shopping,,Other,-179
633ed7be2e1a0ebb7f308ee9,50200023535069,60126.21,60ec41ba55c00300382672d9,HDFC,Revenue-PG-non-split,5eecc6d6449e4f7cfb1c2708,2022-07-31T00:00:00.000Z,NEFT CR-PYTM0123456-PAYTM PAYMENTS SERVI CES LIMITED-SLICK ORGANICS PVT LTD-PYTM2 22120506112,insurance,insurance,net_banking_transfer,8554.89
633ed7be2e1a0ebb7f308eeb,50200023535069,95882.29,60ec41ba55c00300382672d9,HDFC,Transfer in/Revenue-other,5eecc6d6449e4f7cfb1c2708,2022-07-31T00:00:00.000Z,"IMPS-221216905322-GOKWIK COMMERCE SOLU-I CIC-XXXXXXXX0630-PAYOUT FOR JULY 29, 202 2",,,net_banking_transfer,35756.08
633ed7be2e1a0ebb7f308eee,50200023535069,-159117.71,60ec41ba55c00300382672d9,HDFC,SAAS/tech expense,5eecc6d6449e4f7cfb1c2708,2022-07-31T00:00:00.000Z,POS 514834XXXXXX9486 AMAZON,shopping,,debit_card,-255000
633ed7be2e1a0ebb7f308ef1,50200023535069,-159018.71,60ec41ba55c00300382672d9,HDFC,Transfer in/Revenue-other,5eecc6d6449e4f7cfb1c2708,2022-07-31T00:00:00.000Z,INT. ON SWCR ON-50300653995829,,,Other,99
633ed7be2e1a0ebb7f308ef4,50200023535069,99.29,60ec41ba55c00300382672d9,HDFC,Loan-in,5eecc6d6449e4f7cfb1c2708,2022-07-31T00:00:00.000Z,SWEEP-IN CREDIT - 50300653995829,,,self_transfer,159118
633ed83d2e1a0ebb7f312732,50200035187206,5159253.08,60ec419255c00300382671a5,HDFC,Internal Transfers,5eecc6d6449e4f7cfb1c2708,2022-07-20T00:00:00.000Z,IB FUNDS TRANSFER DR-50200023535069 -SL ICK ORGANICS PVT LTD,,,net_banking_transfer,-1400000
633ed83d2e1a0ebb7f312735,50200035187206,5059253.08,60ec419255c00300382671a5,HDFC,Internal Transfers,5eecc6d6449e4f7cfb1c2708,2022-07-20T00:00:00.000Z,IB FUNDS TRANSFER DR-50200023535069 -SL ICK ORGANICS PVT LTD,,,net_banking_transfer,-100000
633ed83d2e1a0ebb7f312737,50200035187206,11057715.55,60ec419255c00300382671a5,HDFC,Transfer in/Revenue-other,5eecc6d6449e4f7cfb1c2708,2022-07-21T00:00:00.000Z,RTGS CR-SCBL0036001-ANIL KUMAR AGARWAL-S LICK ORGANICS P LTD-SCBLR220220721008047 15,insurance,insurance,net_banking_transfer,5998462.47
633ed83d2e1a0ebb7f312739,50200035187206,12551838.55,60ec419255c00300382671a5,HDFC,Investments-New,5eecc6d6449e4f7cfb1c2708,2022-07-27T00:00:00.000Z,FT - CR - 05031050011209 - VIKRAM MADHOK,,,Other,1494123
63bfb1e32e1a0ebb7f6219da,50200050976833,11081.63,60ec41a455c0030038267236,HDFC,Revenue-PG-non-split,5eecc6d6449e4f7cfb1c2708,2022-09-19T00:00:00.000Z,NEFT CR-CITI0100000-PAYPAL PAYMENTS PL-O PGSP COLL AC-SLICK ORGANICS PRIVATE LIMI TED-CITIN22337693862,,,net_banking_transfer,3100.53
63bfb1e32e1a0ebb7f6219dc,50200050976833,14381.6,60ec41a455c0030038267236,HDFC,Revenue-PG-non-split,5eecc6d6449e4f7cfb1c2708,2022-10-11T00:00:00.000Z,NEFT CR-CITI0100000-PAYPAL PAYMENTS PL-O PGSP COLL AC-SLICK ORGANICS PRIVATE LIMI TED-CITIN22349867534,,,net_banking_transfer,3299.97
63bfb1e32e1a0ebb7f6219df,50200050976833,18218.95,60ec41a455c0030038267236,HDFC,Revenue-PG-non-split,5eecc6d6449e4f7cfb1c2708,2022-11-03T00:00:00.000Z,NEFT CR-CITI0100000-PAYPAL PAYMENTS PL-O PGSP COLL AC-SLICK ORGANICS PRIVATE LIMI TED-CITIN22361516238,,,net_banking_transfer,3837.35
63bfb1e32e1a0ebb7f6219e1,50200050976833,21322.37,60ec41a455c0030038267236,HDFC,Revenue-PG-non-split,5eecc6d6449e4f7cfb1c2708,2022-11-23T00:00:00.000Z,NEFT CR-CITI0100000-PAYPAL PAYMENTS PL-O,,,net_banking_transfer,3103.42
63bfb1e32e1a0ebb7f6219e3,50200050976833,24512.84,60ec41a455c0030038267236,HDFC,Revenue-PG-non-split,5eecc6d6449e4f7cfb1c2708,2022-12-07T00:00:00.000Z,NEFT CR-CITI0100000-PAYPAL PAYMENTS PL-O PGSP COLL AC-SLICK ORGANICS PRIVATE LIMI TED-CITIN22378084058,,,net_banking_transfer,3190.47
63bfb1e32e1a0ebb7f6219e5,50200050976833,27646.05,60ec41a455c0030038267236,HDFC,Revenue-PG-non-split,5eecc6d6449e4f7cfb1c2708,2022-12-14T00:00:00.000Z,NEFT CR-CITI0100000-PAYPAL PAYMENTS PL-O,,,net_banking_transfer,3133.21
63bfb29b2e1a0ebb7f6291cc,50200023535069,493583.72,60ec41ba55c00300382672d9,HDFC,Revenue-PG-non-split,5eecc6d6449e4f7cfb1c2708,2022-10-01T00:00:00.000Z,NEFT CR-PYTM0123456-PAYTM PAYMENTS SERVI CES LIMITED-SLICK ORGANICS PVT LTD-PYTM2 22745467597,ewallet,,net_banking_transfer,20484.74
63bfb29b2e1a0ebb7f6291ce,50200023535069,110682.72,60ec41ba55c00300382672d9,HDFC,Marketing Expense,5eecc6d6449e4f7cfb1c2708,2022-10-01T00:00:00.000Z,"NEFT DR-CITI0100000-GOOGLE INDIA PVT LTD -NETBANK, MUM-N274222141708363-382901",,,net_banking_transfer,-382901
63bfb29b2e1a0ebb7f6291d0,50200023535069,-89317.28,60ec41ba55c00300382672d9,HDFC,direct expenses,5eecc6d6449e4f7cfb1c2708,2022-10-01T00:00:00.000Z,"NEFT DR-KKBK0002499-HITESH MALHOTRA-NETB ANK, MUM-N274222141708735-200000",,,net_banking_transfer,-200000
63bfb29b2e1a0ebb7f6291d2,50200023535069,-239317.28,60ec41ba55c00300382672d9,HDFC,direct expenses,5eecc6d6449e4f7cfb1c2708,2022-10-01T00:00:00.000Z,"NEFT DR-UTIB0000119-SAFEXPRESS-NETBANK, MUM-N274222141754233-150000",,,net_banking_transfer,-150000
63bfb29b2e1a0ebb7f6291d4,50200023535069,-227077.09,60ec41ba55c00300382672d9,HDFC,Revenue-PG-split enabled,5eecc6d6449e4f7cfb1c2708,2022-10-01T00:00:00.000Z,NEFT CR-UTIB0001506-RAZORPAY SOFTWARE PR IVATE LIMITED-SLICK ORGANICS PVT LITD-AX ISCN0169492946,,,net_banking_transfer,12240.19
63bfb29b2e1a0ebb7f6291d6,50200023535069,-229440.6,60ec41ba55c00300382672d9,HDFC,direct expenses,5eecc6d6449e4f7cfb1c2708,2022-10-01T00:00:00.000Z,POS 514834XXXXXX9486 SEOPTIMER,,,debit_card,-2363.51
63bfb29b2e1a0ebb7f6291d8,50200023535069,-249440.6,60ec41ba55c00300382672d9,HDFC,direct expenses,5eecc6d6449e4f7cfb1c2708,2022-10-01T00:00:00.000Z,POS 514834XXXXXX9486 FLIPKART,shopping,,debit_card,-20000
63bfb29b2e1a0ebb7f6291da,50200023535069,-161639.91,60ec41ba55c00300382672d9,HDFC,Revenue-PG-non-split,5eecc6d6449e4f7cfb1c2708,2022-10-01T00:00:00.000Z,NEFT CR-KKBK0000958-NODAL ACCOUNT BROKEN TUSK TECHNOL-SLICK ORGANICS PRIVATE LIMI TED-CMS2742227662920,,,net_banking_transfer,87800.69
63bfb29b2e1a0ebb7f6291dc,50200023535069,-155350.71,60ec41ba55c00300382672d9,HDFC,Revenue-PG-split enabled,5eecc6d6449e4f7cfb1c2708,2022-10-01T00:00:00.000Z,NEFT CR-UTIB0001506-RAZORPAY SOFTWARE PR IVATE LIMITED-SLICK ORGANICS PVT LITD-AX ISCN0169589786,,,net_banking_transfer,6289.2
63bfb29b2e1a0ebb7f6291de,50200023535069,-145226.71,60ec41ba55c00300382672d9,HDFC,Loan-in,5eecc6d6449e4f7cfb1c2708,2022-10-02T00:00:00.000Z,SWEEP-IN CREDIT - 50300684649760,,,self_transfer,10124
63bfb29b2e1a0ebb7f6291e0,50200023535069,-55908.71,60ec41ba55c00300382672d9,HDFC,Loan-in,5eecc6d6449e4f7cfb1c2708,2022-10-02T00:00:00.000Z,SWEEP-IN CREDIT - 50300684649760,,,self_transfer,89318
63bfb29b2e1a0ebb7f6291e2,50200023535069,0.29,60ec41ba55c00300382672d9,HDFC,Loan-in,5eecc6d6449e4f7cfb1c2708,2022-10-02T00:00:00.000Z,SWEEP-IN CREDIT - 50300684649760,,,self_transfer,55909
63bfb29b2e1a0ebb7f6291e4,50200023535069,-40797.14,60ec41ba55c00300382672d9,HDFC,SAAS/tech expense,5eecc6d6449e4f7cfb1c2708,2022-10-02T00:00:00.000Z,POS 514834XXXXXX9486 AMAZON.COM,shopping,,debit_card,-40797.43
63bfb29b2e1a0ebb7f6291e6,50200023535069,-26023.45,60ec41ba55c00300382672d9,HDFC,Revenue-PG-non-split,5eecc6d6449e4f7cfb1c2708,2022-10-02T00:00:00.000Z,NEFT CR-PYTM0123456-PAYTM PAYMENTS SERVI CES LIMITED-SLICK ORGANICS PVT LTD-PYTM2 22757321342,ewallet,,net_banking_transfer,14773.69
63bfb29b2e1a0ebb7f6291e8,50200023535069,0.55,60ec41ba55c00300382672d9,HDFC,Loan-in,5eecc6d6449e4f7cfb1c2708,2022-10-03T00:00:00.000Z,SWEEP-IN CREDIT - 50300684649760,,,self_transfer,26024
63bfb29b2e1a0ebb7f6291ea,50200023535069,25449.08,60ec41ba55c00300382672d9,HDFC,Revenue-Mktplace,5eecc6d6449e4f7cfb1c2708,2022-10-03T00:00:00.000Z,NEFT CR-DEUT0797BGL-FLIPKART INTERNET PR,shopping,,net_banking_transfer,25448.53
63bfb29b2e1a0ebb7f6291ec,50200023535069,36848.58,60ec41ba55c00300382672d9,HDFC,Revenue-PG-non-split,5eecc6d6449e4f7cfb1c2708,2022-10-03T00:00:00.000Z,NEFT CR-PYTM0123456-PAYTM PAYMENTS SERVI CES LIMITED-SLICK ORGANICS PVT LTD-PYTM2 22769763710,ewallet,,net_banking_transfer,11399.5
63bfb29b2e1a0ebb7f6291ee,50200023535069,67666.7,60ec41ba55c00300382672d9,HDFC,Revenue-PG-split enabled,5eecc6d6449e4f7cfb1c2708,2022-10-03T00:00:00.000Z,NEFT CR-UTIB0001506-RAZORPAY SOFTWARE PR IVATE LIMITED-SLICK ORGANICS PVT LITD-AX ISCN0169764173,,,net_banking_transfer,30818.12
63bfb29b2e1a0ebb7f6291f0,50200023535069,84716.78,60ec41ba55c00300382672d9,HDFC,Revenue-Mktplace,5eecc6d6449e4f7cfb1c2708,2022-10-03T00:00:00.000Z,NEFT CR-DEUT0797BGL-MYNTRA DESIGNS PRIVA TE LIMITED-SLICK ORGANICS PVT. LTD.-2276 00846GN00227,shopping,,net_banking_transfer,17050.08
63bfb29b2e1a0ebb7f6291f2,50200023535069,92972.51,60ec41ba55c00300382672d9,HDFC,Revenue-Mktplace,5eecc6d6449e4f7cfb1c2708,2022-10-03T00:00:00.000Z,NEFT CR-DEUT0797BGL-MYNTRA DESIGNS PRIVA TE LIMITED-SLICK ORGANICS PVT. LTD.-2276 00836GN00273,shopping,,net_banking_transfer,8255.73
63bfb29b2e1a0ebb7f6291f5,50200023535069,92892.8,60ec41ba55c00300382672d9,HDFC,bank charges,5eecc6d6449e4f7cfb1c2708,2022-10-03T00:00:00.000Z,.DC INTL POS TXN MARKUP+ST 020922 030922 -CDT2227411374283,,,international_transaction_arbitrage,-79.71
63bfb29b2e1a0ebb7f6291f7,50200023535069,-57107.2,60ec41ba55c00300382672d9,HDFC,direct expenses,5eecc6d6449e4f7cfb1c2708,2022-10-03T00:00:00.000Z,"NEFT DR-KKBK0004581-MJ GLOBAL PVT LTD-NE TBANK, MUM-N276222144731211-150000",,,net_banking_transfer,-150000
63bfb29b2e1a0ebb7f6291f9,50200023535069,-207107.2,60ec41ba55c00300382672d9,HDFC,direct expenses,5eecc6d6449e4f7cfb1c2708,2022-10-03T00:00:00.000Z,"NEFT DR-IDFB0040101-ACTIVES ADDITIVES AP PLICATIONS LLP-NETBANK, MUM-N27622214473 2045-150000",,,net_banking_transfer,-150000
63bfb29b2e1a0ebb7f6291fb,50200023535069,-462107.2,60ec41ba55c00300382672d9,HDFC,SAAS/tech expense,5eecc6d6449e4f7cfb1c2708,2022-10-03T00:00:00.000Z,POS 514834XXXXXX9486 AMAZON,shopping,,debit_card,-255000
63bfb29b2e1a0ebb7f6291fd,50200023535069,-472107.2,60ec41ba55c00300382672d9,HDFC,direct expenses,5eecc6d6449e4f7cfb1c2708,2022-10-03T00:00:00.000Z,01322000013526-TPT-10000-CLASSIC RACKS,,,net_banking_transfer,-10000
63bfb29b2e1a0ebb7f6291ff,50200023535069,-470780.49,60ec41ba55c00300382672d9,HDFC,Transfer in/Revenue-other,5eecc6d6449e4f7cfb1c2708,2022-10-03T00:00:00.000Z,NEFT CR-UTIB0000114-ONE SIGMA TECHNOLOGI ES PRIVATE LIM-SLICK ORGANICS PRIVATE LI MITED-AXISP00324939974,,,net_banking_transfer,1326.71
63bfb29b2e1a0ebb7f629201,50200023535069,-467996.94,60ec41ba55c00300382672d9,HDFC,Transfer in/Revenue-other,5eecc6d6449e4f7cfb1c2708,2022-10-03T00:00:00.000Z,NEFT CR-UTIB0000114-ONE SIGMA TECHNOLOGI ES PRIVATE LIM-SLICK ORGANICS PRIVATE LI MITED-AXISP00324939947,,,net_banking_transfer,2783.55
63bfb29b2e1a0ebb7f629203,50200023535069,-465797.38,60ec41ba55c00300382672d9,HDFC,Transfer in/Revenue-other,5eecc6d6449e4f7cfb1c2708,2022-10-03T00:00:00.000Z,NEFT CR-UTIB0000114-ONE SIGMA TECHNOLOGI ES PRIVATE LIM-SLICK ORGANICS PRIVATE LI MITED-AXISP00324939955,,,net_banking_transfer,2199.56
63bfb29b2e1a0ebb7f629205,50200023535069,-466886.38,60ec41ba55c00300382672d9,HDFC,direct expenses,5eecc6d6449e4f7cfb1c2708,2022-10-03T00:00:00.000Z,POS 514834XXXXXX9486 SMARTSHIFT LOGIS,,,debit_card,-1089
63bfb29b2e1a0ebb7f629207,50200023535069,-467041.62,60ec41ba55c00300382672d9,HDFC,bank charges,5eecc6d6449e4f7cfb1c2708,2022-10-03T00:00:00.000Z,.DC INTL POS TXN MARKUP+ST 020922 040922 -CDT2227411374283,,,international_transaction_arbitrage,-155.24
63bfb29b2e1a0ebb7f629209,50200023535069,-491691.62,60ec41ba55c00300382672d9,HDFC,direct expenses,5eecc6d6449e4f7cfb1c2708,2022-10-03T00:00:00.000Z,"NEFT DR-KKBK0000173-NITISH KUMAR MANDAL- NETBANK, MUM-N276222145047615-24650",,,net_banking_transfer,-24650
63bfb29b2e1a0ebb7f62920b,50200023535069,-431445.4,60ec41ba55c00300382672d9,HDFC,Revenue-PG-non-split,5eecc6d6449e4f7cfb1c2708,2022-10-03T00:00:00.000Z,NEFT CR-KKBK0000958-NODAL ACCOUNT BROKEN TUSK TECHNOL-SLICK ORGANICS PRIVATE LIMI TED-CMS2762227843705,,,net_banking_transfer,60246.22
63bfb29b2e1a0ebb7f62920d,50200023535069,-427097.53,60ec41ba55c00300382672d9,HDFC,Revenue-PG-split enabled,5eecc6d6449e4f7cfb1c2708,2022-10-03T00:00:00.000Z,NEFT CR-UTIB0001506-RAZORPAY SOFTWARE PR IVATE LIMITED-SLICK ORGANICS PVT LITD-AX ISCN0170007694,,,net_banking_transfer,4347.87
63bfb29b2e1a0ebb7f62920f,50200023535069,-405420.55,60ec41ba55c00300382672d9,HDFC,Revenue-COD,5eecc6d6449e4f7cfb1c2708,2022-10-03T00:00:00.000Z,NEFT CR-ICIC0000155-SHIPROCKET COD CRF I D 4980173-SLICK ORGANICS PVT LTD-CMS2869 240831,,,net_banking_transfer,21676.98
63bfb29b2e1a0ebb7f629211,50200023535069,-427920.55,60ec41ba55c00300382672d9,HDFC,direct expenses,5eecc6d6449e4f7cfb1c2708,2022-10-03T00:00:00.000Z,50100295319150-TPT-22500-JANNAT AYAZ KHA N,,,net_banking_transfer,-22500
63bfb29b2e1a0ebb7f629213,50200023535069,-527920.55,60ec41ba55c00300382672d9,HDFC,direct expenses,5eecc6d6449e4f7cfb1c2708,2022-10-03T00:00:00.000Z,"NEFT DR-ICIC0006566-MARKETING MANTRA-NET BANK, MUM-N276222145778126-100000",,,net_banking_transfer,-100000
63bfb29b2e1a0ebb7f629216,50200023535069,-527922.55,60ec41ba55c00300382672d9,HDFC,Marketing Expense,5eecc6d6449e4f7cfb1c2708,2022-10-03T00:00:00.000Z,ME DC SI 514834XXXXXX9486 LINKEDIN,,,Other,-2
63bfb29b2e1a0ebb7f629218,50200023535069,-502922.55,60ec41ba55c00300382672d9,HDFC,Revenue-Mktplace,5eecc6d6449e4f7cfb1c2708,2022-10-03T00:00:00.000Z,CRV POS 514834******9486 FLIPKART,shopping,,refund,25000
63bfb29b2e1a0ebb7f62921a,50200023535069,-247922.55,60ec41ba55c00300382672d9,HDFC,Loan-in,5eecc6d6449e4f7cfb1c2708,2022-10-04T00:00:00.000Z,SWEEP-IN CREDIT - 50300684649760,,,self_transfer,255000
63bfb29b2e1a0ebb7f62921c,50200023535069,-190814.55,60ec41ba55c00300382672d9,HDFC,Loan-in,5eecc6d6449e4f7cfb1c2708,2022-10-04T00:00:00.000Z,SWEEP-IN CREDIT - 50300684649760,,,self_transfer,57108
63bfb29b2e1a0ebb7f62921e,50200023535069,-40814.55,60ec41ba55c00300382672d9,HDFC,Loan-in,5eecc6d6449e4f7cfb1c2708,2022-10-04T00:00:00.000Z,SWEEP-IN CREDIT - 50300684649760,,,self_transfer,150000
63bfb29b2e1a0ebb7f629220,50200023535069,-30814.55,60ec41ba55c00300382672d9,HDFC,Loan-in,5eecc6d6449e4f7cfb1c2708,2022-10-04T00:00:00.000Z,SWEEP-IN CREDIT - 50300684649760,,,self_transfer,10000
63bfb29b2e1a0ebb7f629222,50200023535069,-30812.55,60ec41ba55c00300382672d9,HDFC,Loan-in,5eecc6d6449e4f7cfb1c2708,2022-10-04T00:00:00.000Z,SWEEP-IN CREDIT - 50300684649760,,,self_transfer,2
63bfb29b2e1a0ebb7f629224,50200023535069,-11227.55,60ec41ba55c00300382672d9,HDFC,Loan-in,5eecc6d6449e4f7cfb1c2708,2022-10-04T00:00:00.000Z,SWEEP-IN CREDIT - 50300684649760,,,self_transfer,19585
63bfb29b2e1a0ebb7f629226,50200023535069,0.45,60ec41ba55c00300382672d9,HDFC,Loan-in,5eecc6d6449e4f7cfb1c2708,2022-10-04T00:00:00.000Z,SWEEP-IN CREDIT - 50300684649760,,,self_transfer,11228
63bfb29c2e1a0ebb7f629228,50200023535069,10975.87,60ec41ba55c00300382672d9,HDFC,Revenue-PG-non-split,5eecc6d6449e4f7cfb1c2708,2022-10-04T00:00:00.000Z,NEFT CR-PYTM0123456-PAYTM PAYMENTS SERVI CES LIMITED-SLICK ORGANICS PVT LTD-PYTM2 22770599138,ewallet,,net_banking_transfer,10975.42
63bfb29c2e1a0ebb7f62922b,50200023535069,518054.38,60ec41ba55c00300382672d9,HDFC,Revenue-Mktplace,5eecc6d6449e4f7cfb1c2708,2022-10-04T00:00:00.000Z,NEFT CR-DEUT0797BGL-AMAZON PAY (INDIA) P,shopping,,net_banking_transfer,507078.51
63bfb29c2e1a0ebb7f62922d,50200023535069,677874.35,60ec41ba55c00300382672d9,HDFC,Revenue-Mktplace,5eecc6d6449e4f7cfb1c2708,2022-10-04T00:00:00.000Z,IMPS-227705371836-AMAZON SELLER SERVIC-H SBC-XXXXXXXX6004-4I2A1WVK0ZG3OGLYSLICK O RGANICS PVT LTD,shopping,,net_banking_transfer,159819.97
63bfb29c2e1a0ebb7f629230,50200023535069,177874.35,60ec41ba55c00300382672d9,HDFC,direct expenses,5eecc6d6449e4f7cfb1c2708,2022-10-04T00:00:00.000Z,05892560000649-TPT-500000-DECORPAC INDIA PRIVATE LIMITED,,,net_banking_transfer,-500000
63bfb29c2e1a0ebb7f629234,50200023535069,-322125.65,60ec41ba55c00300382672d9,HDFC,direct expenses,5eecc6d6449e4f7cfb1c2708,2022-10-04T00:00:00.000Z,"NEFT DR-ICIC0000369-BO INTERNATIONAL-NET BANK, MUM-N277222146411748-500000",,,net_banking_transfer,-500000
63bfb29c2e1a0ebb7f629237,50200023535069,-397173.65,60ec41ba55c00300382672d9,HDFC,direct expenses,5eecc6d6449e4f7cfb1c2708,2022-10-04T00:00:00.000Z,"NEFT DR-ICIC0006643-KRISHNA PACKAGING CO MPANY-NETBANK, MUM-N277222146393670-7504 8",,,net_banking_transfer,-75048
63bfb29c2e1a0ebb7f629239,50200023535069,-845173.65,60ec41ba55c00300382672d9,HDFC,direct expenses,5eecc6d6449e4f7cfb1c2708,2022-10-04T00:00:00.000Z,"NEFT DR-KKBK0002499-HITESH MALHOTRA-NETB ANK, MUM-N277222146431653-448000",,,net_banking_transfer,-448000
63bfb29c2e1a0ebb7f62923b,50200023535069,-836346.57,60ec41ba55c00300382672d9,HDFC,Revenue-PG-split enabled,5eecc6d6449e4f7cfb1c2708,2022-10-04T00:00:00.000Z,NEFT CR-UTIB0001506-RAZORPAY SOFTWARE PR IVATE LIMITED-SLICK ORGANICS PVT LITD-AX ISCN0170105307,,,net_banking_transfer,8827.08
63bfb29c2e1a0ebb7f62923d,50200023535069,-832423.44,60ec41ba55c00300382672d9,HDFC,Revenue-PG-non-split,5eecc6d6449e4f7cfb1c2708,2022-10-04T00:00:00.000Z,NEFT CR-KKBK0000958-NODAL ACCOUNT BROKEN TUSK TECHNOL-SLICK ORGANICS PRIVATE LIMI TED-CMS2772227983116,,,net_banking_transfer,3923.13
63bfb29c2e1a0ebb7f62923f,50200023535069,-819846.03,60ec41ba55c00300382672d9,HDFC,Revenue-PG-non-split,5eecc6d6449e4f7cfb1c2708,2022-10-04T00:00:00.000Z,NEFT CR-KKBK0000958-NODAL ACCOUNT BROKEN TUSK TECHNOL-SLICK ORGANICS PRIVATE LIMI TED-CMS2772227994487,,,net_banking_transfer,12577.41
63bfb29c2e1a0ebb7f629241,50200023535069,-816383.03,60ec41ba55c00300382672d9,HDFC,Transfer in/Revenue-other,5eecc6d6449e4f7cfb1c2708,2022-10-04T00:00:00.000Z,NEFT CR-UTIB0000114-ONE SIGMA TECHNOLOGI ES PRIVATE LIM-SLICK ORGANICS PRIVATE LI MITED-AXISP00325450015,,,net_banking_transfer,3463
63bfb29c2e1a0ebb7f629243,50200023535069,-817535.03,60ec41ba55c00300382672d9,HDFC,direct expenses,5eecc6d6449e4f7cfb1c2708,2022-10-04T00:00:00.000Z,POS 514834XXXXXX9486 SMARTSHIFT LOGIS,,,debit_card,-1152
63bfb29c2e1a0ebb7f629245,50200023535069,-1072535.03,60ec41ba55c00300382672d9,HDFC,SAAS/tech expense,5eecc6d6449e4f7cfb1c2708,2022-10-04T00:00:00.000Z,POS 514834XXXXXX9486 AMAZON,shopping,,debit_card,-255000
63bfb29c2e1a0ebb7f629247,50200023535069,-1071025.03,60ec41ba55c00300382672d9,HDFC,Revenue-Mktplace,5eecc6d6449e4f7cfb1c2708,2022-10-04T00:00:00.000Z,NEFT CR-SCBL0036001-DREAMPLUG TECHNOLOGI ES PRIVATE LIMITED-SLICK ORGANICS PRIVAT E LIMITEDSLICK-IN1ON22100408VVE,,,net_banking_transfer,1510
63bfb29c2e1a0ebb7f629249,50200023535069,-1096025.03,60ec41ba55c00300382672d9,HDFC,direct expenses,5eecc6d6449e4f7cfb1c2708,2022-10-04T00:00:00.000Z,POS 514834XXXXXX9486 FLIPKART,shopping,,debit_card,-25000
63bfb29c2e1a0ebb7f62924b,50200023535069,-1092602.98,60ec41ba55c00300382672d9,HDFC,Revenue-PG-split enabled,5eecc6d6449e4f7cfb1c2708,2022-10-04T00:00:00.000Z,NEFT CR-UTIB0001506-RAZORPAY SOFTWARE PR,,,net_banking_transfer,3422.05
63bfb29c2e1a0ebb7f62924d,50200023535069,-1104602.98,60ec41ba55c00300382672d9,HDFC,direct expenses,5eecc6d6449e4f7cfb1c2708,2022-10-04T00:00:00.000Z,"NEFT DR-KARB0000113-ASHWINI N DIXIT-NETB ANK, MUM-N277222147690117-12000",,,net_banking_transfer,-12000
63bfb29c2e1a0ebb7f62924f,50200023535069,-1117102.98,60ec41ba55c00300382672d9,HDFC,direct expenses,5eecc6d6449e4f7cfb1c2708,2022-10-04T00:00:00.000Z,"NEFT DR-UTIB0004445-BUZZLER DIGITAL-NETB ANK, MUM-N277222147734053-12500",,,net_banking_transfer,-12500
63bfb29c2e1a0ebb7f629251,50200023535069,-1167102.98,60ec41ba55c00300382672d9,HDFC,direct expenses,5eecc6d6449e4f7cfb1c2708,2022-10-04T00:00:00.000Z,"NEFT DR-KKBK0000173-MATRIX PRINTING SOLU TIONS PRIVATE LIMITE-NETBANK, MUM-N27722 2147769608-50000",,,net_banking_transfer,-50000
63bfb29c2e1a0ebb7f629254,50200023535069,-1237702.98,60ec41ba55c00300382672d9,HDFC,direct expenses,5eecc6d6449e4f7cfb1c2708,2022-10-04T00:00:00.000Z,"NEFT DR-HSBC0400004-A LITTLE FLY-NETBANK , MUM-N277222147812108-70600",,,net_banking_transfer,-70600
63bfb29c2e1a0ebb7f629256,50200023535069,-1235569.65,60ec41ba55c00300382672d9,HDFC,Transfer in/Revenue-other,5eecc6d6449e4f7cfb1c2708,2022-10-04T00:00:00.000Z,NEFT CR-YESB0000001-EASEBUZZ PVT LTD NOD AL A/C-SLICK ORGANICS PVT LTD-YESB227760 40202,,,net_banking_transfer,2133.33
63bfb29c2e1a0ebb7f629258,50200023535069,-913443.65,60ec41ba55c00300382672d9,HDFC,Loan-in,5eecc6d6449e4f7cfb1c2708,2022-10-05T00:00:00.000Z,SWEEP-IN CREDIT - 50300684649760,,,self_transfer,322126
63bfb29c2e1a0ebb7f62925a,50200023535069,-838395.65,60ec41ba55c00300382672d9,HDFC,Loan-in,5eecc6d6449e4f7cfb1c2708,2022-10-05T00:00:00.000Z,SWEEP-IN CREDIT - 50300684649760,,,self_transfer,75048
63bfb29c2e1a0ebb7f62925c,50200023535069,-390395.65,60ec41ba55c00300382672d9,HDFC,Loan-in,5eecc6d6449e4f7cfb1c2708,2022-10-05T00:00:00.000Z,SWEEP-IN CREDIT - 50300684649760,,,self_transfer,448000
63bfb29c2e1a0ebb7f62925e,50200023535069,-163033.65,60ec41ba55c00300382672d9,HDFC,Loan-in,5eecc6d6449e4f7cfb1c2708,2022-10-05T00:00:00.000Z,SWEEP-IN CREDIT - 50300684649760,,,self_transfer,227362
63bfb29c2e1a0ebb7f629260,50200023535069,-139543.65,60ec41ba55c00300382672d9,HDFC,Loan-in,5eecc6d6449e4f7cfb1c2708,2022-10-05T00:00:00.000Z,SWEEP-IN CREDIT - 50300684649760,,,self_transfer,23490
63bfb29c2e1a0ebb7f629262,50200023535069,-130965.65,60ec41ba55c00300382672d9,HDFC,Loan-in,5eecc6d6449e4f7cfb1c2708,2022-10-05T00:00:00.000Z,SWEEP-IN CREDIT - 50300684649760,,,self_transfer,8578
63bfb29c2e1a0ebb7f629264,50200023535069,-118465.65,60ec41ba55c00300382672d9,HDFC,Loan-in,5eecc6d6449e4f7cfb1c2708,2022-10-05T00:00:00.000Z,SWEEP-IN CREDIT - 50300684649760,,,self_transfer,12500
63bfb29c2e1a0ebb7f629266,50200023535069,-68465.65,60ec41ba55c00300382672d9,HDFC,Loan-in,5eecc6d6449e4f7cfb1c2708,2022-10-05T00:00:00.000Z,SWEEP-IN CREDIT - 50300684649760,,,self_transfer,50000
63bfb29c2e1a0ebb7f629268,50200023535069,0.35,60ec41ba55c00300382672d9,HDFC,Loan-in,5eecc6d6449e4f7cfb1c2708,2022-10-05T00:00:00.000Z,SWEEP-IN CREDIT - 50300684649760,,,self_transfer,68466
63bfb29c2e1a0ebb7f62926a,50200023535069,17583.7,60ec41ba55c00300382672d9,HDFC,Revenue-PG-non-split,5eecc6d6449e4f7cfb1c2708,2022-10-05T00:00:00.000Z,NEFT CR-PYTM0123456-PAYTM PAYMENTS SERVI CES LIMITED-SLICK ORGANICS PVT LTD-PYTM2 22783309851,ewallet,,net_banking_transfer,17583.35
63bfb29c2e1a0ebb7f62926c,50200023535069,7583.7,60ec41ba55c00300382672d9,HDFC,direct expenses,5eecc6d6449e4f7cfb1c2708,2022-10-05T00:00:00.000Z,"NEFT DR-ICIC0000314-UPASANA KOCHHAR-NETB ANK, MUM-N278222148343814-10000",,,net_banking_transfer,-10000
63bfb29c2e1a0ebb7f62926e,50200023535069,7903.06,60ec41ba55c00300382672d9,HDFC,Transfer in/Revenue-other,5eecc6d6449e4f7cfb1c2708,2022-10-05T00:00:00.000Z,NEFT CR-UTIB0000114-ONE SIGMA TECHNOLOGI ES PRIVATE LIM-SLICK ORGANICS PRIVATE LI MITED-AXISP00325701166,,,net_banking_transfer,319.36
63bfb29c2e1a0ebb7f629270,50200023535069,27903.06,60ec41ba55c00300382672d9,HDFC,Revenue-Mktplace,5eecc6d6449e4f7cfb1c2708,2022-10-05T00:00:00.000Z,CRV POS 514834******9486 FLIPKART,shopping,,refund,20000
63bfb29c2e1a0ebb7f629272,50200023535069,40328.38,60ec41ba55c00300382672d9,HDFC,Revenue-PG-non-split,5eecc6d6449e4f7cfb1c2708,2022-10-06T00:00:00.000Z,NEFT CR-PYTM0123456-PAYTM PAYMENTS SERVI CES LIMITED-SLICK ORGANICS PVT LTD-PYTM2 22794112009,ewallet,,net_banking_transfer,12425.32
63bfb29c2e1a0ebb7f629274,50200023535069,47874.22,60ec41ba55c00300382672d9,HDFC,Revenue-Mktplace,5eecc6d6449e4f7cfb1c2708,2022-10-06T00:00:00.000Z,NEFT CR-DEUT0797BGL-MYNTRA DESIGNS PRIVA TE LIMITED-SLICK ORGANICS PVT. LTD.-2279 00475GN00290,shopping,,net_banking_transfer,7545.84
63bfb29c2e1a0ebb7f629276,50200023535069,63502.18,60ec41ba55c00300382672d9,HDFC,Revenue-Mktplace,5eecc6d6449e4f7cfb1c2708,2022-10-06T00:00:00.000Z,NEFT CR-DEUT0797BGL-MYNTRA DESIGNS PRIVA TE LIMITED-SLICK ORGANICS PVT. LTD.-2279 00480GN00173,shopping,,net_banking_transfer,15627.96
63bfb29c2e1a0ebb7f629278,50200023535069,95647.69,60ec41ba55c00300382672d9,HDFC,Revenue-PG-split enabled,5eecc6d6449e4f7cfb1c2708,2022-10-06T00:00:00.000Z,NEFT CR-UTIB0001506-RAZORPAY SOFTWARE PR IVATE LIMITED-SLICK ORGANICS PVT LITD-AX ISCN0170291114,,,net_banking_transfer,32145.51
63bfb29c2e1a0ebb7f62927b,50200023535069,49191.69,60ec41ba55c00300382672d9,HDFC,direct expenses,5eecc6d6449e4f7cfb1c2708,2022-10-06T00:00:00.000Z,02711600008220-TPT-46456-VARUN SINGH,,,net_banking_transfer,-46456
63bfb29c2e1a0ebb7f62927d,50200023535069,34191.69,60ec41ba55c00300382672d9,HDFC,direct expenses,5eecc6d6449e4f7cfb1c2708,2022-10-06T00:00:00.000Z,"NEFT DR-ICIC0006956-LAKSHAY CARRYING COR PORATION-NETBANK, MUM-N279222148970894-1 5000",,,net_banking_transfer,-15000
63bfb29c2e1a0ebb7f629280,50200023535069,39837.6,60ec41ba55c00300382672d9,HDFC,Transfer in/Revenue-other,5eecc6d6449e4f7cfb1c2708,2022-10-06T00:00:00.000Z,NEFT CR-UTIB0000114-ONE SIGMA TECHNOLOGI ES PRIVATE LIM-SLICK ORGANICS PRIVATE LI MITED-AXISP00325807068,,,net_banking_transfer,5645.91
63bfb29c2e1a0ebb7f629283,50200023535069,122684.46,60ec41ba55c00300382672d9,HDFC,Revenue-COD,5eecc6d6449e4f7cfb1c2708,2022-10-06T00:00:00.000Z,NEFT CR-ICIC0000155-SHIPROCKET COD CRF I D 4992496-SLICK ORGANICS PVT LTD-CMS2873 915771,,,net_banking_transfer,82846.86
63bfb29c2e1a0ebb7f629285,50200023535069,196883.47,60ec41ba55c00300382672d9,HDFC,Transfer in/Revenue-other,5eecc6d6449e4f7cfb1c2708,2022-10-06T00:00:00.000Z,NEFT CR-YESB0000001-EASEBUZZ PVT LTD NOD AL A/C-SLICK ORGANICS PVT LTD-YESB227914 54941,,,net_banking_transfer,74199.01
63bfb29c2e1a0ebb7f629287,50200023535069,199545.6,60ec41ba55c00300382672d9,HDFC,Revenue-PG-split enabled,5eecc6d6449e4f7cfb1c2708,2022-10-06T00:00:00.000Z,NEFT CR-UTIB0001506-RAZORPAY SOFTWARE PR IVATE LIMITED-SLICK ORGANICS PVT LITD-AX ISCN0170404272,,,net_banking_transfer,2662.13
63bfb29c2e1a0ebb7f62928a,50200023535069,-55454.4,60ec41ba55c00300382672d9,HDFC,SAAS/tech expense,5eecc6d6449e4f7cfb1c2708,2022-10-06T00:00:00.000Z,POS 514834XXXXXX9486 AMAZON,shopping,,debit_card,-255000
63bfb29c2e1a0ebb7f62928c,50200023535069,-55435.4,60ec41ba55c00300382672d9,HDFC,Transfer in/Revenue-other,5eecc6d6449e4f7cfb1c2708,2022-10-07T00:00:00.000Z,INT. ON SWCR ON-50300684649760,,,Other,19
63bfb29c2e1a0ebb7f62928e,50200023535069,19.6,60ec41ba55c00300382672d9,HDFC,Loan-in,5eecc6d6449e4f7cfb1c2708,2022-10-07T00:00:00.000Z,SWEEP-IN CREDIT - 50300684649760,,,self_transfer,55455
63bfb29c2e1a0ebb7f629290,50200023535069,-209420.4,60ec41ba55c00300382672d9,HDFC,direct expenses,5eecc6d6449e4f7cfb1c2708,2022-10-07T00:00:00.000Z,02711930004579 NET BANKING SI -209440,,,Other,-209440
63bfb29c2e1a0ebb7f629292,50200023535069,-271920.4,60ec41ba55c00300382672d9,HDFC,direct expenses,5eecc6d6449e4f7cfb1c2708,2022-10-07T00:00:00.000Z,50100064106714 NET BANKING SI -62500,,,Other,-62500
63bfb29c2e1a0ebb7f629294,50200023535069,-321920.4,60ec41ba55c00300382672d9,HDFC,direct expenses,5eecc6d6449e4f7cfb1c2708,2022-10-07T00:00:00.000Z,50100108772229 NET BANKING SI -50000,,,Other,-50000
63bfb29c2e1a0ebb7f629296,50200023535069,-495439.4,60ec41ba55c00300382672d9,HDFC,direct expenses,5eecc6d6449e4f7cfb1c2708,2022-10-07T00:00:00.000Z,50100155115510 NET BANKING SI -173519,,,Other,-173519
63bfb29c2e1a0ebb7f629299,50200023535069,-554569.4,60ec41ba55c00300382672d9,HDFC,direct expenses,5eecc6d6449e4f7cfb1c2708,2022-10-07T00:00:00.000Z,50100349886722 NET BANKING SI -59130,,,Other,-59130
63bfb29c2e1a0ebb7f62929b,50200023535069,-592585.4,60ec41ba55c00300382672d9,HDFC,direct expenses,5eecc6d6449e4f7cfb1c2708,2022-10-07T00:00:00.000Z,00901610080520 NET BANKING SI -38016,,,Other,-38016
63bfb29c2e1a0ebb7f62929d,50200023535069,-719169.4,60ec41ba55c00300382672d9,HDFC,direct expenses,5eecc6d6449e4f7cfb1c2708,2022-10-07T00:00:00.000Z,50100093802387 NET BANKING SI -126584,,,Other,-126584
63bfb29c2e1a0ebb7f62929f,50200023535069,-734609.4,60ec41ba55c00300382672d9,HDFC,direct expenses,5eecc6d6449e4f7cfb1c2708,2022-10-07T00:00:00.000Z,50100312215410 NET BANKING SI -15440,,,Other,-15440
63bfb29c2e1a0ebb7f6292a1,50200023535069,-754459.4,60ec41ba55c00300382672d9,HDFC,direct expenses,5eecc6d6449e4f7cfb1c2708,2022-10-07T00:00:00.000Z,02711600008220 NET BANKING SI -19850,,,Other,-19850
63bfb29c2e1a0ebb7f6292a4,50200023535069,-915394.4,60ec41ba55c00300382672d9,HDFC,direct expenses,5eecc6d6449e4f7cfb1c2708,2022-10-07T00:00:00.000Z,09291610057185 NET BANKING SI -160935,,,Other,-160935
63bfb29c2e1a0ebb7f6292a6,50200023535069,-1012594.4,60ec41ba55c00300382672d9,HDFC,direct expenses,5eecc6d6449e4f7cfb1c2708,2022-10-07T00:00:00.000Z,00321000085687 NET BANKING SI -97200,,,Other,-97200
63bfb29c2e1a0ebb7f6292a8,50200023535069,-1092016.4,60ec41ba55c00300382672d9,HDFC,direct expenses,5eecc6d6449e4f7cfb1c2708,2022-10-07T00:00:00.000Z,50100293329616 NET BANKING SI -79422,,,Other,-79422
63bfb29c2e1a0ebb7f6292aa,50200023535069,-1268229.4,60ec41ba55c00300382672d9,HDFC,direct expenses,5eecc6d6449e4f7cfb1c2708,2022-10-07T00:00:00.000Z,50100093802387 NET BANKING SI -176213,,,Other,-176213
63bfb29c2e1a0ebb7f6292ac,50200023535069,-1487339.4,60ec41ba55c00300382672d9,HDFC,direct expenses,5eecc6d6449e4f7cfb1c2708,2022-10-07T00:00:00.000Z,NEFT DR-SCBL0036025-DHRUV MADHOK-SANDOZ - MUM-N280222150453828-NET BANKING SI -2 19110,,,net_banking_transfer,-219110
63bfb29c2e1a0ebb7f6292ae,50200023535069,-1591200.4,60ec41ba55c00300382672d9,HDFC,direct expenses,5eecc6d6449e4f7cfb1c2708,2022-10-07T00:00:00.000Z,NEFT DR-ICIC0000021-AKHILESH DIXIT-SANDO Z - MUM-N280222150453830-NET BANKING SI -103861,,,net_banking_transfer,-103861
63bfb29d2e1a0ebb7f6292b0,50200023535069,-1620200.4,60ec41ba55c00300382672d9,HDFC,direct expenses,5eecc6d6449e4f7cfb1c2708,2022-10-07T00:00:00.000Z,NEFT DR-SIBL0000555-JAIVEER KUMAR-SANDOZ - MUM-N280222150453832-NET BANKING SI - 29000,,,net_banking_transfer,-29000
63bfb29d2e1a0ebb7f6292b2,50200023535069,-1645200.4,60ec41ba55c00300382672d9,HDFC,direct expenses,5eecc6d6449e4f7cfb1c2708,2022-10-07T00:00:00.000Z,NEFT DR-BARB0VJGRKA-OM PRASAD PANDEY-SAN DOZ - MUM-N280222150453834-NET BANKING S I -25000,,,net_banking_transfer,-25000
63bfb29d2e1a0ebb7f6292b4,50200023535069,-1669200.4,60ec41ba55c00300382672d9,HDFC,direct expenses,5eecc6d6449e4f7cfb1c2708,2022-10-07T00:00:00.000Z,NEFT DR-PUNB0482100-RAM BHAVAN YADAV-SAN DOZ - MUM-N280222150453836-NET BANKING S I -24000,,,net_banking_transfer,-24000
63bfb29d2e1a0ebb7f6292b6,50200023535069,-1727867.4,60ec41ba55c00300382672d9,HDFC,direct expenses,5eecc6d6449e4f7cfb1c2708,2022-10-07T00:00:00.000Z,NEFT DR-PUNB0150400-SAGARIKA DEBNATH-SA NDOZ - MUM-N280222150453838-NET BANKING SI -58667,,,net_banking_transfer,-58667
63bfb29d2e1a0ebb7f6292b8,50200023535069,-1816267.4,60ec41ba55c00300382672d9,HDFC,direct expenses,5eecc6d6449e4f7cfb1c2708,2022-10-07T00:00:00.000Z,NEFT DR-IOBA0001445-PRIYANKA GOPAL-SANDO,,,net_banking_transfer,-88400
63bfb29d2e1a0ebb7f6292ba,50200023535069,-1882667.4,60ec41ba55c00300382672d9,HDFC,direct expenses,5eecc6d6449e4f7cfb1c2708,2022-10-07T00:00:00.000Z,NEFT DR-UTIB0000120-ADNAN ALI-SANDOZ - M UM-N280222150453842-NET BANKING SI -6640 0,,,net_banking_transfer,-66400
63bfb29d2e1a0ebb7f6292bc,50200023535069,-1933194.4,60ec41ba55c00300382672d9,HDFC,direct expenses,5eecc6d6449e4f7cfb1c2708,2022-10-07T00:00:00.000Z,NEFT DR-KKBK0008066-KUSHAGRA SINGH-SANDO Z - MUM-N280222150453844-NET BANKING SI -50527,,,net_banking_transfer,-50527
63bfb29d2e1a0ebb7f6292bf,50200023535069,-1975594.4,60ec41ba55c00300382672d9,HDFC,direct expenses,5eecc6d6449e4f7cfb1c2708,2022-10-07T00:00:00.000Z,NEFT DR-UTIB0001720-ANUBHAV RAO-SANDOZ - MUM-N280222150453846-NET BANKING SI -42 400,,,net_banking_transfer,-42400
63bfb29d2e1a0ebb7f6292c1,50200023535069,-2005124.4,60ec41ba55c00300382672d9,HDFC,direct expenses,5eecc6d6449e4f7cfb1c2708,2022-10-07T00:00:00.000Z,NEFT DR-SBIN0008079-DHARAMVEER-SANDOZ - MUM-N280222150453848-NET BANKING SI -295 30,,,net_banking_transfer,-29530
63bfb29d2e1a0ebb7f6292c4,50200023535069,-2034624.4,60ec41ba55c00300382672d9,HDFC,direct expenses,5eecc6d6449e4f7cfb1c2708,2022-10-07T00:00:00.000Z,NEFT DR-KKBK0004632-DOLLY JAIN-SANDOZ - MUM-N280222150453850-NET BANKING SI -295 00,,,net_banking_transfer,-29500
63bfb29d2e1a0ebb7f6292c6,50200023535069,-2053702.4,60ec41ba55c00300382672d9,HDFC,N-ACH payments,5eecc6d6449e4f7cfb1c2708,2022-10-07T00:00:00.000Z,NEFT DR-DBSS0IN0811-SACHIN SINGH-SANDOZ - MUM-N280222150453852-NET BANKING SI -1 9078,,,net_banking_transfer,-19078
63bfb29d2e1a0ebb7f6292c8,50200023535069,-2071872.4,60ec41ba55c00300382672d9,HDFC,direct expenses,5eecc6d6449e4f7cfb1c2708,2022-10-07T00:00:00.000Z,NEFT DR-PUNB0307800-SANJEEV NIRMANIA-SAN DOZ - MUM-N280222150453854-NET BANKING S I -18170,,,net_banking_transfer,-18170
63bfb29d2e1a0ebb7f6292ca,50200023535069,-2089088.4,60ec41ba55c00300382672d9,HDFC,direct expenses,5eecc6d6449e4f7cfb1c2708,2022-10-07T00:00:00.000Z,NEFT DR-SBIN0017746-MANOJ KUMAR-SANDOZ - MUM-N280222150453857-NET BANKING SI -17 216,,,net_banking_transfer,-17216
63bfb29d2e1a0ebb7f6292cc,50200023535069,-2104169.4,60ec41ba55c00300382672d9,HDFC,Salary/Emp/consultant Expense,5eecc6d6449e4f7cfb1c2708,2022-10-07T00:00:00.000Z,NEFT DR-CNRB0019016-MANEESH-SANDOZ - MUM -N280222150453859-NET BANKING SI -SALARY,,,net_banking_transfer,-15081
63bfb29d2e1a0ebb7f6292ce,50200023535069,-2119250.4,60ec41ba55c00300382672d9,HDFC,direct expenses,5eecc6d6449e4f7cfb1c2708,2022-10-07T00:00:00.000Z,NEFT DR-SCBL0036023-VIVEK YADAV-SANDOZ - MUM-N280222150453861-NET BANKING SI -15 081,,,net_banking_transfer,-15081
63bfb29d2e1a0ebb7f6292d0,50200023535069,-2134331.4,60ec41ba55c00300382672d9,HDFC,direct expenses,5eecc6d6449e4f7cfb1c2708,2022-10-07T00:00:00.000Z,NEFT DR-SCBL0036028-SHUBHAM SINGH PANWAR,,,net_banking_transfer,-15081
63bfb29d2e1a0ebb7f6292d2,50200023535069,-2150194.4,60ec41ba55c00300382672d9,HDFC,direct expenses,5eecc6d6449e4f7cfb1c2708,2022-10-07T00:00:00.000Z,NEFT DR-SBIN0008132-VIKASH KUMAR-SANDOZ - MUM-N280222150453865-NET BANKING SI -1 5863,,,net_banking_transfer,-15863
63bfb29d2e1a0ebb7f6292d4,50200023535069,-2171036.4,60ec41ba55c00300382672d9,HDFC,direct expenses,5eecc6d6449e4f7cfb1c2708,2022-10-07T00:00:00.000Z,NEFT DR-KKBK0005032-DEEPAK YADAV-SANDOZ - MUM-N280222150453867-NET BANKING SI -2 0842,,,net_banking_transfer,-20842
63bfb29d2e1a0ebb7f6292d6,50200023535069,-2190886.4,60ec41ba55c00300382672d9,HDFC,direct expenses,5eecc6d6449e4f7cfb1c2708,2022-10-07T00:00:00.000Z,NEFT DR-PUNB0494300-KUNDAN PRASAD-SANDOZ - MUM-N280222150453869-NET BANKING SI - 19850,,,net_banking_transfer,-19850
63bfb29d2e1a0ebb7f6292d8,50200023535069,-2209743.4,60ec41ba55c00300382672d9,HDFC,direct expenses,5eecc6d6449e4f7cfb1c2708,2022-10-07T00:00:00.000Z,NEFT DR-PUNB0151400-BHUWAN CHANDER JOSHI -SANDOZ - MUM-N280222150453871-NET BANKI NG SI -18857,,,net_banking_transfer,-18857
63bfb29d2e1a0ebb7f6292da,50200023535069,-2228600.4,60ec41ba55c00300382672d9,HDFC,direct expenses,5eecc6d6449e4f7cfb1c2708,2022-10-07T00:00:00.000Z,NEFT DR-BARB0DINARA-MD ARIF RAZA-SANDOZ - MUM-N280222150453873-NET BANKING SI -1 8857,,,net_banking_transfer,-18857
63bfb29d2e1a0ebb7f6292dc,50200023535069,-2422647.4,60ec41ba55c00300382672d9,HDFC,direct expenses,5eecc6d6449e4f7cfb1c2708,2022-10-07T00:00:00.000Z,NEFT DR-KKBK0000261-TANVI TANEJA-SANDOZ - MUM-N280222150453875-NET BANKING SI -1 94047,,,net_banking_transfer,-194047
63bfb29d2e1a0ebb7f6292de,50200023535069,-2499772.4,60ec41ba55c00300382672d9,HDFC,direct expenses,5eecc6d6449e4f7cfb1c2708,2022-10-07T00:00:00.000Z,NEFT DR-SBIN0070392-APARNA MOHANAN KONAT -SANDOZ - MUM-N280222150453877-NET BANKI NG SI -77125,,,net_banking_transfer,-77125
63bfb29d2e1a0ebb7f6292e0,50200023535069,-2554772.4,60ec41ba55c00300382672d9,HDFC,direct expenses,5eecc6d6449e4f7cfb1c2708,2022-10-07T00:00:00.000Z,NEFT DR-ICIC0003851-JITENDER KUMAR-SANDO Z - MUM-N280222150453879-NET BANKING SI -55000,,,net_banking_transfer,-55000
63bfb29d2e1a0ebb7f6292e2,50200023535069,-2424516.41,60ec41ba55c00300382672d9,HDFC,Revenue-Mktplace,5eecc6d6449e4f7cfb1c2708,2022-10-07T00:00:00.000Z,NEFT CR-DEUT0797BGL-FLIPKART INTERNET PR IVATE LIMITED-SLICK ORGANICS PVT LTD-228 000132GN00211,shopping,,net_banking_transfer,130255.99
63bfb29d2e1a0ebb7f6292e4,50200023535069,-2419597.28,60ec41ba55c00300382672d9,HDFC,Revenue-PG-non-split,5eecc6d6449e4f7cfb1c2708,2022-10-07T00:00:00.000Z,NEFT CR-PYTM0123456-PAYTM PAYMENTS SERVI CES LIMITED-SLICK ORGANICS PVT LTD-PYTM2 22805762677,ewallet,,net_banking_transfer,4919.13
63bfb29d2e1a0ebb7f6292e6,50200023535069,-2418675.28,60ec41ba55c00300382672d9,HDFC,Transfer in/Revenue-other,5eecc6d6449e4f7cfb1c2708,2022-10-07T00:00:00.000Z,NEFT CR-UTIB0004405-WOOVLY INDIA PRIVATE,,,net_banking_transfer,922
63bfb29d2e1a0ebb7f6292e8,50200023535069,-2411962.06,60ec41ba55c00300382672d9,HDFC,Revenue-PG-split enabled,5eecc6d6449e4f7cfb1c2708,2022-10-07T00:00:00.000Z,NEFT CR-UTIB0001506-RAZORPAY SOFTWARE PR IVATE LIMITED-SLICK ORGANICS PVT LITD-AX ISCN0170496983,,,net_banking_transfer,6713.22
63bfb29d2e1a0ebb7f6292ea,50200023535069,-2407675.61,60ec41ba55c00300382672d9,HDFC,Revenue-Mktplace,5eecc6d6449e4f7cfb1c2708,2022-10-07T00:00:00.000Z,NEFT CR-DEUT0797BGL-MYNTRA DESIGNS PRIVA TE LIMITED-SLICK ORGANICS PVT. LTD.-2280 00707GN00190,shopping,,net_banking_transfer,4286.45
63bfb29d2e1a0ebb7f6292ec,50200023535069,-2417675.61,60ec41ba55c00300382672d9,HDFC,Refund,5eecc6d6449e4f7cfb1c2708,2022-10-07T00:00:00.000Z,IMPS-228010198187-RAZORPAY REFUND CREDIT S TOPUP-RATN-XXXXXXXXXXXX8432-10000,,,net_banking_transfer,-10000
63bfb29d2e1a0ebb7f6292ee,50200023535069,-2523228.61,60ec41ba55c00300382672d9,HDFC,direct expenses,5eecc6d6449e4f7cfb1c2708,2022-10-07T00:00:00.000Z,"NEFT DR-KKBK0000261-AAYUSHI PAREEK-NETBA NK, MUM-N280222150992415-105553",,,net_banking_transfer,-105553
63bfb29d2e1a0ebb7f6292f0,50200023535069,-2568228.61,60ec41ba55c00300382672d9,HDFC,direct expenses,5eecc6d6449e4f7cfb1c2708,2022-10-07T00:00:00.000Z,"NEFT DR-ICIC0000314-ATUL VAISHNAV-NETBAN K, MUM-N280222150984638-45000",,,net_banking_transfer,-45000
63bfb29d2e1a0ebb7f6292f2,50200023535069,-2583101.61,60ec41ba55c00300382672d9,HDFC,direct expenses,5eecc6d6449e4f7cfb1c2708,2022-10-07T00:00:00.000Z,50100093802387-TPT-14873-ISSHANA MAHAJAN,,,net_banking_transfer,-14873
63bfb29d2e1a0ebb7f6292f4,50200023535069,-2593565.61,60ec41ba55c00300382672d9,HDFC,direct expenses,5eecc6d6449e4f7cfb1c2708,2022-10-07T00:00:00.000Z,"NEFT DR-ICIC0002697-NITISH KUMAR-NETBANK , MUM-N280222151042302-10464",,,net_banking_transfer,-10464
63bfb29d2e1a0ebb7f6292f6,50200023535069,-2595970.61,60ec41ba55c00300382672d9,HDFC,direct expenses,5eecc6d6449e4f7cfb1c2708,2022-10-07T00:00:00.000Z,"NEFT DR-ICIC0000021-AKHILESH DIXIT-NETBA NK, MUM-N280222151232782-2405",,,net_banking_transfer,-2405
63bfb29d2e1a0ebb7f6292f8,50200023535069,-2591007.61,60ec41ba55c00300382672d9,HDFC,Transfer in/Revenue-other,5eecc6d6449e4f7cfb1c2708,2022-10-07T00:00:00.000Z,NEFT CR-HSBC0560002-INNOVATIVE RETAIL CO NCEPTS PRIVATE-SLICK ORGANICS PVT LTD-HS BCN22280171978,,,net_banking_transfer,4963
63bfb29d2e1a0ebb7f6292fb,50200023535069,-2586141.11,60ec41ba55c00300382672d9,HDFC,Transfer in/Revenue-other,5eecc6d6449e4f7cfb1c2708,2022-10-07T00:00:00.000Z,NEFT CR-HSBC0560002-INNOVATIVE RETAIL CO NCEPTS PRIVATE-SLICK ORGANICS PVT LTD-HS BCN22280172001,,,net_banking_transfer,4866.5
63bfb29d2e1a0ebb7f6292fd,50200023535069,-2580866.11,60ec41ba55c00300382672d9,HDFC,Transfer in/Revenue-other,5eecc6d6449e4f7cfb1c2708,2022-10-07T00:00:00.000Z,NEFT CR-HSBC0560002-INNOVATIVE RETAIL CO NCEPTS PRIVATE-SLICK ORGANICS PVT LTD-HS BCN22280171980,,,net_banking_transfer,5275
63bfb29d2e1a0ebb7f6292ff,50200023535069,-2581587.11,60ec41ba55c00300382672d9,HDFC,direct expenses,5eecc6d6449e4f7cfb1c2708,2022-10-07T00:00:00.000Z,POS 514834XXXXXX9486 ONE97 COMMUNICAT,ewallet,,debit_card,-721
63bfb29d2e1a0ebb7f629302,50200023535069,-2579819.02,60ec41ba55c00300382672d9,HDFC,Transfer in/Revenue-other,5eecc6d6449e4f7cfb1c2708,2022-10-07T00:00:00.000Z,NEFT CR-UTIB0000114-ONE SIGMA TECHNOLOGI,,,net_banking_transfer,1768.09
63bfb29d2e1a0ebb7f629304,50200023535069,-2575771.46,60ec41ba55c00300382672d9,HDFC,Revenue-COD,5eecc6d6449e4f7cfb1c2708,2022-10-07T00:00:00.000Z,NEFT CR-ICIC0000155-SHIPROCKET COD CRF I D 5004702-SLICK ORGANICS PVT LTD-CMS2876 534471,,,net_banking_transfer,4047.56
63bfb29d2e1a0ebb7f629306,50200023535069,-2546481.95,60ec41ba55c00300382672d9,HDFC,Transfer in/Revenue-other,5eecc6d6449e4f7cfb1c2708,2022-10-07T00:00:00.000Z,NEFT CR-YESB0000001-EASEBUZZ PVT LTD NOD AL A/C-SLICK ORGANICS PVT LTD-YESB228043 36227,,,net_banking_transfer,29289.51
63bfb29d2e1a0ebb7f629308,50200023535069,-2548522.95,60ec41ba55c00300382672d9,HDFC,SAAS/tech expense,5eecc6d6449e4f7cfb1c2708,2022-10-07T00:00:00.000Z,POS 514834XXXXXX9486 AMAZON,shopping,,debit_card,-2041
63bfb29d2e1a0ebb7f62930a,50200023535069,-2541644.2,60ec41ba55c00300382672d9,HDFC,Revenue-PG-split enabled,5eecc6d6449e4f7cfb1c2708,2022-10-07T00:00:00.000Z,NEFT CR-UTIB0001506-RAZORPAY SOFTWARE PR IVATE LIMITED-SLICK ORGANICS PVT LITD-AX ISCN0170653905,,,net_banking_transfer,6878.75
63bfb29d2e1a0ebb7f62930c,50200023535069,-2541564.2,60ec41ba55c00300382672d9,HDFC,Transfer in/Revenue-other,5eecc6d6449e4f7cfb1c2708,2022-10-08T00:00:00.000Z,INT. ON SWCR ON-50300684649760,,,Other,80
63bfb29d2e1a0ebb7f62930e,50200023535069,-2332143.2,60ec41ba55c00300382672d9,HDFC,Loan-in,5eecc6d6449e4f7cfb1c2708,2022-10-08T00:00:00.000Z,SWEEP-IN CREDIT - 50300684649760,,,self_transfer,209421
63bfb29d2e1a0ebb7f629310,50200023535069,-2332119.2,60ec41ba55c00300382672d9,HDFC,Transfer in/Revenue-other,5eecc6d6449e4f7cfb1c2708,2022-10-08T00:00:00.000Z,INT. ON SWCR ON-50300684649760,,,Other,24
63bfb29d2e1a0ebb7f629312,50200023535069,-2269619.2,60ec41ba55c00300382672d9,HDFC,Loan-in,5eecc6d6449e4f7cfb1c2708,2022-10-08T00:00:00.000Z,SWEEP-IN CREDIT - 50300684649760,,,self_transfer,62500
63bfb29d2e1a0ebb7f629315,50200023535069,-2269600.2,60ec41ba55c00300382672d9,HDFC,Transfer in/Revenue-other,5eecc6d6449e4f7cfb1c2708,2022-10-08T00:00:00.000Z,INT. ON SWCR ON-50300684649760,,,Other,19
63bfb29d2e1a0ebb7f629317,50200023535069,-2219600.2,60ec41ba55c00300382672d9,HDFC,Loan-in,5eecc6d6449e4f7cfb1c2708,2022-10-08T00:00:00.000Z,SWEEP-IN CREDIT - 50300684649760,,,self_transfer,50000
63bfb29d2e1a0ebb7f629319,50200023535069,-2219533.2,60ec41ba55c00300382672d9,HDFC,Transfer in/Revenue-other,5eecc6d6449e4f7cfb1c2708,2022-10-08T00:00:00.000Z,INT. ON SWCR ON-50300684649760,,,Other,67
63bfb29d2e1a0ebb7f62931b,50200023535069,-2046014.2,60ec41ba55c00300382672d9,HDFC,Loan-in,5eecc6d6449e4f7cfb1c2708,2022-10-08T00:00:00.000Z,SWEEP-IN CREDIT - 50300684649760,,,self_transfer,173519
63bfb29d2e1a0ebb7f62931e,50200023535069,-2045991.2,60ec41ba55c00300382672d9,HDFC,Transfer in/Revenue-other,5eecc6d6449e4f7cfb1c2708,2022-10-08T00:00:00.000Z,INT. ON SWCR ON-50300684649760,,,Other,23
63bfb29d2e1a0ebb7f629320,50200023535069,-1986861.2,60ec41ba55c00300382672d9,HDFC,Loan-in,5eecc6d6449e4f7cfb1c2708,2022-10-08T00:00:00.000Z,SWEEP-IN CREDIT - 50300684649760,,,self_transfer,59130
63bfb29d2e1a0ebb7f629323,50200023535069,-1986846.2,60ec41ba55c00300382672d9,HDFC,Transfer in/Revenue-other,5eecc6d6449e4f7cfb1c2708,2022-10-08T00:00:00.000Z,INT. ON SWCR ON-50300684649760,,,Other,15
63bfb29d2e1a0ebb7f629325,50200023535069,-1948830.2,60ec41ba55c00300382672d9,HDFC,Loan-in,5eecc6d6449e4f7cfb1c2708,2022-10-08T00:00:00.000Z,SWEEP-IN CREDIT - 50300684649760,,,self_transfer,38016
63bfb29d2e1a0ebb7f629328,50200023535069,-1948781.2,60ec41ba55c00300382672d9,HDFC,Transfer in/Revenue-other,5eecc6d6449e4f7cfb1c2708,2022-10-08T00:00:00.000Z,INT. ON SWCR ON-50300684649760,,,Other,49
63bfb29d2e1a0ebb7f62932a,50200023535069,-1822197.2,60ec41ba55c00300382672d9,HDFC,Loan-in,5eecc6d6449e4f7cfb1c2708,2022-10-08T00:00:00.000Z,SWEEP-IN CREDIT - 50300684649760,,,self_transfer,126584
63bfb29d2e1a0ebb7f62932c,50200023535069,-1822191.2,60ec41ba55c00300382672d9,HDFC,Transfer in/Revenue-other,5eecc6d6449e4f7cfb1c2708,2022-10-08T00:00:00.000Z,INT. ON SWCR ON-50300684649760,,,Other,6
63bfb29d2e1a0ebb7f62932e,50200023535069,-1806751.2,60ec41ba55c00300382672d9,HDFC,Loan-in,5eecc6d6449e4f7cfb1c2708,2022-10-08T00:00:00.000Z,SWEEP-IN CREDIT - 50300684649760,,,self_transfer,15440
63bfb29e2e1a0ebb7f629330,50200023535069,-1806743.2,60ec41ba55c00300382672d9,HDFC,Transfer in/Revenue-other,5eecc6d6449e4f7cfb1c2708,2022-10-08T00:00:00.000Z,INT. ON SWCR ON-50300684649760,,,Other,8
63bfb29e2e1a0ebb7f629332,50200023535069,-1786893.2,60ec41ba55c00300382672d9,HDFC,Loan-in,5eecc6d6449e4f7cfb1c2708,2022-10-08T00:00:00.000Z,SWEEP-IN CREDIT - 50300684649760,,,self_transfer,19850
63bfb29e2e1a0ebb7f629334,50200023535069,-1786831.2,60ec41ba55c00300382672d9,HDFC,Transfer in/Revenue-other,5eecc6d6449e4f7cfb1c2708,2022-10-08T00:00:00.000Z,INT. ON SWCR ON-50300684649760,,,Other,62
63bfb29e2e1a0ebb7f629336,50200023535069,-1625896.2,60ec41ba55c00300382672d9,HDFC,Loan-in,5eecc6d6449e4f7cfb1c2708,2022-10-08T00:00:00.000Z,SWEEP-IN CREDIT - 50300684649760,,,self_transfer,160935
63bfb29e2e1a0ebb7f629338,50200023535069,-1625859.2,60ec41ba55c00300382672d9,HDFC,Transfer in/Revenue-other,5eecc6d6449e4f7cfb1c2708,2022-10-08T00:00:00.000Z,INT. ON SWCR ON-50300684649760,,,Other,37
63bfb29e2e1a0ebb7f62933a,50200023535069,-1528659.2,60ec41ba55c00300382672d9,HDFC,Loan-in,5eecc6d6449e4f7cfb1c2708,2022-10-08T00:00:00.000Z,SWEEP-IN CREDIT - 50300684649760,,,self_transfer,97200
63bfb29e2e1a0ebb7f62933c,50200023535069,-1528629.2,60ec41ba55c00300382672d9,HDFC,Transfer in/Revenue-other,5eecc6d6449e4f7cfb1c2708,2022-10-08T00:00:00.000Z,INT. ON SWCR ON-50300684649760,,,Other,30
63bfb29e2e1a0ebb7f62933e,50200023535069,-1449207.2,60ec41ba55c00300382672d9,HDFC,Loan-in,5eecc6d6449e4f7cfb1c2708,2022-10-08T00:00:00.000Z,SWEEP-IN CREDIT - 50300684649760,,,self_transfer,79422
63bfb29e2e1a0ebb7f629340,50200023535069,-1449139.2,60ec41ba55c00300382672d9,HDFC,Transfer in/Revenue-other,5eecc6d6449e4f7cfb1c2708,2022-10-08T00:00:00.000Z,INT. ON SWCR ON-50300684649760,,,Other,68
63bfb29e2e1a0ebb7f629342,50200023535069,-1272926.2,60ec41ba55c00300382672d9,HDFC,Loan-in,5eecc6d6449e4f7cfb1c2708,2022-10-08T00:00:00.000Z,SWEEP-IN CREDIT - 50300684649760,,,self_transfer,176213
63bfb29e2e1a0ebb7f629344,50200023535069,-1272438.2,60ec41ba55c00300382672d9,HDFC,Transfer in/Revenue-other,5eecc6d6449e4f7cfb1c2708,2022-10-08T00:00:00.000Z,INT. ON SWCR ON-50300684649760,,,Other,488
63bfb29e2e1a0ebb7f629346,50200023535069,488.8,60ec41ba55c00300382672d9,HDFC,Loan-in,5eecc6d6449e4f7cfb1c2708,2022-10-08T00:00:00.000Z,SWEEP-IN CREDIT - 50300684649760,,,self_transfer,1272927
63bfb29e2e1a0ebb7f629348,50200023535069,9361.5,60ec41ba55c00300382672d9,HDFC,Revenue-PG-non-split,5eecc6d6449e4f7cfb1c2708,2022-10-08T00:00:00.000Z,NEFT CR-PYTM0123456-PAYTM PAYMENTS SERVI CES LIMITED-SLICK ORGANICS PVT LTD-PYTM2 22817401573,ewallet,,net_banking_transfer,8872.7
63bfb29e2e1a0ebb7f62934b,50200023535069,6441.5,60ec41ba55c00300382672d9,HDFC,direct expenses,5eecc6d6449e4f7cfb1c2708,2022-10-08T00:00:00.000Z,"NEFT DR-BARB0SUSGUR-GREENIECAN INDIA-NET BANK, MUM-N281222153771348-2920",,,net_banking_transfer,-2920
63bfb29e2e1a0ebb7f62934e,50200023535069,1441.5,60ec41ba55c00300382672d9,HDFC,direct expenses,5eecc6d6449e4f7cfb1c2708,2022-10-08T00:00:00.000Z,50200067075260-TPT-5000-GLITTER WRAPS,,,net_banking_transfer,-5000
63bfb29e2e1a0ebb7f629350,50200023535069,1443.5,60ec41ba55c00300382672d9,HDFC,Transfer in/Revenue-other,5eecc6d6449e4f7cfb1c2708,2022-10-08T00:00:00.000Z,CRV POS 514834******9486 LINKEDIN,,,refund,2
63bfb29e2e1a0ebb7f629354,50200023535069,9852.85,60ec41ba55c00300382672d9,HDFC,Revenue-PG-non-split,5eecc6d6449e4f7cfb1c2708,2022-10-09T00:00:00.000Z,NEFT CR-PYTM0123456-PAYTM PAYMENTS SERVI CES LIMITED-SLICK ORGANICS PVT LTD-PYTM2 22828968859,ewallet,,net_banking_transfer,8409.35
63bfb29e2e1a0ebb7f629356,50200023535069,-31355.15,60ec41ba55c00300382672d9,HDFC,direct expenses,5eecc6d6449e4f7cfb1c2708,2022-10-09T00:00:00.000Z,"NEFT DR-KKBK0000187-APPLIED LIFE PRIVATE LIMITED-NETBANK, MUM-N282222154493219-4 1208",,,net_banking_transfer,-41208
63bfb29e2e1a0ebb7f629358,50200023535069,-31340.15,60ec41ba55c00300382672d9,HDFC,Transfer in/Revenue-other,5eecc6d6449e4f7cfb1c2708,2022-10-10T00:00:00.000Z,INT. ON SWCR ON-50300684649760,,,Other,15
63bfb29e2e1a0ebb7f62935a,50200023535069,15.85,60ec41ba55c00300382672d9,HDFC,Loan-in,5eecc6d6449e4f7cfb1c2708,2022-10-10T00:00:00.000Z,SWEEP-IN CREDIT - 50300684649760,,,self_transfer,31356
63bfb29e2e1a0ebb7f62935c,50200023535069,56512.36,60ec41ba55c00300382672d9,HDFC,Revenue-Mktplace,5eecc6d6449e4f7cfb1c2708,2022-10-10T00:00:00.000Z,NEFT CR-DEUT0797BGL-FLIPKART INTERNET PR IVATE LIMITED-SLICK ORGANICS PVT LTD-228 300155GN00248,shopping,,net_banking_transfer,56496.51
63bfb29e2e1a0ebb7f62935e,50200023535069,69825.61,60ec41ba55c00300382672d9,HDFC,Revenue-PG-non-split,5eecc6d6449e4f7cfb1c2708,2022-10-10T00:00:00.000Z,NEFT CR-PYTM0123456-PAYTM PAYMENTS SERVI CES LIMITED-SLICK ORGANICS PVT LTD-PYTM2 22830673087,ewallet,,net_banking_transfer,13313.25
63bfb29e2e1a0ebb7f629360,50200023535069,108770.03,60ec41ba55c00300382672d9,HDFC,Revenue-PG-split enabled,5eecc6d6449e4f7cfb1c2708,2022-10-10T00:00:00.000Z,NEFT CR-UTIB0001506-RAZORPAY SOFTWARE PR IVATE LIMITED-SLICK ORGANICS PVT LITD-AX ISCN0171088154,,,net_banking_transfer,38944.42
63bfb29e2e1a0ebb7f629362,50200023535069,135217.7,60ec41ba55c00300382672d9,HDFC,Revenue-Mktplace,5eecc6d6449e4f7cfb1c2708,2022-10-10T00:00:00.000Z,NEFT CR-DEUT0797BGL-MYNTRA DESIGNS PRIVA,shopping,,net_banking_transfer,26447.67
63bfb29e2e1a0ebb7f629365,50200023535069,135027.7,60ec41ba55c00300382672d9,HDFC,direct expenses,5eecc6d6449e4f7cfb1c2708,2022-10-10T00:00:00.000Z,POS 514834XXXXXX9486 PTM*PAYTM WALLET,ewallet,,debit_card,-190
63bfb29e2e1a0ebb7f629367,50200023535069,126163.7,60ec41ba55c00300382672d9,HDFC,direct expenses,5eecc6d6449e4f7cfb1c2708,2022-10-10T00:00:00.000Z,POS 514834XXXXXX9486 PTM*FABHOTELS,travel,,debit_card,-8864
63bfb29e2e1a0ebb7f629369,50200023535069,126068.07,60ec41ba55c00300382672d9,HDFC,bank charges,5eecc6d6449e4f7cfb1c2708,2022-10-10T00:00:00.000Z,.DC INTL POS TXN MARKUP+ST 160922 170922 -CDT2227411374283,,,international_transaction_arbitrage,-95.63
63bfb29e2e1a0ebb7f62936b,50200023535069,114962.15,60ec41ba55c00300382672d9,HDFC,bank charges,5eecc6d6449e4f7cfb1c2708,2022-10-10T00:00:00.000Z,.DC INTL POS TXN MARKUP+ST 160922 170922 -CDT2227411374283,,,international_transaction_arbitrage,-11105.92
63bfb29e2e1a0ebb7f62936d,50200023535069,-140037.85,60ec41ba55c00300382672d9,HDFC,SAAS/tech expense,5eecc6d6449e4f7cfb1c2708,2022-10-10T00:00:00.000Z,POS 514834XXXXXX9486 AMAZON,shopping,,debit_card,-255000
63bfb29e2e1a0ebb7f62936f,50200023535069,-165037.85,60ec41ba55c00300382672d9,HDFC,direct expenses,5eecc6d6449e4f7cfb1c2708,2022-10-10T00:00:00.000Z,POS 514834XXXXXX9486 FLIPKART,shopping,,debit_card,-25000
63bfb29e2e1a0ebb7f629371,50200023535069,-231188.85,60ec41ba55c00300382672d9,HDFC,direct expenses,5eecc6d6449e4f7cfb1c2708,2022-10-10T00:00:00.000Z,"NEFT DR-UTIB0000119-SAFEXPRESS-NETBANK, MUM-N283222155392033-66151",,,net_banking_transfer,-66151
63bfb29e2e1a0ebb7f629373,50200023535069,-276437.85,60ec41ba55c00300382672d9,HDFC,direct expenses,5eecc6d6449e4f7cfb1c2708,2022-10-10T00:00:00.000Z,"NEFT DR-UTIB0000119-SAFEXPRESS-NETBANK, MUM-N283222155411186-45249",,,net_banking_transfer,-45249
63bfb29e2e1a0ebb7f629375,50200023535069,-265636.06,60ec41ba55c00300382672d9,HDFC,Transfer in/Revenue-other,5eecc6d6449e4f7cfb1c2708,2022-10-10T00:00:00.000Z,NEFT CR-UTIB0000114-ONE SIGMA TECHNOLOGI ES PRIVATE LIM-SLICK ORGANICS PRIVATE LI MITED-AXISP00326995271,,,net_banking_transfer,10801.79
63bfb29e2e1a0ebb7f629377,50200023535069,-260587.44,60ec41ba55c00300382672d9,HDFC,Transfer in/Revenue-other,5eecc6d6449e4f7cfb1c2708,2022-10-10T00:00:00.000Z,NEFT CR-UTIB0000114-ONE SIGMA TECHNOLOGI ES PRIVATE LIM-SLICK ORGANICS PRIVATE LI MITED-AXISP00326995142,,,net_banking_transfer,5048.62
63bfb29e2e1a0ebb7f629379,50200023535069,-250208.97,60ec41ba55c00300382672d9,HDFC,Transfer in/Revenue-other,5eecc6d6449e4f7cfb1c2708,2022-10-10T00:00:00.000Z,NEFT CR-UTIB0000114-ONE SIGMA TECHNOLOGI ES PRIVATE LIM-SLICK ORGANICS PRIVATE LI MITED-AXISP00326994780,,,net_banking_transfer,10378.47
63bfb29e2e1a0ebb7f62937b,50200023535069,-253875.97,60ec41ba55c00300382672d9,HDFC,direct expenses,5eecc6d6449e4f7cfb1c2708,2022-10-10T00:00:00.000Z,50100162216680-TPT-3667-ARUSHE BHARDWAJ,,,net_banking_transfer,-3667
63bfb29e2e1a0ebb7f62937d,50200023535069,-253877.97,60ec41ba55c00300382672d9,HDFC,Marketing Expense,5eecc6d6449e4f7cfb1c2708,2022-10-10T00:00:00.000Z,ME DC SI 514834XXXXXX9486 LINKEDIN,,,Other,-2
63bfb29e2e1a0ebb7f629381,50200023535069,-255648.97,60ec41ba55c00300382672d9,HDFC,SAAS/tech expense,5eecc6d6449e4f7cfb1c2708,2022-10-10T00:00:00.000Z,POS 514834XXXXXX9486 AMAZON,shopping,,debit_card,-1771
63bfb29e2e1a0ebb7f629383,50200023535069,-190011.54,60ec41ba55c00300382672d9,HDFC,Transfer in/Revenue-other,5eecc6d6449e4f7cfb1c2708,2022-10-10T00:00:00.000Z,NEFT CR-YESB0000001-EASEBUZZ PVT LTD NOD AL A/C-SLICK ORGANICS PVT LTD-YESB228321 52087,,,net_banking_transfer,65637.43
63bfb29e2e1a0ebb7f629385,50200023535069,81152.46,60ec41ba55c00300382672d9,HDFC,Transfer in/Revenue-other,5eecc6d6449e4f7cfb1c2708,2022-10-10T00:00:00.000Z,00640330000510-SLICK ORGANICS PVT L,,,Other,271164
63bfb29e2e1a0ebb7f629387,50200023535069,207780.76,60ec41ba55c00300382672d9,HDFC,Revenue-COD,5eecc6d6449e4f7cfb1c2708,2022-10-10T00:00:00.000Z,NEFT CR-ICIC0000155-SHIPROCKET COD CRF I,,,net_banking_transfer,126628.3
63bfb29e2e1a0ebb7f629389,50200023535069,227607.16,60ec41ba55c00300382672d9,HDFC,Revenue-PG-split enabled,5eecc6d6449e4f7cfb1c2708,2022-10-10T00:00:00.000Z,NEFT CR-UTIB0001506-RAZORPAY SOFTWARE PR IVATE LIMITED-SLICK ORGANICS PVT LITD-AX ISCN0171278432,,,net_banking_transfer,19826.4
63bfb29e2e1a0ebb7f62938b,50200023535069,249119.5,60ec41ba55c00300382672d9,HDFC,Transfer in/Revenue-other,5eecc6d6449e4f7cfb1c2708,2022-10-10T00:00:00.000Z,NEFT CR-YESB0000001-EASEBUZZ PVT LTD NOD AL A/C-SLICK ORGANICS PVT LTD-YESB228323 94763,,,net_banking_transfer,21512.34
63bfb29e2e1a0ebb7f62938d,50200023535069,758427.09,60ec41ba55c00300382672d9,HDFC,Revenue-Mktplace,5eecc6d6449e4f7cfb1c2708,2022-10-11T00:00:00.000Z,NEFT CR-DEUT0797BGL-AMAZON PAY (INDIA) P RIVATE LIMITED-SLICK ORGANICS PVT LTD-22 8400117GN00321,shopping,,net_banking_transfer,509307.59
63bfb29e2e1a0ebb7f62938f,50200023535069,258427.09,60ec41ba55c00300382672d9,HDFC,direct expenses,5eecc6d6449e4f7cfb1c2708,2022-10-11T00:00:00.000Z,05892560000649-TPT-500000-DECORPAC INDIA PRIVATE LIMITED,,,net_banking_transfer,-500000
63bfb29e2e1a0ebb7f629391,50200023535069,58427.09,60ec41ba55c00300382672d9,HDFC,direct expenses,5eecc6d6449e4f7cfb1c2708,2022-10-11T00:00:00.000Z,"NEFT DR-YESB0000551-VISTTA COSMETICS-NET BANK, MUM-N284222157300366-200000",,,net_banking_transfer,-200000
63bfb29e2e1a0ebb7f629393,50200023535069,71619.56,60ec41ba55c00300382672d9,HDFC,Revenue-PG-split enabled,5eecc6d6449e4f7cfb1c2708,2022-10-11T00:00:00.000Z,NEFT CR-UTIB0001506-RAZORPAY SOFTWARE PR IVATE LIMITED-SLICK ORGANICS PVT LITD-AX ISCN0171386883,,,net_banking_transfer,13192.47
63bfb29e2e1a0ebb7f629395,50200023535069,88659.57,60ec41ba55c00300382672d9,HDFC,Revenue-PG-non-split,5eecc6d6449e4f7cfb1c2708,2022-10-11T00:00:00.000Z,NEFT CR-PYTM0123456-PAYTM PAYMENTS SERVI CES LIMITED-SLICK ORGANICS PVT LTD-PYTM2 22842414408,ewallet,,net_banking_transfer,17040.01
63bfb29e2e1a0ebb7f629397,50200023535069,69399.57,60ec41ba55c00300382672d9,HDFC,direct expenses,5eecc6d6449e4f7cfb1c2708,2022-10-11T00:00:00.000Z,"NEFT DR-KKBK0000131-KANPUR FLOWERCYCLING PRIVATE LIMITED-NETBANK, MUM-N284222157 543335-19260",,,net_banking_transfer,-19260
63bfb29e2e1a0ebb7f629399,50200023535069,69500.12,60ec41ba55c00300382672d9,HDFC,Transfer in/Revenue-other,5eecc6d6449e4f7cfb1c2708,2022-10-11T00:00:00.000Z,EASEBUZZ PRIVA-A489101022PTY9JCSLPJ,,,Other,100.55
63bfb29e2e1a0ebb7f62939b,50200023535069,59500.12,60ec41ba55c00300382672d9,HDFC,direct expenses,5eecc6d6449e4f7cfb1c2708,2022-10-11T00:00:00.000Z,"NEFT DR-ICIC0000021-AKHILESH DIXIT-NETBA NK, MUM-N284222157692979-10000",,,net_banking_transfer,-10000
63bfb29e2e1a0ebb7f62939d,50200023535069,59338.63,60ec41ba55c00300382672d9,HDFC,bank charges,5eecc6d6449e4f7cfb1c2708,2022-10-11T00:00:00.000Z,.DC INTL POS TXN MARKUP+ST 210922 220922 -CDT2227411374283,,,international_transaction_arbitrage,-161.49
63bfb29e2e1a0ebb7f62939f,50200023535069,56416.63,60ec41ba55c00300382672d9,HDFC,direct expenses,5eecc6d6449e4f7cfb1c2708,2022-10-11T00:00:00.000Z,"NEFT DR-BARB0SUSGUR-GREENIECAN INDIA-NET BANK, MUM-N284222157854944-2922",,,net_banking_transfer,-2922
63bfb29e2e1a0ebb7f6293a1,50200023535069,60576.83,60ec41ba55c00300382672d9,HDFC,Transfer in/Revenue-other,5eecc6d6449e4f7cfb1c2708,2022-10-11T00:00:00.000Z,NEFT CR-UTIB0000114-ONE SIGMA TECHNOLOGI,,,net_banking_transfer,4160.2
63bfb29e2e1a0ebb7f6293a3,50200023535069,65616.61,60ec41ba55c00300382672d9,HDFC,Revenue-PG-non-split,5eecc6d6449e4f7cfb1c2708,2022-10-11T00:00:00.000Z,NEFT CR-SCBL0036001-STRIPE INDIA PRIVATE LIMITED-SLICK ORGANICS PRIVATE LIMITED- IN1ON22101101CTY,,,net_banking_transfer,5039.78
63bfb29e2e1a0ebb7f6293a5,50200023535069,131142.36,60ec41ba55c00300382672d9,HDFC,Transfer in/Revenue-other,5eecc6d6449e4f7cfb1c2708,2022-10-11T00:00:00.000Z,NEFT CR-YESB0000001-EASEBUZZ PVT LTD NOD AL A/C-SLICK ORGANICS PVT LTD-YESB228446 00326,,,net_banking_transfer,65525.75
63bfb29e2e1a0ebb7f6293a7,50200023535069,130977.36,60ec41ba55c00300382672d9,HDFC,direct expenses,5eecc6d6449e4f7cfb1c2708,2022-10-11T00:00:00.000Z,POS 514834XXXXXX9486 SMARTSHIFT LOGIS,,,debit_card,-165
63bfb29e2e1a0ebb7f6293a9,50200023535069,144478.52,60ec41ba55c00300382672d9,HDFC,Revenue-PG-split enabled,5eecc6d6449e4f7cfb1c2708,2022-10-11T00:00:00.000Z,NEFT CR-UTIB0001506-RAZORPAY SOFTWARE PR IVATE LIMITED-SLICK ORGANICS PVT LITD-AX ISCN0171660421,,,net_banking_transfer,13501.16
63bfb29e2e1a0ebb7f6293ab,50200023535069,203961.67,60ec41ba55c00300382672d9,HDFC,Revenue-Mktplace,5eecc6d6449e4f7cfb1c2708,2022-10-12T00:00:00.000Z,NEFT CR-DEUT0797BGL-FLIPKART INTERNET PR IVATE LIMITED-SLICK ORGANICS PVT LTD-228 500151GN00234,shopping,,net_banking_transfer,59483.15
63bfb29e2e1a0ebb7f6293ad,50200023535069,221739.96,60ec41ba55c00300382672d9,HDFC,Revenue-PG-non-split,5eecc6d6449e4f7cfb1c2708,2022-10-12T00:00:00.000Z,NEFT CR-PYTM0123456-PAYTM PAYMENTS SERVI CES LIMITED-SLICK ORGANICS PVT LTD-PYTM2 22854378086,ewallet,,net_banking_transfer,17778.29
63bfb29e2e1a0ebb7f6293af,50200023535069,222276.26,60ec41ba55c00300382672d9,HDFC,Revenue-Mktplace,5eecc6d6449e4f7cfb1c2708,2022-10-12T00:00:00.000Z,NEFT CR-DEUT0797BGL-MYNTRA DESIGNS PRIVA TE LIMITED-SLICK ORGANICS - SJIT-2285006 82GN00157,shopping,,net_banking_transfer,536.3
63bfb29e2e1a0ebb7f6293b1,50200023535069,222382.5,60ec41ba55c00300382672d9,HDFC,Revenue-Mktplace,5eecc6d6449e4f7cfb1c2708,2022-10-12T00:00:00.000Z,NEFT CR-DEUT0797BGL-MYNTRA DESIGNS PRIVA TE LIMITED-SLICK ORGANICS - SJIT-2285006 83GN00107,shopping,,net_banking_transfer,106.24
63bfb29e2e1a0ebb7f6293b3,50200023535069,219722.5,60ec41ba55c00300382672d9,HDFC,direct expenses,5eecc6d6449e4f7cfb1c2708,2022-10-12T00:00:00.000Z,50200051429170-TPT-2660-MEND PACKAGING L LP,,,net_banking_transfer,-2660
63bfb29e2e1a0ebb7f6293b5,50200023535069,228451.98,60ec41ba55c00300382672d9,HDFC,Revenue-Mktplace,5eecc6d6449e4f7cfb1c2708,2022-10-12T00:00:00.000Z,NEFT CR-DEUT0797BGL-MYNTRA DESIGNS PRIVA TE LIMITED-SLICK ORGANICS PVT. LTD.-2285 00727GN00055,shopping,,net_banking_transfer,8729.48
63bfb29f2e1a0ebb7f6293b7,50200023535069,249903.49,60ec41ba55c00300382672d9,HDFC,Revenue-PG-split enabled,5eecc6d6449e4f7cfb1c2708,2022-10-12T00:00:00.000Z,NEFT CR-UTIB0001506-RAZORPAY SOFTWARE PR IVATE LIMITED-SLICK ORGANICS PVT LITD-AX ISCN0171744529,,,net_banking_transfer,21451.51
63bfb29f2e1a0ebb7f6293b9,50200023535069,306589.84,60ec41ba55c00300382672d9,HDFC,Revenue-Mktplace,5eecc6d6449e4f7cfb1c2708,2022-10-12T00:00:00.000Z,NEFT CR-HSBC0400002-AMAZON SERVICES LLC-,shopping,,net_banking_transfer,56686.35
63bfb29f2e1a0ebb7f6293bb,50200023535069,177078.84,60ec41ba55c00300382672d9,HDFC,Salary/Emp/consultant Expense,5eecc6d6449e4f7cfb1c2708,2022-10-12T00:00:00.000Z,1921352806/EPFO,,,Other,-129511
63bfb29f2e1a0ebb7f6293bd,50200023535069,167817.84,60ec41ba55c00300382672d9,HDFC,direct expenses,5eecc6d6449e4f7cfb1c2708,2022-10-12T00:00:00.000Z,02022133072219/ESIC,,,Other,-9261
63bfb29f2e1a0ebb7f6293c0,50200023535069,139817.84,60ec41ba55c00300382672d9,HDFC,direct expenses,5eecc6d6449e4f7cfb1c2708,2022-10-12T00:00:00.000Z,"NEFT DR-ICIC0006293-NIRITY NICKUNG SHAH- NETBANK, MUM-N285222159616617-28000",,,net_banking_transfer,-28000
63bfb29f2e1a0ebb7f6293c2,50200023535069,-10182.16,60ec41ba55c00300382672d9,HDFC,direct expenses,5eecc6d6449e4f7cfb1c2708,2022-10-12T00:00:00.000Z,"NEFT DR-SCBL0036031-PR PUNDIT PUBLIC REL ATIONS PRIVATE LIMIT-NETBANK, MUM-N28522 2159619546-150000",,,net_banking_transfer,-150000
63bfb29f2e1a0ebb7f6293c4,50200023535069,-35182.16,60ec41ba55c00300382672d9,HDFC,direct expenses,5eecc6d6449e4f7cfb1c2708,2022-10-12T00:00:00.000Z,"NEFT DR-KKBK0001393-MASCOT SPINCONTROL I NDIA PVT LTD-NETBANK, MUM-N2852221597633 45-25000",,,net_banking_transfer,-25000
63bfb29f2e1a0ebb7f6293c6,50200023535069,-31565,60ec41ba55c00300382672d9,HDFC,Transfer in/Revenue-other,5eecc6d6449e4f7cfb1c2708,2022-10-12T00:00:00.000Z,NEFT CR-UTIB0000114-ONE SIGMA TECHNOLOGI ES PRIVATE LIM-SLICK ORGANICS PRIVATE LI MITED-AXISP00327802666,,,net_banking_transfer,3617.16
63bfb29f2e1a0ebb7f6293c8,50200023535069,-12702,60ec41ba55c00300382672d9,HDFC,Revenue-Mktplace,5eecc6d6449e4f7cfb1c2708,2022-10-12T00:00:00.000Z,NEFT CR-ICIC0000985-DIGITAL AGE RETAIL P VT LTD-SLICK ORGANICS PVT LTD-CMS2886342 183,,,net_banking_transfer,18863
63bfb29f2e1a0ebb7f6293ca,50200023535069,-7414.4,60ec41ba55c00300382672d9,HDFC,Revenue-PG-split enabled,5eecc6d6449e4f7cfb1c2708,2022-10-12T00:00:00.000Z,NEFT CR-UTIB0001506-RAZORPAY SOFTWARE PR IVATE LIMITED-SLICK ORGANICS PVT LITD-AX ISCN0171978058,,,net_banking_transfer,5287.6
63bfb29f2e1a0ebb7f6293cc,50200023535069,-11453.59,60ec41ba55c00300382672d9,HDFC,direct expenses,5eecc6d6449e4f7cfb1c2708,2022-10-12T00:00:00.000Z,POS 514834XXXXXX9486 WWW.FAQPRIME.COM,,,debit_card,-4039.19
63bfb29f2e1a0ebb7f6293ce,50200023535069,24711.74,60ec41ba55c00300382672d9,HDFC,Revenue-COD,5eecc6d6449e4f7cfb1c2708,2022-10-12T00:00:00.000Z,NEFT CR-ICIC0000155-SHIPROCKET COD CRF I D 5025244-SLICK ORGANICS PVT LTD-CMS2887 753226,,,net_banking_transfer,36165.33
63bfb29f2e1a0ebb7f6293d0,50200023535069,83394.07,60ec41ba55c00300382672d9,HDFC,Transfer in/Revenue-other,5eecc6d6449e4f7cfb1c2708,2022-10-12T00:00:00.000Z,NEFT CR-YESB0000001-EASEBUZZ PVT LTD NOD AL A/C-SLICK ORGANICS PVT LTD-YESB228573 23830,,,net_banking_transfer,58682.33
63bfb29f2e1a0ebb7f6293d2,50200023535069,107736.07,60ec41ba55c00300382672d9,HDFC,Revenue-COD,5eecc6d6449e4f7cfb1c2708,2022-10-12T00:00:00.000Z,PICKRR TECHNOL-AKHILESHDIXIT85GMAIL,,,Other,24342
63bfb29f2e1a0ebb7f6293d4,50200023535069,118351.19,60ec41ba55c00300382672d9,HDFC,Revenue-PG-non-split,5eecc6d6449e4f7cfb1c2708,2022-10-13T00:00:00.000Z,NEFT CR-PYTM0123456-PAYTM PAYMENTS SERVI,ewallet,,net_banking_transfer,10615.12
63bfb29f2e1a0ebb7f6293d6,50200023535069,104601.19,60ec41ba55c00300382672d9,HDFC,direct expenses,5eecc6d6449e4f7cfb1c2708,2022-10-13T00:00:00.000Z,POS 514834XXXXXX9486 PTM*PAYTM,ewallet,,debit_card,-13750
63bfb29f2e1a0ebb7f6293d8,50200023535069,103601.19,60ec41ba55c00300382672d9,HDFC,direct expenses,5eecc6d6449e4f7cfb1c2708,2022-10-13T00:00:00.000Z,"NEFT DR-RATN0VAAPIS-CR CARD COLLECTION P ARKING GL RAZORPAY-NETBANK, MUM-N286222 161264072-1000",,,net_banking_transfer,-1000
63bfb29f2e1a0ebb7f6293da,50200023535069,120341.69,60ec41ba55c00300382672d9,HDFC,Revenue-PG-split enabled,5eecc6d6449e4f7cfb1c2708,2022-10-13T00:00:00.000Z,NEFT CR-UTIB0001506-RAZORPAY SOFTWARE PR IVATE LIMITED-SLICK ORGANICS PVT LITD-AX ISCN0172101618,,,net_banking_transfer,16740.5
63bfb29f2e1a0ebb7f6293dc,50200023535069,116889.15,60ec41ba55c00300382672d9,HDFC,direct expenses,5eecc6d6449e4f7cfb1c2708,2022-10-13T00:00:00.000Z,POS 514834XXXXXX9486 E-COMMERCE RP,,,debit_card,-3452.54
63bfb29f2e1a0ebb7f6293df,50200023535069,115681.7,60ec41ba55c00300382672d9,HDFC,direct expenses,5eecc6d6449e4f7cfb1c2708,2022-10-13T00:00:00.000Z,POS 514834XXXXXX9486 RAZ*DRBATRAS,,,debit_card,-1207.45
63bfb29f2e1a0ebb7f6293e1,50200023535069,114184.95,60ec41ba55c00300382672d9,HDFC,SAAS/tech expense,5eecc6d6449e4f7cfb1c2708,2022-10-13T00:00:00.000Z,POS 514834XXXXXX9486 AMAZON,shopping,,debit_card,-1496.75
63bfb29f2e1a0ebb7f6293e3,50200023535069,115508.24,60ec41ba55c00300382672d9,HDFC,Transfer in/Revenue-other,5eecc6d6449e4f7cfb1c2708,2022-10-13T00:00:00.000Z,NEFT CR-UTIB0000114-ONE SIGMA TECHNOLOGI ES PRIVATE LIM-SLICK ORGANICS PRIVATE LI MITED-AXISP00328079462,,,net_banking_transfer,1323.29
63bfb29f2e1a0ebb7f6293e5,50200023535069,108236.24,60ec41ba55c00300382672d9,HDFC,direct expenses,5eecc6d6449e4f7cfb1c2708,2022-10-13T00:00:00.000Z,POS 514834XXXXXX9486 GROFERS INDIA PV,groceries,,debit_card,-7272
63bfb29f2e1a0ebb7f6293e7,50200023535069,157987.41,60ec41ba55c00300382672d9,HDFC,Transfer in/Revenue-other,5eecc6d6449e4f7cfb1c2708,2022-10-13T00:00:00.000Z,NEFT CR-YESB0000001-EASEBUZZ PVT LTD NOD AL A/C-SLICK ORGANICS PVT LTD-YESB228698 91735,,,net_banking_transfer,49751.17
63bfb29f2e1a0ebb7f6293e9,50200023535069,168798.33,60ec41ba55c00300382672d9,HDFC,Revenue-PG-split enabled,5eecc6d6449e4f7cfb1c2708,2022-10-13T00:00:00.000Z,NEFT CR-UTIB0001506-RAZORPAY SOFTWARE PR IVATE LIMITED-SLICK ORGANICS PVT LITD-AX ISCN0172292480,,,net_banking_transfer,10810.92
63bfb29f2e1a0ebb7f6293eb,50200023535069,-391201.67,60ec41ba55c00300382672d9,HDFC,direct expenses,5eecc6d6449e4f7cfb1c2708,2022-10-13T00:00:00.000Z,"NEFT DR-RATN0VAAPIS-CR CARD COLLECTION P ARKING GL RAZORPAY-NETBANK, MUM-N286222 162384398-56000",,,net_banking_transfer,-560000
63bfb29f2e1a0ebb7f6293ed,50200023535069,-390938.67,60ec41ba55c00300382672d9,HDFC,Transfer in/Revenue-other,5eecc6d6449e4f7cfb1c2708,2022-10-14T00:00:00.000Z,INT. ON SWCR ON-50300684649760,,,Other,263
63bfb29f2e1a0ebb7f6293f0,50200023535069,263.33,60ec41ba55c00300382672d9,HDFC,Loan-in,5eecc6d6449e4f7cfb1c2708,2022-10-14T00:00:00.000Z,SWEEP-IN CREDIT - 50300684649760,,,self_transfer,391202
63bfb29f2e1a0ebb7f6293f2,50200023535069,25592.85,60ec41ba55c00300382672d9,HDFC,Revenue-Mktplace,5eecc6d6449e4f7cfb1c2708,2022-10-14T00:00:00.000Z,NEFT CR-DEUT0797BGL-FLIPKART INTERNET PR IVATE LIMITED-SLICK ORGANICS PVT LTD-228 700131GN00202,shopping,,net_banking_transfer,25329.52
63bfb29f2e1a0ebb7f6293f4,50200023535069,41895.06,60ec41ba55c00300382672d9,HDFC,Revenue-PG-non-split,5eecc6d6449e4f7cfb1c2708,2022-10-14T00:00:00.000Z,NEFT CR-PYTM0123456-PAYTM PAYMENTS SERVI CES LIMITED-SLICK ORGANICS PVT LTD-PYTM2 22877579710,ewallet,,net_banking_transfer,16302.21
63bfb29f2e1a0ebb7f6293f6,50200023535069,44118.73,60ec41ba55c00300382672d9,HDFC,Revenue-Mktplace,5eecc6d6449e4f7cfb1c2708,2022-10-14T00:00:00.000Z,NEFT CR-DEUT0797BGL-MYNTRA DESIGNS PRIVA,shopping,,net_banking_transfer,2223.67
63bfb29f2e1a0ebb7f6293f8,50200023535069,46051.7,60ec41ba55c00300382672d9,HDFC,Revenue-Mktplace,5eecc6d6449e4f7cfb1c2708,2022-10-14T00:00:00.000Z,NEFT CR-DEUT0797BGL-MYNTRA DESIGNS PRIVA TE LIMITED-SLICK ORGANICS - SJIT-2287006 52GN00147,shopping,,net_banking_transfer,1932.97
63bfb29f2e1a0ebb7f6293fa,50200023535069,60755.79,60ec41ba55c00300382672d9,HDFC,Revenue-Mktplace,5eecc6d6449e4f7cfb1c2708,2022-10-14T00:00:00.000Z,NEFT CR-DEUT0797BGL-MYNTRA DESIGNS PRIVA TE LIMITED-SLICK ORGANICS PVT. LTD.-2287 00712GN00161,shopping,,net_banking_transfer,14704.09
63bfb29f2e1a0ebb7f6293fc,50200023535069,75988.39,60ec41ba55c00300382672d9,HDFC,Revenue-PG-split enabled,5eecc6d6449e4f7cfb1c2708,2022-10-14T00:00:00.000Z,NEFT CR-UTIB0001506-RAZORPAY SOFTWARE PR IVATE LIMITED-SLICK ORGANICS PVT LITD-AX ISCN0172400008,,,net_banking_transfer,15232.6
63bfb29f2e1a0ebb7f6293fe,50200023535069,69788.39,60ec41ba55c00300382672d9,HDFC,direct expenses,5eecc6d6449e4f7cfb1c2708,2022-10-14T00:00:00.000Z,50200067075260-TPT-6200-GLITTER WRAPS,,,net_banking_transfer,-6200
63bfb29f2e1a0ebb7f629400,50200023535069,-5259.61,60ec41ba55c00300382672d9,HDFC,direct expenses,5eecc6d6449e4f7cfb1c2708,2022-10-14T00:00:00.000Z,"NEFT DR-ICIC0006643-KRISHNA PACKAGING CO MPANY-NETBANK, MUM-N287222163110703-7504 8",,,net_banking_transfer,-75048
63bfb29f2e1a0ebb7f629402,50200023535069,-32259.61,60ec41ba55c00300382672d9,HDFC,direct expenses,5eecc6d6449e4f7cfb1c2708,2022-10-14T00:00:00.000Z,50100415834335-TPT-27000-NIHARIKA DO TAR UN KUMAR,,,net_banking_transfer,-27000
63bfb29f2e1a0ebb7f629404,50200023535069,-22138.21,60ec41ba55c00300382672d9,HDFC,Transfer in/Revenue-other,5eecc6d6449e4f7cfb1c2708,2022-10-14T00:00:00.000Z,NEFT CR-UTIB0000114-ONE SIGMA TECHNOLOGI ES PRIVATE LIM-SLICK ORGANICS PRIVATE LI MITED-AXISP00328400007,,,net_banking_transfer,10121.4
63bfb29f2e1a0ebb7f629406,50200023535069,-23338.21,60ec41ba55c00300382672d9,HDFC,direct expenses,5eecc6d6449e4f7cfb1c2708,2022-10-14T00:00:00.000Z,POS 514834XXXXXX9486 SMARTSHIFT LOGIS,,,debit_card,-1200
63bfb29f2e1a0ebb7f629408,50200023535069,-22209.21,60ec41ba55c00300382672d9,HDFC,Revenue-Mktplace,5eecc6d6449e4f7cfb1c2708,2022-10-14T00:00:00.000Z,NEFT CR-SCBL0036001-DREAMPLUG TECHNOLOGI ES PRIVATE LIMITED-SLICK ORGANICS PRIVAT E LIMITEDSLICK-IN1ON22101401Z21,,,net_banking_transfer,1129
63bfb29f2e1a0ebb7f62940a,50200023535069,1611374.29,60ec41ba55c00300382672d9,HDFC,Revenue-Mktplace,5eecc6d6449e4f7cfb1c2708,2022-10-14T00:00:00.000Z,NEFT CR-KKBK0000958-NYKAA E RETAIL PRIVA TE LIMITED NYKAA-SLICK ORGANICS PVT LTD- KKBK222873167832,,,net_banking_transfer,1633583.5
63bfb29f2e1a0ebb7f62940c,50200023535069,1665962.13,60ec41ba55c00300382672d9,HDFC,Transfer in/Revenue-other,5eecc6d6449e4f7cfb1c2708,2022-10-14T00:00:00.000Z,NEFT CR-YESB0000001-EASEBUZZ PVT LTD NOD AL A/C-SLICK ORGANICS PVT LTD-YESB228723 57974,,,net_banking_transfer,54587.84
63bfb29f2e1a0ebb7f62940e,50200023535069,1664832.13,60ec41ba55c00300382672d9,HDFC,direct expenses,5eecc6d6449e4f7cfb1c2708,2022-10-14T00:00:00.000Z,POS 514834XXXXXX9486 SMARTSHIFT LOGIS,,,debit_card,-1130
63bfb29f2e1a0ebb7f629410,50200023535069,1670376.24,60ec41ba55c00300382672d9,HDFC,Revenue-PG-split enabled,5eecc6d6449e4f7cfb1c2708,2022-10-14T00:00:00.000Z,NEFT CR-UTIB0001506-RAZORPAY SOFTWARE PR,,,net_banking_transfer,5544.11
63bfb29f2e1a0ebb7f629412,50200023535069,1674082.23,60ec41ba55c00300382672d9,HDFC,Revenue-COD,5eecc6d6449e4f7cfb1c2708,2022-10-14T00:00:00.000Z,NEFT CR-ICIC0000155-SHIPROCKET COD CRF I D 5037463-SLICK ORGANICS PVT LTD-CMS2891 914947,,,net_banking_transfer,3705.99
63bfb29f2e1a0ebb7f629414,50200023535069,1672053.23,60ec41ba55c00300382672d9,HDFC,direct expenses,5eecc6d6449e4f7cfb1c2708,2022-10-14T00:00:00.000Z,POS 514834XXXXXX9486 ADOBE CREATIVE C,,,debit_card,-2029
63bfb29f2e1a0ebb7f629416,50200023535069,1672055.23,60ec41ba55c00300382672d9,HDFC,Transfer in/Revenue-other,5eecc6d6449e4f7cfb1c2708,2022-10-14T00:00:00.000Z,CRV POS 514834******9486 LINKEDIN,,,refund,2
63bfb29f2e1a0ebb7f629418,50200023535069,1697113.18,60ec41ba55c00300382672d9,HDFC,Revenue-PG-non-split,5eecc6d6449e4f7cfb1c2708,2022-10-15T00:00:00.000Z,NEFT CR-PYTM0123456-PAYTM PAYMENTS SERVI CES LIMITED-SLICK ORGANICS PVT LTD-PYTM2 22889808910,ewallet,,net_banking_transfer,25057.95
63bfb29f2e1a0ebb7f62941a,50200023535069,1701648.94,60ec41ba55c00300382672d9,HDFC,Revenue-PG-split enabled,5eecc6d6449e4f7cfb1c2708,2022-10-15T00:00:00.000Z,NEFT CR-UTIB0001506-RAZORPAY SOFTWARE PR IVATE LIMITED-SLICK ORGANICS PVT LITD-AX ISCN0172698346,,,net_banking_transfer,4535.76
63bfb29f2e1a0ebb7f62941c,50200023535069,1701647.94,60ec41ba55c00300382672d9,HDFC,direct expenses,5eecc6d6449e4f7cfb1c2708,2022-10-15T00:00:00.000Z,ME DC SI 514834XXXXXX9486 SHOPIFY LTD,,,Other,-1
63bfb29f2e1a0ebb7f62941f,50200023535069,1300317.94,60ec41ba55c00300382672d9,HDFC,direct expenses,5eecc6d6449e4f7cfb1c2708,2022-10-15T00:00:00.000Z,02711600008220-TPT-401330-VARUN SINGH,,,net_banking_transfer,-401330
63bfb29f2e1a0ebb7f629421,50200023535069,1326808.94,60ec41ba55c00300382672d9,HDFC,Transfer in/Revenue-other,5eecc6d6449e4f7cfb1c2708,2022-10-15T00:00:00.000Z,FT- REMITTANCE OG SEP22-50200050675669 - HOUZ OF NATURE PVT LTD -,,,Other,26491
63bfb29f2e1a0ebb7f629423,50200023535069,1379058.83,60ec41ba55c00300382672d9,HDFC,Transfer in/Revenue-other,5eecc6d6449e4f7cfb1c2708,2022-10-15T00:00:00.000Z,NEFT CR-YESB0000001-EASEBUZZ PVT LTD NOD AL A/C-SLICK ORGANICS PVT LTD-YESB228849 38211,,,net_banking_transfer,52249.89
63bfb29f2e1a0ebb7f629425,50200023535069,1399031.53,60ec41ba55c00300382672d9,HDFC,Revenue-PG-split enabled,5eecc6d6449e4f7cfb1c2708,2022-10-15T00:00:00.000Z,NEFT CR-UTIB0001506-RAZORPAY SOFTWARE PR IVATE LIMITED-SLICK ORGANICS PVT LITD-AX ISCN0172888690,,,net_banking_transfer,19972.7
63bfb29f2e1a0ebb7f629427,50200023535069,1401482.53,60ec41ba55c00300382672d9,HDFC,Revenue-COD,5eecc6d6449e4f7cfb1c2708,2022-10-15T00:00:00.000Z,NEFT CR-KKBK0000958-PICKRR TECHNOLOGIES PVT LTD-SLICK ORGANICS PRIVATE LIMITED-C MS2882229472154,,,net_banking_transfer,2451
63bfb29f2e1a0ebb7f62942a,50200023535069,1422728.37,60ec41ba55c00300382672d9,HDFC,Revenue-PG-non-split,5eecc6d6449e4f7cfb1c2708,2022-10-16T00:00:00.000Z,NEFT CR-PYTM0123456-PAYTM PAYMENTS SERVI CES LIMITED-SLICK ORGANICS PVT LTD-PYTM2 22891237803,ewallet,,net_banking_transfer,21245.84
63bfb29f2e1a0ebb7f62942c,50200023535069,1430961.69,60ec41ba55c00300382672d9,HDFC,Transfer in/Revenue-other,5eecc6d6449e4f7cfb1c2708,2022-10-17T00:00:00.000Z,NEFT CR-KKBK0000958-NODAL ACCOUNT BROKEN,,,net_banking_transfer,8233.32
63bfb29f2e1a0ebb7f62942e,50200023535069,1441792.69,60ec41ba55c00300382672d9,HDFC,Transfer in/Revenue-other,5eecc6d6449e4f7cfb1c2708,2022-10-17T00:00:00.000Z,NEFT CR-KKBK0000958-OCTAVOS ENTERPRISE S OLUTIONS PVT-KANKOKU-CMS2902229496438,,,net_banking_transfer,10831
63bfb29f2e1a0ebb7f629430,50200023535069,1443973.48,60ec41ba55c00300382672d9,HDFC,Revenue-Mktplace,5eecc6d6449e4f7cfb1c2708,2022-10-17T00:00:00.000Z,NEFT CR-DEUT0797BGL-MYNTRA DESIGNS PRIVA TE LIMITED-SLICK ORGANICS - SJIT-2290005 13GN00163,shopping,,net_banking_transfer,2180.79
63bfb29f2e1a0ebb7f629432,50200023535069,1452572.53,60ec41ba55c00300382672d9,HDFC,Revenue-Mktplace,5eecc6d6449e4f7cfb1c2708,2022-10-17T00:00:00.000Z,NEFT CR-DEUT0797BGL-MYNTRA DESIGNS PRIVA TE LIMITED-SLICK ORGANICS - SJIT-2290005 14GN00180,shopping,,net_banking_transfer,8599.05
63bfb29f2e1a0ebb7f629434,50200023535069,505520.53,60ec41ba55c00300382672d9,HDFC,direct expenses,5eecc6d6449e4f7cfb1c2708,2022-10-17T00:00:00.000Z,"NEFT DR-RATN0VAAPIS-CR CARD COLLECTION P ARKING GL RAZORPAY-NETBANK, MUM-N290222 165976558-947052",,,net_banking_transfer,-947052
63bfb29f2e1a0ebb7f629436,50200023535069,517657.52,60ec41ba55c00300382672d9,HDFC,Revenue-Mktplace,5eecc6d6449e4f7cfb1c2708,2022-10-17T00:00:00.000Z,NEFT CR-DEUT0797BGL-MYNTRA DESIGNS PRIVA TE LIMITED-SLICK ORGANICS PVT. LTD.-2290 00539GN00253,shopping,,net_banking_transfer,12136.99
63bfb2a02e1a0ebb7f629438,50200023535069,534555.31,60ec41ba55c00300382672d9,HDFC,Revenue-PG-non-split,5eecc6d6449e4f7cfb1c2708,2022-10-17T00:00:00.000Z,NEFT CR-PYTM0123456-PAYTM PAYMENTS SERVI CES LIMITED-SLICK ORGANICS PVT LTD-PYTM2 22903740327,ewallet,,net_banking_transfer,16897.79
63bfb2a02e1a0ebb7f62943a,50200023535069,582897.04,60ec41ba55c00300382672d9,HDFC,Revenue-PG-split enabled,5eecc6d6449e4f7cfb1c2708,2022-10-17T00:00:00.000Z,NEFT CR-UTIB0001506-RAZORPAY SOFTWARE PR IVATE LIMITED-SLICK ORGANICS PVT LITD-AX ISCN0173140952,,,net_banking_transfer,48341.73
63bfb2a02e1a0ebb7f62943c,50200023535069,609657.67,60ec41ba55c00300382672d9,HDFC,Revenue-Mktplace,5eecc6d6449e4f7cfb1c2708,2022-10-17T00:00:00.000Z,NEFT CR-DEUT0797BGL-FLIPKART INTERNET PR IVATE LIMITED-SLICK ORGANICS PVT LTD-229 000661GN00014,shopping,,net_banking_transfer,26760.63
63bfb2a02e1a0ebb7f62943e,50200023535069,9657.67,60ec41ba55c00300382672d9,HDFC,Tax,5eecc6d6449e4f7cfb1c2708,2022-10-17T00:00:00.000Z,051030817102217276- CBDT TAX,,,Other,-600000
63bfb2a02e1a0ebb7f629441,50200023535069,7972.63,60ec41ba55c00300382672d9,HDFC,Marketing Expense,5eecc6d6449e4f7cfb1c2708,2022-10-17T00:00:00.000Z,ME DC SI 514834XXXXXX9486 LINKEDIN (PGSI ),,,Other,-1685.04
63bfb2a02e1a0ebb7f629443,50200023535069,18464.08,60ec41ba55c00300382672d9,HDFC,Revenue-PG-non-split,5eecc6d6449e4f7cfb1c2708,2022-10-17T00:00:00.000Z,NEFT CR-SCBL0036001-STRIPE INDIA PRIVATE LIMITED-SLICK ORGANICS PRIVATE LIMITED- IN1ON221017022YZ,,,net_banking_transfer,10491.45
63bfb2a02e1a0ebb7f629445,50200023535069,23050.16,60ec41ba55c00300382672d9,HDFC,Transfer in/Revenue-other,5eecc6d6449e4f7cfb1c2708,2022-10-17T00:00:00.000Z,NEFT CR-UTIB0000114-ONE SIGMA TECHNOLOGI,,,net_banking_transfer,4586.08
63bfb2a02e1a0ebb7f629447,50200023535069,32343.97,60ec41ba55c00300382672d9,HDFC,Transfer in/Revenue-other,5eecc6d6449e4f7cfb1c2708,2022-10-17T00:00:00.000Z,NEFT CR-UTIB0000114-ONE SIGMA TECHNOLOGI ES PRIVATE LIM-SLICK ORGANICS PRIVATE LI MITED-AXISP00328966990,,,net_banking_transfer,9293.81
63bfb2a02e1a0ebb7f629449,50200023535069,38285.23,60ec41ba55c00300382672d9,HDFC,Transfer in/Revenue-other,5eecc6d6449e4f7cfb1c2708,2022-10-17T00:00:00.000Z,NEFT CR-UTIB0000114-ONE SIGMA TECHNOLOGI ES PRIVATE LIM-SLICK ORGANICS PRIVATE LI MITED-AXISP00328966795,,,net_banking_transfer,5941.26
63bfb2a02e1a0ebb7f62944b,50200023535069,33048.04,60ec41ba55c00300382672d9,HDFC,Marketing Expense,5eecc6d6449e4f7cfb1c2708,2022-10-17T00:00:00.000Z,ME DC SI 514834XXXXXX9486 LINKEDIN (PGSI ),,,Other,-5237.19
63bfb2a02e1a0ebb7f62944d,50200023535069,141260.73,60ec41ba55c00300382672d9,HDFC,Transfer in/Revenue-other,5eecc6d6449e4f7cfb1c2708,2022-10-17T00:00:00.000Z,NEFT CR-YESB0000001-EASEBUZZ PVT LTD NOD AL A/C-SLICK ORGANICS PVT LTD-YESB229087 94584,,,net_banking_transfer,108212.69
63bfb2a02e1a0ebb7f62944f,50200023535069,160983.41,60ec41ba55c00300382672d9,HDFC,Revenue-PG-split enabled,5eecc6d6449e4f7cfb1c2708,2022-10-17T00:00:00.000Z,NEFT CR-UTIB0001506-RAZORPAY SOFTWARE PR IVATE LIMITED-SLICK ORGANICS PVT LITD-AX ISCN0173344598,,,net_banking_transfer,19722.68
63bfb2a02e1a0ebb7f629451,50200023535069,164245.41,60ec41ba55c00300382672d9,HDFC,Revenue-COD,5eecc6d6449e4f7cfb1c2708,2022-10-17T00:00:00.000Z,PICKRR TECHNOL-AKHILESHDIXIT85GMAIL,,,Other,3262
63bfb2a02e1a0ebb7f629453,50200023535069,154205.41,60ec41ba55c00300382672d9,HDFC,Tax,5eecc6d6449e4f7cfb1c2708,2022-10-17T00:00:00.000Z,GST/BANK REFERENCE NO: R2229038187251/CI N NO: HDFC22100700125549,,,Other,-10040
63bfb2a02e1a0ebb7f629455,50200023535069,191138.59,60ec41ba55c00300382672d9,HDFC,Revenue-COD,5eecc6d6449e4f7cfb1c2708,2022-10-17T00:00:00.000Z,NEFT CR-ICIC0000155-SHIPROCKET COD CRF I D 5045747-SLICK ORGANICS PVT LTD-CMS2896 594048,,,net_banking_transfer,36933.18
63bfb2a02e1a0ebb7f629457,50200023535069,198410.59,60ec41ba55c00300382672d9,HDFC,Transfer in/Revenue-other,5eecc6d6449e4f7cfb1c2708,2022-10-17T00:00:00.000Z,CRV POS 514834******9486 BLINKIT,,,refund,7272
63bfb2a02e1a0ebb7f629459,50200023535069,217009.37,60ec41ba55c00300382672d9,HDFC,Revenue-PG-non-split,5eecc6d6449e4f7cfb1c2708,2022-10-18T00:00:00.000Z,NEFT CR-PYTM0123456-PAYTM PAYMENTS SERVI CES LIMITED-SLICK ORGANICS PVT LTD-PYTM2 22914654162,ewallet,,net_banking_transfer,18598.78
63bfb2a02e1a0ebb7f62945b,50200023535069,228510.41,60ec41ba55c00300382672d9,HDFC,Revenue-PG-split enabled,5eecc6d6449e4f7cfb1c2708,2022-10-18T00:00:00.000Z,NEFT CR-UTIB0001506-RAZORPAY SOFTWARE PR IVATE LIMITED-SLICK ORGANICS PVT LITD-AX ISCN0173465620,,,net_banking_transfer,11501.04
63bfb2a02e1a0ebb7f62945d,50200023535069,512408.88,60ec41ba55c00300382672d9,HDFC,Revenue-Mktplace,5eecc6d6449e4f7cfb1c2708,2022-10-18T00:00:00.000Z,NEFT CR-DEUT0797BGL-AMAZON PAY (INDIA) P RIVATE LIMITED-SLICK ORGANICS PVT LTD-22 9100481GN00084,shopping,,net_banking_transfer,283898.47
63bfb2a02e1a0ebb7f62945f,50200023535069,296408.88,60ec41ba55c00300382672d9,HDFC,direct expenses,5eecc6d6449e4f7cfb1c2708,2022-10-18T00:00:00.000Z,NEFT DR-UTIB0000514-NATS ASSOCIATES-NETB,,,net_banking_transfer,-216000
63bfb2a02e1a0ebb7f629461,50200023535069,288408.88,60ec41ba55c00300382672d9,HDFC,direct expenses,5eecc6d6449e4f7cfb1c2708,2022-10-18T00:00:00.000Z,"NEFT DR-SBIN0001211-URJA TANTA-NETBANK, MUM-N291222168007048-8000",,,net_banking_transfer,-8000
63bfb2a02e1a0ebb7f629463,50200023535069,280408.88,60ec41ba55c00300382672d9,HDFC,direct expenses,5eecc6d6449e4f7cfb1c2708,2022-10-18T00:00:00.000Z,50100156335509-TPT-8000-CATHERINE REALTY SHADAP,,,net_banking_transfer,-8000
63bfb2a02e1a0ebb7f629465,50200023535069,279614.88,60ec41ba55c00300382672d9,HDFC,direct expenses,5eecc6d6449e4f7cfb1c2708,2022-10-18T00:00:00.000Z,POS 514834XXXXXX9486 PAYTM_ADDMONEYTO,ewallet,,debit_card,-794
63bfb2a02e1a0ebb7f629467,50200023535069,115007.88,60ec41ba55c00300382672d9,HDFC,direct expenses,5eecc6d6449e4f7cfb1c2708,2022-10-18T00:00:00.000Z,"NEFT DR-IDFB0040101-ACTIVES ADDITIVES AP PLICATIONS LLP-NETBANK, MUM-N29122216811 4886-164607",,,net_banking_transfer,-164607
63bfb2a02e1a0ebb7f629469,50200023535069,172010.2,60ec41ba55c00300382672d9,HDFC,Transfer in/Revenue-other,5eecc6d6449e4f7cfb1c2708,2022-10-18T00:00:00.000Z,NEFT CR-YESB0000001-EASEBUZZ PVT LTD NOD AL A/C-SLICK ORGANICS PVT LTD-YESB229111 16114,,,net_banking_transfer,57002.32
63bfb2a02e1a0ebb7f62946b,50200023535069,185441.2,60ec41ba55c00300382672d9,HDFC,Transfer in/Revenue-other,5eecc6d6449e4f7cfb1c2708,2022-10-18T00:00:00.000Z,50200050241205-TPT-ARATA-NAPSA PRIVATE L IMITED,,,net_banking_transfer,13431
63bfb2a02e1a0ebb7f62946d,50200023535069,192084.82,60ec41ba55c00300382672d9,HDFC,Revenue-PG-split enabled,5eecc6d6449e4f7cfb1c2708,2022-10-18T00:00:00.000Z,NEFT CR-UTIB0001506-RAZORPAY SOFTWARE PR IVATE LIMITED-SLICK ORGANICS PVT LITD-AX ISCN0173668879,,,net_banking_transfer,6643.62
63bfb2a02e1a0ebb7f62946f,50200023535069,233180.75,60ec41ba55c00300382672d9,HDFC,Revenue-Mktplace,5eecc6d6449e4f7cfb1c2708,2022-10-19T00:00:00.000Z,NEFT CR-DEUT0797BGL-FLIPKART INTERNET PR IVATE LIMITED-SLICK ORGANICS PVT LTD-229 200086GN00050,shopping,,net_banking_transfer,41095.93
63bfb2a02e1a0ebb7f629471,50200023535069,247846.12,60ec41ba55c00300382672d9,HDFC,Revenue-PG-non-split,5eecc6d6449e4f7cfb1c2708,2022-10-19T00:00:00.000Z,NEFT CR-PYTM0123456-PAYTM PAYMENTS SERVI CES LIMITED-SLICK ORGANICS PVT LTD-PYTM2 22926948923,ewallet,,net_banking_transfer,14665.37
63bfb2a02e1a0ebb7f629473,50200023535069,251366.05,60ec41ba55c00300382672d9,HDFC,Revenue-Mktplace,5eecc6d6449e4f7cfb1c2708,2022-10-19T00:00:00.000Z,NEFT CR-DEUT0797BGL-MYNTRA DESIGNS PRIVA TE LIMITED-SLICK ORGANICS - SJIT-2292006 07GN00181,shopping,,net_banking_transfer,3519.93
63bfb2a02e1a0ebb7f629475,50200023535069,252265.11,60ec41ba55c00300382672d9,HDFC,Revenue-Mktplace,5eecc6d6449e4f7cfb1c2708,2022-10-19T00:00:00.000Z,NEFT CR-DEUT0797BGL-MYNTRA DESIGNS PRIVA TE LIMITED-SLICK ORGANICS - SJIT-2292006 08GN00159,shopping,,net_banking_transfer,899.06
63bfb2a02e1a0ebb7f629477,50200023535069,263378.28,60ec41ba55c00300382672d9,HDFC,Revenue-Mktplace,5eecc6d6449e4f7cfb1c2708,2022-10-19T00:00:00.000Z,NEFT CR-DEUT0797BGL-MYNTRA DESIGNS PRIVA,shopping,,net_banking_transfer,11113.17
63bfb2a02e1a0ebb7f629479,50200023535069,269926.89,60ec41ba55c00300382672d9,HDFC,Revenue-Mktplace,5eecc6d6449e4f7cfb1c2708,2022-10-19T00:00:00.000Z,NEFT CR-DEUT0797BGL-MYNTRA DESIGNS PRIVA TE LIMITED-SLICK ORGANICS PVT. LTD.-2292 00676GN00002,shopping,,net_banking_transfer,6548.61
63bfb2a02e1a0ebb7f62947b,50200023535069,119926.89,60ec41ba55c00300382672d9,HDFC,direct expenses,5eecc6d6449e4f7cfb1c2708,2022-10-19T00:00:00.000Z,"NEFT DR-YESB0000551-VISTTA COSMETICS-NET BANK, MUM-N292222169465743-150000",,,net_banking_transfer,-150000
63bfb2a02e1a0ebb7f62947d,50200023535069,143117.71,60ec41ba55c00300382672d9,HDFC,Revenue-PG-split enabled,5eecc6d6449e4f7cfb1c2708,2022-10-19T00:00:00.000Z,NEFT CR-UTIB0001506-RAZORPAY SOFTWARE PR IVATE LIMITED-SLICK ORGANICS PVT LITD-AX ISCN0173770761,,,net_banking_transfer,23190.82
63bfb2a02e1a0ebb7f62947f,50200023535069,136648.71,60ec41ba55c00300382672d9,HDFC,direct expenses,5eecc6d6449e4f7cfb1c2708,2022-10-19T00:00:00.000Z,"NEFT DR-ICIC0000021-AKHILESH DIXIT-NETBA NK, MUM-N292222169472376-6469",,,net_banking_transfer,-6469
63bfb2a02e1a0ebb7f629481,50200023535069,100648.71,60ec41ba55c00300382672d9,HDFC,direct expenses,5eecc6d6449e4f7cfb1c2708,2022-10-19T00:00:00.000Z,"NEFT DR-UBIN0531855-MOHANISH KOTHARI-NET BANK, MUM-N292222169477549-36000",,,net_banking_transfer,-36000
63bfb2a02e1a0ebb7f629483,50200023535069,72148.71,60ec41ba55c00300382672d9,HDFC,direct expenses,5eecc6d6449e4f7cfb1c2708,2022-10-19T00:00:00.000Z,"NEFT DR-UTIB0000131-MONIKA TANEJA-NETBAN K, MUM-N292222169488077-28500",,,net_banking_transfer,-28500
63bfb2a02e1a0ebb7f629485,50200023535069,67436.71,60ec41ba55c00300382672d9,HDFC,direct expenses,5eecc6d6449e4f7cfb1c2708,2022-10-19T00:00:00.000Z,POS 514834XXXXXX9486 MYNTRA DESIGNS P,shopping,,debit_card,-4712
63bfb2a02e1a0ebb7f629487,50200023535069,64813.71,60ec41ba55c00300382672d9,HDFC,direct expenses,5eecc6d6449e4f7cfb1c2708,2022-10-19T00:00:00.000Z,POS 514834XXXXXX9486 MYNTRA DESIGNS P,shopping,,debit_card,-2623
63bfb2a02e1a0ebb7f629489,50200023535069,106712.29,60ec41ba55c00300382672d9,HDFC,Transfer in/Revenue-other,5eecc6d6449e4f7cfb1c2708,2022-10-19T00:00:00.000Z,NEFT CR-YESB0000001-EASEBUZZ PVT LTD NOD AL A/C-SLICK ORGANICS PVT LTD-YESB229239 60435,,,net_banking_transfer,41898.58
63bfb2a02e1a0ebb7f62948b,50200023535069,124773.62,60ec41ba55c00300382672d9,HDFC,Revenue-Mktplace,5eecc6d6449e4f7cfb1c2708,2022-10-19T00:00:00.000Z,NEFT CR-ICIC0000105-MANASH LIFESTYLE PRI VATE LIMITED NO-SLICK ORGANICS PRIVATE L IMITED MP M-ICIJ222920010037,shopping,,net_banking_transfer,18061.33
63bfb2a02e1a0ebb7f62948d,50200023535069,168763.56,60ec41ba55c00300382672d9,HDFC,Revenue-Mktplace,5eecc6d6449e4f7cfb1c2708,2022-10-19T00:00:00.000Z,NEFT CR-ICIC0000105-MANASH LIFESTYLE PRI VATE LIMITED NO-SLICK ORGANICS PRIVATE L IMITED MP G-ICIJ222920010036,shopping,,net_banking_transfer,43989.94
63bfb2a02e1a0ebb7f62948f,50200023535069,170768.34,60ec41ba55c00300382672d9,HDFC,Revenue-Mktplace,5eecc6d6449e4f7cfb1c2708,2022-10-19T00:00:00.000Z,NEFT CR-ICIC0000105-MANASH LIFESTYLE PRI VATE LIMITED NO-SLICK ORGANICS PRIVATE L IMITED BANG-ICIJ222920010039,shopping,,net_banking_transfer,2004.78
63bfb2a02e1a0ebb7f629491,50200023535069,173475.33,60ec41ba55c00300382672d9,HDFC,Revenue-Mktplace,5eecc6d6449e4f7cfb1c2708,2022-10-19T00:00:00.000Z,NEFT CR-ICIC0000105-MANASH LIFESTYLE PRI VATE LIMITED NO-SLICK ORGANICS PRIVATE L IMITED KOLK-ICIJ222920010038,shopping,,net_banking_transfer,2706.99
63bfb2a02e1a0ebb7f629493,50200023535069,196140.37,60ec41ba55c00300382672d9,HDFC,Revenue-PG-split enabled,5eecc6d6449e4f7cfb1c2708,2022-10-19T00:00:00.000Z,NEFT CR-UTIB0001506-RAZORPAY SOFTWARE PR,,,net_banking_transfer,22665.04
63bfb2a02e1a0ebb7f629495,50200023535069,196141.37,60ec41ba55c00300382672d9,HDFC,Transfer in/Revenue-other,5eecc6d6449e4f7cfb1c2708,2022-10-19T00:00:00.000Z,CRV POS 514834******9486 SHOPIFY LTD,,,refund,1
63bfb2a02e1a0ebb7f629497,50200023535069,232498.23,60ec41ba55c00300382672d9,HDFC,Revenue-PG-non-split,5eecc6d6449e4f7cfb1c2708,2022-10-20T00:00:00.000Z,NEFT CR-PYTM0123456-PAYTM PAYMENTS SERVI CES LIMITED-SLICK ORGANICS PVT LTD-PYTM2 22937809412,ewallet,,net_banking_transfer,36356.86
63bfb2a02e1a0ebb7f629499,50200023535069,182498.23,60ec41ba55c00300382672d9,HDFC,direct expenses,5eecc6d6449e4f7cfb1c2708,2022-10-20T00:00:00.000Z,"NEFT DR-PUNB0062910-YADAVPACKAGING-NETBA NK, MUM-N293222171598394-50000",,,net_banking_transfer,-50000
63bfb2a02e1a0ebb7f62949b,50200023535069,207556.83,60ec41ba55c00300382672d9,HDFC,Revenue-PG-split enabled,5eecc6d6449e4f7cfb1c2708,2022-10-20T00:00:00.000Z,NEFT CR-UTIB0001506-RAZORPAY SOFTWARE PR IVATE LIMITED-SLICK ORGANICS PVT LITD-AX ISCN0174108162,,,net_banking_transfer,25058.6
63bfb2a02e1a0ebb7f62949d,50200023535069,157556.83,60ec41ba55c00300382672d9,HDFC,direct expenses,5eecc6d6449e4f7cfb1c2708,2022-10-20T00:00:00.000Z,"NEFT DR-BKID0007124-MATRIX PRINTING SOLU TIONS PVT LTD-NETBANK, MUM-N293222171653 445-50000",,,net_banking_transfer,-50000
63bfb2a02e1a0ebb7f62949f,50200023535069,150756.83,60ec41ba55c00300382672d9,HDFC,direct expenses,5eecc6d6449e4f7cfb1c2708,2022-10-20T00:00:00.000Z,"NEFT DR-ICIC0004109-ASHRAFI ASSOCIATES-N ETBANK, MUM-N293222171697090-6800",,,net_banking_transfer,-6800
63bfb2a02e1a0ebb7f6294a2,50200023535069,103362.83,60ec41ba55c00300382672d9,HDFC,direct expenses,5eecc6d6449e4f7cfb1c2708,2022-10-20T00:00:00.000Z,00918630000430-TPT-47394-UNICOMMERCE ESO LUTIONS PRIVATE LIMITED,,,net_banking_transfer,-47394
63bfb2a02e1a0ebb7f6294a4,50200023535069,-413123.17,60ec41ba55c00300382672d9,HDFC,direct expenses,5eecc6d6449e4f7cfb1c2708,2022-10-20T00:00:00.000Z,"NEFT DR-ICIC0000024-TAKE MOTO YOHKI INDI A PRIVATE LIMITED-NETBANK, MUM-N29322217 1759141-516486",travel,,net_banking_transfer,-516486
63bfb2a02e1a0ebb7f6294a6,50200023535069,-417253.17,60ec41ba55c00300382672d9,HDFC,Marketing Expense,5eecc6d6449e4f7cfb1c2708,2022-10-20T00:00:00.000Z,ME DC SI 514834XXXXXX9486 LINKEDIN (PGSI ),,,Other,-4130
63bfb2a02e1a0ebb7f6294a8,50200023535069,-409959.01,60ec41ba55c00300382672d9,HDFC,Revenue-Mktplace,5eecc6d6449e4f7cfb1c2708,2022-10-20T00:00:00.000Z,NEFT CR-ICIC0000105-MANASH LIFESTYLE PRI VATE LIMITED NO-SLICK ORGANICS PRIVATE L IMITED MP G-ICIJ222930007600,shopping,,net_banking_transfer,7294.16
63bfb2a02e1a0ebb7f6294aa,50200023535069,-382974.05,60ec41ba55c00300382672d9,HDFC,Revenue-Mktplace,5eecc6d6449e4f7cfb1c2708,2022-10-20T00:00:00.000Z,NEFT CR-ICIC0000105-MANASH LIFESTYLE PRI VATE LIMITED NO-SLICK ORGANICS PRIVATE L IMITED MP M-ICIJ222930007601,shopping,,net_banking_transfer,26984.96
63bfb2a02e1a0ebb7f6294ac,50200023535069,-383497.97,60ec41ba55c00300382672d9,HDFC,Marketing Expense,5eecc6d6449e4f7cfb1c2708,2022-10-20T00:00:00.000Z,ME DC SI 514834XXXXXX9486 LINKEDIN (PGSI ),,,Other,-523.92
63bfb2a02e1a0ebb7f6294ae,50200023535069,-324000.67,60ec41ba55c00300382672d9,HDFC,Transfer in/Revenue-other,5eecc6d6449e4f7cfb1c2708,2022-10-20T00:00:00.000Z,NEFT CR-YESB0000001-EASEBUZZ PVT LTD NOD,,,net_banking_transfer,59497.3
63bfb2a02e1a0ebb7f6294b1,50200023535069,-294424.61,60ec41ba55c00300382672d9,HDFC,Revenue-PG-split enabled,5eecc6d6449e4f7cfb1c2708,2022-10-20T00:00:00.000Z,NEFT CR-UTIB0001506-RAZORPAY SOFTWARE PR IVATE LIMITED-SLICK ORGANICS PVT LITD-AX ISCN0174324649,,,net_banking_transfer,29576.06
63bfb2a02e1a0ebb7f6294b3,50200023535069,-356538.61,60ec41ba55c00300382672d9,HDFC,direct expenses,5eecc6d6449e4f7cfb1c2708,2022-10-20T00:00:00.000Z,50200029570430-TPT-62114-RIVOTTA PRIVATE LIMITED,,,net_banking_transfer,-62114
63bfb2a02e1a0ebb7f6294b5,50200023535069,-356534.61,60ec41ba55c00300382672d9,HDFC,Transfer in/Revenue-other,5eecc6d6449e4f7cfb1c2708,2022-10-21T00:00:00.000Z,INT. ON SWCR ON-50300684649760,,,Other,4
63bfb2a12e1a0ebb7f6294b7,50200023535069,-352404.61,60ec41ba55c00300382672d9,HDFC,Loan-in,5eecc6d6449e4f7cfb1c2708,2022-10-21T00:00:00.000Z,SWEEP-IN CREDIT - 50300684649760,,,self_transfer,4130
63bfb2a12e1a0ebb7f6294b9,50200023535069,-352049.61,60ec41ba55c00300382672d9,HDFC,Transfer in/Revenue-other,5eecc6d6449e4f7cfb1c2708,2022-10-21T00:00:00.000Z,INT. ON SWCR ON-50300684649760,,,Other,355
63bfb2a12e1a0ebb7f6294bb,50200023535069,355.39,60ec41ba55c00300382672d9,HDFC,Loan-in,5eecc6d6449e4f7cfb1c2708,2022-10-21T00:00:00.000Z,SWEEP-IN CREDIT - 50300684649760,,,self_transfer,352405
63bfb2a12e1a0ebb7f6294bd,50200023535069,-99829.61,60ec41ba55c00300382672d9,HDFC,direct expenses,5eecc6d6449e4f7cfb1c2708,2022-10-21T00:00:00.000Z,NEFT DR-UTIB0000119-SAFEXPRESS-SANDOZ - MUM-N294222173474210-NET BANKING SI -100 185,,,net_banking_transfer,-100185
63bfb2a12e1a0ebb7f6294bf,50200023535069,-66681.52,60ec41ba55c00300382672d9,HDFC,Revenue-PG-non-split,5eecc6d6449e4f7cfb1c2708,2022-10-21T00:00:00.000Z,NEFT CR-PYTM0123456-PAYTM PAYMENTS SERVI CES LIMITED-SLICK ORGANICS PVT LTD-PYTM2 22949926490,ewallet,,net_banking_transfer,33148.09
63bfb2a12e1a0ebb7f6294c1,50200023535069,-42892.58,60ec41ba55c00300382672d9,HDFC,Revenue-Mktplace,5eecc6d6449e4f7cfb1c2708,2022-10-21T00:00:00.000Z,NEFT CR-DEUT0797BGL-FLIPKART INTERNET PR IVATE LIMITED-SLICK ORGANICS PVT LTD-229 400517GN00042,shopping,,net_banking_transfer,23788.94
63bfb2a12e1a0ebb7f6294c3,50200023535069,-39496.98,60ec41ba55c00300382672d9,HDFC,Revenue-Mktplace,5eecc6d6449e4f7cfb1c2708,2022-10-21T00:00:00.000Z,NEFT CR-DEUT0797BGL-MYNTRA DESIGNS PRIVA TE LIMITED-SLICK ORGANICS - SJIT-2294006 72GN00194,shopping,,net_banking_transfer,3395.6
63bfb2a12e1a0ebb7f6294c5,50200023535069,-38171.49,60ec41ba55c00300382672d9,HDFC,Revenue-Mktplace,5eecc6d6449e4f7cfb1c2708,2022-10-21T00:00:00.000Z,NEFT CR-DEUT0797BGL-MYNTRA DESIGNS PRIVA TE LIMITED-SLICK ORGANICS - SJIT-2294006 71GN00153,shopping,,net_banking_transfer,1325.49
63bfb2a12e1a0ebb7f6294c7,50200023535069,-54307.49,60ec41ba55c00300382672d9,HDFC,direct expenses,5eecc6d6449e4f7cfb1c2708,2022-10-21T00:00:00.000Z,"NEFT DR-PUNB0100110-KRAUTER HEALTHCARE L TD-NETBANK, MUM-N294222173952754-16136",,,net_banking_transfer,-16136
63bfb2a12e1a0ebb7f6294c9,50200023535069,-49582.22,60ec41ba55c00300382672d9,HDFC,Revenue-Mktplace,5eecc6d6449e4f7cfb1c2708,2022-10-21T00:00:00.000Z,NEFT CR-DEUT0797BGL-MYNTRA DESIGNS PRIVA TE LIMITED-SLICK ORGANICS PVT. LTD.-2294 00696GN00057,shopping,,net_banking_transfer,4725.27
63bfb2a12e1a0ebb7f6294cb,50200023535069,-29545.08,60ec41ba55c00300382672d9,HDFC,Revenue-Mktplace,5eecc6d6449e4f7cfb1c2708,2022-10-21T00:00:00.000Z,NEFT CR-DEUT0797BGL-MYNTRA DESIGNS PRIVA,shopping,,net_banking_transfer,20037.14
63bfb2a12e1a0ebb7f6294cd,50200023535069,7391.21,60ec41ba55c00300382672d9,HDFC,Revenue-PG-split enabled,5eecc6d6449e4f7cfb1c2708,2022-10-21T00:00:00.000Z,NEFT CR-UTIB0001506-RAZORPAY SOFTWARE PR IVATE LIMITED-SLICK ORGANICS PVT LITD-AX ISCN0174459255,,,net_banking_transfer,36936.29
63bfb2a12e1a0ebb7f6294cf,50200023535069,-57608.79,60ec41ba55c00300382672d9,HDFC,direct expenses,5eecc6d6449e4f7cfb1c2708,2022-10-21T00:00:00.000Z,"NEFT DR-SBIN0011783-GALACTIC GRIP-NETBAN K, MUM-N294222173960280-65000",,,net_banking_transfer,-65000
63bfb2a12e1a0ebb7f6294d1,50200023535069,-56264.45,60ec41ba55c00300382672d9,HDFC,Revenue-Mktplace,5eecc6d6449e4f7cfb1c2708,2022-10-21T00:00:00.000Z,NEFT CR-ICIC0000105-MANASH LIFESTYLE PRI VATE LIMITED NO-SLICK ORGANICS PRIVATE L IMITED MP M-ICIJ222940006846,shopping,,net_banking_transfer,1344.34
63bfb2a12e1a0ebb7f6294d3,50200023535069,-31067.08,60ec41ba55c00300382672d9,HDFC,Revenue-PG-non-split,5eecc6d6449e4f7cfb1c2708,2022-10-21T00:00:00.000Z,NEFT CR-KKBK0000958-NODAL ACCOUNT BROKEN TUSK TECHNOL-SLICK ORGANICS PRIVATE LIMI TED-CMS2942230273403,,,net_banking_transfer,25197.37
63bfb2a12e1a0ebb7f6294d6,50200023535069,-28228.08,60ec41ba55c00300382672d9,HDFC,Revenue-Mktplace,5eecc6d6449e4f7cfb1c2708,2022-10-21T00:00:00.000Z,NEFT CR-ICIC0000985-DIGITAL AGE RETAIL P VT LTD-SLICK ORGANICS PVT LTD-CMS2905616 786,,,net_banking_transfer,2839
63bfb2a12e1a0ebb7f6294d8,50200023535069,-601392.08,60ec41ba55c00300382672d9,HDFC,direct expenses,5eecc6d6449e4f7cfb1c2708,2022-10-21T00:00:00.000Z,05892560000649-TPT-573164-DECORPAC INDIA PRIVATE LIMITED,,,net_banking_transfer,-573164
63bfb2a12e1a0ebb7f6294da,50200023535069,-539568.48,60ec41ba55c00300382672d9,HDFC,Transfer in/Revenue-other,5eecc6d6449e4f7cfb1c2708,2022-10-21T00:00:00.000Z,NEFT CR-YESB0000001-EASEBUZZ PVT LTD NOD AL A/C-SLICK ORGANICS PVT LTD-YESB229496 25078,,,net_banking_transfer,61823.6
63bfb2a12e1a0ebb7f6294dc,50200023535069,-523672.17,60ec41ba55c00300382672d9,HDFC,Revenue-PG-split enabled,5eecc6d6449e4f7cfb1c2708,2022-10-21T00:00:00.000Z,NEFT CR-UTIB0001506-RAZORPAY SOFTWARE PR IVATE LIMITED-SLICK ORGANICS PVT LITD-AX ISCN0174720023,,,net_banking_transfer,15896.31
63bfb2a12e1a0ebb7f6294de,50200023535069,-523567.17,60ec41ba55c00300382672d9,HDFC,Transfer in/Revenue-other,5eecc6d6449e4f7cfb1c2708,2022-10-22T00:00:00.000Z,INT. ON SWCR ON-50300684649760,,,Other,105
63bfb2a12e1a0ebb7f6294e0,50200023535069,-423737.17,60ec41ba55c00300382672d9,HDFC,Loan-in,5eecc6d6449e4f7cfb1c2708,2022-10-22T00:00:00.000Z,SWEEP-IN CREDIT - 50300684649760,,,self_transfer,99830
63bfb2a12e1a0ebb7f6294e2,50200023535069,-423290.17,60ec41ba55c00300382672d9,HDFC,Transfer in/Revenue-other,5eecc6d6449e4f7cfb1c2708,2022-10-22T00:00:00.000Z,INT. ON SWCR ON-50300684649760,,,Other,447
63bfb2a12e1a0ebb7f6294e4,50200023535069,447.83,60ec41ba55c00300382672d9,HDFC,Loan-in,5eecc6d6449e4f7cfb1c2708,2022-10-22T00:00:00.000Z,SWEEP-IN CREDIT - 50300684649760,,,self_transfer,423738
63bfb2a12e1a0ebb7f6294e6,50200023535069,-53363.17,60ec41ba55c00300382672d9,HDFC,direct expenses,5eecc6d6449e4f7cfb1c2708,2022-10-22T00:00:00.000Z,"NEFT DR-ICIC0006643-KRISHNA PACKAGING CO MPANY-NETBANK, MUM-N295222176417779-5381 1",,,net_banking_transfer,-53811
63bfb2a12e1a0ebb7f6294e8,50200023535069,-76753.17,60ec41ba55c00300382672d9,HDFC,direct expenses,5eecc6d6449e4f7cfb1c2708,2022-10-22T00:00:00.000Z,NEFT DR-KKBK0000173-NITISH KUMAR MANDAL-,,,net_banking_transfer,-23390
63bfb2a12e1a0ebb7f6294ea,50200023535069,-178226.17,60ec41ba55c00300382672d9,HDFC,direct expenses,5eecc6d6449e4f7cfb1c2708,2022-10-22T00:00:00.000Z,"NEFT DR-ICIC0006566-MARKETING MANTRA-NET BANK, MUM-N295222176433339-101473",,,net_banking_transfer,-101473
63bfb2a12e1a0ebb7f6294ec,50200023535069,-184019.17,60ec41ba55c00300382672d9,HDFC,direct expenses,5eecc6d6449e4f7cfb1c2708,2022-10-22T00:00:00.000Z,POS 514834XXXXXX9486 RSP*GROFERS INDI,groceries,,debit_card,-5793
63bfb2a12e1a0ebb7f6294ee,50200023535069,-184117.17,60ec41ba55c00300382672d9,HDFC,direct expenses,5eecc6d6449e4f7cfb1c2708,2022-10-22T00:00:00.000Z,POS 514834XXXXXX9486 PTM*PAYTM WALLET,ewallet,,debit_card,-98
63bfb2a12e1a0ebb7f6294f0,50200023535069,-189117.17,60ec41ba55c00300382672d9,HDFC,direct expenses,5eecc6d6449e4f7cfb1c2708,2022-10-22T00:00:00.000Z,"NEFT DR-ICIC0000021-AKHILESH DIXIT-NETBA NK, MUM-N295222176603223-5000",,,net_banking_transfer,-5000
63bfb2a12e1a0ebb7f6294f2,50200023535069,-154793.99,60ec41ba55c00300382672d9,HDFC,Revenue-PG-non-split,5eecc6d6449e4f7cfb1c2708,2022-10-22T00:00:00.000Z,NEFT CR-PYTM0123456-PAYTM PAYMENTS SERVI CES LIMITED-SLICK ORGANICS PVT LTD-PYTM2 22951400045,ewallet,,net_banking_transfer,34323.18
63bfb2a12e1a0ebb7f6294f4,50200023535069,-154787.99,60ec41ba55c00300382672d9,HDFC,Transfer in/Revenue-other,5eecc6d6449e4f7cfb1c2708,2022-10-23T00:00:00.000Z,INT. ON SWCR ON-50300684649760,,,Other,6
63bfb2a12e1a0ebb7f6294f6,50200023535069,-148994.99,60ec41ba55c00300382672d9,HDFC,Loan-in,5eecc6d6449e4f7cfb1c2708,2022-10-23T00:00:00.000Z,SWEEP-IN CREDIT - 50300684649760,,,self_transfer,5793
63bfb2a12e1a0ebb7f6294f8,50200023535069,-148896.99,60ec41ba55c00300382672d9,HDFC,Loan-in,5eecc6d6449e4f7cfb1c2708,2022-10-23T00:00:00.000Z,SWEEP-IN CREDIT - 50300684649760,,,self_transfer,98
63bfb2a12e1a0ebb7f6294fa,50200023535069,-148837.99,60ec41ba55c00300382672d9,HDFC,Transfer in/Revenue-other,5eecc6d6449e4f7cfb1c2708,2022-10-23T00:00:00.000Z,INT. ON SWCR ON-50300684649760,,,Other,59
63bfb2a12e1a0ebb7f6294fc,50200023535069,-95473.99,60ec41ba55c00300382672d9,HDFC,Loan-in,5eecc6d6449e4f7cfb1c2708,2022-10-23T00:00:00.000Z,SWEEP-IN CREDIT - 50300684649760,,,self_transfer,53364
63bfb2a12e1a0ebb7f6294fe,50200023535069,-95447.99,60ec41ba55c00300382672d9,HDFC,Transfer in/Revenue-other,5eecc6d6449e4f7cfb1c2708,2022-10-23T00:00:00.000Z,INT. ON SWCR ON-50300684649760,,,Other,26
63bfb2a12e1a0ebb7f629500,50200023535069,-72057.99,60ec41ba55c00300382672d9,HDFC,Loan-in,5eecc6d6449e4f7cfb1c2708,2022-10-23T00:00:00.000Z,SWEEP-IN CREDIT - 50300684649760,,,self_transfer,23390
63bfb2a12e1a0ebb7f629502,50200023535069,-71978.99,60ec41ba55c00300382672d9,HDFC,Transfer in/Revenue-other,5eecc6d6449e4f7cfb1c2708,2022-10-23T00:00:00.000Z,INT. ON SWCR ON-50300684649760,,,Other,79
63bfb2a12e1a0ebb7f629504,50200023535069,79.01,60ec41ba55c00300382672d9,HDFC,Loan-in,5eecc6d6449e4f7cfb1c2708,2022-10-23T00:00:00.000Z,SWEEP-IN CREDIT - 50300684649760,,,self_transfer,72058
63bfb2a12e1a0ebb7f629506,50200023535069,39383.03,60ec41ba55c00300382672d9,HDFC,Revenue-PG-non-split,5eecc6d6449e4f7cfb1c2708,2022-10-23T00:00:00.000Z,NEFT CR-PYTM0123456-PAYTM PAYMENTS SERVI CES LIMITED-SLICK ORGANICS PVT LTD-PYTM2 22963366253,ewallet,,net_banking_transfer,39304.02
63bfb2a12e1a0ebb7f629508,50200023535069,38706.91,60ec41ba55c00300382672d9,HDFC,bank charges,5eecc6d6449e4f7cfb1c2708,2022-10-23T00:00:00.000Z,.DC INTL POS TXN MARKUP+ST 290922 300922 -CDT2227411374283,,,international_transaction_arbitrage,-676.12
63bfb2a12e1a0ebb7f62950a,50200023535069,13706.91,60ec41ba55c00300382672d9,HDFC,direct expenses,5eecc6d6449e4f7cfb1c2708,2022-10-23T00:00:00.000Z,POS 514834XXXXXX9486 FLIPKART,shopping,,debit_card,-25000
63bfb2a12e1a0ebb7f62950c,50200023535069,41638.61,60ec41ba55c00300382672d9,HDFC,Revenue-PG-non-split,5eecc6d6449e4f7cfb1c2708,2022-10-24T00:00:00.000Z,NEFT CR-PYTM0123456-PAYTM PAYMENTS SERVI CES LIMITED-SLICK ORGANICS PVT LTD-PYTM2 22975149696,ewallet,,net_banking_transfer,27931.7
63bfb2a12e1a0ebb7f62950e,50200023535069,47431.61,60ec41ba55c00300382672d9,HDFC,Transfer in/Revenue-other,5eecc6d6449e4f7cfb1c2708,2022-10-24T00:00:00.000Z,CRV POS 514834******9486 RSP*GROFERS IND,groceries,,refund,5793
63bfb2a12e1a0ebb7f629510,50200023535069,185456.69,60ec41ba55c00300382672d9,HDFC,Revenue-Mktplace,5eecc6d6449e4f7cfb1c2708,2022-10-25T00:00:00.000Z,IMPS-229805254127-AMAZON SELLER SERVIC-H,shopping,,net_banking_transfer,138025.08
63bfb2a12e1a0ebb7f629512,50200023535069,203378.88,60ec41ba55c00300382672d9,HDFC,Revenue-PG-non-split,5eecc6d6449e4f7cfb1c2708,2022-10-25T00:00:00.000Z,NEFT CR-PYTM0123456-PAYTM PAYMENTS SERVI CES LIMITED-SLICK ORGANICS PVT LTD-PYTM2 22987059373,ewallet,,net_banking_transfer,17922.19
63bfb2a12e1a0ebb7f629515,50200023535069,358237.73,60ec41ba55c00300382672d9,HDFC,Revenue-PG-split enabled,5eecc6d6449e4f7cfb1c2708,2022-10-25T00:00:00.000Z,NEFT CR-UTIB0001506-RAZORPAY SOFTWARE PR IVATE LIMITED-SLICK ORGANICS PVT LITD-AX ISCN0175340163,,,net_banking_transfer,154858.85
63bfb2a12e1a0ebb7f629517,50200023535069,367118.67,60ec41ba55c00300382672d9,HDFC,Revenue-Mktplace,5eecc6d6449e4f7cfb1c2708,2022-10-25T00:00:00.000Z,NEFT CR-DEUT0797BGL-MYNTRA DESIGNS PRIVA TE LIMITED-SLICK ORGANICS - SJIT-2298003 90GN00185,shopping,,net_banking_transfer,8880.94
63bfb2a12e1a0ebb7f629519,50200023535069,372809.87,60ec41ba55c00300382672d9,HDFC,Revenue-Mktplace,5eecc6d6449e4f7cfb1c2708,2022-10-25T00:00:00.000Z,NEFT CR-DEUT0797BGL-MYNTRA DESIGNS PRIVA TE LIMITED-SLICK ORGANICS - SJIT-2298003 91GN00180,shopping,,net_banking_transfer,5691.2
63bfb2a12e1a0ebb7f62951b,50200023535069,394543.78,60ec41ba55c00300382672d9,HDFC,Revenue-Mktplace,5eecc6d6449e4f7cfb1c2708,2022-10-25T00:00:00.000Z,NEFT CR-DEUT0797BGL-MYNTRA DESIGNS PRIVA TE LIMITED-SLICK ORGANICS PVT. LTD.-2298 00410GN00075,shopping,,net_banking_transfer,21733.91
63bfb2a12e1a0ebb7f62951d,50200023535069,408436.58,60ec41ba55c00300382672d9,HDFC,Revenue-Mktplace,5eecc6d6449e4f7cfb1c2708,2022-10-25T00:00:00.000Z,NEFT CR-DEUT0797BGL-MYNTRA DESIGNS PRIVA TE LIMITED-SLICK ORGANICS PVT. LTD.-2298 00407GN00229,shopping,,net_banking_transfer,13892.8
63bfb2a12e1a0ebb7f629521,50200023535069,931939.84,60ec41ba55c00300382672d9,HDFC,Revenue-Mktplace,5eecc6d6449e4f7cfb1c2708,2022-10-25T00:00:00.000Z,NEFT CR-DEUT0797BGL-AMAZON PAY (INDIA) P RIVATE LIMITED-SLICK ORGANICS PVT LTD-22 9800101GN00349,shopping,,net_banking_transfer,523503.26
63bfb2a12e1a0ebb7f629523,50200023535069,931011.84,60ec41ba55c00300382672d9,HDFC,SAAS/tech expense,5eecc6d6449e4f7cfb1c2708,2022-10-25T00:00:00.000Z,POS 514834XXXXXX9486 AMAZON,shopping,,debit_card,-928
63bfb2a12e1a0ebb7f629525,50200023535069,929223.01,60ec41ba55c00300382672d9,HDFC,Marketing Expense,5eecc6d6449e4f7cfb1c2708,2022-10-25T00:00:00.000Z,ME DC SI 514834XXXXXX9486 LINKEDIN (PGSI ),,,Other,-1788.83
63bfb2a12e1a0ebb7f629527,50200023535069,933521.01,60ec41ba55c00300382672d9,HDFC,Transfer in/Revenue-other,5eecc6d6449e4f7cfb1c2708,2022-10-25T00:00:00.000Z,NEFT CR-HSBC0560002-INNOVATIVE RETAIL CO NCEPTS PRIVATE-SLICK ORGANICS PVT LTD-HS BCN22298273384,,,net_banking_transfer,4298
63bfb2a12e1a0ebb7f629529,50200023535069,942720.01,60ec41ba55c00300382672d9,HDFC,Transfer in/Revenue-other,5eecc6d6449e4f7cfb1c2708,2022-10-25T00:00:00.000Z,NEFT CR-HSBC0560002-INNOVATIVE RETAIL CO NCEPTS PRIVATE-SLICK ORGANICS PVT LTD-HS BCN22298274257,,,net_banking_transfer,9199
63bfb2a12e1a0ebb7f62952b,50200023535069,946727.01,60ec41ba55c00300382672d9,HDFC,Transfer in/Revenue-other,5eecc6d6449e4f7cfb1c2708,2022-10-25T00:00:00.000Z,NEFT CR-HSBC0560002-INNOVATIVE RETAIL CO,,,net_banking_transfer,4007
63bfb2a12e1a0ebb7f62952e,50200023535069,1101209.71,60ec41ba55c00300382672d9,HDFC,Transfer in/Revenue-other,5eecc6d6449e4f7cfb1c2708,2022-10-25T00:00:00.000Z,NEFT CR-YESB0000001-EASEBUZZ PVT LTD NOD AL A/C-SLICK ORGANICS PVT LTD-YESB229880 34013,,,net_banking_transfer,154482.7
63bfb2a12e1a0ebb7f629530,50200023535069,1105187.01,60ec41ba55c00300382672d9,HDFC,Transfer in/Revenue-other,5eecc6d6449e4f7cfb1c2708,2022-10-25T00:00:00.000Z,NEFT CR-UTIB0000114-ONE SIGMA TECHNOLOGI ES PRIVATE LIM-SLICK ORGANICS PRIVATE LI MITED-AXISP00331355120,,,net_banking_transfer,3977.3
63bfb2a12e1a0ebb7f629532,50200023535069,1110052.83,60ec41ba55c00300382672d9,HDFC,Transfer in/Revenue-other,5eecc6d6449e4f7cfb1c2708,2022-10-25T00:00:00.000Z,NEFT CR-UTIB0000114-ONE SIGMA TECHNOLOGI ES PRIVATE LIM-SLICK ORGANICS PRIVATE LI MITED-AXISP00331355067,,,net_banking_transfer,4865.82
63bfb2a12e1a0ebb7f629534,50200023535069,1111754.39,60ec41ba55c00300382672d9,HDFC,Transfer in/Revenue-other,5eecc6d6449e4f7cfb1c2708,2022-10-25T00:00:00.000Z,NEFT CR-UTIB0000114-ONE SIGMA TECHNOLOGI ES PRIVATE LIM-SLICK ORGANICS PRIVATE LI MITED-AXISP00331355809,,,net_banking_transfer,1701.56
63bfb2a12e1a0ebb7f629536,50200023535069,1113021.24,60ec41ba55c00300382672d9,HDFC,Transfer in/Revenue-other,5eecc6d6449e4f7cfb1c2708,2022-10-25T00:00:00.000Z,NEFT CR-UTIB0000114-ONE SIGMA TECHNOLOGI ES PRIVATE LIM-SLICK ORGANICS PRIVATE LI MITED-AXISP00331355174,,,net_banking_transfer,1266.85
63bfb2a12e1a0ebb7f629538,50200023535069,1256760.69,60ec41ba55c00300382672d9,HDFC,Transfer in/Revenue-other,5eecc6d6449e4f7cfb1c2708,2022-10-25T00:00:00.000Z,NEFT CR-YESB0000001-EASEBUZZ PVT LTD NOD AL A/C-SLICK ORGANICS PVT LTD-YESB229881 97570,,,net_banking_transfer,143739.45
63bfb2a12e1a0ebb7f62953a,50200023535069,1286403.22,60ec41ba55c00300382672d9,HDFC,Revenue-PG-split enabled,5eecc6d6449e4f7cfb1c2708,2022-10-25T00:00:00.000Z,NEFT CR-UTIB0001506-RAZORPAY SOFTWARE PR IVATE LIMITED-SLICK ORGANICS PVT LITD-AX ISCN0175617666,,,net_banking_transfer,29642.53
63bfb2a12e1a0ebb7f62953c,50200023535069,1243203.22,60ec41ba55c00300382672d9,HDFC,direct expenses,5eecc6d6449e4f7cfb1c2708,2022-10-25T00:00:00.000Z,"NEFT DR-KKBK0000871-DERMAFOLLIX HEALTHCA RE-NETBANK, MUM-N298222178732738-43200",,,net_banking_transfer,-43200
63bfb2a22e1a0ebb7f62953f,50200023535069,1276782.55,60ec41ba55c00300382672d9,HDFC,Revenue-PG-non-split,5eecc6d6449e4f7cfb1c2708,2022-10-26T00:00:00.000Z,NEFT CR-PYTM0123456-PAYTM PAYMENTS SERVI CES LIMITED-SLICK ORGANICS PVT LTD-PYTM2 22998830957,ewallet,,net_banking_transfer,33579.33
63bfb2a22e1a0ebb7f629541,50200023535069,1264282.55,60ec41ba55c00300382672d9,HDFC,direct expenses,5eecc6d6449e4f7cfb1c2708,2022-10-26T00:00:00.000Z,"NEFT DR-IDIB000P153-KRITI DS MAKEUP AND BEAUTY STUDIO-NETBANK, MUM-N299222179052 039-12500",,,net_banking_transfer,-12500
63bfb2a22e1a0ebb7f629543,50200023535069,1315895.7,60ec41ba55c00300382672d9,HDFC,Revenue-PG-non-split,5eecc6d6449e4f7cfb1c2708,2022-10-27T00:00:00.000Z,NEFT CR-PYTM0123456-PAYTM PAYMENTS SERVI,ewallet,,net_banking_transfer,51613.15
63bfb2a22e1a0ebb7f629545,50200023535069,1318170.7,60ec41ba55c00300382672d9,HDFC,Revenue-Mktplace,5eecc6d6449e4f7cfb1c2708,2022-10-27T00:00:00.000Z,NEFT CR-SCBL0036001-DREAMPLUG TECHNOLOGI ES PRIVATE LIMITED-SLICK ORGANICS PRIVAT E LIMITEDSLICK-IN1ON22102700FWN,,,net_banking_transfer,2275
63bfb2a22e1a0ebb7f629548,50200023535069,1321651.22,60ec41ba55c00300382672d9,HDFC,Revenue-Mktplace,5eecc6d6449e4f7cfb1c2708,2022-10-27T00:00:00.000Z,NEFT CR-DEUT0797BGL-MYNTRA DESIGNS PRIVA TE LIMITED-SLICK ORGANICS - SJIT-2300004 12GN00163,shopping,,net_banking_transfer,3480.52
63bfb2a22e1a0ebb7f62954a,50200023535069,1329319.78,60ec41ba55c00300382672d9,HDFC,Revenue-Mktplace,5eecc6d6449e4f7cfb1c2708,2022-10-27T00:00:00.000Z,NEFT CR-DEUT0797BGL-MYNTRA DESIGNS PRIVA TE LIMITED-SLICK ORGANICS - SJIT-2300004 13GN00180,shopping,,net_banking_transfer,7668.56
63bfb2a22e1a0ebb7f62954c,50200023535069,1331084.3,60ec41ba55c00300382672d9,HDFC,Revenue-Mktplace,5eecc6d6449e4f7cfb1c2708,2022-10-27T00:00:00.000Z,NEFT CR-DEUT0797BGL-MYNTRA DESIGNS PRIVA TE LIMITED-SLICK ORGANICS PVT. LTD.-2300 00426GN00078,shopping,,net_banking_transfer,1764.52
63bfb2a22e1a0ebb7f62954e,50200023535069,1338831.8,60ec41ba55c00300382672d9,HDFC,Revenue-Mktplace,5eecc6d6449e4f7cfb1c2708,2022-10-27T00:00:00.000Z,NEFT CR-DEUT0797BGL-MYNTRA DESIGNS PRIVA TE LIMITED-SLICK ORGANICS PVT. LTD.-2300 00427GN00274,shopping,,net_banking_transfer,7747.5
63bfb2a22e1a0ebb7f629550,50200023535069,1398611.34,60ec41ba55c00300382672d9,HDFC,Revenue-PG-split enabled,5eecc6d6449e4f7cfb1c2708,2022-10-27T00:00:00.000Z,NEFT CR-UTIB0001506-RAZORPAY SOFTWARE PR IVATE LIMITED-SLICK ORGANICS PVT LITD-AX ISCN0175937448,,,net_banking_transfer,59779.54
63bfb2a22e1a0ebb7f629553,50200023535069,1449542.7,60ec41ba55c00300382672d9,HDFC,Revenue-Mktplace,5eecc6d6449e4f7cfb1c2708,2022-10-27T00:00:00.000Z,NEFT CR-HSBC0400002-AMAZON SERVICES LLC- SLICK ORGANICS PRIVATE LIMITED-HSBCN2230 0517791,shopping,,net_banking_transfer,50931.36
63bfb2a22e1a0ebb7f629555,50200023535069,1455140.74,60ec41ba55c00300382672d9,HDFC,Transfer in/Revenue-other,5eecc6d6449e4f7cfb1c2708,2022-10-27T00:00:00.000Z,NEFT CR-UTIB0000114-ONE SIGMA TECHNOLOGI ES PRIVATE LIM-SLICK ORGANICS PRIVATE LI MITED-AXISP00331749813,,,net_banking_transfer,5598.04
63bfb2a22e1a0ebb7f629557,50200023535069,1459433.58,60ec41ba55c00300382672d9,HDFC,Transfer in/Revenue-other,5eecc6d6449e4f7cfb1c2708,2022-10-27T00:00:00.000Z,NEFT CR-UTIB0000114-ONE SIGMA TECHNOLOGI ES PRIVATE LIM-SLICK ORGANICS PRIVATE LI MITED-AXISP00331749640,,,net_banking_transfer,4292.84
63bfb2a22e1a0ebb7f629559,50200023535069,1449433.58,60ec41ba55c00300382672d9,HDFC,Refund,5eecc6d6449e4f7cfb1c2708,2022-10-27T00:00:00.000Z,NEFT DR-RATN0VAAPIS-RAZORPAY REFUND CRED,,,net_banking_transfer,-10000
63bfb2a22e1a0ebb7f62955b,50200023535069,1471810.27,60ec41ba55c00300382672d9,HDFC,Revenue-PG-split enabled,5eecc6d6449e4f7cfb1c2708,2022-10-27T00:00:00.000Z,NEFT CR-UTIB0001506-RAZORPAY SOFTWARE PR IVATE LIMITED-SLICK ORGANICS PVT LITD-AX ISCN0176174382,,,net_banking_transfer,22376.69
63bfb2a22e1a0ebb7f62955d,50200023535069,1635630.55,60ec41ba55c00300382672d9,HDFC,Transfer in/Revenue-other,5eecc6d6449e4f7cfb1c2708,2022-10-27T00:00:00.000Z,NEFT CR-YESB0000001-EASEBUZZ PVT LTD NOD AL A/C-SLICK ORGANICS PVT LTD-YESB230027 46580,,,net_banking_transfer,163820.28
63bfb2a22e1a0ebb7f62955f,50200023535069,1653333.4,60ec41ba55c00300382672d9,HDFC,Revenue-Mktplace,5eecc6d6449e4f7cfb1c2708,2022-10-27T00:00:00.000Z,NEFT CR-ICIC0000105-MANASH LIFESTYLE PRI VATE LIMITED NO-SLICK ORGANICS PRIVATE L IMITED MP G-ICIJ223000002779,shopping,,net_banking_transfer,17702.85
63bfb2a22e1a0ebb7f629561,50200023535069,1677011.81,60ec41ba55c00300382672d9,HDFC,Revenue-Mktplace,5eecc6d6449e4f7cfb1c2708,2022-10-27T00:00:00.000Z,NEFT CR-ICIC0000105-MANASH LIFESTYLE PRI VATE LIMITED NO-SLICK ORGANICS PRIVATE L IMITED MP M-ICIJ223000002781,shopping,,net_banking_transfer,23678.41
63bfb2a22e1a0ebb7f629563,50200023535069,1662662.68,60ec41ba55c00300382672d9,HDFC,direct expenses,5eecc6d6449e4f7cfb1c2708,2022-10-27T00:00:00.000Z,POS 514834XXXXXX9486 PLAYBOOK.COM,,,debit_card,-14349.13
63bfb2a22e1a0ebb7f629566,50200023535069,1659940.68,60ec41ba55c00300382672d9,HDFC,direct expenses,5eecc6d6449e4f7cfb1c2708,2022-10-27T00:00:00.000Z,POS 514834XXXXXX9486 FLIPKART INTER B,shopping,,debit_card,-2722
63bfb2a22e1a0ebb7f629568,50200023535069,1676720.21,60ec41ba55c00300382672d9,HDFC,Revenue-PG-non-split,5eecc6d6449e4f7cfb1c2708,2022-10-28T00:00:00.000Z,NEFT CR-PYTM0123456-PAYTM PAYMENTS SERVI CES LIMITED-SLICK ORGANICS PVT LTD-PYTM2 23011264676,ewallet,,net_banking_transfer,16779.53
63bfb2a22e1a0ebb7f62956a,50200023535069,1695147.34,60ec41ba55c00300382672d9,HDFC,Revenue-PG-split enabled,5eecc6d6449e4f7cfb1c2708,2022-10-28T00:00:00.000Z,NEFT CR-UTIB0001506-RAZORPAY SOFTWARE PR IVATE LIMITED-SLICK ORGANICS PVT LITD-AX ISCN0176285788,,,net_banking_transfer,18427.13
63bfb2a22e1a0ebb7f62956c,50200023535069,1700255.74,60ec41ba55c00300382672d9,HDFC,Revenue-Mktplace,5eecc6d6449e4f7cfb1c2708,2022-10-28T00:00:00.000Z,NEFT CR-DEUT0797BGL-MYNTRA DESIGNS PRIVA TE LIMITED-SLICK ORGANICS - SJIT-2301008 09GN00153,shopping,,net_banking_transfer,5108.4
63bfb2a22e1a0ebb7f62956f,50200023535069,1701330.26,60ec41ba55c00300382672d9,HDFC,Revenue-Mktplace,5eecc6d6449e4f7cfb1c2708,2022-10-28T00:00:00.000Z,NEFT CR-DEUT0797BGL-MYNTRA DESIGNS PRIVA TE LIMITED-SLICK ORGANICS - SJIT-2301008 08GN00118,shopping,,net_banking_transfer,1074.52
63bfb2a22e1a0ebb7f629571,50200023535069,1701232.66,60ec41ba55c00300382672d9,HDFC,bank charges,5eecc6d6449e4f7cfb1c2708,2022-10-28T00:00:00.000Z,.DC INTL POS TXN MARKUP+ST 011022 021022 -CDT2227411374283,,,international_transaction_arbitrage,-97.6
63bfb2a22e1a0ebb7f629573,50200023535069,1798100.64,60ec41ba55c00300382672d9,HDFC,Revenue-Mktplace,5eecc6d6449e4f7cfb1c2708,2022-10-28T00:00:00.000Z,NEFT CR-DEUT0797BGL-FLIPKART INTERNET PR IVATE LIMITED-SLICK ORGANICS PVT LTD-230 100877GN00273,shopping,,net_banking_transfer,96867.98
63bfb2a22e1a0ebb7f629575,50200023535069,1803304.81,60ec41ba55c00300382672d9,HDFC,Revenue-Mktplace,5eecc6d6449e4f7cfb1c2708,2022-10-28T00:00:00.000Z,NEFT CR-DEUT0797BGL-MYNTRA DESIGNS PRIVA,shopping,,net_banking_transfer,5204.17
63bfb2a22e1a0ebb7f629577,50200023535069,1801619.88,60ec41ba55c00300382672d9,HDFC,bank charges,5eecc6d6449e4f7cfb1c2708,2022-10-28T00:00:00.000Z,.DC INTL POS TXN MARKUP+ST 011022 031022 -CDT2227411374283,,,international_transaction_arbitrage,-1684.93
63bfb2a22e1a0ebb7f629579,50200023535069,1783619.88,60ec41ba55c00300382672d9,HDFC,direct expenses,5eecc6d6449e4f7cfb1c2708,2022-10-28T00:00:00.000Z,50100535146241-TPT-18000-SHOUMINI DUTTA,,,net_banking_transfer,-18000
63bfb2a22e1a0ebb7f62957b,50200023535069,1779290.88,60ec41ba55c00300382672d9,HDFC,direct expenses,5eecc6d6449e4f7cfb1c2708,2022-10-28T00:00:00.000Z,POS 514834XXXXXX9486 FLIPKART INTER B,shopping,,debit_card,-4329
63bfb2a22e1a0ebb7f62957d,50200023535069,1777290.88,60ec41ba55c00300382672d9,HDFC,direct expenses,5eecc6d6449e4f7cfb1c2708,2022-10-28T00:00:00.000Z,50100535146241-TPT-2000-SHOUMINI DUTTA,,,net_banking_transfer,-2000
63bfb2a22e1a0ebb7f62957f,50200023535069,1780532.17,60ec41ba55c00300382672d9,HDFC,Revenue-PG-non-split,5eecc6d6449e4f7cfb1c2708,2022-10-28T00:00:00.000Z,NEFT CR-SCBL0036001-STRIPE INDIA PRIVATE LIMITED-SLICK ORGANICS PRIVATE LIMITED- IN1ON22102801HR5,,,net_banking_transfer,3241.29
63bfb2a22e1a0ebb7f629581,50200023535069,1776203.17,60ec41ba55c00300382672d9,HDFC,direct expenses,5eecc6d6449e4f7cfb1c2708,2022-10-28T00:00:00.000Z,POS 514834XXXXXX9486 FLIPKART INTER B,shopping,,debit_card,-4329
63bfb2a22e1a0ebb7f629583,50200023535069,1736203.17,60ec41ba55c00300382672d9,HDFC,direct expenses,5eecc6d6449e4f7cfb1c2708,2022-10-28T00:00:00.000Z,"NEFT DR-RATN0VAAPIS-CR CARD COLLECTION P ARKING GL RAZORPAY-NETBANK, MUM-N301222 181278327-40000",,,net_banking_transfer,-40000
63bfb2a22e1a0ebb7f629585,50200023535069,1716203.17,60ec41ba55c00300382672d9,HDFC,direct expenses,5eecc6d6449e4f7cfb1c2708,2022-10-28T00:00:00.000Z,POS 514834XXXXXX9486 FLIPKART,shopping,,debit_card,-20000
63bfb2a22e1a0ebb7f629587,50200023535069,1716770.36,60ec41ba55c00300382672d9,HDFC,Transfer in/Revenue-other,5eecc6d6449e4f7cfb1c2708,2022-10-28T00:00:00.000Z,NEFT CR-UTIB0000114-ONE SIGMA TECHNOLOGI ES PRIVATE LIM-SLICK ORGANICS PRIVATE LI MITED-AXISP00332046931,,,net_banking_transfer,567.19
63bfb2a22e1a0ebb7f629589,50200023535069,1616770.36,60ec41ba55c00300382672d9,HDFC,direct expenses,5eecc6d6449e4f7cfb1c2708,2022-10-28T00:00:00.000Z,"NEFT DR-RATN0VAAPIS-CR CARD COLLECTION P ARKING GL RAZORPAY-NETBANK, MUM-N301222 181485958-100000",,,net_banking_transfer,-100000
63bfb2a22e1a0ebb7f62958b,50200023535069,1618092.69,60ec41ba55c00300382672d9,HDFC,Revenue-Mktplace,5eecc6d6449e4f7cfb1c2708,2022-10-28T00:00:00.000Z,NEFT CR-ICIC0000105-MANASH LIFESTYLE PRI VATE LIMITED NO-SLICK ORGANICS PRIVATE L IMITED MP M-ICIJ223010005401,shopping,,net_banking_transfer,1322.33
63bfb2a22e1a0ebb7f62958d,50200023535069,1622758.94,60ec41ba55c00300382672d9,HDFC,Revenue-Mktplace,5eecc6d6449e4f7cfb1c2708,2022-10-28T00:00:00.000Z,NEFT CR-ICIC0000105-MANASH LIFESTYLE PRI VATE LIMITED NO-SLICK ORGANICS PRIVATE L IMITED MP G-ICIJ223010005400,shopping,,net_banking_transfer,4666.25
63bfb2a22e1a0ebb7f62958f,50200023535069,1704069.49,60ec41ba55c00300382672d9,HDFC,Transfer in/Revenue-other,5eecc6d6449e4f7cfb1c2708,2022-10-28T00:00:00.000Z,NEFT CR-YESB0000001-EASEBUZZ PVT LTD NOD AL A/C-SLICK ORGANICS PVT LTD-YESB230151 86757,,,net_banking_transfer,81310.55
63bfb2a22e1a0ebb7f629591,50200023535069,1724343.92,60ec41ba55c00300382672d9,HDFC,Revenue-PG-split enabled,5eecc6d6449e4f7cfb1c2708,2022-10-28T00:00:00.000Z,NEFT CR-UTIB0001506-RAZORPAY SOFTWARE PR,,,net_banking_transfer,20274.43
63bfb2a22e1a0ebb7f629593,50200023535069,1759699.55,60ec41ba55c00300382672d9,HDFC,Revenue-COD,5eecc6d6449e4f7cfb1c2708,2022-10-28T00:00:00.000Z,NEFT CR-ICIC0000155-SHIPROCKET COD CRF I D 5102999-SLICK ORGANICS PVT LTD-CMS2914 793963,,,net_banking_transfer,35355.63
63bfb2a22e1a0ebb7f629595,50200023535069,1782509.74,60ec41ba55c00300382672d9,HDFC,Revenue-PG-non-split,5eecc6d6449e4f7cfb1c2708,2022-10-29T00:00:00.000Z,NEFT CR-PYTM0123456-PAYTM PAYMENTS SERVI CES LIMITED-SLICK ORGANICS PVT LTD-PYTM2 23022945138,ewallet,,net_banking_transfer,22810.19
63bfb2a22e1a0ebb7f629597,50200023535069,1793840.88,60ec41ba55c00300382672d9,HDFC,Revenue-PG-split enabled,5eecc6d6449e4f7cfb1c2708,2022-10-29T00:00:00.000Z,NEFT CR-UTIB0001506-RAZORPAY SOFTWARE PR IVATE LIMITED-SLICK ORGANICS PVT LITD-AX ISCN0176654976,,,net_banking_transfer,11331.14
63bfb2a22e1a0ebb7f629599,50200023535069,1777160.88,60ec41ba55c00300382672d9,HDFC,direct expenses,5eecc6d6449e4f7cfb1c2708,2022-10-29T00:00:00.000Z,"NEFT DR-SBIN0008078-PANDIT PLASTICS-NETB ANK, MUM-N302222182636082-16680",,,net_banking_transfer,-16680
63bfb2a22e1a0ebb7f62959b,50200023535069,1852120.88,60ec41ba55c00300382672d9,HDFC,Transfer in/Revenue-other,5eecc6d6449e4f7cfb1c2708,2022-10-29T00:00:00.000Z,NEFT CR-YESB0000001-EASEBUZZ PVT LTD NOD AL A/C-SLICK ORGANICS PVT LTD-YESB230275 89257,,,net_banking_transfer,74960
63bfb2a22e1a0ebb7f62959d,50200023535069,1878063.48,60ec41ba55c00300382672d9,HDFC,Revenue-PG-split enabled,5eecc6d6449e4f7cfb1c2708,2022-10-29T00:00:00.000Z,NEFT CR-UTIB0001506-RAZORPAY SOFTWARE PR IVATE LIMITED-SLICK ORGANICS PVT LITD-AX ISCN0176859273,,,net_banking_transfer,25942.6
63bfb2a22e1a0ebb7f62959f,50200023535069,1904184.68,60ec41ba55c00300382672d9,HDFC,Revenue-PG-non-split,5eecc6d6449e4f7cfb1c2708,2022-10-30T00:00:00.000Z,NEFT CR-PYTM0123456-PAYTM PAYMENTS SERVI CES LIMITED-SLICK ORGANICS PVT LTD-PYTM2 23034550035,ewallet,,net_banking_transfer,26121.2
63bfb2a22e1a0ebb7f6295a2,50200023535069,1904005.68,60ec41ba55c00300382672d9,HDFC,SAAS/tech expense,5eecc6d6449e4f7cfb1c2708,2022-10-30T00:00:00.000Z,ME DC SI 514834XXXXXX9486 AMAZON,shopping,,Other,-179
63bfb2a22e1a0ebb7f6295a5,50200023535069,1862702.97,60ec41ba55c00300382672d9,HDFC,SAAS/tech expense,5eecc6d6449e4f7cfb1c2708,2022-10-31T00:00:00.000Z,POS 514834XXXXXX9486 AMAZON.COM,shopping,,debit_card,-41302.71
63bfb2a22e1a0ebb7f6295a7,50200023535069,1835702.97,60ec41ba55c00300382672d9,HDFC,direct expenses,5eecc6d6449e4f7cfb1c2708,2022-10-31T00:00:00.000Z,NEFT DR-KKBK0000654-NIHARIKA MISHRA-SAND OZ - MUM-N304222183426190-NET BANKING SI -27000,,,net_banking_transfer,-27000
63bfb2a22e1a0ebb7f6295a9,50200023535069,1833819.69,60ec41ba55c00300382672d9,HDFC,direct expenses,5eecc6d6449e4f7cfb1c2708,2022-10-31T00:00:00.000Z,POS 514834XXXXXX9486 PTM*PAYTM,ewallet,,debit_card,-1883.28
63bfb2a22e1a0ebb7f6295ac,50200023535069,1865042.76,60ec41ba55c00300382672d9,HDFC,Revenue-PG-non-split,5eecc6d6449e4f7cfb1c2708,2022-10-31T00:00:00.000Z,NEFT CR-PYTM0123456-PAYTM PAYMENTS SERVI CES LIMITED-SLICK ORGANICS PVT LTD-PYTM2 23046517980,ewallet,,net_banking_transfer,31223.07
63bfb2a22e1a0ebb7f6295ae,50200023535069,1943357.63,60ec41ba55c00300382672d9,HDFC,Revenue-PG-split enabled,5eecc6d6449e4f7cfb1c2708,2022-10-31T00:00:00.000Z,NEFT CR-UTIB0001506-RAZORPAY SOFTWARE PR,,,net_banking_transfer,78314.87
63bfb2a22e1a0ebb7f6295b0,50200023535069,1939012.21,60ec41ba55c00300382672d9,HDFC,Marketing Expense,5eecc6d6449e4f7cfb1c2708,2022-10-31T00:00:00.000Z,ME DC SI 514834XXXXXX9486 LINKEDIN (PGSI ),,,Other,-4345.42
63bfb2a22e1a0ebb7f6295b2,50200023535069,1914012.21,60ec41ba55c00300382672d9,HDFC,direct expenses,5eecc6d6449e4f7cfb1c2708,2022-10-31T00:00:00.000Z,POS 514834XXXXXX9486 FLIPKART,shopping,,debit_card,-25000
63bfb2a22e1a0ebb7f6295b4,50200023535069,1911300.21,60ec41ba55c00300382672d9,HDFC,direct expenses,5eecc6d6449e4f7cfb1c2708,2022-10-31T00:00:00.000Z,POS 514834XXXXXX9486 NYKAA,,,debit_card,-2712
63bfb2a22e1a0ebb7f6295b6,50200023535069,1882300.21,60ec41ba55c00300382672d9,HDFC,direct expenses,5eecc6d6449e4f7cfb1c2708,2022-10-31T00:00:00.000Z,57500000443889-TPT-29000-WEBKLIPPER TECH NOLOGIES PRIVATE LIMITED,,,net_banking_transfer,-29000
63bfb2a22e1a0ebb7f6295b8,50200023535069,1885499.76,60ec41ba55c00300382672d9,HDFC,Revenue-Mktplace,5eecc6d6449e4f7cfb1c2708,2022-10-31T00:00:00.000Z,NEFT CR-ICIC0000105-MANASH LIFESTYLE PRI VATE LIMITED NO-SLICK ORGANICS PRIVATE L IMITED MP G-ICIJ223040003643,shopping,,net_banking_transfer,3199.55
63bfb2a22e1a0ebb7f6295ba,50200023535069,1888627.49,60ec41ba55c00300382672d9,HDFC,Revenue-Mktplace,5eecc6d6449e4f7cfb1c2708,2022-10-31T00:00:00.000Z,NEFT CR-ICIC0000105-MANASH LIFESTYLE PRI VATE LIMITED NO-SLICK ORGANICS PRIVATE L IMITED MP M-ICIJ223040003644,shopping,,net_banking_transfer,3127.73
63bfb2a22e1a0ebb7f6295bc,50200023535069,1892257.12,60ec41ba55c00300382672d9,HDFC,Transfer in/Revenue-other,5eecc6d6449e4f7cfb1c2708,2022-10-31T00:00:00.000Z,NEFT CR-UTIB0000114-ONE SIGMA TECHNOLOGI ES PRIVATE LIM-SLICK ORGANICS PRIVATE LI MITED-AXISP00332586891,,,net_banking_transfer,3629.63
63bfb2a22e1a0ebb7f6295be,50200023535069,1899415.09,60ec41ba55c00300382672d9,HDFC,Transfer in/Revenue-other,5eecc6d6449e4f7cfb1c2708,2022-10-31T00:00:00.000Z,NEFT CR-UTIB0000114-ONE SIGMA TECHNOLOGI ES PRIVATE LIM-SLICK ORGANICS PRIVATE LI MITED-AXISP00332587094,,,net_banking_transfer,7157.97
63bfb2a22e1a0ebb7f6295c0,50200023535069,1898121.09,60ec41ba55c00300382672d9,HDFC,direct expenses,5eecc6d6449e4f7cfb1c2708,2022-10-31T00:00:00.000Z,POS 514834XXXXXX9486 FLIPKART PAYMENT,shopping,,debit_card,-1294
63bfb2a32e1a0ebb7f6295c2,50200023535069,2143467.72,60ec41ba55c00300382672d9,HDFC,Transfer in/Revenue-other,5eecc6d6449e4f7cfb1c2708,2022-10-31T00:00:00.000Z,NEFT CR-YESB0000001-EASEBUZZ PVT LTD NOD AL A/C-SLICK ORGANICS PVT LTD-YESB230420 72927,,,net_banking_transfer,245346.63
63bfb2a32e1a0ebb7f6295c4,50200023535069,2156301.1,60ec41ba55c00300382672d9,HDFC,Revenue-PG-split enabled,5eecc6d6449e4f7cfb1c2708,2022-10-31T00:00:00.000Z,NEFT CR-UTIB0001506-RAZORPAY SOFTWARE PR IVATE LIMITED-SLICK ORGANICS PVT LITD-AX ISCN0177532105,,,net_banking_transfer,12833.38
63bfb2a32e1a0ebb7f6295c6,50200023535069,2156930.1,60ec41ba55c00300382672d9,HDFC,Revenue-Mktplace,5eecc6d6449e4f7cfb1c2708,2022-10-31T00:00:00.000Z,CRV POS 514834******9486 FLIPKART INTER,shopping,,refund,629
63bfb2a32e1a0ebb7f6295c8,50200023535069,2157559.1,60ec41ba55c00300382672d9,HDFC,Revenue-Mktplace,5eecc6d6449e4f7cfb1c2708,2022-10-31T00:00:00.000Z,CRV POS 514834******9486 FLIPKART INTER,shopping,,refund,629
63bfb2a32e1a0ebb7f6295ca,50200023535069,2253934.28,60ec41ba55c00300382672d9,HDFC,Revenue-COD,5eecc6d6449e4f7cfb1c2708,2022-10-31T00:00:00.000Z,NEFT CR-ICIC0000155-SHIPROCKET COD CRF I,,,net_banking_transfer,96375.18
63bfb2a32e1a0ebb7f6295cc,50200023535069,2351284.28,60ec41ba55c00300382672d9,HDFC,Transfer in/Revenue-other,5eecc6d6449e4f7cfb1c2708,2022-10-31T00:00:00.000Z,00640330000510-SLICK ORGANICS PVT L,,,Other,97350
63bfb2a32e1a0ebb7f6295ce,50200023535069,2365683.53,60ec41ba55c00300382672d9,HDFC,Revenue-PG-non-split,5eecc6d6449e4f7cfb1c2708,2022-11-01T00:00:00.000Z,NEFT CR-PYTM0123456-PAYTM PAYMENTS SERVI CES LIMITED-SLICK ORGANICS PVT LTD-PYTM2 23057807214,ewallet,,net_banking_transfer,14399.25
63bfb2a32e1a0ebb7f6295d0,50200023535069,2360894.53,60ec41ba55c00300382672d9,HDFC,direct expenses,5eecc6d6449e4f7cfb1c2708,2022-11-01T00:00:00.000Z,NEFT DR-UTIB0000119-SAFEXPRESS-SANDOZ - MUM-N305222185764871-NET BANKING SI -478 9,,,net_banking_transfer,-4789
63bfb2a32e1a0ebb7f6295d2,50200023535069,2220662.53,60ec41ba55c00300382672d9,HDFC,direct expenses,5eecc6d6449e4f7cfb1c2708,2022-11-01T00:00:00.000Z,NEFT DR-UTIB0000119-SAFEXPRESS-SANDOZ - MUM-N305222185764873-NET BANKING SI -140 232,,,net_banking_transfer,-140232
63bfb2a32e1a0ebb7f6295d4,50200023535069,1631319.53,60ec41ba55c00300382672d9,HDFC,Marketing Expense,5eecc6d6449e4f7cfb1c2708,2022-11-01T00:00:00.000Z,"NEFT DR-CITI0100000-GOOGLE INDIA PVT LTD -NETBANK, MUM-N305222185768322-589343",,,net_banking_transfer,-589343
63bfb2a32e1a0ebb7f6295d7,50200023535069,828222.53,60ec41ba55c00300382672d9,HDFC,direct expenses,5eecc6d6449e4f7cfb1c2708,2022-11-01T00:00:00.000Z,02711600008220-TPT-803097-VARUN SINGH,,,net_banking_transfer,-803097
63bfb2a32e1a0ebb7f6295da,50200023535069,678222.53,60ec41ba55c00300382672d9,HDFC,direct expenses,5eecc6d6449e4f7cfb1c2708,2022-11-01T00:00:00.000Z,"NEFT DR-YESB0000551-VISTTA COSMETICS-NET BANK, MUM-N305222185826966-150000",,,net_banking_transfer,-150000
63bfb2a32e1a0ebb7f6295dc,50200023535069,696238.63,60ec41ba55c00300382672d9,HDFC,Revenue-PG-split enabled,5eecc6d6449e4f7cfb1c2708,2022-11-01T00:00:00.000Z,NEFT CR-UTIB0001506-RAZORPAY SOFTWARE PR IVATE LIMITED-SLICK ORGANICS PVT LITD-AX ISCN0177801817,,,net_banking_transfer,18016.1
63bfb2a32e1a0ebb7f6295de,50200023535069,546238.63,60ec41ba55c00300382672d9,HDFC,direct expenses,5eecc6d6449e4f7cfb1c2708,2022-11-01T00:00:00.000Z,"NEFT DR-IDFB0040101-ACTIVES ADDITIVES AP PLICATIONS LLP-NETBANK, MUM-N30522218586 5023-150000",,,net_banking_transfer,-150000
63bfb2a32e1a0ebb7f6295e0,50200023535069,545806.63,60ec41ba55c00300382672d9,HDFC,direct expenses,5eecc6d6449e4f7cfb1c2708,2022-11-01T00:00:00.000Z,POS 514834XXXXXX9486 SMARTSHIFT LOGIS,,,debit_card,-432
63bfb2a32e1a0ebb7f6295e2,50200023535069,502986.63,60ec41ba55c00300382672d9,HDFC,Tax,5eecc6d6449e4f7cfb1c2708,2022-11-01T00:00:00.000Z,051030801112214988- CBDT TAX,,,Other,-42820
63bfb2a32e1a0ebb7f6295e4,50200023535069,501541.63,60ec41ba55c00300382672d9,HDFC,direct expenses,5eecc6d6449e4f7cfb1c2708,2022-11-01T00:00:00.000Z,POS 514834XXXXXX9486 SMARTSHIFT LOGIS,,,debit_card,-1445
63bfb2a32e1a0ebb7f6295e6,50200023535069,501374.82,60ec41ba55c00300382672d9,HDFC,bank charges,5eecc6d6449e4f7cfb1c2708,2022-11-01T00:00:00.000Z,.DC INTL POS TXN MARKUP+ST 121022 141022 -CDT2230512020599,,,international_transaction_arbitrage,-166.81
63bfb2a32e1a0ebb7f6295e8,50200023535069,605917.35,60ec41ba55c00300382672d9,HDFC,Transfer in/Revenue-other,5eecc6d6449e4f7cfb1c2708,2022-11-01T00:00:00.000Z,NEFT CR-YESB0000001-EASEBUZZ PVT LTD NOD AL A/C-SLICK ORGANICS PVT LTD-YESB230544 44927,,,net_banking_transfer,104542.53
63bfb2a32e1a0ebb7f6295ea,50200023535069,546517.35,60ec41ba55c00300382672d9,HDFC,direct expenses,5eecc6d6449e4f7cfb1c2708,2022-11-01T00:00:00.000Z,50200029955581-TPT-59400-THE IMAGE CODE,,,net_banking_transfer,-59400
63bfb2a32e1a0ebb7f6295ec,50200023535069,142868.35,60ec41ba55c00300382672d9,HDFC,direct expenses,5eecc6d6449e4f7cfb1c2708,2022-11-01T00:00:00.000Z,NEFT DR-ICIC0000024-TAKE MOTO YOHKI INDI,travel,,net_banking_transfer,-403649
63bfb2a32e1a0ebb7f6295ee,50200023535069,145994.31,60ec41ba55c00300382672d9,HDFC,Revenue-PG-split enabled,5eecc6d6449e4f7cfb1c2708,2022-11-01T00:00:00.000Z,NEFT CR-UTIB0001506-RAZORPAY SOFTWARE PR IVATE LIMITED-SLICK ORGANICS PVT LITD-AX ISCN0178019835,,,net_banking_transfer,3125.96
63bfb2a32e1a0ebb7f6295f0,50200023535069,126734.31,60ec41ba55c00300382672d9,HDFC,direct expenses,5eecc6d6449e4f7cfb1c2708,2022-11-01T00:00:00.000Z,"NEFT DR-KKBK0000173-NITISH KUMAR MANDAL- NETBANK, MUM-N305222187385172-19260",,,net_banking_transfer,-19260
63bfb2a32e1a0ebb7f6295f2,50200023535069,125908.31,60ec41ba55c00300382672d9,HDFC,Marketing Expense,5eecc6d6449e4f7cfb1c2708,2022-11-01T00:00:00.000Z,ME DC SI 514834XXXXXX9486 FACEBOOK SI,,,Other,-826
63bfb2a32e1a0ebb7f6295f4,50200023535069,154909.28,60ec41ba55c00300382672d9,HDFC,Revenue-Mktplace,5eecc6d6449e4f7cfb1c2708,2022-11-02T00:00:00.000Z,NEFT CR-DEUT0797BGL-FLIPKART INTERNET PR IVATE LIMITED-SLICK ORGANICS PVT LTD-230 600121GN00031,shopping,,net_banking_transfer,29000.97
63bfb2a32e1a0ebb7f6295f6,50200023535069,165602.44,60ec41ba55c00300382672d9,HDFC,Revenue-PG-non-split,5eecc6d6449e4f7cfb1c2708,2022-11-02T00:00:00.000Z,NEFT CR-PYTM0123456-PAYTM PAYMENTS SERVI CES LIMITED-SLICK ORGANICS PVT LTD-PYTM2 23069746335,ewallet,,net_banking_transfer,10693.16
63bfb2a32e1a0ebb7f6295f8,50200023535069,177235.28,60ec41ba55c00300382672d9,HDFC,Revenue-Mktplace,5eecc6d6449e4f7cfb1c2708,2022-11-02T00:00:00.000Z,NEFT CR-DEUT0797BGL-MYNTRA DESIGNS PRIVA TE LIMITED-SLICK ORGANICS - SJIT-2306007 44GN00168,shopping,,net_banking_transfer,11632.84
63bfb2a32e1a0ebb7f6295fa,50200023535069,210223.4,60ec41ba55c00300382672d9,HDFC,Revenue-Mktplace,5eecc6d6449e4f7cfb1c2708,2022-11-02T00:00:00.000Z,NEFT CR-DEUT0797BGL-MYNTRA DESIGNS PRIVA TE LIMITED-SLICK ORGANICS - SJIT-2306007 43GN00210,shopping,,net_banking_transfer,32988.12
63bfb2a32e1a0ebb7f6295fc,50200023535069,226858.02,60ec41ba55c00300382672d9,HDFC,Revenue-Mktplace,5eecc6d6449e4f7cfb1c2708,2022-11-02T00:00:00.000Z,NEFT CR-DEUT0797BGL-MYNTRA DESIGNS PRIVA TE LIMITED-SLICK ORGANICS PVT. LTD.-2306 00769GN00120,shopping,,net_banking_transfer,16634.62
63bfb2a32e1a0ebb7f6295fe,50200023535069,233251.59,60ec41ba55c00300382672d9,HDFC,Revenue-PG-split enabled,5eecc6d6449e4f7cfb1c2708,2022-11-02T00:00:00.000Z,NEFT CR-UTIB0001506-RAZORPAY SOFTWARE PR IVATE LIMITED-SLICK ORGANICS PVT LITD-AX ISCN0178214189,,,net_banking_transfer,6393.57
63bfb2a32e1a0ebb7f629600,50200023535069,183251.59,60ec41ba55c00300382672d9,HDFC,direct expenses,5eecc6d6449e4f7cfb1c2708,2022-11-02T00:00:00.000Z,"NEFT DR-KKBK0000173-MATRIX PRINTING SOLU TIONS PRIVATE LIMITE-NETBANK, MUM-N30622 2188051649-50000",,,net_banking_transfer,-50000
63bfb2a32e1a0ebb7f629602,50200023535069,182636.59,60ec41ba55c00300382672d9,HDFC,Tax,5eecc6d6449e4f7cfb1c2708,2022-11-02T00:00:00.000Z,051030802112217301- CBDT TAX,,,Other,-615
63bfb2a32e1a0ebb7f629604,50200023535069,134706.59,60ec41ba55c00300382672d9,HDFC,direct expenses,5eecc6d6449e4f7cfb1c2708,2022-11-02T00:00:00.000Z,POS 514834XXXXXX9486 PTM*PAYTM,ewallet,,debit_card,-47930
63bfb2a32e1a0ebb7f629606,50200023535069,138649.45,60ec41ba55c00300382672d9,HDFC,Transfer in/Revenue-other,5eecc6d6449e4f7cfb1c2708,2022-11-02T00:00:00.000Z,NEFT CR-UTIB0000114-ONE SIGMA TECHNOLOGI ES PRIVATE LIM-SLICK ORGANICS PRIVATE LI MITED-AXISP00333866180,,,net_banking_transfer,3942.86
63bfb2a32e1a0ebb7f629608,50200023535069,139330.07,60ec41ba55c00300382672d9,HDFC,Transfer in/Revenue-other,5eecc6d6449e4f7cfb1c2708,2022-11-02T00:00:00.000Z,NEFT CR-UTIB0000114-ONE SIGMA TECHNOLOGI ES PRIVATE LIM-SLICK ORGANICS PRIVATE LI MITED-AXISP00333866084,,,net_banking_transfer,680.62
63bfb2a32e1a0ebb7f62960b,50200023535069,139331.07,60ec41ba55c00300382672d9,HDFC,Transfer in/Revenue-other,5eecc6d6449e4f7cfb1c2708,2022-11-02T00:00:00.000Z,NEFT CR-SCBL0036001-HEALTH GLOW PRIVATE LIMITED-SLICK ORGANICS PVT LTD-ARATA-IN 1ON22110202V1A,,,net_banking_transfer,1
63bfb2a32e1a0ebb7f62960d,50200023535069,136820.16,60ec41ba55c00300382672d9,HDFC,SAAS/tech expense,5eecc6d6449e4f7cfb1c2708,2022-11-02T00:00:00.000Z,POS 514834XXXXXX9486 AMAZON.COM,shopping,,debit_card,-2510.91
63bfb2a32e1a0ebb7f62960f,50200023535069,169086.76,60ec41ba55c00300382672d9,HDFC,Transfer in/Revenue-other,5eecc6d6449e4f7cfb1c2708,2022-11-02T00:00:00.000Z,NEFT CR-YESB0000001-EASEBUZZ PVT LTD NOD AL A/C-SLICK ORGANICS PVT LTD-YESB230671 29992,,,net_banking_transfer,32266.6
63bfb2a32e1a0ebb7f629611,50200023535069,199651.76,60ec41ba55c00300382672d9,HDFC,Revenue-COD,5eecc6d6449e4f7cfb1c2708,2022-11-02T00:00:00.000Z,PICKRR TECHNOL-AKHILESHDIXIT85GMAIL,,,Other,30565
63bfb2a32e1a0ebb7f629613,50200023535069,220805.46,60ec41ba55c00300382672d9,HDFC,Revenue-PG-split enabled,5eecc6d6449e4f7cfb1c2708,2022-11-02T00:00:00.000Z,NEFT CR-UTIB0001506-RAZORPAY SOFTWARE PR IVATE LIMITED-SLICK ORGANICS PVT LITD-AX ISCN0178471244,,,net_banking_transfer,21153.7
63bfb2a32e1a0ebb7f629615,50200023535069,221449.93,60ec41ba55c00300382672d9,HDFC,Revenue-COD,5eecc6d6449e4f7cfb1c2708,2022-11-02T00:00:00.000Z,NEFT CR-ICIC0000155-SHIPROCKET COD CRF I D 5123447-SLICK ORGANICS PVT LTD-CMS2922 081772,,,net_banking_transfer,644.47
63bfb2a32e1a0ebb7f629617,50200023535069,341449.73,60ec41ba55c00300382672d9,HDFC,Revenue-Mktplace,5eecc6d6449e4f7cfb1c2708,2022-11-02T00:00:00.000Z,NEFT CR-HSBC0110004-CLOUDTAIL INDIA PRIV ATE LIMITED-SLICK ORGANICS PVT LTD-HSBCN 22306170898,,,net_banking_transfer,119999.8
63bfb2a32e1a0ebb7f629619,50200023535069,354487.6,60ec41ba55c00300382672d9,HDFC,Revenue-PG-non-split,5eecc6d6449e4f7cfb1c2708,2022-11-03T00:00:00.000Z,NEFT CR-PYTM0123456-PAYTM PAYMENTS SERVI CES LIMITED-SLICK ORGANICS PVT LTD-PYTM2 23071313266,ewallet,,net_banking_transfer,13037.87
63bfb2a32e1a0ebb7f62961b,50200023535069,366754.4,60ec41ba55c00300382672d9,HDFC,Revenue-PG-split enabled,5eecc6d6449e4f7cfb1c2708,2022-11-03T00:00:00.000Z,NEFT CR-UTIB0001506-RAZORPAY SOFTWARE PR IVATE LIMITED-SLICK ORGANICS PVT LITD-AX ISCN0178631553,,,net_banking_transfer,12266.8
63bfb2a32e1a0ebb7f62961d,50200023535069,357754.4,60ec41ba55c00300382672d9,HDFC,direct expenses,5eecc6d6449e4f7cfb1c2708,2022-11-03T00:00:00.000Z,00071610019925-TPT-9000-KHUSHBOO SINGHVI,,,net_banking_transfer,-9000
63bfb2a32e1a0ebb7f62961f,50200023535069,344254.4,60ec41ba55c00300382672d9,HDFC,direct expenses,5eecc6d6449e4f7cfb1c2708,2022-11-03T00:00:00.000Z,50100415834335-TPT-13500-NIHARIKA DO TAR,,,net_banking_transfer,-13500
63bfb2a32e1a0ebb7f629621,50200023535069,328954.4,60ec41ba55c00300382672d9,HDFC,direct expenses,5eecc6d6449e4f7cfb1c2708,2022-11-03T00:00:00.000Z,"NEFT DR-UTIB0004445-BUZZLER DIGITAL-NETB ANK, MUM-N307222189780858-15300",,,net_banking_transfer,-15300
63bfb2a32e1a0ebb7f629623,50200023535069,327184.4,60ec41ba55c00300382672d9,HDFC,Marketing Expense,5eecc6d6449e4f7cfb1c2708,2022-11-03T00:00:00.000Z,ME DC SI 514834XXXXXX9486 LINKEDIN (PGSI ),,,Other,-1770
63bfb2a32e1a0ebb7f629625,50200023535069,326769.4,60ec41ba55c00300382672d9,HDFC,direct expenses,5eecc6d6449e4f7cfb1c2708,2022-11-03T00:00:00.000Z,POS 514834XXXXXX9486 PTM*PAYTM WALLET,ewallet,,debit_card,-415
63bfb2a32e1a0ebb7f629627,50200023535069,325710.4,60ec41ba55c00300382672d9,HDFC,direct expenses,5eecc6d6449e4f7cfb1c2708,2022-11-03T00:00:00.000Z,POS 514834XXXXXX9486 PTM*PAYTM WALLET,ewallet,,debit_card,-1059
63bfb2a32e1a0ebb7f629629,50200023535069,328266.4,60ec41ba55c00300382672d9,HDFC,Revenue-Mktplace,5eecc6d6449e4f7cfb1c2708,2022-11-03T00:00:00.000Z,NEFT CR-ICIC0000104-MANASH LIFESTYLE PRI VATE LIMITED-SLICK ORGANICS PRIVATE LIMI TED-CMS2922607901,shopping,,net_banking_transfer,2556
63bfb2a32e1a0ebb7f62962b,50200023535069,278266.4,60ec41ba55c00300382672d9,HDFC,direct expenses,5eecc6d6449e4f7cfb1c2708,2022-11-03T00:00:00.000Z,"NEFT DR-UTIB0001696-EMIZA SUPPLY CHAIN S ERVICES PRIVATE LIMI-NETBANK, MUM-N30722 2190075717-50000",,,net_banking_transfer,-50000
63bfb2a32e1a0ebb7f62962d,50200023535069,269416.4,60ec41ba55c00300382672d9,HDFC,direct expenses,5eecc6d6449e4f7cfb1c2708,2022-11-03T00:00:00.000Z,"NEFT DR-SBIN0001859-PARSHOTAM AND ASSOCI ATES-NETBANK, MUM-N307222190137561-8850",,,net_banking_transfer,-8850
63bfb2a32e1a0ebb7f62962f,50200023535069,255429.4,60ec41ba55c00300382672d9,HDFC,direct expenses,5eecc6d6449e4f7cfb1c2708,2022-11-03T00:00:00.000Z,"NEFT DR-ICIC0000715-GAJENDRA BAHADUR SIN GH-NETBANK, MUM-N307222190119000-13987",,,net_banking_transfer,-13987
63bfb2a32e1a0ebb7f629631,50200023535069,264719.89,60ec41ba55c00300382672d9,HDFC,Transfer in/Revenue-other,5eecc6d6449e4f7cfb1c2708,2022-11-03T00:00:00.000Z,NEFT CR-UTIB0000114-ONE SIGMA TECHNOLOGI ES PRIVATE LIM-SLICK ORGANICS PRIVATE LI MITED-AXISP00334178598,,,net_banking_transfer,9290.49
63bfb2a32e1a0ebb7f629633,50200023535069,265481.89,60ec41ba55c00300382672d9,HDFC,Revenue-Mktplace,5eecc6d6449e4f7cfb1c2708,2022-11-03T00:00:00.000Z,NEFT CR-SCBL0036001-DREAMPLUG TECHNOLOGI ES PRIVATE LIMITED-SLICK ORGANICS PRIVAT E LIMITEDSLICK-IN1ON22110301DMJ,,,net_banking_transfer,762
63bfb2a32e1a0ebb7f629635,50200023535069,264602.89,60ec41ba55c00300382672d9,HDFC,direct expenses,5eecc6d6449e4f7cfb1c2708,2022-11-03T00:00:00.000Z,POS 514834XXXXXX9486 ADOBE ACROBAT ST,,,debit_card,-879
63bfb2a32e1a0ebb7f629637,50200023535069,262573.89,60ec41ba55c00300382672d9,HDFC,direct expenses,5eecc6d6449e4f7cfb1c2708,2022-11-03T00:00:00.000Z,POS 514834XXXXXX9486 ADOBE CREATIVE C,,,debit_card,-2029
63bfb2a32e1a0ebb7f629639,50200023535069,334837.76,60ec41ba55c00300382672d9,HDFC,Transfer in/Revenue-other,5eecc6d6449e4f7cfb1c2708,2022-11-03T00:00:00.000Z,NEFT CR-YESB0000001-EASEBUZZ PVT LTD NOD AL A/C-SLICK ORGANICS PVT LTD-YESB230797 20959,,,net_banking_transfer,72263.87
63bfb2a32e1a0ebb7f62963b,50200023535069,333374.76,60ec41ba55c00300382672d9,HDFC,direct expenses,5eecc6d6449e4f7cfb1c2708,2022-11-03T00:00:00.000Z,POS 514834XXXXXX9486 SMARTSHIFT LOGIS,,,debit_card,-1463
63bfb2a32e1a0ebb7f62963d,50200023535069,9153374.76,60ec41ba55c00300382672d9,HDFC,Transfer in/Revenue-other,5eecc6d6449e4f7cfb1c2708,2022-11-03T00:00:00.000Z,RTGS CR-IDFB0010204-PCPL CENTRAL DISBURS EMENT AC-SLICK ORGANICS PRIVATE LIMITED- IDFBR52022110300459579,,,net_banking_transfer,8820000
63bfb2a32e1a0ebb7f62963f,50200023535069,9151811.76,60ec41ba55c00300382672d9,HDFC,direct expenses,5eecc6d6449e4f7cfb1c2708,2022-11-03T00:00:00.000Z,POS 514834XXXXXX9486 PAYTM_ADDMONEYTO,ewallet,,debit_card,-1563
63bfb2a32e1a0ebb7f629641,50200023535069,9159160.47,60ec41ba55c00300382672d9,HDFC,Revenue-PG-split enabled,5eecc6d6449e4f7cfb1c2708,2022-11-03T00:00:00.000Z,NEFT CR-UTIB0001506-RAZORPAY SOFTWARE PR IVATE LIMITED-SLICK ORGANICS PVT LITD-AX ISCN0178842478,,,net_banking_transfer,7348.71
63bfb2a42e1a0ebb7f629643,50200023535069,9167752.03,60ec41ba55c00300382672d9,HDFC,Revenue-PG-non-split,5eecc6d6449e4f7cfb1c2708,2022-11-04T00:00:00.000Z,NEFT CR-PYTM0123456-PAYTM PAYMENTS SERVI CES LIMITED-SLICK ORGANICS PVT LTD-PYTM2 23083026178,ewallet,,net_banking_transfer,8591.56
63bfb2a42e1a0ebb7f629645,50200023535069,9188166.27,60ec41ba55c00300382672d9,HDFC,Revenue-Mktplace,5eecc6d6449e4f7cfb1c2708,2022-11-04T00:00:00.000Z,NEFT CR-DEUT0797BGL-FLIPKART INTERNET PR IVATE LIMITED-SLICK ORGANICS PVT LTD-230 800074GN00216,shopping,,net_banking_transfer,20414.24
63bfb2a42e1a0ebb7f629647,50200023535069,8538166.27,60ec41ba55c00300382672d9,HDFC,Tax,5eecc6d6449e4f7cfb1c2708,2022-11-04T00:00:00.000Z,051030804112210480- CBDT TAX,,,Other,-650000
63bfb2a42e1a0ebb7f629649,50200023535069,8418166.27,60ec41ba55c00300382672d9,HDFC,Tax,5eecc6d6449e4f7cfb1c2708,2022-11-04T00:00:00.000Z,051030804112210380- CBDT TAX,,,Other,-120000
63bfb2a42e1a0ebb7f62964b,50200023535069,8422313.97,60ec41ba55c00300382672d9,HDFC,Revenue-Mktplace,5eecc6d6449e4f7cfb1c2708,2022-11-04T00:00:00.000Z,NEFT CR-DEUT0797BGL-MYNTRA DESIGNS PRIVA TE LIMITED-SLICK ORGANICS - SJIT-2308006 79GN00151,shopping,,net_banking_transfer,4147.7
63bfb2a42e1a0ebb7f62964d,50200023535069,8428310.75,60ec41ba55c00300382672d9,HDFC,Revenue-Mktplace,5eecc6d6449e4f7cfb1c2708,2022-11-04T00:00:00.000Z,NEFT CR-DEUT0797BGL-MYNTRA DESIGNS PRIVA TE LIMITED-SLICK ORGANICS - SJIT-2308006 80GN00195,shopping,,net_banking_transfer,5996.78
63bfb2a42e1a0ebb7f62964f,50200023535069,8432517.06,60ec41ba55c00300382672d9,HDFC,Revenue-Mktplace,5eecc6d6449e4f7cfb1c2708,2022-11-04T00:00:00.000Z,NEFT CR-DEUT0797BGL-MYNTRA DESIGNS PRIVA TE LIMITED-SLICK ORGANICS PVT. LTD.-2308 00704GN00249,shopping,,net_banking_transfer,4206.31
63bfb2a42e1a0ebb7f629651,50200023535069,8437153.97,60ec41ba55c00300382672d9,HDFC,Revenue-PG-split enabled,5eecc6d6449e4f7cfb1c2708,2022-11-04T00:00:00.000Z,NEFT CR-UTIB0001506-RAZORPAY SOFTWARE PR IVATE LIMITED-SLICK ORGANICS PVT LITD-AX ISCN0179035331,,,net_banking_transfer,4636.91
63bfb2a42e1a0ebb7f629653,50200023535069,8434653.97,60ec41ba55c00300382672d9,HDFC,direct expenses,5eecc6d6449e4f7cfb1c2708,2022-11-04T00:00:00.000Z,POS 514834XXXXXX9486 PTM*PAYTM WALLET,ewallet,,debit_card,-2500
63bfb2a42e1a0ebb7f629655,50200023535069,8422329.97,60ec41ba55c00300382672d9,HDFC,direct expenses,5eecc6d6449e4f7cfb1c2708,2022-11-04T00:00:00.000Z,"NEFT DR-UTIB0001696-EMIZA SUPPLY CHAIN S ERVICES PRIVATE LIMI-NETBANK, MUM-N30822 2191425905-12324",,,net_banking_transfer,-12324
63bfb2a42e1a0ebb7f629657,50200023535069,8122329.97,60ec41ba55c00300382672d9,HDFC,direct expenses,5eecc6d6449e4f7cfb1c2708,2022-11-04T00:00:00.000Z,"NEFT DR-YESB0000551-VISTTA COSMETICS-NET BANK, MUM-N308222191596079-300000",,,net_banking_transfer,-300000
63bfb2a42e1a0ebb7f629659,50200023535069,8054885.97,60ec41ba55c00300382672d9,HDFC,direct expenses,5eecc6d6449e4f7cfb1c2708,2022-11-04T00:00:00.000Z,"NEFT DR-SBIN0011783-GALACTIC GRIP-NETBAN K, MUM-N308222191597155-67444",,,net_banking_transfer,-67444
63bfb2a42e1a0ebb7f62965b,50200023535069,8004885.97,60ec41ba55c00300382672d9,HDFC,direct expenses,5eecc6d6449e4f7cfb1c2708,2022-11-04T00:00:00.000Z,NEFT DR-ICIC0006643-KRISHNA PACKAGING CO,,,net_banking_transfer,-50000
63bfb2a42e1a0ebb7f62965d,50200023535069,8009094.45,60ec41ba55c00300382672d9,HDFC,Transfer in/Revenue-other,5eecc6d6449e4f7cfb1c2708,2022-11-04T00:00:00.000Z,NEFT CR-UTIB0000114-ONE SIGMA TECHNOLOGI ES PRIVATE LIM-SLICK ORGANICS PRIVATE LI MITED-AXISP00334445785,,,net_banking_transfer,4208.48
63bfb2a42e1a0ebb7f62965f,50200023535069,3009094.45,60ec41ba55c00300382672d9,HDFC,direct expenses,5eecc6d6449e4f7cfb1c2708,2022-11-04T00:00:00.000Z,FD BOOKED - 50300699243918 : SLICK ORGAN ICS PVT LTD,,,investment,-5000000
63bfb2a42e1a0ebb7f629661,50200023535069,3043238.87,60ec41ba55c00300382672d9,HDFC,Transfer in/Revenue-other,5eecc6d6449e4f7cfb1c2708,2022-11-04T00:00:00.000Z,NEFT CR-YESB0000001-EASEBUZZ PVT LTD NOD AL A/C-SLICK ORGANICS PVT LTD-YESB230823 70283,,,net_banking_transfer,34144.42
63bfb2a42e1a0ebb7f629663,50200023535069,3044112.87,60ec41ba55c00300382672d9,HDFC,Transfer in/Revenue-other,5eecc6d6449e4f7cfb1c2708,2022-11-04T00:00:00.000Z,FT- SLICK ORGANICS-50200022102665 - MARG O NETWORKS PRIVATE LIMITED -,,,Other,874
63bfb2a42e1a0ebb7f629665,50200023535069,3048861.01,60ec41ba55c00300382672d9,HDFC,Revenue-PG-split enabled,5eecc6d6449e4f7cfb1c2708,2022-11-04T00:00:00.000Z,NEFT CR-UTIB0001506-RAZORPAY SOFTWARE PR IVATE LIMITED-SLICK ORGANICS PVT LITD-AX ISCN0179327752,,,net_banking_transfer,4748.14
63bfb2a42e1a0ebb7f629667,50200023535069,2548861.01,60ec41ba55c00300382672d9,HDFC,Marketing Expense,5eecc6d6449e4f7cfb1c2708,2022-11-04T00:00:00.000Z,"NEFT DR-CITI0000006-FACEBOOK INDIA ONLIN E SERVICES PVT LTD-NETBANK, MUM-N3082221 92588959-500000",,,net_banking_transfer,-500000
63bfb2a42e1a0ebb7f629669,50200023535069,2556482.46,60ec41ba55c00300382672d9,HDFC,Revenue-COD,5eecc6d6449e4f7cfb1c2708,2022-11-04T00:00:00.000Z,NEFT CR-ICIC0000155-SHIPROCKET COD CRF I D 5135747-SLICK ORGANICS PVT LTD-CMS2926 004418,,,net_banking_transfer,7621.45
63bfb2a42e1a0ebb7f62966b,50200023535069,2561861.61,60ec41ba55c00300382672d9,HDFC,Revenue-PG-non-split,5eecc6d6449e4f7cfb1c2708,2022-11-05T00:00:00.000Z,NEFT CR-PYTM0123456-PAYTM PAYMENTS SERVI CES LIMITED-SLICK ORGANICS PVT LTD-PYTM2 23094771056,ewallet,,net_banking_transfer,5379.15
63bfb2a42e1a0ebb7f62966d,50200023535069,2561035.61,60ec41ba55c00300382672d9,HDFC,Marketing Expense,5eecc6d6449e4f7cfb1c2708,2022-11-05T00:00:00.000Z,ME DC SI 514834XXXXXX9486 FACEBOOK SI,,,Other,-826
63bfb2a42e1a0ebb7f62966f,50200023535069,2564238.74,60ec41ba55c00300382672d9,HDFC,Revenue-PG-split enabled,5eecc6d6449e4f7cfb1c2708,2022-11-05T00:00:00.000Z,NEFT CR-UTIB0001506-RAZORPAY SOFTWARE PR IVATE LIMITED-SLICK ORGANICS PVT LITD-AX ISCN0179481457,,,net_banking_transfer,3203.13
63bfb2a42e1a0ebb7f629671,50200023535069,2560148.74,60ec41ba55c00300382672d9,HDFC,direct expenses,5eecc6d6449e4f7cfb1c2708,2022-11-05T00:00:00.000Z,POS 514834XXXXXX9486 SMARTSHIFT LOGIS,,,debit_card,-4090
63bfb2a42e1a0ebb7f629673,50200023535069,2560403.47,60ec41ba55c00300382672d9,HDFC,Transfer in/Revenue-other,5eecc6d6449e4f7cfb1c2708,2022-11-05T00:00:00.000Z,NEFT CR-KKBK0000958-NODAL ACCOUNT BROKEN,,,net_banking_transfer,254.73
63bfb2a42e1a0ebb7f629675,50200023535069,2560115.47,60ec41ba55c00300382672d9,HDFC,direct expenses,5eecc6d6449e4f7cfb1c2708,2022-11-05T00:00:00.000Z,POS 514834XXXXXX9486 PTM*PAYTM WALLET,ewallet,,debit_card,-288
63bfb2a42e1a0ebb7f629677,50200023535069,2581137.48,60ec41ba55c00300382672d9,HDFC,Transfer in/Revenue-other,5eecc6d6449e4f7cfb1c2708,2022-11-05T00:00:00.000Z,NEFT CR-YESB0000001-EASEBUZZ PVT LTD NOD AL A/C-SLICK ORGANICS PVT LTD-YESB230945 89315,,,net_banking_transfer,21022.01
63bfb2a42e1a0ebb7f629679,50200023535069,2592905.72,60ec41ba55c00300382672d9,HDFC,Revenue-PG-split enabled,5eecc6d6449e4f7cfb1c2708,2022-11-05T00:00:00.000Z,NEFT CR-UTIB0001506-RAZORPAY SOFTWARE PR IVATE LIMITED-SLICK ORGANICS PVT LITD-AX ISCN0179664070,,,net_banking_transfer,11768.24
63bfb2a42e1a0ebb7f62967b,50200023535069,2601446.85,60ec41ba55c00300382672d9,HDFC,Revenue-PG-non-split,5eecc6d6449e4f7cfb1c2708,2022-11-06T00:00:00.000Z,NEFT CR-PYTM0123456-PAYTM PAYMENTS SERVI CES LIMITED-SLICK ORGANICS PVT LTD-PYTM2 23106449927,ewallet,,net_banking_transfer,8541.13
63bfb2a42e1a0ebb7f62967d,50200023535069,2538946.85,60ec41ba55c00300382672d9,HDFC,direct expenses,5eecc6d6449e4f7cfb1c2708,2022-11-07T00:00:00.000Z,50100064106714 NET BANKING SI -62500,,,Other,-62500
63bfb2a42e1a0ebb7f62967f,50200023535069,2488946.85,60ec41ba55c00300382672d9,HDFC,direct expenses,5eecc6d6449e4f7cfb1c2708,2022-11-07T00:00:00.000Z,50100108772229 NET BANKING SI -50000,,,Other,-50000
63bfb2a42e1a0ebb7f629681,50200023535069,2415613.85,60ec41ba55c00300382672d9,HDFC,direct expenses,5eecc6d6449e4f7cfb1c2708,2022-11-07T00:00:00.000Z,50100293329616 NET BANKING SI -73333,,,Other,-73333
63bfb2a42e1a0ebb7f629683,50200023535069,2356483.85,60ec41ba55c00300382672d9,HDFC,direct expenses,5eecc6d6449e4f7cfb1c2708,2022-11-07T00:00:00.000Z,50100349886722 NET BANKING SI -59130,,,Other,-59130
63bfb2a42e1a0ebb7f629685,50200023535069,2147043.85,60ec41ba55c00300382672d9,HDFC,direct expenses,5eecc6d6449e4f7cfb1c2708,2022-11-07T00:00:00.000Z,02711930004579 NET BANKING SI -209440,,,Other,-209440
63bfb2a42e1a0ebb7f629687,50200023535069,1973524.85,60ec41ba55c00300382672d9,HDFC,direct expenses,5eecc6d6449e4f7cfb1c2708,2022-11-07T00:00:00.000Z,50100155115510 NET BANKING SI -173519,,,Other,-173519
63bfb2a42e1a0ebb7f629689,50200023535069,1920457.85,60ec41ba55c00300382672d9,HDFC,direct expenses,5eecc6d6449e4f7cfb1c2708,2022-11-07T00:00:00.000Z,50100312215410 NET BANKING SI -53067,,,Other,-53067
63bfb2a42e1a0ebb7f62968b,50200023535069,1759522.85,60ec41ba55c00300382672d9,HDFC,direct expenses,5eecc6d6449e4f7cfb1c2708,2022-11-07T00:00:00.000Z,09291610057185 NET BANKING SI -160935,,,Other,-160935
63bfb2a42e1a0ebb7f62968d,50200023535069,1641732.85,60ec41ba55c00300382672d9,HDFC,direct expenses,5eecc6d6449e4f7cfb1c2708,2022-11-07T00:00:00.000Z,50100093802387 NET BANKING SI -117790,,,Other,-117790
63bfb2a42e1a0ebb7f62968f,50200023535069,1621882.85,60ec41ba55c00300382672d9,HDFC,direct expenses,5eecc6d6449e4f7cfb1c2708,2022-11-07T00:00:00.000Z,02711600008220 NET BANKING SI -19850,,,Other,-19850
63bfb2a42e1a0ebb7f629691,50200023535069,1583866.85,60ec41ba55c00300382672d9,HDFC,direct expenses,5eecc6d6449e4f7cfb1c2708,2022-11-07T00:00:00.000Z,00901610080520 NET BANKING SI -38016,,,Other,-38016
63bfb2a42e1a0ebb7f629693,50200023535069,1480005.85,60ec41ba55c00300382672d9,HDFC,direct expenses,5eecc6d6449e4f7cfb1c2708,2022-11-07T00:00:00.000Z,NEFT DR-ICIC0000021-AKHILESH DIXIT-SANDO Z - MUM-N311222194749789-NET BANKING SI -103861,,,net_banking_transfer,-103861
63bfb2a42e1a0ebb7f629695,50200023535069,1465005.85,60ec41ba55c00300382672d9,HDFC,direct expenses,5eecc6d6449e4f7cfb1c2708,2022-11-07T00:00:00.000Z,NEFT DR-ICIC0003851-JITENDER KUMAR-SANDO Z - MUM-N311222194749790-NET BANKING SI -15000,,,net_banking_transfer,-15000
63bfb2a42e1a0ebb7f629697,50200023535069,1420005.85,60ec41ba55c00300382672d9,HDFC,direct expenses,5eecc6d6449e4f7cfb1c2708,2022-11-07T00:00:00.000Z,NEFT DR-ICIC0000314-ATUL VAISHNAV-SANDOZ - MUM-N311222194749791-NET BANKING SI - 45000,,,net_banking_transfer,-45000
63bfb2a42e1a0ebb7f629699,50200023535069,1389424.85,60ec41ba55c00300382672d9,HDFC,direct expenses,5eecc6d6449e4f7cfb1c2708,2022-11-07T00:00:00.000Z,NEFT DR-SIBL0000555-JAIVEER KUMAR-SANDOZ,,,net_banking_transfer,-30581
63bfb2a42e1a0ebb7f62969b,50200023535069,1364424.85,60ec41ba55c00300382672d9,HDFC,direct expenses,5eecc6d6449e4f7cfb1c2708,2022-11-07T00:00:00.000Z,NEFT DR-BARB0VJGRKA-OM PRASAD PANDEY-SAN DOZ - MUM-N311222194749793-NET BANKING S I -25000,,,net_banking_transfer,-25000
63bfb2a42e1a0ebb7f62969d,50200023535069,1340424.85,60ec41ba55c00300382672d9,HDFC,direct expenses,5eecc6d6449e4f7cfb1c2708,2022-11-07T00:00:00.000Z,NEFT DR-PUNB0482100-RAM BHAVAN YADAV-SAN DOZ - MUM-N311222194749794-NET BANKING S I -24000,,,net_banking_transfer,-24000
63bfb2a42e1a0ebb7f62969f,50200023535069,1263299.85,60ec41ba55c00300382672d9,HDFC,direct expenses,5eecc6d6449e4f7cfb1c2708,2022-11-07T00:00:00.000Z,NEFT DR-SBIN0070392-APARNA MOHANAN KONAT -SANDOZ - MUM-N311222194749795-NET BANKI NG SI -77125,,,net_banking_transfer,-77125
63bfb2a42e1a0ebb7f6296a1,50200023535069,1174899.85,60ec41ba55c00300382672d9,HDFC,direct expenses,5eecc6d6449e4f7cfb1c2708,2022-11-07T00:00:00.000Z,NEFT DR-IOBA0001445-PRIYANKA GOPAL-SANDO Z - MUM-N311222194749796-NET BANKING SI -88400,,,net_banking_transfer,-88400
63bfb2a42e1a0ebb7f6296a3,50200023535069,1108499.85,60ec41ba55c00300382672d9,HDFC,direct expenses,5eecc6d6449e4f7cfb1c2708,2022-11-07T00:00:00.000Z,NEFT DR-UTIB0000120-ADNAN ALI-SANDOZ - M UM-N311222194749797-NET BANKING SI -6640 0,,,net_banking_transfer,-66400
63bfb2a42e1a0ebb7f6296a5,50200023535069,1062099.85,60ec41ba55c00300382672d9,HDFC,direct expenses,5eecc6d6449e4f7cfb1c2708,2022-11-07T00:00:00.000Z,NEFT DR-KKBK0008066-KUSHAGRA SINGH-SANDO Z - MUM-N311222194749798-NET BANKING SI -46400,,,net_banking_transfer,-46400
63bfb2a42e1a0ebb7f6296a7,50200023535069,1027749.85,60ec41ba55c00300382672d9,HDFC,direct expenses,5eecc6d6449e4f7cfb1c2708,2022-11-07T00:00:00.000Z,NEFT DR-SBIN0008079-DHARAMVEER-SANDOZ - MUM-N311222194749799-NET BANKING SI -343 50,,,net_banking_transfer,-34350
63bfb2a42e1a0ebb7f6296aa,50200023535069,998249.85,60ec41ba55c00300382672d9,HDFC,direct expenses,5eecc6d6449e4f7cfb1c2708,2022-11-07T00:00:00.000Z,NEFT DR-KKBK0004632-DOLLY JAIN-SANDOZ - MUM-N311222194749800-NET BANKING SI -295 00,,,net_banking_transfer,-29500
63bfb2a42e1a0ebb7f6296ac,50200023535069,979171.85,60ec41ba55c00300382672d9,HDFC,N-ACH payments,5eecc6d6449e4f7cfb1c2708,2022-11-07T00:00:00.000Z,NEFT DR-DBSS0IN0811-SACHIN SINGH-SANDOZ - MUM-N311222194749801-NET BANKING SI -1 9078,,,net_banking_transfer,-19078
63bfb2a42e1a0ebb7f6296ae,50200023535069,958622.85,60ec41ba55c00300382672d9,HDFC,direct expenses,5eecc6d6449e4f7cfb1c2708,2022-11-07T00:00:00.000Z,NEFT DR-PUNB0307800-SANJEEV NIRMANIA-SAN,,,net_banking_transfer,-20549
63bfb2a42e1a0ebb7f6296b0,50200023535069,937780.85,60ec41ba55c00300382672d9,HDFC,direct expenses,5eecc6d6449e4f7cfb1c2708,2022-11-07T00:00:00.000Z,NEFT DR-KKBK0005032-DEEPAK YADAV-SANDOZ - MUM-N311222194749803-NET BANKING SI -2 0842,,,net_banking_transfer,-20842
63bfb2a42e1a0ebb7f6296b2,50200023535069,917930.85,60ec41ba55c00300382672d9,HDFC,direct expenses,5eecc6d6449e4f7cfb1c2708,2022-11-07T00:00:00.000Z,NEFT DR-PUNB0494300-KUNDAN PRASAD-SANDOZ - MUM-N311222194749804-NET BANKING SI - 19850,,,net_banking_transfer,-19850
63bfb2a42e1a0ebb7f6296b4,50200023535069,899073.85,60ec41ba55c00300382672d9,HDFC,direct expenses,5eecc6d6449e4f7cfb1c2708,2022-11-07T00:00:00.000Z,NEFT DR-PUNB0151400-BHUWAN CHANDER JOSHI -SANDOZ - MUM-N311222194749805-NET BANKI NG SI -18857,,,net_banking_transfer,-18857
63bfb2a42e1a0ebb7f6296b6,50200023535069,679963.85,60ec41ba55c00300382672d9,HDFC,direct expenses,5eecc6d6449e4f7cfb1c2708,2022-11-07T00:00:00.000Z,NEFT DR-SCBL0036025-DHRUV MADHOK-SANDOZ - MUM-N311222194749806-NET BANKING SI -2 19110,,,net_banking_transfer,-219110
63bfb2a42e1a0ebb7f6296ba,50200023535069,485916.85,60ec41ba55c00300382672d9,HDFC,direct expenses,5eecc6d6449e4f7cfb1c2708,2022-11-07T00:00:00.000Z,NEFT DR-KKBK0000261-TANVI TANEJA-SANDOZ - MUM-N311222194749807-NET BANKING SI -1 94047,,,net_banking_transfer,-194047
63bfb2a42e1a0ebb7f6296bc,50200023535069,459756.85,60ec41ba55c00300382672d9,HDFC,direct expenses,5eecc6d6449e4f7cfb1c2708,2022-11-07T00:00:00.000Z,NEFT DR-ICIC0002697-NITISH KUMAR-SANDOZ - MUM-N311222194749808-NET BANKING SI -2 6160,,,net_banking_transfer,-26160
63bfb2a42e1a0ebb7f6296be,50200023535069,396689.85,60ec41ba55c00300382672d9,HDFC,direct expenses,5eecc6d6449e4f7cfb1c2708,2022-11-07T00:00:00.000Z,NEFT DR-PUNB0150400-SAGARIKA DEBNATH-SA NDOZ - MUM-N311222194749809-NET BANKING SI -63067,,,net_banking_transfer,-63067
63bfb2a42e1a0ebb7f6296c0,50200023535069,379428.85,60ec41ba55c00300382672d9,HDFC,direct expenses,5eecc6d6449e4f7cfb1c2708,2022-11-07T00:00:00.000Z,NEFT DR-SBIN0017746-MANOJ KUMAR-SANDOZ - MUM-N311222194749810-NET BANKING SI -17 261,,,net_banking_transfer,-17261
63bfb2a42e1a0ebb7f6296c3,50200023535069,364165.85,60ec41ba55c00300382672d9,HDFC,direct expenses,5eecc6d6449e4f7cfb1c2708,2022-11-07T00:00:00.000Z,NEFT DR-CNRB0019016-MANEESH-SANDOZ - MUM -N311222194749811-NET BANKING SI -15263,,,net_banking_transfer,-15263
63bfb2a52e1a0ebb7f6296c5,50200023535069,348902.85,60ec41ba55c00300382672d9,HDFC,direct expenses,5eecc6d6449e4f7cfb1c2708,2022-11-07T00:00:00.000Z,NEFT DR-SCBL0036023-VIVEK YADAV-SANDOZ - MUM-N311222194749812-NET BANKING SI -15 263,,,net_banking_transfer,-15263
63bfb2a52e1a0ebb7f6296c7,50200023535069,333639.85,60ec41ba55c00300382672d9,HDFC,direct expenses,5eecc6d6449e4f7cfb1c2708,2022-11-07T00:00:00.000Z,NEFT DR-SCBL0036028-SHUBHAM SINGH PANWAR,,,net_banking_transfer,-15263
63bfb2a52e1a0ebb7f6296c9,50200023535069,318376.85,60ec41ba55c00300382672d9,HDFC,direct expenses,5eecc6d6449e4f7cfb1c2708,2022-11-07T00:00:00.000Z,NEFT DR-SBIN0008132-VIKASH KUMAR-SANDOZ - MUM-N311222194749814-NET BANKING SI -1 5263,,,net_banking_transfer,-15263
63bfb2a52e1a0ebb7f6296cb,50200023535069,299519.85,60ec41ba55c00300382672d9,HDFC,direct expenses,5eecc6d6449e4f7cfb1c2708,2022-11-07T00:00:00.000Z,NEFT DR-PUNB0MBGB06-MD ARIF RAZA-SANDOZ - MUM-N311222194749815-NET BANKING SI -1 8857,,,net_banking_transfer,-18857
63bfb2a52e1a0ebb7f6296cd,50200023535069,305058.95,60ec41ba55c00300382672d9,HDFC,Revenue-PG-non-split,5eecc6d6449e4f7cfb1c2708,2022-11-07T00:00:00.000Z,NEFT CR-PYTM0123456-PAYTM PAYMENTS SERVI CES LIMITED-SLICK ORGANICS PVT LTD-PYTM2 23118171267,ewallet,,net_banking_transfer,5539.1
63bfb2a52e1a0ebb7f6296cf,50200023535069,328588.34,60ec41ba55c00300382672d9,HDFC,Revenue-Mktplace,5eecc6d6449e4f7cfb1c2708,2022-11-07T00:00:00.000Z,NEFT CR-DEUT0797BGL-FLIPKART INTERNET PR IVATE LIMITED-SLICK ORGANICS PVT LTD-231 100130GN00282,shopping,,net_banking_transfer,23529.39
63bfb2a52e1a0ebb7f6296d1,50200023535069,341533.9,60ec41ba55c00300382672d9,HDFC,Revenue-PG-split enabled,5eecc6d6449e4f7cfb1c2708,2022-11-07T00:00:00.000Z,NEFT CR-UTIB0001506-RAZORPAY SOFTWARE PR IVATE LIMITED-SLICK ORGANICS PVT LITD-AX ISCN0179911484,,,net_banking_transfer,12945.56
63bfb2a52e1a0ebb7f6296d3,50200023535069,349012.49,60ec41ba55c00300382672d9,HDFC,Revenue-Mktplace,5eecc6d6449e4f7cfb1c2708,2022-11-07T00:00:00.000Z,NEFT CR-DEUT0797BGL-MYNTRA DESIGNS PRIVA TE LIMITED-SLICK ORGANICS PVT. LTD.-2311 00864GN00043,shopping,,net_banking_transfer,7478.59
63bfb2a52e1a0ebb7f6296d5,50200023535069,354940.02,60ec41ba55c00300382672d9,HDFC,Revenue-Mktplace,5eecc6d6449e4f7cfb1c2708,2022-11-07T00:00:00.000Z,NEFT CR-DEUT0797BGL-MYNTRA DESIGNS PRIVA TE LIMITED-SLICK ORGANICS - SJIT-2311008 90GN00191,shopping,,net_banking_transfer,5927.53
63bfb2a52e1a0ebb7f6296d7,50200023535069,361912.42,60ec41ba55c00300382672d9,HDFC,Revenue-Mktplace,5eecc6d6449e4f7cfb1c2708,2022-11-07T00:00:00.000Z,NEFT CR-DEUT0797BGL-MYNTRA DESIGNS PRIVA TE LIMITED-SLICK ORGANICS - SJIT-2311008 88GN00153,shopping,,net_banking_transfer,6972.4
63bfb2a52e1a0ebb7f6296d9,50200023535069,370923.1,60ec41ba55c00300382672d9,HDFC,Transfer in/Revenue-other,5eecc6d6449e4f7cfb1c2708,2022-11-07T00:00:00.000Z,NEFT CR-UTIB0000114-ONE SIGMA TECHNOLOGI ES PRIVATE LIM-SLICK ORGANICS PRIVATE LI MITED-AXISP00335057828,,,net_banking_transfer,9010.68
63bfb2a52e1a0ebb7f6296db,50200023535069,373806.42,60ec41ba55c00300382672d9,HDFC,Transfer in/Revenue-other,5eecc6d6449e4f7cfb1c2708,2022-11-07T00:00:00.000Z,NEFT CR-UTIB0000114-ONE SIGMA TECHNOLOGI ES PRIVATE LIM-SLICK ORGANICS PRIVATE LI MITED-AXISP00335057656,,,net_banking_transfer,2883.32
63bfb2a52e1a0ebb7f6296dd,50200023535069,380378.83,60ec41ba55c00300382672d9,HDFC,Transfer in/Revenue-other,5eecc6d6449e4f7cfb1c2708,2022-11-07T00:00:00.000Z,NEFT CR-UTIB0000114-ONE SIGMA TECHNOLOGI,,,net_banking_transfer,6572.41
63bfb2a52e1a0ebb7f6296e1,50200023535069,383668.96,60ec41ba55c00300382672d9,HDFC,Revenue-PG-non-split,5eecc6d6449e4f7cfb1c2708,2022-11-07T00:00:00.000Z,NEFT CR-SCBL0036001-STRIPE INDIA PRIVATE LIMITED-SLICK ORGANICS PRIVATE LIMITED- IN1ON221107090NA,,,net_banking_transfer,3290.13
63bfb2a52e1a0ebb7f6296e3,50200023535069,367404.96,60ec41ba55c00300382672d9,HDFC,direct expenses,5eecc6d6449e4f7cfb1c2708,2022-11-07T00:00:00.000Z,50100482015380-TPT-16264-AANCHAL JUNEJA,,,net_banking_transfer,-16264
63bfb2a52e1a0ebb7f6296e6,50200023535069,457454.5,60ec41ba55c00300382672d9,HDFC,Transfer in/Revenue-other,5eecc6d6449e4f7cfb1c2708,2022-11-07T00:00:00.000Z,NEFT CR-YESB0000001-EASEBUZZ PVT LTD NOD AL A/C-SLICK ORGANICS PVT LTD-YESB231187 30715,,,net_banking_transfer,90049.54
63bfb2a52e1a0ebb7f6296e8,50200023535069,394434.5,60ec41ba55c00300382672d9,HDFC,direct expenses,5eecc6d6449e4f7cfb1c2708,2022-11-07T00:00:00.000Z,"NEFT DR-KKBK0000261-AAYUSHI PAREEK-NETBA NK, MUM-N311222196345153-63020",,,net_banking_transfer,-63020
63bfb2a52e1a0ebb7f6296ea,50200023535069,362015.5,60ec41ba55c00300382672d9,HDFC,direct expenses,5eecc6d6449e4f7cfb1c2708,2022-11-07T00:00:00.000Z,"NEFT DR-UTIB0001720-ANUBHAV RAO-NETBANK, MUM-N311222196358561-32419",,,net_banking_transfer,-32419
63bfb2a52e1a0ebb7f6296ec,50200023535069,362429.94,60ec41ba55c00300382672d9,HDFC,Revenue-PG-non-split,5eecc6d6449e4f7cfb1c2708,2022-11-07T00:00:00.000Z,NEFT CR-KKBK0000958-NODAL ACCOUNT BROKEN TUSK TECHNOL-SLICK ORGANICS PRIVATE LIMI TED-CMS3112231735444,,,net_banking_transfer,414.44
63bfb2a52e1a0ebb7f6296ee,50200023535069,369270.26,60ec41ba55c00300382672d9,HDFC,Revenue-PG-split enabled,5eecc6d6449e4f7cfb1c2708,2022-11-07T00:00:00.000Z,NEFT CR-UTIB0001506-RAZORPAY SOFTWARE PR IVATE LIMITED-SLICK ORGANICS PVT LITD-AX ISCN0180114139,,,net_banking_transfer,6840.32
63bfb2a52e1a0ebb7f6296f0,50200023535069,467504.78,60ec41ba55c00300382672d9,HDFC,Revenue-COD,5eecc6d6449e4f7cfb1c2708,2022-11-07T00:00:00.000Z,NEFT CR-ICIC0000155-SHIPROCKET COD CRF I D 5144044-SLICK ORGANICS PVT LTD-CMS2930 295588,,,net_banking_transfer,98234.52
63bfb2a52e1a0ebb7f6296f2,50200023535069,413504.78,60ec41ba55c00300382672d9,HDFC,direct expenses,5eecc6d6449e4f7cfb1c2708,2022-11-07T00:00:00.000Z,"NEFT DR-INDB0000275-LASH TECHNOLOGIES PR IVATE LIMITED-NETBANK, MUM-N311222196889 182-54000",,,net_banking_transfer,-54000
63bfb2a52e1a0ebb7f6296f4,50200023535069,436991.73,60ec41ba55c00300382672d9,HDFC,Revenue-PG-non-split,5eecc6d6449e4f7cfb1c2708,2022-11-08T00:00:00.000Z,NEFT CR-PYTM0123456-PAYTM PAYMENTS SERVI CES LIMITED-SLICK ORGANICS PVT LTD-PYTM2 23129919289,ewallet,,net_banking_transfer,23486.95
63bfb2a52e1a0ebb7f6296f6,50200023535069,748963.86,60ec41ba55c00300382672d9,HDFC,Revenue-Mktplace,5eecc6d6449e4f7cfb1c2708,2022-11-08T00:00:00.000Z,IMPS-231205170715-AMAZON SELLER SERVIC-H SBC-XXXXXXXX6004-22RGWS6IYRWA6T1BSLICK O RGANICS PVT LTD,shopping,,net_banking_transfer,311972.13
63bfb2a52e1a0ebb7f6296f8,50200023535069,1576295.04,60ec41ba55c00300382672d9,HDFC,Revenue-Mktplace,5eecc6d6449e4f7cfb1c2708,2022-11-08T00:00:00.000Z,NEFT CR-DEUT0797BGL-AMAZON PAY (INDIA) P,shopping,,net_banking_transfer,827331.18
63bfb2a52e1a0ebb7f6296fa,50200023535069,1566795.04,60ec41ba55c00300382672d9,HDFC,direct expenses,5eecc6d6449e4f7cfb1c2708,2022-11-08T00:00:00.000Z,"NEFT DR-UTIB0000131-MONIKA TANEJA-NETBAN K, MUM-N312222197342901-9500",,,net_banking_transfer,-9500
63bfb2a52e1a0ebb7f6296fc,50200023535069,1552168.04,60ec41ba55c00300382672d9,HDFC,direct expenses,5eecc6d6449e4f7cfb1c2708,2022-11-08T00:00:00.000Z,"NEFT DR-SBIN0008078-PANDIT PLASTICS-NETB ANK, MUM-N312222197397280-14627",,,net_banking_transfer,-14627
63bfb2a52e1a0ebb7f6296fe,50200023535069,1460368.04,60ec41ba55c00300382672d9,HDFC,direct expenses,5eecc6d6449e4f7cfb1c2708,2022-11-08T00:00:00.000Z,50200063349422-TPT-91800-COHORT E-COMMER CE CONSULTING LLP,,,net_banking_transfer,-91800
63bfb2a52e1a0ebb7f629700,50200023535069,1421105.04,60ec41ba55c00300382672d9,HDFC,direct expenses,5eecc6d6449e4f7cfb1c2708,2022-11-08T00:00:00.000Z,"NEFT DR-KKBK0000187-APPLIED LIFE PRIVATE LIMITED-NETBANK, MUM-N312222197384644-3 9263",,,net_banking_transfer,-39263
63bfb2a52e1a0ebb7f629702,50200023535069,1264505.04,60ec41ba55c00300382672d9,HDFC,direct expenses,5eecc6d6449e4f7cfb1c2708,2022-11-08T00:00:00.000Z,"NEFT DR-KKBK0005289-HILL GROOVE CONSULTI NG LLP-NETBANK, MUM-N312222197410941-156 600",,,net_banking_transfer,-156600
63bfb2a52e1a0ebb7f629704,50200023535069,1048505.04,60ec41ba55c00300382672d9,HDFC,direct expenses,5eecc6d6449e4f7cfb1c2708,2022-11-08T00:00:00.000Z,"NEFT DR-BARB0VJMATU-ARTISTO DESIGNZ-NETB ANK, MUM-N312222197416685-216000",,,net_banking_transfer,-216000
63bfb2a52e1a0ebb7f629706,50200023535069,939327.04,60ec41ba55c00300382672d9,HDFC,direct expenses,5eecc6d6449e4f7cfb1c2708,2022-11-08T00:00:00.000Z,00921000075586-TPT-109178-ROET BINDRA,,,net_banking_transfer,-109178
63bfb2a52e1a0ebb7f629708,50200023535069,771441.04,60ec41ba55c00300382672d9,HDFC,direct expenses,5eecc6d6449e4f7cfb1c2708,2022-11-08T00:00:00.000Z,"NEFT DR-DBSS0IN0811-SARANSH KULKARNI-NET BANK, MUM-N312222197422738-167886",,,net_banking_transfer,-167886
63bfb2a52e1a0ebb7f62970a,50200023535069,771267.04,60ec41ba55c00300382672d9,HDFC,direct expenses,5eecc6d6449e4f7cfb1c2708,2022-11-08T00:00:00.000Z,POS 514834XXXXXX9486 PTM*PAYTM WALLET,ewallet,,debit_card,-174
63bfb2a52e1a0ebb7f62970c,50200023535069,751267.04,60ec41ba55c00300382672d9,HDFC,direct expenses,5eecc6d6449e4f7cfb1c2708,2022-11-08T00:00:00.000Z,"NEFT DR-KKBK0000180-VIMAL PLASTICS-NETBA NK, MUM-N312222197552730-20000",,,net_banking_transfer,-20000
63bfb2a52e1a0ebb7f62970e,50200023535069,589267.04,60ec41ba55c00300382672d9,HDFC,direct expenses,5eecc6d6449e4f7cfb1c2708,2022-11-08T00:00:00.000Z,50200054531492-TPT-162000-ALETA PEOPLE S ERVICES,,,net_banking_transfer,-162000
63bfb2a52e1a0ebb7f629710,50200023535069,589266.04,60ec41ba55c00300382672d9,HDFC,direct expenses,5eecc6d6449e4f7cfb1c2708,2022-11-08T00:00:00.000Z,ME DC SI 514834XXXXXX9486 SHOPIFY LTD,,,Other,-1
63bfb2a52e1a0ebb7f629713,50200023535069,540666.04,60ec41ba55c00300382672d9,HDFC,direct expenses,5eecc6d6449e4f7cfb1c2708,2022-11-08T00:00:00.000Z,"NEFT DR-CNRB0015170-SNEHAL TAYDE-NETBANK , MUM-N312222197674696-48600",,,net_banking_transfer,-48600
63bfb2a52e1a0ebb7f629715,50200023535069,539642.04,60ec41ba55c00300382672d9,HDFC,direct expenses,5eecc6d6449e4f7cfb1c2708,2022-11-08T00:00:00.000Z,POS 514834XXXXXX9486 SMARTSHIFT LOGIS,,,debit_card,-1024
63bfb2a52e1a0ebb7f629717,50200023535069,546473.43,60ec41ba55c00300382672d9,HDFC,Transfer in/Revenue-other,5eecc6d6449e4f7cfb1c2708,2022-11-08T00:00:00.000Z,NEFT CR-UTIB0000114-ONE SIGMA TECHNOLOGI ES PRIVATE LIM-SLICK ORGANICS PRIVATE LI MITED-AXISP00335579583,,,net_banking_transfer,6831.39
63bfb2a52e1a0ebb7f629719,50200023535069,551563.43,60ec41ba55c00300382672d9,HDFC,Transfer in/Revenue-other,5eecc6d6449e4f7cfb1c2708,2022-11-08T00:00:00.000Z,NEFT CR-HSBC0110002-NAPSA PRIVATE LIMITE,,,net_banking_transfer,5090
63bfb2a52e1a0ebb7f62971b,50200023535069,450517.43,60ec41ba55c00300382672d9,HDFC,direct expenses,5eecc6d6449e4f7cfb1c2708,2022-11-09T00:00:00.000Z,NEFT DR-KKBK0004581-MJ GLOBAL PVT LTD-SA NDOZ - MUM-N313222198259085-NET BANKING SI -101046,,,net_banking_transfer,-101046
63bfb2a52e1a0ebb7f62971d,50200023535069,465255.9,60ec41ba55c00300382672d9,HDFC,Revenue-PG-non-split,5eecc6d6449e4f7cfb1c2708,2022-11-09T00:00:00.000Z,NEFT CR-PYTM0123456-PAYTM PAYMENTS SERVI CES LIMITED-SLICK ORGANICS PVT LTD-PYTM2 23131670951,ewallet,,net_banking_transfer,14738.47
63bfb2a52e1a0ebb7f62971f,50200023535069,505930.4,60ec41ba55c00300382672d9,HDFC,Revenue-Mktplace,5eecc6d6449e4f7cfb1c2708,2022-11-09T00:00:00.000Z,NEFT CR-DEUT0797BGL-FLIPKART INTERNET PR IVATE LIMITED-SLICK ORGANICS PVT LTD-231 300145GN00116,shopping,,net_banking_transfer,40674.5
63bfb2a52e1a0ebb7f629721,50200023535069,504750.4,60ec41ba55c00300382672d9,HDFC,Marketing Expense,5eecc6d6449e4f7cfb1c2708,2022-11-09T00:00:00.000Z,ME DC SI 514834XXXXXX9486 FACEBOOK SI,,,Other,-1180
63bfb2a52e1a0ebb7f629723,50200023535069,501643.4,60ec41ba55c00300382672d9,HDFC,direct expenses,5eecc6d6449e4f7cfb1c2708,2022-11-09T00:00:00.000Z,POS 514834XXXXXX9486 SMARTSHIFT LOGIS,,,debit_card,-3107
63bfb2a52e1a0ebb7f629725,50200023535069,504747.36,60ec41ba55c00300382672d9,HDFC,Revenue-Mktplace,5eecc6d6449e4f7cfb1c2708,2022-11-09T00:00:00.000Z,NEFT CR-DEUT0797BGL-MYNTRA DESIGNS PRIVA TE LIMITED-SLICK ORGANICS - SJIT-2313007 66GN00143,shopping,,net_banking_transfer,3103.96
63bfb2a52e1a0ebb7f629727,50200023535069,512950.11,60ec41ba55c00300382672d9,HDFC,Revenue-Mktplace,5eecc6d6449e4f7cfb1c2708,2022-11-09T00:00:00.000Z,NEFT CR-DEUT0797BGL-MYNTRA DESIGNS PRIVA TE LIMITED-SLICK ORGANICS - SJIT-2313007 67GN00165,shopping,,net_banking_transfer,8202.75
63bfb2a52e1a0ebb7f629729,50200023535069,514519.66,60ec41ba55c00300382672d9,HDFC,Revenue-Mktplace,5eecc6d6449e4f7cfb1c2708,2022-11-09T00:00:00.000Z,NEFT CR-DEUT0797BGL-MYNTRA DESIGNS PRIVA TE LIMITED-SLICK ORGANICS PVT. LTD.-2313 00795GN00026,shopping,,net_banking_transfer,1569.55
63bfb2a52e1a0ebb7f62972b,50200023535069,587447.42,60ec41ba55c00300382672d9,HDFC,Revenue-PG-split enabled,5eecc6d6449e4f7cfb1c2708,2022-11-09T00:00:00.000Z,NEFT CR-UTIB0001506-RAZORPAY SOFTWARE PR IVATE LIMITED-SLICK ORGANICS PVT LITD-AX ISCN0180477453,,,net_banking_transfer,72927.76
63bfb2a52e1a0ebb7f62972d,50200023535069,566231.42,60ec41ba55c00300382672d9,HDFC,agency/vendor expense,5eecc6d6449e4f7cfb1c2708,2022-11-09T00:00:00.000Z,"NEFT DR-UTIB0003557-INCOSEC LEGAL-NETBAN K, MUM-N313222198475697-21216",,,net_banking_transfer,-21216
63bfb2a52e1a0ebb7f62972f,50200023535069,416231.42,60ec41ba55c00300382672d9,HDFC,direct expenses,5eecc6d6449e4f7cfb1c2708,2022-11-09T00:00:00.000Z,"NEFT DR-YESB0000551-VISTTA COSMETICS-NET BANK, MUM-N313222198519009-150000",,,net_banking_transfer,-150000
63bfb2a52e1a0ebb7f629731,50200023535069,351431.42,60ec41ba55c00300382672d9,HDFC,direct expenses,5eecc6d6449e4f7cfb1c2708,2022-11-09T00:00:00.000Z,50200039330521-TPT-64800-ELITE PUBLICIST,,,net_banking_transfer,-64800
63bfb2a52e1a0ebb7f629733,50200023535069,346431.42,60ec41ba55c00300382672d9,HDFC,direct expenses,5eecc6d6449e4f7cfb1c2708,2022-11-09T00:00:00.000Z,NEFT DR-BARB0VJNAZA-HEENA P TALREJA-NETB,,,net_banking_transfer,-5000
63bfb2a52e1a0ebb7f629735,50200023535069,337431.42,60ec41ba55c00300382672d9,HDFC,direct expenses,5eecc6d6449e4f7cfb1c2708,2022-11-09T00:00:00.000Z,00291000013955-TPT-9000-ALEENA MACKAR,,,net_banking_transfer,-9000
63bfb2a52e1a0ebb7f629737,50200023535069,332431.42,60ec41ba55c00300382672d9,HDFC,direct expenses,5eecc6d6449e4f7cfb1c2708,2022-11-09T00:00:00.000Z,"NEFT DR-SBIN0000489-SONALI MHATRE-NETBAN K, MUM-N313222198612076-5000",,,net_banking_transfer,-5000
63bfb2a52e1a0ebb7f62973a,50200023535069,324931.42,60ec41ba55c00300382672d9,HDFC,direct expenses,5eecc6d6449e4f7cfb1c2708,2022-11-09T00:00:00.000Z,15871050016759-TPT-7500-SIVAKAMI R,,,net_banking_transfer,-7500
63bfb2a52e1a0ebb7f62973c,50200023535069,274931.42,60ec41ba55c00300382672d9,HDFC,direct expenses,5eecc6d6449e4f7cfb1c2708,2022-11-09T00:00:00.000Z,"NEFT DR-ICIC0006643-KRISHNA PACKAGING CO MPANY-NETBANK, MUM-N313222198755388-5000 0",,,net_banking_transfer,-50000
63bfb2a52e1a0ebb7f62973e,50200023535069,224931.42,60ec41ba55c00300382672d9,HDFC,direct expenses,5eecc6d6449e4f7cfb1c2708,2022-11-09T00:00:00.000Z,"NEFT DR-BKID0007124-MATRIX PRINTING SOLU TIONS PVT LTD-NETBANK, MUM-N313222198766 711-50000",,,net_banking_transfer,-50000
63bfb2a52e1a0ebb7f629740,50200023535069,208431.42,60ec41ba55c00300382672d9,HDFC,direct expenses,5eecc6d6449e4f7cfb1c2708,2022-11-09T00:00:00.000Z,50100155187569-TPT-16500-KHADIJA NASRAT ISLAM,,,net_banking_transfer,-16500
63bfb2a52e1a0ebb7f629742,50200023535069,158431.42,60ec41ba55c00300382672d9,HDFC,direct expenses,5eecc6d6449e4f7cfb1c2708,2022-11-09T00:00:00.000Z,02712120000086-TPT-50000-SPOTON LOGISTIC S PVT LTD,,,net_banking_transfer,-50000
63bfb2a52e1a0ebb7f629744,50200023535069,157838.8,60ec41ba55c00300382672d9,HDFC,bank charges,5eecc6d6449e4f7cfb1c2708,2022-11-09T00:00:00.000Z,.DC INTL POS TXN MARKUP+ST 271022 291022 -CDT2230512020599,,,international_transaction_arbitrage,-592.62
63bfb2a62e1a0ebb7f629746,50200023535069,161346.32,60ec41ba55c00300382672d9,HDFC,Revenue-PG-non-split,5eecc6d6449e4f7cfb1c2708,2022-11-09T00:00:00.000Z,NEFT CR-SCBL0036001-STRIPE INDIA PRIVATE LIMITED-SLICK ORGANICS PRIVATE LIMITED- IN1ON22110906AZF,,,net_banking_transfer,3507.52
63bfb2a62e1a0ebb7f629748,50200023535069,166434.48,60ec41ba55c00300382672d9,HDFC,Revenue-PG-non-split,5eecc6d6449e4f7cfb1c2708,2022-11-09T00:00:00.000Z,NEFT CR-KKBK0000958-NODAL ACCOUNT BROKEN TUSK TECHNOL-SLICK ORGANICS PRIVATE LIMI TED-CMS3132232039604,,,net_banking_transfer,5088.16
63bfb2a62e1a0ebb7f62974b,50200023535069,127234.48,60ec41ba55c00300382672d9,HDFC,direct expenses,5eecc6d6449e4f7cfb1c2708,2022-11-09T00:00:00.000Z,"NEFT DR-IDFB0020101-DANISH AHMAD-NETBANK , MUM-N313222198967327-39200",,,net_banking_transfer,-39200
63bfb2a62e1a0ebb7f62974e,50200023535069,169957.27,60ec41ba55c00300382672d9,HDFC,Revenue-Mktplace,5eecc6d6449e4f7cfb1c2708,2022-11-09T00:00:00.000Z,NEFT CR-HSBC0400002-AMAZON SERVICES LLC- SLICK ORGANICS PRIVATE LIMITED-HSBCN2231 3339862,shopping,,net_banking_transfer,42722.79
63bfb2a62e1a0ebb7f629750,50200023535069,295068.26,60ec41ba55c00300382672d9,HDFC,Transfer in/Revenue-other,5eecc6d6449e4f7cfb1c2708,2022-11-09T00:00:00.000Z,NEFT CR-YESB0000001-EASEBUZZ PVT LTD NOD AL A/C-SLICK ORGANICS PVT LTD-YESB231340 80975,,,net_banking_transfer,125110.99
63bfb2a62e1a0ebb7f629754,50200023535069,303600.3,60ec41ba55c00300382672d9,HDFC,Transfer in/Revenue-other,5eecc6d6449e4f7cfb1c2708,2022-11-09T00:00:00.000Z,NEFT CR-UTIB0000114-ONE SIGMA TECHNOLOGI,,,net_banking_transfer,8532.04
63bfb2a62e1a0ebb7f629756,50200023535069,363601.22,60ec41ba55c00300382672d9,HDFC,Revenue-COD,5eecc6d6449e4f7cfb1c2708,2022-11-09T00:00:00.000Z,NEFT CR-ICIC0000155-SHIPROCKET COD CRF I D 5156218-SLICK ORGANICS PVT LTD-CMS2934 232466,,,net_banking_transfer,60000.92
63bfb2a62e1a0ebb7f629759,50200023535069,365352.22,60ec41ba55c00300382672d9,HDFC,Revenue-COD,5eecc6d6449e4f7cfb1c2708,2022-11-09T00:00:00.000Z,PICKRR TECHNOL-AKHILESHDIXIT85GMAIL,,,Other,1751
63bfb2a62e1a0ebb7f62975b,50200023535069,371052.34,60ec41ba55c00300382672d9,HDFC,Revenue-PG-split enabled,5eecc6d6449e4f7cfb1c2708,2022-11-09T00:00:00.000Z,NEFT CR-UTIB0001506-RAZORPAY SOFTWARE PR IVATE LIMITED-SLICK ORGANICS PVT LITD-AX ISCN0180667003,,,net_banking_transfer,5700.12
63bfb2a62e1a0ebb7f62975d,50200023535069,221052.34,60ec41ba55c00300382672d9,HDFC,direct expenses,5eecc6d6449e4f7cfb1c2708,2022-11-09T00:00:00.000Z,"NEFT DR-KKBK0001381-BLC AND ASSOCIATES L LP-NETBANK, MUM-N313222200110228-150000",,,net_banking_transfer,-150000
63bfb2a62e1a0ebb7f62975f,50200023535069,136790.34,60ec41ba55c00300382672d9,HDFC,direct expenses,5eecc6d6449e4f7cfb1c2708,2022-11-10T00:00:00.000Z,NEFT DR-CITI0000002-OMG NETWORK INDIA PR IVATE LIMITED-SANDOZ - MUM-N314222200265 685-NET BANKING SI -84262,,,net_banking_transfer,-84262
63bfb2a62e1a0ebb7f629761,50200023535069,147209.02,60ec41ba55c00300382672d9,HDFC,Revenue-PG-non-split,5eecc6d6449e4f7cfb1c2708,2022-11-10T00:00:00.000Z,NEFT CR-PYTM0123456-PAYTM PAYMENTS SERVI CES LIMITED-SLICK ORGANICS PVT LTD-PYTM2 23143908928,ewallet,,net_banking_transfer,10418.68
63bfb2a62e1a0ebb7f629763,50200023535069,155949.94,60ec41ba55c00300382672d9,HDFC,Revenue-PG-split enabled,5eecc6d6449e4f7cfb1c2708,2022-11-10T00:00:00.000Z,NEFT CR-UTIB0001506-RAZORPAY SOFTWARE PR IVATE LIMITED-SLICK ORGANICS PVT LITD-AX ISCN0180765748,,,net_banking_transfer,8740.92
63bfb2a62e1a0ebb7f629765,50200023535069,-10839.06,60ec41ba55c00300382672d9,HDFC,direct expenses,5eecc6d6449e4f7cfb1c2708,2022-11-10T00:00:00.000Z,"NEFT DR-ICIC0006566-MARKETING MANTRA-NET BANK, MUM-N314222200556055-166789",,,net_banking_transfer,-166789
63bfb2a62e1a0ebb7f629767,50200023535069,-42182.06,60ec41ba55c00300382672d9,HDFC,direct expenses,5eecc6d6449e4f7cfb1c2708,2022-11-10T00:00:00.000Z,"NEFT DR-INDB0000004-GATI KINTETSU EXPRES S PVT LTD-NETBANK, MUM-N314222200653717- 31343",,,net_banking_transfer,-31343
63bfb2a62e1a0ebb7f629769,50200023535069,-26153.56,60ec41ba55c00300382672d9,HDFC,Transfer in/Revenue-other,5eecc6d6449e4f7cfb1c2708,2022-11-10T00:00:00.000Z,NEFT CR-HSBC0560002-INNOVATIVE RETAIL CO NCEPTS PRIVATE-SLICK ORGANICS PVT LTD-HS BCN22314461931,,,net_banking_transfer,16028.5
63bfb2a62e1a0ebb7f62976b,50200023535069,-22323.85,60ec41ba55c00300382672d9,HDFC,Transfer in/Revenue-other,5eecc6d6449e4f7cfb1c2708,2022-11-10T00:00:00.000Z,NEFT CR-UTIB0000114-ONE SIGMA TECHNOLOGI ES PRIVATE LIM-SLICK ORGANICS PRIVATE LI MITED-AXISP00336143128,,,net_banking_transfer,3829.71
63bfb2a62e1a0ebb7f62976d,50200023535069,8686.87,60ec41ba55c00300382672d9,HDFC,Transfer in/Revenue-other,5eecc6d6449e4f7cfb1c2708,2022-11-10T00:00:00.000Z,NEFT CR-KKBK0000958-NODAL ACCOUNT BROKEN,,,net_banking_transfer,31010.72
63bfb2a62e1a0ebb7f62976f,50200023535069,76133.25,60ec41ba55c00300382672d9,HDFC,Transfer in/Revenue-other,5eecc6d6449e4f7cfb1c2708,2022-11-10T00:00:00.000Z,NEFT CR-YESB0000001-EASEBUZZ PVT LTD NOD AL A/C-SLICK ORGANICS PVT LTD-YESB231467 75366,,,net_banking_transfer,67446.38
63bfb2a62e1a0ebb7f629772,50200023535069,79185.22,60ec41ba55c00300382672d9,HDFC,Revenue-PG-split enabled,5eecc6d6449e4f7cfb1c2708,2022-11-10T00:00:00.000Z,NEFT CR-UTIB0001506-RAZORPAY SOFTWARE PR IVATE LIMITED-SLICK ORGANICS PVT LITD-AX ISCN0180926239,,,net_banking_transfer,3051.97
63bfb2a62e1a0ebb7f629774,50200023535069,-52424.78,60ec41ba55c00300382672d9,HDFC,direct expenses,5eecc6d6449e4f7cfb1c2708,2022-11-10T00:00:00.000Z,"NEFT DR-BARB0MOHAMP-MARKETING MANTRA SOL UTIONS-NETBANK, MUM-N314222201754182-131 610",,,net_banking_transfer,-131610
63bfb2a62e1a0ebb7f629776,50200023535069,-41584.78,60ec41ba55c00300382672d9,HDFC,Loan-in,5eecc6d6449e4f7cfb1c2708,2022-11-11T00:00:00.000Z,SWEEP-IN CREDIT - 50300699243918,,,self_transfer,10840
63bfb2a62e1a0ebb7f629778,50200023535069,-10241.78,60ec41ba55c00300382672d9,HDFC,Loan-in,5eecc6d6449e4f7cfb1c2708,2022-11-11T00:00:00.000Z,SWEEP-IN CREDIT - 50300699243918,,,self_transfer,31343
63bfb2a62e1a0ebb7f62977a,50200023535069,0.22,60ec41ba55c00300382672d9,HDFC,Loan-in,5eecc6d6449e4f7cfb1c2708,2022-11-11T00:00:00.000Z,SWEEP-IN CREDIT - 50300699243918,,,self_transfer,10242
63bfb2a62e1a0ebb7f62977c,50200023535069,-97199.78,60ec41ba55c00300382672d9,HDFC,direct expenses,5eecc6d6449e4f7cfb1c2708,2022-11-11T00:00:00.000Z,00321000085687 NET BANKING SI -97200,,,Other,-97200
63bfb2a62e1a0ebb7f62977e,50200023535069,-232199.78,60ec41ba55c00300382672d9,HDFC,direct expenses,5eecc6d6449e4f7cfb1c2708,2022-11-11T00:00:00.000Z,57500000443889 NET BANKING SI -135000,,,Other,-135000
63bfb2a62e1a0ebb7f629780,50200023535069,-221358.83,60ec41ba55c00300382672d9,HDFC,Revenue-PG-non-split,5eecc6d6449e4f7cfb1c2708,2022-11-11T00:00:00.000Z,NEFT CR-PYTM0123456-PAYTM PAYMENTS SERVI CES LIMITED-SLICK ORGANICS PVT LTD-PYTM2 23155389969,ewallet,,net_banking_transfer,10840.95
63bfb2a62e1a0ebb7f629782,50200023535069,-250793.83,60ec41ba55c00300382672d9,HDFC,direct expenses,5eecc6d6449e4f7cfb1c2708,2022-11-11T00:00:00.000Z,01322000013526-TPT-29435-CLASSIC RACKS,,,net_banking_transfer,-29435
63bfb2a62e1a0ebb7f629784,50200023535069,-227195.42,60ec41ba55c00300382672d9,HDFC,Revenue-Mktplace,5eecc6d6449e4f7cfb1c2708,2022-11-11T00:00:00.000Z,NEFT CR-DEUT0797BGL-FLIPKART INTERNET PR IVATE LIMITED-SLICK ORGANICS PVT LTD-231 500423GN00116,shopping,,net_banking_transfer,23598.41
63bfb2a62e1a0ebb7f629786,50200023535069,-225459.48,60ec41ba55c00300382672d9,HDFC,Revenue-Mktplace,5eecc6d6449e4f7cfb1c2708,2022-11-11T00:00:00.000Z,NEFT CR-DEUT0797BGL-MYNTRA DESIGNS PRIVA TE LIMITED-SLICK ORGANICS - SJIT-2315007 08GN00148,shopping,,net_banking_transfer,1735.94
63bfb2a62e1a0ebb7f629788,50200023535069,-216254.86,60ec41ba55c00300382672d9,HDFC,Revenue-Mktplace,5eecc6d6449e4f7cfb1c2708,2022-11-11T00:00:00.000Z,NEFT CR-DEUT0797BGL-MYNTRA DESIGNS PRIVA TE LIMITED-SLICK ORGANICS - SJIT-2315007 09GN00162,shopping,,net_banking_transfer,9204.62
63bfb2a62e1a0ebb7f62978a,50200023535069,-218918.86,60ec41ba55c00300382672d9,HDFC,direct expenses,5eecc6d6449e4f7cfb1c2708,2022-11-11T00:00:00.000Z,POS 514834XXXXXX9486 PAYU*SAVEX TECHN,,,debit_card,-2664
63bfb2a62e1a0ebb7f62978c,50200023535069,-217635.14,60ec41ba55c00300382672d9,HDFC,Revenue-Mktplace,5eecc6d6449e4f7cfb1c2708,2022-11-11T00:00:00.000Z,NEFT CR-DEUT0797BGL-MYNTRA DESIGNS PRIVA,shopping,,net_banking_transfer,1283.72
63bfb2a62e1a0ebb7f62978e,50200023535069,-213013.37,60ec41ba55c00300382672d9,HDFC,Revenue-PG-split enabled,5eecc6d6449e4f7cfb1c2708,2022-11-11T00:00:00.000Z,NEFT CR-UTIB0001506-RAZORPAY SOFTWARE PR IVATE LIMITED-SLICK ORGANICS PVT LITD-AX ISCN0181123966,,,net_banking_transfer,4621.77
63bfb2a62e1a0ebb7f629790,50200023535069,-555119.53,60ec41ba55c00300382672d9,HDFC,direct expenses,5eecc6d6449e4f7cfb1c2708,2022-11-11T00:00:00.000Z,POS 514834XXXXXX9486 E-COMMERCE RP,,,debit_card,-342106.16
63bfb2a62e1a0ebb7f629792,50200023535069,-687078.53,60ec41ba55c00300382672d9,HDFC,direct expenses,5eecc6d6449e4f7cfb1c2708,2022-11-11T00:00:00.000Z,"NEFT DR-KKBK0000218-MONETIZE INFO LLP-NE TBANK, MUM-N315222202757710-131959",,,net_banking_transfer,-131959
63bfb2a62e1a0ebb7f629794,50200023535069,-663998.48,60ec41ba55c00300382672d9,HDFC,Revenue-PG-non-split,5eecc6d6449e4f7cfb1c2708,2022-11-11T00:00:00.000Z,NEFT CR-KKBK0000958-NODAL ACCOUNT BROKEN TUSK TECHNOL-SLICK ORGANICS PRIVATE LIMI TED-CMS3152232353501,,,net_banking_transfer,23080.05
63bfb2a62e1a0ebb7f629796,50200023535069,-663100.34,60ec41ba55c00300382672d9,HDFC,Transfer in/Revenue-other,5eecc6d6449e4f7cfb1c2708,2022-11-11T00:00:00.000Z,NEFT CR-UTIB0000114-ONE SIGMA TECHNOLOGI ES PRIVATE LIM-SLICK ORGANICS PRIVATE LI MITED-AXISP00336638107,,,net_banking_transfer,898.14
63bfb2a62e1a0ebb7f629799,50200023535069,-662078.34,60ec41ba55c00300382672d9,HDFC,Transfer in/Revenue-other,5eecc6d6449e4f7cfb1c2708,2022-11-11T00:00:00.000Z,NEFT CR-SCBL0036001-HEALTH GLOW PRIVATE LIMITED-SLICK ORGANICS PVT LTD-ARATA-IN 1ON221111022CG,,,net_banking_transfer,1022
63bfb2a62e1a0ebb7f62979b,50200023535069,-627038.25,60ec41ba55c00300382672d9,HDFC,Transfer in/Revenue-other,5eecc6d6449e4f7cfb1c2708,2022-11-11T00:00:00.000Z,NEFT CR-YESB0000001-EASEBUZZ PVT LTD NOD AL A/C-SLICK ORGANICS PVT LTD-YESB231592 92519,,,net_banking_transfer,35040.09
63bfb2a62e1a0ebb7f62979f,50200023535069,-628079.25,60ec41ba55c00300382672d9,HDFC,direct expenses,5eecc6d6449e4f7cfb1c2708,2022-11-11T00:00:00.000Z,POS 514834XXXXXX9486 PTM*PAYTM WALLET,ewallet,,debit_card,-1041
63bfb2a62e1a0ebb7f6297a1,50200023535069,-559073.33,60ec41ba55c00300382672d9,HDFC,Revenue-COD,5eecc6d6449e4f7cfb1c2708,2022-11-11T00:00:00.000Z,NEFT CR-ICIC0000155-SHIPROCKET COD CRF I D 5168546-SLICK ORGANICS PVT LTD-CMS2939 511029,,,net_banking_transfer,69005.92
63bfb2a62e1a0ebb7f6297a4,50200023535069,-559036.33,60ec41ba55c00300382672d9,HDFC,Transfer in/Revenue-other,5eecc6d6449e4f7cfb1c2708,2022-11-12T00:00:00.000Z,INT. ON SWCR ON-50300699243918,,,Other,37
63bfb2a62e1a0ebb7f6297a6,50200023535069,-461836.33,60ec41ba55c00300382672d9,HDFC,Loan-in,5eecc6d6449e4f7cfb1c2708,2022-11-12T00:00:00.000Z,SWEEP-IN CREDIT - 50300699243918,,,self_transfer,97200
63bfb2a62e1a0ebb7f6297a8,50200023535069,-461784.33,60ec41ba55c00300382672d9,HDFC,Transfer in/Revenue-other,5eecc6d6449e4f7cfb1c2708,2022-11-12T00:00:00.000Z,INT. ON SWCR ON-50300699243918,,,Other,52
63bfb2a62e1a0ebb7f6297aa,50200023535069,-326784.33,60ec41ba55c00300382672d9,HDFC,Loan-in,5eecc6d6449e4f7cfb1c2708,2022-11-12T00:00:00.000Z,SWEEP-IN CREDIT - 50300699243918,,,self_transfer,135000
63bfb2a62e1a0ebb7f6297ac,50200023535069,-326667.33,60ec41ba55c00300382672d9,HDFC,Transfer in/Revenue-other,5eecc6d6449e4f7cfb1c2708,2022-11-12T00:00:00.000Z,INT. ON SWCR ON-50300699243918,,,Other,117
63bfb2a62e1a0ebb7f6297ae,50200023535069,-22341.33,60ec41ba55c00300382672d9,HDFC,Loan-in,5eecc6d6449e4f7cfb1c2708,2022-11-12T00:00:00.000Z,SWEEP-IN CREDIT - 50300699243918,,,self_transfer,304326
63bfb2a62e1a0ebb7f6297b0,50200023535069,-22334.33,60ec41ba55c00300382672d9,HDFC,Transfer in/Revenue-other,5eecc6d6449e4f7cfb1c2708,2022-11-12T00:00:00.000Z,INT. ON SWCR ON-50300699243918,,,Other,7
63bfb2a62e1a0ebb7f6297b2,50200023535069,-3739.33,60ec41ba55c00300382672d9,HDFC,Loan-in,5eecc6d6449e4f7cfb1c2708,2022-11-12T00:00:00.000Z,SWEEP-IN CREDIT - 50300699243918,,,self_transfer,18595
63bfb2a62e1a0ebb7f6297b5,50200023535069,-3738.33,60ec41ba55c00300382672d9,HDFC,Transfer in/Revenue-other,5eecc6d6449e4f7cfb1c2708,2022-11-12T00:00:00.000Z,INT. ON SWCR ON-50300699243918,,,Other,1
63bfb2a62e1a0ebb7f6297b7,50200023535069,1.67,60ec41ba55c00300382672d9,HDFC,Loan-in,5eecc6d6449e4f7cfb1c2708,2022-11-12T00:00:00.000Z,SWEEP-IN CREDIT - 50300699243918,,,self_transfer,3740
63bfb2a62e1a0ebb7f6297b9,50200023535069,-95204.33,60ec41ba55c00300382672d9,HDFC,direct expenses,5eecc6d6449e4f7cfb1c2708,2022-11-12T00:00:00.000Z,NEFT DR-PUNB0062910-YADAVPACKAGING-SANDO Z - MUM-N316222203939434-NET BANKING SI -95206,,,net_banking_transfer,-95206
63bfb2a62e1a0ebb7f6297bb,50200023535069,-83113.24,60ec41ba55c00300382672d9,HDFC,Revenue-PG-non-split,5eecc6d6449e4f7cfb1c2708,2022-11-12T00:00:00.000Z,NEFT CR-PYTM0123456-PAYTM PAYMENTS SERVI CES LIMITED-SLICK ORGANICS PVT LTD-PYTM2 23168399258,ewallet,,net_banking_transfer,12091.09
63bfb2a62e1a0ebb7f6297bd,50200023535069,-85142.24,60ec41ba55c00300382672d9,HDFC,direct expenses,5eecc6d6449e4f7cfb1c2708,2022-11-12T00:00:00.000Z,POS 514834XXXXXX9486 ADOBE CREATIVE C,,,debit_card,-2029
63bfb2a62e1a0ebb7f6297c0,50200023535069,-89089.34,60ec41ba55c00300382672d9,HDFC,direct expenses,5eecc6d6449e4f7cfb1c2708,2022-11-12T00:00:00.000Z,POS 514834XXXXXX9486 WWW.FAQPRIME.COM,,,debit_card,-3947.1
63bfb2a62e1a0ebb7f6297c2,50200023535069,-89088.34,60ec41ba55c00300382672d9,HDFC,Transfer in/Revenue-other,5eecc6d6449e4f7cfb1c2708,2022-11-12T00:00:00.000Z,CRV POS 514834******9486 SHOPIFY LTD,,,refund,1
63bfb2a62e1a0ebb7f6297c4,50200023535069,-89049.34,60ec41ba55c00300382672d9,HDFC,Transfer in/Revenue-other,5eecc6d6449e4f7cfb1c2708,2022-11-13T00:00:00.000Z,INT. ON SWCR ON-50300699243918,,,Other,39
63bfb2a62e1a0ebb7f6297c6,50200023535069,39.66,60ec41ba55c00300382672d9,HDFC,Loan-in,5eecc6d6449e4f7cfb1c2708,2022-11-13T00:00:00.000Z,SWEEP-IN CREDIT - 50300699243918,,,self_transfer,89089
63bfb2a62e1a0ebb7f6297c8,50200023535069,12589.49,60ec41ba55c00300382672d9,HDFC,Revenue-PG-non-split,5eecc6d6449e4f7cfb1c2708,2022-11-13T00:00:00.000Z,NEFT CR-PYTM0123456-PAYTM PAYMENTS SERVI CES LIMITED-SLICK ORGANICS PVT LTD-PYTM2 23178907034,ewallet,,net_banking_transfer,12549.83
63bfb2a72e1a0ebb7f6297ca,50200023535069,-116591.51,60ec41ba55c00300382672d9,HDFC,Salary/Emp/consultant Expense,5eecc6d6449e4f7cfb1c2708,2022-11-13T00:00:00.000Z,1948109112/EPFO,,,Other,-129181
63bfb2a72e1a0ebb7f6297cc,50200023535069,-116534.51,60ec41ba55c00300382672d9,HDFC,Transfer in/Revenue-other,5eecc6d6449e4f7cfb1c2708,2022-11-14T00:00:00.000Z,INT. ON SWCR ON-50300699243918,,,Other,57
63bfb2a72e1a0ebb7f6297ce,50200023535069,57.49,60ec41ba55c00300382672d9,HDFC,Loan-in,5eecc6d6449e4f7cfb1c2708,2022-11-14T00:00:00.000Z,SWEEP-IN CREDIT - 50300699243918,,,self_transfer,116592
63bfb2a72e1a0ebb7f6297d0,50200023535069,-33873.51,60ec41ba55c00300382672d9,HDFC,direct expenses,5eecc6d6449e4f7cfb1c2708,2022-11-14T00:00:00.000Z,50100362612187 NET BANKING SI -33931,,,Other,-33931
63bfb2a72e1a0ebb7f6297d2,50200023535069,-135123.51,60ec41ba55c00300382672d9,HDFC,direct expenses,5eecc6d6449e4f7cfb1c2708,2022-11-14T00:00:00.000Z,50100370748619 NET BANKING SI -101250,,,Other,-101250
63bfb2a72e1a0ebb7f6297d4,50200023535069,-107220.33,60ec41ba55c00300382672d9,HDFC,Revenue-Mktplace,5eecc6d6449e4f7cfb1c2708,2022-11-14T00:00:00.000Z,NEFT CR-DEUT0797BGL-FLIPKART INTERNET PR IVATE LIMITED-SLICK ORGANICS PVT LTD-231 800153GN00109,shopping,,net_banking_transfer,27903.18
63bfb2a72e1a0ebb7f6297d6,50200023535069,-97367.52,60ec41ba55c00300382672d9,HDFC,Revenue-PG-non-split,5eecc6d6449e4f7cfb1c2708,2022-11-14T00:00:00.000Z,NEFT CR-PYTM0123456-PAYTM PAYMENTS SERVI CES LIMITED-SLICK ORGANICS PVT LTD-PYTM2 23180904996,ewallet,,net_banking_transfer,9852.81
63bfb2a72e1a0ebb7f6297d8,50200023535069,-597367.52,60ec41ba55c00300382672d9,HDFC,direct expenses,5eecc6d6449e4f7cfb1c2708,2022-11-14T00:00:00.000Z,POS 514834XXXXXX9486 E-COMMERCE RP,,,debit_card,-500000
63bfb2a72e1a0ebb7f6297da,50200023535069,-589550.93,60ec41ba55c00300382672d9,HDFC,Revenue-Mktplace,5eecc6d6449e4f7cfb1c2708,2022-11-14T00:00:00.000Z,NEFT CR-DEUT0797BGL-MYNTRA DESIGNS PRIVA TE LIMITED-SLICK ORGANICS - SJIT-2318007 80GN00186,shopping,,net_banking_transfer,7816.59
63bfb2a72e1a0ebb7f6297dd,50200023535069,-585643.74,60ec41ba55c00300382672d9,HDFC,Revenue-Mktplace,5eecc6d6449e4f7cfb1c2708,2022-11-14T00:00:00.000Z,NEFT CR-DEUT0797BGL-MYNTRA DESIGNS PRIVA,shopping,,net_banking_transfer,3907.19
63bfb2a72e1a0ebb7f6297df,50200023535069,-579949.37,60ec41ba55c00300382672d9,HDFC,Revenue-Mktplace,5eecc6d6449e4f7cfb1c2708,2022-11-14T00:00:00.000Z,NEFT CR-DEUT0797BGL-MYNTRA DESIGNS PRIVA TE LIMITED-SLICK ORGANICS PVT. LTD.-2318 00798GN00204,shopping,,net_banking_transfer,5694.37
63bfb2a72e1a0ebb7f6297e2,50200023535069,-547553.74,60ec41ba55c00300382672d9,HDFC,Revenue-PG-split enabled,5eecc6d6449e4f7cfb1c2708,2022-11-14T00:00:00.000Z,NEFT CR-UTIB0001506-RAZORPAY SOFTWARE PR IVATE LIMITED-SLICK ORGANICS PVT LITD-AX ISCN0181604689,,,net_banking_transfer,32395.63
63bfb2a72e1a0ebb7f6297e4,50200023535069,-556604.74,60ec41ba55c00300382672d9,HDFC,direct expenses,5eecc6d6449e4f7cfb1c2708,2022-11-14T00:00:00.000Z,02022138152527/ESIC,,,Other,-9051
63bfb2a72e1a0ebb7f6297e6,50200023535069,-550291.79,60ec41ba55c00300382672d9,HDFC,Transfer in/Revenue-other,5eecc6d6449e4f7cfb1c2708,2022-11-14T00:00:00.000Z,NEFT CR-UTIB0000114-ONE SIGMA TECHNOLOGI ES PRIVATE LIM-SLICK ORGANICS PRIVATE LI MITED-AXISP00337445667,,,net_banking_transfer,6312.95
63bfb2a72e1a0ebb7f6297e8,50200023535069,-547881,60ec41ba55c00300382672d9,HDFC,Transfer in/Revenue-other,5eecc6d6449e4f7cfb1c2708,2022-11-14T00:00:00.000Z,NEFT CR-UTIB0000114-ONE SIGMA TECHNOLOGI ES PRIVATE LIM-SLICK ORGANICS PRIVATE LI MITED-AXISP00337446171,,,net_banking_transfer,2410.79
63bfb2a72e1a0ebb7f6297ea,50200023535069,-388075.32,60ec41ba55c00300382672d9,HDFC,Transfer in/Revenue-other,5eecc6d6449e4f7cfb1c2708,2022-11-14T00:00:00.000Z,NEFT CR-YESB0000001-EASEBUZZ PVT LTD NOD AL A/C-SLICK ORGANICS PVT LTD-YESB231860 48380,,,net_banking_transfer,159805.68
63bfb2a72e1a0ebb7f6297ec,50200023535069,-309244.64,60ec41ba55c00300382672d9,HDFC,Revenue-COD,5eecc6d6449e4f7cfb1c2708,2022-11-14T00:00:00.000Z,NEFT CR-ICIC0000155-SHIPROCKET COD CRF I D 5176857-SLICK ORGANICS PVT LTD-CMS2944 691061,,,net_banking_transfer,78830.68
63bfb2a72e1a0ebb7f6297ee,50200023535069,-308829.51,60ec41ba55c00300382672d9,HDFC,Revenue-PG-split enabled,5eecc6d6449e4f7cfb1c2708,2022-11-14T00:00:00.000Z,NEFT CR-UTIB0001506-RAZORPAY SOFTWARE PR IVATE LIMITED-SLICK ORGANICS PVT LITD-AX ISCN0181802965,,,net_banking_transfer,415.13
63bfb2a72e1a0ebb7f6297f0,50200023535069,-304315.68,60ec41ba55c00300382672d9,HDFC,Transfer in/Revenue-other,5eecc6d6449e4f7cfb1c2708,2022-11-14T00:00:00.000Z,NEFT CR-UTIB0000114-ONE SIGMA TECHNOLOGI ES PRIVATE LIM-SLICK ORGANICS PRIVATE LI MITED-AXISP00337446156,,,net_banking_transfer,4513.83
63bfb2a72e1a0ebb7f6297f2,50200023535069,-304296.68,60ec41ba55c00300382672d9,HDFC,Transfer in/Revenue-other,5eecc6d6449e4f7cfb1c2708,2022-11-15T00:00:00.000Z,INT. ON SWCR ON-50300699243918,,,Other,19
63bfb2a72e1a0ebb7f6297f4,50200023535069,-270422.68,60ec41ba55c00300382672d9,HDFC,Loan-in,5eecc6d6449e4f7cfb1c2708,2022-11-15T00:00:00.000Z,SWEEP-IN CREDIT - 50300699243918,,,self_transfer,33874
63bfb2a72e1a0ebb7f6297f6,50200023535069,-270367.68,60ec41ba55c00300382672d9,HDFC,Transfer in/Revenue-other,5eecc6d6449e4f7cfb1c2708,2022-11-15T00:00:00.000Z,INT. ON SWCR ON-50300699243918,,,Other,55
63bfb2a72e1a0ebb7f6297f8,50200023535069,-169117.68,60ec41ba55c00300382672d9,HDFC,Loan-in,5eecc6d6449e4f7cfb1c2708,2022-11-15T00:00:00.000Z,SWEEP-IN CREDIT - 50300699243918,,,self_transfer,101250
63bfb2a72e1a0ebb7f6297fa,50200023535069,-169024.68,60ec41ba55c00300382672d9,HDFC,Transfer in/Revenue-other,5eecc6d6449e4f7cfb1c2708,2022-11-15T00:00:00.000Z,INT. ON SWCR ON-50300699243918,,,Other,93
63bfb2a72e1a0ebb7f6297fc,50200023535069,93.32,60ec41ba55c00300382672d9,HDFC,Loan-in,5eecc6d6449e4f7cfb1c2708,2022-11-15T00:00:00.000Z,SWEEP-IN CREDIT - 50300699243918,,,self_transfer,169118
63bfb2a72e1a0ebb7f6297fe,50200023535069,-149906.68,60ec41ba55c00300382672d9,HDFC,direct expenses,5eecc6d6449e4f7cfb1c2708,2022-11-15T00:00:00.000Z,NEFT DR-IDFB0040101-ACTIVES ADDITIVES AP PLICATIONS LLP-SANDOZ - MUM-N31922220655 0606-NET BANKING SI -150000,,,net_banking_transfer,-150000
63bfb2a72e1a0ebb7f629800,50200023535069,-138659.52,60ec41ba55c00300382672d9,HDFC,Revenue-PG-non-split,5eecc6d6449e4f7cfb1c2708,2022-11-15T00:00:00.000Z,NEFT CR-PYTM0123456-PAYTM PAYMENTS SERVI CES LIMITED-SLICK ORGANICS PVT LTD-PYTM2 23192186349,ewallet,,net_banking_transfer,11247.16
63bfb2a72e1a0ebb7f629802,50200023535069,8624.37,60ec41ba55c00300382672d9,HDFC,Revenue-Mktplace,5eecc6d6449e4f7cfb1c2708,2022-11-15T00:00:00.000Z,IMPS-231905226743-AMAZON SELLER SERVIC-H SBC-XXXXXXXX6004-5DBUOMBGT3LFV63OSLICK O RGANICS PVT LTD,shopping,,net_banking_transfer,147283.89
63bfb2a72e1a0ebb7f629804,50200023535069,518635.68,60ec41ba55c00300382672d9,HDFC,Revenue-Mktplace,5eecc6d6449e4f7cfb1c2708,2022-11-15T00:00:00.000Z,NEFT CR-DEUT0797BGL-AMAZON PAY (INDIA) P RIVATE LIMITED-SLICK ORGANICS PVT LTD-23 1900318GN00008,shopping,,net_banking_transfer,510011.31
63bfb2a72e1a0ebb7f629806,50200023535069,524647.54,60ec41ba55c00300382672d9,HDFC,Revenue-PG-split enabled,5eecc6d6449e4f7cfb1c2708,2022-11-15T00:00:00.000Z,NEFT CR-UTIB0001506-RAZORPAY SOFTWARE PR IVATE LIMITED-SLICK ORGANICS PVT LITD-AX ISCN0181882192,,,net_banking_transfer,6011.86
63bfb2a72e1a0ebb7f629808,50200023535069,24647.54,60ec41ba55c00300382672d9,HDFC,Marketing Expense,5eecc6d6449e4f7cfb1c2708,2022-11-15T00:00:00.000Z,"NEFT DR-CITI0000006-FACEBOOK INDIA ONLIN E SERVICES PVT LTD-NETBANK, MUM-N3192222 06844512-500000",,,net_banking_transfer,-500000
63bfb2a72e1a0ebb7f62980a,50200023535069,-125352.46,60ec41ba55c00300382672d9,HDFC,direct expenses,5eecc6d6449e4f7cfb1c2708,2022-11-15T00:00:00.000Z,"NEFT DR-YESB0000551-VISTTA COSMETICS-NET BANK, MUM-N319222206868965-150000",,,net_banking_transfer,-150000
63bfb2a72e1a0ebb7f62980c,50200023535069,-375352.46,60ec41ba55c00300382672d9,HDFC,direct expenses,5eecc6d6449e4f7cfb1c2708,2022-11-15T00:00:00.000Z,"NEFT DR-ICIC0000369-BO INTERNATIONAL-NET BANK, MUM-N319222206885623-250000",,,net_banking_transfer,-250000
63bfb2a72e1a0ebb7f62980e,50200023535069,-671102.46,60ec41ba55c00300382672d9,HDFC,direct expenses,5eecc6d6449e4f7cfb1c2708,2022-11-15T00:00:00.000Z,57500001065314-TPT-295750-KRAUTER HEALTH CARE LTD,,,net_banking_transfer,-295750
63bfb2a72e1a0ebb7f629810,50200023535069,-1019024.15,60ec41ba55c00300382672d9,HDFC,direct expenses,5eecc6d6449e4f7cfb1c2708,2022-11-15T00:00:00.000Z,POS 514834XXXXXX9486 E-COMMERCE RP,,,debit_card,-347921.69
63bfb2a72e1a0ebb7f629812,50200023535069,-1019176.15,60ec41ba55c00300382672d9,HDFC,direct expenses,5eecc6d6449e4f7cfb1c2708,2022-11-15T00:00:00.000Z,POS 514834XXXXXX9486 SMARTSHIFT LOGIS,,,debit_card,-152
63bfb2a72e1a0ebb7f629814,50200023535069,-1013642.49,60ec41ba55c00300382672d9,HDFC,Transfer in/Revenue-other,5eecc6d6449e4f7cfb1c2708,2022-11-15T00:00:00.000Z,NEFT CR-UTIB0000114-ONE SIGMA TECHNOLOGI ES PRIVATE LIM-SLICK ORGANICS PRIVATE LI MITED-AXISP00337792973,,,net_banking_transfer,5533.66
63bfb2a72e1a0ebb7f629816,50200023535069,-960063.49,60ec41ba55c00300382672d9,HDFC,Transfer in/Revenue-other,5eecc6d6449e4f7cfb1c2708,2022-11-15T00:00:00.000Z,NEFT CR-YESB0000001-EASEBUZZ PVT LTD NOD,,,net_banking_transfer,53579
63bfb2a72e1a0ebb7f629819,50200023535069,-1010063.49,60ec41ba55c00300382672d9,HDFC,direct expenses,5eecc6d6449e4f7cfb1c2708,2022-11-15T00:00:00.000Z,"NEFT DR-ICIC0006643-KRISHNA PACKAGING CO MPANY-NETBANK, MUM-N319222207923407-5000 0",,,net_banking_transfer,-50000
63bfb2a72e1a0ebb7f62981b,50200023535069,-1074863.49,60ec41ba55c00300382672d9,HDFC,direct expenses,5eecc6d6449e4f7cfb1c2708,2022-11-15T00:00:00.000Z,"NEFT DR-KKBK0001393-MASCOT SPINCONTROL I NDIA PVT LTD-NETBANK, MUM-N3192222079625 10-64800",,,net_banking_transfer,-64800
63bfb2a72e1a0ebb7f62981d,50200023535069,-1074797.45,60ec41ba55c00300382672d9,HDFC,Revenue-PG-split enabled,5eecc6d6449e4f7cfb1c2708,2022-11-15T00:00:00.000Z,NEFT CR-UTIB0001506-RAZORPAY SOFTWARE PR IVATE LIMITED-SLICK ORGANICS PVT LITD-AX ISCN0182086355,,,net_banking_transfer,66.04
63bfb2a72e1a0ebb7f62981f,50200023535069,-1074707.45,60ec41ba55c00300382672d9,HDFC,Transfer in/Revenue-other,5eecc6d6449e4f7cfb1c2708,2022-11-16T00:00:00.000Z,INT. ON SWCR ON-50300699243918,,,Other,90
63bfb2a72e1a0ebb7f629822,50200023535069,-924800.45,60ec41ba55c00300382672d9,HDFC,Loan-in,5eecc6d6449e4f7cfb1c2708,2022-11-16T00:00:00.000Z,SWEEP-IN CREDIT - 50300699243918,,,self_transfer,149907
63bfb2a72e1a0ebb7f629824,50200023535069,-924590.45,60ec41ba55c00300382672d9,HDFC,Transfer in/Revenue-other,5eecc6d6449e4f7cfb1c2708,2022-11-16T00:00:00.000Z,INT. ON SWCR ON-50300699243918,,,Other,210
63bfb2a72e1a0ebb7f629826,50200023535069,-576668.45,60ec41ba55c00300382672d9,HDFC,Loan-in,5eecc6d6449e4f7cfb1c2708,2022-11-16T00:00:00.000Z,SWEEP-IN CREDIT - 50300699243918,,,self_transfer,347922
63bfb2a72e1a0ebb7f629828,50200023535069,-576516.45,60ec41ba55c00300382672d9,HDFC,Loan-in,5eecc6d6449e4f7cfb1c2708,2022-11-16T00:00:00.000Z,SWEEP-IN CREDIT - 50300699243918,,,self_transfer,152
63bfb2a72e1a0ebb7f62982a,50200023535069,-576380.45,60ec41ba55c00300382672d9,HDFC,Transfer in/Revenue-other,5eecc6d6449e4f7cfb1c2708,2022-11-16T00:00:00.000Z,INT. ON SWCR ON-50300699243918,,,Other,136
63bfb2a72e1a0ebb7f62982c,50200023535069,-350934.45,60ec41ba55c00300382672d9,HDFC,Loan-in,5eecc6d6449e4f7cfb1c2708,2022-11-16T00:00:00.000Z,SWEEP-IN CREDIT - 50300699243918,,,self_transfer,225446
63bfb2a72e1a0ebb7f62982e,50200023535069,-350756.45,60ec41ba55c00300382672d9,HDFC,Transfer in/Revenue-other,5eecc6d6449e4f7cfb1c2708,2022-11-16T00:00:00.000Z,INT. ON SWCR ON-50300699243918,,,Other,178
63bfb2a72e1a0ebb7f629830,50200023535069,-55006.45,60ec41ba55c00300382672d9,HDFC,Loan-in,5eecc6d6449e4f7cfb1c2708,2022-11-16T00:00:00.000Z,SWEEP-IN CREDIT - 50300699243918,,,self_transfer,295750
63bfb2a72e1a0ebb7f629832,50200023535069,-54973.45,60ec41ba55c00300382672d9,HDFC,Transfer in/Revenue-other,5eecc6d6449e4f7cfb1c2708,2022-11-16T00:00:00.000Z,INT. ON SWCR ON-50300699243918,,,Other,33
63bfb2a72e1a0ebb7f629835,50200023535069,33.55,60ec41ba55c00300382672d9,HDFC,Loan-in,5eecc6d6449e4f7cfb1c2708,2022-11-16T00:00:00.000Z,SWEEP-IN CREDIT - 50300699243918,,,self_transfer,55007
63bfb2a72e1a0ebb7f629837,50200023535069,6712.72,60ec41ba55c00300382672d9,HDFC,Revenue-PG-non-split,5eecc6d6449e4f7cfb1c2708,2022-11-16T00:00:00.000Z,NEFT CR-PYTM0123456-PAYTM PAYMENTS SERVI CES LIMITED-SLICK ORGANICS PVT LTD-PYTM2 23203916477,ewallet,,net_banking_transfer,6679.17
63bfb2a72e1a0ebb7f629839,50200023535069,-248287.28,60ec41ba55c00300382672d9,HDFC,direct expenses,5eecc6d6449e4f7cfb1c2708,2022-11-16T00:00:00.000Z,NEFT DR-SCBL0036020-AMERICAN EXPRESS-SAN DOZ - MUM-N320222208326185-NET BANKING S I -255000,,,net_banking_transfer,-255000
63bfb2a72e1a0ebb7f62983c,50200023535069,-192963.82,60ec41ba55c00300382672d9,HDFC,Revenue-Mktplace,5eecc6d6449e4f7cfb1c2708,2022-11-16T00:00:00.000Z,NEFT CR-DEUT0797BGL-FLIPKART INTERNET PR IVATE LIMITED-SLICK ORGANICS PVT LTD-232 000217GN00026,shopping,,net_banking_transfer,55323.46
63bfb2a72e1a0ebb7f62983e,50200023535069,-188913.52,60ec41ba55c00300382672d9,HDFC,Revenue-Mktplace,5eecc6d6449e4f7cfb1c2708,2022-11-16T00:00:00.000Z,NEFT CR-DEUT0797BGL-MYNTRA DESIGNS PRIVA,shopping,,net_banking_transfer,4050.3
63bfb2a72e1a0ebb7f629840,50200023535069,-180349.64,60ec41ba55c00300382672d9,HDFC,Revenue-Mktplace,5eecc6d6449e4f7cfb1c2708,2022-11-16T00:00:00.000Z,NEFT CR-DEUT0797BGL-MYNTRA DESIGNS PRIVA TE LIMITED-SLICK ORGANICS - SJIT-2320008 83GN00184,shopping,,net_banking_transfer,8563.88
63bfb2a72e1a0ebb7f629843,50200023535069,-173428.34,60ec41ba55c00300382672d9,HDFC,Revenue-Mktplace,5eecc6d6449e4f7cfb1c2708,2022-11-16T00:00:00.000Z,NEFT CR-DEUT0797BGL-MYNTRA DESIGNS PRIVA TE LIMITED-SLICK ORGANICS PVT. LTD.-2320 00913GN00168,shopping,,net_banking_transfer,6921.3
63bfb2a72e1a0ebb7f629845,50200023535069,-163066.96,60ec41ba55c00300382672d9,HDFC,Revenue-PG-split enabled,5eecc6d6449e4f7cfb1c2708,2022-11-16T00:00:00.000Z,NEFT CR-UTIB0001506-RAZORPAY SOFTWARE PR IVATE LIMITED-SLICK ORGANICS PVT LITD-AX ISCN0182174564,,,net_banking_transfer,10361.38
63bfb2a72e1a0ebb7f629848,50200023535069,-413066.96,60ec41ba55c00300382672d9,HDFC,direct expenses,5eecc6d6449e4f7cfb1c2708,2022-11-16T00:00:00.000Z,"NEFT DR-SRCB0000281-3D TECHNOPACK PRIVAT E LIMITED-NETBANK, MUM-N320222208759482- 250000",,,net_banking_transfer,-250000
63bfb2a72e1a0ebb7f62984a,50200023535069,-437056.96,60ec41ba55c00300382672d9,HDFC,direct expenses,5eecc6d6449e4f7cfb1c2708,2022-11-16T00:00:00.000Z,"NEFT DR-KKBK0000173-NITISH KUMAR MANDAL- NETBANK, MUM-N320222208901562-23990",,,net_banking_transfer,-23990
63bfb2a72e1a0ebb7f62984c,50200023535069,-434921.97,60ec41ba55c00300382672d9,HDFC,Transfer in/Revenue-other,5eecc6d6449e4f7cfb1c2708,2022-11-16T00:00:00.000Z,NEFT CR-UTIB0000114-ONE SIGMA TECHNOLOGI ES PRIVATE LIM-SLICK ORGANICS PRIVATE LI MITED-AXISP00338306673,,,net_banking_transfer,2134.99
63bfb2a82e1a0ebb7f62984e,50200023535069,-511385.97,60ec41ba55c00300382672d9,HDFC,direct expenses,5eecc6d6449e4f7cfb1c2708,2022-11-16T00:00:00.000Z,POS 514834XXXXXX9486 CAS*INSTASPACES,,,debit_card,-76464
63bfb2a82e1a0ebb7f629850,50200023535069,-507154.97,60ec41ba55c00300382672d9,HDFC,Revenue-Mktplace,5eecc6d6449e4f7cfb1c2708,2022-11-16T00:00:00.000Z,NEFT CR-SCBL0036001-DREAMPLUG TECHNOLOGI ES PRIVATE LIMITED-SLICK ORGANICS PRIVAT E LIMITEDSLICK-IN1ON22111601MK5,,,net_banking_transfer,4231
63bfb2a82e1a0ebb7f629852,50200023535069,-507654.97,60ec41ba55c00300382672d9,HDFC,direct expenses,5eecc6d6449e4f7cfb1c2708,2022-11-16T00:00:00.000Z,POS 514834XXXXXX9486 SMARTSHIFT LOGIS,,,debit_card,-500
63bfb2a82e1a0ebb7f629854,50200023535069,-462677.53,60ec41ba55c00300382672d9,HDFC,Transfer in/Revenue-other,5eecc6d6449e4f7cfb1c2708,2022-11-16T00:00:00.000Z,NEFT CR-YESB0000001-EASEBUZZ PVT LTD NOD AL A/C-SLICK ORGANICS PVT LTD-YESB232014 45631,,,net_banking_transfer,44977.44
63bfb2a82e1a0ebb7f629856,50200023535069,-462917.53,60ec41ba55c00300382672d9,HDFC,direct expenses,5eecc6d6449e4f7cfb1c2708,2022-11-16T00:00:00.000Z,POS 514834XXXXXX9486 SMARTSHIFT LOGIS,,,debit_card,-240
63bfb2a82e1a0ebb7f629858,50200023535069,-460012.07,60ec41ba55c00300382672d9,HDFC,Revenue-PG-split enabled,5eecc6d6449e4f7cfb1c2708,2022-11-16T00:00:00.000Z,NEFT CR-UTIB0001506-RAZORPAY SOFTWARE PR IVATE LIMITED-SLICK ORGANICS PVT LITD-AX ISCN0182331226,,,net_banking_transfer,2905.46
63bfb2a82e1a0ebb7f62985a,50200023535069,-459849.07,60ec41ba55c00300382672d9,HDFC,Transfer in/Revenue-other,5eecc6d6449e4f7cfb1c2708,2022-11-17T00:00:00.000Z,INT. ON SWCR ON-50300699243918,,,Other,163
63bfb2a82e1a0ebb7f62985c,50200023535069,-211561.07,60ec41ba55c00300382672d9,HDFC,Loan-in,5eecc6d6449e4f7cfb1c2708,2022-11-17T00:00:00.000Z,SWEEP-IN CREDIT - 50300699243918,,,self_transfer,248288
63bfb2a82e1a0ebb7f62985e,50200023535069,-211512.07,60ec41ba55c00300382672d9,HDFC,Transfer in/Revenue-other,5eecc6d6449e4f7cfb1c2708,2022-11-17T00:00:00.000Z,INT. ON SWCR ON-50300699243918,,,Other,49
63bfb2a82e1a0ebb7f629866,50200023535069,-137182.07,60ec41ba55c00300382672d9,HDFC,Loan-in,5eecc6d6449e4f7cfb1c2708,2022-11-17T00:00:00.000Z,SWEEP-IN CREDIT - 50300699243918,,,self_transfer,74330
63bfb2a82e1a0ebb7f629868,50200023535069,-137092.07,60ec41ba55c00300382672d9,HDFC,Transfer in/Revenue-other,5eecc6d6449e4f7cfb1c2708,2022-11-17T00:00:00.000Z,INT. ON SWCR ON-50300699243918,,,Other,90
63bfb2a82e1a0ebb7f62986b,50200023535069,90.93,60ec41ba55c00300382672d9,HDFC,Loan-in,5eecc6d6449e4f7cfb1c2708,2022-11-17T00:00:00.000Z,SWEEP-IN CREDIT - 50300699243918,,,self_transfer,137183
63bfb2a82e1a0ebb7f62986d,50200023535069,11400.37,60ec41ba55c00300382672d9,HDFC,Revenue-PG-non-split,5eecc6d6449e4f7cfb1c2708,2022-11-17T00:00:00.000Z,NEFT CR-PYTM0123456-PAYTM PAYMENTS SERVI CES LIMITED-SLICK ORGANICS PVT LTD-PYTM2 23216324952,ewallet,,net_banking_transfer,11309.44
63bfb2a82e1a0ebb7f629870,50200023535069,17240.82,60ec41ba55c00300382672d9,HDFC,Revenue-PG-split enabled,5eecc6d6449e4f7cfb1c2708,2022-11-17T00:00:00.000Z,NEFT CR-UTIB0001506-RAZORPAY SOFTWARE PR IVATE LIMITED-SLICK ORGANICS PVT LITD-AX ISCN0182422284,,,net_banking_transfer,5840.45
63bfb2a82e1a0ebb7f629873,50200023535069,-9669.18,60ec41ba55c00300382672d9,HDFC,direct expenses,5eecc6d6449e4f7cfb1c2708,2022-11-17T00:00:00.000Z,POS 514834XXXXXX9486 PTM*PAYTM,ewallet,,debit_card,-26910
63bfb2a82e1a0ebb7f629876,50200023535069,-6556.38,60ec41ba55c00300382672d9,HDFC,Transfer in/Revenue-other,5eecc6d6449e4f7cfb1c2708,2022-11-17T00:00:00.000Z,NEFT CR-UTIB0000114-ONE SIGMA TECHNOLOGI ES PRIVATE LIM-SLICK ORGANICS PRIVATE LI MITED-AXISP00338685718,,,net_banking_transfer,3112.8
63bfb2a82e1a0ebb7f629878,50200023535069,54177.24,60ec41ba55c00300382672d9,HDFC,Transfer in/Revenue-other,5eecc6d6449e4f7cfb1c2708,2022-11-17T00:00:00.000Z,NEFT CR-YESB0000001-EASEBUZZ PVT LTD NOD AL A/C-SLICK ORGANICS PVT LTD-YESB232140 68199,,,net_banking_transfer,60733.62
63bfb2a82e1a0ebb7f62987a,50200023535069,68297,60ec41ba55c00300382672d9,HDFC,Revenue-PG-split enabled,5eecc6d6449e4f7cfb1c2708,2022-11-17T00:00:00.000Z,NEFT CR-UTIB0001506-RAZORPAY SOFTWARE PR IVATE LIMITED-SLICK ORGANICS PVT LITD-AX ISCN0182608194,,,net_banking_transfer,14119.76
63bfb2a82e1a0ebb7f62987c,50200023535069,85642.64,60ec41ba55c00300382672d9,HDFC,Revenue-Mktplace,5eecc6d6449e4f7cfb1c2708,2022-11-18T00:00:00.000Z,NEFT CR-DEUT0797BGL-FLIPKART INTERNET PR IVATE LIMITED-SLICK ORGANICS PVT LTD-232 200120GN00278,shopping,,net_banking_transfer,17345.64
63bfb2a82e1a0ebb7f62987e,50200023535069,-164357.36,60ec41ba55c00300382672d9,HDFC,direct expenses,5eecc6d6449e4f7cfb1c2708,2022-11-18T00:00:00.000Z,57500001065314 NET BANKING SI -250000,,,Other,-250000
63bfb2a82e1a0ebb7f629880,50200023535069,-150829.42,60ec41ba55c00300382672d9,HDFC,Revenue-PG-non-split,5eecc6d6449e4f7cfb1c2708,2022-11-18T00:00:00.000Z,NEFT CR-PYTM0123456-PAYTM PAYMENTS SERVI CES LIMITED-SLICK ORGANICS PVT LTD-PYTM2 23227437551,ewallet,,net_banking_transfer,13527.94
63bfb2a82e1a0ebb7f629882,50200023535069,-143418.08,60ec41ba55c00300382672d9,HDFC,Revenue-Mktplace,5eecc6d6449e4f7cfb1c2708,2022-11-18T00:00:00.000Z,NEFT CR-DEUT0797BGL-MYNTRA DESIGNS PRIVA TE LIMITED-SLICK ORGANICS - SJIT-2322007 53GN00197,shopping,,net_banking_transfer,7411.34
63bfb2a82e1a0ebb7f629884,50200023535069,-139774.09,60ec41ba55c00300382672d9,HDFC,Revenue-Mktplace,5eecc6d6449e4f7cfb1c2708,2022-11-18T00:00:00.000Z,NEFT CR-DEUT0797BGL-MYNTRA DESIGNS PRIVA,shopping,,net_banking_transfer,3643.99
63bfb2a82e1a0ebb7f629886,50200023535069,-134060.4,60ec41ba55c00300382672d9,HDFC,Revenue-Mktplace,5eecc6d6449e4f7cfb1c2708,2022-11-18T00:00:00.000Z,NEFT CR-DEUT0797BGL-MYNTRA DESIGNS PRIVA TE LIMITED-SLICK ORGANICS PVT. LTD.-2322 00775GN00157,shopping,,net_banking_transfer,5713.69
63bfb2a82e1a0ebb7f629889,50200023535069,-122537.22,60ec41ba55c00300382672d9,HDFC,Revenue-PG-split enabled,5eecc6d6449e4f7cfb1c2708,2022-11-18T00:00:00.000Z,NEFT CR-UTIB0001506-RAZORPAY SOFTWARE PR IVATE LIMITED-SLICK ORGANICS PVT LITD-AX ISCN0182692710,,,net_banking_transfer,11523.18
63bfb2a82e1a0ebb7f62988b,50200023535069,-132537.22,60ec41ba55c00300382672d9,HDFC,Refund,5eecc6d6449e4f7cfb1c2708,2022-11-18T00:00:00.000Z,"NEFT DR-RATN0VAAPIS-RAZORPAY REFUND CRED ITS TOPUP-NETBANK, MUM-N322222211495181- 10000",,,net_banking_transfer,-10000
63bfb2a82e1a0ebb7f62988d,50200023535069,-133023.22,60ec41ba55c00300382672d9,HDFC,direct expenses,5eecc6d6449e4f7cfb1c2708,2022-11-18T00:00:00.000Z,POS 514834XXXXXX9486 PTM*PAYTM WALLET,ewallet,,debit_card,-486
63bfb2a82e1a0ebb7f62988f,50200023535069,-183023.22,60ec41ba55c00300382672d9,HDFC,direct expenses,5eecc6d6449e4f7cfb1c2708,2022-11-18T00:00:00.000Z,"NEFT DR-BKID0007124-MATRIX PRINTING SOLU TIONS PVT LTD-NETBANK, MUM-N322222211625 829-50000",,,net_banking_transfer,-50000
63bfb2a82e1a0ebb7f629891,50200023535069,-257028.22,60ec41ba55c00300382672d9,HDFC,direct expenses,5eecc6d6449e4f7cfb1c2708,2022-11-18T00:00:00.000Z,"NEFT DR-BARB0MOHAMP-MARKETING MANTRA SOL UTIONS-NETBANK, MUM-N322222211619670-740 05",,,net_banking_transfer,-74005
63bfb2a82e1a0ebb7f629893,50200023535069,-290348.22,60ec41ba55c00300382672d9,HDFC,direct expenses,5eecc6d6449e4f7cfb1c2708,2022-11-18T00:00:00.000Z,"NEFT DR-KKBK0001393-MASCOT SPINCONTROL I NDIA PVT LTD-NETBANK, MUM-N3222222116153 23-33320",,,net_banking_transfer,-33320
63bfb2a82e1a0ebb7f629895,50200023535069,-276785.22,60ec41ba55c00300382672d9,HDFC,Transfer in/Revenue-other,5eecc6d6449e4f7cfb1c2708,2022-11-18T00:00:00.000Z,NEFT CR-KKBK0000958-OCTAVOS ENTERPRISE S OLUTIONS PVT-SLICK ORGANICS PRIVATE LIMI TED-CMS3222232976884,,,net_banking_transfer,13563
63bfb2a82e1a0ebb7f629897,50200023535069,-293585.22,60ec41ba55c00300382672d9,HDFC,direct expenses,5eecc6d6449e4f7cfb1c2708,2022-11-18T00:00:00.000Z,"NEFT DR-UBIN0919721-PINKU-NETBANK, MUM-N 322222211659499-16800",,,net_banking_transfer,-16800
63bfb2a82e1a0ebb7f629899,50200023535069,-393585.22,60ec41ba55c00300382672d9,HDFC,direct expenses,5eecc6d6449e4f7cfb1c2708,2022-11-18T00:00:00.000Z,"NEFT DR-YESB0000551-VISTTA COSMETICS-NET BANK, MUM-N322222211685518-100000",,,net_banking_transfer,-100000
63bfb2a82e1a0ebb7f62989c,50200023535069,-394850.58,60ec41ba55c00300382672d9,HDFC,Marketing Expense,5eecc6d6449e4f7cfb1c2708,2022-11-18T00:00:00.000Z,ME DC SI 514834XXXXXX9486 LINKEDIN (PGSI ),,,Other,-1265.36
63bfb2a82e1a0ebb7f62989e,50200023535069,-393689.77,60ec41ba55c00300382672d9,HDFC,Transfer in/Revenue-other,5eecc6d6449e4f7cfb1c2708,2022-11-18T00:00:00.000Z,NEFT CR-UTIB0000114-ONE SIGMA TECHNOLOGI,,,net_banking_transfer,1160.81
63bfb2a82e1a0ebb7f6298a1,50200023535069,-394783.77,60ec41ba55c00300382672d9,HDFC,direct expenses,5eecc6d6449e4f7cfb1c2708,2022-11-18T00:00:00.000Z,POS 514834XXXXXX9486 SMARTSHIFT LOGIS,,,debit_card,-1094
63bfb2a82e1a0ebb7f6298a3,50200023535069,-358312.46,60ec41ba55c00300382672d9,HDFC,Transfer in/Revenue-other,5eecc6d6449e4f7cfb1c2708,2022-11-18T00:00:00.000Z,NEFT CR-YESB0000001-EASEBUZZ PVT LTD NOD AL A/C-SLICK ORGANICS PVT LTD-YESB232266 60200,,,net_banking_transfer,36471.31
63bfb2a82e1a0ebb7f6298a5,50200023535069,-358812.46,60ec41ba55c00300382672d9,HDFC,direct expenses,5eecc6d6449e4f7cfb1c2708,2022-11-18T00:00:00.000Z,POS 514834XXXXXX9486 SMARTSHIFT LOGIS,,,debit_card,-500
63bfb2a82e1a0ebb7f6298a7,50200023535069,-351186.19,60ec41ba55c00300382672d9,HDFC,Revenue-PG-split enabled,5eecc6d6449e4f7cfb1c2708,2022-11-18T00:00:00.000Z,NEFT CR-UTIB0001506-RAZORPAY SOFTWARE PR IVATE LIMITED-SLICK ORGANICS PVT LITD-AX ISCN0182829592,,,net_banking_transfer,7626.27
63bfb2a82e1a0ebb7f6298a9,50200023535069,-351266.19,60ec41ba55c00300382672d9,HDFC,SAAS/tech expense,5eecc6d6449e4f7cfb1c2708,2022-11-18T00:00:00.000Z,POS 514834XXXXXX9486 MICROSOFT*STORE,,,debit_card,-80
63bfb2a82e1a0ebb7f6298ab,50200023535069,-351186.19,60ec41ba55c00300382672d9,HDFC,Transfer in/Revenue-other,5eecc6d6449e4f7cfb1c2708,2022-11-18T00:00:00.000Z,POS 514834XXXXXX9486 MICROSOFT*STORE,,,debit_card,80
63bfb2a82e1a0ebb7f6298ad,50200023535069,-356085.19,60ec41ba55c00300382672d9,HDFC,SAAS/tech expense,5eecc6d6449e4f7cfb1c2708,2022-11-18T00:00:00.000Z,POS 514834XXXXXX9486 MICROSOFT*STORE,,,debit_card,-4899
63bfb2a82e1a0ebb7f6298af,50200023535069,-355959.19,60ec41ba55c00300382672d9,HDFC,Transfer in/Revenue-other,5eecc6d6449e4f7cfb1c2708,2022-11-19T00:00:00.000Z,INT. ON SWCR ON-50300699243918,,,Other,126
63bfb2a82e1a0ebb7f6298b1,50200023535069,-191601.19,60ec41ba55c00300382672d9,HDFC,Loan-in,5eecc6d6449e4f7cfb1c2708,2022-11-19T00:00:00.000Z,SWEEP-IN CREDIT - 50300699243918,,,self_transfer,164358
63bfb2a82e1a0ebb7f6298b3,50200023535069,-191600.19,60ec41ba55c00300382672d9,HDFC,Transfer in/Revenue-other,5eecc6d6449e4f7cfb1c2708,2022-11-19T00:00:00.000Z,INT. ON SWCR ON-50300699243918,,,Other,1
63bfb2a82e1a0ebb7f6298b5,50200023535069,-190334.19,60ec41ba55c00300382672d9,HDFC,Loan-in,5eecc6d6449e4f7cfb1c2708,2022-11-19T00:00:00.000Z,SWEEP-IN CREDIT - 50300699243918,,,self_transfer,1266
63bfb2a82e1a0ebb7f6298b7,50200023535069,-190320.19,60ec41ba55c00300382672d9,HDFC,Transfer in/Revenue-other,5eecc6d6449e4f7cfb1c2708,2022-11-19T00:00:00.000Z,INT. ON SWCR ON-50300699243918,,,Other,14
63bfb2a82e1a0ebb7f6298b9,50200023535069,-171654.19,60ec41ba55c00300382672d9,HDFC,Loan-in,5eecc6d6449e4f7cfb1c2708,2022-11-19T00:00:00.000Z,SWEEP-IN CREDIT - 50300699243918,,,self_transfer,18666
63bfb2a82e1a0ebb7f6298bb,50200023535069,-171597.19,60ec41ba55c00300382672d9,HDFC,Transfer in/Revenue-other,5eecc6d6449e4f7cfb1c2708,2022-11-19T00:00:00.000Z,INT. ON SWCR ON-50300699243918,,,Other,57
63bfb2a82e1a0ebb7f6298bd,50200023535069,-97592.19,60ec41ba55c00300382672d9,HDFC,Loan-in,5eecc6d6449e4f7cfb1c2708,2022-11-19T00:00:00.000Z,SWEEP-IN CREDIT - 50300699243918,,,self_transfer,74005
63bfb2a82e1a0ebb7f6298bf,50200023535069,-97566.19,60ec41ba55c00300382672d9,HDFC,Transfer in/Revenue-other,5eecc6d6449e4f7cfb1c2708,2022-11-19T00:00:00.000Z,INT. ON SWCR ON-50300699243918,,,Other,26
63bfb2a82e1a0ebb7f6298c1,50200023535069,-64246.19,60ec41ba55c00300382672d9,HDFC,Loan-in,5eecc6d6449e4f7cfb1c2708,2022-11-19T00:00:00.000Z,SWEEP-IN CREDIT - 50300699243918,,,self_transfer,33320
63bfb2a82e1a0ebb7f6298c3,50200023535069,-64244.19,60ec41ba55c00300382672d9,HDFC,Transfer in/Revenue-other,5eecc6d6449e4f7cfb1c2708,2022-11-19T00:00:00.000Z,INT. ON SWCR ON-50300699243918,,,Other,2
63bfb2a82e1a0ebb7f6298c5,50200023535069,-61007.19,60ec41ba55c00300382672d9,HDFC,Loan-in,5eecc6d6449e4f7cfb1c2708,2022-11-19T00:00:00.000Z,SWEEP-IN CREDIT - 50300699243918,,,self_transfer,3237
63bfb2a82e1a0ebb7f6298c7,50200023535069,-60960.19,60ec41ba55c00300382672d9,HDFC,Transfer in/Revenue-other,5eecc6d6449e4f7cfb1c2708,2022-11-19T00:00:00.000Z,INT. ON SWCR ON-50300699243918,,,Other,47
63bfb2a82e1a0ebb7f6298c9,50200023535069,47.81,60ec41ba55c00300382672d9,HDFC,Loan-in,5eecc6d6449e4f7cfb1c2708,2022-11-19T00:00:00.000Z,SWEEP-IN CREDIT - 50300699243918,,,self_transfer,61008
63bfb2a82e1a0ebb7f6298cb,50200023535069,-49952.19,60ec41ba55c00300382672d9,HDFC,direct expenses,5eecc6d6449e4f7cfb1c2708,2022-11-19T00:00:00.000Z,NEFT DR-KKBK0000664-SHRADDHA DINESH SHU KLA-SANDOZ - MUM-N323222212593441-NET BA NKING SI -50000,,,net_banking_transfer,-50000
63bfb2a82e1a0ebb7f6298cd,50200023535069,-41565.86,60ec41ba55c00300382672d9,HDFC,Revenue-PG-non-split,5eecc6d6449e4f7cfb1c2708,2022-11-19T00:00:00.000Z,NEFT CR-PYTM0123456-PAYTM PAYMENTS SERVI,ewallet,,net_banking_transfer,8386.33
63bfb2a82e1a0ebb7f6298cf,50200023535069,-38386.74,60ec41ba55c00300382672d9,HDFC,Revenue-PG-split enabled,5eecc6d6449e4f7cfb1c2708,2022-11-19T00:00:00.000Z,NEFT CR-UTIB0001506-RAZORPAY SOFTWARE PR IVATE LIMITED-SLICK ORGANICS PVT LITD-AX ISCN0182907285,,,net_banking_transfer,3179.12
63bfb2a82e1a0ebb7f6298d1,50200023535069,-12452.52,60ec41ba55c00300382672d9,HDFC,Transfer in/Revenue-other,5eecc6d6449e4f7cfb1c2708,2022-11-19T00:00:00.000Z,NEFT CR-YESB0000001-EASEBUZZ PVT LTD NOD AL A/C-SLICK ORGANICS PVT LTD-YESB232387 98333,,,net_banking_transfer,25934.22
63bfb2a92e1a0ebb7f6298d3,50200023535069,-17552.52,60ec41ba55c00300382672d9,HDFC,direct expenses,5eecc6d6449e4f7cfb1c2708,2022-11-19T00:00:00.000Z,50100155187569-TPT-5100-KHADIJA NASRAT I SLAM,,,net_banking_transfer,-5100
63bfb2a92e1a0ebb7f6298d5,50200023535069,26960.48,60ec41ba55c00300382672d9,HDFC,Revenue-Mktplace,5eecc6d6449e4f7cfb1c2708,2022-11-19T00:00:00.000Z,NEFT CR-SCBL0036001-THREPSI SOLUTIONS PR IVATE LIMITED-SLICK ORGANICS PVT LTD-IN1 ON22111900RGV,,,net_banking_transfer,44513
63bfb2a92e1a0ebb7f6298d7,50200023535069,40439.95,60ec41ba55c00300382672d9,HDFC,Revenue-PG-split enabled,5eecc6d6449e4f7cfb1c2708,2022-11-19T00:00:00.000Z,NEFT CR-UTIB0001506-RAZORPAY SOFTWARE PR IVATE LIMITED-SLICK ORGANICS PVT LITD-AX ISCN0183048709,,,net_banking_transfer,13479.47
63bfb2a92e1a0ebb7f6298d9,50200023535069,51468.82,60ec41ba55c00300382672d9,HDFC,Revenue-PG-non-split,5eecc6d6449e4f7cfb1c2708,2022-11-20T00:00:00.000Z,NEFT CR-PYTM0123456-PAYTM PAYMENTS SERVI CES LIMITED-SLICK ORGANICS PVT LTD-PYTM2 23240883139,ewallet,,net_banking_transfer,11028.87
63bfb2a92e1a0ebb7f6298dc,50200023535069,41468.82,60ec41ba55c00300382672d9,HDFC,direct expenses,5eecc6d6449e4f7cfb1c2708,2022-11-20T00:00:00.000Z,50200039508087-TPT-10000-SHREE PUNCHMUKH I LOGISTICS,,,net_banking_transfer,-10000
63bfb2a92e1a0ebb7f6298de,50200023535069,25242.82,60ec41ba55c00300382672d9,HDFC,direct expenses,5eecc6d6449e4f7cfb1c2708,2022-11-20T00:00:00.000Z,"NEFT DR-KKBK0000180-VIMAL PLASTICS-NETBA NK, MUM-N324222213655360-16226",,,net_banking_transfer,-16226
63bfb2a92e1a0ebb7f6298e0,50200023535069,36784.75,60ec41ba55c00300382672d9,HDFC,Revenue-PG-non-split,5eecc6d6449e4f7cfb1c2708,2022-11-21T00:00:00.000Z,NEFT CR-PYTM0123456-PAYTM PAYMENTS SERVI CES LIMITED-SLICK ORGANICS PVT LTD-PYTM2 23252784979,ewallet,,net_banking_transfer,11541.93
63bfb2a92e1a0ebb7f6298e2,50200023535069,59076.39,60ec41ba55c00300382672d9,HDFC,Revenue-Mktplace,5eecc6d6449e4f7cfb1c2708,2022-11-21T00:00:00.000Z,NEFT CR-DEUT0797BGL-FLIPKART INTERNET PR IVATE LIMITED-SLICK ORGANICS PVT LTD-232 500146GN00158,shopping,,net_banking_transfer,22291.64
63bfb2a92e1a0ebb7f6298e4,50200023535069,92906.98,60ec41ba55c00300382672d9,HDFC,Revenue-PG-split enabled,5eecc6d6449e4f7cfb1c2708,2022-11-21T00:00:00.000Z,NEFT CR-UTIB0001506-RAZORPAY SOFTWARE PR IVATE LIMITED-SLICK ORGANICS PVT LITD-AX ISCN0183192794,,,net_banking_transfer,33830.59
63bfb2a92e1a0ebb7f6298e6,50200023535069,91201.19,60ec41ba55c00300382672d9,HDFC,bank charges,5eecc6d6449e4f7cfb1c2708,2022-11-21T00:00:00.000Z,.DC INTL POS TXN MARKUP+ST 301022 011122,,,international_transaction_arbitrage,-1705.79
63bfb2a92e1a0ebb7f6298e8,50200023535069,92559.56,60ec41ba55c00300382672d9,HDFC,Transfer in/Revenue-other,5eecc6d6449e4f7cfb1c2708,2022-11-21T00:00:00.000Z,NEFT CR-UTIB0000114-ONE SIGMA TECHNOLOGI ES PRIVATE LIM-SLICK ORGANICS PRIVATE LI MITED-AXISP00339298560,,,net_banking_transfer,1358.37
63bfb2a92e1a0ebb7f6298ea,50200023535069,96605,60ec41ba55c00300382672d9,HDFC,Transfer in/Revenue-other,5eecc6d6449e4f7cfb1c2708,2022-11-21T00:00:00.000Z,NEFT CR-UTIB0000114-ONE SIGMA TECHNOLOGI ES PRIVATE LIM-SLICK ORGANICS PRIVATE LI MITED-AXISP00339298639,,,net_banking_transfer,4045.44
63bfb2a92e1a0ebb7f6298ec,50200023535069,96501.3,60ec41ba55c00300382672d9,HDFC,bank charges,5eecc6d6449e4f7cfb1c2708,2022-11-21T00:00:00.000Z,.DC INTL POS TXN MARKUP+ST 021122 041122 -CDT2230512020599,,,international_transaction_arbitrage,-103.7
63bfb2a92e1a0ebb7f6298ee,50200023535069,213419.69,60ec41ba55c00300382672d9,HDFC,Transfer in/Revenue-other,5eecc6d6449e4f7cfb1c2708,2022-11-21T00:00:00.000Z,NEFT CR-YESB0000001-EASEBUZZ PVT LTD NOD AL A/C-SLICK ORGANICS PVT LTD-YESB232530 38700,,,net_banking_transfer,116918.39
63bfb2a92e1a0ebb7f6298f0,50200023535069,219469.06,60ec41ba55c00300382672d9,HDFC,Revenue-COD,5eecc6d6449e4f7cfb1c2708,2022-11-21T00:00:00.000Z,NEFT CR-ICIC0000155-SHIPROCKET COD CRF I D 5217810-SLICK ORGANICS PVT LTD-CMS2959 351959,,,net_banking_transfer,6049.37
63bfb2a92e1a0ebb7f6298f2,50200023535069,227036.66,60ec41ba55c00300382672d9,HDFC,Revenue-PG-split enabled,5eecc6d6449e4f7cfb1c2708,2022-11-21T00:00:00.000Z,NEFT CR-UTIB0001506-RAZORPAY SOFTWARE PR IVATE LIMITED-SLICK ORGANICS PVT LITD-AX ISCN0183371547,,,net_banking_transfer,7567.6
63bfb2a92e1a0ebb7f6298f5,50200023535069,177036.66,60ec41ba55c00300382672d9,HDFC,direct expenses,5eecc6d6449e4f7cfb1c2708,2022-11-21T00:00:00.000Z,"NEFT DR-YESB0000236-DELIGHT VACATION PVT LTD-NETBANK, MUM-N325222215042933-50000",,,net_banking_transfer,-50000
63bfb2a92e1a0ebb7f6298f7,50200023535069,159036.66,60ec41ba55c00300382672d9,HDFC,direct expenses,5eecc6d6449e4f7cfb1c2708,2022-11-21T00:00:00.000Z,59209090900405-TPT-18000-KIRO,,,net_banking_transfer,-18000
63bfb2a92e1a0ebb7f6298f9,50200023535069,144536.66,60ec41ba55c00300382672d9,HDFC,direct expenses,5eecc6d6449e4f7cfb1c2708,2022-11-21T00:00:00.000Z,"NEFT DR-IDIB000P153-KRITI DS MAKEUP AND BEAUTY STUDIO-NETBANK, MUM-N325222215155 144-14500",,,net_banking_transfer,-14500
63bfb2a92e1a0ebb7f6298fb,50200023535069,158040.98,60ec41ba55c00300382672d9,HDFC,Revenue-PG-non-split,5eecc6d6449e4f7cfb1c2708,2022-11-22T00:00:00.000Z,NEFT CR-PYTM0123456-PAYTM PAYMENTS SERVI CES LIMITED-SLICK ORGANICS PVT LTD-PYTM2 23264478362,ewallet,,net_banking_transfer,13504.32
63bfb2a92e1a0ebb7f6298fd,50200023535069,-91959.02,60ec41ba55c00300382672d9,HDFC,direct expenses,5eecc6d6449e4f7cfb1c2708,2022-11-22T00:00:00.000Z,NEFT DR-ICIC0000369-BO INTERNATIONAL-SAN DOZ - MUM-N326222215249125-NET BANKING S I -250000,,,net_banking_transfer,-250000
63bfb2a92e1a0ebb7f6298ff,50200023535069,-141959.02,60ec41ba55c00300382672d9,HDFC,direct expenses,5eecc6d6449e4f7cfb1c2708,2022-11-22T00:00:00.000Z,NEFT DR-ICIC0006643-KRISHNA PACKAGING CO,,,net_banking_transfer,-50000
63bfb2a92e1a0ebb7f629901,50200023535069,-191959.02,60ec41ba55c00300382672d9,HDFC,direct expenses,5eecc6d6449e4f7cfb1c2708,2022-11-22T00:00:00.000Z,NEFT DR-BKID0007124-MATRIX PRINTING SOLU TIONS PVT LTD-SANDOZ - MUM-N326222215249 127-NET BANKING SI -50000,,,net_banking_transfer,-50000
63bfb2a92e1a0ebb7f629903,50200023535069,-303823.02,60ec41ba55c00300382672d9,HDFC,direct expenses,5eecc6d6449e4f7cfb1c2708,2022-11-22T00:00:00.000Z,NEFT DR-YESB0000551-VISTTA COSMETICS-SAN DOZ - MUM-N326222215249128-NET BANKING S I -111864,,,net_banking_transfer,-111864
63bfb2a92e1a0ebb7f629906,50200023535069,-353823.02,60ec41ba55c00300382672d9,HDFC,direct expenses,5eecc6d6449e4f7cfb1c2708,2022-11-22T00:00:00.000Z,NEFT DR-YESB0000551-VISTTA COSMETICS-SAN DOZ - MUM-N326222215249129-NET BANKING S I -50000,,,net_banking_transfer,-50000
63bfb2a92e1a0ebb7f629908,50200023535069,-157048.1,60ec41ba55c00300382672d9,HDFC,Revenue-Mktplace,5eecc6d6449e4f7cfb1c2708,2022-11-22T00:00:00.000Z,IMPS-232605133495-AMAZON SELLER SERVIC-H SBC-XXXXXXXX6004-6D7KDWDJ1KV0UBSTSLICK O RGANICS PVT LTD,shopping,,net_banking_transfer,196774.92
63bfb2a92e1a0ebb7f62990a,50200023535069,399477.46,60ec41ba55c00300382672d9,HDFC,Revenue-Mktplace,5eecc6d6449e4f7cfb1c2708,2022-11-22T00:00:00.000Z,NEFT CR-DEUT0797BGL-AMAZON PAY (INDIA) P RIVATE LIMITED-SLICK ORGANICS PVT LTD-23 2600152GN00412,shopping,,net_banking_transfer,556525.56
63bfb2a92e1a0ebb7f62990c,50200023535069,408522.91,60ec41ba55c00300382672d9,HDFC,Revenue-Mktplace,5eecc6d6449e4f7cfb1c2708,2022-11-22T00:00:00.000Z,NEFT CR-DEUT0797BGL-MYNTRA DESIGNS PRIVA TE LIMITED-SLICK ORGANICS - SJIT-2326004 01GN00197,shopping,,net_banking_transfer,9045.45
63bfb2a92e1a0ebb7f62990e,50200023535069,423676.93,60ec41ba55c00300382672d9,HDFC,Revenue-Mktplace,5eecc6d6449e4f7cfb1c2708,2022-11-22T00:00:00.000Z,NEFT CR-DEUT0797BGL-MYNTRA DESIGNS PRIVA TE LIMITED-SLICK ORGANICS - SJIT-2326004 00GN00222,shopping,,net_banking_transfer,15154.02
63bfb2a92e1a0ebb7f629910,50200023535069,420676.93,60ec41ba55c00300382672d9,HDFC,direct expenses,5eecc6d6449e4f7cfb1c2708,2022-11-22T00:00:00.000Z,"NEFT DR-UTIB0000032-SKUMAR MULTIPRODUCTS PVT LTD-NETBANK, MUM-N326222215454005-3 000",,,net_banking_transfer,-3000
63bfb2a92e1a0ebb7f629912,50200023535069,430079.39,60ec41ba55c00300382672d9,HDFC,Revenue-Mktplace,5eecc6d6449e4f7cfb1c2708,2022-11-22T00:00:00.000Z,NEFT CR-DEUT0797BGL-MYNTRA DESIGNS PRIVA TE LIMITED-SLICK ORGANICS PVT. LTD.-2326 00420GN00024,shopping,,net_banking_transfer,9402.46
63bfb2a92e1a0ebb7f629914,50200023535069,438820.36,60ec41ba55c00300382672d9,HDFC,Revenue-PG-split enabled,5eecc6d6449e4f7cfb1c2708,2022-11-22T00:00:00.000Z,NEFT CR-UTIB0001506-RAZORPAY SOFTWARE PR IVATE LIMITED-SLICK ORGANICS PVT LITD-AX ISCN0183440320,,,net_banking_transfer,8740.97
63bfb2a92e1a0ebb7f629916,50200023535069,433482.36,60ec41ba55c00300382672d9,HDFC,direct expenses,5eecc6d6449e4f7cfb1c2708,2022-11-22T00:00:00.000Z,NEFT DR-ICIC0000021-AKHILESH DIXIT-NETBA,,,net_banking_transfer,-5338
63bfb2a92e1a0ebb7f629918,50200023535069,352482.36,60ec41ba55c00300382672d9,HDFC,direct expenses,5eecc6d6449e4f7cfb1c2708,2022-11-22T00:00:00.000Z,50200054531492-TPT-81000-ALETA PEOPLE SE RVICES,,,net_banking_transfer,-81000
63bfb2a92e1a0ebb7f62991a,50200023535069,-147517.64,60ec41ba55c00300382672d9,HDFC,Marketing Expense,5eecc6d6449e4f7cfb1c2708,2022-11-22T00:00:00.000Z,"NEFT DR-CITI0000006-FACEBOOK INDIA ONLIN E SERVICES PVT LTD-NETBANK, MUM-N3262222 15589131-500000",,,net_banking_transfer,-500000
63bfb2a92e1a0ebb7f62991c,50200023535069,-347517.64,60ec41ba55c00300382672d9,HDFC,direct expenses,5eecc6d6449e4f7cfb1c2708,2022-11-22T00:00:00.000Z,"NEFT DR-ICIC0000024-TAKE MOTO YOHKI INDI A PRIVATE LIMITED-NETBANK, MUM-N32622221 5590351-200000",travel,,net_banking_transfer,-200000
63bfb2a92e1a0ebb7f62991e,50200023535069,-347518.64,60ec41ba55c00300382672d9,HDFC,direct expenses,5eecc6d6449e4f7cfb1c2708,2022-11-22T00:00:00.000Z,ME DC SI 514834XXXXXX9486 SHOPIFY LTD,,,Other,-1
63bfb2a92e1a0ebb7f629920,50200023535069,-364706.64,60ec41ba55c00300382672d9,HDFC,direct expenses,5eecc6d6449e4f7cfb1c2708,2022-11-22T00:00:00.000Z,00918630000430-TPT-17188-UNICOMMERCE ESO LUTIONS PRIVATE LIMITED,,,net_banking_transfer,-17188
63bfb2a92e1a0ebb7f629922,50200023535069,1317734.94,60ec41ba55c00300382672d9,HDFC,Revenue-Mktplace,5eecc6d6449e4f7cfb1c2708,2022-11-22T00:00:00.000Z,NEFT CR-KKBK0000958-NYKAA E RETAIL PRIVA TE LIMITED NYKAA-SLICK ORGANICS PVT LTD- KKBK223269635839,,,net_banking_transfer,1682441.58
63bfb2a92e1a0ebb7f629924,50200023535069,1305234.94,60ec41ba55c00300382672d9,HDFC,direct expenses,5eecc6d6449e4f7cfb1c2708,2022-11-22T00:00:00.000Z,"NEFT DR-SBIN0032160-KARISHMA NAVLANI-NET BANK, MUM-N326222215845303-12500",,,net_banking_transfer,-12500
63bfb2a92e1a0ebb7f629926,50200023535069,1303248.94,60ec41ba55c00300382672d9,HDFC,SAAS/tech expense,5eecc6d6449e4f7cfb1c2708,2022-11-22T00:00:00.000Z,12022320000801-TPT-1986-DELHIVERY LIMITE D,,,net_banking_transfer,-1986
63bfb2a92e1a0ebb7f629928,50200023535069,1306651.47,60ec41ba55c00300382672d9,HDFC,Transfer in/Revenue-other,5eecc6d6449e4f7cfb1c2708,2022-11-22T00:00:00.000Z,NEFT CR-UTIB0000114-ONE SIGMA TECHNOLOGI ES PRIVATE LIM-SLICK ORGANICS PRIVATE LI MITED-AXISP00339534215,,,net_banking_transfer,3402.53
63bfb2a92e1a0ebb7f62992a,50200023535069,1347003.66,60ec41ba55c00300382672d9,HDFC,Transfer in/Revenue-other,5eecc6d6449e4f7cfb1c2708,2022-11-22T00:00:00.000Z,NEFT CR-YESB0000001-EASEBUZZ PVT LTD NOD AL A/C-SLICK ORGANICS PVT LTD-YESB232655 60941,,,net_banking_transfer,40352.19
63bfb2a92e1a0ebb7f62992c,50200023535069,1387604.06,60ec41ba55c00300382672d9,HDFC,Revenue-Mktplace,5eecc6d6449e4f7cfb1c2708,2022-11-22T00:00:00.000Z,NEFT CR-SCBL0036001-THREPSI SOLUTIONS PR IVATE LIMITED-SLICK ORGANICS PRIVATE LIM ITED-IN1ON22112202J6D,,,net_banking_transfer,40600.4
63bfb2a92e1a0ebb7f62992e,50200023535069,1399201.73,60ec41ba55c00300382672d9,HDFC,Revenue-PG-split enabled,5eecc6d6449e4f7cfb1c2708,2022-11-22T00:00:00.000Z,NEFT CR-UTIB0001506-RAZORPAY SOFTWARE PR IVATE LIMITED-SLICK ORGANICS PVT LITD-AX ISCN0183621625,,,net_banking_transfer,11597.67
63bfb2a92e1a0ebb7f629930,50200023535069,1429620.31,60ec41ba55c00300382672d9,HDFC,Revenue-Mktplace,5eecc6d6449e4f7cfb1c2708,2022-11-23T00:00:00.000Z,NEFT CR-DEUT0797BGL-FLIPKART INTERNET PR,shopping,,net_banking_transfer,30418.58
63bfb2a92e1a0ebb7f629932,50200023535069,1442414.07,60ec41ba55c00300382672d9,HDFC,Revenue-PG-non-split,5eecc6d6449e4f7cfb1c2708,2022-11-23T00:00:00.000Z,NEFT CR-PYTM0123456-PAYTM PAYMENTS SERVI CES LIMITED-SLICK ORGANICS PVT LTD-PYTM2 23276575697,ewallet,,net_banking_transfer,12793.76
63bfb2a92e1a0ebb7f629935,50200023535069,1443905.6,60ec41ba55c00300382672d9,HDFC,Revenue-Mktplace,5eecc6d6449e4f7cfb1c2708,2022-11-23T00:00:00.000Z,NEFT CR-DEUT0797BGL-MYNTRA DESIGNS PRIVA TE LIMITED-SLICK ORGANICS - SJIT-2327008 40GN00161,shopping,,net_banking_transfer,1491.53
63bfb2a92e1a0ebb7f629937,50200023535069,1446657.21,60ec41ba55c00300382672d9,HDFC,Revenue-Mktplace,5eecc6d6449e4f7cfb1c2708,2022-11-23T00:00:00.000Z,NEFT CR-DEUT0797BGL-MYNTRA DESIGNS PRIVA TE LIMITED-SLICK ORGANICS - SJIT-2327008 41GN00185,shopping,,net_banking_transfer,2751.61
63bfb2a92e1a0ebb7f629939,50200023535069,1448107.39,60ec41ba55c00300382672d9,HDFC,Revenue-Mktplace,5eecc6d6449e4f7cfb1c2708,2022-11-23T00:00:00.000Z,NEFT CR-DEUT0797BGL-MYNTRA DESIGNS PRIVA TE LIMITED-SLICK ORGANICS PVT. LTD.-2327 00859GN00293,shopping,,net_banking_transfer,1450.18
63bfb2a92e1a0ebb7f62993c,50200023535069,1456628.25,60ec41ba55c00300382672d9,HDFC,Revenue-PG-split enabled,5eecc6d6449e4f7cfb1c2708,2022-11-23T00:00:00.000Z,NEFT CR-UTIB0001506-RAZORPAY SOFTWARE PR IVATE LIMITED-SLICK ORGANICS PVT LITD-AX ISCN0183697866,,,net_banking_transfer,8520.86
63bfb2a92e1a0ebb7f62993e,50200023535069,1484349.04,60ec41ba55c00300382672d9,HDFC,Revenue-Mktplace,5eecc6d6449e4f7cfb1c2708,2022-11-23T00:00:00.000Z,NEFT CR-HSBC0400002-AMAZON SERVICES LLC- SLICK ORGANICS PRIVATE LIMITED-HSBCN2232 7255967,shopping,,net_banking_transfer,27720.79
63bfb2a92e1a0ebb7f629940,50200023535069,1334882.04,60ec41ba55c00300382672d9,HDFC,direct expenses,5eecc6d6449e4f7cfb1c2708,2022-11-23T00:00:00.000Z,"NEFT DR-BARB0MOHAMP-MARKETING MANTRA SOL UTIONS-NETBANK, MUM-N327222217187747-149 467",,,net_banking_transfer,-149467
63bfb2a92e1a0ebb7f629942,50200023535069,1315082.04,60ec41ba55c00300382672d9,HDFC,direct expenses,5eecc6d6449e4f7cfb1c2708,2022-11-23T00:00:00.000Z,50100536534119-TPT-19800-MITHIL KAPOOR,,,net_banking_transfer,-19800
63bfb2a92e1a0ebb7f629944,50200023535069,1305878.04,60ec41ba55c00300382672d9,HDFC,direct expenses,5eecc6d6449e4f7cfb1c2708,2022-11-23T00:00:00.000Z,"NEFT DR-SBIN0008078-PANDIT PLASTICS-NETB ANK, MUM-N327222217261870-9204",,,net_banking_transfer,-9204
63bfb2a92e1a0ebb7f629946,50200023535069,1321345.04,60ec41ba55c00300382672d9,HDFC,Transfer in/Revenue-other,5eecc6d6449e4f7cfb1c2708,2022-11-23T00:00:00.000Z,NEFT CR-ICIC0SF0002-ENRICH HAIR - SKIN S -SLICK ORGANICS PRIVATE LIMITED-30166198 881DC,,,net_banking_transfer,15467
63bfb2aa2e1a0ebb7f629948,50200023535069,1325277.48,60ec41ba55c00300382672d9,HDFC,Transfer in/Revenue-other,5eecc6d6449e4f7cfb1c2708,2022-11-23T00:00:00.000Z,NEFT CR-UTIB0000114-ONE SIGMA TECHNOLOGI,,,net_banking_transfer,3932.44
63bfb2aa2e1a0ebb7f62994a,50200023535069,1325114.47,60ec41ba55c00300382672d9,HDFC,bank charges,5eecc6d6449e4f7cfb1c2708,2022-11-23T00:00:00.000Z,.DC INTL POS TXN MARKUP+ST 121122 141122 -CDT2230512020599,,,international_transaction_arbitrage,-163.01
63bfb2aa2e1a0ebb7f62994c,50200023535069,1354917.27,60ec41ba55c00300382672d9,HDFC,Transfer in/Revenue-other,5eecc6d6449e4f7cfb1c2708,2022-11-23T00:00:00.000Z,NEFT CR-YESB0000001-EASEBUZZ PVT LTD NOD AL A/C-SLICK ORGANICS PVT LTD-YESB232784 48419,,,net_banking_transfer,29802.8
63bfb2aa2e1a0ebb7f62994e,50200023535069,1364952.64,60ec41ba55c00300382672d9,HDFC,Revenue-PG-split enabled,5eecc6d6449e4f7cfb1c2708,2022-11-23T00:00:00.000Z,NEFT CR-UTIB0001506-RAZORPAY SOFTWARE PR IVATE LIMITED-SLICK ORGANICS PVT LITD-AX ISCN0183851097,,,net_banking_transfer,10035.37
63bfb2aa2e1a0ebb7f629950,50200023535069,1396694.64,60ec41ba55c00300382672d9,HDFC,Transfer in/Revenue-other,5eecc6d6449e4f7cfb1c2708,2022-11-23T00:00:00.000Z,FT- REMITTANCE OG OCT22-50200050675669 - HOUZ OF NATURE PVT LTD -,,,Other,31742
63bfb2aa2e1a0ebb7f629952,50200023535069,1407747.43,60ec41ba55c00300382672d9,HDFC,Revenue-PG-non-split,5eecc6d6449e4f7cfb1c2708,2022-11-24T00:00:00.000Z,NEFT CR-PYTM0123456-PAYTM PAYMENTS SERVI CES LIMITED-SLICK ORGANICS PVT LTD-PYTM2 23287872684,ewallet,,net_banking_transfer,11052.79
63bfb2aa2e1a0ebb7f629955,50200023535069,1427847.3,60ec41ba55c00300382672d9,HDFC,Revenue-PG-split enabled,5eecc6d6449e4f7cfb1c2708,2022-11-24T00:00:00.000Z,NEFT CR-UTIB0001506-RAZORPAY SOFTWARE PR IVATE LIMITED-SLICK ORGANICS PVT LITD-AX ISCN0183941762,,,net_banking_transfer,20099.87
63bfb2aa2e1a0ebb7f629957,50200023535069,1424150.91,60ec41ba55c00300382672d9,HDFC,Marketing Expense,5eecc6d6449e4f7cfb1c2708,2022-11-24T00:00:00.000Z,ME DC SI 514834XXXXXX9486 LINKEDIN (PGSI ),,,Other,-3696.39
63bfb2aa2e1a0ebb7f629959,50200023535069,1428864.76,60ec41ba55c00300382672d9,HDFC,Transfer in/Revenue-other,5eecc6d6449e4f7cfb1c2708,2022-11-24T00:00:00.000Z,NEFT CR-UTIB0000114-ONE SIGMA TECHNOLOGI ES PRIVATE LIM-SLICK ORGANICS PRIVATE LI MITED-AXISP00340059434,,,net_banking_transfer,4713.85
63bfb2aa2e1a0ebb7f62995b,50200023535069,1426125.76,60ec41ba55c00300382672d9,HDFC,direct expenses,5eecc6d6449e4f7cfb1c2708,2022-11-24T00:00:00.000Z,POS 514834XXXXXX9486 SMARTSHIFT LOGIS,,,debit_card,-2739
63bfb2aa2e1a0ebb7f62995d,50200023535069,1428747.76,60ec41ba55c00300382672d9,HDFC,Revenue-Mktplace,5eecc6d6449e4f7cfb1c2708,2022-11-24T00:00:00.000Z,NEFT CR-SCBL0036001-DREAMPLUG TECHNOLOGI ES PRIVATE LIMITED-SLICK ORGANICS PRIVAT E LIMITEDSLICK-IN1ON22112401IXS,,,net_banking_transfer,2622
63bfb2aa2e1a0ebb7f62995f,50200023535069,1457657.76,60ec41ba55c00300382672d9,HDFC,Transfer in/Revenue-other,5eecc6d6449e4f7cfb1c2708,2022-11-24T00:00:00.000Z,NEFT CR-YESB0000001-EASEBUZZ PVT LTD NOD AL A/C-SLICK ORGANICS PVT LTD-YESB232808 94777,,,net_banking_transfer,28910
63bfb2aa2e1a0ebb7f629961,50200023535069,1510186.27,60ec41ba55c00300382672d9,HDFC,Revenue-PG-split enabled,5eecc6d6449e4f7cfb1c2708,2022-11-24T00:00:00.000Z,NEFT CR-UTIB0001506-RAZORPAY SOFTWARE PR,,,net_banking_transfer,52528.51
63bfb2aa2e1a0ebb7f629963,50200023535069,1410186.27,60ec41ba55c00300382672d9,HDFC,direct expenses,5eecc6d6449e4f7cfb1c2708,2022-11-25T00:00:00.000Z,NEFT DR-KKBK0000180-VEDIC COSMECEUTICALS PVT LTD-SANDOZ - MUM-N329222219341873-N ET BANKING SI -100000,,,net_banking_transfer,-100000
63bfb2aa2e1a0ebb7f629965,50200023535069,1432964.66,60ec41ba55c00300382672d9,HDFC,Revenue-Mktplace,5eecc6d6449e4f7cfb1c2708,2022-11-25T00:00:00.000Z,NEFT CR-DEUT0797BGL-FLIPKART INTERNET PR IVATE LIMITED-SLICK ORGANICS PVT LTD-232 900260GN00173,shopping,,net_banking_transfer,22778.39
63bfb2aa2e1a0ebb7f629967,50200023535069,1440837.62,60ec41ba55c00300382672d9,HDFC,Revenue-Mktplace,5eecc6d6449e4f7cfb1c2708,2022-11-25T00:00:00.000Z,NEFT CR-DEUT0797BGL-MYNTRA DESIGNS PRIVA TE LIMITED-SLICK ORGANICS - SJIT-2329009 65GN00211,shopping,,net_banking_transfer,7872.96
63bfb2aa2e1a0ebb7f629969,50200023535069,1444290.24,60ec41ba55c00300382672d9,HDFC,Revenue-Mktplace,5eecc6d6449e4f7cfb1c2708,2022-11-25T00:00:00.000Z,NEFT CR-DEUT0797BGL-MYNTRA DESIGNS PRIVA TE LIMITED-SLICK ORGANICS - SJIT-2329009 66GN00193,shopping,,net_banking_transfer,3452.62
63bfb2aa2e1a0ebb7f62996b,50200023535069,1515933.4,60ec41ba55c00300382672d9,HDFC,Revenue-PG-non-split,5eecc6d6449e4f7cfb1c2708,2022-11-25T00:00:00.000Z,NEFT CR-PYTM0123456-PAYTM PAYMENTS SERVI CES LIMITED-SLICK ORGANICS PVT LTD-PYTM2 23299691643,ewallet,,net_banking_transfer,71643.16
63bfb2aa2e1a0ebb7f62996d,50200023535069,1526804.18,60ec41ba55c00300382672d9,HDFC,Revenue-Mktplace,5eecc6d6449e4f7cfb1c2708,2022-11-25T00:00:00.000Z,NEFT CR-DEUT0797BGL-MYNTRA DESIGNS PRIVA TE LIMITED-SLICK ORGANICS PVT. LTD.-2329 01003GN00274,shopping,,net_banking_transfer,10870.78
63bfb2aa2e1a0ebb7f62996f,50200023535069,1573401.07,60ec41ba55c00300382672d9,HDFC,Revenue-PG-split enabled,5eecc6d6449e4f7cfb1c2708,2022-11-25T00:00:00.000Z,NEFT CR-UTIB0001506-RAZORPAY SOFTWARE PR IVATE LIMITED-SLICK ORGANICS PVT LITD-AX ISCN0184274961,,,net_banking_transfer,46596.89
63bfb2aa2e1a0ebb7f629971,50200023535069,1550101.07,60ec41ba55c00300382672d9,HDFC,direct expenses,5eecc6d6449e4f7cfb1c2708,2022-11-25T00:00:00.000Z,"NEFT DR-ICIC0006293-NIRITY NICKUNG SHAH- NETBANK, MUM-N329222219578816-23300",,,net_banking_transfer,-23300
63bfb2aa2e1a0ebb7f629973,50200023535069,1550895.47,60ec41ba55c00300382672d9,HDFC,Transfer in/Revenue-other,5eecc6d6449e4f7cfb1c2708,2022-11-25T00:00:00.000Z,NEFT CR-UTIB0000114-ONE SIGMA TECHNOLOGI ES PRIVATE LIM-SLICK ORGANICS PRIVATE LI MITED-AXISP00340321706,,,net_banking_transfer,794.4
63bfb2aa2e1a0ebb7f629975,50200023535069,1589584.45,60ec41ba55c00300382672d9,HDFC,Transfer in/Revenue-other,5eecc6d6449e4f7cfb1c2708,2022-11-25T00:00:00.000Z,NEFT CR-YESB0000001-EASEBUZZ PVT LTD NOD AL A/C-SLICK ORGANICS PVT LTD-YESB232935 18010,,,net_banking_transfer,38688.98
63bfb2aa2e1a0ebb7f629977,50200023535069,1633505.62,60ec41ba55c00300382672d9,HDFC,Revenue-PG-split enabled,5eecc6d6449e4f7cfb1c2708,2022-11-25T00:00:00.000Z,NEFT CR-UTIB0001506-RAZORPAY SOFTWARE PR,,,net_banking_transfer,43921.17
63bfb2aa2e1a0ebb7f629979,50200023535069,1634155.62,60ec41ba55c00300382672d9,HDFC,Transfer in/Revenue-other,5eecc6d6449e4f7cfb1c2708,2022-11-25T00:00:00.000Z,FT - CHQ NO - 000821 - AMT-1540036-16FTS CR - 50200038726231 - HOUSE OF BEAUTY P RIVATE LIMITED,,,Other,650
63bfb2aa2e1a0ebb7f62997b,50200023535069,1716978.73,60ec41ba55c00300382672d9,HDFC,Revenue-PG-non-split,5eecc6d6449e4f7cfb1c2708,2022-11-26T00:00:00.000Z,NEFT CR-PYTM0123456-PAYTM PAYMENTS SERVI CES LIMITED-SLICK ORGANICS PVT LTD-PYTM2 23301610359,ewallet,,net_banking_transfer,82823.11
63bfb2aa2e1a0ebb7f62997d,50200023535069,1716306.96,60ec41ba55c00300382672d9,HDFC,Marketing Expense,5eecc6d6449e4f7cfb1c2708,2022-11-26T00:00:00.000Z,ME DC SI 514834XXXXXX9486 FACEBOOK SI,,,Other,-671.77
63bfb2aa2e1a0ebb7f62997f,50200023535069,1374935.96,60ec41ba55c00300382672d9,HDFC,direct expenses,5eecc6d6449e4f7cfb1c2708,2022-11-26T00:00:00.000Z,50200020787428-TPT-341371-SHRI AKSHARA F ILMS,,,net_banking_transfer,-341371
63bfb2aa2e1a0ebb7f629981,50200023535069,1374936.96,60ec41ba55c00300382672d9,HDFC,Transfer in/Revenue-other,5eecc6d6449e4f7cfb1c2708,2022-11-26T00:00:00.000Z,CRV POS 514834******9486 SHOPIFY LTD,,,refund,1
63bfb2aa2e1a0ebb7f629983,50200023535069,1426208.45,60ec41ba55c00300382672d9,HDFC,Revenue-PG-non-split,5eecc6d6449e4f7cfb1c2708,2022-11-27T00:00:00.000Z,NEFT CR-PYTM0123456-PAYTM PAYMENTS SERVI CES LIMITED-SLICK ORGANICS PVT LTD-PYTM2 23313044286,ewallet,,net_banking_transfer,51271.49
63bfb2aa2e1a0ebb7f629985,50200023535069,1405992.71,60ec41ba55c00300382672d9,HDFC,direct expenses,5eecc6d6449e4f7cfb1c2708,2022-11-27T00:00:00.000Z,POS 514834XXXXXX9486 PLAYBOOK.COM,,,debit_card,-20215.74
63bfb2aa2e1a0ebb7f629987,50200023535069,1476123.94,60ec41ba55c00300382672d9,HDFC,Revenue-PG-non-split,5eecc6d6449e4f7cfb1c2708,2022-11-28T00:00:00.000Z,NEFT CR-PYTM0123456-PAYTM PAYMENTS SERVI CES LIMITED-SLICK ORGANICS PVT LTD-PYTM2 23324885268,ewallet,,net_banking_transfer,70131.23
63bfb2aa2e1a0ebb7f629989,50200023535069,1529229.65,60ec41ba55c00300382672d9,HDFC,Revenue-Mktplace,5eecc6d6449e4f7cfb1c2708,2022-11-28T00:00:00.000Z,NEFT CR-DEUT0797BGL-FLIPKART INTERNET PR IVATE LIMITED-SLICK ORGANICS PVT LTD-233 200148GN00021,shopping,,net_banking_transfer,53105.71
63bfb2aa2e1a0ebb7f62998b,50200023535069,1539521.21,60ec41ba55c00300382672d9,HDFC,Revenue-Mktplace,5eecc6d6449e4f7cfb1c2708,2022-11-28T00:00:00.000Z,NEFT CR-DEUT0797BGL-MYNTRA DESIGNS PRIVA TE LIMITED-SLICK ORGANICS - SJIT-2332008 00GN00174,shopping,,net_banking_transfer,10291.56
63bfb2aa2e1a0ebb7f62998d,50200023535069,1765132.34,60ec41ba55c00300382672d9,HDFC,Revenue-PG-split enabled,5eecc6d6449e4f7cfb1c2708,2022-11-28T00:00:00.000Z,RTGS CR-UTIB0001506-RAZORPAY SOFTWARE PR IVATE LIMITED --SLICK ORGANICS PVT LITD- UTIBR52022112800337677,,,net_banking_transfer,225611.13
63bfb2aa2e1a0ebb7f62998f,50200023535069,1792447.34,60ec41ba55c00300382672d9,HDFC,Transfer in/Revenue-other,5eecc6d6449e4f7cfb1c2708,2022-11-28T00:00:00.000Z,NEFT CR-HSBC0560002-INNOVATIVE RETAIL CO NCEPTS PRIVATE-SLICK ORGANICS PVT LTD-HS BCN22332930746,,,net_banking_transfer,27315
63bfb2aa2e1a0ebb7f629991,50200023535069,1642447.34,60ec41ba55c00300382672d9,HDFC,direct expenses,5eecc6d6449e4f7cfb1c2708,2022-11-28T00:00:00.000Z,NEFT DR-YESB0000551-VISTTA COSMETICS-NET,,,net_banking_transfer,-150000
63bfb2aa2e1a0ebb7f629993,50200023535069,1636167.34,60ec41ba55c00300382672d9,HDFC,direct expenses,5eecc6d6449e4f7cfb1c2708,2022-11-28T00:00:00.000Z,POS 514834XXXXXX9486 GROFERS INDIA PR,groceries,,debit_card,-6280
63bfb2aa2e1a0ebb7f629995,50200023535069,1636165.34,60ec41ba55c00300382672d9,HDFC,Marketing Expense,5eecc6d6449e4f7cfb1c2708,2022-11-28T00:00:00.000Z,ME DC SI 514834XXXXXX9486 LINKEDIN,,,Other,-2
63bfb2aa2e1a0ebb7f629997,50200023535069,1640244.34,60ec41ba55c00300382672d9,HDFC,Transfer in/Revenue-other,5eecc6d6449e4f7cfb1c2708,2022-11-28T00:00:00.000Z,50200050241205-TPT-ARATA-NAPSA PRIVATE L IMITED,,,net_banking_transfer,4079
63bfb2aa2e1a0ebb7f629999,50200023535069,1642979.85,60ec41ba55c00300382672d9,HDFC,Transfer in/Revenue-other,5eecc6d6449e4f7cfb1c2708,2022-11-28T00:00:00.000Z,NEFT CR-CITI0000004-ONE SIGMA TECHNOLOGI ES PVT LTD-SLICK ORGANICS PRIVATE LIMITE D-CITIN22371060860,,,net_banking_transfer,2735.51
63bfb2aa2e1a0ebb7f62999b,50200023535069,1648660.89,60ec41ba55c00300382672d9,HDFC,Transfer in/Revenue-other,5eecc6d6449e4f7cfb1c2708,2022-11-28T00:00:00.000Z,NEFT CR-CITI0000004-ONE SIGMA TECHNOLOGI ES PVT LTD-SLICK ORGANICS PRIVATE LIMITE D-CITIN22371061340,,,net_banking_transfer,5681.04
63bfb2aa2e1a0ebb7f62999d,50200023535069,1648657.89,60ec41ba55c00300382672d9,HDFC,Marketing Expense,5eecc6d6449e4f7cfb1c2708,2022-11-28T00:00:00.000Z,ME DC SI 514834XXXXXX9486 FACEBOOK INDIA ONLINE,,,Other,-3
63bfb2aa2e1a0ebb7f62999f,50200023535069,1681882.35,60ec41ba55c00300382672d9,HDFC,Revenue-COD,5eecc6d6449e4f7cfb1c2708,2022-11-28T00:00:00.000Z,NEFT CR-ICIC0000155-SHIPROCKET COD CRF I D 5258771-SLICK ORGANICS PVT LTD-CMS2969 987599,,,net_banking_transfer,33224.46
63bfb2aa2e1a0ebb7f6299a1,50200023535069,1742506.98,60ec41ba55c00300382672d9,HDFC,Revenue-PG-split enabled,5eecc6d6449e4f7cfb1c2708,2022-11-28T00:00:00.000Z,NEFT CR-UTIB0001506-RAZORPAY SOFTWARE PR IVATE LIMITED-SLICK ORGANICS PVT LITD-AX ISCN0184883974,,,net_banking_transfer,60624.63
63bfb2aa2e1a0ebb7f6299a3,50200023535069,1875752.62,60ec41ba55c00300382672d9,HDFC,Transfer in/Revenue-other,5eecc6d6449e4f7cfb1c2708,2022-11-28T00:00:00.000Z,NEFT CR-YESB0000001-EASEBUZZ PVT LTD NOD AL A/C-SLICK ORGANICS PVT LTD-YESB233212 24111,,,net_banking_transfer,133245.64
63bfb2aa2e1a0ebb7f6299a5,50200023535069,1884027.14,60ec41ba55c00300382672d9,HDFC,Revenue-Mktplace,5eecc6d6449e4f7cfb1c2708,2022-11-28T00:00:00.000Z,NEFT CR-DEUT0797BGL-MYNTRA DESIGNS PRIVA TE LIMITED-SLICK ORGANICS - SJIT-2332017 76GN00227,shopping,,net_banking_transfer,8274.52
63bfb2aa2e1a0ebb7f6299a7,50200023535069,1914477.68,60ec41ba55c00300382672d9,HDFC,Revenue-Mktplace,5eecc6d6449e4f7cfb1c2708,2022-11-28T00:00:00.000Z,NEFT CR-DEUT0797BGL-MYNTRA DESIGNS PRIVA TE LIMITED-SLICK ORGANICS PVT. LTD.-2332 01781GN00011,shopping,,net_banking_transfer,30450.54
63bfb2aa2e1a0ebb7f6299aa,50200023535069,1958772.15,60ec41ba55c00300382672d9,HDFC,Revenue-PG-non-split,5eecc6d6449e4f7cfb1c2708,2022-11-29T00:00:00.000Z,NEFT CR-PYTM0123456-PAYTM PAYMENTS SERVI CES LIMITED-SLICK ORGANICS PVT LTD-PYTM2 23336571263,ewallet,,net_banking_transfer,44294.47
63bfb2aa2e1a0ebb7f6299ac,50200023535069,1919222.15,60ec41ba55c00300382672d9,HDFC,Salary/Emp/consultant Expense,5eecc6d6449e4f7cfb1c2708,2022-11-29T00:00:00.000Z,NEFT DR-UTIB0000404-ELIZABETH THOMAS ALE,,,net_banking_transfer,-39550
63bfb2aa2e1a0ebb7f6299ae,50200023535069,1742071.15,60ec41ba55c00300382672d9,HDFC,direct expenses,5eecc6d6449e4f7cfb1c2708,2022-11-29T00:00:00.000Z,NEFT DR-SRCB0000281-3D TECHNOPACK PRIVAT E LIMITED-SANDOZ - MUM-N333222223076383- NET BANKING SI -177151,,,net_banking_transfer,-177151
63bfb2aa2e1a0ebb7f6299b0,50200023535069,1667391.15,60ec41ba55c00300382672d9,HDFC,direct expenses,5eecc6d6449e4f7cfb1c2708,2022-11-29T00:00:00.000Z,NEFT DR-SRCB0000281-3D TECHNOPACK PRIVAT E LIMITED-SANDOZ - MUM-N333222223076384- NET BANKING SI -74680,,,net_banking_transfer,-74680
63bfb2aa2e1a0ebb7f6299b2,50200023535069,1605272.15,60ec41ba55c00300382672d9,HDFC,direct expenses,5eecc6d6449e4f7cfb1c2708,2022-11-29T00:00:00.000Z,NEFT DR-UTIB0001696-EMIZA SUPPLY CHAIN S ERVICES PRIVATE LIMI-SANDOZ - MUM-N33322 2223076385-NET BANKING SI -62119,,,net_banking_transfer,-62119
63bfb2aa2e1a0ebb7f6299b4,50200023535069,1182345.15,60ec41ba55c00300382672d9,HDFC,Marketing Expense,5eecc6d6449e4f7cfb1c2708,2022-11-29T00:00:00.000Z,NEFT DR-CITI0000006-FACEBOOK INDIA ONLIN E SERVICES PVT LTD-SANDOZ - MUM-N3332222 23076386-NET BANKING SI -422927,,,net_banking_transfer,-422927
63bfb2aa2e1a0ebb7f6299b6,50200023535069,1362449,60ec41ba55c00300382672d9,HDFC,Revenue-Mktplace,5eecc6d6449e4f7cfb1c2708,2022-11-29T00:00:00.000Z,IMPS-233305385937-AMAZON SELLER SERVIC-H SBC-XXXXXXXX6004-71LXEE77300JIX9DSLICK O RGANICS PVT LTD,shopping,,net_banking_transfer,180103.85
63bfb2aa2e1a0ebb7f6299b9,50200023535069,1885127.07,60ec41ba55c00300382672d9,HDFC,Revenue-Mktplace,5eecc6d6449e4f7cfb1c2708,2022-11-29T00:00:00.000Z,NEFT CR-DEUT0797BGL-AMAZON PAY (INDIA) P RIVATE LIMITED-SLICK ORGANICS PVT LTD-23 3300389GN00143,shopping,,net_banking_transfer,522678.07
63bfb2aa2e1a0ebb7f6299bb,50200023535069,1873407.07,60ec41ba55c00300382672d9,HDFC,direct expenses,5eecc6d6449e4f7cfb1c2708,2022-11-29T00:00:00.000Z,POS 514834XXXXXX9486 PTM*PAYTM,ewallet,,debit_card,-11720
63bfb2aa2e1a0ebb7f6299bd,50200023535069,1623407.07,60ec41ba55c00300382672d9,HDFC,direct expenses,5eecc6d6449e4f7cfb1c2708,2022-11-29T00:00:00.000Z,"NEFT DR-ICIC0000369-BO INTERNATIONAL-NET BANK, MUM-N333222223264717-250000",,,net_banking_transfer,-250000
63bfb2ab2e1a0ebb7f6299bf,50200023535069,1585079.07,60ec41ba55c00300382672d9,HDFC,direct expenses,5eecc6d6449e4f7cfb1c2708,2022-11-29T00:00:00.000Z,"NEFT DR-ICIC0006643-KRISHNA PACKAGING CO MPANY-NETBANK, MUM-N333222223269082-3832 8",,,net_banking_transfer,-38328
63bfb2ab2e1a0ebb7f6299c1,50200023535069,1557791.07,60ec41ba55c00300382672d9,HDFC,direct expenses,5eecc6d6449e4f7cfb1c2708,2022-11-29T00:00:00.000Z,"NEFT DR-ICIC0006643-KRISHNA PACKAGING CO MPANY-NETBANK, MUM-N333222223264999-2728 8",,,net_banking_transfer,-27288
63bfb2ab2e1a0ebb7f6299c3,50200023535069,1496733.07,60ec41ba55c00300382672d9,HDFC,direct expenses,5eecc6d6449e4f7cfb1c2708,2022-11-29T00:00:00.000Z,NEFT DR-BKID0007124-MATRIX PRINTING SOLU,,,net_banking_transfer,-61058
63bfb2ab2e1a0ebb7f6299c5,50200023535069,1396733.07,60ec41ba55c00300382672d9,HDFC,Marketing Expense,5eecc6d6449e4f7cfb1c2708,2022-11-29T00:00:00.000Z,"NEFT DR-CITI0000006-FACEBOOK INDIA ONLIN E SERVICES PVT LTD-NETBANK, MUM-N3332222 23277880-100000",,,net_banking_transfer,-100000
63bfb2ab2e1a0ebb7f6299c7,50200023535069,1235733.07,60ec41ba55c00300382672d9,HDFC,direct expenses,5eecc6d6449e4f7cfb1c2708,2022-11-29T00:00:00.000Z,57500000443889-TPT-161000-WEBKLIPPER TEC HNOLOGIES PRIVATE LIMITED,,,net_banking_transfer,-161000
63bfb2ab2e1a0ebb7f6299c9,50200023535069,1268408.35,60ec41ba55c00300382672d9,HDFC,Revenue-PG-split enabled,5eecc6d6449e4f7cfb1c2708,2022-11-29T00:00:00.000Z,NEFT CR-UTIB0001506-RAZORPAY SOFTWARE PR IVATE LIMITED-SLICK ORGANICS PVT LITD-AX ISCN0184962495,,,net_banking_transfer,32675.28
63bfb2ab2e1a0ebb7f6299cb,50200023535069,968408.35,60ec41ba55c00300382672d9,HDFC,Tax,5eecc6d6449e4f7cfb1c2708,2022-11-29T00:00:00.000Z,051030829112214693- CBDT TAX,,,Other,-300000
63bfb2ab2e1a0ebb7f6299cd,50200023535069,868408.35,60ec41ba55c00300382672d9,HDFC,direct expenses,5eecc6d6449e4f7cfb1c2708,2022-11-29T00:00:00.000Z,"NEFT DR-YESB0000551-VISTTA COSMETICS-NET BANK, MUM-N333222223548100-100000",,,net_banking_transfer,-100000
63bfb2ab2e1a0ebb7f6299cf,50200023535069,866509.85,60ec41ba55c00300382672d9,HDFC,direct expenses,5eecc6d6449e4f7cfb1c2708,2022-11-29T00:00:00.000Z,"NEFT DR-FDRL0001027-SUMAYYA JAHAN J S-NE TBANK, MUM-N333222223559469-1899",,,net_banking_transfer,-1898.5
63bfb2ab2e1a0ebb7f6299d1,50200023535069,846009.85,60ec41ba55c00300382672d9,HDFC,direct expenses,5eecc6d6449e4f7cfb1c2708,2022-11-29T00:00:00.000Z,"NEFT DR-KKBK0000208-SYSCOM PACKAGING COM PANY-NETBANK, MUM-N333222223637831-20500",,,net_banking_transfer,-20500
63bfb2ab2e1a0ebb7f6299d3,50200023535069,834677.85,60ec41ba55c00300382672d9,HDFC,direct expenses,5eecc6d6449e4f7cfb1c2708,2022-11-29T00:00:00.000Z,"NEFT DR-YESB0000551-VISTTA COSMETICS-NET BANK, MUM-N333222223644229-11332",,,net_banking_transfer,-11332
63bfb2ab2e1a0ebb7f6299d5,50200023535069,734677.85,60ec41ba55c00300382672d9,HDFC,direct expenses,5eecc6d6449e4f7cfb1c2708,2022-11-29T00:00:00.000Z,"NEFT DR-UTIB0000514-NATS ASSOCIATES-NETB ANK, MUM-N333222223801035-100000",,,net_banking_transfer,-100000
63bfb2ab2e1a0ebb7f6299d8,50200023535069,740251.05,60ec41ba55c00300382672d9,HDFC,Transfer in/Revenue-other,5eecc6d6449e4f7cfb1c2708,2022-11-29T00:00:00.000Z,NEFT CR-CITI0000004-ONE SIGMA TECHNOLOGI ES PVT LTD-SLICK ORGANICS PRIVATE LIMITE D-CITIN22371591392,,,net_banking_transfer,5573.2
63bfb2ab2e1a0ebb7f6299da,50200023535069,780905.51,60ec41ba55c00300382672d9,HDFC,Transfer in/Revenue-other,5eecc6d6449e4f7cfb1c2708,2022-11-29T00:00:00.000Z,NEFT CR-YESB0000001-EASEBUZZ PVT LTD NOD AL A/C-SLICK ORGANICS PVT LTD-YESB233337 46020,,,net_banking_transfer,40654.46
63bfb2ab2e1a0ebb7f6299dc,50200023535069,778876.51,60ec41ba55c00300382672d9,HDFC,direct expenses,5eecc6d6449e4f7cfb1c2708,2022-11-29T00:00:00.000Z,POS 514834XXXXXX9486 ADOBE CREATIVE C,,,debit_card,-2029
63bfb2ab2e1a0ebb7f6299de,50200023535069,801789.51,60ec41ba55c00300382672d9,HDFC,Revenue-Mktplace,5eecc6d6449e4f7cfb1c2708,2022-11-29T00:00:00.000Z,NEFT CR-ICIC0000985-DIGITAL AGE RETAIL P VT LTD-SLICK ORGANICS PVT LTD-CMS2970966 297,,,net_banking_transfer,22913
63bfb2ab2e1a0ebb7f6299e0,50200023535069,809124.41,60ec41ba55c00300382672d9,HDFC,Revenue-PG-split enabled,5eecc6d6449e4f7cfb1c2708,2022-11-29T00:00:00.000Z,NEFT CR-UTIB0001506-RAZORPAY SOFTWARE PR,,,net_banking_transfer,7334.9
63bfb2ab2e1a0ebb7f6299e2,50200023535069,820509.18,60ec41ba55c00300382672d9,HDFC,Revenue-Mktplace,5eecc6d6449e4f7cfb1c2708,2022-11-29T00:00:00.000Z,NEFT CR-SCBL0036001-THREPSI SOLUTIONS PR IVATE LIMITED-SLICK ORGANICS PRIVATE LIM ITED-IN1ON22112909X57,,,net_banking_transfer,11384.77
63bfb2ab2e1a0ebb7f6299e4,50200023535069,820845.91,60ec41ba55c00300382672d9,HDFC,Revenue-Mktplace,5eecc6d6449e4f7cfb1c2708,2022-11-29T00:00:00.000Z,NEFT CR-DEUT0797BGL-MYNTRA DESIGNS PRIVA TE LIMITED-SLICK ORGANICS - SJIT-2333014 43GN00160,shopping,,net_banking_transfer,336.73
63bfb2ab2e1a0ebb7f6299e6,50200023535069,813887.75,60ec41ba55c00300382672d9,HDFC,direct expenses,5eecc6d6449e4f7cfb1c2708,2022-11-29T00:00:00.000Z,POS 514834XXXXXX9486 THE LEELA MUMBAI,,,debit_card,-6958.16
63bfb2ab2e1a0ebb7f6299e8,50200023535069,831364.73,60ec41ba55c00300382672d9,HDFC,Revenue-PG-non-split,5eecc6d6449e4f7cfb1c2708,2022-11-30T00:00:00.000Z,NEFT CR-PYTM0123456-PAYTM PAYMENTS SERVI CES LIMITED-SLICK ORGANICS PVT LTD-PYTM2 23348386503,ewallet,,net_banking_transfer,17476.98
63bfb2ab2e1a0ebb7f6299ea,50200023535069,820178.33,60ec41ba55c00300382672d9,HDFC,direct expenses,5eecc6d6449e4f7cfb1c2708,2022-11-30T00:00:00.000Z,POS 514834XXXXXX9486 THE LEELA MUMBAI,,,debit_card,-11186.4
63bfb2ab2e1a0ebb7f6299ec,50200023535069,839774.2,60ec41ba55c00300382672d9,HDFC,Revenue-PG-split enabled,5eecc6d6449e4f7cfb1c2708,2022-11-30T00:00:00.000Z,NEFT CR-UTIB0001506-RAZORPAY SOFTWARE PR IVATE LIMITED-SLICK ORGANICS PVT LITD-AX ISCN0185254870,,,net_banking_transfer,19595.87
63bfb2ab2e1a0ebb7f6299ee,50200023535069,837050.17,60ec41ba55c00300382672d9,HDFC,Marketing Expense,5eecc6d6449e4f7cfb1c2708,2022-11-30T00:00:00.000Z,ME DC SI 514834XXXXXX9486 LINKEDIN (PGSI ),,,Other,-2724.03
63bfb2ab2e1a0ebb7f6299f0,50200023535069,812050.17,60ec41ba55c00300382672d9,HDFC,direct expenses,5eecc6d6449e4f7cfb1c2708,2022-11-30T00:00:00.000Z,"NEFT DR-ICIC0000004-MUKESH GOYAL-NETBANK , MUM-N334222225332799-25000",,,net_banking_transfer,-25000
63bfb2ab2e1a0ebb7f6299f2,50200023535069,811784.17,60ec41ba55c00300382672d9,HDFC,direct expenses,5eecc6d6449e4f7cfb1c2708,2022-11-30T00:00:00.000Z,POS 514834XXXXXX9486 PAYTM_ADDMONEYTO,ewallet,,debit_card,-266
63bfb2ab2e1a0ebb7f6299f4,50200023535069,811456.17,60ec41ba55c00300382672d9,HDFC,direct expenses,5eecc6d6449e4f7cfb1c2708,2022-11-30T00:00:00.000Z,POS 514834XXXXXX9486 SMARTSHIFT LOGIS,,,debit_card,-328
63bfb2ab2e1a0ebb7f6299f6,50200023535069,808977.17,60ec41ba55c00300382672d9,HDFC,direct expenses,5eecc6d6449e4f7cfb1c2708,2022-11-30T00:00:00.000Z,POS 514834XXXXXX9486 CAFE DELHI HEIGH,food,,debit_card,-2479
63bfb2ab2e1a0ebb7f6299f8,50200023535069,809474.59,60ec41ba55c00300382672d9,HDFC,Transfer in/Revenue-other,5eecc6d6449e4f7cfb1c2708,2022-11-30T00:00:00.000Z,NEFT CR-CITI0000004-ONE SIGMA TECHNOLOGI ES PVT LTD-SLICK ORGANICS PRIVATE LIMITE D-CITIN22374710161,,,net_banking_transfer,497.42
63bfb2ab2e1a0ebb7f6299fa,50200023535069,821731.47,60ec41ba55c00300382672d9,HDFC,Transfer in/Revenue-other,5eecc6d6449e4f7cfb1c2708,2022-11-30T00:00:00.000Z,NEFT CR-YESB0000001-EASEBUZZ PVT LTD NOD AL A/C-SLICK ORGANICS PVT LTD-YESB233468 44331,,,net_banking_transfer,12256.88
63bfb2ab2e1a0ebb7f6299fc,50200023535069,818041.47,60ec41ba55c00300382672d9,HDFC,direct expenses,5eecc6d6449e4f7cfb1c2708,2022-11-30T00:00:00.000Z,POS 514834XXXXXX9486 PAYTM_ADDMONEYTO,ewallet,,debit_card,-3690
63bfb2ab2e1a0ebb7f6299fe,50200023535069,829705.8,60ec41ba55c00300382672d9,HDFC,Revenue-PG-split enabled,5eecc6d6449e4f7cfb1c2708,2022-11-30T00:00:00.000Z,NEFT CR-UTIB0001506-RAZORPAY SOFTWARE PR IVATE LIMITED-SLICK ORGANICS PVT LITD-AX ISCN0185444204,,,net_banking_transfer,11664.33
63bfb2ab2e1a0ebb7f629a00,50200023535069,829526.8,60ec41ba55c00300382672d9,HDFC,SAAS/tech expense,5eecc6d6449e4f7cfb1c2708,2022-11-30T00:00:00.000Z,ME DC SI 514834XXXXXX9486 AMAZON,shopping,,Other,-179
63bfb2ab2e1a0ebb7f629a02,50200023535069,837997.35,60ec41ba55c00300382672d9,HDFC,Revenue-PG-non-split,5eecc6d6449e4f7cfb1c2708,2022-12-01T00:00:00.000Z,NEFT CR-PYTM0123456-PAYTM PAYMENTS SERVI CES LIMITED-SLICK ORGANICS PVT LTD-PYTM2 23350382188,ewallet,,net_banking_transfer,8470.55
63bfb2ab2e1a0ebb7f629a04,50200023535069,-12268.65,60ec41ba55c00300382672d9,HDFC,direct expenses,5eecc6d6449e4f7cfb1c2708,2022-12-01T00:00:00.000Z,02711600008220 NET BANKING SI -850266,,,Other,-850266
63bfb2ab2e1a0ebb7f629a06,50200023535069,-58168.65,60ec41ba55c00300382672d9,HDFC,direct expenses,5eecc6d6449e4f7cfb1c2708,2022-12-01T00:00:00.000Z,50200063349422 NET BANKING SI -45900,,,Other,-45900
63bfb2ab2e1a0ebb7f629a08,50200023535069,-73168.65,60ec41ba55c00300382672d9,HDFC,direct expenses,5eecc6d6449e4f7cfb1c2708,2022-12-01T00:00:00.000Z,50100159819386 NET BANKING SI -15000,,,Other,-15000
63bfb2ab2e1a0ebb7f629a0a,50200023535069,-832346.65,60ec41ba55c00300382672d9,HDFC,Marketing Expense,5eecc6d6449e4f7cfb1c2708,2022-12-01T00:00:00.000Z,NEFT DR-CITI0100000-GOOGLE INDIA PVT LTD -SANDOZ - MUM-N335222227101086-NET BANKI NG SI -759178,,,net_banking_transfer,-759178
63bfb2ab2e1a0ebb7f629a0c,50200023535069,-875253.65,60ec41ba55c00300382672d9,HDFC,direct expenses,5eecc6d6449e4f7cfb1c2708,2022-12-01T00:00:00.000Z,NEFT DR-KKBK0000664-SHRADDHA DINESH SHU KLA-SANDOZ - MUM-N335222227101087-NET BA NKING SI -42907,,,net_banking_transfer,-42907
63bfb2ab2e1a0ebb7f629a0e,50200023535069,-983253.65,60ec41ba55c00300382672d9,HDFC,direct expenses,5eecc6d6449e4f7cfb1c2708,2022-12-01T00:00:00.000Z,NEFT DR-BARB0VJMATU-ARTISTO DESIGNZ-SAND OZ - MUM-N335222227101089-NET BANKING SI -108000,,,net_banking_transfer,-108000
63bfb2ab2e1a0ebb7f629a10,50200023535069,-1060253.65,60ec41ba55c00300382672d9,HDFC,direct expenses,5eecc6d6449e4f7cfb1c2708,2022-12-01T00:00:00.000Z,NEFT DR-DBSS0IN0811-SARANSH KULKARNI-SAN DOZ - MUM-N335222227101090-NET BANKING S I -77000,,,net_banking_transfer,-77000
63bfb2ab2e1a0ebb7f629a12,50200023535069,-1085253.65,60ec41ba55c00300382672d9,HDFC,direct expenses,5eecc6d6449e4f7cfb1c2708,2022-12-01T00:00:00.000Z,NEFT DR-CNRB0015170-SNEHAL TAYDE-SANDOZ - MUM-N335222227101093-NET BANKING SI -2 5000,,,net_banking_transfer,-25000
63bfb2ab2e1a0ebb7f629a15,50200023535069,-1112253.65,60ec41ba55c00300382672d9,HDFC,direct expenses,5eecc6d6449e4f7cfb1c2708,2022-12-01T00:00:00.000Z,NEFT DR-KKBK0000654-NIHARIKA MISHRA-SAND OZ - MUM-N335222227101095-NET BANKING SI -27000,,,net_banking_transfer,-27000
63bfb2ab2e1a0ebb7f629a18,50200023535069,-1131603.65,60ec41ba55c00300382672d9,HDFC,agency/vendor expense,5eecc6d6449e4f7cfb1c2708,2022-12-01T00:00:00.000Z,NEFT DR-UTIB0003557-INCOSEC LEGAL-SANDOZ - MUM-N335222227101098-NET BANKING SI - 19350,,,net_banking_transfer,-19350
63bfb2ab2e1a0ebb7f629a1b,50200023535069,-1209903.65,60ec41ba55c00300382672d9,HDFC,direct expenses,5eecc6d6449e4f7cfb1c2708,2022-12-01T00:00:00.000Z,NEFT DR-KKBK0005289-HILL GROOVE CONSULTI,,,net_banking_transfer,-78300
63bfb2ab2e1a0ebb7f629a1d,50200023535069,-1402763.65,60ec41ba55c00300382672d9,HDFC,direct expenses,5eecc6d6449e4f7cfb1c2708,2022-12-01T00:00:00.000Z,NEFT DR-UTIB0000119-SAFEXPRESS-SANDOZ - MUM-N335222227101102-NET BANKING SI -192 860,,,net_banking_transfer,-192860
63bfb2ab2e1a0ebb7f629a21,50200023535069,-1434057.65,60ec41ba55c00300382672d9,HDFC,direct expenses,5eecc6d6449e4f7cfb1c2708,2022-12-01T00:00:00.000Z,NEFT DR-UTIB0000119-SAFEXPRESS-SANDOZ - MUM-N335222227101103-NET BANKING SI -312 94,,,net_banking_transfer,-31294
63bfb2ab2e1a0ebb7f629a23,50200023535069,-1689057.65,60ec41ba55c00300382672d9,HDFC,direct expenses,5eecc6d6449e4f7cfb1c2708,2022-12-01T00:00:00.000Z,NEFT DR-ICIC0000004-HEMANT GUPTA-SANDOZ - MUM-N335222227101105-NET BANKING SI -2 55000,,,net_banking_transfer,-255000
63bfb2ab2e1a0ebb7f629a25,50200023535069,-1703057.65,60ec41ba55c00300382672d9,HDFC,direct expenses,5eecc6d6449e4f7cfb1c2708,2022-12-01T00:00:00.000Z,NEFT DR-ICIC0000715-GAJENDRA BAHADUR SIN GH-SANDOZ - MUM-N335222227101106-NET BAN KING SI -14000,,,net_banking_transfer,-14000
63bfb2ab2e1a0ebb7f629a27,50200023535069,-1710057.65,60ec41ba55c00300382672d9,HDFC,direct expenses,5eecc6d6449e4f7cfb1c2708,2022-12-01T00:00:00.000Z,NEFT DR-UTIB0000682-NICOLE ROSEANNE B SA NGMA-SANDOZ - MUM-N335222227101107-NET B ANKING SI -7000,,,net_banking_transfer,-7000
63bfb2ab2e1a0ebb7f629a29,50200023535069,-1701473.58,60ec41ba55c00300382672d9,HDFC,Revenue-PG-split enabled,5eecc6d6449e4f7cfb1c2708,2022-12-01T00:00:00.000Z,NEFT CR-UTIB0001506-RAZORPAY SOFTWARE PR IVATE LIMITED-SLICK ORGANICS PVT LITD-AX ISCN0185574242,,,net_banking_transfer,8584.07
63bfb2ab2e1a0ebb7f629a2b,50200023535069,-1711685.58,60ec41ba55c00300382672d9,HDFC,direct expenses,5eecc6d6449e4f7cfb1c2708,2022-12-01T00:00:00.000Z,50200059134559-TPT-10212-ALL THINGS,,,net_banking_transfer,-10212
63bfb2ab2e1a0ebb7f629a2e,50200023535069,-1711020.21,60ec41ba55c00300382672d9,HDFC,Revenue-Mktplace,5eecc6d6449e4f7cfb1c2708,2022-12-01T00:00:00.000Z,NEFT CR-DEUT0797BGL-MYNTRA DESIGNS PRIVA TE LIMITED-SLICK ORGANICS - SJIT-2335006 30GN00188,shopping,,net_banking_transfer,665.37
63bfb2ab2e1a0ebb7f629a30,50200023535069,-1706608.39,60ec41ba55c00300382672d9,HDFC,Revenue-Mktplace,5eecc6d6449e4f7cfb1c2708,2022-12-01T00:00:00.000Z,NEFT CR-DEUT0797BGL-MYNTRA DESIGNS PRIVA TE LIMITED-SLICK ORGANICS PVT. LTD.-2335 00666GN00249,shopping,,net_banking_transfer,4411.82
63bfb2ab2e1a0ebb7f629a32,50200023535069,-1692595.03,60ec41ba55c00300382672d9,HDFC,Revenue-Mktplace,5eecc6d6449e4f7cfb1c2708,2022-12-01T00:00:00.000Z,NEFT CR-DEUT0797BGL-MYNTRA DESIGNS PRIVA TE LIMITED-SLICK ORGANICS PVT. LTD.-2335 00666GN00268,shopping,,net_banking_transfer,14013.36
63bfb2ab2e1a0ebb7f629a34,50200023535069,-1692067.98,60ec41ba55c00300382672d9,HDFC,Revenue-Mktplace,5eecc6d6449e4f7cfb1c2708,2022-12-01T00:00:00.000Z,NEFT CR-DEUT0797BGL-MYNTRA DESIGNS PRIVA TE LIMITED-SLICK ORGANICS - SJIT-2335006 49GN00128,shopping,,net_banking_transfer,527.05
63bfb2ab2e1a0ebb7f629a36,50200023535069,-1689525.53,60ec41ba55c00300382672d9,HDFC,Revenue-Mktplace,5eecc6d6449e4f7cfb1c2708,2022-12-01T00:00:00.000Z,NEFT CR-DEUT0797BGL-MYNTRA DESIGNS PRIVA,shopping,,net_banking_transfer,2542.45
63bfb2ab2e1a0ebb7f629a38,50200023535069,-1695968.53,60ec41ba55c00300382672d9,HDFC,direct expenses,5eecc6d6449e4f7cfb1c2708,2022-12-01T00:00:00.000Z,50200059134559-TPT-6443-ALL THINGS,,,net_banking_transfer,-6443
63bfb2ab2e1a0ebb7f629a3a,50200023535069,-1698173.53,60ec41ba55c00300382672d9,HDFC,direct expenses,5eecc6d6449e4f7cfb1c2708,2022-12-01T00:00:00.000Z,"NEFT DR-BARB0SUSGUR-GREENIECAN INDIA-NET BANK, MUM-N335222227370666-2205",,,net_banking_transfer,-2205
63bfb2ac2e1a0ebb7f629a3d,50200023535069,-1714474.15,60ec41ba55c00300382672d9,HDFC,direct expenses,5eecc6d6449e4f7cfb1c2708,2022-12-01T00:00:00.000Z,POS 514834XXXXXX9486 SHOPIFY* 1593166,,,debit_card,-16300.62
63bfb2ac2e1a0ebb7f629a3f,50200023535069,-1712883.4,60ec41ba55c00300382672d9,HDFC,Transfer in/Revenue-other,5eecc6d6449e4f7cfb1c2708,2022-12-01T00:00:00.000Z,NEFT CR-UTIB0000114-ONE SIGMA TECHNOLOGI ES PRIVATE LIM-SLICK ORGANICS PRIVATE LI MITED-AXISP00342217217,bnpl,,net_banking_transfer,1590.75
63bfb2ac2e1a0ebb7f629a41,50200023535069,-2212883.4,60ec41ba55c00300382672d9,HDFC,direct expenses,5eecc6d6449e4f7cfb1c2708,2022-12-01T00:00:00.000Z,"NEFT DR-ICIC0000369-BO INTERNATIONAL-NET BANK, MUM-N335222227947640-500000",,,net_banking_transfer,-500000
63bfb2ac2e1a0ebb7f629a43,50200023535069,-2213844.4,60ec41ba55c00300382672d9,HDFC,direct expenses,5eecc6d6449e4f7cfb1c2708,2022-12-01T00:00:00.000Z,"NEFT DR-UBIN0541214-GUPTA STATIONERY SUI TE-NETBANK, MUM-N335222227964863-961",,,net_banking_transfer,-961
63bfb2ac2e1a0ebb7f629a45,50200023535069,-2214844.4,60ec41ba55c00300382672d9,HDFC,direct expenses,5eecc6d6449e4f7cfb1c2708,2022-12-01T00:00:00.000Z,POS 514834XXXXXX9486 SMARTSHIFT LOGIS,,,debit_card,-1000
63bfb2ac2e1a0ebb7f629a47,50200023535069,-2215714.4,60ec41ba55c00300382672d9,HDFC,direct expenses,5eecc6d6449e4f7cfb1c2708,2022-12-01T00:00:00.000Z,POS 514834XXXXXX9486 SMARTSHIFT LOGIS,,,debit_card,-870
63bfb2ac2e1a0ebb7f629a49,50200023535069,-2215997.4,60ec41ba55c00300382672d9,HDFC,direct expenses,5eecc6d6449e4f7cfb1c2708,2022-12-01T00:00:00.000Z,POS 514834XXXXXX9486 PAYTM_ADDMONEYTO,ewallet,,debit_card,-283
63bfb2ac2e1a0ebb7f629a4b,50200023535069,-2205904.48,60ec41ba55c00300382672d9,HDFC,Transfer in/Revenue-other,5eecc6d6449e4f7cfb1c2708,2022-12-01T00:00:00.000Z,NEFT CR-YESB0000001-EASEBUZZ PVT LTD NOD AL A/C-SLICK ORGANICS PVT LTD-YESB233599 18388,,,net_banking_transfer,10092.92
63bfb2ac2e1a0ebb7f629a4d,50200023535069,-2198578.97,60ec41ba55c00300382672d9,HDFC,Revenue-PG-split enabled,5eecc6d6449e4f7cfb1c2708,2022-12-01T00:00:00.000Z,NEFT CR-UTIB0001506-RAZORPAY SOFTWARE PR IVATE LIMITED-SLICK ORGANICS PVT LITD-AX ISCN0185759096,,,net_banking_transfer,7325.51
63bfb2ac2e1a0ebb7f629a50,50200023535069,-2198575.97,60ec41ba55c00300382672d9,HDFC,Transfer in/Revenue-other,5eecc6d6449e4f7cfb1c2708,2022-12-01T00:00:00.000Z,CRV POS 514834******9486 FACEBOOK INDIA,,,refund,3
63bfb2ac2e1a0ebb7f629a53,50200023535069,-2198573.97,60ec41ba55c00300382672d9,HDFC,Transfer in/Revenue-other,5eecc6d6449e4f7cfb1c2708,2022-12-01T00:00:00.000Z,CRV POS 514834******9486 LINKEDIN,,,refund,2
63bfb2ac2e1a0ebb7f629a55,50200023535069,-2198555.97,60ec41ba55c00300382672d9,HDFC,Transfer in/Revenue-other,5eecc6d6449e4f7cfb1c2708,2022-12-02T00:00:00.000Z,INT. ON SWCR ON-50300699243918,,,Other,18
63bfb2ac2e1a0ebb7f629a57,50200023535069,-2186286.97,60ec41ba55c00300382672d9,HDFC,Loan-in,5eecc6d6449e4f7cfb1c2708,2022-12-02T00:00:00.000Z,SWEEP-IN CREDIT - 50300699243918,,,self_transfer,12269
63bfb2ac2e1a0ebb7f629a59,50200023535069,-2186218.97,60ec41ba55c00300382672d9,HDFC,Transfer in/Revenue-other,5eecc6d6449e4f7cfb1c2708,2022-12-02T00:00:00.000Z,INT. ON SWCR ON-50300699243918,,,Other,68
63bfb2ac2e1a0ebb7f629a5b,50200023535069,-2140318.97,60ec41ba55c00300382672d9,HDFC,Loan-in,5eecc6d6449e4f7cfb1c2708,2022-12-02T00:00:00.000Z,SWEEP-IN CREDIT - 50300699243918,,,self_transfer,45900
63bfb2ac2e1a0ebb7f629a5d,50200023535069,-2140296.97,60ec41ba55c00300382672d9,HDFC,Transfer in/Revenue-other,5eecc6d6449e4f7cfb1c2708,2022-12-02T00:00:00.000Z,INT. ON SWCR ON-50300699243918,,,Other,22
63bfb2ac2e1a0ebb7f629a5f,50200023535069,-2125296.97,60ec41ba55c00300382672d9,HDFC,Loan-in,5eecc6d6449e4f7cfb1c2708,2022-12-02T00:00:00.000Z,SWEEP-IN CREDIT - 50300699243918,,,self_transfer,15000
63bfb2ac2e1a0ebb7f629a61,50200023535069,-2125292.97,60ec41ba55c00300382672d9,HDFC,Transfer in/Revenue-other,5eecc6d6449e4f7cfb1c2708,2022-12-02T00:00:00.000Z,INT. ON SWCR ON-50300699243918,,,Other,4
63bfb2ac2e1a0ebb7f629a64,50200023535069,-2122503.97,60ec41ba55c00300382672d9,HDFC,Loan-in,5eecc6d6449e4f7cfb1c2708,2022-12-02T00:00:00.000Z,SWEEP-IN CREDIT - 50300699243918,,,self_transfer,2789
63bfb2ac2e1a0ebb7f629a66,50200023535069,-2120081.97,60ec41ba55c00300382672d9,HDFC,Transfer in/Revenue-other,5eecc6d6449e4f7cfb1c2708,2022-12-02T00:00:00.000Z,INT. ON SWCR ON-50300699243918,,,Other,2422
63bfb2ac2e1a0ebb7f629a68,50200023535069,-483192.97,60ec41ba55c00300382672d9,HDFC,Loan-in,5eecc6d6449e4f7cfb1c2708,2022-12-02T00:00:00.000Z,SWEEP-IN CREDIT - 50300699243918,,,self_transfer,1636889
63bfb2ac2e1a0ebb7f629a6a,50200023535069,-483188.97,60ec41ba55c00300382672d9,HDFC,Transfer in/Revenue-other,5eecc6d6449e4f7cfb1c2708,2022-12-02T00:00:00.000Z,INT. ON SWCR ON-50300684649760,,,Other,4
63bfb2ac2e1a0ebb7f629a6c,50200023535069,-482188.97,60ec41ba55c00300382672d9,HDFC,Loan-in,5eecc6d6449e4f7cfb1c2708,2022-12-02T00:00:00.000Z,SWEEP-IN CREDIT - 50300684649760,,,self_transfer,1000
63bfb2ac2e1a0ebb7f629a6e,50200023535069,-482185.97,60ec41ba55c00300382672d9,HDFC,Transfer in/Revenue-other,5eecc6d6449e4f7cfb1c2708,2022-12-02T00:00:00.000Z,INT. ON SWCR ON-50300684649760,,,Other,3
63bfb2ac2e1a0ebb7f629a70,50200023535069,-481315.97,60ec41ba55c00300382672d9,HDFC,Loan-in,5eecc6d6449e4f7cfb1c2708,2022-12-02T00:00:00.000Z,SWEEP-IN CREDIT - 50300684649760,,,self_transfer,870
63bfb2ac2e1a0ebb7f629a72,50200023535069,-481314.97,60ec41ba55c00300382672d9,HDFC,Transfer in/Revenue-other,5eecc6d6449e4f7cfb1c2708,2022-12-02T00:00:00.000Z,INT. ON SWCR ON-50300684649760,,,Other,1
63bfb2ac2e1a0ebb7f629a74,50200023535069,-481031.97,60ec41ba55c00300382672d9,HDFC,Loan-in,5eecc6d6449e4f7cfb1c2708,2022-12-02T00:00:00.000Z,SWEEP-IN CREDIT - 50300684649760,,,self_transfer,283
63bfb2ac2e1a0ebb7f629a76,50200023535069,-481029.97,60ec41ba55c00300382672d9,HDFC,Transfer in/Revenue-other,5eecc6d6449e4f7cfb1c2708,2022-12-02T00:00:00.000Z,INT. ON SWCR ON-50300699243918,,,Other,2
63bfb2ac2e1a0ebb7f629a78,50200023535069,-479401.97,60ec41ba55c00300382672d9,HDFC,Loan-in,5eecc6d6449e4f7cfb1c2708,2022-12-02T00:00:00.000Z,SWEEP-IN CREDIT - 50300699243918,,,self_transfer,1628
63bfb2ac2e1a0ebb7f629a7a,50200023535069,-478995.97,60ec41ba55c00300382672d9,HDFC,Transfer in/Revenue-other,5eecc6d6449e4f7cfb1c2708,2022-12-02T00:00:00.000Z,INT. ON SWCR ON-50300699243918,,,Other,406
63bfb2ac2e1a0ebb7f629a7c,50200023535069,-204524.97,60ec41ba55c00300382672d9,HDFC,Loan-in,5eecc6d6449e4f7cfb1c2708,2022-12-02T00:00:00.000Z,SWEEP-IN CREDIT - 50300699243918,,,self_transfer,274471
63bfb2ac2e1a0ebb7f629a7e,50200023535069,-203730.97,60ec41ba55c00300382672d9,HDFC,Transfer in/Revenue-other,5eecc6d6449e4f7cfb1c2708,2022-12-02T00:00:00.000Z,INT. ON SWCR ON-50300684649760,,,Other,794
63bfb2ac2e1a0ebb7f629a80,50200023535069,794.03,60ec41ba55c00300382672d9,HDFC,Loan-in,5eecc6d6449e4f7cfb1c2708,2022-12-02T00:00:00.000Z,SWEEP-IN CREDIT - 50300684649760,,,self_transfer,204525
63bfb2ac2e1a0ebb7f629a82,50200023535069,12098.23,60ec41ba55c00300382672d9,HDFC,Revenue-PG-non-split,5eecc6d6449e4f7cfb1c2708,2022-12-02T00:00:00.000Z,NEFT CR-PYTM0123456-PAYTM PAYMENTS SERVI CES LIMITED-SLICK ORGANICS PVT LTD-PYTM2 23361802644,ewallet,,net_banking_transfer,11304.2
63bfb2ac2e1a0ebb7f629a84,50200023535069,58062.35,60ec41ba55c00300382672d9,HDFC,Revenue-Mktplace,5eecc6d6449e4f7cfb1c2708,2022-12-02T00:00:00.000Z,NEFT CR-DEUT0797BGL-FLIPKART INTERNET PR IVATE LIMITED-SLICK ORGANICS PVT LTD-233 600209GN00071,shopping,,net_banking_transfer,45964.12
63bfb2ac2e1a0ebb7f629a86,50200023535069,58354.15,60ec41ba55c00300382672d9,HDFC,Revenue-Mktplace,5eecc6d6449e4f7cfb1c2708,2022-12-02T00:00:00.000Z,NEFT CR-DEUT0797BGL-MYNTRA DESIGNS PRIVA TE LIMITED-SLICK ORGANICS - SJIT-2336008 40GN00205,shopping,,net_banking_transfer,291.8
63bfb2ac2e1a0ebb7f629a89,50200023535069,63298.45,60ec41ba55c00300382672d9,HDFC,Revenue-Mktplace,5eecc6d6449e4f7cfb1c2708,2022-12-02T00:00:00.000Z,NEFT CR-DEUT0797BGL-MYNTRA DESIGNS PRIVA TE LIMITED-SLICK ORGANICS PVT. LTD.-2336 00852GN00002,shopping,,net_banking_transfer,4944.3
63bfb2ac2e1a0ebb7f629a8b,50200023535069,63480.68,60ec41ba55c00300382672d9,HDFC,Revenue-Mktplace,5eecc6d6449e4f7cfb1c2708,2022-12-02T00:00:00.000Z,NEFT CR-DEUT0797BGL-MYNTRA DESIGNS PRIVA TE LIMITED-SLICK ORGANICS - SJIT-2336009 03GN00158,shopping,,net_banking_transfer,182.23
63bfb2ac2e1a0ebb7f629a8d,50200023535069,73940.67,60ec41ba55c00300382672d9,HDFC,Revenue-PG-split enabled,5eecc6d6449e4f7cfb1c2708,2022-12-02T00:00:00.000Z,NEFT CR-UTIB0001506-RAZORPAY SOFTWARE PR,,,net_banking_transfer,10459.99
63bfb2ac2e1a0ebb7f629a8f,50200023535069,68940.67,60ec41ba55c00300382672d9,HDFC,direct expenses,5eecc6d6449e4f7cfb1c2708,2022-12-02T00:00:00.000Z,"NEFT DR-SBIN0007755-KENDRIYA POLICE KALY AN BHANDAR-NETBANK, MUM-N336222229407003 -5000",,,net_banking_transfer,-5000
63bfb2ac2e1a0ebb7f629a91,50200023535069,63032.67,60ec41ba55c00300382672d9,HDFC,direct expenses,5eecc6d6449e4f7cfb1c2708,2022-12-02T00:00:00.000Z,50200051022608-TPT-5908-MAATI SU,,,net_banking_transfer,-5908
63bfb2ac2e1a0ebb7f629a93,50200023535069,58307.67,60ec41ba55c00300382672d9,HDFC,direct expenses,5eecc6d6449e4f7cfb1c2708,2022-12-02T00:00:00.000Z,"NEFT DR-BARB0VJBCPL-GS1 INDIA-NETBANK, M UM-N336222229499083-4725",,,net_banking_transfer,-4725
63bfb2ac2e1a0ebb7f629a95,50200023535069,53382.25,60ec41ba55c00300382672d9,HDFC,direct expenses,5eecc6d6449e4f7cfb1c2708,2022-12-02T00:00:00.000Z,POS 514834XXXXXX9486 AMZ*MARKETING SV,,,debit_card,-4925.42
63bfb2ac2e1a0ebb7f629a97,50200023535069,54105.68,60ec41ba55c00300382672d9,HDFC,Transfer in/Revenue-other,5eecc6d6449e4f7cfb1c2708,2022-12-02T00:00:00.000Z,NEFT CR-UTIB0000114-ONE SIGMA TECHNOLOGI ES PRIVATE LIM-SLICK ORGANICS PRIVATE LI MITED-AXISP00342644389,bnpl,,net_banking_transfer,723.43
63bfb2ac2e1a0ebb7f629a99,50200023535069,4105.68,60ec41ba55c00300382672d9,HDFC,N-ACH payments,5eecc6d6449e4f7cfb1c2708,2022-12-02T00:00:00.000Z,"NEFT DR-ICIC0001136-AKHILESH BACHCHAN-NE TBANK, MUM-N336222230011047-50000",,,net_banking_transfer,-50000
63bfb2ac2e1a0ebb7f629a9d,50200023535069,14143.7,60ec41ba55c00300382672d9,HDFC,Transfer in/Revenue-other,5eecc6d6449e4f7cfb1c2708,2022-12-02T00:00:00.000Z,NEFT CR-YESB0000001-EASEBUZZ PVT LTD NOD AL A/C-SLICK ORGANICS PVT LTD-YESB233629 29751,,,net_banking_transfer,10038.02
63bfb2ac2e1a0ebb7f629a9f,50200023535069,40344.92,60ec41ba55c00300382672d9,HDFC,Revenue-PG-split enabled,5eecc6d6449e4f7cfb1c2708,2022-12-02T00:00:00.000Z,NEFT CR-UTIB0001506-RAZORPAY SOFTWARE PR IVATE LIMITED-SLICK ORGANICS PVT LITD-AX ISCN0186103849,,,net_banking_transfer,26201.22
63bfb2ac2e1a0ebb7f629aa1,50200023535069,62210.19,60ec41ba55c00300382672d9,HDFC,Revenue-COD,5eecc6d6449e4f7cfb1c2708,2022-12-02T00:00:00.000Z,NEFT CR-ICIC0000155-SHIPROCKET COD CRF I D 5291395-SLICK ORGANICS PVT LTD-CMS2981 387085,,,net_banking_transfer,21865.27
63bfb2ac2e1a0ebb7f629aa3,50200023535069,28009.21,60ec41ba55c00300382672d9,HDFC,SAAS/tech expense,5eecc6d6449e4f7cfb1c2708,2022-12-02T00:00:00.000Z,POS 514834XXXXXX9486 AMAZON.COM,shopping,,debit_card,-34200.98
63bfb2ac2e1a0ebb7f629aa6,50200023535069,62002.7,60ec41ba55c00300382672d9,HDFC,Revenue-PG-non-split,5eecc6d6449e4f7cfb1c2708,2022-12-03T00:00:00.000Z,NEFT CR-PYTM0123456-PAYTM PAYMENTS SERVI CES LIMITED-SLICK ORGANICS PVT LTD-PYTM2 23373794626,ewallet,,net_banking_transfer,33993.49
63bfb2ac2e1a0ebb7f629aa8,50200023535069,87464.45,60ec41ba55c00300382672d9,HDFC,Revenue-PG-split enabled,5eecc6d6449e4f7cfb1c2708,2022-12-03T00:00:00.000Z,NEFT CR-UTIB0001506-RAZORPAY SOFTWARE PR IVATE LIMITED-SLICK ORGANICS PVT LITD-AX ISCN0186217515,,,net_banking_transfer,25461.75
63bfb2ac2e1a0ebb7f629aaa,50200023535069,64804.45,60ec41ba55c00300382672d9,HDFC,direct expenses,5eecc6d6449e4f7cfb1c2708,2022-12-03T00:00:00.000Z,"NEFT DR-KKBK0000173-NITISH KUMAR MANDAL- NETBANK, MUM-N337222231077976-22660",,,net_banking_transfer,-22660
63bfb2ac2e1a0ebb7f629aac,50200023535069,63529.41,60ec41ba55c00300382672d9,HDFC,Marketing Expense,5eecc6d6449e4f7cfb1c2708,2022-12-03T00:00:00.000Z,ME DC SI 514834XXXXXX9486 LINKEDIN (PGSI,,,Other,-1275.04
63bfb2ac2e1a0ebb7f629aae,50200023535069,61063.41,60ec41ba55c00300382672d9,HDFC,direct expenses,5eecc6d6449e4f7cfb1c2708,2022-12-03T00:00:00.000Z,POS 514834XXXXXX9486 PAYTM_ADDMONEYTO,ewallet,,debit_card,-2466
63bfb2ac2e1a0ebb7f629ab0,50200023535069,79703.39,60ec41ba55c00300382672d9,HDFC,Transfer in/Revenue-other,5eecc6d6449e4f7cfb1c2708,2022-12-03T00:00:00.000Z,NEFT CR-YESB0000001-EASEBUZZ PVT LTD NOD AL A/C-SLICK ORGANICS PVT LTD-YESB233757 36821,,,net_banking_transfer,18639.98
63bfb2ac2e1a0ebb7f629ab2,50200023535069,106362.89,60ec41ba55c00300382672d9,HDFC,Revenue-PG-split enabled,5eecc6d6449e4f7cfb1c2708,2022-12-03T00:00:00.000Z,NEFT CR-UTIB0001506-RAZORPAY SOFTWARE PR IVATE LIMITED-SLICK ORGANICS PVT LITD-AX ISCN0186391025,,,net_banking_transfer,26659.5
63bfb2ac2e1a0ebb7f629ab4,50200023535069,131258.96,60ec41ba55c00300382672d9,HDFC,Revenue-PG-non-split,5eecc6d6449e4f7cfb1c2708,2022-12-04T00:00:00.000Z,NEFT CR-PYTM0123456-PAYTM PAYMENTS SERVI CES LIMITED-SLICK ORGANICS PVT LTD-PYTM2 23385395695,ewallet,,net_banking_transfer,24896.07
63bfb2ac2e1a0ebb7f629ab6,50200023535069,157150.87,60ec41ba55c00300382672d9,HDFC,Revenue-PG-non-split,5eecc6d6449e4f7cfb1c2708,2022-12-05T00:00:00.000Z,NEFT CR-PYTM0123456-PAYTM PAYMENTS SERVI CES LIMITED-SLICK ORGANICS PVT LTD-PYTM2 23397569206,ewallet,,net_banking_transfer,25891.91
63bfb2ac2e1a0ebb7f629ab8,50200023535069,180802.45,60ec41ba55c00300382672d9,HDFC,Revenue-Mktplace,5eecc6d6449e4f7cfb1c2708,2022-12-05T00:00:00.000Z,NEFT CR-DEUT0797BGL-FLIPKART INTERNET PR IVATE LIMITED-SLICK ORGANICS PVT LTD-233 900119GN00079,shopping,,net_banking_transfer,23651.58
63bfb2ad2e1a0ebb7f629aba,50200023535069,182929.25,60ec41ba55c00300382672d9,HDFC,Revenue-Mktplace,5eecc6d6449e4f7cfb1c2708,2022-12-05T00:00:00.000Z,NEFT CR-DEUT0797BGL-MYNTRA DESIGNS PRIVA TE LIMITED-SLICK ORGANICS - SJIT-2339007 69GN00246,shopping,,net_banking_transfer,2126.8
63bfb2ad2e1a0ebb7f629abc,50200023535069,183898.59,60ec41ba55c00300382672d9,HDFC,Revenue-Mktplace,5eecc6d6449e4f7cfb1c2708,2022-12-05T00:00:00.000Z,NEFT CR-DEUT0797BGL-MYNTRA DESIGNS PRIVA TE LIMITED-SLICK ORGANICS - SJIT-2339007 70GN00228,shopping,,net_banking_transfer,969.34
63bfb2ad2e1a0ebb7f629abe,50200023535069,133898.59,60ec41ba55c00300382672d9,HDFC,Marketing Expense,5eecc6d6449e4f7cfb1c2708,2022-12-05T00:00:00.000Z,POS 514834XXXXXX9486 GOOGLEWORKSP,,,debit_card,-50000
63bfb2ad2e1a0ebb7f629ac0,50200023535069,155614.03,60ec41ba55c00300382672d9,HDFC,Revenue-Mktplace,5eecc6d6449e4f7cfb1c2708,2022-12-05T00:00:00.000Z,NEFT CR-DEUT0797BGL-MYNTRA DESIGNS PRIVA TE LIMITED-SLICK ORGANICS PVT. LTD.-2339 00796GN00027,shopping,,net_banking_transfer,21715.44
63bfb2ad2e1a0ebb7f629ac2,50200023535069,230908.94,60ec41ba55c00300382672d9,HDFC,Revenue-PG-split enabled,5eecc6d6449e4f7cfb1c2708,2022-12-05T00:00:00.000Z,NEFT CR-UTIB0001506-RAZORPAY SOFTWARE PR IVATE LIMITED-SLICK ORGANICS PVT LITD-AX ISCN0186788735,,,net_banking_transfer,75294.91
63bfb2ad2e1a0ebb7f629ac4,50200023535069,180908.94,60ec41ba55c00300382672d9,HDFC,direct expenses,5eecc6d6449e4f7cfb1c2708,2022-12-05T00:00:00.000Z,"NEFT DR-UBIN0531626-MRS KHUSHANZ A TURNE R-NETBANK, MUM-N339222232766945-50000",,,net_banking_transfer,-50000
63bfb2ad2e1a0ebb7f629ac6,50200023535069,149908.94,60ec41ba55c00300382672d9,HDFC,direct expenses,5eecc6d6449e4f7cfb1c2708,2022-12-05T00:00:00.000Z,NEFT DR-KKBK0000180-VIMAL PLASTICS-NETBA,,,net_banking_transfer,-31000
63bfb2ad2e1a0ebb7f629ac8,50200023535069,49908.94,60ec41ba55c00300382672d9,HDFC,direct expenses,5eecc6d6449e4f7cfb1c2708,2022-12-05T00:00:00.000Z,"NEFT DR-IDFB0040101-ACTIVES ADDITIVES AP PLICATIONS LLP-NETBANK, MUM-N33922223284 6177-100000",,,net_banking_transfer,-100000
63bfb2ad2e1a0ebb7f629aca,50200023535069,31274.94,60ec41ba55c00300382672d9,HDFC,N-ACH payments,5eecc6d6449e4f7cfb1c2708,2022-12-05T00:00:00.000Z,"NEFT DR-ICIC0001136-AKHILESH BACHCHAN-NE TBANK, MUM-N339222232853382-18634",,,net_banking_transfer,-18634
63bfb2ad2e1a0ebb7f629ace,50200023535069,-33525.06,60ec41ba55c00300382672d9,HDFC,direct expenses,5eecc6d6449e4f7cfb1c2708,2022-12-05T00:00:00.000Z,"NEFT DR-KKBK0001393-MASCOT SPINCONTROL I NDIA PVT LTD-NETBANK, MUM-N3392222328713 36-64800",,,net_banking_transfer,-64800
63bfb2ad2e1a0ebb7f629ad0,50200023535069,-43525.06,60ec41ba55c00300382672d9,HDFC,Refund,5eecc6d6449e4f7cfb1c2708,2022-12-05T00:00:00.000Z,"NEFT DR-RATN0VAAPIS-RAZORPAY REFUND CRED ITS TOPUP-NETBANK, MUM-N339222233070788- 10000",,,net_banking_transfer,-10000
63bfb2ad2e1a0ebb7f629ad2,50200023535069,-40157.1,60ec41ba55c00300382672d9,HDFC,Revenue-PG-non-split,5eecc6d6449e4f7cfb1c2708,2022-12-05T00:00:00.000Z,NEFT CR-SCBL0036001-STRIPE INDIA PRIVATE LIMITED-SLICK ORGANICS PRIVATE LIMITED- IN1ON22120506XAX,,,net_banking_transfer,3367.96
63bfb2ad2e1a0ebb7f629ad4,50200023535069,-40992.01,60ec41ba55c00300382672d9,HDFC,bank charges,5eecc6d6449e4f7cfb1c2708,2022-12-05T00:00:00.000Z,.DC INTL POS TXN MARKUP+ST 271122 291122 -CDT2233912799612,,,international_transaction_arbitrage,-834.91
63bfb2ad2e1a0ebb7f629ad6,50200023535069,-40490.61,60ec41ba55c00300382672d9,HDFC,Transfer in/Revenue-other,5eecc6d6449e4f7cfb1c2708,2022-12-05T00:00:00.000Z,NEFT CR-UTIB0000114-ONE SIGMA TECHNOLOGI ES PRIVATE LIM-SLICK ORGANICS PRIVATE LI MITED-AXISP00343329621,bnpl,,net_banking_transfer,501.4
63bfb2ad2e1a0ebb7f629ad8,50200023535069,-37954.24,60ec41ba55c00300382672d9,HDFC,Transfer in/Revenue-other,5eecc6d6449e4f7cfb1c2708,2022-12-05T00:00:00.000Z,NEFT CR-UTIB0000114-ONE SIGMA TECHNOLOGI ES PRIVATE LIM-SLICK ORGANICS PRIVATE LI MITED-AXISP00343329180,bnpl,,net_banking_transfer,2536.37
63bfb2ad2e1a0ebb7f629ada,50200023535069,-35594.57,60ec41ba55c00300382672d9,HDFC,Transfer in/Revenue-other,5eecc6d6449e4f7cfb1c2708,2022-12-05T00:00:00.000Z,NEFT CR-UTIB0000114-ONE SIGMA TECHNOLOGI ES PRIVATE LIM-SLICK ORGANICS PRIVATE LI MITED-AXISP00343329735,bnpl,,net_banking_transfer,2359.67
63bfb2ad2e1a0ebb7f629adc,50200023535069,15799.5,60ec41ba55c00300382672d9,HDFC,Revenue-COD,5eecc6d6449e4f7cfb1c2708,2022-12-05T00:00:00.000Z,NEFT CR-ICIC0000155-SHIPROCKET COD CRF I D 5299699-SLICK ORGANICS PVT LTD-CMS2986 715295,,,net_banking_transfer,51394.07
63bfb2ad2e1a0ebb7f629ade,50200023535069,42159.37,60ec41ba55c00300382672d9,HDFC,Transfer in/Revenue-other,5eecc6d6449e4f7cfb1c2708,2022-12-05T00:00:00.000Z,NEFT CR-YESB0000001-EASEBUZZ PVT LTD NOD,,,net_banking_transfer,26359.87
63bfb2ad2e1a0ebb7f629ae0,50200023535069,44027.37,60ec41ba55c00300382672d9,HDFC,Revenue-COD,5eecc6d6449e4f7cfb1c2708,2022-12-05T00:00:00.000Z,PICKRR TECHNOL-AKHILESHDIXIT85GMAIL,,,Other,1868
63bfb2ad2e1a0ebb7f629ae2,50200023535069,44028.38,60ec41ba55c00300382672d9,HDFC,Transfer in/Revenue-other,5eecc6d6449e4f7cfb1c2708,2022-12-05T00:00:00.000Z,NEFT CR-YESB0000001-EXCRO PAY ESCROW ACC OUNT-SLICKORGANICSPRIVATELIMITED-YESB233 90456471,,,net_banking_transfer,1.01
63bfb2ad2e1a0ebb7f629ae4,50200023535069,64674.6,60ec41ba55c00300382672d9,HDFC,Revenue-PG-split enabled,5eecc6d6449e4f7cfb1c2708,2022-12-05T00:00:00.000Z,NEFT CR-UTIB0001506-RAZORPAY SOFTWARE PR IVATE LIMITED-SLICK ORGANICS PVT LITD-AX ISCN0187044661,,,net_banking_transfer,20646.22
63bfb2ad2e1a0ebb7f629ae6,50200023535069,79837.79,60ec41ba55c00300382672d9,HDFC,Revenue-PG-non-split,5eecc6d6449e4f7cfb1c2708,2022-12-06T00:00:00.000Z,NEFT CR-PYTM0123456-PAYTM PAYMENTS SERVI CES LIMITED-SLICK ORGANICS PVT LTD-PYTM2 23409126955,ewallet,,net_banking_transfer,15163.19
63bfb2ad2e1a0ebb7f629ae8,50200023535069,90742.19,60ec41ba55c00300382672d9,HDFC,Revenue-PG-split enabled,5eecc6d6449e4f7cfb1c2708,2022-12-06T00:00:00.000Z,NEFT CR-UTIB0001506-RAZORPAY SOFTWARE PR IVATE LIMITED-SLICK ORGANICS PVT LITD-AX ISCN0187234761,,,net_banking_transfer,10904.4
63bfb2ad2e1a0ebb7f629aea,50200023535069,89810.19,60ec41ba55c00300382672d9,HDFC,direct expenses,5eecc6d6449e4f7cfb1c2708,2022-12-06T00:00:00.000Z,POS 514834XXXXXX9486 PAYU*SAVEX TECHN,,,debit_card,-932
63bfb2ad2e1a0ebb7f629aec,50200023535069,85196.19,60ec41ba55c00300382672d9,HDFC,SAAS/tech expense,5eecc6d6449e4f7cfb1c2708,2022-12-06T00:00:00.000Z,POS 514834XXXXXX9486 AMAZON PAY INDIA,shopping,,debit_card,-4614
63bfb2ad2e1a0ebb7f629aee,50200023535069,85197.19,60ec41ba55c00300382672d9,HDFC,Transfer in/Revenue-other,5eecc6d6449e4f7cfb1c2708,2022-12-06T00:00:00.000Z,NEFT CR-YESB0000001-EXCRO PAY ESCROW ACC OUNT-SLICKORGANICSPRIVATELIMITED-YESB234 03246068,,,net_banking_transfer,1
63bfb2ad2e1a0ebb7f629af0,50200023535069,87892.66,60ec41ba55c00300382672d9,HDFC,Transfer in/Revenue-other,5eecc6d6449e4f7cfb1c2708,2022-12-06T00:00:00.000Z,NEFT CR-YESB0000001-EASEBUZZ PVT LTD NOD AL A/C-SLICK ORGANICS PVT LTD-YESB234034 25785,,,net_banking_transfer,2695.47
63bfb2ad2e1a0ebb7f629af2,50200023535069,106978.16,60ec41ba55c00300382672d9,HDFC,Transfer in/Revenue-other,5eecc6d6449e4f7cfb1c2708,2022-12-06T00:00:00.000Z,NEFT CR-HSBC0560002-INNOVATIVE RETAIL CO NCEPTS PRIVATE-SLICK ORGANICS PVT LTD-HS BCN22340101786,,,net_banking_transfer,19085.5
63bfb2ad2e1a0ebb7f629af4,50200023535069,95504.16,60ec41ba55c00300382672d9,HDFC,Utilities/bills,5eecc6d6449e4f7cfb1c2708,2022-12-06T00:00:00.000Z,IB BILLPAY DR-HDFCEB-361011XXXX4399,bills,,Other,-11474
63bfb2ad2e1a0ebb7f629af6,50200023535069,111023,60ec41ba55c00300382672d9,HDFC,Revenue-PG-split enabled,5eecc6d6449e4f7cfb1c2708,2022-12-06T00:00:00.000Z,NEFT CR-UTIB0001506-RAZORPAY SOFTWARE PR IVATE LIMITED-SLICK ORGANICS PVT LITD-AX ISCN0187464127,,,net_banking_transfer,15518.84
63bfb2ad2e1a0ebb7f629af8,50200023535069,48523,60ec41ba55c00300382672d9,HDFC,direct expenses,5eecc6d6449e4f7cfb1c2708,2022-12-07T00:00:00.000Z,50100064106714 NET BANKING SI -62500,,,Other,-62500
63bfb2ad2e1a0ebb7f629afb,50200023535069,-1477,60ec41ba55c00300382672d9,HDFC,direct expenses,5eecc6d6449e4f7cfb1c2708,2022-12-07T00:00:00.000Z,50100108772229 NET BANKING SI -50000,,,Other,-50000
63bfb2ad2e1a0ebb7f629afd,50200023535069,-39981,60ec41ba55c00300382672d9,HDFC,direct expenses,5eecc6d6449e4f7cfb1c2708,2022-12-07T00:00:00.000Z,00901610080520 NET BANKING SI -38504,,,Other,-38504
63bfb2ad2e1a0ebb7f629aff,50200023535069,-213500,60ec41ba55c00300382672d9,HDFC,direct expenses,5eecc6d6449e4f7cfb1c2708,2022-12-07T00:00:00.000Z,50100155115510 NET BANKING SI -173519,,,Other,-173519
63bfb2ad2e1a0ebb7f629b01,50200023535069,-286833,60ec41ba55c00300382672d9,HDFC,direct expenses,5eecc6d6449e4f7cfb1c2708,2022-12-07T00:00:00.000Z,50100293329616 NET BANKING SI -73333,,,Other,-73333
63bfb2ad2e1a0ebb7f629b03,50200023535069,-345963,60ec41ba55c00300382672d9,HDFC,direct expenses,5eecc6d6449e4f7cfb1c2708,2022-12-07T00:00:00.000Z,50100349886722 NET BANKING SI -59130,,,Other,-59130
63bfb2ad2e1a0ebb7f629b05,50200023535069,-490160,60ec41ba55c00300382672d9,HDFC,direct expenses,5eecc6d6449e4f7cfb1c2708,2022-12-07T00:00:00.000Z,50100093802387 NET BANKING SI -144197,,,Other,-144197
63bfb2ad2e1a0ebb7f629b07,50200023535069,-510010,60ec41ba55c00300382672d9,HDFC,direct expenses,5eecc6d6449e4f7cfb1c2708,2022-12-07T00:00:00.000Z,02711600008220 NET BANKING SI -19850,,,Other,-19850
63bfb2ad2e1a0ebb7f629b09,50200023535069,-563077,60ec41ba55c00300382672d9,HDFC,direct expenses,5eecc6d6449e4f7cfb1c2708,2022-12-07T00:00:00.000Z,50100312215410 NET BANKING SI -53067,,,Other,-53067
63bfb2ad2e1a0ebb7f629b0b,50200023535069,-608910,60ec41ba55c00300382672d9,HDFC,direct expenses,5eecc6d6449e4f7cfb1c2708,2022-12-07T00:00:00.000Z,50100482015380 NET BANKING SI -45833,,,Other,-45833
63bfb2ad2e1a0ebb7f629b0d,50200023535069,-643910,60ec41ba55c00300382672d9,HDFC,direct expenses,5eecc6d6449e4f7cfb1c2708,2022-12-07T00:00:00.000Z,NEFT DR-ICIC0003851-JITENDER KUMAR-SANDO Z - MUM-N341222236525791-NET BANKING SI -35000,,,net_banking_transfer,-35000
63bfb2ad2e1a0ebb7f629b0f,50200023535069,-688910,60ec41ba55c00300382672d9,HDFC,direct expenses,5eecc6d6449e4f7cfb1c2708,2022-12-07T00:00:00.000Z,NEFT DR-ICIC0000314-ATUL VAISHNAV-SANDOZ - MUM-N341222236525792-NET BANKING SI - 45000,,,net_banking_transfer,-45000
63bfb2ad2e1a0ebb7f629b11,50200023535069,-718710,60ec41ba55c00300382672d9,HDFC,direct expenses,5eecc6d6449e4f7cfb1c2708,2022-12-07T00:00:00.000Z,NEFT DR-SIBL0000555-JAIVEER KUMAR-SANDOZ - MUM-N341222236525793-NET BANKING SI - 29800,,,net_banking_transfer,-29800
63bfb2ad2e1a0ebb7f629b13,50200023535069,-743710,60ec41ba55c00300382672d9,HDFC,direct expenses,5eecc6d6449e4f7cfb1c2708,2022-12-07T00:00:00.000Z,NEFT DR-BARB0VJGRKA-OM PRASAD PANDEY-SAN DOZ - MUM-N341222236525794-NET BANKING S I -25000,,,net_banking_transfer,-25000
63bfb2ad2e1a0ebb7f629b15,50200023535069,-767710,60ec41ba55c00300382672d9,HDFC,direct expenses,5eecc6d6449e4f7cfb1c2708,2022-12-07T00:00:00.000Z,NEFT DR-PUNB0482100-RAM BHAVAN YADAV-SAN DOZ - MUM-N341222236525795-NET BANKING S I -24000,,,net_banking_transfer,-24000
63bfb2ad2e1a0ebb7f629b17,50200023535069,-844835,60ec41ba55c00300382672d9,HDFC,direct expenses,5eecc6d6449e4f7cfb1c2708,2022-12-07T00:00:00.000Z,NEFT DR-SBIN0070392-APARNA MOHANAN KONAT -SANDOZ - MUM-N341222236525796-NET BANKI NG SI -77125,,,net_banking_transfer,-77125
63bfb2ad2e1a0ebb7f629b1a,50200023535069,-933235,60ec41ba55c00300382672d9,HDFC,direct expenses,5eecc6d6449e4f7cfb1c2708,2022-12-07T00:00:00.000Z,NEFT DR-IOBA0001445-PRIYANKA GOPAL-SANDO Z - MUM-N341222236525797-NET BANKING SI -88400,,,net_banking_transfer,-88400
63bfb2ad2e1a0ebb7f629b1d,50200023535069,-999635,60ec41ba55c00300382672d9,HDFC,direct expenses,5eecc6d6449e4f7cfb1c2708,2022-12-07T00:00:00.000Z,NEFT DR-UTIB0000120-ADNAN ALI-SANDOZ - M UM-N341222236525798-NET BANKING SI -6640 0,,,net_banking_transfer,-66400
63bfb2ad2e1a0ebb7f629b1f,50200023535069,-1046035,60ec41ba55c00300382672d9,HDFC,direct expenses,5eecc6d6449e4f7cfb1c2708,2022-12-07T00:00:00.000Z,NEFT DR-KKBK0008066-KUSHAGRA SINGH-SANDO,,,net_banking_transfer,-46400
63bfb2ad2e1a0ebb7f629b21,50200023535069,-1088435,60ec41ba55c00300382672d9,HDFC,direct expenses,5eecc6d6449e4f7cfb1c2708,2022-12-07T00:00:00.000Z,NEFT DR-UTIB0001720-ANUBHAV RAO-SANDOZ - MUM-N341222236525800-NET BANKING SI -42 400,,,net_banking_transfer,-42400
63bfb2ad2e1a0ebb7f629b23,50200023535069,-1122785,60ec41ba55c00300382672d9,HDFC,direct expenses,5eecc6d6449e4f7cfb1c2708,2022-12-07T00:00:00.000Z,NEFT DR-SBIN0008079-DHARAMVEER-SANDOZ - MUM-N341222236525801-NET BANKING SI -343 50,,,net_banking_transfer,-34350
63bfb2ad2e1a0ebb7f629b25,50200023535069,-1141863,60ec41ba55c00300382672d9,HDFC,N-ACH payments,5eecc6d6449e4f7cfb1c2708,2022-12-07T00:00:00.000Z,NEFT DR-DBSS0IN0811-SACHIN SINGH-SANDOZ - MUM-N341222236525802-NET BANKING SI -1 9078,,,net_banking_transfer,-19078
63bfb2ad2e1a0ebb7f629b27,50200023535069,-1163036,60ec41ba55c00300382672d9,HDFC,direct expenses,5eecc6d6449e4f7cfb1c2708,2022-12-07T00:00:00.000Z,NEFT DR-PUNB0307800-SANJEEV NIRMANIA-SAN DOZ - MUM-N341222236525803-NET BANKING S I -21173,,,net_banking_transfer,-21173
63bfb2ad2e1a0ebb7f629b29,50200023535069,-1178299,60ec41ba55c00300382672d9,HDFC,direct expenses,5eecc6d6449e4f7cfb1c2708,2022-12-07T00:00:00.000Z,NEFT DR-CNRB0019016-MANEESH-SANDOZ - MUM -N341222236525804-NET BANKING SI -15263,,,net_banking_transfer,-15263
63bfb2ad2e1a0ebb7f629b2b,50200023535069,-1193562,60ec41ba55c00300382672d9,HDFC,direct expenses,5eecc6d6449e4f7cfb1c2708,2022-12-07T00:00:00.000Z,NEFT DR-SCBL0036023-VIVEK YADAV-SANDOZ - MUM-N341222236525805-NET BANKING SI -15 263,,,net_banking_transfer,-15263
63bfb2ad2e1a0ebb7f629b2d,50200023535069,-1208825,60ec41ba55c00300382672d9,HDFC,direct expenses,5eecc6d6449e4f7cfb1c2708,2022-12-07T00:00:00.000Z,NEFT DR-SCBL0036028-SHUBHAM SINGH PANWAR -SANDOZ - MUM-N341222236525806-NET BANKI NG SI -15263,,,net_banking_transfer,-15263
63bfb2ad2e1a0ebb7f629b2f,50200023535069,-1224088,60ec41ba55c00300382672d9,HDFC,direct expenses,5eecc6d6449e4f7cfb1c2708,2022-12-07T00:00:00.000Z,NEFT DR-SBIN0008132-VIKASH KUMAR-SANDOZ - MUM-N341222236525807-NET BANKING SI -1 5263,,,net_banking_transfer,-15263
63bfb2ad2e1a0ebb7f629b31,50200023535069,-1244930,60ec41ba55c00300382672d9,HDFC,direct expenses,5eecc6d6449e4f7cfb1c2708,2022-12-07T00:00:00.000Z,NEFT DR-KKBK0005032-DEEPAK YADAV-SANDOZ - MUM-N341222236525808-NET BANKING SI -2 0842,,,net_banking_transfer,-20842
63bfb2ae2e1a0ebb7f629b33,50200023535069,-1264780,60ec41ba55c00300382672d9,HDFC,direct expenses,5eecc6d6449e4f7cfb1c2708,2022-12-07T00:00:00.000Z,NEFT DR-PUNB0494300-KUNDAN PRASAD-SANDOZ - MUM-N341222236525809-NET BANKING SI - 19850,,,net_banking_transfer,-19850
63bfb2ae2e1a0ebb7f629b35,50200023535069,-1283637,60ec41ba55c00300382672d9,HDFC,direct expenses,5eecc6d6449e4f7cfb1c2708,2022-12-07T00:00:00.000Z,NEFT DR-PUNB0151400-BHUWAN CHANDER JOSHI,,,net_banking_transfer,-18857
63bfb2ae2e1a0ebb7f629b37,50200023535069,-1300898,60ec41ba55c00300382672d9,HDFC,direct expenses,5eecc6d6449e4f7cfb1c2708,2022-12-07T00:00:00.000Z,NEFT DR-SBIN0017746-MANOJ KUMAR-SANDOZ - MUM-N341222236525811-NET BANKING SI -17 261,,,net_banking_transfer,-17261
63bfb2ae2e1a0ebb7f629b39,50200023535069,-1316161,60ec41ba55c00300382672d9,HDFC,direct expenses,5eecc6d6449e4f7cfb1c2708,2022-12-07T00:00:00.000Z,NEFT DR-UBIN0919721-PINKU-SANDOZ - MUM-N 341222236525812-NET BANKING SI -15263,,,net_banking_transfer,-15263
63bfb2ae2e1a0ebb7f629b3b,50200023535069,-1345661,60ec41ba55c00300382672d9,HDFC,direct expenses,5eecc6d6449e4f7cfb1c2708,2022-12-07T00:00:00.000Z,NEFT DR-KKBK0004632-DOLLY JAIN-SANDOZ - MUM-N341222236525813-NET BANKING SI -295 00,,,net_banking_transfer,-29500
63bfb2ae2e1a0ebb7f629b3d,50200023535069,-1408728,60ec41ba55c00300382672d9,HDFC,direct expenses,5eecc6d6449e4f7cfb1c2708,2022-12-07T00:00:00.000Z,NEFT DR-PUNB0150400-SAGARIKA DEBNATH-SA NDOZ - MUM-N341222236525814-NET BANKING SI -63067,,,net_banking_transfer,-63067
63bfb2ae2e1a0ebb7f629b3f,50200023535069,-1434888,60ec41ba55c00300382672d9,HDFC,direct expenses,5eecc6d6449e4f7cfb1c2708,2022-12-07T00:00:00.000Z,NEFT DR-ICIC0002697-NITISH KUMAR-SANDOZ - MUM-N341222236525815-NET BANKING SI -2 6160,,,net_banking_transfer,-26160
63bfb2ae2e1a0ebb7f629b41,50200023535069,-1453745,60ec41ba55c00300382672d9,HDFC,direct expenses,5eecc6d6449e4f7cfb1c2708,2022-12-07T00:00:00.000Z,NEFT DR-PUNB0MBGB06-MD ARIF RAZA-SANDOZ - MUM-N341222236525816-NET BANKING SI -1 8857,,,net_banking_transfer,-18857
63bfb2ae2e1a0ebb7f629b43,50200023535069,-1427542.29,60ec41ba55c00300382672d9,HDFC,Revenue-PG-non-split,5eecc6d6449e4f7cfb1c2708,2022-12-07T00:00:00.000Z,NEFT CR-PYTM0123456-PAYTM PAYMENTS SERVI CES LIMITED-SLICK ORGANICS PVT LTD-PYTM2 23410921434,ewallet,,net_banking_transfer,26202.71
63bfb2ae2e1a0ebb7f629b45,50200023535069,-1390368.94,60ec41ba55c00300382672d9,HDFC,Revenue-Mktplace,5eecc6d6449e4f7cfb1c2708,2022-12-07T00:00:00.000Z,NEFT CR-DEUT0797BGL-FLIPKART INTERNET PR IVATE LIMITED-SLICK ORGANICS PVT LTD-234 100145GN00054,shopping,,net_banking_transfer,37173.35
63bfb2ae2e1a0ebb7f629b47,50200023535069,-1584415.94,60ec41ba55c00300382672d9,HDFC,direct expenses,5eecc6d6449e4f7cfb1c2708,2022-12-07T00:00:00.000Z,"NEFT DR-KKBK0000261-TANVI TANEJA-NETBANK , MUM-N341222236664614-194047",,,net_banking_transfer,-194047
63bfb2ae2e1a0ebb7f629b49,50200023535069,-1715469.94,60ec41ba55c00300382672d9,HDFC,direct expenses,5eecc6d6449e4f7cfb1c2708,2022-12-07T00:00:00.000Z,"NEFT DR-ICIC0000021-AKHILESH DIXIT-NETBA NK, MUM-N341222236654260-131054",,,net_banking_transfer,-131054
63bfb2ae2e1a0ebb7f629b4b,50200023535069,-1723086.94,60ec41ba55c00300382672d9,HDFC,N-ACH payments,5eecc6d6449e4f7cfb1c2708,2022-12-07T00:00:00.000Z,"NEFT DR-ICIC0001136-AKHILESH BACHCHAN-NE TBANK, MUM-N341222236665018-7617",,,net_banking_transfer,-7617
63bfb2ae2e1a0ebb7f629b4d,50200023535069,-1759486.94,60ec41ba55c00300382672d9,HDFC,direct expenses,5eecc6d6449e4f7cfb1c2708,2022-12-07T00:00:00.000Z,NEFT DR-UBIN0531626-MRS KHUSHANZ A TURNE,,,net_banking_transfer,-36400
63bfb2ae2e1a0ebb7f629b4f,50200023535069,-1755589.73,60ec41ba55c00300382672d9,HDFC,Revenue-Mktplace,5eecc6d6449e4f7cfb1c2708,2022-12-07T00:00:00.000Z,NEFT CR-DEUT0797BGL-MYNTRA DESIGNS PRIVA TE LIMITED-SLICK ORGANICS - SJIT-2341008 00GN00241,shopping,,net_banking_transfer,3897.21
63bfb2ae2e1a0ebb7f629b51,50200023535069,-1755047.45,60ec41ba55c00300382672d9,HDFC,Revenue-Mktplace,5eecc6d6449e4f7cfb1c2708,2022-12-07T00:00:00.000Z,NEFT CR-DEUT0797BGL-MYNTRA DESIGNS PRIVA TE LIMITED-SLICK ORGANICS - SJIT-2341008 01GN00215,shopping,,net_banking_transfer,542.28
63bfb2ae2e1a0ebb7f629b53,50200023535069,-1750795.45,60ec41ba55c00300382672d9,HDFC,Revenue-Mktplace,5eecc6d6449e4f7cfb1c2708,2022-12-07T00:00:00.000Z,NEFT CR-SCBL0036001-DREAMPLUG TECHNOLOGI ES PRIVATE LIMITED-SLICK ORGANICS PRIVAT E LIMITEDSLICK-IN1ON22120700ZO6,,,net_banking_transfer,4252
63bfb2ae2e1a0ebb7f629b55,50200023535069,-1739605.74,60ec41ba55c00300382672d9,HDFC,Revenue-Mktplace,5eecc6d6449e4f7cfb1c2708,2022-12-07T00:00:00.000Z,NEFT CR-DEUT0797BGL-MYNTRA DESIGNS PRIVA TE LIMITED-SLICK ORGANICS PVT. LTD.-2341 00834GN00232,shopping,,net_banking_transfer,11189.71
63bfb2ae2e1a0ebb7f629b57,50200023535069,-1719754.76,60ec41ba55c00300382672d9,HDFC,Revenue-PG-split enabled,5eecc6d6449e4f7cfb1c2708,2022-12-07T00:00:00.000Z,NEFT CR-UTIB0001506-RAZORPAY SOFTWARE PR IVATE LIMITED-SLICK ORGANICS PVT LITD-AX ISCN0187574246,,,net_banking_transfer,19850.98
63bfb2ae2e1a0ebb7f629b59,50200023535069,-1719850.76,60ec41ba55c00300382672d9,HDFC,direct expenses,5eecc6d6449e4f7cfb1c2708,2022-12-07T00:00:00.000Z,POS 514834XXXXXX9486 PTM*PAYTM WALLET,ewallet,,debit_card,-96
63bfb2ae2e1a0ebb7f629b5b,50200023535069,-1694999.14,60ec41ba55c00300382672d9,HDFC,Revenue-Mktplace,5eecc6d6449e4f7cfb1c2708,2022-12-07T00:00:00.000Z,NEFT CR-HSBC0400002-AMAZON SERVICES LLC- SLICK ORGANICS PRIVATE LIMITED-HSBCN2234 1230952,shopping,,net_banking_transfer,24851.62
63bfb2ae2e1a0ebb7f629b5d,50200023535069,-1695097.14,60ec41ba55c00300382672d9,HDFC,direct expenses,5eecc6d6449e4f7cfb1c2708,2022-12-07T00:00:00.000Z,POS 514834XXXXXX9486 PTM*PAYTM WALLET,ewallet,,debit_card,-98
63bfb2ae2e1a0ebb7f629b5f,50200023535069,-1700097.14,60ec41ba55c00300382672d9,HDFC,direct expenses,5eecc6d6449e4f7cfb1c2708,2022-12-07T00:00:00.000Z,"NEFT DR-ICIC0006956-LAKSHAY CARRYING COR PORATION-NETBANK, MUM-N341222237323000-5 000",,,net_banking_transfer,-5000
63bfb2ae2e1a0ebb7f629b61,50200023535069,-1700095.75,60ec41ba55c00300382672d9,HDFC,Transfer in/Revenue-other,5eecc6d6449e4f7cfb1c2708,2022-12-07T00:00:00.000Z,NEFT CR-YESB0000001-EXCRO PAY ESCROW ACC OUNT-SLICKORGANICSPRIVATELIMITED-YESB234 16376613,,,net_banking_transfer,1.39
63bfb2ae2e1a0ebb7f629b63,50200023535069,-1698695.75,60ec41ba55c00300382672d9,HDFC,Revenue-COD,5eecc6d6449e4f7cfb1c2708,2022-12-07T00:00:00.000Z,PICKRR TECHNOL-AKHILESHDIXIT85GMAIL,,,Other,1400
63bfb2ae2e1a0ebb7f629b65,50200023535069,-1664746.45,60ec41ba55c00300382672d9,HDFC,Revenue-COD,5eecc6d6449e4f7cfb1c2708,2022-12-07T00:00:00.000Z,NEFT CR-ICIC0000155-SHIPROCKET COD CRF I D 5320055-SLICK ORGANICS PVT LTD-CMS2991 241960,,,net_banking_transfer,33949.3
63bfb2ae2e1a0ebb7f629b67,50200023535069,-1655670.92,60ec41ba55c00300382672d9,HDFC,Transfer in/Revenue-other,5eecc6d6449e4f7cfb1c2708,2022-12-07T00:00:00.000Z,NEFT CR-YESB0000001-EASEBUZZ PVT LTD NOD,,,net_banking_transfer,9075.53
63bfb2ae2e1a0ebb7f629b69,50200023535069,-1628795.52,60ec41ba55c00300382672d9,HDFC,Revenue-PG-split enabled,5eecc6d6449e4f7cfb1c2708,2022-12-07T00:00:00.000Z,NEFT CR-UTIB0001506-RAZORPAY SOFTWARE PR IVATE LIMITED-SLICK ORGANICS PVT LITD-AX ISCN0187755427,,,net_banking_transfer,26875.4
63bfb2ae2e1a0ebb7f629b6b,50200023535069,-1628789.52,60ec41ba55c00300382672d9,HDFC,Transfer in/Revenue-other,5eecc6d6449e4f7cfb1c2708,2022-12-08T00:00:00.000Z,INT. ON SWCR ON-50300684649760,,,Other,6
63bfb2ae2e1a0ebb7f629b6d,50200023535069,-1627312.52,60ec41ba55c00300382672d9,HDFC,Loan-in,5eecc6d6449e4f7cfb1c2708,2022-12-08T00:00:00.000Z,SWEEP-IN CREDIT - 50300684649760,,,self_transfer,1477
63bfb2ae2e1a0ebb7f629b6f,50200023535069,-1627148.52,60ec41ba55c00300382672d9,HDFC,Transfer in/Revenue-other,5eecc6d6449e4f7cfb1c2708,2022-12-08T00:00:00.000Z,INT. ON SWCR ON-50300684649760,,,Other,164
63bfb2ae2e1a0ebb7f629b71,50200023535069,-1588644.52,60ec41ba55c00300382672d9,HDFC,Loan-in,5eecc6d6449e4f7cfb1c2708,2022-12-08T00:00:00.000Z,SWEEP-IN CREDIT - 50300684649760,,,self_transfer,38504
63bfb2ae2e1a0ebb7f629b73,50200023535069,-1587906.52,60ec41ba55c00300382672d9,HDFC,Transfer in/Revenue-other,5eecc6d6449e4f7cfb1c2708,2022-12-08T00:00:00.000Z,INT. ON SWCR ON-50300684649760,,,Other,738
63bfb2ae2e1a0ebb7f629b75,50200023535069,-1414387.52,60ec41ba55c00300382672d9,HDFC,Loan-in,5eecc6d6449e4f7cfb1c2708,2022-12-08T00:00:00.000Z,SWEEP-IN CREDIT - 50300684649760,,,self_transfer,173519
63bfb2ae2e1a0ebb7f629b77,50200023535069,-1414075.52,60ec41ba55c00300382672d9,HDFC,Transfer in/Revenue-other,5eecc6d6449e4f7cfb1c2708,2022-12-08T00:00:00.000Z,INT. ON SWCR ON-50300684649760,,,Other,312
63bfb2ae2e1a0ebb7f629b79,50200023535069,-1340742.52,60ec41ba55c00300382672d9,HDFC,Loan-in,5eecc6d6449e4f7cfb1c2708,2022-12-08T00:00:00.000Z,SWEEP-IN CREDIT - 50300684649760,,,self_transfer,73333
63bfb2ae2e1a0ebb7f629b7b,50200023535069,-1340490.52,60ec41ba55c00300382672d9,HDFC,Transfer in/Revenue-other,5eecc6d6449e4f7cfb1c2708,2022-12-08T00:00:00.000Z,INT. ON SWCR ON-50300684649760,,,Other,252
63bfb2ae2e1a0ebb7f629b7d,50200023535069,-1281360.52,60ec41ba55c00300382672d9,HDFC,Loan-in,5eecc6d6449e4f7cfb1c2708,2022-12-08T00:00:00.000Z,SWEEP-IN CREDIT - 50300684649760,,,self_transfer,59130
63bfb2ae2e1a0ebb7f629b7f,50200023535069,-1280747.52,60ec41ba55c00300382672d9,HDFC,Transfer in/Revenue-other,5eecc6d6449e4f7cfb1c2708,2022-12-08T00:00:00.000Z,INT. ON SWCR ON-50300684649760,,,Other,613
63bfb2ae2e1a0ebb7f629b81,50200023535069,-1136550.52,60ec41ba55c00300382672d9,HDFC,Loan-in,5eecc6d6449e4f7cfb1c2708,2022-12-08T00:00:00.000Z,SWEEP-IN CREDIT - 50300684649760,,,self_transfer,144197
63bfb2ae2e1a0ebb7f629b83,50200023535069,-1136466.52,60ec41ba55c00300382672d9,HDFC,Transfer in/Revenue-other,5eecc6d6449e4f7cfb1c2708,2022-12-08T00:00:00.000Z,INT. ON SWCR ON-50300684649760,,,Other,84
63bfb2ae2e1a0ebb7f629b85,50200023535069,-1116616.52,60ec41ba55c00300382672d9,HDFC,Loan-in,5eecc6d6449e4f7cfb1c2708,2022-12-08T00:00:00.000Z,SWEEP-IN CREDIT - 50300684649760,,,self_transfer,19850
63bfb2ae2e1a0ebb7f629b87,50200023535069,-1116390.52,60ec41ba55c00300382672d9,HDFC,Transfer in/Revenue-other,5eecc6d6449e4f7cfb1c2708,2022-12-08T00:00:00.000Z,INT. ON SWCR ON-50300684649760,,,Other,226
63bfb2ae2e1a0ebb7f629b89,50200023535069,-1063323.52,60ec41ba55c00300382672d9,HDFC,Loan-in,5eecc6d6449e4f7cfb1c2708,2022-12-08T00:00:00.000Z,SWEEP-IN CREDIT - 50300684649760,,,self_transfer,53067
63bfb2ae2e1a0ebb7f629b8b,50200023535069,-1063128.52,60ec41ba55c00300382672d9,HDFC,Transfer in/Revenue-other,5eecc6d6449e4f7cfb1c2708,2022-12-08T00:00:00.000Z,INT. ON SWCR ON-50300684649760,,,Other,195
63bfb2ae2e1a0ebb7f629b8d,50200023535069,-1017295.52,60ec41ba55c00300382672d9,HDFC,Loan-in,5eecc6d6449e4f7cfb1c2708,2022-12-08T00:00:00.000Z,SWEEP-IN CREDIT - 50300684649760,,,self_transfer,45833
63bfb2ae2e1a0ebb7f629b8f,50200023535069,-1013702.52,60ec41ba55c00300382672d9,HDFC,Transfer in/Revenue-other,5eecc6d6449e4f7cfb1c2708,2022-12-08T00:00:00.000Z,INT. ON SWCR ON-50300684649760,,,Other,3593
63bfb2ae2e1a0ebb7f629b91,50200023535069,-168867.52,60ec41ba55c00300382672d9,HDFC,Loan-in,5eecc6d6449e4f7cfb1c2708,2022-12-08T00:00:00.000Z,SWEEP-IN CREDIT - 50300684649760,,,self_transfer,844835
63bfb2ae2e1a0ebb7f629b94,50200023535069,-168311.52,60ec41ba55c00300382672d9,HDFC,Transfer in/Revenue-other,5eecc6d6449e4f7cfb1c2708,2022-12-08T00:00:00.000Z,INT. ON SWCR ON-50300684649760,,,Other,556
63bfb2ae2e1a0ebb7f629b96,50200023535069,-37640.52,60ec41ba55c00300382672d9,HDFC,Loan-in,5eecc6d6449e4f7cfb1c2708,2022-12-08T00:00:00.000Z,SWEEP-IN CREDIT - 50300684649760,,,self_transfer,130671
63bfb2ae2e1a0ebb7f629b98,50200023535069,-37480.52,60ec41ba55c00300382672d9,HDFC,Transfer in/Revenue-other,5eecc6d6449e4f7cfb1c2708,2022-12-08T00:00:00.000Z,INT. ON SWCR ON-50300684649760,,,Other,160
63bfb2ae2e1a0ebb7f629b9a,50200023535069,160.48,60ec41ba55c00300382672d9,HDFC,Loan-in,5eecc6d6449e4f7cfb1c2708,2022-12-08T00:00:00.000Z,SWEEP-IN CREDIT - 50300684649760,,,self_transfer,37641
63bfb2ae2e1a0ebb7f629b9c,50200023535069,25151.77,60ec41ba55c00300382672d9,HDFC,Revenue-PG-non-split,5eecc6d6449e4f7cfb1c2708,2022-12-08T00:00:00.000Z,NEFT CR-PYTM0123456-PAYTM PAYMENTS SERVI CES LIMITED-SLICK ORGANICS PVT LTD-PYTM2 23422689128,ewallet,,net_banking_transfer,24991.29
63bfb2ae2e1a0ebb7f629b9e,50200023535069,43030.71,60ec41ba55c00300382672d9,HDFC,Revenue-PG-split enabled,5eecc6d6449e4f7cfb1c2708,2022-12-08T00:00:00.000Z,NEFT CR-UTIB0001506-RAZORPAY SOFTWARE PR,,,net_banking_transfer,17878.94
63bfb2ae2e1a0ebb7f629ba1,50200023535069,42947.71,60ec41ba55c00300382672d9,HDFC,direct expenses,5eecc6d6449e4f7cfb1c2708,2022-12-08T00:00:00.000Z,POS 514834XXXXXX9486 PTM*PAYTM WALLET,ewallet,,debit_card,-83
63bfb2ae2e1a0ebb7f629ba4,50200023535069,42249.71,60ec41ba55c00300382672d9,HDFC,SAAS/tech expense,5eecc6d6449e4f7cfb1c2708,2022-12-08T00:00:00.000Z,POS 514834XXXXXX9486 AMAZON PAY INDIA,shopping,,debit_card,-698
63bfb2ae2e1a0ebb7f629ba6,50200023535069,41551.71,60ec41ba55c00300382672d9,HDFC,SAAS/tech expense,5eecc6d6449e4f7cfb1c2708,2022-12-08T00:00:00.000Z,POS 514834XXXXXX9486 AMAZON PAY INDIA,shopping,,debit_card,-698
63bfb2ae2e1a0ebb7f629ba8,50200023535069,41374.71,60ec41ba55c00300382672d9,HDFC,Marketing Expense,5eecc6d6449e4f7cfb1c2708,2022-12-08T00:00:00.000Z,ME DC SI 514834XXXXXX9486 FACEBOOK SI,,,Other,-177
63bfb2ae2e1a0ebb7f629bab,50200023535069,39486.71,60ec41ba55c00300382672d9,HDFC,Marketing Expense,5eecc6d6449e4f7cfb1c2708,2022-12-08T00:00:00.000Z,ME DC SI 514834XXXXXX9486 LINKEDIN (PGSI ),,,Other,-1888
63bfb2af2e1a0ebb7f629bad,50200023535069,57745.71,60ec41ba55c00300382672d9,HDFC,Revenue-Mktplace,5eecc6d6449e4f7cfb1c2708,2022-12-08T00:00:00.000Z,NEFT CR-ICIC0000105-MANASH LIFESTYLE PRI VATE LIMITED NO-SLICK ORGANICS PRIVATE L IMITED-ICIJ223420002051,shopping,,net_banking_transfer,18259
63bfb2af2e1a0ebb7f629baf,50200023535069,56245.71,60ec41ba55c00300382672d9,HDFC,direct expenses,5eecc6d6449e4f7cfb1c2708,2022-12-08T00:00:00.000Z,50200039508087-TPT-1500-SHREE PUNCHMUKHI LOGISTICS,,,net_banking_transfer,-1500
63bfb2af2e1a0ebb7f629bb1,50200023535069,65112.71,60ec41ba55c00300382672d9,HDFC,Transfer in/Revenue-other,5eecc6d6449e4f7cfb1c2708,2022-12-08T00:00:00.000Z,NEFT CR-SCBL0036001-HEALTH GLOW PRIVATE LIMITED-SLICK ORGANICS PVT LTD-ARATA-IN 1ON22120802716,,,net_banking_transfer,8867
63bfb2af2e1a0ebb7f629bb3,50200023535069,65790.25,60ec41ba55c00300382672d9,HDFC,Transfer in/Revenue-other,5eecc6d6449e4f7cfb1c2708,2022-12-08T00:00:00.000Z,NEFT CR-UTIB0000114-ONE SIGMA TECHNOLOGI ES PRIVATE LIM-SLICK ORGANICS PRIVATE LI MITED-AXISP00344621441,bnpl,,net_banking_transfer,677.54
63bfb2af2e1a0ebb7f629bb5,50200023535069,76723.08,60ec41ba55c00300382672d9,HDFC,Transfer in/Revenue-other,5eecc6d6449e4f7cfb1c2708,2022-12-08T00:00:00.000Z,NEFT CR-YESB0000001-EASEBUZZ PVT LTD NOD AL A/C-SLICK ORGANICS PVT LTD-YESB234298 90116,,,net_banking_transfer,10932.83
63bfb2af2e1a0ebb7f629bb7,50200023535069,77106.08,60ec41ba55c00300382672d9,HDFC,Transfer in/Revenue-other,5eecc6d6449e4f7cfb1c2708,2022-12-08T00:00:00.000Z,NEFT CR-SCBL0036001-HEALTH GLOW PRIVATE LIMITED-SLICK ORGANICS PVT LTD-ARATA-IN 1ON22120803MVK,,,net_banking_transfer,383
63bfb2af2e1a0ebb7f629bb9,50200023535069,85557.37,60ec41ba55c00300382672d9,HDFC,Transfer in/Revenue-other,5eecc6d6449e4f7cfb1c2708,2022-12-08T00:00:00.000Z,NEFT CR-SCBL0036001-HEALTH GLOW PRIVATE LIMITED-SLICK ORGANICS PVT LTD-ARATA-IN 1ON22120803QUX,,,net_banking_transfer,8451.29
63bfb2af2e1a0ebb7f629bbb,50200023535069,98879.57,60ec41ba55c00300382672d9,HDFC,Revenue-PG-split enabled,5eecc6d6449e4f7cfb1c2708,2022-12-08T00:00:00.000Z,NEFT CR-UTIB0001506-RAZORPAY SOFTWARE PR,,,net_banking_transfer,13322.2
63bfb2af2e1a0ebb7f629bbd,50200023535069,110374.76,60ec41ba55c00300382672d9,HDFC,Revenue-PG-non-split,5eecc6d6449e4f7cfb1c2708,2022-12-09T00:00:00.000Z,NEFT CR-PYTM0123456-PAYTM PAYMENTS SERVI CES LIMITED-SLICK ORGANICS PVT LTD-PYTM2 23434504211,ewallet,,net_banking_transfer,11495.19
63bfb2af2e1a0ebb7f629bbf,50200023535069,110197.76,60ec41ba55c00300382672d9,HDFC,Marketing Expense,5eecc6d6449e4f7cfb1c2708,2022-12-09T00:00:00.000Z,ME DC SI 514834XXXXXX9486 FACEBOOK SI,,,Other,-177
63bfb2af2e1a0ebb7f629bc1,50200023535069,90510.76,60ec41ba55c00300382672d9,HDFC,direct expenses,5eecc6d6449e4f7cfb1c2708,2022-12-09T00:00:00.000Z,NEFT DR-CITI0000002-OMG NETWORK INDIA PR IVATE LIMITED-SANDOZ - MUM-N343222240675 626-NET BANKING SI -19687,,,net_banking_transfer,-19687
63bfb2af2e1a0ebb7f629bc3,50200023535069,92201.05,60ec41ba55c00300382672d9,HDFC,Revenue-Mktplace,5eecc6d6449e4f7cfb1c2708,2022-12-09T00:00:00.000Z,NEFT CR-DEUT0797BGL-MYNTRA DESIGNS PRIVA TE LIMITED-SLICK ORGANICS - SJIT-2343007 61GN00238,shopping,,net_banking_transfer,1690.29
63bfb2af2e1a0ebb7f629bc7,50200023535069,92961.23,60ec41ba55c00300382672d9,HDFC,Revenue-Mktplace,5eecc6d6449e4f7cfb1c2708,2022-12-09T00:00:00.000Z,NEFT CR-DEUT0797BGL-MYNTRA DESIGNS PRIVA TE LIMITED-SLICK ORGANICS - SJIT-2343007 62GN00212,shopping,,net_banking_transfer,760.18
63bfb2af2e1a0ebb7f629bca,50200023535069,51509.23,60ec41ba55c00300382672d9,HDFC,direct expenses,5eecc6d6449e4f7cfb1c2708,2022-12-09T00:00:00.000Z,"NEFT DR-KKBK0000180-VIMAL PLASTICS-NETBA NK, MUM-N343222240845455-41452",,,net_banking_transfer,-41452
63bfb2af2e1a0ebb7f629bcc,50200023535069,54772.4,60ec41ba55c00300382672d9,HDFC,Revenue-Mktplace,5eecc6d6449e4f7cfb1c2708,2022-12-09T00:00:00.000Z,NEFT CR-DEUT0797BGL-MYNTRA DESIGNS PRIVA TE LIMITED-SLICK ORGANICS PVT. LTD.-2343 00781GN00166,shopping,,net_banking_transfer,3263.17
63bfb2af2e1a0ebb7f629bce,50200023535069,70403.39,60ec41ba55c00300382672d9,HDFC,Revenue-PG-split enabled,5eecc6d6449e4f7cfb1c2708,2022-12-09T00:00:00.000Z,NEFT CR-UTIB0001506-RAZORPAY SOFTWARE PR IVATE LIMITED-SLICK ORGANICS PVT LITD-AX ISCN0188130827,,,net_banking_transfer,15630.99
63bfb2af2e1a0ebb7f629bd0,50200023535069,62403.39,60ec41ba55c00300382672d9,HDFC,direct expenses,5eecc6d6449e4f7cfb1c2708,2022-12-09T00:00:00.000Z,50100222177899-TPT-8000-ALISHA MARTIN,,,net_banking_transfer,-8000
63bfb2af2e1a0ebb7f629bd2,50200023535069,59683.3,60ec41ba55c00300382672d9,HDFC,Marketing Expense,5eecc6d6449e4f7cfb1c2708,2022-12-09T00:00:00.000Z,ME DC SI 514834XXXXXX9486 LINKEDIN (PGSI ),,,Other,-2720.09
63bfb2af2e1a0ebb7f629bd4,50200023535069,58706.3,60ec41ba55c00300382672d9,HDFC,direct expenses,5eecc6d6449e4f7cfb1c2708,2022-12-09T00:00:00.000Z,POS 514834XXXXXX9486 SMARTSHIFT LOGIS,,,debit_card,-977
63bfb2af2e1a0ebb7f629bd6,50200023535069,60029.59,60ec41ba55c00300382672d9,HDFC,Transfer in/Revenue-other,5eecc6d6449e4f7cfb1c2708,2022-12-09T00:00:00.000Z,NEFT CR-UTIB0000114-ONE SIGMA TECHNOLOGI ES PRIVATE LIM-SLICK ORGANICS PRIVATE LI MITED-AXISP00345098631,bnpl,,net_banking_transfer,1323.29
63bfb2af2e1a0ebb7f629bd8,50200023535069,59138.59,60ec41ba55c00300382672d9,HDFC,direct expenses,5eecc6d6449e4f7cfb1c2708,2022-12-09T00:00:00.000Z,POS 514834XXXXXX9486 SMARTSHIFT LOGIS,,,debit_card,-891
63bfb2af2e1a0ebb7f629bda,50200023535069,58363.59,60ec41ba55c00300382672d9,HDFC,direct expenses,5eecc6d6449e4f7cfb1c2708,2022-12-09T00:00:00.000Z,POS 514834XXXXXX9486 PTM*PAYTM WALLET,ewallet,,debit_card,-775
63bfb2af2e1a0ebb7f629bdc,50200023535069,64115.59,60ec41ba55c00300382672d9,HDFC,Transfer in/Revenue-other,5eecc6d6449e4f7cfb1c2708,2022-12-09T00:00:00.000Z,NEFT CR-SCBL0036001-HEALTH GLOW PRIVATE,,,net_banking_transfer,5752
63bfb2af2e1a0ebb7f629bde,50200023535069,108368.66,60ec41ba55c00300382672d9,HDFC,Revenue-COD,5eecc6d6449e4f7cfb1c2708,2022-12-09T00:00:00.000Z,NEFT CR-ICIC0000155-SHIPROCKET COD CRF I D 5332361-SLICK ORGANICS PVT LTD-CMS2996 120001,,,net_banking_transfer,44253.07
63bfb2af2e1a0ebb7f629be0,50200023535069,119966.01,60ec41ba55c00300382672d9,HDFC,Transfer in/Revenue-other,5eecc6d6449e4f7cfb1c2708,2022-12-09T00:00:00.000Z,NEFT CR-YESB0000001-EASEBUZZ PVT LTD NOD AL A/C-SLICK ORGANICS PVT LTD-YESB234330 01888,,,net_banking_transfer,11597.35
63bfb2af2e1a0ebb7f629be2,50200023535069,133183.4,60ec41ba55c00300382672d9,HDFC,Revenue-PG-split enabled,5eecc6d6449e4f7cfb1c2708,2022-12-09T00:00:00.000Z,NEFT CR-UTIB0001506-RAZORPAY SOFTWARE PR IVATE LIMITED-SLICK ORGANICS PVT LITD-AX ISCN0188295702,,,net_banking_transfer,13217.39
63bfb2af2e1a0ebb7f629be4,50200023535069,133006.4,60ec41ba55c00300382672d9,HDFC,Marketing Expense,5eecc6d6449e4f7cfb1c2708,2022-12-10T00:00:00.000Z,ME DC SI 514834XXXXXX9486 FACEBOOK INDIA ONLINE,,,Other,-177
63bfb2af2e1a0ebb7f629be6,50200023535069,132829.4,60ec41ba55c00300382672d9,HDFC,Marketing Expense,5eecc6d6449e4f7cfb1c2708,2022-12-10T00:00:00.000Z,ME DC SI 514834XXXXXX9486 FACEBOOK INDIA ONLINE,,,Other,-177
63bfb2af2e1a0ebb7f629be8,50200023535069,132652.4,60ec41ba55c00300382672d9,HDFC,Marketing Expense,5eecc6d6449e4f7cfb1c2708,2022-12-10T00:00:00.000Z,ME DC SI 514834XXXXXX9486 FACEBOOK INDIA ONLINE,,,Other,-177
63bfb2af2e1a0ebb7f629bea,50200023535069,132475.4,60ec41ba55c00300382672d9,HDFC,Marketing Expense,5eecc6d6449e4f7cfb1c2708,2022-12-10T00:00:00.000Z,ME DC SI 514834XXXXXX9486 FACEBOOK INDIA ONLINE,,,Other,-177
63bfb2af2e1a0ebb7f629bec,50200023535069,132298.4,60ec41ba55c00300382672d9,HDFC,Marketing Expense,5eecc6d6449e4f7cfb1c2708,2022-12-10T00:00:00.000Z,ME DC SI 514834XXXXXX9486 FACEBOOK SI,,,Other,-177
63bfb2af2e1a0ebb7f629bee,50200023535069,132121.4,60ec41ba55c00300382672d9,HDFC,Marketing Expense,5eecc6d6449e4f7cfb1c2708,2022-12-10T00:00:00.000Z,ME DC SI 514834XXXXXX9486 FACEBOOK SI,,,Other,-177
63bfb2af2e1a0ebb7f629bf0,50200023535069,131944.4,60ec41ba55c00300382672d9,HDFC,Marketing Expense,5eecc6d6449e4f7cfb1c2708,2022-12-10T00:00:00.000Z,ME DC SI 514834XXXXXX9486 FACEBOOK SI,,,Other,-177
63bfb2af2e1a0ebb7f629bf3,50200023535069,131767.4,60ec41ba55c00300382672d9,HDFC,Marketing Expense,5eecc6d6449e4f7cfb1c2708,2022-12-10T00:00:00.000Z,ME DC SI 514834XXXXXX9486 FACEBOOK SI,,,Other,-177
63bfb2af2e1a0ebb7f629bf5,50200023535069,131590.4,60ec41ba55c00300382672d9,HDFC,Marketing Expense,5eecc6d6449e4f7cfb1c2708,2022-12-10T00:00:00.000Z,ME DC SI 514834XXXXXX9486 FACEBOOK SI,,,Other,-177
63bfb2af2e1a0ebb7f629bf7,50200023535069,148041.99,60ec41ba55c00300382672d9,HDFC,Revenue-PG-non-split,5eecc6d6449e4f7cfb1c2708,2022-12-10T00:00:00.000Z,NEFT CR-PYTM0123456-PAYTM PAYMENTS SERVI,ewallet,,net_banking_transfer,16451.59
63bfb2af2e1a0ebb7f629bf9,50200023535069,147864.99,60ec41ba55c00300382672d9,HDFC,Marketing Expense,5eecc6d6449e4f7cfb1c2708,2022-12-10T00:00:00.000Z,ME DC SI 514834XXXXXX9486 FACEBOOK SI,,,Other,-177
63bfb2af2e1a0ebb7f629bfb,50200023535069,147687.99,60ec41ba55c00300382672d9,HDFC,Marketing Expense,5eecc6d6449e4f7cfb1c2708,2022-12-10T00:00:00.000Z,ME DC SI 514834XXXXXX9486 FACEBOOK SI,,,Other,-177
63bfb2af2e1a0ebb7f629bfd,50200023535069,147510.99,60ec41ba55c00300382672d9,HDFC,Marketing Expense,5eecc6d6449e4f7cfb1c2708,2022-12-10T00:00:00.000Z,ME DC SI 514834XXXXXX9486 FACEBOOK SI,,,Other,-177
63bfb2af2e1a0ebb7f629bff,50200023535069,147333.99,60ec41ba55c00300382672d9,HDFC,Marketing Expense,5eecc6d6449e4f7cfb1c2708,2022-12-10T00:00:00.000Z,ME DC SI 514834XXXXXX9486 FACEBOOK SI,,,Other,-177
63bfb2af2e1a0ebb7f629c01,50200023535069,147156.99,60ec41ba55c00300382672d9,HDFC,Marketing Expense,5eecc6d6449e4f7cfb1c2708,2022-12-10T00:00:00.000Z,ME DC SI 514834XXXXXX9486 FACEBOOK SI,,,Other,-177
63bfb2af2e1a0ebb7f629c03,50200023535069,146979.99,60ec41ba55c00300382672d9,HDFC,Marketing Expense,5eecc6d6449e4f7cfb1c2708,2022-12-10T00:00:00.000Z,ME DC SI 514834XXXXXX9486 FACEBOOK SI,,,Other,-177
63bfb2af2e1a0ebb7f629c05,50200023535069,146802.99,60ec41ba55c00300382672d9,HDFC,Marketing Expense,5eecc6d6449e4f7cfb1c2708,2022-12-10T00:00:00.000Z,ME DC SI 514834XXXXXX9486 FACEBOOK SI,,,Other,-177
63bfb2af2e1a0ebb7f629c07,50200023535069,146625.99,60ec41ba55c00300382672d9,HDFC,Marketing Expense,5eecc6d6449e4f7cfb1c2708,2022-12-10T00:00:00.000Z,ME DC SI 514834XXXXXX9486 FACEBOOK SI,,,Other,-177
63bfb2af2e1a0ebb7f629c09,50200023535069,146448.99,60ec41ba55c00300382672d9,HDFC,Marketing Expense,5eecc6d6449e4f7cfb1c2708,2022-12-10T00:00:00.000Z,ME DC SI 514834XXXXXX9486 FACEBOOK SI,,,Other,-177
63bfb2af2e1a0ebb7f629c0b,50200023535069,146271.99,60ec41ba55c00300382672d9,HDFC,Marketing Expense,5eecc6d6449e4f7cfb1c2708,2022-12-10T00:00:00.000Z,ME DC SI 514834XXXXXX9486 FACEBOOK SI,,,Other,-177
63bfb2af2e1a0ebb7f629c0d,50200023535069,146094.99,60ec41ba55c00300382672d9,HDFC,Marketing Expense,5eecc6d6449e4f7cfb1c2708,2022-12-10T00:00:00.000Z,ME DC SI 514834XXXXXX9486 FACEBOOK SI,,,Other,-177
63bfb2af2e1a0ebb7f629c0f,50200023535069,136371.99,60ec41ba55c00300382672d9,HDFC,direct expenses,5eecc6d6449e4f7cfb1c2708,2022-12-10T00:00:00.000Z,02022139344284/ESIC,,,Other,-9723
63bfb2af2e1a0ebb7f629c11,50200023535069,8000.99,60ec41ba55c00300382672d9,HDFC,Salary/Emp/consultant Expense,5eecc6d6449e4f7cfb1c2708,2022-12-10T00:00:00.000Z,1975165589/EPFO,,,Other,-128371
63bfb2af2e1a0ebb7f629c13,50200023535069,7823.99,60ec41ba55c00300382672d9,HDFC,Marketing Expense,5eecc6d6449e4f7cfb1c2708,2022-12-10T00:00:00.000Z,ME DC SI 514834XXXXXX9486 FACEBOOK SI,,,Other,-177
63bfb2af2e1a0ebb7f629c15,50200023535069,-42176.01,60ec41ba55c00300382672d9,HDFC,direct expenses,5eecc6d6449e4f7cfb1c2708,2022-12-10T00:00:00.000Z,"NEFT DR-ICIC0002451-SOUTH COURT CONDOMIN IUM ASSOCIATION-NETBANK, MUM-N3442222428 99616-50000",,,net_banking_transfer,-50000
63bfb2af2e1a0ebb7f629c17,50200023535069,-47496.01,60ec41ba55c00300382672d9,HDFC,direct expenses,5eecc6d6449e4f7cfb1c2708,2022-12-10T00:00:00.000Z,50200051022608-TPT-5320-MAATI SU,,,net_banking_transfer,-5320
63bfb2af2e1a0ebb7f629c19,50200023535069,-47673.01,60ec41ba55c00300382672d9,HDFC,Marketing Expense,5eecc6d6449e4f7cfb1c2708,2022-12-10T00:00:00.000Z,ME DC SI 514834XXXXXX9486 FACEBOOK SI,,,Other,-177
63bfb2af2e1a0ebb7f629c1c,50200023535069,-47850.01,60ec41ba55c00300382672d9,HDFC,Marketing Expense,5eecc6d6449e4f7cfb1c2708,2022-12-10T00:00:00.000Z,ME DC SI 514834XXXXXX9486 FACEBOOK INDIA ONLINE,,,Other,-177
63bfb2af2e1a0ebb7f629c1e,50200023535069,-48086.01,60ec41ba55c00300382672d9,HDFC,Marketing Expense,5eecc6d6449e4f7cfb1c2708,2022-12-10T00:00:00.000Z,ME DC SI 514834XXXXXX9486 FACEBOOK SI,,,Other,-236
63bfb2af2e1a0ebb7f629c20,50200023535069,-48322.01,60ec41ba55c00300382672d9,HDFC,Marketing Expense,5eecc6d6449e4f7cfb1c2708,2022-12-10T00:00:00.000Z,ME DC SI 514834XXXXXX9486 FACEBOOK SI,,,Other,-236
63bfb2af2e1a0ebb7f629c22,50200023535069,-48558.01,60ec41ba55c00300382672d9,HDFC,Marketing Expense,5eecc6d6449e4f7cfb1c2708,2022-12-10T00:00:00.000Z,ME DC SI 514834XXXXXX9486 FACEBOOK SI,,,Other,-236
63bfb2af2e1a0ebb7f629c24,50200023535069,-48794.01,60ec41ba55c00300382672d9,HDFC,Marketing Expense,5eecc6d6449e4f7cfb1c2708,2022-12-10T00:00:00.000Z,ME DC SI 514834XXXXXX9486 FACEBOOK SI,,,Other,-236
63bfb2b02e1a0ebb7f629c26,50200023535069,-49030.01,60ec41ba55c00300382672d9,HDFC,Marketing Expense,5eecc6d6449e4f7cfb1c2708,2022-12-11T00:00:00.000Z,ME DC SI 514834XXXXXX9486 FACEBOOK INDIA ONLINE,,,Other,-236
63bfb2b02e1a0ebb7f629c28,50200023535069,-49029.01,60ec41ba55c00300382672d9,HDFC,Transfer in/Revenue-other,5eecc6d6449e4f7cfb1c2708,2022-12-11T00:00:00.000Z,INT. ON SWCR ON-50300684649760,,,Other,1
63bfb2b02e1a0ebb7f629c2a,50200023535069,-48852.01,60ec41ba55c00300382672d9,HDFC,Loan-in,5eecc6d6449e4f7cfb1c2708,2022-12-11T00:00:00.000Z,SWEEP-IN CREDIT - 50300684649760,,,self_transfer,177
63bfb2b02e1a0ebb7f629c2e,50200023535069,-48851.01,60ec41ba55c00300382672d9,HDFC,Transfer in/Revenue-other,5eecc6d6449e4f7cfb1c2708,2022-12-11T00:00:00.000Z,INT. ON SWCR ON-50300684649760,,,Other,1
63bfb2b02e1a0ebb7f629c30,50200023535069,-48674.01,60ec41ba55c00300382672d9,HDFC,Loan-in,5eecc6d6449e4f7cfb1c2708,2022-12-11T00:00:00.000Z,SWEEP-IN CREDIT - 50300684649760,,,self_transfer,177
63bfb2b02e1a0ebb7f629c33,50200023535069,-48487.01,60ec41ba55c00300382672d9,HDFC,Transfer in/Revenue-other,5eecc6d6449e4f7cfb1c2708,2022-12-11T00:00:00.000Z,INT. ON SWCR ON-50300684649760,,,Other,187
63bfb2b02e1a0ebb7f629c36,50200023535069,-6310.01,60ec41ba55c00300382672d9,HDFC,Loan-in,5eecc6d6449e4f7cfb1c2708,2022-12-11T00:00:00.000Z,SWEEP-IN CREDIT - 50300684649760,,,self_transfer,42177
63bfb2b02e1a0ebb7f629c38,50200023535069,-6286.01,60ec41ba55c00300382672d9,HDFC,Transfer in/Revenue-other,5eecc6d6449e4f7cfb1c2708,2022-12-11T00:00:00.000Z,INT. ON SWCR ON-50300684649760,,,Other,24
63bfb2b02e1a0ebb7f629c3b,50200023535069,-966.01,60ec41ba55c00300382672d9,HDFC,Loan-in,5eecc6d6449e4f7cfb1c2708,2022-12-11T00:00:00.000Z,SWEEP-IN CREDIT - 50300684649760,,,self_transfer,5320
63bfb2b02e1a0ebb7f629c3d,50200023535069,-965.01,60ec41ba55c00300382672d9,HDFC,Transfer in/Revenue-other,5eecc6d6449e4f7cfb1c2708,2022-12-11T00:00:00.000Z,INT. ON SWCR ON-50300684649760,,,Other,1
63bfb2b02e1a0ebb7f629c3f,50200023535069,-729.01,60ec41ba55c00300382672d9,HDFC,Loan-in,5eecc6d6449e4f7cfb1c2708,2022-12-11T00:00:00.000Z,SWEEP-IN CREDIT - 50300684649760,,,self_transfer,236
63bfb2b02e1a0ebb7f629c41,50200023535069,-728.01,60ec41ba55c00300382672d9,HDFC,Transfer in/Revenue-other,5eecc6d6449e4f7cfb1c2708,2022-12-11T00:00:00.000Z,INT. ON SWCR ON-50300684649760,,,Other,1
63bfb2b02e1a0ebb7f629c43,50200023535069,-492.01,60ec41ba55c00300382672d9,HDFC,Loan-in,5eecc6d6449e4f7cfb1c2708,2022-12-11T00:00:00.000Z,SWEEP-IN CREDIT - 50300684649760,,,self_transfer,236
63bfb2b02e1a0ebb7f629c45,50200023535069,-491.01,60ec41ba55c00300382672d9,HDFC,Transfer in/Revenue-other,5eecc6d6449e4f7cfb1c2708,2022-12-11T00:00:00.000Z,INT. ON SWCR ON-50300684649760,,,Other,1
63bfb2b02e1a0ebb7f629c47,50200023535069,-255.01,60ec41ba55c00300382672d9,HDFC,Loan-in,5eecc6d6449e4f7cfb1c2708,2022-12-11T00:00:00.000Z,SWEEP-IN CREDIT - 50300684649760,,,self_transfer,236
63bfb2b02e1a0ebb7f629c49,50200023535069,-491.01,60ec41ba55c00300382672d9,HDFC,Marketing Expense,5eecc6d6449e4f7cfb1c2708,2022-12-11T00:00:00.000Z,ME DC SI 514834XXXXXX9486 FACEBOOK SI,,,Other,-236
63bfb2b02e1a0ebb7f629c4b,50200023535069,-727.01,60ec41ba55c00300382672d9,HDFC,Marketing Expense,5eecc6d6449e4f7cfb1c2708,2022-12-11T00:00:00.000Z,ME DC SI 514834XXXXXX9486 FACEBOOK SI,,,Other,-236
63bfb2b02e1a0ebb7f629c4d,50200023535069,-963.01,60ec41ba55c00300382672d9,HDFC,Marketing Expense,5eecc6d6449e4f7cfb1c2708,2022-12-11T00:00:00.000Z,ME DC SI 514834XXXXXX9486 FACEBOOK SI,,,Other,-236
63bfb2b02e1a0ebb7f629c4f,50200023535069,-1199.01,60ec41ba55c00300382672d9,HDFC,Marketing Expense,5eecc6d6449e4f7cfb1c2708,2022-12-11T00:00:00.000Z,ME DC SI 514834XXXXXX9486 FACEBOOK INDIA ONLINE,,,Other,-236
63bfb2b02e1a0ebb7f629c51,50200023535069,15523.94,60ec41ba55c00300382672d9,HDFC,Revenue-PG-non-split,5eecc6d6449e4f7cfb1c2708,2022-12-11T00:00:00.000Z,NEFT CR-PYTM0123456-PAYTM PAYMENTS SERVI CES LIMITED-SLICK ORGANICS PVT LTD-PYTM2 23458150623,ewallet,,net_banking_transfer,16722.95
63bfb2b02e1a0ebb7f629c53,50200023535069,15287.94,60ec41ba55c00300382672d9,HDFC,Marketing Expense,5eecc6d6449e4f7cfb1c2708,2022-12-11T00:00:00.000Z,ME DC SI 514834XXXXXX9486 FACEBOOK SI,,,Other,-236
63bfb2b02e1a0ebb7f629c55,50200023535069,15051.94,60ec41ba55c00300382672d9,HDFC,Marketing Expense,5eecc6d6449e4f7cfb1c2708,2022-12-11T00:00:00.000Z,ME DC SI 514834XXXXXX9486 FACEBOOK SI,,,Other,-236
63bfb2b02e1a0ebb7f629c58,50200023535069,14815.94,60ec41ba55c00300382672d9,HDFC,Marketing Expense,5eecc6d6449e4f7cfb1c2708,2022-12-11T00:00:00.000Z,ME DC SI 514834XXXXXX9486 FACEBOOK SI,,,Other,-236
63bfb2b02e1a0ebb7f629c5a,50200023535069,14579.94,60ec41ba55c00300382672d9,HDFC,Marketing Expense,5eecc6d6449e4f7cfb1c2708,2022-12-11T00:00:00.000Z,ME DC SI 514834XXXXXX9486 FACEBOOK SI,,,Other,-236
63bfb2b02e1a0ebb7f629c5c,50200023535069,14343.94,60ec41ba55c00300382672d9,HDFC,Marketing Expense,5eecc6d6449e4f7cfb1c2708,2022-12-11T00:00:00.000Z,ME DC SI 514834XXXXXX9486 FACEBOOK SI,,,Other,-236
63bfb2b02e1a0ebb7f629c5e,50200023535069,14107.94,60ec41ba55c00300382672d9,HDFC,Marketing Expense,5eecc6d6449e4f7cfb1c2708,2022-12-11T00:00:00.000Z,ME DC SI 514834XXXXXX9486 FACEBOOK INDIA ONLINE,,,Other,-236
63bfb2b02e1a0ebb7f629c60,50200023535069,13871.94,60ec41ba55c00300382672d9,HDFC,Marketing Expense,5eecc6d6449e4f7cfb1c2708,2022-12-11T00:00:00.000Z,ME DC SI 514834XXXXXX9486 FACEBOOK SI,,,Other,-236
63bfb2b02e1a0ebb7f629c62,50200023535069,13635.94,60ec41ba55c00300382672d9,HDFC,Marketing Expense,5eecc6d6449e4f7cfb1c2708,2022-12-11T00:00:00.000Z,ME DC SI 514834XXXXXX9486 FACEBOOK SI,,,Other,-236
63bfb2b02e1a0ebb7f629c64,50200023535069,13399.94,60ec41ba55c00300382672d9,HDFC,Marketing Expense,5eecc6d6449e4f7cfb1c2708,2022-12-11T00:00:00.000Z,ME DC SI 514834XXXXXX9486 FACEBOOK SI,,,Other,-236
63bfb2b02e1a0ebb7f629c66,50200023535069,13163.94,60ec41ba55c00300382672d9,HDFC,Marketing Expense,5eecc6d6449e4f7cfb1c2708,2022-12-11T00:00:00.000Z,ME DC SI 514834XXXXXX9486 FACEBOOK INDIA ONLINE,,,Other,-236
63bfb2b02e1a0ebb7f629c68,50200023535069,12927.94,60ec41ba55c00300382672d9,HDFC,Marketing Expense,5eecc6d6449e4f7cfb1c2708,2022-12-11T00:00:00.000Z,ME DC SI 514834XXXXXX9486 FACEBOOK INDIA ONLINE,,,Other,-236
63bfb2b02e1a0ebb7f629c6a,50200023535069,12691.94,60ec41ba55c00300382672d9,HDFC,Marketing Expense,5eecc6d6449e4f7cfb1c2708,2022-12-11T00:00:00.000Z,ME DC SI 514834XXXXXX9486 FACEBOOK SI,,,Other,-236
63bfb2b02e1a0ebb7f629c6c,50200023535069,12455.94,60ec41ba55c00300382672d9,HDFC,Marketing Expense,5eecc6d6449e4f7cfb1c2708,2022-12-11T00:00:00.000Z,ME DC SI 514834XXXXXX9486 FACEBOOK SI,,,Other,-236
63bfb2b02e1a0ebb7f629c6e,50200023535069,12219.94,60ec41ba55c00300382672d9,HDFC,Marketing Expense,5eecc6d6449e4f7cfb1c2708,2022-12-11T00:00:00.000Z,ME DC SI 514834XXXXXX9486 FACEBOOK SI,,,Other,-236
63bfb2b02e1a0ebb7f629c70,50200023535069,11983.94,60ec41ba55c00300382672d9,HDFC,Marketing Expense,5eecc6d6449e4f7cfb1c2708,2022-12-11T00:00:00.000Z,ME DC SI 514834XXXXXX9486 FACEBOOK SI,,,Other,-236
63bfb2b02e1a0ebb7f629c72,50200023535069,11747.94,60ec41ba55c00300382672d9,HDFC,Marketing Expense,5eecc6d6449e4f7cfb1c2708,2022-12-11T00:00:00.000Z,ME DC SI 514834XXXXXX9486 FACEBOOK SI,,,Other,-236
63bfb2b02e1a0ebb7f629c74,50200023535069,11511.94,60ec41ba55c00300382672d9,HDFC,Marketing Expense,5eecc6d6449e4f7cfb1c2708,2022-12-12T00:00:00.000Z,ME DC SI 514834XXXXXX9486 FACEBOOK SI,,,Other,-236
63bfb2b02e1a0ebb7f629c76,50200023535069,11275.94,60ec41ba55c00300382672d9,HDFC,Marketing Expense,5eecc6d6449e4f7cfb1c2708,2022-12-12T00:00:00.000Z,ME DC SI 514834XXXXXX9486 FACEBOOK SI,,,Other,-236
63bfb2b02e1a0ebb7f629c79,50200023535069,11039.94,60ec41ba55c00300382672d9,HDFC,Marketing Expense,5eecc6d6449e4f7cfb1c2708,2022-12-12T00:00:00.000Z,ME DC SI 514834XXXXXX9486 FACEBOOK SI,,,Other,-236
63bfb2b02e1a0ebb7f629c7b,50200023535069,12893.94,60ec41ba55c00300382672d9,HDFC,Revenue-COD,5eecc6d6449e4f7cfb1c2708,2022-12-12T00:00:00.000Z,NEFT CR-KKBK0000958-PICKRR TECHNOLOGIES PVT LTD-SLICK ORGANICS PRIVATE LIMITED-C MS3462235555158,,,net_banking_transfer,1854
63bfb2b02e1a0ebb7f629c7d,50200023535069,12657.94,60ec41ba55c00300382672d9,HDFC,Marketing Expense,5eecc6d6449e4f7cfb1c2708,2022-12-12T00:00:00.000Z,ME DC SI 514834XXXXXX9486 FACEBOOK SI,,,Other,-236
63bfb2b02e1a0ebb7f629c80,50200023535069,12421.94,60ec41ba55c00300382672d9,HDFC,Marketing Expense,5eecc6d6449e4f7cfb1c2708,2022-12-12T00:00:00.000Z,ME DC SI 514834XXXXXX9486 FACEBOOK SI,,,Other,-236
63bfb2b02e1a0ebb7f629c83,50200023535069,24012.62,60ec41ba55c00300382672d9,HDFC,Revenue-PG-non-split,5eecc6d6449e4f7cfb1c2708,2022-12-12T00:00:00.000Z,NEFT CR-PYTM0123456-PAYTM PAYMENTS SERVI CES LIMITED-SLICK ORGANICS PVT LTD-PYTM2 23469967603,ewallet,,net_banking_transfer,11590.68
63bfb2b02e1a0ebb7f629c86,50200023535069,23776.62,60ec41ba55c00300382672d9,HDFC,Marketing Expense,5eecc6d6449e4f7cfb1c2708,2022-12-12T00:00:00.000Z,ME DC SI 514834XXXXXX9486 FACEBOOK SI,,,Other,-236
63bfb2b02e1a0ebb7f629c88,50200023535069,23540.62,60ec41ba55c00300382672d9,HDFC,Marketing Expense,5eecc6d6449e4f7cfb1c2708,2022-12-12T00:00:00.000Z,ME DC SI 514834XXXXXX9486 FACEBOOK SI,,,Other,-236
63bfb2b02e1a0ebb7f629c8a,50200023535069,23304.62,60ec41ba55c00300382672d9,HDFC,Marketing Expense,5eecc6d6449e4f7cfb1c2708,2022-12-12T00:00:00.000Z,ME DC SI 514834XXXXXX9486 FACEBOOK SI,,,Other,-236
63bfb2b02e1a0ebb7f629c8c,50200023535069,139917.74,60ec41ba55c00300382672d9,HDFC,Transfer in/Revenue-other,5eecc6d6449e4f7cfb1c2708,2022-12-12T00:00:00.000Z,IMPS-234607745443-EXCRO PAY ESCROW ACC-Y ESB-XXXXXXXXXXX1807-333112298023,,,net_banking_transfer,116613.12
63bfb2b02e1a0ebb7f629c8e,50200023535069,139681.74,60ec41ba55c00300382672d9,HDFC,Marketing Expense,5eecc6d6449e4f7cfb1c2708,2022-12-12T00:00:00.000Z,ME DC SI 514834XXXXXX9486 FACEBOOK INDIA ONLINE,,,Other,-236
63bfb2b02e1a0ebb7f629c90,50200023535069,141960.64,60ec41ba55c00300382672d9,HDFC,Revenue-Mktplace,5eecc6d6449e4f7cfb1c2708,2022-12-12T00:00:00.000Z,NEFT CR-DEUT0797BGL-MYNTRA DESIGNS PRIVA,shopping,,net_banking_transfer,2278.9
63bfb2b02e1a0ebb7f629c93,50200023535069,148139.54,60ec41ba55c00300382672d9,HDFC,Revenue-Mktplace,5eecc6d6449e4f7cfb1c2708,2022-12-12T00:00:00.000Z,NEFT CR-DEUT0797BGL-MYNTRA DESIGNS PRIVA TE LIMITED-SLICK ORGANICS - SJIT-2346007 60GN00269,shopping,,net_banking_transfer,6178.9
63bfb2b02e1a0ebb7f629c95,50200023535069,147785.54,60ec41ba55c00300382672d9,HDFC,Marketing Expense,5eecc6d6449e4f7cfb1c2708,2022-12-12T00:00:00.000Z,ME DC SI 514834XXXXXX9486 FACEBOOK SI,,,Other,-354
63bfb2b02e1a0ebb7f629c97,50200023535069,154670.26,60ec41ba55c00300382672d9,HDFC,Revenue-Mktplace,5eecc6d6449e4f7cfb1c2708,2022-12-12T00:00:00.000Z,NEFT CR-DEUT0797BGL-MYNTRA DESIGNS PRIVA TE LIMITED-SLICK ORGANICS PVT. LTD.-2346 00774GN00285,shopping,,net_banking_transfer,6884.72
63bfb2b02e1a0ebb7f629c99,50200023535069,238266.04,60ec41ba55c00300382672d9,HDFC,Revenue-PG-split enabled,5eecc6d6449e4f7cfb1c2708,2022-12-12T00:00:00.000Z,NEFT CR-UTIB0001506-RAZORPAY SOFTWARE PR IVATE LIMITED-SLICK ORGANICS PVT LITD-AX ISCN0188592589,,,net_banking_transfer,83595.78
63bfb2b02e1a0ebb7f629c9b,50200023535069,237912.04,60ec41ba55c00300382672d9,HDFC,Marketing Expense,5eecc6d6449e4f7cfb1c2708,2022-12-12T00:00:00.000Z,ME DC SI 514834XXXXXX9486 FACEBOOK SI,,,Other,-354
63bfb2b02e1a0ebb7f629c9d,50200023535069,237558.04,60ec41ba55c00300382672d9,HDFC,Marketing Expense,5eecc6d6449e4f7cfb1c2708,2022-12-12T00:00:00.000Z,ME DC SI 514834XXXXXX9486 FACEBOOK INDIA ONLINE,,,Other,-354
63bfb2b02e1a0ebb7f629c9f,50200023535069,277106.04,60ec41ba55c00300382672d9,HDFC,Transfer in/Revenue-other,5eecc6d6449e4f7cfb1c2708,2022-12-12T00:00:00.000Z,NEFT CR-YESB0000001-EASEBUZZ PVT LTD NOD AL A/C-SLICK ORGANICS PVT LTD-YESB234606 47581,,,net_banking_transfer,39548
63bfb2b02e1a0ebb7f629ca2,50200023535069,276752.04,60ec41ba55c00300382672d9,HDFC,Marketing Expense,5eecc6d6449e4f7cfb1c2708,2022-12-12T00:00:00.000Z,ME DC SI 514834XXXXXX9486 FACEBOOK INDIA ONLINE,,,Other,-354
63bfb2b02e1a0ebb7f629ca4,50200023535069,285838.47,60ec41ba55c00300382672d9,HDFC,Transfer in/Revenue-other,5eecc6d6449e4f7cfb1c2708,2022-12-12T00:00:00.000Z,NEFT CR-UTIB0000114-ONE SIGMA TECHNOLOGI ES PRIVATE LIM-SLICK ORGANICS PRIVATE LI MITED-AXISP00345571581,bnpl,,net_banking_transfer,9086.43
63bfb2b02e1a0ebb7f629ca6,50200023535069,292821.85,60ec41ba55c00300382672d9,HDFC,Transfer in/Revenue-other,5eecc6d6449e4f7cfb1c2708,2022-12-12T00:00:00.000Z,NEFT CR-UTIB0000114-ONE SIGMA TECHNOLOGI ES PRIVATE LIM-SLICK ORGANICS PRIVATE LI MITED-AXISP00345571555,bnpl,,net_banking_transfer,6983.38
63bfb2b12e1a0ebb7f629ca8,50200023535069,302894.5,60ec41ba55c00300382672d9,HDFC,Transfer in/Revenue-other,5eecc6d6449e4f7cfb1c2708,2022-12-12T00:00:00.000Z,NEFT CR-UTIB0000114-ONE SIGMA TECHNOLOGI ES PRIVATE LIM-SLICK ORGANICS PRIVATE LI MITED-AXISP00345571634,bnpl,,net_banking_transfer,10072.65
63bfb2b12e1a0ebb7f629caa,50200023535069,306201.39,60ec41ba55c00300382672d9,HDFC,Revenue-PG-non-split,5eecc6d6449e4f7cfb1c2708,2022-12-12T00:00:00.000Z,NEFT CR-SCBL0036001-STRIPE INDIA PRIVATE,,,net_banking_transfer,3306.89
63bfb2b12e1a0ebb7f629cac,50200023535069,304172.39,60ec41ba55c00300382672d9,HDFC,direct expenses,5eecc6d6449e4f7cfb1c2708,2022-12-12T00:00:00.000Z,POS 514834XXXXXX9486 ADOBE CREATIVE C,,,debit_card,-2029
63bfb2b12e1a0ebb7f629cae,50200023535069,327790.68,60ec41ba55c00300382672d9,HDFC,Transfer in/Revenue-other,5eecc6d6449e4f7cfb1c2708,2022-12-12T00:00:00.000Z,NEFT CR-YESB0000001-EASEBUZZ PVT LTD NOD AL A/C-SLICK ORGANICS PVT LTD-YESB234608 16528,,,net_banking_transfer,23618.29
63bfb2b12e1a0ebb7f629cb0,50200023535069,323746.46,60ec41ba55c00300382672d9,HDFC,direct expenses,5eecc6d6449e4f7cfb1c2708,2022-12-12T00:00:00.000Z,POS 514834XXXXXX9486 WWW.FAQPRIME.COM,,,debit_card,-4044.22
63bfb2b12e1a0ebb7f629cb2,50200023535069,334838.18,60ec41ba55c00300382672d9,HDFC,Revenue-PG-split enabled,5eecc6d6449e4f7cfb1c2708,2022-12-12T00:00:00.000Z,NEFT CR-UTIB0001506-RAZORPAY SOFTWARE PR IVATE LIMITED-SLICK ORGANICS PVT LITD-AX ISCN0188806891,,,net_banking_transfer,11091.72
63bfb2b12e1a0ebb7f629cb4,50200023535069,334484.18,60ec41ba55c00300382672d9,HDFC,Marketing Expense,5eecc6d6449e4f7cfb1c2708,2022-12-12T00:00:00.000Z,ME DC SI 514834XXXXXX9486 FACEBOOK SI,,,Other,-354
63bfb2b12e1a0ebb7f629cb6,50200023535069,381905.8,60ec41ba55c00300382672d9,HDFC,Revenue-COD,5eecc6d6449e4f7cfb1c2708,2022-12-12T00:00:00.000Z,NEFT CR-ICIC0000155-SHIPROCKET COD CRF I D 5340654-SLICK ORGANICS PVT LTD-CMS3001 097546,,,net_banking_transfer,47421.62
63bfb2b12e1a0ebb7f629cb8,50200023535069,381551.8,60ec41ba55c00300382672d9,HDFC,Marketing Expense,5eecc6d6449e4f7cfb1c2708,2022-12-12T00:00:00.000Z,ME DC SI 514834XXXXXX9486 FACEBOOK SI,,,Other,-354
63bfb2b12e1a0ebb7f629cbb,50200023535069,381197.8,60ec41ba55c00300382672d9,HDFC,Marketing Expense,5eecc6d6449e4f7cfb1c2708,2022-12-12T00:00:00.000Z,ME DC SI 514834XXXXXX9486 FACEBOOK SI,,,Other,-354
63bfb2b12e1a0ebb7f629cbe,50200023535069,380843.8,60ec41ba55c00300382672d9,HDFC,Marketing Expense,5eecc6d6449e4f7cfb1c2708,2022-12-13T00:00:00.000Z,ME DC SI 514834XXXXXX9486 FACEBOOK SI,,,Other,-354
63bfb2b12e1a0ebb7f629cc0,50200023535069,380489.8,60ec41ba55c00300382672d9,HDFC,Marketing Expense,5eecc6d6449e4f7cfb1c2708,2022-12-13T00:00:00.000Z,ME DC SI 514834XXXXXX9486 FACEBOOK INDIA ONLINE,,,Other,-354
63bfb2b12e1a0ebb7f629cc2,50200023535069,380135.8,60ec41ba55c00300382672d9,HDFC,Marketing Expense,5eecc6d6449e4f7cfb1c2708,2022-12-13T00:00:00.000Z,ME DC SI 514834XXXXXX9486 FACEBOOK SI,,,Other,-354
63bfb2b12e1a0ebb7f629cc4,50200023535069,379781.8,60ec41ba55c00300382672d9,HDFC,Marketing Expense,5eecc6d6449e4f7cfb1c2708,2022-12-13T00:00:00.000Z,ME DC SI 514834XXXXXX9486 FACEBOOK SI,,,Other,-354
63bfb2b12e1a0ebb7f629cc6,50200023535069,379427.8,60ec41ba55c00300382672d9,HDFC,Marketing Expense,5eecc6d6449e4f7cfb1c2708,2022-12-13T00:00:00.000Z,ME DC SI 514834XXXXXX9486 FACEBOOK SI,,,Other,-354
63bfb2b12e1a0ebb7f629cc8,50200023535069,389643.48,60ec41ba55c00300382672d9,HDFC,Transfer in/Revenue-other,5eecc6d6449e4f7cfb1c2708,2022-12-13T00:00:00.000Z,IMPS-234707954195-EXCRO PAY ESCROW ACC-Y ESB-XXXXXXXXXXX1807-333112298023,,,net_banking_transfer,10215.68
63bfb2b12e1a0ebb7f629cca,50200023535069,389289.48,60ec41ba55c00300382672d9,HDFC,Marketing Expense,5eecc6d6449e4f7cfb1c2708,2022-12-13T00:00:00.000Z,ME DC SI 514834XXXXXX9486 FACEBOOK SI,,,Other,-354
63bfb2b12e1a0ebb7f629ccc,50200023535069,388935.48,60ec41ba55c00300382672d9,HDFC,Marketing Expense,5eecc6d6449e4f7cfb1c2708,2022-12-13T00:00:00.000Z,ME DC SI 514834XXXXXX9486 FACEBOOK SI,,,Other,-354
63bfb2b12e1a0ebb7f629cce,50200023535069,398858.32,60ec41ba55c00300382672d9,HDFC,Revenue-PG-split enabled,5eecc6d6449e4f7cfb1c2708,2022-12-13T00:00:00.000Z,NEFT CR-RATN0000999-RAZORPAY SOFTWARE PV T LTD-SLICK ORGANICS PVT LITD-0002869757 27,,,net_banking_transfer,9922.84
63bfb2b12e1a0ebb7f629cd0,50200023535069,398504.32,60ec41ba55c00300382672d9,HDFC,Marketing Expense,5eecc6d6449e4f7cfb1c2708,2022-12-13T00:00:00.000Z,ME DC SI 514834XXXXXX9486 FACEBOOK SI,,,Other,-354
63bfb2b12e1a0ebb7f629cd2,50200023535069,390504.32,60ec41ba55c00300382672d9,HDFC,direct expenses,5eecc6d6449e4f7cfb1c2708,2022-12-13T00:00:00.000Z,"NEFT DR-SBIN0001211-URJA TANTA-NETBANK, MUM-N347222245837797-8000",,,net_banking_transfer,-8000
63bfb2b12e1a0ebb7f629cd4,50200023535069,-59495.68,60ec41ba55c00300382672d9,HDFC,direct expenses,5eecc6d6449e4f7cfb1c2708,2022-12-13T00:00:00.000Z,"NEFT DR-ICIC0000004-MUKESH GOYAL-NETBANK , MUM-N347222245883578-450000",,,net_banking_transfer,-450000
63bfb2b12e1a0ebb7f629cd6,50200023535069,-59849.68,60ec41ba55c00300382672d9,HDFC,Marketing Expense,5eecc6d6449e4f7cfb1c2708,2022-12-13T00:00:00.000Z,ME DC SI 514834XXXXXX9486 FACEBOOK INDIA ONLINE,,,Other,-354
63bfb2b12e1a0ebb7f629cd8,50200023535069,-59629.68,60ec41ba55c00300382672d9,HDFC,Revenue-Mktplace,5eecc6d6449e4f7cfb1c2708,2022-12-13T00:00:00.000Z,NEFT CR-ICIC0000105-MANASH LIFESTYLE PRI VATE LIMITED NO-SLICK ORGANICS PRIVATE L IMITED-ICIJ223470002576,shopping,,net_banking_transfer,220
63bfb2b12e1a0ebb7f629cda,50200023535069,-59983.68,60ec41ba55c00300382672d9,HDFC,Marketing Expense,5eecc6d6449e4f7cfb1c2708,2022-12-13T00:00:00.000Z,ME DC SI 514834XXXXXX9486 FACEBOOK INDIA ONLINE,,,Other,-354
63bfb2b12e1a0ebb7f629cdc,50200023535069,-56568.69,60ec41ba55c00300382672d9,HDFC,Transfer in/Revenue-other,5eecc6d6449e4f7cfb1c2708,2022-12-13T00:00:00.000Z,NEFT CR-UTIB0000114-ONE SIGMA TECHNOLOGI ES PRIVATE LIM-SLICK ORGANICS PRIVATE LI MITED-AXISP00345866893,bnpl,,net_banking_transfer,3414.99
63bfb2b12e1a0ebb7f629cde,50200023535069,-58068.69,60ec41ba55c00300382672d9,HDFC,direct expenses,5eecc6d6449e4f7cfb1c2708,2022-12-13T00:00:00.000Z,"NEFT DR-UTIB0000588-SOMYA SHARMA-NETBANK , MUM-N347222246454270-1500",,,net_banking_transfer,-1500
63bfb2b12e1a0ebb7f629ce0,50200023535069,-50799.69,60ec41ba55c00300382672d9,HDFC,Revenue-Mktplace,5eecc6d6449e4f7cfb1c2708,2022-12-13T00:00:00.000Z,NEFT CR-ICIC0000105-MANASH LIFETYLE PVT LTD-SLICK ORGANICS PRIVATE LIMITED-ICIB2 23470021247,,,net_banking_transfer,7269
63bfb2b12e1a0ebb7f629ce2,50200023535069,-22549.34,60ec41ba55c00300382672d9,HDFC,Transfer in/Revenue-other,5eecc6d6449e4f7cfb1c2708,2022-12-13T00:00:00.000Z,NEFT CR-YESB0000001-EASEBUZZ PVT LTD NOD AL A/C-SLICK ORGANICS PVT LTD-YESB234739 73144,,,net_banking_transfer,28250.35
63bfb2b12e1a0ebb7f629ce4,50200023535069,-20350.34,60ec41ba55c00300382672d9,HDFC,Transfer in/Revenue-other,5eecc6d6449e4f7cfb1c2708,2022-12-13T00:00:00.000Z,FT - CR - 50200038726231 - HOUSE OF BEAU,,,Other,2199
63bfb2b12e1a0ebb7f629ce6,50200023535069,-16527.33,60ec41ba55c00300382672d9,HDFC,Revenue-PG-split enabled,5eecc6d6449e4f7cfb1c2708,2022-12-13T00:00:00.000Z,NEFT CR-RATN0000999-RAZORPAY SOFTWARE PV T LTD-SLICK ORGANICS PVT LITD-0002870449 38,,,net_banking_transfer,3823.01
63bfb2b12e1a0ebb7f629ce8,50200023535069,-16881.33,60ec41ba55c00300382672d9,HDFC,Marketing Expense,5eecc6d6449e4f7cfb1c2708,2022-12-13T00:00:00.000Z,ME DC SI 514834XXXXXX9486 FACEBOOK SI,,,Other,-354
63bfb2b12e1a0ebb7f629cea,50200023535069,23999.67,60ec41ba55c00300382672d9,HDFC,Transfer in/Revenue-other,5eecc6d6449e4f7cfb1c2708,2022-12-13T00:00:00.000Z,FT- REMITTANCE OG NOV 22-50200050675669 - HOUZ OF NATURE PVT LTD -,,,Other,40881
63bfb2b12e1a0ebb7f629cec,50200023535069,23468.67,60ec41ba55c00300382672d9,HDFC,Marketing Expense,5eecc6d6449e4f7cfb1c2708,2022-12-13T00:00:00.000Z,ME DC SI 514834XXXXXX9486 FACEBOOK SI,,,Other,-531
63bfb2b12e1a0ebb7f629cee,50200023535069,22937.67,60ec41ba55c00300382672d9,HDFC,Marketing Expense,5eecc6d6449e4f7cfb1c2708,2022-12-14T00:00:00.000Z,ME DC SI 514834XXXXXX9486 FACEBOOK INDIA ONLINE,,,Other,-531
63bfb2b12e1a0ebb7f629cf1,50200023535069,22406.67,60ec41ba55c00300382672d9,HDFC,Marketing Expense,5eecc6d6449e4f7cfb1c2708,2022-12-14T00:00:00.000Z,ME DC SI 514834XXXXXX9486 FACEBOOK INDIA ONLINE,,,Other,-531
63bfb2b12e1a0ebb7f629cf3,50200023535069,29179.75,60ec41ba55c00300382672d9,HDFC,Transfer in/Revenue-other,5eecc6d6449e4f7cfb1c2708,2022-12-14T00:00:00.000Z,IMPS-234804604984-EXCRO PAY ESCROW ACC-Y ESB-XXXXXXXXXXX1807-333112298023,,,net_banking_transfer,6773.08
63bfb2b12e1a0ebb7f629cf5,50200023535069,28648.75,60ec41ba55c00300382672d9,HDFC,Marketing Expense,5eecc6d6449e4f7cfb1c2708,2022-12-14T00:00:00.000Z,ME DC SI 514834XXXXXX9486 FACEBOOK SI,,,Other,-531
63bfb2b12e1a0ebb7f629cf8,50200023535069,-6351.25,60ec41ba55c00300382672d9,HDFC,direct expenses,5eecc6d6449e4f7cfb1c2708,2022-12-14T00:00:00.000Z,"NEFT DR-ICIC0000004-MUKESH GOYAL-NETBANK , MUM-N348222247169706-35000",,,net_banking_transfer,-35000
63bfb2b12e1a0ebb7f629cfa,50200023535069,26668.32,60ec41ba55c00300382672d9,HDFC,Transfer in/Revenue-other,5eecc6d6449e4f7cfb1c2708,2022-12-14T00:00:00.000Z,IMPS-234807701938-EXCRO PAY ESCROW ACC-Y ESB-XXXXXXXXXXX1807-333112298023,,,net_banking_transfer,33019.57
63bfb2b12e1a0ebb7f629cfc,50200023535069,26137.32,60ec41ba55c00300382672d9,HDFC,Marketing Expense,5eecc6d6449e4f7cfb1c2708,2022-12-14T00:00:00.000Z,ME DC SI 514834XXXXXX9486 FACEBOOK INDIA ONLINE,,,Other,-531
63bfb2b12e1a0ebb7f629cfe,50200023535069,29318.68,60ec41ba55c00300382672d9,HDFC,Revenue-Mktplace,5eecc6d6449e4f7cfb1c2708,2022-12-14T00:00:00.000Z,NEFT CR-DEUT0797BGL-MYNTRA DESIGNS PRIVA TE LIMITED-SLICK ORGANICS - SJIT-2348007 96GN00231,shopping,,net_banking_transfer,3181.36
63bfb2b12e1a0ebb7f629d00,50200023535069,38019.57,60ec41ba55c00300382672d9,HDFC,Revenue-Mktplace,5eecc6d6449e4f7cfb1c2708,2022-12-14T00:00:00.000Z,NEFT CR-DEUT0797BGL-MYNTRA DESIGNS PRIVA TE LIMITED-SLICK ORGANICS - SJIT-2348007 97GN00265,shopping,,net_banking_transfer,8700.89
63bfb2b12e1a0ebb7f629d02,50200023535069,37488.57,60ec41ba55c00300382672d9,HDFC,Marketing Expense,5eecc6d6449e4f7cfb1c2708,2022-12-14T00:00:00.000Z,ME DC SI 514834XXXXXX9486 FACEBOOK SI,,,Other,-531
63bfb2b12e1a0ebb7f629d04,50200023535069,48214.53,60ec41ba55c00300382672d9,HDFC,Revenue-Mktplace,5eecc6d6449e4f7cfb1c2708,2022-12-14T00:00:00.000Z,NEFT CR-DEUT0797BGL-MYNTRA DESIGNS PRIVA,shopping,,net_banking_transfer,10725.96
63bfb2b12e1a0ebb7f629d07,50200023535069,54918.49,60ec41ba55c00300382672d9,HDFC,Revenue-PG-split enabled,5eecc6d6449e4f7cfb1c2708,2022-12-14T00:00:00.000Z,NEFT CR-RATN0000999-RAZORPAY SOFTWARE PV T LTD-SLICK ORGANICS PVT LITD-0002871430 21,,,net_banking_transfer,6703.96
63bfb2b12e1a0ebb7f629d09,50200023535069,54387.49,60ec41ba55c00300382672d9,HDFC,Marketing Expense,5eecc6d6449e4f7cfb1c2708,2022-12-14T00:00:00.000Z,ME DC SI 514834XXXXXX9486 FACEBOOK SI,,,Other,-531
63bfb2b12e1a0ebb7f629d0b,50200023535069,41552.49,60ec41ba55c00300382672d9,HDFC,direct expenses,5eecc6d6449e4f7cfb1c2708,2022-12-14T00:00:00.000Z,00918630000430-TPT-12835-UNICOMMERCE ESO LUTIONS PRIVATE LIMITED,,,net_banking_transfer,-12835
63bfb2b12e1a0ebb7f629d0d,50200023535069,-23163.51,60ec41ba55c00300382672d9,HDFC,direct expenses,5eecc6d6449e4f7cfb1c2708,2022-12-14T00:00:00.000Z,"NEFT DR-PUNB0062910-YADAVPACKAGING-NETBA NK, MUM-N348222247488355-64716",,,net_banking_transfer,-64716
63bfb2b12e1a0ebb7f629d10,50200023535069,-28351.51,60ec41ba55c00300382672d9,HDFC,direct expenses,5eecc6d6449e4f7cfb1c2708,2022-12-14T00:00:00.000Z,"NEFT DR-ICIC0000021-AKHILESH DIXIT-NETBA NK, MUM-N348222247509506-5188",,,net_banking_transfer,-5188
63bfb2b12e1a0ebb7f629d12,50200023535069,-27822,60ec41ba55c00300382672d9,HDFC,Transfer in/Revenue-other,5eecc6d6449e4f7cfb1c2708,2022-12-14T00:00:00.000Z,NEFT CR-UTIB0000114-ONE SIGMA TECHNOLOGI ES PRIVATE LIM-SLICK ORGANICS PRIVATE LI MITED-AXISP00346106932,bnpl,,net_banking_transfer,529.51
63bfb2b12e1a0ebb7f629d14,50200023535069,-28572,60ec41ba55c00300382672d9,HDFC,direct expenses,5eecc6d6449e4f7cfb1c2708,2022-12-14T00:00:00.000Z,POS 514834XXXXXX9486 RAZ*NYKAA ERETAI,,,debit_card,-750
63bfb2b12e1a0ebb7f629d17,50200023535069,-25895.81,60ec41ba55c00300382672d9,HDFC,Revenue-Mktplace,5eecc6d6449e4f7cfb1c2708,2022-12-14T00:00:00.000Z,NEFT CR-ICIC0000105-MANASH LIFESTYLE PRI VATE LIMITED NO-SLICK ORGANICS PRIVATE L IMITED-ICIJ223480005333,shopping,,net_banking_transfer,2676.19
63bfb2b12e1a0ebb7f629d1a,50200023535069,-26426.81,60ec41ba55c00300382672d9,HDFC,Marketing Expense,5eecc6d6449e4f7cfb1c2708,2022-12-14T00:00:00.000Z,ME DC SI 514834XXXXXX9486 FACEBOOK SI,,,Other,-531
63bfb2b12e1a0ebb7f629d1c,50200023535069,-27314.06,60ec41ba55c00300382672d9,HDFC,SAAS/tech expense,5eecc6d6449e4f7cfb1c2708,2022-12-14T00:00:00.000Z,POS 514834XXXXXX9486 AMAZONIN,shopping,,debit_card,-887.25
63bfb2b12e1a0ebb7f629d1e,50200023535069,-23566.5,60ec41ba55c00300382672d9,HDFC,Revenue-COD,5eecc6d6449e4f7cfb1c2708,2022-12-14T00:00:00.000Z,NEFT CR-ICIC0000155-SHIPROCKET COD CRF I D 5361001-SLICK ORGANICS PVT LTD-CMS3005 455253,,,net_banking_transfer,3747.56
63bfb2b22e1a0ebb7f629d20,50200023535069,12224.21,60ec41ba55c00300382672d9,HDFC,Transfer in/Revenue-other,5eecc6d6449e4f7cfb1c2708,2022-12-14T00:00:00.000Z,NEFT CR-YESB0000001-EASEBUZZ PVT LTD NOD AL A/C-SLICK ORGANICS PVT LTD-YESB234870 91601,,,net_banking_transfer,35790.71
63bfb2b22e1a0ebb7f629d22,50200023535069,11369.21,60ec41ba55c00300382672d9,HDFC,direct expenses,5eecc6d6449e4f7cfb1c2708,2022-12-14T00:00:00.000Z,POS 514834XXXXXX9486 PTM*PAYTM WALLET,ewallet,,debit_card,-855
63bfb2b22e1a0ebb7f629d24,50200023535069,14208.35,60ec41ba55c00300382672d9,HDFC,Revenue-PG-split enabled,5eecc6d6449e4f7cfb1c2708,2022-12-14T00:00:00.000Z,NEFT CR-RATN0000999-RAZORPAY SOFTWARE PV,,,net_banking_transfer,2839.14
63bfb2b22e1a0ebb7f629d26,50200023535069,573006.1,60ec41ba55c00300382672d9,HDFC,Transfer in/Revenue-other,5eecc6d6449e4f7cfb1c2708,2022-12-14T00:00:00.000Z,NEFT CR-IDFB0010204-PCPL CENTRAL DISBURS EMENT AC-SLICK ORGANICS PRIVATE LIMITED- IDFBH22348297177,,,net_banking_transfer,558797.75
63bfb2b22e1a0ebb7f629d28,50200023535069,373006.1,60ec41ba55c00300382672d9,HDFC,direct expenses,5eecc6d6449e4f7cfb1c2708,2022-12-14T00:00:00.000Z,"NEFT DR-YESB0000551-VISTTA COSMETICS-NET BANK, MUM-N348222248505685-200000",,,net_banking_transfer,-200000
63bfb2b22e1a0ebb7f629d2a,50200023535069,118006.1,60ec41ba55c00300382672d9,HDFC,direct expenses,5eecc6d6449e4f7cfb1c2708,2022-12-14T00:00:00.000Z,"NEFT DR-SCBL0036020-AMERICAN EXPRESS-NET BANK, MUM-N348222248506300-255000",,,net_banking_transfer,-255000
63bfb2b22e1a0ebb7f629d2c,50200023535069,-81993.9,60ec41ba55c00300382672d9,HDFC,direct expenses,5eecc6d6449e4f7cfb1c2708,2022-12-14T00:00:00.000Z,"NEFT DR-ICIC0000369-BO INTERNATIONAL-NET BANK, MUM-N348222248499341-200000",,,net_banking_transfer,-200000
63bfb2b22e1a0ebb7f629d2e,50200023535069,-131993.9,60ec41ba55c00300382672d9,HDFC,direct expenses,5eecc6d6449e4f7cfb1c2708,2022-12-14T00:00:00.000Z,"NEFT DR-ICIC0000369-BO INTERNATIONAL-NET BANK, MUM-N348222248499667-50000",,,net_banking_transfer,-50000
63bfb2b22e1a0ebb7f629d30,50200023535069,-156993.9,60ec41ba55c00300382672d9,HDFC,direct expenses,5eecc6d6449e4f7cfb1c2708,2022-12-14T00:00:00.000Z,"NEFT DR-ICIC0002451-SOUTH COURT CONDOMIN IUM ASSOCIATION-NETBANK, MUM-N3482222485 07409-25000",,,net_banking_transfer,-25000
63bfb2b22e1a0ebb7f629d32,50200023535069,-159993.9,60ec41ba55c00300382672d9,HDFC,direct expenses,5eecc6d6449e4f7cfb1c2708,2022-12-14T00:00:00.000Z,16661000010675-TPT-3000-GURSIMRAN KAUR T ANEJA,,,net_banking_transfer,-3000
63bfb2b22e1a0ebb7f629d34,50200023535069,-160524.9,60ec41ba55c00300382672d9,HDFC,Marketing Expense,5eecc6d6449e4f7cfb1c2708,2022-12-14T00:00:00.000Z,ME DC SI 514834XXXXXX9486 FACEBOOK SI,,,Other,-531
63bfb2b22e1a0ebb7f629d37,50200023535069,-161055.9,60ec41ba55c00300382672d9,HDFC,Marketing Expense,5eecc6d6449e4f7cfb1c2708,2022-12-14T00:00:00.000Z,ME DC SI 514834XXXXXX9486 FACEBOOK SI,,,Other,-531
63bfb2b22e1a0ebb7f629d39,50200023535069,-161586.9,60ec41ba55c00300382672d9,HDFC,Marketing Expense,5eecc6d6449e4f7cfb1c2708,2022-12-15T00:00:00.000Z,ME DC SI 514834XXXXXX9486 FACEBOOK INDIA ONLINE,,,Other,-531
63bfb2b22e1a0ebb7f629d3b,50200023535069,-161556.9,60ec41ba55c00300382672d9,HDFC,Transfer in/Revenue-other,5eecc6d6449e4f7cfb1c2708,2022-12-15T00:00:00.000Z,INT. ON SWCR ON-50300684649760,,,Other,30
63bfb2b22e1a0ebb7f629d3f,50200023535069,-155204.9,60ec41ba55c00300382672d9,HDFC,Loan-in,5eecc6d6449e4f7cfb1c2708,2022-12-15T00:00:00.000Z,SWEEP-IN CREDIT - 50300684649760,,,self_transfer,6352
63bfb2b22e1a0ebb7f629d41,50200023535069,-155203.9,60ec41ba55c00300382672d9,HDFC,Transfer in/Revenue-other,5eecc6d6449e4f7cfb1c2708,2022-12-15T00:00:00.000Z,INT. ON SWCR ON-50300684649760,,,Other,1
63bfb2b22e1a0ebb7f629d44,50200023535069,-154982.9,60ec41ba55c00300382672d9,HDFC,Loan-in,5eecc6d6449e4f7cfb1c2708,2022-12-15T00:00:00.000Z,SWEEP-IN CREDIT - 50300684649760,,,self_transfer,221
63bfb2b22e1a0ebb7f629d46,50200023535069,-154903.9,60ec41ba55c00300382672d9,HDFC,Transfer in/Revenue-other,5eecc6d6449e4f7cfb1c2708,2022-12-15T00:00:00.000Z,INT. ON SWCR ON-50300684649760,,,Other,79
63bfb2b22e1a0ebb7f629d48,50200023535069,-138090.9,60ec41ba55c00300382672d9,HDFC,Loan-in,5eecc6d6449e4f7cfb1c2708,2022-12-15T00:00:00.000Z,SWEEP-IN CREDIT - 50300684649760,,,self_transfer,16813
63bfb2b22e1a0ebb7f629d4a,50200023535069,-138066.9,60ec41ba55c00300382672d9,HDFC,Transfer in/Revenue-other,5eecc6d6449e4f7cfb1c2708,2022-12-15T00:00:00.000Z,INT. ON SWCR ON-50300684649760,,,Other,24
63bfb2b22e1a0ebb7f629d4c,50200023535069,-132878.9,60ec41ba55c00300382672d9,HDFC,Loan-in,5eecc6d6449e4f7cfb1c2708,2022-12-15T00:00:00.000Z,SWEEP-IN CREDIT - 50300684649760,,,self_transfer,5188
63bfb2b22e1a0ebb7f629d4e,50200023535069,-132843.12,60ec41ba55c00300382672d9,HDFC,Transfer in/Revenue-other,5eecc6d6449e4f7cfb1c2708,2022-12-15T00:00:00.000Z,INT. ON SWCR ON-50300498262188,,,Other,35.78
63bfb2b22e1a0ebb7f629d50,50200023535069,-132312.12,60ec41ba55c00300382672d9,HDFC,Loan-in,5eecc6d6449e4f7cfb1c2708,2022-12-15T00:00:00.000Z,SWEEP-IN CREDIT - 50300498262188,,,self_transfer,531
63bfb2b22e1a0ebb7f629d52,50200023535069,-132276.34,60ec41ba55c00300382672d9,HDFC,Transfer in/Revenue-other,5eecc6d6449e4f7cfb1c2708,2022-12-15T00:00:00.000Z,INT. ON SWCR ON-50300498262188,,,Other,35.78
63bfb2b22e1a0ebb7f629d54,50200023535069,-131745.34,60ec41ba55c00300382672d9,HDFC,Loan-in,5eecc6d6449e4f7cfb1c2708,2022-12-15T00:00:00.000Z,SWEEP-IN CREDIT - 50300498262188,,,self_transfer,531
63bfb2b22e1a0ebb7f629d57,50200023535069,-131495.34,60ec41ba55c00300382672d9,HDFC,Transfer in/Revenue-other,5eecc6d6449e4f7cfb1c2708,2022-12-15T00:00:00.000Z,INT. ON SWCR ON-50300684649760,,,Other,250
63bfb2b22e1a0ebb7f629d59,50200023535069,-78073.34,60ec41ba55c00300382672d9,HDFC,Loan-in,5eecc6d6449e4f7cfb1c2708,2022-12-15T00:00:00.000Z,SWEEP-IN CREDIT - 50300684649760,,,self_transfer,53422
63bfb2b22e1a0ebb7f629d5b,50200023535069,-77839.34,60ec41ba55c00300382672d9,HDFC,Transfer in/Revenue-other,5eecc6d6449e4f7cfb1c2708,2022-12-15T00:00:00.000Z,INT. ON SWCR ON-50300684649760,,,Other,234
63bfb2b22e1a0ebb7f629d5d,50200023535069,-27839.34,60ec41ba55c00300382672d9,HDFC,Loan-in,5eecc6d6449e4f7cfb1c2708,2022-12-15T00:00:00.000Z,SWEEP-IN CREDIT - 50300684649760,,,self_transfer,50000
63bfb2b22e1a0ebb7f629d5f,50200023535069,-27760.34,60ec41ba55c00300382672d9,HDFC,Transfer in/Revenue-other,5eecc6d6449e4f7cfb1c2708,2022-12-15T00:00:00.000Z,INT. ON SWCR ON-50300684649760,,,Other,79
63bfb2b22e1a0ebb7f629d61,50200023535069,-10894.34,60ec41ba55c00300382672d9,HDFC,Loan-in,5eecc6d6449e4f7cfb1c2708,2022-12-15T00:00:00.000Z,SWEEP-IN CREDIT - 50300684649760,,,self_transfer,16866
63bfb2b22e1a0ebb7f629d63,50200023535069,-10829.34,60ec41ba55c00300382672d9,HDFC,Transfer in/Revenue-other,5eecc6d6449e4f7cfb1c2708,2022-12-15T00:00:00.000Z,INT. ON SWCR ON-50300653995829,,,Other,65
63bfb2b22e1a0ebb7f629d65,50200023535069,-5094.34,60ec41ba55c00300382672d9,HDFC,Loan-in,5eecc6d6449e4f7cfb1c2708,2022-12-15T00:00:00.000Z,SWEEP-IN CREDIT - 50300653995829,,,self_transfer,5735
63bfb2b22e1a0ebb7f629d68,50200023535069,-4924.88,60ec41ba55c00300382672d9,HDFC,Transfer in/Revenue-other,5eecc6d6449e4f7cfb1c2708,2022-12-15T00:00:00.000Z,INT. ON SWCR ON-50300498262188,,,Other,169.46
63bfb2b22e1a0ebb7f629d6a,50200023535069,-2525.88,60ec41ba55c00300382672d9,HDFC,Loan-in,5eecc6d6449e4f7cfb1c2708,2022-12-15T00:00:00.000Z,SWEEP-IN CREDIT - 50300498262188,,,self_transfer,2399
63bfb2b22e1a0ebb7f629d6d,50200023535069,-2348.72,60ec41ba55c00300382672d9,HDFC,Transfer in/Revenue-other,5eecc6d6449e4f7cfb1c2708,2022-12-15T00:00:00.000Z,INT. ON SWCR ON-50300498262188,,,Other,177.16
63bfb2b22e1a0ebb7f629d6f,50200023535069,177.28,60ec41ba55c00300382672d9,HDFC,Loan-in,5eecc6d6449e4f7cfb1c2708,2022-12-15T00:00:00.000Z,SWEEP-IN CREDIT - 50300498262188,,,self_transfer,2526
63bfb2b22e1a0ebb7f629d71,50200023535069,-353.72,60ec41ba55c00300382672d9,HDFC,Marketing Expense,5eecc6d6449e4f7cfb1c2708,2022-12-15T00:00:00.000Z,ME DC SI 514834XXXXXX9486 FACEBOOK SI,,,Other,-531
63bfb2b22e1a0ebb7f629d73,50200023535069,12702.14,60ec41ba55c00300382672d9,HDFC,Transfer in/Revenue-other,5eecc6d6449e4f7cfb1c2708,2022-12-15T00:00:00.000Z,IMPS-234904953117-EXCRO PAY ESCROW ACC-Y ESB-XXXXXXXXXXX1807-333112298023,,,net_banking_transfer,13055.86
63bfb2b22e1a0ebb7f629d75,50200023535069,12171.14,60ec41ba55c00300382672d9,HDFC,Marketing Expense,5eecc6d6449e4f7cfb1c2708,2022-12-15T00:00:00.000Z,ME DC SI 514834XXXXXX9486 FACEBOOK SI,,,Other,-531
63bfb2b22e1a0ebb7f629d77,50200023535069,11640.14,60ec41ba55c00300382672d9,HDFC,Marketing Expense,5eecc6d6449e4f7cfb1c2708,2022-12-15T00:00:00.000Z,ME DC SI 514834XXXXXX9486 FACEBOOK SI,,,Other,-531
63bfb2b22e1a0ebb7f629d79,50200023535069,511640.14,60ec41ba55c00300382672d9,HDFC,Internal Transfers,5eecc6d6449e4f7cfb1c2708,2022-12-15T00:00:00.000Z,IB FUNDS TRANSFER CR-50200035187206 -SL ICK ORGANICS PVT LTD,,,Other,500000
63bfb2b22e1a0ebb7f629d7b,50200023535069,161640.14,60ec41ba55c00300382672d9,HDFC,direct expenses,5eecc6d6449e4f7cfb1c2708,2022-12-15T00:00:00.000Z,50200020787428-TPT-350000-SHRI AKSHARA F ILMS,,,net_banking_transfer,-350000
63bfb2b22e1a0ebb7f629d7d,50200023535069,169642.66,60ec41ba55c00300382672d9,HDFC,Revenue-PG-split enabled,5eecc6d6449e4f7cfb1c2708,2022-12-15T00:00:00.000Z,NEFT CR-RATN0000999-RAZORPAY SOFTWARE PV T LTD-SLICK ORGANICS PVT LITD-0002873330 78,,,net_banking_transfer,8002.52
63bfb2b22e1a0ebb7f629d7f,50200023535069,669642.66,60ec41ba55c00300382672d9,HDFC,Internal Transfers,5eecc6d6449e4f7cfb1c2708,2022-12-15T00:00:00.000Z,IB FUNDS TRANSFER CR-50200035187206 -SL,,,Other,500000
63bfb2b22e1a0ebb7f629d81,50200023535069,172394.09,60ec41ba55c00300382672d9,HDFC,direct expenses,5eecc6d6449e4f7cfb1c2708,2022-12-15T00:00:00.000Z,POS 514834XXXXXX9486 E-COMMERCE RP,,,debit_card,-497248.57
63bfb2b22e1a0ebb7f629d83,50200023535069,171863.09,60ec41ba55c00300382672d9,HDFC,Marketing Expense,5eecc6d6449e4f7cfb1c2708,2022-12-15T00:00:00.000Z,ME DC SI 514834XXXXXX9486 FACEBOOK SI,,,Other,-531
63bfb2b22e1a0ebb7f629d85,50200023535069,131566.46,60ec41ba55c00300382672d9,HDFC,direct expenses,5eecc6d6449e4f7cfb1c2708,2022-12-15T00:00:00.000Z,POS 514834XXXXXX9486 SHOPIFY* 1611987,,,debit_card,-40296.63
63bfb2b22e1a0ebb7f629d87,50200023535069,128723.46,60ec41ba55c00300382672d9,HDFC,direct expenses,5eecc6d6449e4f7cfb1c2708,2022-12-15T00:00:00.000Z,50100093802387-TPT-2843-ISSHANA MAHAJAN,,,net_banking_transfer,-2843
63bfb2b22e1a0ebb7f629d89,50200023535069,130196.46,60ec41ba55c00300382672d9,HDFC,Revenue-Mktplace,5eecc6d6449e4f7cfb1c2708,2022-12-15T00:00:00.000Z,NEFT CR-ICIC0000105-MANASH LIFESTYLE PRI VATE LIMITED NO-SLICK ORGANICS PRIVATE L IMITED-ICIJ223490005510,shopping,,net_banking_transfer,1473
63bfb2b22e1a0ebb7f629d8b,50200023535069,117694.11,60ec41ba55c00300382672d9,HDFC,direct expenses,5eecc6d6449e4f7cfb1c2708,2022-12-15T00:00:00.000Z,102212048040541/CITRUSEAZYPAY,bnpl,,Other,-12502.35
63bfb2b22e1a0ebb7f629d8d,50200023535069,97694.11,60ec41ba55c00300382672d9,HDFC,direct expenses,5eecc6d6449e4f7cfb1c2708,2022-12-15T00:00:00.000Z,SARVAN KUMAR - CHQ PAID - K G MARG,,,chq,-20000
63bfb2b22e1a0ebb7f629d8f,50200023535069,127848.98,60ec41ba55c00300382672d9,HDFC,Transfer in/Revenue-other,5eecc6d6449e4f7cfb1c2708,2022-12-15T00:00:00.000Z,NEFT CR-YESB0000001-EASEBUZZ PVT LTD NOD AL A/C-SLICK ORGANICS PVT LTD-YESB234901 50696,,,net_banking_transfer,30154.87
63bfb2b22e1a0ebb7f629d91,50200023535069,133488.21,60ec41ba55c00300382672d9,HDFC,Revenue-PG-split enabled,5eecc6d6449e4f7cfb1c2708,2022-12-15T00:00:00.000Z,NEFT CR-RATN0000999-RAZORPAY SOFTWARE PV T LTD-SLICK ORGANICS PVT LITD-0002874163 09,,,net_banking_transfer,5639.23
63bfb2b22e1a0ebb7f629d93,50200023535069,136011.15,60ec41ba55c00300382672d9,HDFC,Transfer in/Revenue-other,5eecc6d6449e4f7cfb1c2708,2022-12-16T00:00:00.000Z,IMPS-235004694717-EXCRO PAY ESCROW ACC-Y ESB-XXXXXXXXXXX1807-333112298023,,,net_banking_transfer,2522.94
63bfb2b22e1a0ebb7f629d95,50200023535069,146743.08,60ec41ba55c00300382672d9,HDFC,Revenue-Mktplace,5eecc6d6449e4f7cfb1c2708,2022-12-16T00:00:00.000Z,NEFT CR-DEUT0797BGL-MYNTRA DESIGNS PRIVA TE LIMITED-SLICK ORGANICS PVT. LTD.-2350 00926GN00096,shopping,,net_banking_transfer,10731.93
63bfb2b22e1a0ebb7f629d97,50200023535069,148304.19,60ec41ba55c00300382672d9,HDFC,Revenue-PG-split enabled,5eecc6d6449e4f7cfb1c2708,2022-12-16T00:00:00.000Z,NEFT CR-RATN0000999-RAZORPAY SOFTWARE PV T LTD-SLICK ORGANICS PVT LITD-0002875064 81,,,net_banking_transfer,1561.11
63bfb2b22e1a0ebb7f629d99,50200023535069,158317.76,60ec41ba55c00300382672d9,HDFC,Revenue-Mktplace,5eecc6d6449e4f7cfb1c2708,2022-12-16T00:00:00.000Z,NEFT CR-DEUT0797BGL-MYNTRA DESIGNS PRIVA TE LIMITED-SLICK ORGANICS - SJIT-2350009 74GN00096,shopping,,net_banking_transfer,10013.57
63bfb2b32e1a0ebb7f629d9b,50200023535069,162207.83,60ec41ba55c00300382672d9,HDFC,Revenue-Mktplace,5eecc6d6449e4f7cfb1c2708,2022-12-16T00:00:00.000Z,NEFT CR-DEUT0797BGL-MYNTRA DESIGNS PRIVA TE LIMITED-SLICK ORGANICS - SJIT-2350009 75GN00090,shopping,,net_banking_transfer,3890.07
63bfb2b32e1a0ebb7f629d9d,50200023535069,162124.83,60ec41ba55c00300382672d9,HDFC,direct expenses,5eecc6d6449e4f7cfb1c2708,2022-12-16T00:00:00.000Z,POS 514834XXXXXX9486 SMARTSHIFT LOGIS,,,debit_card,-83
63bfb2b32e1a0ebb7f629d9f,50200023535069,161374.83,60ec41ba55c00300382672d9,HDFC,direct expenses,5eecc6d6449e4f7cfb1c2708,2022-12-16T00:00:00.000Z,POS 514834XXXXXX9486 RAZ*NYKAA ERETAI,,,debit_card,-750
63bfb2b32e1a0ebb7f629da1,50200023535069,161871.61,60ec41ba55c00300382672d9,HDFC,Transfer in/Revenue-other,5eecc6d6449e4f7cfb1c2708,2022-12-16T00:00:00.000Z,NEFT CR-UTIB0000114-ONE SIGMA TECHNOLOGI ES PRIVATE LIM-SLICK ORGANICS PRIVATE LI MITED-AXISP00346728034,bnpl,,net_banking_transfer,496.78
63bfb2b32e1a0ebb7f629da4,50200023535069,161868.61,60ec41ba55c00300382672d9,HDFC,Marketing Expense,5eecc6d6449e4f7cfb1c2708,2022-12-16T00:00:00.000Z,ME DC SI 514834XXXXXX9486 FACEBOOK INDIA ONLINE,,,Other,-3
63bfb2b32e1a0ebb7f629da6,50200023535069,158448.61,60ec41ba55c00300382672d9,HDFC,direct expenses,5eecc6d6449e4f7cfb1c2708,2022-12-16T00:00:00.000Z,POS 514834XXXXXX9486 PAYTM_ADDMONEYTO,ewallet,,debit_card,-3420
63bfb2b32e1a0ebb7f629da8,50200023535069,42448.61,60ec41ba55c00300382672d9,HDFC,direct expenses,5eecc6d6449e4f7cfb1c2708,2022-12-16T00:00:00.000Z,"NEFT DR-UTIB0000514-NATS ASSOCIATES-NETB ANK, MUM-N350222250620632-116000",,,net_banking_transfer,-116000
63bfb2b32e1a0ebb7f629daa,50200023535069,-648.39,60ec41ba55c00300382672d9,HDFC,direct expenses,5eecc6d6449e4f7cfb1c2708,2022-12-16T00:00:00.000Z,"NEFT DR-KKBK0000187-APPLIED LIFE PRIVATE LIMITED-NETBANK, MUM-N350222250613865-4 3097",,,net_banking_transfer,-43097
63bfb2b32e1a0ebb7f629dac,50200023535069,99351.61,60ec41ba55c00300382672d9,HDFC,Internal Transfers,5eecc6d6449e4f7cfb1c2708,2022-12-16T00:00:00.000Z,IB FUNDS TRANSFER CR-50200035187206 -SL ICK ORGANICS PVT LTD,,,Other,100000
63bfb2b32e1a0ebb7f629dae,50200023535069,699351.61,60ec41ba55c00300382672d9,HDFC,Internal Transfers,5eecc6d6449e4f7cfb1c2708,2022-12-16T00:00:00.000Z,IB FUNDS TRANSFER CR-50200035187206 -SL ICK ORGANICS PVT LTD,,,Other,600000
63bfb2b32e1a0ebb7f629db0,50200023535069,677751.61,60ec41ba55c00300382672d9,HDFC,direct expenses,5eecc6d6449e4f7cfb1c2708,2022-12-16T00:00:00.000Z,"NEFT DR-KKBK0000173-NITISH KUMAR MANDAL- NETBANK, MUM-N350222250682772-21600",,,net_banking_transfer,-21600
63bfb2b32e1a0ebb7f629db2,50200023535069,177751.61,60ec41ba55c00300382672d9,HDFC,Marketing Expense,5eecc6d6449e4f7cfb1c2708,2022-12-16T00:00:00.000Z,"NEFT DR-CITI0000006-FACEBOOK INDIA ONLIN E SERVICES PVT LTD-NETBANK, MUM-N3502222 50685488-500000",,,net_banking_transfer,-500000
63bfb2b32e1a0ebb7f629db4,50200023535069,80551.61,60ec41ba55c00300382672d9,HDFC,direct expenses,5eecc6d6449e4f7cfb1c2708,2022-12-16T00:00:00.000Z,00321000085687-TPT-97200-SAMEER AHUJA,,,net_banking_transfer,-97200
63bfb2b32e1a0ebb7f629db6,50200023535069,580551.61,60ec41ba55c00300382672d9,HDFC,Internal Transfers,5eecc6d6449e4f7cfb1c2708,2022-12-16T00:00:00.000Z,IB FUNDS TRANSFER CR-50200035187206 -SL ICK ORGANICS PVT LTD,,,Other,500000
63bfb2b32e1a0ebb7f629db8,50200023535069,330551.61,60ec41ba55c00300382672d9,HDFC,direct expenses,5eecc6d6449e4f7cfb1c2708,2022-12-16T00:00:00.000Z,"NEFT DR-ICIC0000369-BO INTERNATIONAL-NET BANK, MUM-N350222250693714-250000",,,net_banking_transfer,-250000
63bfb2b32e1a0ebb7f629dba,50200023535069,-901.63,60ec41ba55c00300382672d9,HDFC,direct expenses,5eecc6d6449e4f7cfb1c2708,2022-12-16T00:00:00.000Z,POS 514834XXXXXX9486 E-COMMERCE RP,,,debit_card,-331453.24
63bfb2b32e1a0ebb7f629dbc,50200023535069,-1999.63,60ec41ba55c00300382672d9,HDFC,direct expenses,5eecc6d6449e4f7cfb1c2708,2022-12-16T00:00:00.000Z,POS 514834XXXXXX9486 SMARTSHIFT LOGIS,,,debit_card,-1098
63bfb2b32e1a0ebb7f629dbe,50200023535069,1009.52,60ec41ba55c00300382672d9,HDFC,Transfer in/Revenue-other,5eecc6d6449e4f7cfb1c2708,2022-12-16T00:00:00.000Z,NEFT CR-YESB0000001-EASEBUZZ PVT LTD NOD AL A/C-SLICK ORGANICS PVT LTD-YESB235031 68340,,,net_banking_transfer,3009.15
63bfb2b32e1a0ebb7f629dc1,50200023535069,4596.52,60ec41ba55c00300382672d9,HDFC,Revenue-Mktplace,5eecc6d6449e4f7cfb1c2708,2022-12-16T00:00:00.000Z,NEFT CR-ICIC0000105-MANASH LIFESTYLE PRI,shopping,,net_banking_transfer,3587
63bfb2b32e1a0ebb7f629dc3,50200023535069,11843.84,60ec41ba55c00300382672d9,HDFC,Revenue-COD,5eecc6d6449e4f7cfb1c2708,2022-12-16T00:00:00.000Z,NEFT CR-ICIC0000155-SHIPROCKET COD CRF I D 5373318-SLICK ORGANICS PVT LTD-CMS3009 876647,,,net_banking_transfer,7247.32
63bfb2b32e1a0ebb7f629dc5,50200023535069,31069.84,60ec41ba55c00300382672d9,HDFC,Revenue-Mktplace,5eecc6d6449e4f7cfb1c2708,2022-12-16T00:00:00.000Z,NEFT CR-SCBL0036001-DREAMPLUG TECHNOLOGI ES PRIVATE LIMITED-SLICK ORGANICS PRIVAT E LIMITEDSLICK-IN1ON22121602VLU,,,net_banking_transfer,19226
63bfb2b32e1a0ebb7f629dc7,50200023535069,102853.06,60ec41ba55c00300382672d9,HDFC,Transfer in/Revenue-other,5eecc6d6449e4f7cfb1c2708,2022-12-16T00:00:00.000Z,NEFT CR-YESB0000001-EASEBUZZ PVT LTD NOD AL A/C-SLICK ORGANICS PVT LTD-YESB235032 80245,,,net_banking_transfer,71783.22
63bfb2b32e1a0ebb7f629dc9,50200023535069,-2146.94,60ec41ba55c00300382672d9,HDFC,direct expenses,5eecc6d6449e4f7cfb1c2708,2022-12-16T00:00:00.000Z,"NEFT DR-YESB0000236-DELIGHT VACATION PVT LTD-NETBANK, MUM-N350222251350186-10500 0",,,net_banking_transfer,-105000
63bfb2b32e1a0ebb7f629dcb,50200023535069,-2126.52,60ec41ba55c00300382672d9,HDFC,Transfer in/Revenue-other,5eecc6d6449e4f7cfb1c2708,2022-12-17T00:00:00.000Z,INT. ON SWCR ON-50300498262188,,,Other,20.42
63bfb2b32e1a0ebb7f629dcd,50200023535069,-1872.52,60ec41ba55c00300382672d9,HDFC,Loan-in,5eecc6d6449e4f7cfb1c2708,2022-12-17T00:00:00.000Z,SWEEP-IN CREDIT - 50300498262188,,,self_transfer,254
63bfb2b32e1a0ebb7f629dcf,50200023535069,-1796.06,60ec41ba55c00300382672d9,HDFC,Transfer in/Revenue-other,5eecc6d6449e4f7cfb1c2708,2022-12-17T00:00:00.000Z,INT. ON SWCR ON-50300498262188,,,Other,76.46
63bfb2b32e1a0ebb7f629dd1,50200023535069,-698.06,60ec41ba55c00300382672d9,HDFC,Loan-in,5eecc6d6449e4f7cfb1c2708,2022-12-17T00:00:00.000Z,SWEEP-IN CREDIT - 50300498262188,,,self_transfer,1098
63bfb2b32e1a0ebb7f629dd4,50200023535069,-652.56,60ec41ba55c00300382672d9,HDFC,Transfer in/Revenue-other,5eecc6d6449e4f7cfb1c2708,2022-12-17T00:00:00.000Z,INT. ON SWCR ON-50300498262188,,,Other,45.5
63bfb2b32e1a0ebb7f629dd6,50200023535069,-3.56,60ec41ba55c00300382672d9,HDFC,Loan-in,5eecc6d6449e4f7cfb1c2708,2022-12-17T00:00:00.000Z,SWEEP-IN CREDIT - 50300498262188,,,self_transfer,649
63bfb2b32e1a0ebb7f629dd8,50200023535069,-3.57,60ec41ba55c00300382672d9,HDFC,direct expenses,5eecc6d6449e4f7cfb1c2708,2022-12-17T00:00:00.000Z,INT. ON SWCR ON-50300498262188,,,Other,-0.01
63bfb2b32e1a0ebb7f629dda,50200023535069,0.43,60ec41ba55c00300382672d9,HDFC,Loan-in,5eecc6d6449e4f7cfb1c2708,2022-12-17T00:00:00.000Z,SWEEP-IN CREDIT - 50300498262188,,,self_transfer,4
63bfb2b32e1a0ebb7f629ddc,50200023535069,2975.95,60ec41ba55c00300382672d9,HDFC,Transfer in/Revenue-other,5eecc6d6449e4f7cfb1c2708,2022-12-17T00:00:00.000Z,IMPS-235104903343-EXCRO PAY ESCROW ACC-Y ESB-XXXXXXXXXXX1807-333112298023,,,net_banking_transfer,2975.52
63bfb2b32e1a0ebb7f629dde,50200023535069,5002975.95,60ec41ba55c00300382672d9,HDFC,Internal Transfers,5eecc6d6449e4f7cfb1c2708,2022-12-17T00:00:00.000Z,IB FUNDS TRANSFER CR-50200035187206 -SL ICK ORGANICS PVT LTD,,,Other,5000000
63bfb2b32e1a0ebb7f629de0,50200023535069,10002975.95,60ec41ba55c00300382672d9,HDFC,Internal Transfers,5eecc6d6449e4f7cfb1c2708,2022-12-17T00:00:00.000Z,IB FUNDS TRANSFER CR-50200035187206 -SL ICK ORGANICS PVT LTD,,,Other,5000000
63bfb2b32e1a0ebb7f629de2,50200023535069,9752975.95,60ec41ba55c00300382672d9,HDFC,direct expenses,5eecc6d6449e4f7cfb1c2708,2022-12-17T00:00:00.000Z,57500001065314-TPT-250000-KRAUTER HEALTH CARE LTD,,,net_banking_transfer,-250000
63bfb2b32e1a0ebb7f629de4,50200023535069,12552975.95,60ec41ba55c00300382672d9,HDFC,Internal Transfers,5eecc6d6449e4f7cfb1c2708,2022-12-17T00:00:00.000Z,IB FUNDS TRANSFER CR-50200035187206 -SL ICK ORGANICS PVT LTD,,,Other,2800000
63bfb2b32e1a0ebb7f629de6,50200023535069,12199169.42,60ec41ba55c00300382672d9,HDFC,direct expenses,5eecc6d6449e4f7cfb1c2708,2022-12-17T00:00:00.000Z,POS 514834XXXXXX9486 E-COMMERCE RP,,,debit_card,-353806.53
63bfb2b32e1a0ebb7f629de8,50200023535069,12118169.42,60ec41ba55c00300382672d9,HDFC,direct expenses,5eecc6d6449e4f7cfb1c2708,2022-12-17T00:00:00.000Z,50200054531492-TPT-81000-ALETA PEOPLE SE RVICES,,,net_banking_transfer,-81000
63bfb2b32e1a0ebb7f629dea,50200023535069,12031812.42,60ec41ba55c00300382672d9,HDFC,direct expenses,5eecc6d6449e4f7cfb1c2708,2022-12-17T00:00:00.000Z,50200054531492-TPT-86357-ALETA PEOPLE SE RVICES,,,net_banking_transfer,-86357
63bfb2b32e1a0ebb7f629dec,50200023535069,11953512.42,60ec41ba55c00300382672d9,HDFC,direct expenses,5eecc6d6449e4f7cfb1c2708,2022-12-17T00:00:00.000Z,"NEFT DR-KKBK0005289-HILL GROOVE CONSULTI NG LLP-NETBANK, MUM-N351222251618674-783 00",,,net_banking_transfer,-78300
63bfb2b32e1a0ebb7f629dee,50200023535069,11907612.42,60ec41ba55c00300382672d9,HDFC,direct expenses,5eecc6d6449e4f7cfb1c2708,2022-12-17T00:00:00.000Z,50200063349422-TPT-45900-COHORT E-COMMER CE CONSULTING LLP,,,net_banking_transfer,-45900
63bfb2b32e1a0ebb7f629df0,50200023535069,11798436.42,60ec41ba55c00300382672d9,HDFC,direct expenses,5eecc6d6449e4f7cfb1c2708,2022-12-17T00:00:00.000Z,00921000075586-TPT-109176-ROET BINDRA,,,net_banking_transfer,-109176
63bfb2b32e1a0ebb7f629df2,50200023535069,11690436.42,60ec41ba55c00300382672d9,HDFC,direct expenses,5eecc6d6449e4f7cfb1c2708,2022-12-17T00:00:00.000Z,"NEFT DR-BARB0VJMATU-ARTISTO DESIGNZ-NETB ANK, MUM-N351222251613565-108000",,,net_banking_transfer,-108000
63bfb2b32e1a0ebb7f629df4,50200023535069,11614076.42,60ec41ba55c00300382672d9,HDFC,direct expenses,5eecc6d6449e4f7cfb1c2708,2022-12-17T00:00:00.000Z,"NEFT DR-DBSS0IN0811-SARANSH KULKARNI-NET BANK, MUM-N351222251602708-76360",,,net_banking_transfer,-76360
63bfb2b32e1a0ebb7f629df6,50200023535069,11590476.42,60ec41ba55c00300382672d9,HDFC,direct expenses,5eecc6d6449e4f7cfb1c2708,2022-12-17T00:00:00.000Z,"NEFT DR-CNRB0015170-SNEHAL TAYDE-NETBANK , MUM-N351222251602865-23600",,,net_banking_transfer,-23600
63bfb2b32e1a0ebb7f629df8,50200023535069,11576476.42,60ec41ba55c00300382672d9,HDFC,direct expenses,5eecc6d6449e4f7cfb1c2708,2022-12-17T00:00:00.000Z,"NEFT DR-ICIC0000715-GAJENDRA BAHADUR SIN GH-NETBANK, MUM-N351222251622299-14000",,,net_banking_transfer,-14000
63bfb2b32e1a0ebb7f629dfa,50200023535069,11567072.42,60ec41ba55c00300382672d9,HDFC,agency/vendor expense,5eecc6d6449e4f7cfb1c2708,2022-12-17T00:00:00.000Z,"NEFT DR-UTIB0003557-INCOSEC LEGAL-NETBAN K, MUM-N351222251614797-9404",,,net_banking_transfer,-9404
63bfb2b32e1a0ebb7f629dfc,50200023535069,6567072.42,60ec41ba55c00300382672d9,HDFC,direct expenses,5eecc6d6449e4f7cfb1c2708,2022-12-17T00:00:00.000Z,FD BOOKED - 50300720578746 : SLICK ORGAN ICS PVT LTD,,,investment,-5000000
63bfb2b32e1a0ebb7f629dfe,50200023535069,1567072.42,60ec41ba55c00300382672d9,HDFC,direct expenses,5eecc6d6449e4f7cfb1c2708,2022-12-17T00:00:00.000Z,FD BOOKED - 50300720580141 : SLICK ORGAN ICS PVT LTD,,,investment,-5000000
63bfb2b32e1a0ebb7f629e01,50200023535069,1562758,60ec41ba55c00300382672d9,HDFC,Marketing Expense,5eecc6d6449e4f7cfb1c2708,2022-12-17T00:00:00.000Z,ME DC SI 514834XXXXXX9486 LINKEDIN (PGSI ),,,Other,-4314.42
63bfb2b32e1a0ebb7f629e03,50200023535069,1535468,60ec41ba55c00300382672d9,HDFC,direct expenses,5eecc6d6449e4f7cfb1c2708,2022-12-17T00:00:00.000Z,"NEFT DR-KKBK0000208-SYSCOM PACKAGING COM PANY-NETBANK, MUM-N351222252038087-27290",,,net_banking_transfer,-27290
63bfb2b32e1a0ebb7f629e05,50200023535069,1535026,60ec41ba55c00300382672d9,HDFC,direct expenses,5eecc6d6449e4f7cfb1c2708,2022-12-17T00:00:00.000Z,POS 514834XXXXXX9486 SMARTSHIFT LOGIS,,,debit_card,-442
63bfb2b32e1a0ebb7f629e07,50200023535069,1548206.35,60ec41ba55c00300382672d9,HDFC,Transfer in/Revenue-other,5eecc6d6449e4f7cfb1c2708,2022-12-17T00:00:00.000Z,NEFT CR-YESB0000001-EASEBUZZ PVT LTD NOD,,,net_banking_transfer,13180.35
63bfb2b32e1a0ebb7f629e09,50200023535069,1596730.81,60ec41ba55c00300382672d9,HDFC,Transfer in/Revenue-other,5eecc6d6449e4f7cfb1c2708,2022-12-17T00:00:00.000Z,NEFT CR-YESB0000001-EASEBUZZ PVT LTD NOD AL A/C-SLICK ORGANICS PVT LTD-YESB235163 85982,,,net_banking_transfer,48524.46
63bfb2b32e1a0ebb7f629e0b,50200023535069,1596359.74,60ec41ba55c00300382672d9,HDFC,Marketing Expense,5eecc6d6449e4f7cfb1c2708,2022-12-18T00:00:00.000Z,ME DC SI 514834XXXXXX9486 FACEBOOK SI,,,Other,-371.07
63bfb2b32e1a0ebb7f629e0d,50200023535069,1591403.74,60ec41ba55c00300382672d9,HDFC,Marketing Expense,5eecc6d6449e4f7cfb1c2708,2022-12-18T00:00:00.000Z,ME DC SI 514834XXXXXX9486 FACEBOOK SI,,,Other,-4956
63bfb2b42e1a0ebb7f629e0f,50200023535069,1590223.74,60ec41ba55c00300382672d9,HDFC,Marketing Expense,5eecc6d6449e4f7cfb1c2708,2022-12-18T00:00:00.000Z,ME DC SI 514834XXXXXX9486 FACEBOOK SI,,,Other,-1180
63bfb2b42e1a0ebb7f629e11,50200023535069,1589043.74,60ec41ba55c00300382672d9,HDFC,Marketing Expense,5eecc6d6449e4f7cfb1c2708,2022-12-18T00:00:00.000Z,ME DC SI 514834XXXXXX9486 FACEBOOK SI,,,Other,-1180
63bfb2b42e1a0ebb7f629e13,50200023535069,1587863.74,60ec41ba55c00300382672d9,HDFC,Marketing Expense,5eecc6d6449e4f7cfb1c2708,2022-12-19T00:00:00.000Z,ME DC SI 514834XXXXXX9486 FACEBOOK INDIA ONLINE,,,Other,-1180
63bfb2b42e1a0ebb7f629e15,50200023535069,1426928.74,60ec41ba55c00300382672d9,HDFC,direct expenses,5eecc6d6449e4f7cfb1c2708,2022-12-19T00:00:00.000Z,09291610057185 NET BANKING SI -160935,,,Other,-160935
63bfb2b42e1a0ebb7f629e17,50200023535069,1336928.74,60ec41ba55c00300382672d9,HDFC,direct expenses,5eecc6d6449e4f7cfb1c2708,2022-12-19T00:00:00.000Z,NEFT DR-ICIC0006643-KRISHNA PACKAGING CO MPANY-SANDOZ - MUM-N353222252839174-NET BANKING SI -90000,,,net_banking_transfer,-90000
63bfb2b42e1a0ebb7f629e19,50200023535069,1340687.93,60ec41ba55c00300382672d9,HDFC,Transfer in/Revenue-other,5eecc6d6449e4f7cfb1c2708,2022-12-19T00:00:00.000Z,IMPS-235306687619-EXCRO PAY ESCROW ACC-Y ESB-XXXXXXXXXXX1807-333112298023,,,net_banking_transfer,3759.19
63bfb2b42e1a0ebb7f629e1b,50200023535069,1339507.93,60ec41ba55c00300382672d9,HDFC,Marketing Expense,5eecc6d6449e4f7cfb1c2708,2022-12-19T00:00:00.000Z,ME DC SI 514834XXXXXX9486 FACEBOOK INDIA ONLINE,,,Other,-1180
63bfb2b42e1a0ebb7f629e1e,50200023535069,1348478.11,60ec41ba55c00300382672d9,HDFC,Revenue-Mktplace,5eecc6d6449e4f7cfb1c2708,2022-12-19T00:00:00.000Z,NEFT CR-DEUT0797BGL-MYNTRA DESIGNS PRIVA TE LIMITED-SLICK ORGANICS - SJIT-2353010 14GN00013,shopping,,net_banking_transfer,8970.18
63bfb2b42e1a0ebb7f629e20,50200023535069,1361245.97,60ec41ba55c00300382672d9,HDFC,Revenue-Mktplace,5eecc6d6449e4f7cfb1c2708,2022-12-19T00:00:00.000Z,NEFT CR-DEUT0797BGL-MYNTRA DESIGNS PRIVA TE LIMITED-SLICK ORGANICS - SJIT-2353010 15GN00016,shopping,,net_banking_transfer,12767.86
63bfb2b42e1a0ebb7f629e22,50200023535069,1336945.97,60ec41ba55c00300382672d9,HDFC,N-ACH payments,5eecc6d6449e4f7cfb1c2708,2022-12-19T00:00:00.000Z,"NEFT DR-UTIB0000328-SACHIN NARENDRA PAND EY-NETBANK, MUM-N353222252926256-24300",,,net_banking_transfer,-24300
63bfb2b42e1a0ebb7f629e24,50200023535069,1343932.91,60ec41ba55c00300382672d9,HDFC,Revenue-Mktplace,5eecc6d6449e4f7cfb1c2708,2022-12-19T00:00:00.000Z,NEFT CR-DEUT0797BGL-MYNTRA DESIGNS PRIVA,shopping,,net_banking_transfer,6986.94
63bfb2b42e1a0ebb7f629e26,50200023535069,1290832.91,60ec41ba55c00300382672d9,HDFC,direct expenses,5eecc6d6449e4f7cfb1c2708,2022-12-19T00:00:00.000Z,"NEFT DR-KKBK0005033-AMBARISH CHATTEJEE-N ETBANK, MUM-N353222252919550-53100",,,net_banking_transfer,-53100
63bfb2b42e1a0ebb7f629e28,50200023535069,1295747.08,60ec41ba55c00300382672d9,HDFC,Revenue-PG-split enabled,5eecc6d6449e4f7cfb1c2708,2022-12-19T00:00:00.000Z,NEFT CR-RATN0000999-RAZORPAY SOFTWARE PV T LTD-SLICK ORGANICS PVT LITD-0002879262 33,,,net_banking_transfer,4914.17
63bfb2b42e1a0ebb7f629e2a,50200023535069,1255747.08,60ec41ba55c00300382672d9,HDFC,direct expenses,5eecc6d6449e4f7cfb1c2708,2022-12-19T00:00:00.000Z,50200031463664-TPT-40000-SWASTIK PACKAGI NGS,,,net_banking_transfer,-40000
63bfb2b42e1a0ebb7f629e2c,50200023535069,1254567.08,60ec41ba55c00300382672d9,HDFC,Marketing Expense,5eecc6d6449e4f7cfb1c2708,2022-12-19T00:00:00.000Z,ME DC SI 514834XXXXXX9486 FACEBOOK SI,,,Other,-1180
63bfb2b42e1a0ebb7f629e2e,50200023535069,1252887.04,60ec41ba55c00300382672d9,HDFC,Marketing Expense,5eecc6d6449e4f7cfb1c2708,2022-12-19T00:00:00.000Z,POS 514834XXXXXX9486 PAY*WWW FACEBOOK,,,debit_card,-1680.04
63bfb2b42e1a0ebb7f629e30,50200023535069,1252250.04,60ec41ba55c00300382672d9,HDFC,direct expenses,5eecc6d6449e4f7cfb1c2708,2022-12-19T00:00:00.000Z,"NEFT DR-KKBK0000208-SYSCOM PACKAGING COM PANY-NETBANK, MUM-N353222253161222-637",,,net_banking_transfer,-637
63bfb2b42e1a0ebb7f629e32,50200023535069,997250.04,60ec41ba55c00300382672d9,HDFC,direct expenses,5eecc6d6449e4f7cfb1c2708,2022-12-19T00:00:00.000Z,57500000443889-TPT-255000-WEBKLIPPER TEC HNOLOGIES PRIVATE LIMITED,,,net_banking_transfer,-255000
63bfb2b42e1a0ebb7f629e34,50200023535069,996969.04,60ec41ba55c00300382672d9,HDFC,direct expenses,5eecc6d6449e4f7cfb1c2708,2022-12-19T00:00:00.000Z,POS 514834XXXXXX9486 PTM*PAYTM WALLET,ewallet,,debit_card,-281
63bfb2b42e1a0ebb7f629e36,50200023535069,1003176.82,60ec41ba55c00300382672d9,HDFC,Revenue-Mktplace,5eecc6d6449e4f7cfb1c2708,2022-12-19T00:00:00.000Z,NEFT CR-ICIC0000105-MANASH LIFESTYLE PRI VATE LIMITED NO-SLICK ORGANICS PRIVATE L IMITED-ICIJ223530001722,shopping,,net_banking_transfer,6207.78
63bfb2b42e1a0ebb7f629e38,50200023535069,1005789.42,60ec41ba55c00300382672d9,HDFC,Transfer in/Revenue-other,5eecc6d6449e4f7cfb1c2708,2022-12-19T00:00:00.000Z,NEFT CR-UTIB0000114-ONE SIGMA TECHNOLOGI ES PRIVATE LIM-SLICK ORGANICS PRIVATE LI MITED-AXISP00347294471,bnpl,,net_banking_transfer,2612.6
63bfb2b42e1a0ebb7f629e3a,50200023535069,1008464.58,60ec41ba55c00300382672d9,HDFC,Transfer in/Revenue-other,5eecc6d6449e4f7cfb1c2708,2022-12-19T00:00:00.000Z,NEFT CR-UTIB0000114-ONE SIGMA TECHNOLOGI ES PRIVATE LIM-SLICK ORGANICS PRIVATE LI MITED-AXISP00347294514,bnpl,,net_banking_transfer,2675.16
63bfb2b42e1a0ebb7f629e3c,50200023535069,1012046.42,60ec41ba55c00300382672d9,HDFC,Transfer in/Revenue-other,5eecc6d6449e4f7cfb1c2708,2022-12-19T00:00:00.000Z,NEFT CR-UTIB0000114-ONE SIGMA TECHNOLOGI ES PRIVATE LIM-SLICK ORGANICS PRIVATE LI MITED-AXISP00347294440,bnpl,,net_banking_transfer,3581.84
63bfb2b42e1a0ebb7f629e3e,50200023535069,1027924.01,60ec41ba55c00300382672d9,HDFC,Revenue-COD,5eecc6d6449e4f7cfb1c2708,2022-12-19T00:00:00.000Z,NEFT CR-ICIC0000155-SHIPROCKET COD CRF I D 5379904-SLICK ORGANICS PVT LTD-CMS3015 277535,,,net_banking_transfer,15877.59
63bfb2b42e1a0ebb7f629e40,50200023535069,1026955.01,60ec41ba55c00300382672d9,HDFC,direct expenses,5eecc6d6449e4f7cfb1c2708,2022-12-19T00:00:00.000Z,POS 514834XXXXXX9486 PTM*PAYTM WALLET,ewallet,,debit_card,-969
63bfb2b42e1a0ebb7f629e42,50200023535069,1157540.71,60ec41ba55c00300382672d9,HDFC,Transfer in/Revenue-other,5eecc6d6449e4f7cfb1c2708,2022-12-19T00:00:00.000Z,NEFT CR-YESB0000001-EASEBUZZ PVT LTD NOD,,,net_banking_transfer,130585.7
63bfb2b42e1a0ebb7f629e44,50200023535069,1159309.17,60ec41ba55c00300382672d9,HDFC,Revenue-PG-split enabled,5eecc6d6449e4f7cfb1c2708,2022-12-19T00:00:00.000Z,NEFT CR-RATN0000999-RAZORPAY SOFTWARE PV T LTD-SLICK ORGANICS PVT LITD-0002879994 11,,,net_banking_transfer,1768.46
63bfb2b42e1a0ebb7f629e46,50200023535069,1174059.17,60ec41ba55c00300382672d9,HDFC,Transfer in/Revenue-other,5eecc6d6449e4f7cfb1c2708,2022-12-19T00:00:00.000Z,00640330000510-SLICK ORGANICS PVT L,,,Other,14750
63bfb2b42e1a0ebb7f629e48,50200023535069,1173385.95,60ec41ba55c00300382672d9,HDFC,bank charges,5eecc6d6449e4f7cfb1c2708,2022-12-19T00:00:00.000Z,.DC INTL POS TXN MARKUP+ST 011222 021222 -CDT2233912799612,,,international_transaction_arbitrage,-673.22
63bfb2b42e1a0ebb7f629e4a,50200023535069,1165125.95,60ec41ba55c00300382672d9,HDFC,direct expenses,5eecc6d6449e4f7cfb1c2708,2022-12-19T00:00:00.000Z,POS 514834XXXXXX9486 WHIZDOM CLUB MQD,,,debit_card,-8260
63bfb2b42e1a0ebb7f629e4c,50200023535069,1164922.52,60ec41ba55c00300382672d9,HDFC,bank charges,5eecc6d6449e4f7cfb1c2708,2022-12-19T00:00:00.000Z,.DC INTL POS TXN MARKUP+ST 021222 031222 -CDT2233912799612,,,international_transaction_arbitrage,-203.43
63bfb2b42e1a0ebb7f629e4e,50200023535069,1163510.03,60ec41ba55c00300382672d9,HDFC,bank charges,5eecc6d6449e4f7cfb1c2708,2022-12-19T00:00:00.000Z,.DC INTL POS TXN MARKUP+ST 031222 051222 -CDT2233912799612,,,international_transaction_arbitrage,-1412.49
63bfb2b42e1a0ebb7f629e50,50200023535069,1162330.03,60ec41ba55c00300382672d9,HDFC,Marketing Expense,5eecc6d6449e4f7cfb1c2708,2022-12-19T00:00:00.000Z,ME DC SI 514834XXXXXX9486 FACEBOOK INDIA ONLINE,,,Other,-1180
63bfb2b42e1a0ebb7f629e52,50200023535069,1162333.03,60ec41ba55c00300382672d9,HDFC,Transfer in/Revenue-other,5eecc6d6449e4f7cfb1c2708,2022-12-19T00:00:00.000Z,CRV POS 514834******9486 FACEBOOK INDIA,,,refund,3
63bfb2b42e1a0ebb7f629e54,50200023535069,1164272.51,60ec41ba55c00300382672d9,HDFC,Transfer in/Revenue-other,5eecc6d6449e4f7cfb1c2708,2022-12-20T00:00:00.000Z,IMPS-235404808286-EXCRO PAY ESCROW ACC-Y ESB-XXXXXXXXXXX1807-333112298023,,,net_banking_transfer,1939.48
63bfb2b42e1a0ebb7f629e56,50200023535069,1162502.51,60ec41ba55c00300382672d9,HDFC,Marketing Expense,5eecc6d6449e4f7cfb1c2708,2022-12-20T00:00:00.000Z,ME DC SI 514834XXXXXX9486 FACEBOOK INDIA ONLINE,,,Other,-1770
63bfb2b42e1a0ebb7f629e5b,50200023535069,1062502.51,60ec41ba55c00300382672d9,HDFC,direct expenses,5eecc6d6449e4f7cfb1c2708,2022-12-20T00:00:00.000Z,"NEFT DR-UTIB0000032-SKUMAR MULTIPRODUCTS PVT LTD-NETBANK, MUM-N354222254227907-1 00000",,,net_banking_transfer,-100000
63bfb2b42e1a0ebb7f629e60,50200023535069,1064436.58,60ec41ba55c00300382672d9,HDFC,Revenue-PG-split enabled,5eecc6d6449e4f7cfb1c2708,2022-12-20T00:00:00.000Z,NEFT CR-RATN0000999-RAZORPAY SOFTWARE PV T LTD-SLICK ORGANICS PVT LITD-0002881002 27,,,net_banking_transfer,1934.07
63bfb2b42e1a0ebb7f629e62,50200023535069,991754.58,60ec41ba55c00300382672d9,HDFC,Tax,5eecc6d6449e4f7cfb1c2708,2022-12-20T00:00:00.000Z,GST/BANK REFERENCE NO: R2235439926855/CI N NO: HDFC22120700190090,tax,gst,Other,-72682
63bfb2b42e1a0ebb7f629e64,50200023535069,741754.58,60ec41ba55c00300382672d9,HDFC,direct expenses,5eecc6d6449e4f7cfb1c2708,2022-12-20T00:00:00.000Z,"NEFT DR-KKBK0000180-VEDIC COSMECEUTICALS PVT LTD-NETBANK, MUM-N354222254373966-2 50000",,,net_banking_transfer,-250000
63bfb2b42e1a0ebb7f629e66,50200023535069,591754.58,60ec41ba55c00300382672d9,HDFC,direct expenses,5eecc6d6449e4f7cfb1c2708,2022-12-20T00:00:00.000Z,NEFT DR-YESB0000551-VISTTA COSMETICS-NET,,,net_banking_transfer,-150000
63bfb2b42e1a0ebb7f629e68,50200023535069,341754.58,60ec41ba55c00300382672d9,HDFC,direct expenses,5eecc6d6449e4f7cfb1c2708,2022-12-20T00:00:00.000Z,"NEFT DR-ICIC0000369-BO INTERNATIONAL-NET BANK, MUM-N354222254406339-250000",,,net_banking_transfer,-250000
63bfb2b42e1a0ebb7f629e6a,50200023535069,291754.58,60ec41ba55c00300382672d9,HDFC,direct expenses,5eecc6d6449e4f7cfb1c2708,2022-12-20T00:00:00.000Z,"NEFT DR-BKID0007124-MATRIX PRINTING SOLU TIONS PVT LTD-NETBANK, MUM-N354222254433 315-50000",,,net_banking_transfer,-50000
63bfb2b42e1a0ebb7f629e6c,50200023535069,-458245.42,60ec41ba55c00300382672d9,HDFC,Marketing Expense,5eecc6d6449e4f7cfb1c2708,2022-12-20T00:00:00.000Z,"NEFT DR-CITI0000006-FACEBOOK INDIA ONLIN E SERVICES PVT LTD-NETBANK, MUM-N3542222 54445539-750000",,,net_banking_transfer,-750000
63bfb2b42e1a0ebb7f629e6e,50200023535069,-638245.42,60ec41ba55c00300382672d9,HDFC,direct expenses,5eecc6d6449e4f7cfb1c2708,2022-12-20T00:00:00.000Z,"NEFT DR-SRCB0000281-3D TECHNOPACK PRIVAT E LIMITED-NETBANK, MUM-N354222254443639- 180000",,,net_banking_transfer,-180000
63bfb2b42e1a0ebb7f629e70,50200023535069,-637660.06,60ec41ba55c00300382672d9,HDFC,Transfer in/Revenue-other,5eecc6d6449e4f7cfb1c2708,2022-12-20T00:00:00.000Z,NEFT CR-UTIB0000114-ONE SIGMA TECHNOLOGI ES PRIVATE LIM-SLICK ORGANICS PRIVATE LI MITED-AXISP00347472177,bnpl,,net_banking_transfer,585.36
63bfb2b42e1a0ebb7f629e73,50200023535069,-1037660.06,60ec41ba55c00300382672d9,HDFC,direct expenses,5eecc6d6449e4f7cfb1c2708,2022-12-20T00:00:00.000Z,"NEFT DR-ICIC0000024-TAKE MOTO YOHKI INDI A PRIVATE LIMITED-NETBANK, MUM-N35422225 4511072-400000",travel,,net_banking_transfer,-400000
63bfb2b42e1a0ebb7f629e76,50200023535069,-1287660.06,60ec41ba55c00300382672d9,HDFC,direct expenses,5eecc6d6449e4f7cfb1c2708,2022-12-20T00:00:00.000Z,05892560000649-TPT-250000-DECORPAC INDIA PRIVATE LIMITED,,,net_banking_transfer,-250000
63bfb2b42e1a0ebb7f629e78,50200023535069,-1288762.06,60ec41ba55c00300382672d9,HDFC,direct expenses,5eecc6d6449e4f7cfb1c2708,2022-12-20T00:00:00.000Z,POS 514834XXXXXX9486 PTM*PAYTM WALLET,ewallet,,debit_card,-1102
63bfb2b42e1a0ebb7f629e7a,50200023535069,-1311262.06,60ec41ba55c00300382672d9,HDFC,direct expenses,5eecc6d6449e4f7cfb1c2708,2022-12-20T00:00:00.000Z,"NEFT DR-CITI0000002-ARNAB BISWAS-NETBANK , MUM-N354222254790279-22500",,,net_banking_transfer,-22500
63bfb2b42e1a0ebb7f629e7c,50200023535069,-2106224.06,60ec41ba55c00300382672d9,HDFC,Marketing Expense,5eecc6d6449e4f7cfb1c2708,2022-12-20T00:00:00.000Z,"NEFT DR-CITI0000006-FACEBOOK INDIA ONLIN E SERVICES PVT LTD-NETBANK, MUM-N3542222 55140495-794962",,,net_banking_transfer,-794962
63bfb2b42e1a0ebb7f629e7e,50200023535069,-2104129.2,60ec41ba55c00300382672d9,HDFC,Revenue-PG-split enabled,5eecc6d6449e4f7cfb1c2708,2022-12-20T00:00:00.000Z,NEFT CR-RATN0000999-RAZORPAY SOFTWARE PV T LTD-SLICK ORGANICS PVT LITD-0002881753 87,,,net_banking_transfer,2094.86
63bfb2b42e1a0ebb7f629e80,50200023535069,-2104232.2,60ec41ba55c00300382672d9,HDFC,Tax,5eecc6d6449e4f7cfb1c2708,2022-12-20T00:00:00.000Z,GST/BANK REFERENCE NO: R2235440044565/CI N NO: HDFC22120700231924,tax,gst,Other,-103
63bfb2b42e1a0ebb7f629e82,50200023535069,-2154232.2,60ec41ba55c00300382672d9,HDFC,direct expenses,5eecc6d6449e4f7cfb1c2708,2022-12-20T00:00:00.000Z,50200063961124-TPT-50000-BEYOND ADS,,,net_banking_transfer,-50000
63bfb2b42e1a0ebb7f629e85,50200023535069,-2163672.2,60ec41ba55c00300382672d9,HDFC,direct expenses,5eecc6d6449e4f7cfb1c2708,2022-12-20T00:00:00.000Z,POS 514834XXXXXX9486 WHIZDOM CLUB MQD,,,debit_card,-9440
63bfb2b42e1a0ebb7f629e87,50200023535069,-2072350.08,60ec41ba55c00300382672d9,HDFC,Transfer in/Revenue-other,5eecc6d6449e4f7cfb1c2708,2022-12-20T00:00:00.000Z,NEFT CR-YESB0000001-EASEBUZZ PVT LTD NOD AL A/C-SLICK ORGANICS PVT LTD-YESB235450 15631,,,net_banking_transfer,91322.12
63bfb2b52e1a0ebb7f629e89,50200023535069,-2072517.11,60ec41ba55c00300382672d9,HDFC,bank charges,5eecc6d6449e4f7cfb1c2708,2022-12-20T00:00:00.000Z,.DC INTL POS TXN MARKUP+ST 121222 141222 -CDT2233912799612,,,international_transaction_arbitrage,-167.03
63bfb2b52e1a0ebb7f629e8b,50200023535069,-1572517.11,60ec41ba55c00300382672d9,HDFC,Transfer in/Revenue-other,5eecc6d6449e4f7cfb1c2708,2022-12-20T00:00:00.000Z,IMPS-235419429109-PCPL CENTRAL DISBUR-I DFB-XXXXXXX1507-IMPSTXN,,,net_banking_transfer,500000
63bfb2b52e1a0ebb7f629e8d,50200023535069,-1455681.11,60ec41ba55c00300382672d9,HDFC,Transfer in/Revenue-other,5eecc6d6449e4f7cfb1c2708,2022-12-20T00:00:00.000Z,IMPS-235419429168-PCPL CENTRAL DISBUR-I DFB-XXXXXXX1507-IMPSTXN,,,net_banking_transfer,116836
63bfb2b52e1a0ebb7f629e8f,50200023535069,-1454579.11,60ec41ba55c00300382672d9,HDFC,Loan-in,5eecc6d6449e4f7cfb1c2708,2022-12-21T00:00:00.000Z,SWEEP-IN CREDIT - 50300720578746,,,self_transfer,1102
63bfb2b52e1a0ebb7f629e91,50200023535069,-996333.11,60ec41ba55c00300382672d9,HDFC,Loan-in,5eecc6d6449e4f7cfb1c2708,2022-12-21T00:00:00.000Z,SWEEP-IN CREDIT - 50300720578746,,,self_transfer,458246
63bfb2b52e1a0ebb7f629e93,50200023535069,-816333.11,60ec41ba55c00300382672d9,HDFC,Loan-in,5eecc6d6449e4f7cfb1c2708,2022-12-21T00:00:00.000Z,SWEEP-IN CREDIT - 50300720578746,,,self_transfer,180000
63bfb2b52e1a0ebb7f629e95,50200023535069,-416918.11,60ec41ba55c00300382672d9,HDFC,Loan-in,5eecc6d6449e4f7cfb1c2708,2022-12-21T00:00:00.000Z,SWEEP-IN CREDIT - 50300720578746,,,self_transfer,399415
63bfb2b52e1a0ebb7f629e97,50200023535069,-407478.11,60ec41ba55c00300382672d9,HDFC,Loan-in,5eecc6d6449e4f7cfb1c2708,2022-12-21T00:00:00.000Z,SWEEP-IN CREDIT - 50300720578746,,,self_transfer,9440
63bfb2b52e1a0ebb7f629e99,50200023535069,-157478.11,60ec41ba55c00300382672d9,HDFC,Loan-in,5eecc6d6449e4f7cfb1c2708,2022-12-21T00:00:00.000Z,SWEEP-IN CREDIT - 50300720578746,,,self_transfer,250000
63bfb2b52e1a0ebb7f629e9b,50200023535069,-134978.11,60ec41ba55c00300382672d9,HDFC,Loan-in,5eecc6d6449e4f7cfb1c2708,2022-12-21T00:00:00.000Z,SWEEP-IN CREDIT - 50300720578746,,,self_transfer,22500
63bfb2b52e1a0ebb7f629e9d,50200023535069,0.89,60ec41ba55c00300382672d9,HDFC,Loan-in,5eecc6d6449e4f7cfb1c2708,2022-12-21T00:00:00.000Z,SWEEP-IN CREDIT - 50300720578746,,,self_transfer,134979
63bfb2b52e1a0ebb7f629e9f,50200023535069,26124.89,60ec41ba55c00300382672d9,HDFC,Transfer in/Revenue-other,5eecc6d6449e4f7cfb1c2708,2022-12-21T00:00:00.000Z,NEFT CR-KKBK0000958-OCTAVOS ENTERPRISE S OLUTIONS PVT-SLICK ORGANICS PRIVATE LIMI TED-CMS3552236469558,,,net_banking_transfer,26124
63bfb2b52e1a0ebb7f629ea1,50200023535069,25298.89,60ec41ba55c00300382672d9,HDFC,Marketing Expense,5eecc6d6449e4f7cfb1c2708,2022-12-21T00:00:00.000Z,ME DC SI 514834XXXXXX9486 FACEBOOK INDIA ONLINE,,,Other,-826
63bfb2b52e1a0ebb7f629ea4,50200023535069,30288.57,60ec41ba55c00300382672d9,HDFC,Transfer in/Revenue-other,5eecc6d6449e4f7cfb1c2708,2022-12-21T00:00:00.000Z,IMPS-235504610545-EXCRO PAY ESCROW ACC-Y ESB-XXXXXXXXXXX1807-333112298023,,,net_banking_transfer,4989.68
63bfb2b52e1a0ebb7f629ea6,50200023535069,-37098.43,60ec41ba55c00300382672d9,HDFC,direct expenses,5eecc6d6449e4f7cfb1c2708,2022-12-21T00:00:00.000Z,NEFT DR-UTIB0001696-EMIZA SUPPLY CHAIN S ERVICES PRIVATE LIMI-SANDOZ - MUM-N35522 2255567725-NET BANKING SI -67387,,,net_banking_transfer,-67387
63bfb2b52e1a0ebb7f629ea8,50200023535069,-214696.43,60ec41ba55c00300382672d9,HDFC,direct expenses,5eecc6d6449e4f7cfb1c2708,2022-12-21T00:00:00.000Z,NEFT DR-KKBK0001381-BLC AND ASSOCIATES L LP-SANDOZ - MUM-N355222255567726-NET BAN KING SI -177598,,,net_banking_transfer,-177598
63bfb2b52e1a0ebb7f629ead,50200023535069,-215522.43,60ec41ba55c00300382672d9,HDFC,Marketing Expense,5eecc6d6449e4f7cfb1c2708,2022-12-21T00:00:00.000Z,ME DC SI 514834XXXXXX9486 FACEBOOK SI,,,Other,-826
63bfb2b52e1a0ebb7f629eb2,50200023535069,-217292.43,60ec41ba55c00300382672d9,HDFC,Marketing Expense,5eecc6d6449e4f7cfb1c2708,2022-12-21T00:00:00.000Z,ME DC SI 514834XXXXXX9486 FACEBOOK SI,,,Other,-1770
63bfb2b52e1a0ebb7f629eb4,50200023535069,-218118.43,60ec41ba55c00300382672d9,HDFC,Marketing Expense,5eecc6d6449e4f7cfb1c2708,2022-12-21T00:00:00.000Z,ME DC SI 514834XXXXXX9486 FACEBOOK INDIA ONLINE,,,Other,-826
63bfb2b52e1a0ebb7f629eb6,50200023535069,-215405.23,60ec41ba55c00300382672d9,HDFC,Revenue-PG-split enabled,5eecc6d6449e4f7cfb1c2708,2022-12-21T00:00:00.000Z,NEFT CR-RATN0000999-RAZORPAY SOFTWARE PV T LTD-SLICK ORGANICS PVT LITD-0002882714 16,,,net_banking_transfer,2713.2
63bfb2b52e1a0ebb7f629eb8,50200023535069,-216231.23,60ec41ba55c00300382672d9,HDFC,Marketing Expense,5eecc6d6449e4f7cfb1c2708,2022-12-21T00:00:00.000Z,ME DC SI 514834XXXXXX9486 FACEBOOK INDIA ONLINE,,,Other,-826
63bfb2b52e1a0ebb7f629eba,50200023535069,-211197.64,60ec41ba55c00300382672d9,HDFC,Revenue-Mktplace,5eecc6d6449e4f7cfb1c2708,2022-12-21T00:00:00.000Z,NEFT CR-DEUT0797BGL-MYNTRA DESIGNS PRIVA TE LIMITED-SLICK ORGANICS PVT. LTD.-2355 00909GN00151,shopping,,net_banking_transfer,5033.59
63bfb2b52e1a0ebb7f629ebc,50200023535069,-211296.64,60ec41ba55c00300382672d9,HDFC,direct expenses,5eecc6d6449e4f7cfb1c2708,2022-12-21T00:00:00.000Z,POS 514834XXXXXX9486 PTM*PAYTM WALLET,ewallet,,debit_card,-99
63bfb2b52e1a0ebb7f629ebe,50200023535069,-208211.85,60ec41ba55c00300382672d9,HDFC,Revenue-Mktplace,5eecc6d6449e4f7cfb1c2708,2022-12-21T00:00:00.000Z,NEFT CR-DEUT0797BGL-MYNTRA DESIGNS PRIVA TE LIMITED-SLICK ORGANICS - SJIT-2355009 56GN00162,shopping,,net_banking_transfer,3084.79
63bfb2b52e1a0ebb7f629ec0,50200023535069,-198209.73,60ec41ba55c00300382672d9,HDFC,Revenue-Mktplace,5eecc6d6449e4f7cfb1c2708,2022-12-21T00:00:00.000Z,NEFT CR-DEUT0797BGL-MYNTRA DESIGNS PRIVA TE LIMITED-SLICK ORGANICS - SJIT-2355009 57GN00209,shopping,,net_banking_transfer,10002.12
63bfb2b52e1a0ebb7f629ec2,50200023535069,-183924.23,60ec41ba55c00300382672d9,HDFC,Revenue-Mktplace,5eecc6d6449e4f7cfb1c2708,2022-12-21T00:00:00.000Z,NEFT CR-HSBC0400002-AMAZON SERVICES LLC- SLICK ORGANICS PRIVATE LIMITED-HSBCN2235 5832884,shopping,,net_banking_transfer,14285.5
63bfb2b52e1a0ebb7f629ec4,50200023535069,-185068.23,60ec41ba55c00300382672d9,HDFC,direct expenses,5eecc6d6449e4f7cfb1c2708,2022-12-21T00:00:00.000Z,POS 514834XXXXXX9486 ZEPTO,,,debit_card,-1144
63bfb2b52e1a0ebb7f629ec6,50200023535069,-185613.23,60ec41ba55c00300382672d9,HDFC,direct expenses,5eecc6d6449e4f7cfb1c2708,2022-12-21T00:00:00.000Z,POS 514834XXXXXX9486 SWIGGY,food,,debit_card,-545
63bfb2b52e1a0ebb7f629ec8,50200023535069,-184732.23,60ec41ba55c00300382672d9,HDFC,Revenue-Mktplace,5eecc6d6449e4f7cfb1c2708,2022-12-21T00:00:00.000Z,NEFT CR-ICIC0000105-MANASH LIFESTYLE PRI VATE LIMITED NO-SLICK ORGANICS PRIVATE L IMITED-ICIJ223550003618,shopping,,net_banking_transfer,881
63bfb2b52e1a0ebb7f629eca,50200023535069,-85273.21,60ec41ba55c00300382672d9,HDFC,Transfer in/Revenue-other,5eecc6d6449e4f7cfb1c2708,2022-12-21T00:00:00.000Z,NEFT CR-YESB0000001-EASEBUZZ PVT LTD NOD AL A/C-SLICK ORGANICS PVT LTD-YESB235581 72512,,,net_banking_transfer,99459.02
63bfb2b52e1a0ebb7f629ecc,50200023535069,-88981.21,60ec41ba55c00300382672d9,HDFC,direct expenses,5eecc6d6449e4f7cfb1c2708,2022-12-21T00:00:00.000Z,POS 514834XXXXXX9486 PTM*PAYTM WALLET,ewallet,,debit_card,-3708
63bfb2b52e1a0ebb7f629ece,50200023535069,-86457.01,60ec41ba55c00300382672d9,HDFC,Revenue-PG-split enabled,5eecc6d6449e4f7cfb1c2708,2022-12-21T00:00:00.000Z,NEFT CR-RATN0000999-RAZORPAY SOFTWARE PV T LTD-SLICK ORGANICS PVT LITD-0002883535 26,,,net_banking_transfer,2524.2
63bfb2b52e1a0ebb7f629ed0,50200023535069,-65818.01,60ec41ba55c00300382672d9,HDFC,Transfer in/Revenue-other,5eecc6d6449e4f7cfb1c2708,2022-12-21T00:00:00.000Z,NEFT CR-HSBC0560002-INNOVATIVE RETAIL CO NCEPTS PRIVATE-SLICK ORGANICS PVT LTD-HS BCN22355901026,,,net_banking_transfer,20639
63bfb2b52e1a0ebb7f629ed2,50200023535069,-72898.01,60ec41ba55c00300382672d9,HDFC,direct expenses,5eecc6d6449e4f7cfb1c2708,2022-12-21T00:00:00.000Z,POS 514834XXXXXX9486 WHIZDOM CLUB MQD,,,debit_card,-7080
63bfb2b52e1a0ebb7f629ed4,50200023535069,-1072898.01,60ec41ba55c00300382672d9,HDFC,direct expenses,5eecc6d6449e4f7cfb1c2708,2022-12-21T00:00:00.000Z,"NEFT DR-KKBK0000180-VEDIC COSMECEUTICALS PVT LTD-NETBANK, MUM-N355222256857540-1 000000",,,net_banking_transfer,-1000000
63bfb2b52e1a0ebb7f629ed6,50200023535069,-1073724.01,60ec41ba55c00300382672d9,HDFC,Marketing Expense,5eecc6d6449e4f7cfb1c2708,2022-12-21T00:00:00.000Z,ME DC SI 514834XXXXXX9486 FACEBOOK INDIA ONLINE,,,Other,-826
63bfb2b52e1a0ebb7f629ed8,50200023535069,-1072898.01,60ec41ba55c00300382672d9,HDFC,Loan-in,5eecc6d6449e4f7cfb1c2708,2022-12-22T00:00:00.000Z,SWEEP-IN CREDIT - 50300720578746,,,self_transfer,826
63bfb2b52e1a0ebb7f629eda,50200023535069,-1071128.01,60ec41ba55c00300382672d9,HDFC,Loan-in,5eecc6d6449e4f7cfb1c2708,2022-12-22T00:00:00.000Z,SWEEP-IN CREDIT - 50300720578746,,,self_transfer,1770
63bfb2b52e1a0ebb7f629edc,50200023535069,-1070302.01,60ec41ba55c00300382672d9,HDFC,Loan-in,5eecc6d6449e4f7cfb1c2708,2022-12-22T00:00:00.000Z,SWEEP-IN CREDIT - 50300720578746,,,self_transfer,826
63bfb2b52e1a0ebb7f629ede,50200023535069,-855605.01,60ec41ba55c00300382672d9,HDFC,Loan-in,5eecc6d6449e4f7cfb1c2708,2022-12-22T00:00:00.000Z,SWEEP-IN CREDIT - 50300720578746,,,self_transfer,214697
63bfb2b52e1a0ebb7f629ee0,50200023535069,-854779.01,60ec41ba55c00300382672d9,HDFC,Loan-in,5eecc6d6449e4f7cfb1c2708,2022-12-22T00:00:00.000Z,SWEEP-IN CREDIT - 50300720578746,,,self_transfer,826
63bfb2b52e1a0ebb7f629ee2,50200023535069,0.99,60ec41ba55c00300382672d9,HDFC,Loan-in,5eecc6d6449e4f7cfb1c2708,2022-12-22T00:00:00.000Z,SWEEP-IN CREDIT - 50300720578746,,,self_transfer,854780
63bfb2b52e1a0ebb7f629ee5,50200023535069,-825.01,60ec41ba55c00300382672d9,HDFC,Marketing Expense,5eecc6d6449e4f7cfb1c2708,2022-12-22T00:00:00.000Z,ME DC SI 514834XXXXXX9486 FACEBOOK INDIA ONLINE,,,Other,-826
63bfb2b52e1a0ebb7f629ee7,50200023535069,3013.74,60ec41ba55c00300382672d9,HDFC,Transfer in/Revenue-other,5eecc6d6449e4f7cfb1c2708,2022-12-22T00:00:00.000Z,IMPS-235604706019-EXCRO PAY ESCROW ACC-Y ESB-XXXXXXXXXXX1807-333112298023,,,net_banking_transfer,3838.75
63bfb2b52e1a0ebb7f629eea,50200023535069,2187.74,60ec41ba55c00300382672d9,HDFC,Marketing Expense,5eecc6d6449e4f7cfb1c2708,2022-12-22T00:00:00.000Z,ME DC SI 514834XXXXXX9486 FACEBOOK INDIA ONLINE,,,Other,-826
63bfb2b52e1a0ebb7f629eec,50200023535069,1361.74,60ec41ba55c00300382672d9,HDFC,Marketing Expense,5eecc6d6449e4f7cfb1c2708,2022-12-22T00:00:00.000Z,ME DC SI 514834XXXXXX9486 FACEBOOK INDIA ONLINE,,,Other,-826
63bfb2b52e1a0ebb7f629eef,50200023535069,1990.06,60ec41ba55c00300382672d9,HDFC,Revenue-PG-split enabled,5eecc6d6449e4f7cfb1c2708,2022-12-22T00:00:00.000Z,NEFT CR-RATN0000999-RAZORPAY SOFTWARE PV T LTD-SLICK ORGANICS PVT LITD-0002884482 09,,,net_banking_transfer,628.32
63bfb2b52e1a0ebb7f629ef1,50200023535069,747.7,60ec41ba55c00300382672d9,HDFC,direct expenses,5eecc6d6449e4f7cfb1c2708,2022-12-22T00:00:00.000Z,POS 514834XXXXXX9486 PTM*PAYTM,ewallet,,debit_card,-1242.36
63bfb2b52e1a0ebb7f629ef3,50200023535069,331.7,60ec41ba55c00300382672d9,HDFC,direct expenses,5eecc6d6449e4f7cfb1c2708,2022-12-22T00:00:00.000Z,POS 514834XXXXXX9486 PTM*PAYTM WALLET,ewallet,,debit_card,-416
63bfb2b52e1a0ebb7f629ef5,50200023535069,135443.19,60ec41ba55c00300382672d9,HDFC,Transfer in/Revenue-other,5eecc6d6449e4f7cfb1c2708,2022-12-22T00:00:00.000Z,NEFT CR-YESB0000001-EASEBUZZ PVT LTD NOD,,,net_banking_transfer,135111.49
63bfb2b52e1a0ebb7f629ef7,50200023535069,136778.07,60ec41ba55c00300382672d9,HDFC,Revenue-PG-split enabled,5eecc6d6449e4f7cfb1c2708,2022-12-22T00:00:00.000Z,NEFT CR-RATN0000999-RAZORPAY SOFTWARE PV T LTD-SLICK ORGANICS PVT LITD-0002885103 64,,,net_banking_transfer,1334.88
63bfb2b52e1a0ebb7f629efa,50200023535069,135598.07,60ec41ba55c00300382672d9,HDFC,Marketing Expense,5eecc6d6449e4f7cfb1c2708,2022-12-22T00:00:00.000Z,ME DC SI 514834XXXXXX9486 FACEBOOK INDIA ONLINE,,,Other,-1180
63bfb2b52e1a0ebb7f629efc,50200023535069,134418.07,60ec41ba55c00300382672d9,HDFC,Marketing Expense,5eecc6d6449e4f7cfb1c2708,2022-12-23T00:00:00.000Z,ME DC SI 514834XXXXXX9486 FACEBOOK INDIA ONLINE,,,Other,-1180
63bfb2b52e1a0ebb7f629efe,50200023535069,138144.89,60ec41ba55c00300382672d9,HDFC,Transfer in/Revenue-other,5eecc6d6449e4f7cfb1c2708,2022-12-23T00:00:00.000Z,IMPS-235703765746-EXCRO PAY ESCROW ACC-Y ESB-XXXXXXXXXXX1807-333112298023,,,net_banking_transfer,3726.82
63bfb2b52e1a0ebb7f629f00,50200023535069,136964.89,60ec41ba55c00300382672d9,HDFC,Marketing Expense,5eecc6d6449e4f7cfb1c2708,2022-12-23T00:00:00.000Z,ME DC SI 514834XXXXXX9486 FACEBOOK INDIA ONLINE,,,Other,-1180
63bfb2b52e1a0ebb7f629f02,50200023535069,161564.64,60ec41ba55c00300382672d9,HDFC,Transfer in/Revenue-other,5eecc6d6449e4f7cfb1c2708,2022-12-23T00:00:00.000Z,IMPS-235707852485-EXCRO PAY ESCROW ACC-Y ESB-XXXXXXXXXXX1807-333112298023,,,net_banking_transfer,24599.75
63bfb2b62e1a0ebb7f629f05,50200023535069,170810.92,60ec41ba55c00300382672d9,HDFC,Revenue-Mktplace,5eecc6d6449e4f7cfb1c2708,2022-12-23T00:00:00.000Z,NEFT CR-DEUT0797BGL-MYNTRA DESIGNS PRIVA TE LIMITED-SLICK ORGANICS - SJIT-2357008 20GN00155,shopping,,net_banking_transfer,9246.28
63bfb2b62e1a0ebb7f629f07,50200023535069,173990.85,60ec41ba55c00300382672d9,HDFC,Revenue-Mktplace,5eecc6d6449e4f7cfb1c2708,2022-12-23T00:00:00.000Z,NEFT CR-DEUT0797BGL-MYNTRA DESIGNS PRIVA TE LIMITED-SLICK ORGANICS - SJIT-2357008 21GN00128,shopping,,net_banking_transfer,3179.93
63bfb2b62e1a0ebb7f629f09,50200023535069,179471.86,60ec41ba55c00300382672d9,HDFC,Revenue-Mktplace,5eecc6d6449e4f7cfb1c2708,2022-12-23T00:00:00.000Z,NEFT CR-DEUT0797BGL-MYNTRA DESIGNS PRIVA TE LIMITED-SLICK ORGANICS PVT. LTD.-2357 00839GN00212,shopping,,net_banking_transfer,5481.01
63bfb2b62e1a0ebb7f629f0b,50200023535069,182026.93,60ec41ba55c00300382672d9,HDFC,Revenue-PG-split enabled,5eecc6d6449e4f7cfb1c2708,2022-12-23T00:00:00.000Z,NEFT CR-RATN0000999-RAZORPAY SOFTWARE PV T LTD-SLICK ORGANICS PVT LITD-0002886251 23,,,net_banking_transfer,2555.07
63bfb2b62e1a0ebb7f629f0d,50200023535069,181791.93,60ec41ba55c00300382672d9,HDFC,direct expenses,5eecc6d6449e4f7cfb1c2708,2022-12-23T00:00:00.000Z,POS 514834XXXXXX9486 PTM*PAYTM WALLET,ewallet,,debit_card,-235
63bfb2b62e1a0ebb7f629f0f,50200023535069,181952.16,60ec41ba55c00300382672d9,HDFC,Revenue-PG-non-split,5eecc6d6449e4f7cfb1c2708,2022-12-23T00:00:00.000Z,NEFT CR-YESB0000001-RZPX PVT LTD NODAL A CCOUNT-SLICKORGANICS-YESB23574197208,,,net_banking_transfer,160.23
63bfb2b62e1a0ebb7f629f11,50200023535069,159960.16,60ec41ba55c00300382672d9,HDFC,direct expenses,5eecc6d6449e4f7cfb1c2708,2022-12-23T00:00:00.000Z,50200063961124-TPT-21992-BEYOND ADS,,,net_banking_transfer,-21992
63bfb2b62e1a0ebb7f629f13,50200023535069,150960.16,60ec41ba55c00300382672d9,HDFC,direct expenses,5eecc6d6449e4f7cfb1c2708,2022-12-23T00:00:00.000Z,50100433068791-TPT-9000-NATHIYA KUBENDIR,,,net_banking_transfer,-9000
63bfb2b62e1a0ebb7f629f15,50200023535069,149780.16,60ec41ba55c00300382672d9,HDFC,Marketing Expense,5eecc6d6449e4f7cfb1c2708,2022-12-23T00:00:00.000Z,ME DC SI 514834XXXXXX9486 FACEBOOK INDIA ONLINE,,,Other,-1180
63bfb2b62e1a0ebb7f629f17,50200023535069,151483.41,60ec41ba55c00300382672d9,HDFC,Transfer in/Revenue-other,5eecc6d6449e4f7cfb1c2708,2022-12-23T00:00:00.000Z,NEFT CR-UTIB0000114-ONE SIGMA TECHNOLOGI ES PRIVATE LIM-SLICK ORGANICS PRIVATE LI MITED-AXISP00348228600,bnpl,,net_banking_transfer,1703.25
63bfb2b62e1a0ebb7f629f1b,50200023535069,156174.18,60ec41ba55c00300382672d9,HDFC,Revenue-Mktplace,5eecc6d6449e4f7cfb1c2708,2022-12-23T00:00:00.000Z,NEFT CR-HSBC0400002-AMAZON PAYMENTS UK L IMITED ACCS-SLICK ORGANICS PRIVATE LIMIT ED-HSBCN22357214370,shopping,,net_banking_transfer,4690.77
63bfb2b62e1a0ebb7f629f1d,50200023535069,240853.66,60ec41ba55c00300382672d9,HDFC,Transfer in/Revenue-other,5eecc6d6449e4f7cfb1c2708,2022-12-23T00:00:00.000Z,NEFT CR-YESB0000001-EASEBUZZ PVT LTD NOD AL A/C-SLICK ORGANICS PVT LTD-YESB235744 46064,,,net_banking_transfer,84679.48
63bfb2b62e1a0ebb7f629f1f,50200023535069,243057.9,60ec41ba55c00300382672d9,HDFC,Revenue-PG-split enabled,5eecc6d6449e4f7cfb1c2708,2022-12-23T00:00:00.000Z,NEFT CR-RATN0000999-RAZORPAY SOFTWARE PV T LTD-SLICK ORGANICS PVT LITD-0002886909 46,,,net_banking_transfer,2204.24
63bfb2b62e1a0ebb7f629f21,50200023535069,243736.9,60ec41ba55c00300382672d9,HDFC,Revenue-COD,5eecc6d6449e4f7cfb1c2708,2022-12-23T00:00:00.000Z,NEFT CR-KKBK0000958-PICKRR TECHNOLOGIES PVT LTD-SLICK ORGANICS PRIVATE LIMITED-C MS3572236778558,,,net_banking_transfer,679
63bfb2b62e1a0ebb7f629f23,50200023535069,242556.9,60ec41ba55c00300382672d9,HDFC,Marketing Expense,5eecc6d6449e4f7cfb1c2708,2022-12-23T00:00:00.000Z,ME DC SI 514834XXXXXX9486 FACEBOOK INDIA ONLINE,,,Other,-1180
63bfb2b62e1a0ebb7f629f25,50200023535069,241376.9,60ec41ba55c00300382672d9,HDFC,Marketing Expense,5eecc6d6449e4f7cfb1c2708,2022-12-24T00:00:00.000Z,ME DC SI 514834XXXXXX9486 FACEBOOK INDIA ONLINE,,,Other,-1180
63bfb2b62e1a0ebb7f629f27,50200023535069,245870.83,60ec41ba55c00300382672d9,HDFC,Transfer in/Revenue-other,5eecc6d6449e4f7cfb1c2708,2022-12-24T00:00:00.000Z,IMPS-235804880746-EXCRO PAY ESCROW ACC-Y ESB-XXXXXXXXXXX1807-333112298023,,,net_banking_transfer,4493.93
63bfb2b62e1a0ebb7f629f29,50200023535069,238220.83,60ec41ba55c00300382672d9,HDFC,direct expenses,5eecc6d6449e4f7cfb1c2708,2022-12-24T00:00:00.000Z,50100155187569 NET BANKING SI -7650,,,Other,-7650
63bfb2b62e1a0ebb7f629f2c,50200023535069,223820.83,60ec41ba55c00300382672d9,HDFC,direct expenses,5eecc6d6449e4f7cfb1c2708,2022-12-24T00:00:00.000Z,50100375208010 NET BANKING SI -14400,,,Other,-14400
63bfb2b62e1a0ebb7f629f2e,50200023535069,222640.83,60ec41ba55c00300382672d9,HDFC,Marketing Expense,5eecc6d6449e4f7cfb1c2708,2022-12-24T00:00:00.000Z,ME DC SI 514834XXXXXX9486 FACEBOOK INDIA ONLINE,,,Other,-1180
63bfb2b62e1a0ebb7f629f30,50200023535069,219690.83,60ec41ba55c00300382672d9,HDFC,Marketing Expense,5eecc6d6449e4f7cfb1c2708,2022-12-24T00:00:00.000Z,ME DC SI 514834XXXXXX9486 FACEBOOK INDIA ONLINE,,,Other,-2950
63bfb2b62e1a0ebb7f629f32,50200023535069,217920.83,60ec41ba55c00300382672d9,HDFC,Marketing Expense,5eecc6d6449e4f7cfb1c2708,2022-12-25T00:00:00.000Z,ME DC SI 514834XXXXXX9486 FACEBOOK INDIA,,,Other,-1770
63bfb2b62e1a0ebb7f629f34,50200023535069,220409.22,60ec41ba55c00300382672d9,HDFC,Transfer in/Revenue-other,5eecc6d6449e4f7cfb1c2708,2022-12-25T00:00:00.000Z,IMPS-235909849771-EXCRO PAY ESCROW ACC-Y ESB-XXXXXXXXXXX1807-333112298023,,,net_banking_transfer,2488.39
63bfb2b62e1a0ebb7f629f36,50200023535069,217459.22,60ec41ba55c00300382672d9,HDFC,Marketing Expense,5eecc6d6449e4f7cfb1c2708,2022-12-26T00:00:00.000Z,ME DC SI 514834XXXXXX9486 FACEBOOK INDIA ONLINE,,,Other,-2950
63bfb2b62e1a0ebb7f629f38,50200023535069,215689.22,60ec41ba55c00300382672d9,HDFC,Marketing Expense,5eecc6d6449e4f7cfb1c2708,2022-12-26T00:00:00.000Z,ME DC SI 514834XXXXXX9486 FACEBOOK INDIA ONLINE,,,Other,-1770
63bfb2b62e1a0ebb7f629f3a,50200023535069,216880.31,60ec41ba55c00300382672d9,HDFC,Transfer in/Revenue-other,5eecc6d6449e4f7cfb1c2708,2022-12-26T00:00:00.000Z,IMPS-236003821556-EXCRO PAY ESCROW ACC-Y ESB-XXXXXXXXXXX1807-333112298023,,,net_banking_transfer,1191.09
63bfb2b62e1a0ebb7f629f3c,50200023535069,224872.39,60ec41ba55c00300382672d9,HDFC,Transfer in/Revenue-other,5eecc6d6449e4f7cfb1c2708,2022-12-26T00:00:00.000Z,IMPS-236007914439-EXCRO PAY ESCROW ACC-Y ESB-XXXXXXXXXXX1807-333112298023,,,net_banking_transfer,7992.08
63bfb2b62e1a0ebb7f629f3e,50200023535069,242975.89,60ec41ba55c00300382672d9,HDFC,Revenue-Mktplace,5eecc6d6449e4f7cfb1c2708,2022-12-26T00:00:00.000Z,NEFT CR-DEUT0797BGL-MYNTRA DESIGNS PRIVA TE LIMITED-SLICK ORGANICS - SJIT-2360008 45GN00229,shopping,,net_banking_transfer,18103.5
63bfb2b62e1a0ebb7f629f40,50200023535069,247278.36,60ec41ba55c00300382672d9,HDFC,Revenue-Mktplace,5eecc6d6449e4f7cfb1c2708,2022-12-26T00:00:00.000Z,NEFT CR-DEUT0797BGL-MYNTRA DESIGNS PRIVA TE LIMITED-SLICK ORGANICS PVT. LTD.-2360 00863GN00051,shopping,,net_banking_transfer,4302.47
63bfb2b62e1a0ebb7f629f42,50200023535069,254317.51,60ec41ba55c00300382672d9,HDFC,Revenue-PG-split enabled,5eecc6d6449e4f7cfb1c2708,2022-12-26T00:00:00.000Z,NEFT CR-RATN0000999-RAZORPAY SOFTWARE PV T LTD-SLICK ORGANICS PVT LITD-0002889108 11,,,net_banking_transfer,7039.15
63bfb2b62e1a0ebb7f629f44,50200023535069,229317.51,60ec41ba55c00300382672d9,HDFC,direct expenses,5eecc6d6449e4f7cfb1c2708,2022-12-26T00:00:00.000Z,POS 514834XXXXXX9486 E-COMMERCE RP,,,debit_card,-25000
63bfb2b62e1a0ebb7f629f46,50200023535069,231806.64,60ec41ba55c00300382672d9,HDFC,Transfer in/Revenue-other,5eecc6d6449e4f7cfb1c2708,2022-12-26T00:00:00.000Z,NEFT CR-UTIB0000114-ONE SIGMA TECHNOLOGI ES PRIVATE LIM-SLICK ORGANICS PRIVATE LI MITED-AXISP00348591986,bnpl,,net_banking_transfer,2489.13
63bfb2b62e1a0ebb7f629f48,50200023535069,233260.69,60ec41ba55c00300382672d9,HDFC,Transfer in/Revenue-other,5eecc6d6449e4f7cfb1c2708,2022-12-26T00:00:00.000Z,NEFT CR-UTIB0000114-ONE SIGMA TECHNOLOGI ES PRIVATE LIM-SLICK ORGANICS PRIVATE LI MITED-AXISP00348591968,bnpl,,net_banking_transfer,1454.05
63bfb2b62e1a0ebb7f629f4a,50200023535069,234231.35,60ec41ba55c00300382672d9,HDFC,Transfer in/Revenue-other,5eecc6d6449e4f7cfb1c2708,2022-12-26T00:00:00.000Z,NEFT CR-UTIB0000114-ONE SIGMA TECHNOLOGI ES PRIVATE LIM-SLICK ORGANICS PRIVATE LI MITED-AXISP00348591995,bnpl,,net_banking_transfer,970.66
63bfb2b62e1a0ebb7f629f4c,50200023535069,232279.16,60ec41ba55c00300382672d9,HDFC,Marketing Expense,5eecc6d6449e4f7cfb1c2708,2022-12-26T00:00:00.000Z,ME DC SI 514834XXXXXX9486 LINKEDIN (PGSI ),,,Other,-1952.19
63bfb2b62e1a0ebb7f629f4e,50200023535069,241265.16,60ec41ba55c00300382672d9,HDFC,Transfer in/Revenue-other,5eecc6d6449e4f7cfb1c2708,2022-12-26T00:00:00.000Z,NEFT CR-HSBC0110002-NAPSA PRIVATE LIMITE,,,net_banking_transfer,8986
63bfb2b62e1a0ebb7f629f50,50200023535069,242947.74,60ec41ba55c00300382672d9,HDFC,Revenue-PG-split enabled,5eecc6d6449e4f7cfb1c2708,2022-12-26T00:00:00.000Z,NEFT CR-RATN0000999-RAZORPAY SOFTWARE PV T LTD-SLICK ORGANICS PVT LITD-0002890230 54,,,net_banking_transfer,1682.58
63bfb2b62e1a0ebb7f629f52,50200023535069,500854.73,60ec41ba55c00300382672d9,HDFC,Transfer in/Revenue-other,5eecc6d6449e4f7cfb1c2708,2022-12-26T00:00:00.000Z,NEFT CR-YESB0000001-EASEBUZZ PVT LTD NOD AL A/C-SLICK ORGANICS PVT LTD-YESB236030 56652,,,net_banking_transfer,257906.99
63bfb2b62e1a0ebb7f629f54,50200023535069,500014.3,60ec41ba55c00300382672d9,HDFC,Marketing Expense,5eecc6d6449e4f7cfb1c2708,2022-12-26T00:00:00.000Z,ME DC SI 514834XXXXXX9486 FACEBOOK INDIA ONLINE,,,Other,-840.43
63bfb2b62e1a0ebb7f629f56,50200023535069,497064.3,60ec41ba55c00300382672d9,HDFC,Marketing Expense,5eecc6d6449e4f7cfb1c2708,2022-12-27T00:00:00.000Z,ME DC SI 514834XXXXXX9486 FACEBOOK INDIA ONLINE,,,Other,-2950
63bfb2b62e1a0ebb7f629f58,50200023535069,501737.15,60ec41ba55c00300382672d9,HDFC,Transfer in/Revenue-other,5eecc6d6449e4f7cfb1c2708,2022-12-27T00:00:00.000Z,IMPS-236104786329-EXCRO PAY ESCROW ACC-Y ESB-XXXXXXXXXXX1807-333112298023,,,net_banking_transfer,4672.85
63bfb2b62e1a0ebb7f629f5a,50200023535069,490037.15,60ec41ba55c00300382672d9,HDFC,direct expenses,5eecc6d6449e4f7cfb1c2708,2022-12-27T00:00:00.000Z,50100375208010 NET BANKING SI -11700,,,Other,-11700
63bfb2b62e1a0ebb7f629f5c,50200023535069,450153.15,60ec41ba55c00300382672d9,HDFC,direct expenses,5eecc6d6449e4f7cfb1c2708,2022-12-27T00:00:00.000Z,NEFT DR-PUNB0062910-YADAVPACKAGING-SANDO Z - MUM-N361222261950726-NET BANKING SI -39884,,,net_banking_transfer,-39884
63bfb2b62e1a0ebb7f629f5e,50200023535069,400153.15,60ec41ba55c00300382672d9,HDFC,direct expenses,5eecc6d6449e4f7cfb1c2708,2022-12-27T00:00:00.000Z,NEFT DR-BKID0007124-MATRIX PRINTING SOLU TIONS PVT LTD-SANDOZ - MUM-N361222261950 729-NET BANKING SI -50000,,,net_banking_transfer,-50000
63bfb2b62e1a0ebb7f629f62,50200023535069,348355.15,60ec41ba55c00300382672d9,HDFC,direct expenses,5eecc6d6449e4f7cfb1c2708,2022-12-27T00:00:00.000Z,NEFT DR-ICIC0000021-AKHILESH DIXIT-SANDO Z - MUM-N361222261950731-NET BANKING SI -51798,,,net_banking_transfer,-51798
63bfb2b62e1a0ebb7f629f64,50200023535069,248355.15,60ec41ba55c00300382672d9,HDFC,direct expenses,5eecc6d6449e4f7cfb1c2708,2022-12-27T00:00:00.000Z,NEFT DR-YESB0000236-DELIGHT VACATION PVT LTD-SANDOZ - MUM-N361222261950734-NET B ANKING SI -100000,,,net_banking_transfer,-100000
63bfb2b62e1a0ebb7f629f67,50200023535069,-251644.85,60ec41ba55c00300382672d9,HDFC,direct expenses,5eecc6d6449e4f7cfb1c2708,2022-12-27T00:00:00.000Z,05892560000649-TPT-500000-DECORPAC INDIA PRIVATE LIMITED,,,net_banking_transfer,-500000
63bfb2b62e1a0ebb7f629f69,50200023535069,-274144.85,60ec41ba55c00300382672d9,HDFC,direct expenses,5eecc6d6449e4f7cfb1c2708,2022-12-27T00:00:00.000Z,"NEFT DR-YESB0000307-SOMYA SHARMA-NETBANK , MUM-N361222262089735-22500",,,net_banking_transfer,-22500
63bfb2b62e1a0ebb7f629f6b,50200023535069,-295694.85,60ec41ba55c00300382672d9,HDFC,direct expenses,5eecc6d6449e4f7cfb1c2708,2022-12-27T00:00:00.000Z,00918630000430-TPT-21550-UNICOMMERCE ESO,,,net_banking_transfer,-21550
63bfb2b62e1a0ebb7f629f6e,50200023535069,-292629.84,60ec41ba55c00300382672d9,HDFC,Revenue-PG-split enabled,5eecc6d6449e4f7cfb1c2708,2022-12-27T00:00:00.000Z,NEFT CR-UTIB0001506-RAZORPAY SOFTWARE PR IVATE LIMITED-SLICK ORGANICS PVT LITD-AX ISCN0192623924,,,net_banking_transfer,3065.01
63bfb2b62e1a0ebb7f629f70,50200023535069,-295579.84,60ec41ba55c00300382672d9,HDFC,Marketing Expense,5eecc6d6449e4f7cfb1c2708,2022-12-27T00:00:00.000Z,ME DC SI 514834XXXXXX9486 FACEBOOK SI,,,Other,-2950
63bfb2b62e1a0ebb7f629f72,50200023535069,-297244.08,60ec41ba55c00300382672d9,HDFC,bank charges,5eecc6d6449e4f7cfb1c2708,2022-12-27T00:00:00.000Z,.DC INTL POS TXN MARKUP+ST 151222 161222 -CDT2233912799612,,,international_transaction_arbitrage,-1664.24
63bfb2b62e1a0ebb7f629f74,50200023535069,-296311.8,60ec41ba55c00300382672d9,HDFC,Transfer in/Revenue-other,5eecc6d6449e4f7cfb1c2708,2022-12-27T00:00:00.000Z,NEFT CR-UTIB0000114-ONE SIGMA TECHNOLOGI ES PRIVATE LIM-SLICK ORGANICS PRIVATE LI MITED-AXISP00348855249,bnpl,,net_banking_transfer,932.28
63bfb2b62e1a0ebb7f629f76,50200023535069,449281.2,60ec41ba55c00300382672d9,HDFC,Transfer in/Revenue-other,5eecc6d6449e4f7cfb1c2708,2022-12-27T00:00:00.000Z,RTGS CR-IDFB0010204-PCPL CENTRAL DISBURS EMENT AC-SLICK ORGANICS PRIVATE LIMITED- IDFBR52022122700527711,,,net_banking_transfer,745593
63bfb2b62e1a0ebb7f629f78,50200023535069,589002.79,60ec41ba55c00300382672d9,HDFC,Transfer in/Revenue-other,5eecc6d6449e4f7cfb1c2708,2022-12-27T00:00:00.000Z,NEFT CR-YESB0000001-EASEBUZZ PVT LTD NOD AL A/C-SLICK ORGANICS PVT LTD-YESB236161 77256,,,net_banking_transfer,139721.59
63bfb2b62e1a0ebb7f629f7a,50200023535069,587597.95,60ec41ba55c00300382672d9,HDFC,Marketing Expense,5eecc6d6449e4f7cfb1c2708,2022-12-27T00:00:00.000Z,ME DC SI 514834XXXXXX9486 FACEBOOK SI,,,Other,-1404.84
63bfb2b62e1a0ebb7f629f7c,50200023535069,589862.97,60ec41ba55c00300382672d9,HDFC,Revenue-PG-split enabled,5eecc6d6449e4f7cfb1c2708,2022-12-27T00:00:00.000Z,NEFT CR-UTIB0001506-RAZORPAY SOFTWARE PR IVATE LIMITED-SLICK ORGANICS PVT LITD-AX ISCN0192834490,,,net_banking_transfer,2265.02
63bfb2b72e1a0ebb7f629f7e,50200023535069,507464.97,60ec41ba55c00300382672d9,HDFC,direct expenses,5eecc6d6449e4f7cfb1c2708,2022-12-28T00:00:00.000Z,NEFT DR-ICIC0006643-KRISHNA PACKAGING CO MPANY-SANDOZ - MUM-N362222263346357-NET BANKING SI -82398,,,net_banking_transfer,-82398
63bfb2b72e1a0ebb7f629f80,50200023535069,511680.83,60ec41ba55c00300382672d9,HDFC,Transfer in/Revenue-other,5eecc6d6449e4f7cfb1c2708,2022-12-28T00:00:00.000Z,IMPS-236204969364-EXCRO PAY ESCROW ACC-Y ESB-XXXXXXXXXXX1807-333112298023,,,net_banking_transfer,4215.86
63bfb2b72e1a0ebb7f629f82,50200023535069,522220.83,60ec41ba55c00300382672d9,HDFC,Revenue-Mktplace,5eecc6d6449e4f7cfb1c2708,2022-12-28T00:00:00.000Z,NEFT CR-ICIC0000985-DIGITAL AGE RETAIL P VT LTD-SLICK ORGANICS PVT LTD-CMS3029248 694,,,net_banking_transfer,10540
63bfb2b72e1a0ebb7f629f84,50200023535069,524852.06,60ec41ba55c00300382672d9,HDFC,Transfer in/Revenue-other,5eecc6d6449e4f7cfb1c2708,2022-12-28T00:00:00.000Z,IMPS-236207639085-EXCRO PAY ESCROW ACC-Y,,,net_banking_transfer,2631.23
63bfb2b72e1a0ebb7f629f86,50200023535069,533641,60ec41ba55c00300382672d9,HDFC,Revenue-Mktplace,5eecc6d6449e4f7cfb1c2708,2022-12-28T00:00:00.000Z,NEFT CR-DEUT0797BGL-MYNTRA DESIGNS PRIVA TE LIMITED-SLICK ORGANICS - SJIT-2362008 39GN00122,shopping,,net_banking_transfer,8788.94
63bfb2b72e1a0ebb7f629f88,50200023535069,536414.28,60ec41ba55c00300382672d9,HDFC,Revenue-Mktplace,5eecc6d6449e4f7cfb1c2708,2022-12-28T00:00:00.000Z,NEFT CR-DEUT0797BGL-MYNTRA DESIGNS PRIVA TE LIMITED-SLICK ORGANICS PVT. LTD.-2362 00859GN00030,shopping,,net_banking_transfer,2773.28
63bfb2b72e1a0ebb7f629f8a,50200023535069,537536.12,60ec41ba55c00300382672d9,HDFC,Revenue-PG-split enabled,5eecc6d6449e4f7cfb1c2708,2022-12-28T00:00:00.000Z,NEFT CR-UTIB0001506-RAZORPAY SOFTWARE PR IVATE LIMITED-SLICK ORGANICS PVT LITD-AX ISCN0192881600,,,net_banking_transfer,1121.84
63bfb2b72e1a0ebb7f629f8c,50200023535069,535528.94,60ec41ba55c00300382672d9,HDFC,direct expenses,5eecc6d6449e4f7cfb1c2708,2022-12-28T00:00:00.000Z,POS 514834XXXXXX9486 PAYTM_PAYTMBILL,bills,,debit_card,-2007.18
63bfb2b72e1a0ebb7f629f8e,50200023535069,532578.94,60ec41ba55c00300382672d9,HDFC,Marketing Expense,5eecc6d6449e4f7cfb1c2708,2022-12-28T00:00:00.000Z,ME DC SI 514834XXXXXX9486 FACEBOOK SI,,,Other,-2950
63bfb2b72e1a0ebb7f629f90,50200023535069,528540.94,60ec41ba55c00300382672d9,HDFC,direct expenses,5eecc6d6449e4f7cfb1c2708,2022-12-28T00:00:00.000Z,50100349886722-TPT-4038-SHIREEN MEER,,,net_banking_transfer,-4038
63bfb2b72e1a0ebb7f629f94,50200023535069,520540.94,60ec41ba55c00300382672d9,HDFC,direct expenses,5eecc6d6449e4f7cfb1c2708,2022-12-28T00:00:00.000Z,"NEFT DR-YESB0001025-PRIYAMBDA BHANOO-NET BANK, MUM-N362222263927325-8000",,,net_banking_transfer,-8000
63bfb2b72e1a0ebb7f629f96,50200023535069,520949.74,60ec41ba55c00300382672d9,HDFC,Transfer in/Revenue-other,5eecc6d6449e4f7cfb1c2708,2022-12-28T00:00:00.000Z,NEFT CR-UTIB0000114-ONE SIGMA TECHNOLOGI ES PRIVATE LIM-SLICK ORGANICS PRIVATE LI MITED-AXISP00349230932,bnpl,,net_banking_transfer,408.8
63bfb2b72e1a0ebb7f629f98,50200023535069,538605.74,60ec41ba55c00300382672d9,HDFC,Revenue-Mktplace,5eecc6d6449e4f7cfb1c2708,2022-12-28T00:00:00.000Z,NEFT CR-SCBL0036001-DREAMPLUG TECHNOLOGI ES PRIVATE LIMITED-SLICK ORGANICS PRIVAT E LIMITEDSLICK-IN1ON22122803SFK,,,net_banking_transfer,17656
63bfb2b72e1a0ebb7f629f9a,50200023535069,655086.18,60ec41ba55c00300382672d9,HDFC,Transfer in/Revenue-other,5eecc6d6449e4f7cfb1c2708,2022-12-28T00:00:00.000Z,NEFT CR-YESB0000001-EASEBUZZ PVT LTD NOD AL A/C-SLICK ORGANICS PVT LTD-YESB236294 59201,,,net_banking_transfer,116480.44
63bfb2b72e1a0ebb7f629f9c,50200023535069,657564.71,60ec41ba55c00300382672d9,HDFC,Revenue-PG-split enabled,5eecc6d6449e4f7cfb1c2708,2022-12-28T00:00:00.000Z,NEFT CR-UTIB0001506-RAZORPAY SOFTWARE PR IVATE LIMITED-SLICK ORGANICS PVT LITD-AX ISCN0193052087,,,net_banking_transfer,2478.53
63bfb2b72e1a0ebb7f629f9e,50200023535069,662636.18,60ec41ba55c00300382672d9,HDFC,Transfer in/Revenue-other,5eecc6d6449e4f7cfb1c2708,2022-12-29T00:00:00.000Z,IMPS-236304940664-EXCRO PAY ESCROW ACC-Y ESB-XXXXXXXXXXX1807-333112298023,,,net_banking_transfer,5071.47
63bfb2b72e1a0ebb7f629fa0,50200023535069,664284.92,60ec41ba55c00300382672d9,HDFC,Revenue-PG-split enabled,5eecc6d6449e4f7cfb1c2708,2022-12-29T00:00:00.000Z,NEFT CR-UTIB0001506-RAZORPAY SOFTWARE PR,,,net_banking_transfer,1648.74
63bfb2b72e1a0ebb7f629fa2,50200023535069,669214.37,60ec41ba55c00300382672d9,HDFC,Transfer in/Revenue-other,5eecc6d6449e4f7cfb1c2708,2022-12-29T00:00:00.000Z,NEFT CR-UTIB0000114-ONE SIGMA TECHNOLOGI ES PRIVATE LIM-SLICK ORGANICS PRIVATE LI MITED-AXISP00349584033,bnpl,,net_banking_transfer,4929.45
63bfb2b72e1a0ebb7f629fa4,50200023535069,633623.37,60ec41ba55c00300382672d9,HDFC,direct expenses,5eecc6d6449e4f7cfb1c2708,2022-12-29T00:00:00.000Z,"NEFT DR-SCBL0036025-DHRUV MADHOK-NETBANK , MUM-N363222265503650-35591",,,net_banking_transfer,-35591
63bfb2b72e1a0ebb7f629fa6,50200023535069,414513.37,60ec41ba55c00300382672d9,HDFC,direct expenses,5eecc6d6449e4f7cfb1c2708,2022-12-29T00:00:00.000Z,"NEFT DR-SCBL0036025-DHRUV MADHOK-NETBANK , MUM-N363222265504739-219110",,,net_banking_transfer,-219110
63bfb2b72e1a0ebb7f629fa8,50200023535069,205073.37,60ec41ba55c00300382672d9,HDFC,direct expenses,5eecc6d6449e4f7cfb1c2708,2022-12-29T00:00:00.000Z,02711930004579-TPT-209440-DHRUV BHASIN,,,net_banking_transfer,-209440
63bfb2b72e1a0ebb7f629faa,50200023535069,511913.79,60ec41ba55c00300382672d9,HDFC,Revenue-Mktplace,5eecc6d6449e4f7cfb1c2708,2022-12-29T00:00:00.000Z,NEFT CR-KKBK0000958-NYKAA E RETAIL PRIVA TE LIMITED NYKAA-SLICK ORGANICS PVT LTD- KKBK223634924062,,,net_banking_transfer,306840.42
63bfb2b72e1a0ebb7f629fac,50200023535069,511594.79,60ec41ba55c00300382672d9,HDFC,direct expenses,5eecc6d6449e4f7cfb1c2708,2022-12-29T00:00:00.000Z,POS 514834XXXXXX9486 SMARTSHIFT LOGIS,,,debit_card,-319
63bfb2b72e1a0ebb7f629fae,50200023535069,510715.79,60ec41ba55c00300382672d9,HDFC,direct expenses,5eecc6d6449e4f7cfb1c2708,2022-12-29T00:00:00.000Z,POS 514834XXXXXX9486 ADOBE ACROBAT ST,,,debit_card,-879
63bfb2b72e1a0ebb7f629fb0,50200023535069,508686.79,60ec41ba55c00300382672d9,HDFC,direct expenses,5eecc6d6449e4f7cfb1c2708,2022-12-29T00:00:00.000Z,POS 514834XXXXXX9486 ADOBE CREATIVE C,,,debit_card,-2029
63bfb2b72e1a0ebb7f629fb2,50200023535069,508603.79,60ec41ba55c00300382672d9,HDFC,direct expenses,5eecc6d6449e4f7cfb1c2708,2022-12-29T00:00:00.000Z,POS 514834XXXXXX9486 SMARTSHIFT LOGIS,,,debit_card,-83
63bfb2b72e1a0ebb7f629fb4,50200023535069,671363.38,60ec41ba55c00300382672d9,HDFC,Transfer in/Revenue-other,5eecc6d6449e4f7cfb1c2708,2022-12-29T00:00:00.000Z,NEFT CR-YESB0000001-EASEBUZZ PVT LTD NOD AL A/C-SLICK ORGANICS PVT LTD-YESB236327 13345,,,net_banking_transfer,162759.59
63bfb2b72e1a0ebb7f629fb6,50200023535069,673314.15,60ec41ba55c00300382672d9,HDFC,Revenue-PG-split enabled,5eecc6d6449e4f7cfb1c2708,2022-12-29T00:00:00.000Z,NEFT CR-UTIB0001506-RAZORPAY SOFTWARE PR IVATE LIMITED-SLICK ORGANICS PVT LITD-AX ISCN0193308711,,,net_banking_transfer,1950.77
63bfb2b72e1a0ebb7f629fb8,50200023535069,674671.34,60ec41ba55c00300382672d9,HDFC,Transfer in/Revenue-other,5eecc6d6449e4f7cfb1c2708,2022-12-29T00:00:00.000Z,IMPS-236323737781-EXCRO PAY ESCROW ACC-Y ESB-XXXXXXXXXXX1807-333112298023,,,net_banking_transfer,1357.19
63bfb2b72e1a0ebb7f629fba,50200023535069,670541.34,60ec41ba55c00300382672d9,HDFC,Marketing Expense,5eecc6d6449e4f7cfb1c2708,2022-12-30T00:00:00.000Z,ME DC SI 514834XXXXXX9486 FACEBOOK SI,,,Other,-4130
63bfb2b72e1a0ebb7f629fbc,50200023535069,674813.28,60ec41ba55c00300382672d9,HDFC,Transfer in/Revenue-other,5eecc6d6449e4f7cfb1c2708,2022-12-30T00:00:00.000Z,IMPS-236403926925-EXCRO PAY ESCROW ACC-Y ESB-XXXXXXXXXXX1807-333112298023,,,net_banking_transfer,4271.94
63bfb2b72e1a0ebb7f629fbe,50200023535069,647813.28,60ec41ba55c00300382672d9,HDFC,direct expenses,5eecc6d6449e4f7cfb1c2708,2022-12-30T00:00:00.000Z,NEFT DR-KKBK0000654-NIHARIKA MISHRA-SAND OZ - MUM-N364222266459778-NET BANKING SI -27000,,,net_banking_transfer,-27000
63bfb2b72e1a0ebb7f629fc1,50200023535069,650673.46,60ec41ba55c00300382672d9,HDFC,Transfer in/Revenue-other,5eecc6d6449e4f7cfb1c2708,2022-12-30T00:00:00.000Z,NEFT CR-YESB0000001-EXCRO PAY ESCROW ACC,,,net_banking_transfer,2860.18
63bfb2b72e1a0ebb7f629fc3,50200023535069,653114.87,60ec41ba55c00300382672d9,HDFC,Revenue-Mktplace,5eecc6d6449e4f7cfb1c2708,2022-12-30T00:00:00.000Z,NEFT CR-DEUT0797BGL-MYNTRA DESIGNS PRIVA TE LIMITED-SLICK ORGANICS PVT. LTD.-2364 00857GN00055,shopping,,net_banking_transfer,2441.41
63bfb2b72e1a0ebb7f629fc5,50200023535069,657215.62,60ec41ba55c00300382672d9,HDFC,Revenue-PG-split enabled,5eecc6d6449e4f7cfb1c2708,2022-12-30T00:00:00.000Z,NEFT CR-UTIB0001506-RAZORPAY SOFTWARE PR IVATE LIMITED-SLICK ORGANICS PVT LITD-AX ISCN0193418186,,,net_banking_transfer,4100.75
63bfb2b72e1a0ebb7f629fc7,50200023535069,666137.49,60ec41ba55c00300382672d9,HDFC,Revenue-Mktplace,5eecc6d6449e4f7cfb1c2708,2022-12-30T00:00:00.000Z,NEFT CR-DEUT0797BGL-MYNTRA DESIGNS PRIVA TE LIMITED-SLICK ORGANICS - SJIT-2364008 41GN00228,shopping,,net_banking_transfer,8921.87
63bfb2b72e1a0ebb7f629fc9,50200023535069,670174.1,60ec41ba55c00300382672d9,HDFC,Transfer in/Revenue-other,5eecc6d6449e4f7cfb1c2708,2022-12-30T00:00:00.000Z,NEFT CR-UTIB0000114-ONE SIGMA TECHNOLOGI ES PRIVATE LIM-SLICK ORGANICS PRIVATE LI MITED-AXISP00349970260,bnpl,,net_banking_transfer,4036.61
63bfb2b72e1a0ebb7f629fcb,50200023535069,668907.1,60ec41ba55c00300382672d9,HDFC,direct expenses,5eecc6d6449e4f7cfb1c2708,2022-12-30T00:00:00.000Z,POS 514834XXXXXX9486 PTM*PAYTM WALLET,ewallet,,debit_card,-1267
63bfb2b72e1a0ebb7f629fcd,50200023535069,827583.35,60ec41ba55c00300382672d9,HDFC,Transfer in/Revenue-other,5eecc6d6449e4f7cfb1c2708,2022-12-30T00:00:00.000Z,NEFT CR-YESB0000001-EASEBUZZ PVT LTD NOD AL A/C-SLICK ORGANICS PVT LTD-YESB236458 26317,,,net_banking_transfer,158676.25
63bfb2b72e1a0ebb7f629fcf,50200023535069,828151.63,60ec41ba55c00300382672d9,HDFC,Revenue-PG-split enabled,5eecc6d6449e4f7cfb1c2708,2022-12-30T00:00:00.000Z,NEFT CR-UTIB0001506-RAZORPAY SOFTWARE PR IVATE LIMITED-SLICK ORGANICS PVT LITD-AX ISCN0193657130,,,net_banking_transfer,568.28
63bfb2b72e1a0ebb7f629fd1,50200023535069,832842.78,60ec41ba55c00300382672d9,HDFC,Transfer in/Revenue-other,5eecc6d6449e4f7cfb1c2708,2022-12-30T00:00:00.000Z,NEFT CR-YESB0000001-EASEBUZZ PVT LTD NOD AL A/C-SLICK ORGANICS PVT LTD-YESB236459 67222,,,net_banking_transfer,4691.15
63bfb2b72e1a0ebb7f629fd3,50200023535069,814185.78,60ec41ba55c00300382672d9,HDFC,direct expenses,5eecc6d6449e4f7cfb1c2708,2022-12-30T00:00:00.000Z,POS 514834XXXXXX9486 PLAYBOOK.COM,,,debit_card,-18657
63bfb2b72e1a0ebb7f629fd5,50200023535069,814006.78,60ec41ba55c00300382672d9,HDFC,SAAS/tech expense,5eecc6d6449e4f7cfb1c2708,2022-12-30T00:00:00.000Z,ME DC SI 514834XXXXXX9486 AMAZON,shopping,,Other,-179
63bfb2b72e1a0ebb7f629fd7,50200023535069,809006.78,60ec41ba55c00300382672d9,HDFC,direct expenses,5eecc6d6449e4f7cfb1c2708,2022-12-31T00:00:00.000Z,50100230430674 NET BANKING SI -5000,,,Other,-5000
63bfb2b72e1a0ebb7f629fd9,50200023535069,812299.79,60ec41ba55c00300382672d9,HDFC,Transfer in/Revenue-other,5eecc6d6449e4f7cfb1c2708,2022-12-31T00:00:00.000Z,IMPS-236504660232-EXCRO PAY ESCROW ACC-Y ESB-XXXXXXXXXXX1807-333112298023,,,net_banking_transfer,3293.01
63bfb2b72e1a0ebb7f629fdb,50200023535069,808169.79,60ec41ba55c00300382672d9,HDFC,Marketing Expense,5eecc6d6449e4f7cfb1c2708,2022-12-31T00:00:00.000Z,ME DC SI 514834XXXXXX9486 FACEBOOK SI,,,Other,-4130
63bfb2b72e1a0ebb7f629fdd,50200023535069,795669.79,60ec41ba55c00300382672d9,HDFC,direct expenses,5eecc6d6449e4f7cfb1c2708,2022-12-31T00:00:00.000Z,"NEFT DR-UBIN0531944-URVI SHAH-NETBANK, M",,,net_banking_transfer,-12500
63bfb2b72e1a0ebb7f629fdf,50200023535069,797208.88,60ec41ba55c00300382672d9,HDFC,Revenue-PG-split enabled,5eecc6d6449e4f7cfb1c2708,2022-12-31T00:00:00.000Z,NEFT CR-UTIB0001506-RAZORPAY SOFTWARE PR IVATE LIMITED-SLICK ORGANICS PVT LITD-AX ISCN0193758247,,,net_banking_transfer,1539.09
63bfb2b72e1a0ebb7f629fe1,50200023535069,797521.88,60ec41ba55c00300382672d9,HDFC,Transfer in/Revenue-other,5eecc6d6449e4f7cfb1c2708,2022-12-31T00:00:00.000Z,FT- SLICK ORGANICS-50200022102665 - MARG O NETWORKS PRIVATE LIMITED -,,,Other,313
63bfb2b72e1a0ebb7f629fe3,50200023535069,930705.2,60ec41ba55c00300382672d9,HDFC,Transfer in/Revenue-other,5eecc6d6449e4f7cfb1c2708,2022-12-31T00:00:00.000Z,NEFT CR-YESB0000001-EASEBUZZ PVT LTD NOD AL A/C-SLICK ORGANICS PVT LTD-YESB236590 12071,,,net_banking_transfer,133183.32
63bfb2b72e1a0ebb7f629fe5,50200023535069,932595.09,60ec41ba55c00300382672d9,HDFC,Revenue-PG-split enabled,5eecc6d6449e4f7cfb1c2708,2022-12-31T00:00:00.000Z,NEFT CR-UTIB0001506-RAZORPAY SOFTWARE PR IVATE LIMITED-SLICK ORGANICS PVT LITD-AX ISCN0193924303,,,net_banking_transfer,1889.89
63bfb2b72e1a0ebb7f629fe7,50200023535069,882595.09,60ec41ba55c00300382672d9,HDFC,direct expenses,5eecc6d6449e4f7cfb1c2708,2022-12-31T00:00:00.000Z,NEFT DR-ICIC0002451-SOUTH COURT CONDOMIN,,,net_banking_transfer,-50000
63bfb33c2e1a0ebb7f62f32c,50200035187206,2500001.28,60ec419255c00300382671a5,HDFC,Transfer in/Revenue-other,5eecc6d6449e4f7cfb1c2708,2021-07-15T00:00:00.000Z,RTGS CR-KKBK0000958-SABJOT SINGH SAHNI-M KKBKR52021071500817918 S SLICK ORGANICS PVT LTD-KKBKR5202107150 0817918,insurance,,net_banking_transfer,2500000
63bfb33c2e1a0ebb7f62f332,50200035187206,9505817.28,60ec419255c00300382671a5,HDFC,Transfer in/Revenue-other,5eecc6d6449e4f7cfb1c2708,2021-07-19T00:00:00.000Z,RTGS CR-UTIB0000514-NATARAJAN RANGANATHA UTIBR52021071900193634 N-SLICK ORGANICS PVT LTD-UTIBR5202107190 0193634,insurance,,net_banking_transfer,3502420
63bfb33c2e1a0ebb7f62f334,50200035187206,12004841.28,60ec419255c00300382671a5,HDFC,Transfer in/Revenue-other,5eecc6d6449e4f7cfb1c2708,2021-07-20T00:00:00.000Z,RTGS CR-KKBK0000958-BEELINE IMPEX PRIVAT KKBKR22021072002007152,,,net_banking_transfer,2499024
63bfb33c2e1a0ebb7f62f3a4,50200035187206,20004035.82,60ec419255c00300382671a5,HDFC,Transfer in/Revenue-other,5eecc6d6449e4f7cfb1c2708,2021-11-18T00:00:00.000Z,RTGS CR-SCBL0036001-VULCANIS LLP-SLICK O SCBLR12021111800004450 RGANICS PRIVATE LIMITED-SCBLR12021111800 004450,insurance,,net_banking_transfer,20004034.54
63bfb33c2e1a0ebb7f62f3a6,50200035187206,70004035.82,60ec419255c00300382671a5,HDFC,Transfer in/Revenue-other,5eecc6d6449e4f7cfb1c2708,2021-11-18T00:00:00.000Z,RTGS CR-SCBL0036001-VULCANIS LLP-SLICK O SCBLR12021111800004449 RGANICS PRIVATE LIMITED-SCBLR12021111800 004449,insurance,,net_banking_transfer,50000000
63bfb33d2e1a0ebb7f62f515,50200035187206,5119569.97,60ec419255c00300382671a5,HDFC,Transfer in/Revenue-other,5eecc6d6449e4f7cfb1c2708,2022-07-04T00:00:00.000Z,FT - CR - 50100198713718 - BHAVNA SAKUL,,,Other,3010217.43
63bfb33d2e1a0ebb7f62f518,50200035187206,51129755.16,60ec419255c00300382671a5,HDFC,Transfer in/Revenue-other,5eecc6d6449e4f7cfb1c2708,2022-07-04T00:00:00.000Z,RTGS CR-KKBK0000958-SABJOT SINGH SAHNI-S KKBKR52022070400935765 LICK ORGANICS PRIVATE LIMITED-KKBKR52022 070400935765,,,net_banking_transfer,40011722.19
63bfb33d2e1a0ebb7f62f526,50200035187206,-1499999.84,60ec419255c00300382671a5,HDFC,direct expenses,5eecc6d6449e4f7cfb1c2708,2022-07-13T00:00:00.000Z,IB FUNDS TRANSFER DR-50200023535069 -SL ICK ORGANICS PVT LTD,,,net_banking_transfer,-500000
63bfb33d2e1a0ebb7f62f52a,50200035187206,5009705.08,60ec419255c00300382671a5,HDFC,Transfer in/Revenue-other,5eecc6d6449e4f7cfb1c2708,2022-07-15T00:00:00.000Z,RTGS CR-IBKL0000874-VIRAT RAJ BOBAL-SLIC IBKLR92022071500028799,,,net_banking_transfer,5009704.92
63bfb33d2e1a0ebb7f62f532,50200035187206,6559253.08,60ec419255c00300382671a5,HDFC,direct expenses,5eecc6d6449e4f7cfb1c2708,2022-07-18T00:00:00.000Z,FD BOOKED - 50300653996950 : SLICK ORGAN ICS PVT LTD,,,investment,-20000000
63bfb33d2e1a0ebb7f62f536,50200035187206,11057715.55,60ec419255c00300382671a5,HDFC,Transfer in/Revenue-other,5eecc6d6449e4f7cfb1c2708,2022-07-21T00:00:00.000Z,RTGS CR-SCBL0036001-ANIL KUMAR AGARWAL-S SCBLR22022072100804715 LICK ORGANICS P LTD-SCBLR220220721008047 15,,,net_banking_transfer,5998462.47
63bfb33d2e1a0ebb7f62f53a,50200035187206,23540006,60ec419255c00300382671a5,HDFC,Transfer in/Revenue-other,5eecc6d6449e4f7cfb1c2708,2022-08-25T00:00:00.000Z,RTGS CR-PUNB0040810-JAGWANT SINGH GILL PUNBR52022082515747042 SO RANJIT SINGH-SLICK ORGANICS PRIVATE L IMITED-PUNBR52022082515747042,,,net_banking_transfer,990730
63bfb33d2e1a0ebb7f62f53e,50200035187206,26560036,60ec419255c00300382671a5,HDFC,Transfer in/Revenue-other,5eecc6d6449e4f7cfb1c2708,2022-08-26T00:00:00.000Z,RTGS CR-UTIB0000514-NATARAJAN RANGANATHA UTIBR52022082600182757 N-SLICK ORGANICS PVT LTD-UTIBR5202208260 0182757,,,net_banking_transfer,3000000
63bfb33d2e1a0ebb7f62f540,50200035187206,26570254,60ec419255c00300382671a5,HDFC,Transfer in/Revenue-other,5eecc6d6449e4f7cfb1c2708,2022-08-26T00:00:00.000Z,NEFT CR-UTIB0000514-NATARAJAN RANGANATHA N-SLICK ORGANICS PVT LTD-AXIR22238672797 9,,,net_banking_transfer,10218
63bfb33d2e1a0ebb7f62f543,50200035187206,10000000,60ec419255c00300382671a5,HDFC,direct expenses,5eecc6d6449e4f7cfb1c2708,2022-09-05T00:00:00.000Z,IB FUNDS TRANSFER DR-50200023535069 -SL ICK ORGANICS PVT LTD,,,net_banking_transfer,-11570254
63bfb33d2e1a0ebb7f62f548,50200035187206,50001,60ec419255c00300382671a5,HDFC,direct expenses,5eecc6d6449e4f7cfb1c2708,2022-09-28T00:00:00.000Z,IB FUNDS TRANSFER DR-50200023535069 -SL ICK ORGANICS PVT LTD,,,net_banking_transfer,-150000
63bfb33d2e1a0ebb7f62f54a,50200035187206,50031,60ec419255c00300382671a5,HDFC,interest income,5eecc6d6449e4f7cfb1c2708,2022-11-26T00:00:00.000Z,QUARTERLY INTEREST CREDIT 50300571891040,,,Other,30
63bfb33d2e1a0ebb7f62f54c,50200035187206,50032,60ec419255c00300382671a5,HDFC,Revenue-PG-split enabled,5eecc6d6449e4f7cfb1c2708,2022-12-09T00:00:00.000Z,IMPS-234315250251-CASHFREE PAYMENTS IN-I CIC-XXXXXXXX0293-KLUBWORKS BANK DETAILS VALIDATION CF,,,net_banking_transfer,1
63bfb33d2e1a0ebb7f62f54e,50200035187206,15050032,60ec419255c00300382671a5,HDFC,Transfer in/Revenue-other,5eecc6d6449e4f7cfb1c2708,2022-12-14T00:00:00.000Z,NEFT CR-ICIC0SF0002-KARNATION FUND-I-SLI CK ORGANICS PVT LTD-30428673551DC,,,net_banking_transfer,15000000
63bfb33d2e1a0ebb7f62f550,50200035187206,14550032,60ec419255c00300382671a5,HDFC,Internal Transfers,5eecc6d6449e4f7cfb1c2708,2022-12-15T00:00:00.000Z,IB FUNDS TRANSFER DR-50200023535069 -SL ICK ORGANICS PVT LTD,,,net_banking_transfer,-500000
63bfb33d2e1a0ebb7f62f552,50200035187206,14050032,60ec419255c00300382671a5,HDFC,Internal Transfers,5eecc6d6449e4f7cfb1c2708,2022-12-15T00:00:00.000Z,IB FUNDS TRANSFER DR-50200023535069 -SL ICK ORGANICS PVT LTD,,,net_banking_transfer,-500000
63bfb33d2e1a0ebb7f62f554,50200035187206,13950032,60ec419255c00300382671a5,HDFC,Internal Transfers,5eecc6d6449e4f7cfb1c2708,2022-12-16T00:00:00.000Z,IB FUNDS TRANSFER DR-50200023535069 -SL ICK ORGANICS PVT LTD,,,net_banking_transfer,-100000
63bfb33d2e1a0ebb7f62f556,50200035187206,13350032,60ec419255c00300382671a5,HDFC,Internal Transfers,5eecc6d6449e4f7cfb1c2708,2022-12-16T00:00:00.000Z,IB FUNDS TRANSFER DR-50200023535069 -SL ICK ORGANICS PVT LTD,,,net_banking_transfer,-600000
63bfb33d2e1a0ebb7f62f558,50200035187206,12850032,60ec419255c00300382671a5,HDFC,Internal Transfers,5eecc6d6449e4f7cfb1c2708,2022-12-16T00:00:00.000Z,IB FUNDS TRANSFER DR-50200023535069 -SL ICK ORGANICS PVT LTD,,,net_banking_transfer,-500000
63bfb33d2e1a0ebb7f62f55a,50200035187206,7850032,60ec419255c00300382671a5,HDFC,Internal Transfers,5eecc6d6449e4f7cfb1c2708,2022-12-17T00:00:00.000Z,IB FUNDS TRANSFER DR-50200023535069 -SL ICK ORGANICS PVT LTD,,,net_banking_transfer,-5000000
63bfb33d2e1a0ebb7f62f55c,50200035187206,2850032,60ec419255c00300382671a5,HDFC,Internal Transfers,5eecc6d6449e4f7cfb1c2708,2022-12-17T00:00:00.000Z,IB FUNDS TRANSFER DR-50200023535069 -SL ICK ORGANICS PVT LTD,,,net_banking_transfer,-5000000
63bfb33d2e1a0ebb7f62f55e,50200035187206,50032,60ec419255c00300382671a5,HDFC,Internal Transfers,5eecc6d6449e4f7cfb1c2708,2022-12-17T00:00:00.000Z,IB FUNDS TRANSFER DR-50200023535069 -SL ICK ORGANICS PVT LTD,,,net_banking_transfer,-2800000
63bfb33d2e1a0ebb7f62f560,50200035187206,50033,60ec419255c00300382671a5,HDFC,interest income,5eecc6d6449e4f7cfb1c2708,2022-12-23T00:00:00.000Z,QUARTERLY INTEREST CREDIT 50300462137427,,,Other,1
641429d4f8804aea721683a6,50200035187206,13350032,60ec419255c00300382671a5,HDFC,direct expenses,5eecc6d6449e4f7cfb1c2708,2022-12-16T00:00:00.000Z,IB FUNDS TRANSFER DR-50200023535069 -SL,,,net_banking_transfer,-600000
641429d4f8804aea721683ad,50200035187206,50071,60ec419255c00300382671a5,HDFC,interest income,5eecc6d6449e4f7cfb1c2708,2023-02-27T00:00:00.000Z,QUARTERLY INTEREST CREDIT 50300571891040 STATEMENT SUMMARY :-,,,Other,38
641429d4f8804aea721683af,50200035187206,45071,60ec419255c00300382671a5,HDFC,Internal Transfers,5eecc6d6449e4f7cfb1c2708,2023-03-08T00:00:00.000Z,IB FUNDS TRANSFER DR-50200023535069 -SL ICK ORGANICS PVT LTD,,,net_banking_transfer,-5000
641429d4f8804aea721683b1,50200035187206,40071,60ec419255c00300382671a5,HDFC,Internal Transfers,5eecc6d6449e4f7cfb1c2708,2023-03-10T00:00:00.000Z,IB FUNDS TRANSFER DR-50200023535069 -SL ICK ORGANICS PVT LTD,,,net_banking_transfer,-5000
641429d4f8804aea721683b3,50200035187206,35071,60ec419255c00300382671a5,HDFC,Internal Transfers,5eecc6d6449e4f7cfb1c2708,2023-03-10T00:00:00.000Z,IB FUNDS TRANSFER DR-50200023535069 -SL ICK ORGANICS PVT LTD,,,net_banking_transfer,-5000
641429d4f8804aea721683b5,50200035187206,35072,60ec419255c00300382671a5,HDFC,Revenue-PG-split enabled,5eecc6d6449e4f7cfb1c2708,2023-03-13T00:00:00.000Z,IMPS-307212298799-CASHFREE PAYMENTS IN-N SPB-XXXXXXXX0008-BAV,,,net_banking_transfer,1
641429d4f8804aea721683b7,50200035187206,1035072,60ec419255c00300382671a5,HDFC,Transfer in/Revenue-other,5eecc6d6449e4f7cfb1c2708,2023-03-13T00:00:00.000Z,NEFT CR-YESB0000001-TYKE MITCON ESCROW A CCOUNT-SLICKORGANICSPVTL-YESB30728682789,,,net_banking_transfer,1000000
641429d4f8804aea721683b9,50200035187206,35072,60ec419255c00300382671a5,HDFC,Internal Transfers,5eecc6d6449e4f7cfb1c2708,2023-03-13T00:00:00.000Z,IB FUNDS TRANSFER DR-50200023535069 -SL ICK ORGANICS PVT LTD,,,net_banking_transfer,-1000000
641429d4f8804aea721683bb,50200035187206,25072,60ec419255c00300382671a5,HDFC,Internal Transfers,5eecc6d6449e4f7cfb1c2708,2023-03-13T00:00:00.000Z,IB FUNDS TRANSFER DR-50200023535069 -SL ICK ORGANICS PVT LTD STATEMENT SUMMARY :-,,,net_banking_transfer,-10000
64142ac6f8804aea721708b6,50200023535069,877595.09,60ec41ba55c00300382672d9,HDFC,direct expenses,5eecc6d6449e4f7cfb1c2708,2023-01-01T00:00:00.000Z,50100230430674 NET BANKING SI -5000,,,Other,-5000
64142ac6f8804aea721708b8,50200023535069,-63147.91,60ec41ba55c00300382672d9,HDFC,direct expenses,5eecc6d6449e4f7cfb1c2708,2023-01-01T00:00:00.000Z,02711600008220 NET BANKING SI -940743,,,Other,-940743
64142ac6f8804aea721708ba,50200023535069,-82047.91,60ec41ba55c00300382672d9,HDFC,direct expenses,5eecc6d6449e4f7cfb1c2708,2023-01-01T00:00:00.000Z,NEFT DR-ICIC0006614-RICHA DEB PARASHAR-S ANDOZ - MUM-N001232270444184-NET BANKING SI -18900,,,net_banking_transfer,-18900
64142ac6f8804aea721708bc,50200023535069,-573607.91,60ec41ba55c00300382672d9,HDFC,Marketing Expense,5eecc6d6449e4f7cfb1c2708,2023-01-01T00:00:00.000Z,NEFT DR-CITI0100000-GOOGLE INDIA PVT LTD -SANDOZ - MUM-N001232270444188-NET BANKI NG SI -491560,,,net_banking_transfer,-491560
64142ac6f8804aea721708be,50200023535069,-4250829.91,60ec41ba55c00300382672d9,HDFC,Marketing Expense,5eecc6d6449e4f7cfb1c2708,2023-01-01T00:00:00.000Z,NEFT DR-CITI0000006-FACEBOOK INDIA ONLIN E SERVICES PVT LTD-SANDOZ - MUM-N0012322 70444191-NET BANKING SI -3677222,,,net_banking_transfer,-3677222
64142ac6f8804aea721708c1,50200023535069,-4252417.72,60ec41ba55c00300382672d9,HDFC,Marketing Expense,5eecc6d6449e4f7cfb1c2708,2023-01-01T00:00:00.000Z,ME DC SI 514834XXXXXX9486 LINKEDIN (PGSI ),,,Other,-1587.81
64142ac6f8804aea721708c3,50200023535069,-4252416.72,60ec41ba55c00300382672d9,HDFC,Transfer in/Revenue-other,5eecc6d6449e4f7cfb1c2708,2023-01-02T00:00:00.000Z,INT. ON SWCR ON-50300720580141,,,Other,1
64142ac6f8804aea721708c5,50200023535069,-4250828.72,60ec41ba55c00300382672d9,HDFC,Loan-in,5eecc6d6449e4f7cfb1c2708,2023-01-02T00:00:00.000Z,SWEEP-IN CREDIT - 50300720580141,,,self_transfer,1588
64142ac6f8804aea721708c7,50200023535069,-4250776.72,60ec41ba55c00300382672d9,HDFC,Transfer in/Revenue-other,5eecc6d6449e4f7cfb1c2708,2023-01-02T00:00:00.000Z,INT. ON SWCR ON-50300720578746,,,Other,52
64142ac6f8804aea721708c9,50200023535069,-4187628.72,60ec41ba55c00300382672d9,HDFC,Loan-in,5eecc6d6449e4f7cfb1c2708,2023-01-02T00:00:00.000Z,SWEEP-IN CREDIT - 50300720578746,,,self_transfer,63148
64142ac6f8804aea721708cb,50200023535069,-4185649.72,60ec41ba55c00300382672d9,HDFC,Transfer in/Revenue-other,5eecc6d6449e4f7cfb1c2708,2023-01-02T00:00:00.000Z,INT. ON SWCR ON-50300720578746,,,Other,1979
64142ac6f8804aea721708cd,50200023535069,-1778204.72,60ec41ba55c00300382672d9,HDFC,Loan-in,5eecc6d6449e4f7cfb1c2708,2023-01-02T00:00:00.000Z,SWEEP-IN CREDIT - 50300720578746,,,self_transfer,2407445
64142ac6f8804aea721708cf,50200023535069,-1776742.72,60ec41ba55c00300382672d9,HDFC,Transfer in/Revenue-other,5eecc6d6449e4f7cfb1c2708,2023-01-02T00:00:00.000Z,INT. ON SWCR ON-50300720580141,,,Other,1462
64142ac6f8804aea721708d2,50200023535069,1462.28,60ec41ba55c00300382672d9,HDFC,Loan-in,5eecc6d6449e4f7cfb1c2708,2023-01-02T00:00:00.000Z,SWEEP-IN CREDIT - 50300720580141,,,self_transfer,1778205
64142ac6f8804aea721708d4,50200023535069,2136.75,60ec41ba55c00300382672d9,HDFC,Transfer in/Revenue-other,5eecc6d6449e4f7cfb1c2708,2023-01-02T00:00:00.000Z,IMPS-300203774515-EXCRO PAY ESCROW ACC-Y ESB-XXXXXXXXXXX1807-333112298023,,,net_banking_transfer,674.47
64142ac6f8804aea721708d6,50200023535069,7145.58,60ec41ba55c00300382672d9,HDFC,Transfer in/Revenue-other,5eecc6d6449e4f7cfb1c2708,2023-01-02T00:00:00.000Z,IMPS-300207845908-EXCRO PAY ESCROW ACC-Y ESB-XXXXXXXXXXX1807-333112298023,,,net_banking_transfer,5008.83
64142ac6f8804aea721708d8,50200023535069,2189.58,60ec41ba55c00300382672d9,HDFC,Marketing Expense,5eecc6d6449e4f7cfb1c2708,2023-01-02T00:00:00.000Z,ME DC SI 514834XXXXXX9486 FACEBOOK SI,,,Other,-4956
64142ac6f8804aea721708da,50200023535069,14315.86,60ec41ba55c00300382672d9,HDFC,Revenue-Mktplace,5eecc6d6449e4f7cfb1c2708,2023-01-02T00:00:00.000Z,NEFT CR-DEUT0797BGL-MYNTRA DESIGNS PRIVA,shopping,,net_banking_transfer,12126.28
64142ac6f8804aea721708dc,50200023535069,15756.12,60ec41ba55c00300382672d9,HDFC,Revenue-Mktplace,5eecc6d6449e4f7cfb1c2708,2023-01-02T00:00:00.000Z,NEFT CR-DEUT0797BGL-MYNTRA DESIGNS PRIVA TE LIMITED-SLICK ORGANICS PVT. LTD.-3002 00825GN00141,shopping,,net_banking_transfer,1440.26
64142ac6f8804aea721708de,50200023535069,19385.32,60ec41ba55c00300382672d9,HDFC,Revenue-PG-split enabled,5eecc6d6449e4f7cfb1c2708,2023-01-02T00:00:00.000Z,NEFT CR-UTIB0001506-RAZORPAY SOFTWARE PR IVATE LIMITED-SLICK ORGANICS PVT LITD-AX ISCN0194148303,,,net_banking_transfer,3629.2
64142ac6f8804aea721708e0,50200023535069,-1257.68,60ec41ba55c00300382672d9,HDFC,direct expenses,5eecc6d6449e4f7cfb1c2708,2023-01-02T00:00:00.000Z,02711600008220-TPT-20643-VARUN SINGH,,,net_banking_transfer,-20643
64142ac6f8804aea721708e2,50200023535069,-25051.71,60ec41ba55c00300382672d9,HDFC,direct expenses,5eecc6d6449e4f7cfb1c2708,2023-01-02T00:00:00.000Z,POS 514834XXXXXX9486 AMZ*MARKETING SV,,,debit_card,-23794.03
64142ac6f8804aea721708e4,50200023535069,-187051.71,60ec41ba55c00300382672d9,HDFC,direct expenses,5eecc6d6449e4f7cfb1c2708,2023-01-02T00:00:00.000Z,50200054531492-TPT-162000-ALETA PEOPLE S ERVICES,,,net_banking_transfer,-162000
64142ac6f8804aea721708e6,50200023535069,-187366.71,60ec41ba55c00300382672d9,HDFC,direct expenses,5eecc6d6449e4f7cfb1c2708,2023-01-02T00:00:00.000Z,POS 514834XXXXXX9486 SMARTSHIFT LOGIS,,,debit_card,-315
64142ac6f8804aea721708e8,50200023535069,-180288.61,60ec41ba55c00300382672d9,HDFC,Revenue-PG-non-split,5eecc6d6449e4f7cfb1c2708,2023-01-02T00:00:00.000Z,NEFT CR-SCBL0036001-STRIPE INDIA PRIVATE LIMITED-SLICK ORGANICS PRIVATE LIMITED- IN1ON23010201V5Q,,,net_banking_transfer,7078.1
64142ac6f8804aea721708ea,50200023535069,-174326.39,60ec41ba55c00300382672d9,HDFC,Transfer in/Revenue-other,5eecc6d6449e4f7cfb1c2708,2023-01-02T00:00:00.000Z,NEFT CR-UTIB0000114-ONE SIGMA TECHNOLOGI ES PRIVATE LIM-SLICK ORGANICS PRIVATE LI MITED-AXISP00351054848,bnpl,,net_banking_transfer,5962.22
64142ac7f8804aea721708ec,50200023535069,-165392.39,60ec41ba55c00300382672d9,HDFC,Transfer in/Revenue-other,5eecc6d6449e4f7cfb1c2708,2023-01-02T00:00:00.000Z,NEFT CR-UTIB0000114-ONE SIGMA TECHNOLOGI ES PRIVATE LIM-SLICK ORGANICS PRIVATE LI MITED-AXISP00351054924,bnpl,,net_banking_transfer,8934
64142ac7f8804aea721708ee,50200023535069,-164453.51,60ec41ba55c00300382672d9,HDFC,Transfer in/Revenue-other,5eecc6d6449e4f7cfb1c2708,2023-01-02T00:00:00.000Z,NEFT CR-UTIB0000114-ONE SIGMA TECHNOLOGI ES PRIVATE LIM-SLICK ORGANICS PRIVATE LI MITED-AXISP00351054815,bnpl,,net_banking_transfer,938.88
64142ac7f8804aea721708f0,50200023535069,-27984.13,60ec41ba55c00300382672d9,HDFC,Transfer in/Revenue-other,5eecc6d6449e4f7cfb1c2708,2023-01-02T00:00:00.000Z,NEFT CR-YESB0000001-EASEBUZZ PVT LTD NOD AL A/C-SLICK ORGANICS PVT LTD-YESB300246 87121,,,net_banking_transfer,136469.38
64142ac7f8804aea721708f2,50200023535069,15612.37,60ec41ba55c00300382672d9,HDFC,Revenue-COD,5eecc6d6449e4f7cfb1c2708,2023-01-02T00:00:00.000Z,NEFT CR-ICIC0000155-SHIPROCKET COD CRF I D 5461815-SLICK ORGANICS PVT LTD-CMS3041 826492,,,net_banking_transfer,43596.5
64142ac7f8804aea721708f4,50200023535069,16521.19,60ec41ba55c00300382672d9,HDFC,Revenue-PG-split enabled,5eecc6d6449e4f7cfb1c2708,2023-01-02T00:00:00.000Z,NEFT CR-UTIB0001506-RAZORPAY SOFTWARE PR,,,net_banking_transfer,908.82
64142ac7f8804aea721708f6,50200023535069,-12934.47,60ec41ba55c00300382672d9,HDFC,SAAS/tech expense,5eecc6d6449e4f7cfb1c2708,2023-01-02T00:00:00.000Z,POS 514834XXXXXX9486 AMAZON.COM,shopping,,debit_card,-29455.66
64142ac7f8804aea721708f8,50200023535069,-12923.47,60ec41ba55c00300382672d9,HDFC,Transfer in/Revenue-other,5eecc6d6449e4f7cfb1c2708,2023-01-03T00:00:00.000Z,INT. ON SWCR ON-50300720580141,,,Other,11
64142ac7f8804aea721708fa,50200023535069,11.53,60ec41ba55c00300382672d9,HDFC,Loan-in,5eecc6d6449e4f7cfb1c2708,2023-01-03T00:00:00.000Z,SWEEP-IN CREDIT - 50300720580141,,,self_transfer,12935
64142ac7f8804aea721708fc,50200023535069,1565.78,60ec41ba55c00300382672d9,HDFC,Transfer in/Revenue-other,5eecc6d6449e4f7cfb1c2708,2023-01-03T00:00:00.000Z,IMPS-300304718738-EXCRO PAY ESCROW ACC-Y ESB-XXXXXXXXXXX1807-333112298023,,,net_banking_transfer,1554.25
64142ac7f8804aea721708fe,50200023535069,-66837.22,60ec41ba55c00300382672d9,HDFC,direct expenses,5eecc6d6449e4f7cfb1c2708,2023-01-03T00:00:00.000Z,NEFT DR-UTIB0001696-EMIZA SUPPLY CHAIN S ERVICES PRIVATE LIMI-SANDOZ - MUM-N00323 2272249950-NET BANKING SI -68403,,,net_banking_transfer,-68403
64142ac7f8804aea72170900,50200023535069,-71793.22,60ec41ba55c00300382672d9,HDFC,Marketing Expense,5eecc6d6449e4f7cfb1c2708,2023-01-03T00:00:00.000Z,ME DC SI 514834XXXXXX9486 FACEBOOK SI,,,Other,-4956
64142ac7f8804aea72170902,50200023535069,-61301.61,60ec41ba55c00300382672d9,HDFC,Revenue-PG-split enabled,5eecc6d6449e4f7cfb1c2708,2023-01-03T00:00:00.000Z,NEFT CR-UTIB0001506-RAZORPAY SOFTWARE PR IVATE LIMITED-SLICK ORGANICS PVT LITD-AX ISCN0194556224,,,net_banking_transfer,10491.61
64142ac7f8804aea72170904,50200023535069,-72658.61,60ec41ba55c00300382672d9,HDFC,Utilities/bills,5eecc6d6449e4f7cfb1c2708,2023-01-03T00:00:00.000Z,IB BILLPAY DR-HDFCEB-361011XXXX4399,bills,,Other,-11357
64142ac7f8804aea72170906,50200023535069,-67725.08,60ec41ba55c00300382672d9,HDFC,Revenue-PG-non-split,5eecc6d6449e4f7cfb1c2708,2023-01-03T00:00:00.000Z,NEFT CR-SCBL0036001-STRIPE INDIA PRIVATE LIMITED-SLICK ORGANICS PRIVATE LIMITED- IN1ON23010300TFN,,,net_banking_transfer,4933.53
64142ac7f8804aea72170908,50200023535069,-167725.08,60ec41ba55c00300382672d9,HDFC,direct expenses,5eecc6d6449e4f7cfb1c2708,2023-01-03T00:00:00.000Z,"NEFT DR-YESB0000551-VISTTA COSMETICS-NET BANK, MUM-N003232272993289-100000",,,net_banking_transfer,-100000
64142ac7f8804aea7217090a,50200023535069,-189775.08,60ec41ba55c00300382672d9,HDFC,direct expenses,5eecc6d6449e4f7cfb1c2708,2023-01-03T00:00:00.000Z,"NEFT DR-KKBK0000173-NITISH KUMAR MANDAL- NETBANK, MUM-N003232272987686-22050",,,net_banking_transfer,-22050
64142ac7f8804aea7217090d,50200023535069,-186654.09,60ec41ba55c00300382672d9,HDFC,Transfer in/Revenue-other,5eecc6d6449e4f7cfb1c2708,2023-01-03T00:00:00.000Z,NEFT CR-UTIB0000114-ONE SIGMA TECHNOLOGI ES PRIVATE LIM-SLICK ORGANICS PRIVATE LI MITED-AXISP00351347154,bnpl,,net_banking_transfer,3120.99
64142ac7f8804aea72170910,50200023535069,-195264.09,60ec41ba55c00300382672d9,HDFC,direct expenses,5eecc6d6449e4f7cfb1c2708,2023-01-03T00:00:00.000Z,POS 514834XXXXXX9486 PTM*PAYTM,ewallet,,debit_card,-8610
64142ac7f8804aea72170912,50200023535069,-146834.03,60ec41ba55c00300382672d9,HDFC,Transfer in/Revenue-other,5eecc6d6449e4f7cfb1c2708,2023-01-03T00:00:00.000Z,NEFT CR-YESB0000001-EASEBUZZ PVT LTD NOD AL A/C-SLICK ORGANICS PVT LTD-YESB300385 70830,,,net_banking_transfer,48430.06
64142ac7f8804aea72170915,50200023535069,-145559.75,60ec41ba55c00300382672d9,HDFC,Revenue-PG-split enabled,5eecc6d6449e4f7cfb1c2708,2023-01-03T00:00:00.000Z,NEFT CR-UTIB0001506-RAZORPAY SOFTWARE PR IVATE LIMITED-SLICK ORGANICS PVT LITD-AX ISCN0194735234,,,net_banking_transfer,1274.28
64142ac7f8804aea72170917,50200023535069,909468.09,60ec41ba55c00300382672d9,HDFC,Revenue-Mktplace,5eecc6d6449e4f7cfb1c2708,2023-01-03T00:00:00.000Z,NEFT CR-HSBC0560002-MYNTRA JABONG INDIA,shopping,,net_banking_transfer,1055027.84
64142ac7f8804aea72170919,50200023535069,899468.09,60ec41ba55c00300382672d9,HDFC,Refund,5eecc6d6449e4f7cfb1c2708,2023-01-03T00:00:00.000Z,"NEFT DR-RATN0VAAPIS-RAZORPAY REFUND CRED ITS TOPUP-NETBANK, MUM-N003232273870005- 10000",,,net_banking_transfer,-10000
64142ac7f8804aea7217091b,50200023535069,901720.18,60ec41ba55c00300382672d9,HDFC,Transfer in/Revenue-other,5eecc6d6449e4f7cfb1c2708,2023-01-04T00:00:00.000Z,IMPS-300404768960-EXCRO PAY ESCROW ACC-Y ESB-XXXXXXXXXXX1807-333112298023,,,net_banking_transfer,2252.09
64142ac7f8804aea7217091d,50200023535069,904750.27,60ec41ba55c00300382672d9,HDFC,Transfer in/Revenue-other,5eecc6d6449e4f7cfb1c2708,2023-01-04T00:00:00.000Z,IMPS-300407822923-EXCRO PAY ESCROW ACC-Y ESB-XXXXXXXXXXX1807-333112298023,,,net_banking_transfer,3030.09
64142ac7f8804aea7217091f,50200023535069,905410.85,60ec41ba55c00300382672d9,HDFC,Revenue-Mktplace,5eecc6d6449e4f7cfb1c2708,2023-01-04T00:00:00.000Z,NEFT CR-DEUT0797BGL-MYNTRA DESIGNS PRIVA TE LIMITED-SLICK ORGANICS - SJIT-3004008 04GN00243,shopping,,net_banking_transfer,660.58
64142ac7f8804aea72170921,50200023535069,869159.85,60ec41ba55c00300382672d9,HDFC,N-ACH payments,5eecc6d6449e4f7cfb1c2708,2023-01-04T00:00:00.000Z,"NEFT DR-ICIC0001136-AKHILESH BACHCHAN-NE TBANK, MUM-N004232274152755-36251",,,net_banking_transfer,-36251
64142ac7f8804aea72170923,50200023535069,869633.32,60ec41ba55c00300382672d9,HDFC,Revenue-Mktplace,5eecc6d6449e4f7cfb1c2708,2023-01-04T00:00:00.000Z,NEFT CR-DEUT0797BGL-MYNTRA DESIGNS PRIVA TE LIMITED-SLICK ORGANICS PVT. LTD.-3004 00819GN00034,shopping,,net_banking_transfer,473.47
64142ac7f8804aea72170925,50200023535069,870985.87,60ec41ba55c00300382672d9,HDFC,Revenue-PG-split enabled,5eecc6d6449e4f7cfb1c2708,2023-01-04T00:00:00.000Z,NEFT CR-UTIB0001506-RAZORPAY SOFTWARE PR IVATE LIMITED-SLICK ORGANICS PVT LITD-AX ISCN0194851396,,,net_banking_transfer,1352.55
64142ac7f8804aea72170927,50200023535069,852334.87,60ec41ba55c00300382672d9,HDFC,direct expenses,5eecc6d6449e4f7cfb1c2708,2023-01-04T00:00:00.000Z,"NEFT DR-SBIN0008078-PANDIT PLASTICS-NETB ANK, MUM-N004232274154396-18651",,,net_banking_transfer,-18651
64142ac7f8804aea72170929,50200023535069,892719.58,60ec41ba55c00300382672d9,HDFC,Revenue-Mktplace,5eecc6d6449e4f7cfb1c2708,2023-01-04T00:00:00.000Z,NEFT CR-HSBC0400002-AMAZON SERVICES LLC- SLICK ORGANICS PRIVATE LIMITED-HSBCN2300 4695936,shopping,,net_banking_transfer,40384.71
64142ac7f8804aea7217092b,50200023535069,1155160.58,60ec41ba55c00300382672d9,HDFC,Transfer in/Revenue-other,5eecc6d6449e4f7cfb1c2708,2023-01-04T00:00:00.000Z,RTGS CR-IDFB0010204-PCPL CENTRAL DISBURS EMENT AC-SLICK ORGANICS PRIVATE LIMITED- IDFBR52023010400607355,,,net_banking_transfer,262441
64142ac7f8804aea7217092d,50200023535069,1163730.02,60ec41ba55c00300382672d9,HDFC,Transfer in/Revenue-other,5eecc6d6449e4f7cfb1c2708,2023-01-04T00:00:00.000Z,NEFT CR-UTIB0000114-ONE SIGMA TECHNOLOGI ES PRIVATE LIM-SLICK ORGANICS PRIVATE LI MITED-AXISP00351638644,bnpl,,net_banking_transfer,8569.44
64142ac7f8804aea72170930,50200023535069,1238241.94,60ec41ba55c00300382672d9,HDFC,Transfer in/Revenue-other,5eecc6d6449e4f7cfb1c2708,2023-01-04T00:00:00.000Z,NEFT CR-YESB0000001-EASEBUZZ PVT LTD NOD,,,net_banking_transfer,74511.92
64142ac7f8804aea72170932,50200023535069,1260066.65,60ec41ba55c00300382672d9,HDFC,Revenue-COD,5eecc6d6449e4f7cfb1c2708,2023-01-04T00:00:00.000Z,NEFT CR-ICIC0000155-SHIPROCKET COD CRF I D 5482183-SLICK ORGANICS PVT LTD-CMS3045 794747,,,net_banking_transfer,21824.71
64142ac7f8804aea72170934,50200023535069,1309697.65,60ec41ba55c00300382672d9,HDFC,Transfer in/Revenue-other,5eecc6d6449e4f7cfb1c2708,2023-01-04T00:00:00.000Z,NEFT CR-YESB0000001-NCOME TECH SOLUTIONS PRIVATE LIMITE-SLICK ORGANICS PVT LTD-Y ESB30041993573,,,net_banking_transfer,49631
64142ac7f8804aea72170936,50200023535069,1310322.5,60ec41ba55c00300382672d9,HDFC,Revenue-PG-split enabled,5eecc6d6449e4f7cfb1c2708,2023-01-04T00:00:00.000Z,NEFT CR-UTIB0001506-RAZORPAY SOFTWARE PR IVATE LIMITED-SLICK ORGANICS PVT LITD-AX ISCN0195075885,,,net_banking_transfer,624.85
64142ac7f8804aea72170938,50200023535069,1310531.5,60ec41ba55c00300382672d9,HDFC,Revenue-COD,5eecc6d6449e4f7cfb1c2708,2023-01-04T00:00:00.000Z,PICKRR TECHNOL-AKHILESHDIXIT85GMAIL,,,Other,209
64142ac7f8804aea7217093a,50200023535069,1305575.5,60ec41ba55c00300382672d9,HDFC,Marketing Expense,5eecc6d6449e4f7cfb1c2708,2023-01-04T00:00:00.000Z,ME DC SI 514834XXXXXX9486 FACEBOOK SI,,,Other,-4956
64142ac7f8804aea7217093c,50200023535069,1307112.53,60ec41ba55c00300382672d9,HDFC,Transfer in/Revenue-other,5eecc6d6449e4f7cfb1c2708,2023-01-05T00:00:00.000Z,IMPS-300503754188-EXCRO PAY ESCROW ACC-Y ESB-XXXXXXXXXXX1807-333112298023,,,net_banking_transfer,1537.03
64142ac7f8804aea7217093e,50200023535069,1308218.81,60ec41ba55c00300382672d9,HDFC,Revenue-PG-split enabled,5eecc6d6449e4f7cfb1c2708,2023-01-05T00:00:00.000Z,NEFT CR-UTIB0001506-RAZORPAY SOFTWARE PR IVATE LIMITED-SLICK ORGANICS PVT LITD-AX ISCN0195237815,,,net_banking_transfer,1106.28
64142ac7f8804aea72170940,50200023535069,1322028.81,60ec41ba55c00300382672d9,HDFC,Revenue-Mktplace,5eecc6d6449e4f7cfb1c2708,2023-01-05T00:00:00.000Z,NEFT CR-SCBL0036001-DREAMPLUG TECHNOLOGI ES PRIVATE LIMITED-SLICK ORGANICS PRIVAT E LIMITEDSLICK-IN1ON230105057FV,,,net_banking_transfer,13810
64142ac7f8804aea72170943,50200023535069,1328252.38,60ec41ba55c00300382672d9,HDFC,Transfer in/Revenue-other,5eecc6d6449e4f7cfb1c2708,2023-01-05T00:00:00.000Z,NEFT CR-UTIB0000114-ONE SIGMA TECHNOLOGI ES PRIVATE LIM-SLICK ORGANICS PRIVATE LI MITED-AXISP00352099539,bnpl,,net_banking_transfer,6223.57
64142ac7f8804aea72170945,50200023535069,1129653.38,60ec41ba55c00300382672d9,HDFC,direct expenses,5eecc6d6449e4f7cfb1c2708,2023-01-05T00:00:00.000Z,"NEFT DR-UTIB0000119-SAFEXPRESS-NETBANK, MUM-N005232276397683-198599",,,net_banking_transfer,-198599
64142ac7f8804aea72170947,50200023535069,1112987.38,60ec41ba55c00300382672d9,HDFC,direct expenses,5eecc6d6449e4f7cfb1c2708,2023-01-05T00:00:00.000Z,50100110669502-TPT-16666-VRITI MALHOTRA,,,net_banking_transfer,-16666
64142ac7f8804aea72170949,50200023535069,1085987.38,60ec41ba55c00300382672d9,HDFC,direct expenses,5eecc6d6449e4f7cfb1c2708,2023-01-05T00:00:00.000Z,"NEFT DR-ICIC0000322-RASHMI MANN-NETBANK, MUM-N005232276416436-27000",,,net_banking_transfer,-27000
64142ac7f8804aea7217094b,50200023535069,1084043.4,60ec41ba55c00300382672d9,HDFC,direct expenses,5eecc6d6449e4f7cfb1c2708,2023-01-05T00:00:00.000Z,POS 514834XXXXXX9486 IMOJO*RESFEBER L,,,debit_card,-1943.98
64142ac7f8804aea7217094d,50200023535069,1086216.45,60ec41ba55c00300382672d9,HDFC,Revenue-PG-split enabled,5eecc6d6449e4f7cfb1c2708,2023-01-05T00:00:00.000Z,NEFT CR-UTIB0001506-RAZORPAY SOFTWARE PR,,,net_banking_transfer,2173.05
64142ac7f8804aea7217094f,50200023535069,1158625.72,60ec41ba55c00300382672d9,HDFC,Transfer in/Revenue-other,5eecc6d6449e4f7cfb1c2708,2023-01-05T00:00:00.000Z,NEFT CR-YESB0000001-EASEBUZZ PVT LTD NOD AL A/C-SLICK ORGANICS PVT LTD-YESB300557 87951,,,net_banking_transfer,72409.27
64142ac7f8804aea72170951,50200023535069,1159073.72,60ec41ba55c00300382672d9,HDFC,Revenue-COD,5eecc6d6449e4f7cfb1c2708,2023-01-05T00:00:00.000Z,NEFT CR-KKBK0000958-PICKRR TECHNOLOGIES PVT LTD-SLICK ORGANICS PRIVATE LIMITED-C MS0052338054650,,,net_banking_transfer,448
64142ac7f8804aea72170953,50200023535069,1154117.72,60ec41ba55c00300382672d9,HDFC,Marketing Expense,5eecc6d6449e4f7cfb1c2708,2023-01-06T00:00:00.000Z,ME DC SI 514834XXXXXX9486 FACEBOOK SI,,,Other,-4956
64142ac7f8804aea72170955,50200023535069,1156715.41,60ec41ba55c00300382672d9,HDFC,Transfer in/Revenue-other,5eecc6d6449e4f7cfb1c2708,2023-01-06T00:00:00.000Z,IMPS-300604765208-EXCRO PAY ESCROW ACC-Y ESB-XXXXXXXXXXX1807-333112298023,,,net_banking_transfer,2597.69
64142ac7f8804aea72170957,50200023535069,1160465.1,60ec41ba55c00300382672d9,HDFC,Transfer in/Revenue-other,5eecc6d6449e4f7cfb1c2708,2023-01-06T00:00:00.000Z,IMPS-300607850922-EXCRO PAY ESCROW ACC-Y ESB-XXXXXXXXXXX1807-333112298023,,,net_banking_transfer,3749.69
64142ac7f8804aea72170959,50200023535069,1161527.38,60ec41ba55c00300382672d9,HDFC,Revenue-Mktplace,5eecc6d6449e4f7cfb1c2708,2023-01-06T00:00:00.000Z,NEFT CR-DEUT0797BGL-MYNTRA DESIGNS PRIVA TE LIMITED-SLICK ORGANICS - SJIT-3006009 21GN00153,shopping,,net_banking_transfer,1062.28
64142ac7f8804aea7217095b,50200023535069,1162864.5,60ec41ba55c00300382672d9,HDFC,Revenue-PG-split enabled,5eecc6d6449e4f7cfb1c2708,2023-01-06T00:00:00.000Z,NEFT CR-UTIB0001506-RAZORPAY SOFTWARE PR IVATE LIMITED-SLICK ORGANICS PVT LITD-AX ISCN0195605454,,,net_banking_transfer,1337.12
64142ac7f8804aea7217095d,50200023535069,864063.63,60ec41ba55c00300382672d9,HDFC,direct expenses,5eecc6d6449e4f7cfb1c2708,2023-01-06T00:00:00.000Z,POS 514834XXXXXX9486 E-COMMERCE RP,,,debit_card,-298800.87
64142ac7f8804aea7217095f,50200023535069,664063.63,60ec41ba55c00300382672d9,HDFC,Tax,5eecc6d6449e4f7cfb1c2708,2023-01-06T00:00:00.000Z,051030806012345586- CBDT TAX,,,Other,-200000
64142ac7f8804aea72170961,50200023535069,662930.63,60ec41ba55c00300382672d9,HDFC,direct expenses,5eecc6d6449e4f7cfb1c2708,2023-01-06T00:00:00.000Z,"NEFT DR-UBIN0541214-GUPTA STATIONERY SUI TE-NETBANK, MUM-N006232278431232-1133",,,net_banking_transfer,-1133
64142ac7f8804aea72170963,50200023535069,661580.63,60ec41ba55c00300382672d9,HDFC,direct expenses,5eecc6d6449e4f7cfb1c2708,2023-01-06T00:00:00.000Z,POS 514834XXXXXX9486 PTM*PAYTM WALLET,ewallet,,debit_card,-1350
64142ac7f8804aea72170965,50200023535069,663874.03,60ec41ba55c00300382672d9,HDFC,Transfer in/Revenue-other,5eecc6d6449e4f7cfb1c2708,2023-01-06T00:00:00.000Z,NEFT CR-UTIB0000114-ONE SIGMA TECHNOLOGI ES PRIVATE LIM-SLICK ORGANICS PRIVATE LI MITED-AXISP00352547514,bnpl,,net_banking_transfer,2293.4
64142ac8f8804aea72170967,50200023535069,671177.68,60ec41ba55c00300382672d9,HDFC,Revenue-Mktplace,5eecc6d6449e4f7cfb1c2708,2023-01-06T00:00:00.000Z,NEFT CR-HSBC0400002-AMAZON PAYMENTS UK L IMITED ACCS-SLICK ORGANICS PRIVATE LIMIT ED-HSBCN23006147157,shopping,,net_banking_transfer,7303.65
64142ac8f8804aea7217096a,50200023535069,680504.68,60ec41ba55c00300382672d9,HDFC,Revenue-Mktplace,5eecc6d6449e4f7cfb1c2708,2023-01-06T00:00:00.000Z,NEFT CR-ICIC0000105-MANASH LIFESTYLE PRI,shopping,,net_banking_transfer,9327
64142ac8f8804aea7217096c,50200023535069,726709.12,60ec41ba55c00300382672d9,HDFC,Revenue-COD,5eecc6d6449e4f7cfb1c2708,2023-01-06T00:00:00.000Z,NEFT CR-ICIC0000155-SHIPROCKET COD CRF I D 5494466-SLICK ORGANICS PVT LTD-CMS3049 672549,,,net_banking_transfer,46204.44
64142ac8f8804aea7217096e,50200023535069,726762.22,60ec41ba55c00300382672d9,HDFC,Revenue-PG-split enabled,5eecc6d6449e4f7cfb1c2708,2023-01-06T00:00:00.000Z,NEFT CR-UTIB0001506-RAZORPAY SOFTWARE PR IVATE LIMITED-SLICK ORGANICS PVT LITD-AX ISCN0195847864,,,net_banking_transfer,53.1
64142ac8f8804aea72170970,50200023535069,831422.39,60ec41ba55c00300382672d9,HDFC,Transfer in/Revenue-other,5eecc6d6449e4f7cfb1c2708,2023-01-06T00:00:00.000Z,NEFT CR-YESB0000001-EASEBUZZ PVT LTD NOD AL A/C-SLICK ORGANICS PVT LTD-YESB300690 97856,,,net_banking_transfer,104660.17
64142ac8f8804aea72170972,50200023535069,778355.39,60ec41ba55c00300382672d9,HDFC,direct expenses,5eecc6d6449e4f7cfb1c2708,2023-01-07T00:00:00.000Z,50100312215410 NET BANKING SI -53067,,,Other,-53067
64142ac8f8804aea72170974,50200023535069,715855.39,60ec41ba55c00300382672d9,HDFC,direct expenses,5eecc6d6449e4f7cfb1c2708,2023-01-07T00:00:00.000Z,50100064106714 NET BANKING SI -62500,,,Other,-62500
64142ac8f8804aea72170976,50200023535069,670022.39,60ec41ba55c00300382672d9,HDFC,direct expenses,5eecc6d6449e4f7cfb1c2708,2023-01-07T00:00:00.000Z,50100482015380 NET BANKING SI -45833,,,Other,-45833
64142ac8f8804aea72170978,50200023535069,596689.39,60ec41ba55c00300382672d9,HDFC,direct expenses,5eecc6d6449e4f7cfb1c2708,2023-01-07T00:00:00.000Z,50100293329616 NET BANKING SI -73333,,,Other,-73333
64142ac8f8804aea7217097a,50200023535069,537559.39,60ec41ba55c00300382672d9,HDFC,direct expenses,5eecc6d6449e4f7cfb1c2708,2023-01-07T00:00:00.000Z,50100349886722 NET BANKING SI -59130,,,Other,-59130
64142ac8f8804aea7217097c,50200023535069,499543.39,60ec41ba55c00300382672d9,HDFC,direct expenses,5eecc6d6449e4f7cfb1c2708,2023-01-07T00:00:00.000Z,00901610080520 NET BANKING SI -38016,,,Other,-38016
64142ac8f8804aea7217097e,50200023535069,326024.39,60ec41ba55c00300382672d9,HDFC,direct expenses,5eecc6d6449e4f7cfb1c2708,2023-01-07T00:00:00.000Z,50100155115510 NET BANKING SI -173519,,,Other,-173519
64142ac8f8804aea72170980,50200023535069,184379.39,60ec41ba55c00300382672d9,HDFC,direct expenses,5eecc6d6449e4f7cfb1c2708,2023-01-07T00:00:00.000Z,50100093802387 NET BANKING SI -141645,,,Other,-141645
64142ac8f8804aea72170982,50200023535069,164529.39,60ec41ba55c00300382672d9,HDFC,direct expenses,5eecc6d6449e4f7cfb1c2708,2023-01-07T00:00:00.000Z,02711600008220 NET BANKING SI -19850,,,Other,-19850
64142ac8f8804aea72170984,50200023535069,145672.39,60ec41ba55c00300382672d9,HDFC,direct expenses,5eecc6d6449e4f7cfb1c2708,2023-01-07T00:00:00.000Z,NEFT DR-PUNB0MBGB06-MD ARIF RAZA-SANDOZ - MUM-N007232279882448-NET BANKING SI -1 8857,,,net_banking_transfer,-18857
64142ac8f8804aea72170986,50200023535069,126815.39,60ec41ba55c00300382672d9,HDFC,direct expenses,5eecc6d6449e4f7cfb1c2708,2023-01-07T00:00:00.000Z,NEFT DR-PUNB0151400-BHUWAN CHANDER JOSHI -SANDOZ - MUM-N007232279882449-NET BANKI NG SI -18857,,,net_banking_transfer,-18857
64142ac8f8804aea72170988,50200023535069,106965.39,60ec41ba55c00300382672d9,HDFC,direct expenses,5eecc6d6449e4f7cfb1c2708,2023-01-07T00:00:00.000Z,NEFT DR-PUNB0494300-KUNDAN PRASAD-SANDOZ - MUM-N007232279882450-NET BANKING SI - 19850,,,net_banking_transfer,-19850
64142ac8f8804aea7217098a,50200023535069,86123.39,60ec41ba55c00300382672d9,HDFC,direct expenses,5eecc6d6449e4f7cfb1c2708,2023-01-07T00:00:00.000Z,NEFT DR-KKBK0005032-DEEPAK YADAV-SANDOZ,,,net_banking_transfer,-20842
64142ac8f8804aea7217098c,50200023535069,70860.39,60ec41ba55c00300382672d9,HDFC,direct expenses,5eecc6d6449e4f7cfb1c2708,2023-01-07T00:00:00.000Z,NEFT DR-UBIN0919721-PINKU-SANDOZ - MUM-N 007232279882452-NET BANKING SI -15263,,,net_banking_transfer,-15263
64142ac8f8804aea7217098e,50200023535069,55597.39,60ec41ba55c00300382672d9,HDFC,direct expenses,5eecc6d6449e4f7cfb1c2708,2023-01-07T00:00:00.000Z,NEFT DR-SCBL0036028-SHUBHAM SINGH PANWAR -SANDOZ - MUM-N007232279882453-NET BANKI NG SI -15263,,,net_banking_transfer,-15263
64142ac8f8804aea72170990,50200023535069,40334.39,60ec41ba55c00300382672d9,HDFC,direct expenses,5eecc6d6449e4f7cfb1c2708,2023-01-07T00:00:00.000Z,NEFT DR-SCBL0036023-VIVEK YADAV-SANDOZ - MUM-N007232279882454-NET BANKING SI -15 263,,,net_banking_transfer,-15263
64142ac8f8804aea72170992,50200023535069,25071.39,60ec41ba55c00300382672d9,HDFC,direct expenses,5eecc6d6449e4f7cfb1c2708,2023-01-07T00:00:00.000Z,NEFT DR-CNRB0019016-MANEESH-SANDOZ - MUM -N007232279882455-NET BANKING SI -15263,,,net_banking_transfer,-15263
64142ac8f8804aea72170994,50200023535069,6901.39,60ec41ba55c00300382672d9,HDFC,direct expenses,5eecc6d6449e4f7cfb1c2708,2023-01-07T00:00:00.000Z,NEFT DR-PUNB0307800-SANJEEV NIRMANIA-SAN DOZ - MUM-N007232279882456-NET BANKING S I -18170,,,net_banking_transfer,-18170
64142ac8f8804aea72170996,50200023535069,-12176.61,60ec41ba55c00300382672d9,HDFC,N-ACH payments,5eecc6d6449e4f7cfb1c2708,2023-01-07T00:00:00.000Z,NEFT DR-DBSS0IN0811-SACHIN SINGH-SANDOZ - MUM-N007232279882457-NET BANKING SI -1 9078,,,net_banking_transfer,-19078
64142ac8f8804aea72170998,50200023535069,-46526.61,60ec41ba55c00300382672d9,HDFC,direct expenses,5eecc6d6449e4f7cfb1c2708,2023-01-07T00:00:00.000Z,NEFT DR-SBIN0008079-DHARAMVEER-SANDOZ - MUM-N007232279882458-NET BANKING SI -343 50,,,net_banking_transfer,-34350
64142ac8f8804aea7217099a,50200023535069,-92926.61,60ec41ba55c00300382672d9,HDFC,direct expenses,5eecc6d6449e4f7cfb1c2708,2023-01-07T00:00:00.000Z,NEFT DR-KKBK0008066-KUSHAGRA SINGH-SANDO Z - MUM-N007232279882459-NET BANKING SI -46400,,,net_banking_transfer,-46400
64142ac8f8804aea7217099c,50200023535069,-155993.61,60ec41ba55c00300382672d9,HDFC,direct expenses,5eecc6d6449e4f7cfb1c2708,2023-01-07T00:00:00.000Z,NEFT DR-PUNB0150400-SAGARIKA DEBNATH-SA NDOZ - MUM-N007232279882460-NET BANKING SI -63067,,,net_banking_transfer,-63067
64142ac8f8804aea7217099e,50200023535069,-222393.61,60ec41ba55c00300382672d9,HDFC,direct expenses,5eecc6d6449e4f7cfb1c2708,2023-01-07T00:00:00.000Z,NEFT DR-UTIB0000120-ADNAN ALI-SANDOZ - M UM-N007232279882461-NET BANKING SI -6640 0,,,net_banking_transfer,-66400
64142ac8f8804aea721709a0,50200023535069,-272393.61,60ec41ba55c00300382672d9,HDFC,direct expenses,5eecc6d6449e4f7cfb1c2708,2023-01-07T00:00:00.000Z,NEFT DR-ICIC0000004-HEMANT GUPTA-SANDOZ - MUM-N007232279882462-NET BANKING SI -5 0000,,,net_banking_transfer,-50000
64142ac8f8804aea721709a2,50200023535069,-317393.61,60ec41ba55c00300382672d9,HDFC,direct expenses,5eecc6d6449e4f7cfb1c2708,2023-01-07T00:00:00.000Z,NEFT DR-ICIC0000314-ATUL VAISHNAV-SANDOZ,,,net_banking_transfer,-45000
64142ac8f8804aea721709a4,50200023535069,-346393.61,60ec41ba55c00300382672d9,HDFC,direct expenses,5eecc6d6449e4f7cfb1c2708,2023-01-07T00:00:00.000Z,NEFT DR-SIBL0000555-JAIVEER KUMAR-SANDOZ - MUM-N007232279882464-NET BANKING SI - 29000,,,net_banking_transfer,-29000
64142ac8f8804aea721709a6,50200023535069,-371393.61,60ec41ba55c00300382672d9,HDFC,direct expenses,5eecc6d6449e4f7cfb1c2708,2023-01-07T00:00:00.000Z,NEFT DR-BARB0VJGRKA-OM PRASAD PANDEY-SAN DOZ - MUM-N007232279882465-NET BANKING S I -25000,,,net_banking_transfer,-25000
64142ac8f8804aea721709a8,50200023535069,-395393.61,60ec41ba55c00300382672d9,HDFC,direct expenses,5eecc6d6449e4f7cfb1c2708,2023-01-07T00:00:00.000Z,NEFT DR-PUNB0482100-RAM BHAVAN YADAV-SAN DOZ - MUM-N007232279882466-NET BANKING S I -24000,,,net_banking_transfer,-24000
64142ac8f8804aea721709aa,50200023535069,-472518.61,60ec41ba55c00300382672d9,HDFC,direct expenses,5eecc6d6449e4f7cfb1c2708,2023-01-07T00:00:00.000Z,NEFT DR-SBIN0070392-APARNA MOHANAN KONAT -SANDOZ - MUM-N007232279882467-NET BANKI NG SI -77125,,,net_banking_transfer,-77125
64142ac8f8804aea721709ac,50200023535069,-498678.61,60ec41ba55c00300382672d9,HDFC,direct expenses,5eecc6d6449e4f7cfb1c2708,2023-01-07T00:00:00.000Z,NEFT DR-ICIC0002697-NITISH KUMAR-SANDOZ - MUM-N007232279882468-NET BANKING SI -2 6160,,,net_banking_transfer,-26160
64142ac8f8804aea721709ae,50200023535069,-588048.61,60ec41ba55c00300382672d9,HDFC,direct expenses,5eecc6d6449e4f7cfb1c2708,2023-01-07T00:00:00.000Z,NEFT DR-IOBA0001445-PRIYANKA GOPAL-SANDO Z - MUM-N007232279882469-NET BANKING SI -89370,,,net_banking_transfer,-89370
64142ac8f8804aea721709b0,50200023535069,-782095.61,60ec41ba55c00300382672d9,HDFC,direct expenses,5eecc6d6449e4f7cfb1c2708,2023-01-07T00:00:00.000Z,NEFT DR-KKBK0000261-TANVI TANEJA-SANDOZ - MUM-N007232279882470-NET BANKING SI -1 94047,,,net_banking_transfer,-194047
64142ac8f8804aea721709b2,50200023535069,-913149.61,60ec41ba55c00300382672d9,HDFC,direct expenses,5eecc6d6449e4f7cfb1c2708,2023-01-07T00:00:00.000Z,NEFT DR-ICIC0000021-AKHILESH DIXIT-SANDO Z - MUM-N007232279882471-NET BANKING SI -131054,,,net_banking_transfer,-131054
64142ac8f8804aea721709b4,50200023535069,-931025.61,60ec41ba55c00300382672d9,HDFC,direct expenses,5eecc6d6449e4f7cfb1c2708,2023-01-07T00:00:00.000Z,NEFT DR-KKBK0004266-NIDHI PANDEY-SANDOZ - MUM-N007232279882472-NET BANKING SI -1 7876,,,net_banking_transfer,-17876
64142ac8f8804aea721709b6,50200023535069,-960407.61,60ec41ba55c00300382672d9,HDFC,direct expenses,5eecc6d6449e4f7cfb1c2708,2023-01-07T00:00:00.000Z,NEFT DR-PUNB0062910-YADAVPACKAGING-SANDO,,,net_banking_transfer,-29382
64142ac8f8804aea721709b8,50200023535069,-976157.61,60ec41ba55c00300382672d9,HDFC,direct expenses,5eecc6d6449e4f7cfb1c2708,2023-01-07T00:00:00.000Z,NEFT DR-ICIC0004109-ASHRAFI ASSOCIATES-S ANDOZ - MUM-N007232279882474-NET BANKING SI -15750,,,net_banking_transfer,-15750
64142ac8f8804aea721709ba,50200023535069,-981113.61,60ec41ba55c00300382672d9,HDFC,Marketing Expense,5eecc6d6449e4f7cfb1c2708,2023-01-07T00:00:00.000Z,ME DC SI 514834XXXXXX9486 FACEBOOK SI,,,Other,-4956
64142ac8f8804aea721709bc,50200023535069,-979818.14,60ec41ba55c00300382672d9,HDFC,Revenue-PG-split enabled,5eecc6d6449e4f7cfb1c2708,2023-01-07T00:00:00.000Z,NEFT CR-UTIB0001506-RAZORPAY SOFTWARE PR IVATE LIMITED-SLICK ORGANICS PVT LITD-AX ISCN0196018574,,,net_banking_transfer,1295.47
64142ac8f8804aea721709be,50200023535069,-979817.14,60ec41ba55c00300382672d9,HDFC,Transfer in/Revenue-other,5eecc6d6449e4f7cfb1c2708,2023-01-07T00:00:00.000Z,IMPS-300726023370-APIBANKING-RATN-XXXXXX XXXXXX0168-ACCOUNTVALIDATION,,,net_banking_transfer,1
64142ac8f8804aea721709c0,50200023535069,-1009317.14,60ec41ba55c00300382672d9,HDFC,direct expenses,5eecc6d6449e4f7cfb1c2708,2023-01-07T00:00:00.000Z,"NEFT DR-KKBK0004632-DOLLY JAIN-NETBANK, MUM-N007232280633927-29500",,,net_banking_transfer,-29500
64142ac8f8804aea721709c2,50200023535069,-1006077.96,60ec41ba55c00300382672d9,HDFC,Transfer in/Revenue-other,5eecc6d6449e4f7cfb1c2708,2023-01-07T00:00:00.000Z,IMPS-300712892210-EXCRO PAY ESCROW ACC-Y ESB-XXXXXXXXXXX1807-333112298023,,,net_banking_transfer,3239.18
64142ac8f8804aea721709c4,50200023535069,-1048477.96,60ec41ba55c00300382672d9,HDFC,direct expenses,5eecc6d6449e4f7cfb1c2708,2023-01-07T00:00:00.000Z,"NEFT DR-UTIB0001720-ANUBHAV RAO-NETBANK, MUM-N007232281424246-42400",,,net_banking_transfer,-42400
64142ac8f8804aea721709c6,50200023535069,-1090303.96,60ec41ba55c00300382672d9,HDFC,direct expenses,5eecc6d6449e4f7cfb1c2708,2023-01-07T00:00:00.000Z,09291610057185-TPT-41826-MANISH KUMAR,,,net_banking_transfer,-41826
64142ac8f8804aea721709c8,50200023535069,-981133.75,60ec41ba55c00300382672d9,HDFC,Transfer in/Revenue-other,5eecc6d6449e4f7cfb1c2708,2023-01-07T00:00:00.000Z,NEFT CR-YESB0000001-EASEBUZZ PVT LTD NOD AL A/C-SLICK ORGANICS PVT LTD-YESB300730 98558,,,net_banking_transfer,109170.21
64142ac8f8804aea721709cb,50200023535069,-979974.18,60ec41ba55c00300382672d9,HDFC,Revenue-PG-split enabled,5eecc6d6449e4f7cfb1c2708,2023-01-07T00:00:00.000Z,NEFT CR-UTIB0001506-RAZORPAY SOFTWARE PR IVATE LIMITED-SLICK ORGANICS PVT LITD-AX ISCN0196177340,,,net_banking_transfer,1159.57
64142ac8f8804aea721709cd,50200023535069,-959181.18,60ec41ba55c00300382672d9,HDFC,Transfer in/Revenue-other,5eecc6d6449e4f7cfb1c2708,2023-01-07T00:00:00.000Z,NEFT CR-HSBC0560002-INNOVATIVE RETAIL CO NCEPTS PRIVATE-SLICK ORGANICS PVT LTD-HS BCN23007513506,,,net_banking_transfer,20793
64142ac8f8804aea721709cf,50200023535069,-960274.53,60ec41ba55c00300382672d9,HDFC,Marketing Expense,5eecc6d6449e4f7cfb1c2708,2023-01-07T00:00:00.000Z,ME DC SI 514834XXXXXX9486 FACEBOOK SI,,,Other,-1093.35
64142ac8f8804aea721709d1,50200023535069,-960268.53,60ec41ba55c00300382672d9,HDFC,Transfer in/Revenue-other,5eecc6d6449e4f7cfb1c2708,2023-01-08T00:00:00.000Z,INT. ON SWCR ON-50300720580141,,,Other,6
64142ac8f8804aea721709d3,50200023535069,-955312.53,60ec41ba55c00300382672d9,HDFC,Loan-in,5eecc6d6449e4f7cfb1c2708,2023-01-08T00:00:00.000Z,SWEEP-IN CREDIT - 50300720580141,,,self_transfer,4956
64142ac8f8804aea721709d5,50200023535069,-954213.53,60ec41ba55c00300382672d9,HDFC,Transfer in/Revenue-other,5eecc6d6449e4f7cfb1c2708,2023-01-08T00:00:00.000Z,INT. ON SWCR ON-50300720580141,,,Other,1099
64142ac8f8804aea721709d7,50200023535069,1099.47,60ec41ba55c00300382672d9,HDFC,Loan-in,5eecc6d6449e4f7cfb1c2708,2023-01-08T00:00:00.000Z,SWEEP-IN CREDIT - 50300720580141,,,self_transfer,955313
64142ac8f8804aea721709d9,50200023535069,2828.5,60ec41ba55c00300382672d9,HDFC,Transfer in/Revenue-other,5eecc6d6449e4f7cfb1c2708,2023-01-08T00:00:00.000Z,IMPS-300803642166-EXCRO PAY ESCROW ACC-Y ESB-XXXXXXXXXXX1807-333112298023,,,net_banking_transfer,1729.03
64142ac8f8804aea721709db,50200023535069,-1301.5,60ec41ba55c00300382672d9,HDFC,Marketing Expense,5eecc6d6449e4f7cfb1c2708,2023-01-08T00:00:00.000Z,ME DC SI 514834XXXXXX9486 FACEBOOK SI,,,Other,-4130
64142ac9f8804aea721709dd,50200023535069,-5402.87,60ec41ba55c00300382672d9,HDFC,Marketing Expense,5eecc6d6449e4f7cfb1c2708,2023-01-08T00:00:00.000Z,ME DC SI 514834XXXXXX9486 FACEBOOK SI,,,Other,-4101.37
64142ac9f8804aea721709df,50200023535069,-5400.87,60ec41ba55c00300382672d9,HDFC,Transfer in/Revenue-other,5eecc6d6449e4f7cfb1c2708,2023-01-09T00:00:00.000Z,INT. ON SWCR ON-50300720580141,,,Other,2
64142ac9f8804aea721709e1,50200023535069,-4098.87,60ec41ba55c00300382672d9,HDFC,Loan-in,5eecc6d6449e4f7cfb1c2708,2023-01-09T00:00:00.000Z,SWEEP-IN CREDIT - 50300720580141,,,self_transfer,1302
64142ac9f8804aea721709e3,50200023535069,-4093.87,60ec41ba55c00300382672d9,HDFC,Transfer in/Revenue-other,5eecc6d6449e4f7cfb1c2708,2023-01-09T00:00:00.000Z,INT. ON SWCR ON-50300720580141,,,Other,5
64142ac9f8804aea721709e5,50200023535069,5.13,60ec41ba55c00300382672d9,HDFC,Loan-in,5eecc6d6449e4f7cfb1c2708,2023-01-09T00:00:00.000Z,SWEEP-IN CREDIT - 50300720580141,,,self_transfer,4099
64142ac9f8804aea721709e7,50200023535069,683.84,60ec41ba55c00300382672d9,HDFC,Transfer in/Revenue-other,5eecc6d6449e4f7cfb1c2708,2023-01-09T00:00:00.000Z,IMPS-300904641468-EXCRO PAY ESCROW ACC-Y ESB-XXXXXXXXXXX1807-333112298023,,,net_banking_transfer,678.71
64142ac9f8804aea721709e9,50200023535069,6836.98,60ec41ba55c00300382672d9,HDFC,Transfer in/Revenue-other,5eecc6d6449e4f7cfb1c2708,2023-01-09T00:00:00.000Z,IMPS-300907683938-EXCRO PAY ESCROW ACC-Y ESB-XXXXXXXXXXX1807-333112298023,,,net_banking_transfer,6153.14
64142ac9f8804aea721709ec,50200023535069,11181.49,60ec41ba55c00300382672d9,HDFC,Revenue-Mktplace,5eecc6d6449e4f7cfb1c2708,2023-01-09T00:00:00.000Z,NEFT CR-DEUT0797BGL-MYNTRA DESIGNS PRIVA TE LIMITED-SLICK ORGANICS - SJIT-3009008 15GN00003,shopping,,net_banking_transfer,4344.51
64142ac9f8804aea721709f0,50200023535069,11765.18,60ec41ba55c00300382672d9,HDFC,Revenue-Mktplace,5eecc6d6449e4f7cfb1c2708,2023-01-09T00:00:00.000Z,NEFT CR-DEUT0797BGL-MYNTRA DESIGNS PRIVA TE LIMITED-SLICK ORGANICS PVT. LTD.-3009 00834GN00077,shopping,,net_banking_transfer,583.69
64142ac9f8804aea721709f2,50200023535069,14527.16,60ec41ba55c00300382672d9,HDFC,Revenue-PG-split enabled,5eecc6d6449e4f7cfb1c2708,2023-01-09T00:00:00.000Z,NEFT CR-UTIB0001506-RAZORPAY SOFTWARE PR IVATE LIMITED-SLICK ORGANICS PVT LITD-AX ISCN0196418868,,,net_banking_transfer,2761.98
64142ac9f8804aea721709f4,50200023535069,-285472.84,60ec41ba55c00300382672d9,HDFC,direct expenses,5eecc6d6449e4f7cfb1c2708,2023-01-09T00:00:00.000Z,POS 514834XXXXXX9486 E-COMMERCE RP,,,debit_card,-300000
64142ac9f8804aea721709f6,50200023535069,-298972.84,60ec41ba55c00300382672d9,HDFC,direct expenses,5eecc6d6449e4f7cfb1c2708,2023-01-09T00:00:00.000Z,"NEFT DR-UTIB0000588-SOMYA SHARMA-NETBANK , MUM-N009232282712595-13500",,,net_banking_transfer,-13500
64142ac9f8804aea721709f9,50200023535069,-290445.36,60ec41ba55c00300382672d9,HDFC,Transfer in/Revenue-other,5eecc6d6449e4f7cfb1c2708,2023-01-09T00:00:00.000Z,NEFT CR-UTIB0000114-ONE SIGMA TECHNOLOGI ES PRIVATE LIM-SLICK ORGANICS PRIVATE LI MITED-AXISP00353435494,bnpl,,net_banking_transfer,8527.48
64142ac9f8804aea721709fb,50200023535069,-284250.29,60ec41ba55c00300382672d9,HDFC,Transfer in/Revenue-other,5eecc6d6449e4f7cfb1c2708,2023-01-09T00:00:00.000Z,NEFT CR-UTIB0000114-ONE SIGMA TECHNOLOGI,bnpl,,net_banking_transfer,6195.07
64142ac9f8804aea721709fd,50200023535069,-275582.29,60ec41ba55c00300382672d9,HDFC,Revenue-Mktplace,5eecc6d6449e4f7cfb1c2708,2023-01-09T00:00:00.000Z,NEFT CR-ICIC0000105-MANASH LIFETYLE PVT LTD-SLICK ORGANICS PRIVATE LIMITED-ICIB2 30090036794,,,net_banking_transfer,8668
64142ac9f8804aea721709ff,50200023535069,-275947.29,60ec41ba55c00300382672d9,HDFC,SAAS/tech expense,5eecc6d6449e4f7cfb1c2708,2023-01-09T00:00:00.000Z,POS 514834XXXXXX9486 AMAZON PAY INDIA,shopping,,debit_card,-365
64142ac9f8804aea72170a01,50200023535069,-187026.24,60ec41ba55c00300382672d9,HDFC,Revenue-COD,5eecc6d6449e4f7cfb1c2708,2023-01-09T00:00:00.000Z,NEFT CR-ICIC0000155-SHIPROCKET COD CRF I D 5502747-SLICK ORGANICS PVT LTD-CMS3057 623310,,,net_banking_transfer,88921.05
64142ac9f8804aea72170a03,50200023535069,-186466.47,60ec41ba55c00300382672d9,HDFC,Revenue-PG-split enabled,5eecc6d6449e4f7cfb1c2708,2023-01-09T00:00:00.000Z,NEFT CR-UTIB0001506-RAZORPAY SOFTWARE PR IVATE LIMITED-SLICK ORGANICS PVT LITD-AX ISCN0196614903,,,net_banking_transfer,559.77
64142ac9f8804aea72170a05,50200023535069,-236466.47,60ec41ba55c00300382672d9,HDFC,direct expenses,5eecc6d6449e4f7cfb1c2708,2023-01-09T00:00:00.000Z,50100108772229-TPT-50000-HEMANT GUPTA,,,net_banking_transfer,-50000
64142ac9f8804aea72170a07,50200023535069,-168175.96,60ec41ba55c00300382672d9,HDFC,Transfer in/Revenue-other,5eecc6d6449e4f7cfb1c2708,2023-01-09T00:00:00.000Z,NEFT CR-YESB0000001-EASEBUZZ PVT LTD NOD AL A/C-SLICK ORGANICS PVT LTD-YESB300991 03540,,,net_banking_transfer,68290.51
64142ac9f8804aea72170a09,50200023535069,-113835.33,60ec41ba55c00300382672d9,HDFC,Transfer in/Revenue-other,5eecc6d6449e4f7cfb1c2708,2023-01-09T00:00:00.000Z,NEFT CR-YESB0000001-EASEBUZZ PVT LTD NOD AL A/C-SLICK ORGANICS PVT LTD-YESB300991 21813,,,net_banking_transfer,54340.63
64142ac9f8804aea72170a0b,50200023535069,-118791.33,60ec41ba55c00300382672d9,HDFC,Marketing Expense,5eecc6d6449e4f7cfb1c2708,2023-01-09T00:00:00.000Z,ME DC SI 514834XXXXXX9486 FACEBOOK SI,,,Other,-4956
64142ac9f8804aea72170a0d,50200023535069,-118641.33,60ec41ba55c00300382672d9,HDFC,Transfer in/Revenue-other,5eecc6d6449e4f7cfb1c2708,2023-01-10T00:00:00.000Z,INT. ON SWCR ON-50300720580141,,,Other,150
64142ac9f8804aea72170a0f,50200023535069,150.67,60ec41ba55c00300382672d9,HDFC,Loan-in,5eecc6d6449e4f7cfb1c2708,2023-01-10T00:00:00.000Z,SWEEP-IN CREDIT - 50300720580141,,,self_transfer,118792
64142ac9f8804aea72170a11,50200023535069,918.46,60ec41ba55c00300382672d9,HDFC,Transfer in/Revenue-other,5eecc6d6449e4f7cfb1c2708,2023-01-10T00:00:00.000Z,IMPS-301004708669-EXCRO PAY ESCROW ACC-Y ESB-XXXXXXXXXXX1807-333112298023,,,net_banking_transfer,767.79
64142ac9f8804aea72170a13,50200023535069,-399081.54,60ec41ba55c00300382672d9,HDFC,Marketing Expense,5eecc6d6449e4f7cfb1c2708,2023-01-10T00:00:00.000Z,NEFT DR-CITI0000006-FACEBOOK INDIA ONLIN E SERVICES PVT LTD-SANDOZ - MUM-N0102322 84241248-NET BANKING SI -400000,,,net_banking_transfer,-400000
64142ac9f8804aea72170a15,50200023535069,-649081.54,60ec41ba55c00300382672d9,HDFC,direct expenses,5eecc6d6449e4f7cfb1c2708,2023-01-10T00:00:00.000Z,NEFT DR-ICIC0000369-BO INTERNATIONAL-SAN DOZ - MUM-N010232284241250-NET BANKING S I -250000,,,net_banking_transfer,-250000
64142ac9f8804aea72170a17,50200023535069,-648902.79,60ec41ba55c00300382672d9,HDFC,Transfer in/Revenue-other,5eecc6d6449e4f7cfb1c2708,2023-01-10T00:00:00.000Z,NEFT CR-SCBL0036001-AXELIA SOLUTIONS PRI,,,net_banking_transfer,178.75
64142ac9f8804aea72170a19,50200023535069,-648372.43,60ec41ba55c00300382672d9,HDFC,Revenue-PG-split enabled,5eecc6d6449e4f7cfb1c2708,2023-01-10T00:00:00.000Z,NEFT CR-UTIB0001506-RAZORPAY SOFTWARE PR IVATE LIMITED-SLICK ORGANICS PVT LITD-AX ISCN0196748903,,,net_banking_transfer,530.36
64142ac9f8804aea72170a1b,50200023535069,-609914.5,60ec41ba55c00300382672d9,HDFC,Transfer in/Revenue-other,5eecc6d6449e4f7cfb1c2708,2023-01-10T00:00:00.000Z,59209873901899-TPT-INV 2240852-NYNM ORGA NICS PVT LTD,,,net_banking_transfer,38457.93
64142ac9f8804aea72170a1d,50200023535069,-593560.08,60ec41ba55c00300382672d9,HDFC,Transfer in/Revenue-other,5eecc6d6449e4f7cfb1c2708,2023-01-10T00:00:00.000Z,NEFT CR-UTIB0000114-ONE SIGMA TECHNOLOGI ES PRIVATE LIM-SLICK ORGANICS PRIVATE LI MITED-AXISP00353684754,bnpl,,net_banking_transfer,16354.42
64142ac9f8804aea72170a1f,50200023535069,-587067.08,60ec41ba55c00300382672d9,HDFC,Revenue-Mktplace,5eecc6d6449e4f7cfb1c2708,2023-01-10T00:00:00.000Z,NEFT CR-ICIC0000105-MANASH LIFETYLE PVT LTD-SLICK ORGANICS PRIVATE LIMITED-ICIB2 30100014124,,,net_banking_transfer,6493
64142ac9f8804aea72170a21,50200023535069,-737067.08,60ec41ba55c00300382672d9,HDFC,direct expenses,5eecc6d6449e4f7cfb1c2708,2023-01-10T00:00:00.000Z,POS 514834XXXXXX9486 E-COMMERCE RP,,,debit_card,-150000
64142ac9f8804aea72170a23,50200023535069,-887067.08,60ec41ba55c00300382672d9,HDFC,direct expenses,5eecc6d6449e4f7cfb1c2708,2023-01-10T00:00:00.000Z,"NEFT DR-IBKL0000165-VISTTA COSMETICS-NET BANK, MUM-N010232285452859-150000",,,net_banking_transfer,-150000
64142ac9f8804aea72170a25,50200023535069,-1037067.08,60ec41ba55c00300382672d9,HDFC,direct expenses,5eecc6d6449e4f7cfb1c2708,2023-01-10T00:00:00.000Z,57500001065314-TPT-150000-KRAUTER HEALTH CARE LTD,,,net_banking_transfer,-150000
64142ac9f8804aea72170a27,50200023535069,-1145067.08,60ec41ba55c00300382672d9,HDFC,direct expenses,5eecc6d6449e4f7cfb1c2708,2023-01-10T00:00:00.000Z,"NEFT DR-BARB0VJMATU-ARTISTO DESIGNZ-NETB ANK, MUM-N010232285546244-108000",,,net_banking_transfer,-108000
64142ac9f8804aea72170a29,50200023535069,-937097.09,60ec41ba55c00300382672d9,HDFC,Transfer in/Revenue-other,5eecc6d6449e4f7cfb1c2708,2023-01-10T00:00:00.000Z,RTGS CR-IDFB0010204-PCPL CENTRAL DISBURS EMENT AC-SLICK ORGANICS PRIVATE LIMITED- IDFBR52023011000666869,,,net_banking_transfer,207969.99
64142ac9f8804aea72170a2c,50200023535069,-951497.09,60ec41ba55c00300382672d9,HDFC,direct expenses,5eecc6d6449e4f7cfb1c2708,2023-01-10T00:00:00.000Z,50100375208010-TPT-14400-DISHA BATRA,,,net_banking_transfer,-14400
64142ac9f8804aea72170a2e,50200023535069,-1006497.09,60ec41ba55c00300382672d9,HDFC,direct expenses,5eecc6d6449e4f7cfb1c2708,2023-01-10T00:00:00.000Z,"NEFT DR-KKBK0005289-HILL GROOVE CONSULTI NG LLP-NETBANK, MUM-N010232285604341-550 00",,,net_banking_transfer,-55000
64142ac9f8804aea72170a30,50200023535069,-1007096.09,60ec41ba55c00300382672d9,HDFC,SAAS/tech expense,5eecc6d6449e4f7cfb1c2708,2023-01-10T00:00:00.000Z,POS 514834XXXXXX9486 AMAZON PAY INDIA,shopping,,debit_card,-599
64142ac9f8804aea72170a32,50200023535069,-1051869.09,60ec41ba55c00300382672d9,HDFC,direct expenses,5eecc6d6449e4f7cfb1c2708,2023-01-10T00:00:00.000Z,"NEFT DR-KKBK0000187-APPLIED LIFE PRIVATE LIMITED-NETBANK, MUM-N010232285654990-4 4773",,,net_banking_transfer,-44773
64142ac9f8804aea72170a34,50200023535069,-989717.85,60ec41ba55c00300382672d9,HDFC,Transfer in/Revenue-other,5eecc6d6449e4f7cfb1c2708,2023-01-10T00:00:00.000Z,NEFT CR-YESB0000001-EASEBUZZ PVT LTD NOD,,,net_banking_transfer,62151.24
64142ac9f8804aea72170a36,50200023535069,-989261.13,60ec41ba55c00300382672d9,HDFC,Revenue-PG-split enabled,5eecc6d6449e4f7cfb1c2708,2023-01-10T00:00:00.000Z,NEFT CR-UTIB0001506-RAZORPAY SOFTWARE PR IVATE LIMITED-SLICK ORGANICS PVT LITD-AX ISCN0196929095,,,net_banking_transfer,456.72
64142ac9f8804aea72170a38,50200023535069,-988407.13,60ec41ba55c00300382672d9,HDFC,Transfer in/Revenue-other,5eecc6d6449e4f7cfb1c2708,2023-01-11T00:00:00.000Z,INT. ON SWCR ON-50300720580141,,,Other,854
64142ac9f8804aea72170a3a,50200023535069,-339325.13,60ec41ba55c00300382672d9,HDFC,Loan-in,5eecc6d6449e4f7cfb1c2708,2023-01-11T00:00:00.000Z,SWEEP-IN CREDIT - 50300720580141,,,self_transfer,649082
64142ac9f8804aea72170a3c,50200023535069,-339209.13,60ec41ba55c00300382672d9,HDFC,Transfer in/Revenue-other,5eecc6d6449e4f7cfb1c2708,2023-01-11T00:00:00.000Z,INT. ON SWCR ON-50300720580141,,,Other,116
64142ac9f8804aea72170a3e,50200023535069,-251223.13,60ec41ba55c00300382672d9,HDFC,Loan-in,5eecc6d6449e4f7cfb1c2708,2023-01-11T00:00:00.000Z,SWEEP-IN CREDIT - 50300720580141,,,self_transfer,87986
64142ac9f8804aea72170a40,50200023535069,-251026.13,60ec41ba55c00300382672d9,HDFC,Transfer in/Revenue-other,5eecc6d6449e4f7cfb1c2708,2023-01-11T00:00:00.000Z,INT. ON SWCR ON-50300720580141,,,Other,197
64142ac9f8804aea72170a42,50200023535069,-101026.13,60ec41ba55c00300382672d9,HDFC,Loan-in,5eecc6d6449e4f7cfb1c2708,2023-01-11T00:00:00.000Z,SWEEP-IN CREDIT - 50300720580141,,,self_transfer,150000
64142ac9f8804aea72170a45,50200023535069,-100893.13,60ec41ba55c00300382672d9,HDFC,Transfer in/Revenue-other,5eecc6d6449e4f7cfb1c2708,2023-01-11T00:00:00.000Z,INT. ON SWCR ON-50300720580141,,,Other,133
64142ac9f8804aea72170a47,50200023535069,133.87,60ec41ba55c00300382672d9,HDFC,Loan-in,5eecc6d6449e4f7cfb1c2708,2023-01-11T00:00:00.000Z,SWEEP-IN CREDIT - 50300720580141,,,self_transfer,101027
64142ac9f8804aea72170a49,50200023535069,1557.42,60ec41ba55c00300382672d9,HDFC,Transfer in/Revenue-other,5eecc6d6449e4f7cfb1c2708,2023-01-11T00:00:00.000Z,IMPS-301103824267-EXCRO PAY ESCROW ACC-Y ESB-XXXXXXXXXXX1807-333112298023,,,net_banking_transfer,1423.55
64142ac9f8804aea72170a4b,50200023535069,-23442.58,60ec41ba55c00300382672d9,HDFC,direct expenses,5eecc6d6449e4f7cfb1c2708,2023-01-11T00:00:00.000Z,NEFT DR-YESB0000236-DELIGHT VACATION PVT LTD-SANDOZ - MUM-N011232286282773-NET B ANKING SI -25000,,,net_banking_transfer,-25000
64142ac9f8804aea72170a4d,50200023535069,-173442.58,60ec41ba55c00300382672d9,HDFC,direct expenses,5eecc6d6449e4f7cfb1c2708,2023-01-11T00:00:00.000Z,POS 514834XXXXXX9486 E-COMMERCE RP,,,debit_card,-150000
64142ac9f8804aea72170a50,50200023535069,-158733.58,60ec41ba55c00300382672d9,HDFC,Revenue-Mktplace,5eecc6d6449e4f7cfb1c2708,2023-01-11T00:00:00.000Z,NEFT CR-ICIC0000985-DIGITAL AGE RETAIL P VT LTD-SLICK ORGANICS PVT LTD DS-CMS30 60710245,,,net_banking_transfer,14709
64142ac9f8804aea72170a52,50200023535069,-211733.58,60ec41ba55c00300382672d9,HDFC,direct expenses,5eecc6d6449e4f7cfb1c2708,2023-01-11T00:00:00.000Z,"NEFT DR-KKBK0005289-HILL GROOVE CONSULTI NG LLP-NETBANK, MUM-N011232286290922-530 00",,,net_banking_transfer,-53000
64142ac9f8804aea72170a54,50200023535069,-207200.63,60ec41ba55c00300382672d9,HDFC,Transfer in/Revenue-other,5eecc6d6449e4f7cfb1c2708,2023-01-11T00:00:00.000Z,IMPS-301107905669-EXCRO PAY ESCROW ACC-Y ESB-XXXXXXXXXXX1807-333112298023,,,net_banking_transfer,4532.95
64142ac9f8804aea72170a57,50200023535069,-202080.67,60ec41ba55c00300382672d9,HDFC,Revenue-Mktplace,5eecc6d6449e4f7cfb1c2708,2023-01-11T00:00:00.000Z,NEFT CR-DEUT0797BGL-MYNTRA DESIGNS PRIVA TE LIMITED-SLICK ORGANICS - SJIT-3011007 96GN00185,shopping,,net_banking_transfer,5119.96
64142ac9f8804aea72170a59,50200023535069,-200699.43,60ec41ba55c00300382672d9,HDFC,Revenue-Mktplace,5eecc6d6449e4f7cfb1c2708,2023-01-11T00:00:00.000Z,NEFT CR-DEUT0797BGL-MYNTRA DESIGNS PRIVA TE LIMITED-SLICK ORGANICS PVT. LTD.-3011 00806GN00277,shopping,,net_banking_transfer,1381.24
64142acaf8804aea72170a5b,50200023535069,-199803.9,60ec41ba55c00300382672d9,HDFC,Revenue-PG-split enabled,5eecc6d6449e4f7cfb1c2708,2023-01-11T00:00:00.000Z,NEFT CR-UTIB0001506-RAZORPAY SOFTWARE PR,,,net_banking_transfer,895.53
64142acaf8804aea72170a5d,50200023535069,-204759.9,60ec41ba55c00300382672d9,HDFC,Marketing Expense,5eecc6d6449e4f7cfb1c2708,2023-01-11T00:00:00.000Z,ME DC SI 514834XXXXXX9486 FACEBOOK SI,,,Other,-4956
64142acaf8804aea72170a5f,50200023535069,-190076.58,60ec41ba55c00300382672d9,HDFC,Transfer in/Revenue-other,5eecc6d6449e4f7cfb1c2708,2023-01-11T00:00:00.000Z,NEFT CR-YESB0000001-EASEBUZZ PVT LTD NOD AL A/C-SLICK ORGANICS PVT LTD-YESB301154 57711,,,net_banking_transfer,14683.32
64142acaf8804aea72170a61,50200023535069,-188404.58,60ec41ba55c00300382672d9,HDFC,Revenue-Mktplace,5eecc6d6449e4f7cfb1c2708,2023-01-11T00:00:00.000Z,NEFT CR-ICIC0000105-MANASH LIFETYLE PVT LTD-SLICK ORGANICS PRIVATE LIMITED-ICIB2 30110013459,,,net_banking_transfer,1672
64142acaf8804aea72170a63,50200023535069,-182632.29,60ec41ba55c00300382672d9,HDFC,Transfer in/Revenue-other,5eecc6d6449e4f7cfb1c2708,2023-01-11T00:00:00.000Z,NEFT CR-UTIB0000114-ONE SIGMA TECHNOLOGI ES PRIVATE LIM-SLICK ORGANICS PRIVATE LI MITED-AXISP00354030297,bnpl,,net_banking_transfer,5772.29
64142acaf8804aea72170a65,50200023535069,-185698.29,60ec41ba55c00300382672d9,HDFC,direct expenses,5eecc6d6449e4f7cfb1c2708,2023-01-11T00:00:00.000Z,POS 514834XXXXXX9486 PTM*PAYTM WALLET,ewallet,,debit_card,-3066
64142acaf8804aea72170a67,50200023535069,-294876.29,60ec41ba55c00300382672d9,HDFC,direct expenses,5eecc6d6449e4f7cfb1c2708,2023-01-11T00:00:00.000Z,00921000075586-TPT-109178-ROET BINDRA,,,net_banking_transfer,-109178
64142acaf8804aea72170a69,50200023535069,-343476.29,60ec41ba55c00300382672d9,HDFC,direct expenses,5eecc6d6449e4f7cfb1c2708,2023-01-11T00:00:00.000Z,"NEFT DR-KKBK0000654-NIHARIKA MISHRA-NETB ANK, MUM-N011232287548373-48600",,,net_banking_transfer,-48600
64142acaf8804aea72170a6b,50200023535069,-343317.28,60ec41ba55c00300382672d9,HDFC,Revenue-PG-split enabled,5eecc6d6449e4f7cfb1c2708,2023-01-11T00:00:00.000Z,NEFT CR-UTIB0001506-RAZORPAY SOFTWARE PR IVATE LIMITED-SLICK ORGANICS PVT LITD-AX ISCN0197286481,,,net_banking_transfer,159.01
64142acaf8804aea72170a6d,50200023535069,-283330.41,60ec41ba55c00300382672d9,HDFC,Transfer in/Revenue-other,5eecc6d6449e4f7cfb1c2708,2023-01-11T00:00:00.000Z,NEFT CR-YESB0000001-EASEBUZZ PVT LTD NOD AL A/C-SLICK ORGANICS PVT LTD-YESB301158 53441,,,net_banking_transfer,59986.87
64142acaf8804aea72170a6f,50200023535069,-283125.41,60ec41ba55c00300382672d9,HDFC,Transfer in/Revenue-other,5eecc6d6449e4f7cfb1c2708,2023-01-12T00:00:00.000Z,INT. ON SWCR ON-50300720580141,,,Other,205
64142acaf8804aea72170a71,50200023535069,-133125.41,60ec41ba55c00300382672d9,HDFC,Loan-in,5eecc6d6449e4f7cfb1c2708,2023-01-12T00:00:00.000Z,SWEEP-IN CREDIT - 50300720580141,,,self_transfer,150000
64142acaf8804aea72170a73,50200023535069,-133093.41,60ec41ba55c00300382672d9,HDFC,Transfer in/Revenue-other,5eecc6d6449e4f7cfb1c2708,2023-01-12T00:00:00.000Z,INT. ON SWCR ON-50300720580141,,,Other,32
64142acaf8804aea72170a75,50200023535069,-109650.41,60ec41ba55c00300382672d9,HDFC,Loan-in,5eecc6d6449e4f7cfb1c2708,2023-01-12T00:00:00.000Z,SWEEP-IN CREDIT - 50300720580141,,,self_transfer,23443
64142acaf8804aea72170a77,50200023535069,-109598.41,60ec41ba55c00300382672d9,HDFC,Transfer in/Revenue-other,5eecc6d6449e4f7cfb1c2708,2023-01-12T00:00:00.000Z,INT. ON SWCR ON-50300720580141,,,Other,52
64142acaf8804aea72170a79,50200023535069,-71307.41,60ec41ba55c00300382672d9,HDFC,Loan-in,5eecc6d6449e4f7cfb1c2708,2023-01-12T00:00:00.000Z,SWEEP-IN CREDIT - 50300720580141,,,self_transfer,38291
64142acaf8804aea72170a7b,50200023535069,-71209.41,60ec41ba55c00300382672d9,HDFC,Transfer in/Revenue-other,5eecc6d6449e4f7cfb1c2708,2023-01-12T00:00:00.000Z,INT. ON SWCR ON-50300720580141,,,Other,98
64142acaf8804aea72170a7d,50200023535069,98.59,60ec41ba55c00300382672d9,HDFC,Loan-in,5eecc6d6449e4f7cfb1c2708,2023-01-12T00:00:00.000Z,SWEEP-IN CREDIT - 50300720580141,,,self_transfer,71308
64142acaf8804aea72170a7f,50200023535069,893.72,60ec41ba55c00300382672d9,HDFC,Transfer in/Revenue-other,5eecc6d6449e4f7cfb1c2708,2023-01-12T00:00:00.000Z,IMPS-301204804733-EXCRO PAY ESCROW ACC-Y,,,net_banking_transfer,795.13
64142acaf8804aea72170a81,50200023535069,-254106.28,60ec41ba55c00300382672d9,HDFC,direct expenses,5eecc6d6449e4f7cfb1c2708,2023-01-12T00:00:00.000Z,NEFT DR-SCBL0036020-AMERICAN EXPRESS-SAN DOZ - MUM-N012232287879408-NET BANKING S I -255000,,,net_banking_transfer,-255000
64142acaf8804aea72170a83,50200023535069,-456606.28,60ec41ba55c00300382672d9,HDFC,direct expenses,5eecc6d6449e4f7cfb1c2708,2023-01-12T00:00:00.000Z,NEFT DR-YESB0CMSNOC-CMS NATIONAL OPERATI NG CENTRE-SANDOZ - MUM-N012232287879409- NET BANKING SI -202500,,,net_banking_transfer,-202500
64142acaf8804aea72170a85,50200023535069,-455106.55,60ec41ba55c00300382672d9,HDFC,Revenue-PG-split enabled,5eecc6d6449e4f7cfb1c2708,2023-01-12T00:00:00.000Z,NEFT CR-UTIB0001506-RAZORPAY SOFTWARE PR IVATE LIMITED-SLICK ORGANICS PVT LITD-AX ISCN0197441718,,,net_banking_transfer,1499.73
64142acaf8804aea72170a87,50200023535069,-454146.55,60ec41ba55c00300382672d9,HDFC,Revenue-Mktplace,5eecc6d6449e4f7cfb1c2708,2023-01-12T00:00:00.000Z,NEFT CR-ICIC0000105-MANASH LIFETYLE PVT LTD-SLICK ORGANICS PRIVATE LIMITED-ICIB2 30120016344,,,net_banking_transfer,960
64142acaf8804aea72170a89,50200023535069,-455474.55,60ec41ba55c00300382672d9,HDFC,direct expenses,5eecc6d6449e4f7cfb1c2708,2023-01-12T00:00:00.000Z,POS 514834XXXXXX9486 PAYTM_ADDMONEYTO,ewallet,,debit_card,-1328
64142acaf8804aea72170a8b,50200023535069,-323334.25,60ec41ba55c00300382672d9,HDFC,Revenue-Mktplace,5eecc6d6449e4f7cfb1c2708,2023-01-12T00:00:00.000Z,NEFT CR-KKBK0000958-NYKAA E RETAIL PRIVA TE LIMITED NYKAA-SLICK ORGANICS PVT LTD- KKBK230125673940,,,net_banking_transfer,132140.3
64142acaf8804aea72170a8d,50200023535069,-325363.25,60ec41ba55c00300382672d9,HDFC,direct expenses,5eecc6d6449e4f7cfb1c2708,2023-01-12T00:00:00.000Z,ME DC SI 514834XXXXXX9486 ADOBE SYSTEMS SOFTWARE,,,Other,-2029
64142acaf8804aea72170a8f,50200023535069,-475363.25,60ec41ba55c00300382672d9,HDFC,direct expenses,5eecc6d6449e4f7cfb1c2708,2023-01-12T00:00:00.000Z,POS 514834XXXXXX9486 E-COMMERCE RP,,,debit_card,-150000
64142acaf8804aea72170a91,50200023535069,-477104.25,60ec41ba55c00300382672d9,HDFC,SAAS/tech expense,5eecc6d6449e4f7cfb1c2708,2023-01-12T00:00:00.000Z,POS 514834XXXXXX9486 AMAZON PAY INDIA,shopping,,debit_card,-1741
64142acaf8804aea72170a93,50200023535069,-472826.17,60ec41ba55c00300382672d9,HDFC,Transfer in/Revenue-other,5eecc6d6449e4f7cfb1c2708,2023-01-12T00:00:00.000Z,NEFT CR-CITI0000004-ONE SIGMA TECHNOLOGI ES PVT LTD-SLICK ORGANICS PRIVATE LIMITE D-CITIN23305575301,bnpl,,net_banking_transfer,4278.08
64142acaf8804aea72170a95,50200023535069,-477826.17,60ec41ba55c00300382672d9,HDFC,direct expenses,5eecc6d6449e4f7cfb1c2708,2023-01-12T00:00:00.000Z,"NEFT DR-KKBK0005195-SYED MOHD MURAD ABDU LLAH-NETBANK, MUM-N012232288980801-5000",,,net_banking_transfer,-5000
64142acaf8804aea72170a97,50200023535069,-420806.57,60ec41ba55c00300382672d9,HDFC,Transfer in/Revenue-other,5eecc6d6449e4f7cfb1c2708,2023-01-12T00:00:00.000Z,NEFT CR-YESB0000001-EASEBUZZ PVT LTD NOD AL A/C-SLICK ORGANICS PVT LTD-YESB301290 42116,,,net_banking_transfer,57019.6
64142acaf8804aea72170a99,50200023535069,-420044.27,60ec41ba55c00300382672d9,HDFC,Revenue-PG-split enabled,5eecc6d6449e4f7cfb1c2708,2023-01-12T00:00:00.000Z,NEFT CR-UTIB0001506-RAZORPAY SOFTWARE PR,,,net_banking_transfer,762.3
64142acaf8804aea72170a9b,50200023535069,-424050.17,60ec41ba55c00300382672d9,HDFC,direct expenses,5eecc6d6449e4f7cfb1c2708,2023-01-12T00:00:00.000Z,POS 514834XXXXXX9486 WWW.FAQPRIME.COM,,,debit_card,-4005.9
64142acaf8804aea72170a9d,50200023535069,-59528.39,60ec41ba55c00300382672d9,HDFC,Revenue-Mktplace,5eecc6d6449e4f7cfb1c2708,2023-01-12T00:00:00.000Z,NEFT CR-HSBC0560002-MYNTRA JABONG INDIA PRIVATE LIMITED-SLICK ORGANICS PRIVATE L IMITED-HSBCN23012548110,shopping,,net_banking_transfer,364521.78
64142acaf8804aea72170a9f,50200023535069,-59443.39,60ec41ba55c00300382672d9,HDFC,Transfer in/Revenue-other,5eecc6d6449e4f7cfb1c2708,2023-01-13T00:00:00.000Z,INT. ON SWCR ON-50300720580141,,,Other,85
64142acaf8804aea72170aa1,50200023535069,85.61,60ec41ba55c00300382672d9,HDFC,Loan-in,5eecc6d6449e4f7cfb1c2708,2023-01-13T00:00:00.000Z,SWEEP-IN CREDIT - 50300720580141,,,self_transfer,59529
64142acaf8804aea72170aa3,50200023535069,2000.94,60ec41ba55c00300382672d9,HDFC,Transfer in/Revenue-other,5eecc6d6449e4f7cfb1c2708,2023-01-13T00:00:00.000Z,IMPS-301304735296-EXCRO PAY ESCROW ACC-Y ESB-XXXXXXXXXXX1807-333112298023,,,net_banking_transfer,1915.33
64142acaf8804aea72170aa5,50200023535069,-97999.06,60ec41ba55c00300382672d9,HDFC,direct expenses,5eecc6d6449e4f7cfb1c2708,2023-01-13T00:00:00.000Z,NEFT DR-ICIC0000369-BO INTERNATIONAL-SAN DOZ - MUM-N013232289424249-NET BANKING S I -100000,,,net_banking_transfer,-100000
64142acaf8804aea72170aa7,50200023535069,-102955.06,60ec41ba55c00300382672d9,HDFC,Marketing Expense,5eecc6d6449e4f7cfb1c2708,2023-01-13T00:00:00.000Z,ME DC SI 514834XXXXXX9486 FACEBOOK SI,,,Other,-4956
64142acaf8804aea72170aa9,50200023535069,-99031.63,60ec41ba55c00300382672d9,HDFC,Transfer in/Revenue-other,5eecc6d6449e4f7cfb1c2708,2023-01-13T00:00:00.000Z,IMPS-301307784436-EXCRO PAY ESCROW ACC-Y ESB-XXXXXXXXXXX1807-333112298023,,,net_banking_transfer,3923.43
64142acaf8804aea72170aab,50200023535069,-97778.8,60ec41ba55c00300382672d9,HDFC,Transfer in/Revenue-other,5eecc6d6449e4f7cfb1c2708,2023-01-13T00:00:00.000Z,NEFT CR-SCBL0036001-AXELIA SOLUTIONS PRI VATE LIMITED-SLICK ORGANICS PVT LTD-IN1O N230112032YM,,,net_banking_transfer,1252.83
64142acaf8804aea72170aae,50200023535069,-95900.27,60ec41ba55c00300382672d9,HDFC,Revenue-PG-split enabled,5eecc6d6449e4f7cfb1c2708,2023-01-13T00:00:00.000Z,NEFT CR-UTIB0001506-RAZORPAY SOFTWARE PR IVATE LIMITED-SLICK ORGANICS PVT LITD-AX ISCN0197837955,,,net_banking_transfer,1878.53
64142acaf8804aea72170ab0,50200023535069,-94837.45,60ec41ba55c00300382672d9,HDFC,Revenue-Mktplace,5eecc6d6449e4f7cfb1c2708,2023-01-13T00:00:00.000Z,NEFT CR-DEUT0797BGL-MYNTRA DESIGNS PRIVA TE LIMITED-SLICK ORGANICS PVT. LTD.-3013 00892GN00193,shopping,,net_banking_transfer,1062.82
64142acaf8804aea72170ab2,50200023535069,-92565.08,60ec41ba55c00300382672d9,HDFC,Revenue-Mktplace,5eecc6d6449e4f7cfb1c2708,2023-01-13T00:00:00.000Z,NEFT CR-DEUT0797BGL-MYNTRA DESIGNS PRIVA TE LIMITED-SLICK ORGANICS - SJIT-3013009 43GN00156,shopping,,net_banking_transfer,2272.37
64142acaf8804aea72170ab4,50200023535069,-94096.72,60ec41ba55c00300382672d9,HDFC,SAAS/tech expense,5eecc6d6449e4f7cfb1c2708,2023-01-13T00:00:00.000Z,POS 514834XXXXXX9486 AMAZON PAY INDIA,shopping,,debit_card,-1531.64
64142acaf8804aea72170ab6,50200023535069,-94097.72,60ec41ba55c00300382672d9,HDFC,direct expenses,5eecc6d6449e4f7cfb1c2708,2023-01-13T00:00:00.000Z,ME DC SI 514834XXXXXX9486 SHOPIFY LTD,,,Other,-1
64142acaf8804aea72170ab8,50200023535069,-92974.72,60ec41ba55c00300382672d9,HDFC,Revenue-Mktplace,5eecc6d6449e4f7cfb1c2708,2023-01-13T00:00:00.000Z,NEFT CR-ICIC0000105-MANASH LIFETYLE PVT,,,net_banking_transfer,1123
64142acaf8804aea72170aba,50200023535069,-85574.23,60ec41ba55c00300382672d9,HDFC,Transfer in/Revenue-other,5eecc6d6449e4f7cfb1c2708,2023-01-13T00:00:00.000Z,NEFT CR-UTIB0000114-ONE SIGMA TECHNOLOGI ES PRIVATE LIM-SLICK ORGANICS PRIVATE LI MITED-AXISP00354641219,bnpl,,net_banking_transfer,7400.49
64142acaf8804aea72170abc,50200023535069,-29345.26,60ec41ba55c00300382672d9,HDFC,Transfer in/Revenue-other,5eecc6d6449e4f7cfb1c2708,2023-01-13T00:00:00.000Z,NEFT CR-HSBC0400002-SOUQ.COM FZ LLC UAE ACCS-SLICK ORGANICS PRIVATE LIMITED-HSBC N23013637193,,,net_banking_transfer,56228.97
64142acaf8804aea72170ac0,50200023535069,20654.74,60ec41ba55c00300382672d9,HDFC,Transfer in/Revenue-other,5eecc6d6449e4f7cfb1c2708,2023-01-13T00:00:00.000Z,NEFT CR-ICIC0000105-ICICI BANK LTD-SLICK ORGANICS PVT LTD-ICIB230130030566,,,net_banking_transfer,50000
64142acaf8804aea72170ac2,50200023535069,34375.41,60ec41ba55c00300382672d9,HDFC,Transfer in/Revenue-other,5eecc6d6449e4f7cfb1c2708,2023-01-13T00:00:00.000Z,NEFT CR-SCBL0036001-HEALTH GLOW PRIVATE LIMITED-SLICK ORGANICS PVT LTD-ARATA-IN 1ON23011302AE5,,,net_banking_transfer,13720.67
64142acaf8804aea72170ac4,50200023535069,-15624.59,60ec41ba55c00300382672d9,HDFC,direct expenses,5eecc6d6449e4f7cfb1c2708,2023-01-13T00:00:00.000Z,"NEFT DR-BKID0007124-MATRIX PRINTING SOLU TIONS PVT LTD-NETBANK, MUM-N013232290654 530-50000",,,net_banking_transfer,-50000
64142acaf8804aea72170ac6,50200023535069,-115624.59,60ec41ba55c00300382672d9,HDFC,direct expenses,5eecc6d6449e4f7cfb1c2708,2023-01-13T00:00:00.000Z,"NEFT DR-ICIC0000024-TAKE MOTO YOHKI INDI A PRIVATE LIMITED-NETBANK, MUM-N01323229 0671295-100000",travel,,net_banking_transfer,-100000
64142acaf8804aea72170ac8,50200023535069,-180424.59,60ec41ba55c00300382672d9,HDFC,direct expenses,5eecc6d6449e4f7cfb1c2708,2023-01-13T00:00:00.000Z,50200039330521-TPT-64800-ELITE PUBLICIST,,,net_banking_transfer,-64800
64142acaf8804aea72170aca,50200023535069,-380424.59,60ec41ba55c00300382672d9,HDFC,direct expenses,5eecc6d6449e4f7cfb1c2708,2023-01-13T00:00:00.000Z,POS 514834XXXXXX9486 E-COMMERCE RP,,,debit_card,-200000
64142acaf8804aea72170acc,50200023535069,-334304.23,60ec41ba55c00300382672d9,HDFC,Transfer in/Revenue-other,5eecc6d6449e4f7cfb1c2708,2023-01-13T00:00:00.000Z,NEFT CR-YESB0000001-EASEBUZZ PVT LTD NOD AL A/C-SLICK ORGANICS PVT LTD-YESB301323 49158,,,net_banking_transfer,46120.36
64142acaf8804aea72170ace,50200023535069,-332637.31,60ec41ba55c00300382672d9,HDFC,Revenue-PG-split enabled,5eecc6d6449e4f7cfb1c2708,2023-01-13T00:00:00.000Z,NEFT CR-UTIB0001506-RAZORPAY SOFTWARE PR IVATE LIMITED-SLICK ORGANICS PVT LITD-AX ISCN0198103891,,,net_banking_transfer,1666.92
64142acaf8804aea72170ad0,50200023535069,-336173.77,60ec41ba55c00300382672d9,HDFC,direct expenses,5eecc6d6449e4f7cfb1c2708,2023-01-13T00:00:00.000Z,POS 514834XXXXXX9486 WWW AIRTEL IN,bills,,debit_card,-3536.46
64142acbf8804aea72170ad2,50200023535069,-336166.77,60ec41ba55c00300382672d9,HDFC,Transfer in/Revenue-other,5eecc6d6449e4f7cfb1c2708,2023-01-14T00:00:00.000Z,INT. ON SWCR ON-50300720580141,,,Other,7
64142acbf8804aea72170ad4,50200023535069,-331210.77,60ec41ba55c00300382672d9,HDFC,Loan-in,5eecc6d6449e4f7cfb1c2708,2023-01-14T00:00:00.000Z,SWEEP-IN CREDIT - 50300720580141,,,self_transfer,4956
64142acbf8804aea72170ad6,50200023535069,-331065.77,60ec41ba55c00300382672d9,HDFC,Transfer in/Revenue-other,5eecc6d6449e4f7cfb1c2708,2023-01-14T00:00:00.000Z,INT. ON SWCR ON-50300720580141,,,Other,145
64142acbf8804aea72170ad8,50200023535069,-233065.77,60ec41ba55c00300382672d9,HDFC,Loan-in,5eecc6d6449e4f7cfb1c2708,2023-01-14T00:00:00.000Z,SWEEP-IN CREDIT - 50300720580141,,,self_transfer,98000
64142acbf8804aea72170ada,50200023535069,-232769.77,60ec41ba55c00300382672d9,HDFC,Transfer in/Revenue-other,5eecc6d6449e4f7cfb1c2708,2023-01-14T00:00:00.000Z,INT. ON SWCR ON-50300720580141,,,Other,296
64142acbf8804aea72170adc,50200023535069,-32769.77,60ec41ba55c00300382672d9,HDFC,Loan-in,5eecc6d6449e4f7cfb1c2708,2023-01-14T00:00:00.000Z,SWEEP-IN CREDIT - 50300720580141,,,self_transfer,200000
64142acbf8804aea72170ade,50200023535069,-32750.77,60ec41ba55c00300382672d9,HDFC,Transfer in/Revenue-other,5eecc6d6449e4f7cfb1c2708,2023-01-14T00:00:00.000Z,INT. ON SWCR ON-50300720580141,,,Other,19
64142acbf8804aea72170ae0,50200023535069,-20080.77,60ec41ba55c00300382672d9,HDFC,Loan-in,5eecc6d6449e4f7cfb1c2708,2023-01-14T00:00:00.000Z,SWEEP-IN CREDIT - 50300720580141,,,self_transfer,12670
64142acbf8804aea72170ae2,50200023535069,-20050.77,60ec41ba55c00300382672d9,HDFC,Transfer in/Revenue-other,5eecc6d6449e4f7cfb1c2708,2023-01-14T00:00:00.000Z,INT. ON SWCR ON-50300720580141,,,Other,30
64142acbf8804aea72170ae4,50200023535069,30.23,60ec41ba55c00300382672d9,HDFC,Loan-in,5eecc6d6449e4f7cfb1c2708,2023-01-14T00:00:00.000Z,SWEEP-IN CREDIT - 50300720580141,,,self_transfer,20081
64142acbf8804aea72170ae6,50200023535069,-26969.77,60ec41ba55c00300382672d9,HDFC,direct expenses,5eecc6d6449e4f7cfb1c2708,2023-01-14T00:00:00.000Z,NEFT DR-ICIC0003431-WAVICLE TECHNOLOGIES PVT LTD-SANDOZ - MUM-N014232291163438-N ET BANKING SI -27000,,,net_banking_transfer,-27000
64142acbf8804aea72170ae8,50200023535069,-31356.77,60ec41ba55c00300382672d9,HDFC,direct expenses,5eecc6d6449e4f7cfb1c2708,2023-01-14T00:00:00.000Z,NEFT DR-ICIC0003431-WAVICLE TECHNOLOGIES PVT LTD-SANDOZ - MUM-N014232291163439-N ET BANKING SI -4387,,,net_banking_transfer,-4387
64142acbf8804aea72170aea,50200023535069,-36312.77,60ec41ba55c00300382672d9,HDFC,Marketing Expense,5eecc6d6449e4f7cfb1c2708,2023-01-14T00:00:00.000Z,ME DC SI 514834XXXXXX9486 FACEBOOK INDIA ONLINE,,,Other,-4956
64142acbf8804aea72170aec,50200023535069,-36663.77,60ec41ba55c00300382672d9,HDFC,direct expenses,5eecc6d6449e4f7cfb1c2708,2023-01-14T00:00:00.000Z,POS 514834XXXXXX9486 PAYTM_ADDMONEYTO,ewallet,,debit_card,-351
64142acbf8804aea72170aee,50200023535069,-33031.32,60ec41ba55c00300382672d9,HDFC,Transfer in/Revenue-other,5eecc6d6449e4f7cfb1c2708,2023-01-14T00:00:00.000Z,IMPS-301419642708-EXCRO PAY ESCROW ACC-Y ESB-XXXXXXXXXXX1807-333112298023,,,net_banking_transfer,3632.45
64142acbf8804aea72170af0,50200023535069,-30524.48,60ec41ba55c00300382672d9,HDFC,Transfer in/Revenue-other,5eecc6d6449e4f7cfb1c2708,2023-01-14T00:00:00.000Z,IMPS-301420715154-EXCRO PAY ESCROW ACC-Y ESB-XXXXXXXXXXX1807-333112298023,,,net_banking_transfer,2506.84
64142acbf8804aea72170af2,50200023535069,-155146.48,60ec41ba55c00300382672d9,HDFC,Salary/Emp/consultant Expense,5eecc6d6449e4f7cfb1c2708,2023-01-14T00:00:00.000Z,2014253379/EPFO,,,Other,-124622
64142acbf8804aea72170af4,50200023535069,-163436.48,60ec41ba55c00300382672d9,HDFC,direct expenses,5eecc6d6449e4f7cfb1c2708,2023-01-14T00:00:00.000Z,02023101292602/ESIC,,,Other,-8290
64142acbf8804aea72170af6,50200023535069,-163428.48,60ec41ba55c00300382672d9,HDFC,Transfer in/Revenue-other,5eecc6d6449e4f7cfb1c2708,2023-01-15T00:00:00.000Z,INT. ON SWCR ON-50300720580141,,,Other,8
64142acbf8804aea72170af8,50200023535069,-158472.48,60ec41ba55c00300382672d9,HDFC,Loan-in,5eecc6d6449e4f7cfb1c2708,2023-01-15T00:00:00.000Z,SWEEP-IN CREDIT - 50300720580141,,,self_transfer,4956
64142acbf8804aea72170afa,50200023535069,-158424.48,60ec41ba55c00300382672d9,HDFC,Transfer in/Revenue-other,5eecc6d6449e4f7cfb1c2708,2023-01-15T00:00:00.000Z,INT. ON SWCR ON-50300720580141,,,Other,48
64142acbf8804aea72170afc,50200023535069,-127067.48,60ec41ba55c00300382672d9,HDFC,Loan-in,5eecc6d6449e4f7cfb1c2708,2023-01-15T00:00:00.000Z,SWEEP-IN CREDIT - 50300720580141,,,self_transfer,31357
64142acbf8804aea72170afe,50200023535069,-127066.48,60ec41ba55c00300382672d9,HDFC,Transfer in/Revenue-other,5eecc6d6449e4f7cfb1c2708,2023-01-15T00:00:00.000Z,INT. ON SWCR ON-50300720580141,,,Other,1
64142acbf8804aea72170b00,50200023535069,-126715.48,60ec41ba55c00300382672d9,HDFC,Loan-in,5eecc6d6449e4f7cfb1c2708,2023-01-15T00:00:00.000Z,SWEEP-IN CREDIT - 50300720580141,,,self_transfer,351
64142acbf8804aea72170b02,50200023535069,-126533.48,60ec41ba55c00300382672d9,HDFC,Transfer in/Revenue-other,5eecc6d6449e4f7cfb1c2708,2023-01-15T00:00:00.000Z,INT. ON SWCR ON-50300720580141,,,Other,182
64142acbf8804aea72170b04,50200023535069,-8050.48,60ec41ba55c00300382672d9,HDFC,Loan-in,5eecc6d6449e4f7cfb1c2708,2023-01-15T00:00:00.000Z,SWEEP-IN CREDIT - 50300720580141,,,self_transfer,118483
64142acbf8804aea72170b06,50200023535069,-8038.48,60ec41ba55c00300382672d9,HDFC,Transfer in/Revenue-other,5eecc6d6449e4f7cfb1c2708,2023-01-15T00:00:00.000Z,INT. ON SWCR ON-50300720580141,,,Other,12
64142acbf8804aea72170b08,50200023535069,12.52,60ec41ba55c00300382672d9,HDFC,Loan-in,5eecc6d6449e4f7cfb1c2708,2023-01-15T00:00:00.000Z,SWEEP-IN CREDIT - 50300720580141,,,self_transfer,8051
64142acbf8804aea72170b0a,50200023535069,7516.25,60ec41ba55c00300382672d9,HDFC,Transfer in/Revenue-other,5eecc6d6449e4f7cfb1c2708,2023-01-15T00:00:00.000Z,IMPS-301508755778-EXCRO PAY ESCROW ACC-Y,,,net_banking_transfer,7503.73
64142acbf8804aea72170b0c,50200023535069,15065.16,60ec41ba55c00300382672d9,HDFC,Transfer in/Revenue-other,5eecc6d6449e4f7cfb1c2708,2023-01-16T00:00:00.000Z,IMPS-301607802309-EXCRO PAY ESCROW ACC-Y ESB-XXXXXXXXXXX1807-333112298023,,,net_banking_transfer,7548.91
64142acbf8804aea72170b0e,50200023535069,10109.16,60ec41ba55c00300382672d9,HDFC,Marketing Expense,5eecc6d6449e4f7cfb1c2708,2023-01-16T00:00:00.000Z,ME DC SI 514834XXXXXX9486 FACEBOOK INDIA ONLINE,,,Other,-4956
64142acbf8804aea72170b10,50200023535069,18482.78,60ec41ba55c00300382672d9,HDFC,Transfer in/Revenue-other,5eecc6d6449e4f7cfb1c2708,2023-01-16T00:00:00.000Z,IMPS-301609846798-EXCRO PAY ESCROW ACC-Y ESB-XXXXXXXXXXX1807-333112298023,,,net_banking_transfer,8373.62
64142acbf8804aea72170b12,50200023535069,30332.82,60ec41ba55c00300382672d9,HDFC,Revenue-Mktplace,5eecc6d6449e4f7cfb1c2708,2023-01-16T00:00:00.000Z,NEFT CR-DEUT0797BGL-MYNTRA DESIGNS PRIVA TE LIMITED-SLICK ORGANICS - SJIT-3016008 33GN00229,shopping,,net_banking_transfer,11850.04
64142acbf8804aea72170b14,50200023535069,31187.77,60ec41ba55c00300382672d9,HDFC,Revenue-Mktplace,5eecc6d6449e4f7cfb1c2708,2023-01-16T00:00:00.000Z,NEFT CR-DEUT0797BGL-MYNTRA DESIGNS PRIVA TE LIMITED-SLICK ORGANICS PVT. LTD.-3016 00843GN00045,shopping,,net_banking_transfer,854.95
64142acbf8804aea72170b16,50200023535069,55227.72,60ec41ba55c00300382672d9,HDFC,Revenue-PG-split enabled,5eecc6d6449e4f7cfb1c2708,2023-01-16T00:00:00.000Z,NEFT CR-UTIB0001506-RAZORPAY SOFTWARE PR IVATE LIMITED-SLICK ORGANICS PVT LITD-AX ISCN0198652473,,,net_banking_transfer,24039.95
64142acbf8804aea72170b18,50200023535069,54727.72,60ec41ba55c00300382672d9,HDFC,direct expenses,5eecc6d6449e4f7cfb1c2708,2023-01-16T00:00:00.000Z,POS 514834XXXXXX9486 WEFAST,,,debit_card,-500
64142acbf8804aea72170b1a,50200023535069,51344.72,60ec41ba55c00300382672d9,HDFC,direct expenses,5eecc6d6449e4f7cfb1c2708,2023-01-16T00:00:00.000Z,POS 514834XXXXXX9486 PTM*PAYTM WALLET,ewallet,,debit_card,-3383
64142acbf8804aea72170b1c,50200023535069,51262.72,60ec41ba55c00300382672d9,HDFC,direct expenses,5eecc6d6449e4f7cfb1c2708,2023-01-16T00:00:00.000Z,POS 514834XXXXXX9486 PTM*PAYTM WALLET,ewallet,,debit_card,-82
64142acbf8804aea72170b1e,50200023535069,60735.68,60ec41ba55c00300382672d9,HDFC,Transfer in/Revenue-other,5eecc6d6449e4f7cfb1c2708,2023-01-16T00:00:00.000Z,NEFT CR-SCBL0036001-HEALTH GLOW PRIVATE LIMITED-SLICK ORGANICS PVT LTD-ARATA-IN 1ON23011601ONE,,,net_banking_transfer,9472.96
64142acbf8804aea72170b20,50200023535069,68100.2,60ec41ba55c00300382672d9,HDFC,Transfer in/Revenue-other,5eecc6d6449e4f7cfb1c2708,2023-01-16T00:00:00.000Z,NEFT CR-SCBL0036001-HEALTH GLOW PRIVATE LIMITED-SLICK ORGANICS PVT LTD-ARATA-IN 1ON23011601OP9,,,net_banking_transfer,7364.52
64142acbf8804aea72170b22,50200023535069,112554.85,60ec41ba55c00300382672d9,HDFC,Transfer in/Revenue-other,5eecc6d6449e4f7cfb1c2708,2023-01-16T00:00:00.000Z,NEFT CR-YESB0000001-EASEBUZZ PVT LTD NOD AL A/C-SLICK ORGANICS PVT LTD-YESB301699 98583,,,net_banking_transfer,44454.65
64142acbf8804aea72170b24,50200023535069,121873.85,60ec41ba55c00300382672d9,HDFC,Revenue-Mktplace,5eecc6d6449e4f7cfb1c2708,2023-01-16T00:00:00.000Z,NEFT CR-ICIC0000105-MANASH LIFESTYLE PRI VATE LIMITED NO-SLICK ORGANICS PRIVATE L IMITED-ICIJ230160007278,shopping,,net_banking_transfer,9319
64142acbf8804aea72170b26,50200023535069,169216.13,60ec41ba55c00300382672d9,HDFC,Revenue-COD,5eecc6d6449e4f7cfb1c2708,2023-01-16T00:00:00.000Z,NEFT CR-ICIC0000155-SHIPROCKET COD CRF I,,,net_banking_transfer,47342.28
64142acbf8804aea72170b28,50200023535069,172464.33,60ec41ba55c00300382672d9,HDFC,Revenue-PG-split enabled,5eecc6d6449e4f7cfb1c2708,2023-01-16T00:00:00.000Z,NEFT CR-UTIB0001506-RAZORPAY SOFTWARE PR IVATE LIMITED-SLICK ORGANICS PVT LITD-AX ISCN0198934661,,,net_banking_transfer,3248.2
64142acbf8804aea72170b2a,50200023535069,201338.48,60ec41ba55c00300382672d9,HDFC,Transfer in/Revenue-other,5eecc6d6449e4f7cfb1c2708,2023-01-16T00:00:00.000Z,NEFT CR-YESB0000001-EASEBUZZ PVT LTD NOD AL A/C-SLICK ORGANICS PVT LTD-YESB301601 42070,,,net_banking_transfer,28874.15
64142acbf8804aea72170b2c,50200023535069,261399.83,60ec41ba55c00300382672d9,HDFC,Revenue-COD,5eecc6d6449e4f7cfb1c2708,2023-01-16T00:00:00.000Z,NEFT CR-ICIC0000155-SHIPROCKET COD CRF I D 5543727-SLICK ORGANICS PVT LTD-CMS3070 306103,,,net_banking_transfer,60061.35
64142acbf8804aea72170b2e,50200023535069,256443.83,60ec41ba55c00300382672d9,HDFC,Marketing Expense,5eecc6d6449e4f7cfb1c2708,2023-01-16T00:00:00.000Z,ME DC SI 514834XXXXXX9486 FACEBOOK INDIA ONLINE,,,Other,-4956
64142acbf8804aea72170b30,50200023535069,251487.83,60ec41ba55c00300382672d9,HDFC,Marketing Expense,5eecc6d6449e4f7cfb1c2708,2023-01-17T00:00:00.000Z,ME DC SI 514834XXXXXX9486 FACEBOOK INDIA ONLINE,,,Other,-4956
64142acbf8804aea72170b33,50200023535069,256839.95,60ec41ba55c00300382672d9,HDFC,Transfer in/Revenue-other,5eecc6d6449e4f7cfb1c2708,2023-01-17T00:00:00.000Z,IMPS-301706798319-EXCRO PAY ESCROW ACC-Y ESB-XXXXXXXXXXX1807-333112298023,,,net_banking_transfer,5352.12
64142acbf8804aea72170b35,50200023535069,260192.6,60ec41ba55c00300382672d9,HDFC,Revenue-PG-split enabled,5eecc6d6449e4f7cfb1c2708,2023-01-17T00:00:00.000Z,NEFT CR-UTIB0001506-RAZORPAY SOFTWARE PR IVATE LIMITED-SLICK ORGANICS PVT LITD-AX ISCN0199086962,,,net_banking_transfer,3352.65
64142acbf8804aea72170b37,50200023535069,260190.6,60ec41ba55c00300382672d9,HDFC,Marketing Expense,5eecc6d6449e4f7cfb1c2708,2023-01-17T00:00:00.000Z,ME DC SI 514834XXXXXX9486 LINKEDIN,,,Other,-2
64142acbf8804aea72170b39,50200023535069,273266.53,60ec41ba55c00300382672d9,HDFC,Transfer in/Revenue-other,5eecc6d6449e4f7cfb1c2708,2023-01-17T00:00:00.000Z,NEFT CR-YESB0000001-EASEBUZZ PVT LTD NOD AL A/C-SLICK ORGANICS PVT LTD-YESB301728 94890,,,net_banking_transfer,13075.93
64142acbf8804aea72170b3b,50200023535069,-76733.47,60ec41ba55c00300382672d9,HDFC,direct expenses,5eecc6d6449e4f7cfb1c2708,2023-01-17T00:00:00.000Z,"NEFT DR-KKBK0000180-VEDIC COSMECEUTICALS PVT LTD-NETBANK, MUM-N017232293916276-3 50000",,,net_banking_transfer,-350000
64142acbf8804aea72170b3d,50200023535069,-25727.47,60ec41ba55c00300382672d9,HDFC,Revenue-Mktplace,5eecc6d6449e4f7cfb1c2708,2023-01-17T00:00:00.000Z,NEFT CR-SCBL0036001-DREAMPLUG TECHNOLOGI ES PRIVATE LIMITED-SLICK ORGANICS PRIVAT E LIMITEDSLICK-IN1ON23011701GXI,,,net_banking_transfer,51006
64142acbf8804aea72170b3f,50200023535069,-28509.47,60ec41ba55c00300382672d9,HDFC,direct expenses,5eecc6d6449e4f7cfb1c2708,2023-01-17T00:00:00.000Z,POS 514834XXXXXX9486 PTM*PAYTM WALLET,ewallet,,debit_card,-2782
64142acbf8804aea72170b41,50200023535069,-28715.47,60ec41ba55c00300382672d9,HDFC,direct expenses,5eecc6d6449e4f7cfb1c2708,2023-01-17T00:00:00.000Z,POS 514834XXXXXX9486 PTM*PAYTM WALLET,ewallet,,debit_card,-206
64142acbf8804aea72170b43,50200023535069,-1211.47,60ec41ba55c00300382672d9,HDFC,Transfer in/Revenue-other,5eecc6d6449e4f7cfb1c2708,2023-01-17T00:00:00.000Z,FT- REMITTANCE OG DEC 22-50200050675669 - HOUZ OF NATURE PVT LTD -,,,Other,27504
64142acbf8804aea72170b45,50200023535069,-131.47,60ec41ba55c00300382672d9,HDFC,Revenue-Mktplace,5eecc6d6449e4f7cfb1c2708,2023-01-17T00:00:00.000Z,NEFT CR-ICIC0000105-MANASH LIFETYLE PVT LTD-SLICK ORGANICS PRIVATE LIMITED-ICIB2 30170032026,,,net_banking_transfer,1080
64142accf8804aea72170b47,50200023535069,1453.36,60ec41ba55c00300382672d9,HDFC,Transfer in/Revenue-other,5eecc6d6449e4f7cfb1c2708,2023-01-17T00:00:00.000Z,NEFT CR-UTIB0000114-ONE SIGMA TECHNOLOGI ES PRIVATE LIM-SLICK ORGANICS PRIVATE LI MITED-AXISP00355561140,bnpl,,net_banking_transfer,1584.83
64142accf8804aea72170b49,50200023535069,6715.75,60ec41ba55c00300382672d9,HDFC,Transfer in/Revenue-other,5eecc6d6449e4f7cfb1c2708,2023-01-17T00:00:00.000Z,NEFT CR-UTIB0000114-ONE SIGMA TECHNOLOGI ES PRIVATE LIM-SLICK ORGANICS PRIVATE LI MITED-AXISP00355560676,bnpl,,net_banking_transfer,5262.39
64142accf8804aea72170b4b,50200023535069,8153.42,60ec41ba55c00300382672d9,HDFC,Transfer in/Revenue-other,5eecc6d6449e4f7cfb1c2708,2023-01-17T00:00:00.000Z,NEFT CR-UTIB0000114-ONE SIGMA TECHNOLOGI ES PRIVATE LIM-SLICK ORGANICS PRIVATE LI MITED-AXISP00355560419,bnpl,,net_banking_transfer,1437.67
64142accf8804aea72170b4d,50200023535069,15435.07,60ec41ba55c00300382672d9,HDFC,Transfer in/Revenue-other,5eecc6d6449e4f7cfb1c2708,2023-01-17T00:00:00.000Z,NEFT CR-UTIB0000114-ONE SIGMA TECHNOLOGI ES PRIVATE LIM-SLICK ORGANICS PRIVATE LI MITED-AXISP00355560662,bnpl,,net_banking_transfer,7281.65
64142accf8804aea72170b4f,50200023535069,269293.88,60ec41ba55c00300382672d9,HDFC,Transfer in/Revenue-other,5eecc6d6449e4f7cfb1c2708,2023-01-17T00:00:00.000Z,NEFT CR-IDFB0010204-PCPL CENTRAL DISBURS EMENT AC-SLICK ORGANICS PRIVATE LIMITED- IDFBH23017621524,,,net_banking_transfer,253858.81
64142accf8804aea72170b51,50200023535069,294258.91,60ec41ba55c00300382672d9,HDFC,Transfer in/Revenue-other,5eecc6d6449e4f7cfb1c2708,2023-01-17T00:00:00.000Z,NEFT CR-YESB0000001-EASEBUZZ PVT LTD NOD AL A/C-SLICK ORGANICS PVT LTD-YESB301730 65502,,,net_banking_transfer,24965.03
64142accf8804aea72170b53,50200023535069,297908.82,60ec41ba55c00300382672d9,HDFC,Revenue-PG-split enabled,5eecc6d6449e4f7cfb1c2708,2023-01-17T00:00:00.000Z,NEFT CR-UTIB0001506-RAZORPAY SOFTWARE PR IVATE LIMITED-SLICK ORGANICS PVT LITD-AX ISCN0199349234,,,net_banking_transfer,3649.91
64142accf8804aea72170b55,50200023535069,47908.82,60ec41ba55c00300382672d9,HDFC,direct expenses,5eecc6d6449e4f7cfb1c2708,2023-01-17T00:00:00.000Z,"NEFT DR-ICIC0000369-BO INTERNATIONAL-NET BANK, MUM-N017232294421748-250000",,,net_banking_transfer,-250000
64142accf8804aea72170b57,50200023535069,47909.82,60ec41ba55c00300382672d9,HDFC,Transfer in/Revenue-other,5eecc6d6449e4f7cfb1c2708,2023-01-17T00:00:00.000Z,CRV POS 514834******9486 SHOPIFY LTD,,,refund,1
64142accf8804aea72170b59,50200023535069,42953.82,60ec41ba55c00300382672d9,HDFC,Marketing Expense,5eecc6d6449e4f7cfb1c2708,2023-01-18T00:00:00.000Z,ME DC SI 514834XXXXXX9486 FACEBOOK INDIA ONLINE,,,Other,-4956
64142accf8804aea72170b5b,50200023535069,17953.82,60ec41ba55c00300382672d9,HDFC,direct expenses,5eecc6d6449e4f7cfb1c2708,2023-01-18T00:00:00.000Z,NEFT DR-YESB0000236-DELIGHT VACATION PVT,,,net_banking_transfer,-25000
64142accf8804aea72170b5d,50200023535069,21689.19,60ec41ba55c00300382672d9,HDFC,Transfer in/Revenue-other,5eecc6d6449e4f7cfb1c2708,2023-01-18T00:00:00.000Z,IMPS-301807735645-EXCRO PAY ESCROW ACC-Y ESB-XXXXXXXXXXX1807-333112298023,,,net_banking_transfer,3735.37
64142accf8804aea72170b5f,50200023535069,26155.64,60ec41ba55c00300382672d9,HDFC,Transfer in/Revenue-other,5eecc6d6449e4f7cfb1c2708,2023-01-18T00:00:00.000Z,IMPS-301808753172-EXCRO PAY ESCROW ACC-Y ESB-XXXXXXXXXXX1807-333112298023,,,net_banking_transfer,4466.45
64142accf8804aea72170b61,50200023535069,32721.4,60ec41ba55c00300382672d9,HDFC,Revenue-Mktplace,5eecc6d6449e4f7cfb1c2708,2023-01-18T00:00:00.000Z,NEFT CR-DEUT0797BGL-MYNTRA DESIGNS PRIVA TE LIMITED-SLICK ORGANICS - SJIT-3018008 19GN00170,shopping,,net_banking_transfer,6565.76
64142accf8804aea72170b63,50200023535069,33406.72,60ec41ba55c00300382672d9,HDFC,Revenue-Mktplace,5eecc6d6449e4f7cfb1c2708,2023-01-18T00:00:00.000Z,NEFT CR-DEUT0797BGL-MYNTRA DESIGNS PRIVA TE LIMITED-SLICK ORGANICS PVT. LTD.-3018 00830GN00262,shopping,,net_banking_transfer,685.32
64142accf8804aea72170b65,50200023535069,35444.94,60ec41ba55c00300382672d9,HDFC,Revenue-PG-split enabled,5eecc6d6449e4f7cfb1c2708,2023-01-18T00:00:00.000Z,NEFT CR-UTIB0001506-RAZORPAY SOFTWARE PR IVATE LIMITED-SLICK ORGANICS PVT LITD-AX ISCN0199508276,,,net_banking_transfer,2038.22
64142accf8804aea72170b67,50200023535069,-64555.06,60ec41ba55c00300382672d9,HDFC,direct expenses,5eecc6d6449e4f7cfb1c2708,2023-01-18T00:00:00.000Z,"NEFT DR-YESB0000551-VISTTA COSMETICS-NET BANK, MUM-N018232294829101-100000",,,net_banking_transfer,-100000
64142accf8804aea72170b69,50200023535069,-54841.06,60ec41ba55c00300382672d9,HDFC,Transfer in/Revenue-other,5eecc6d6449e4f7cfb1c2708,2023-01-18T00:00:00.000Z,NEFT CR-HSBC0110002-NAPSA PRIVATE LIMITE D-SLICK ORGANICS PVT. LTD.-HSBCN23018242 182,,,net_banking_transfer,9714
64142accf8804aea72170b6b,50200023535069,-47627.06,60ec41ba55c00300382672d9,HDFC,Transfer in/Revenue-other,5eecc6d6449e4f7cfb1c2708,2023-01-18T00:00:00.000Z,NEFT CR-UTIB0000114-ONE SIGMA TECHNOLOGI ES PRIVATE LIM-SLICK ORGANICS PRIVATE LI MITED-AXISP00355731870,bnpl,,net_banking_transfer,7214
64142accf8804aea72170b6d,50200023535069,-26011.34,60ec41ba55c00300382672d9,HDFC,Revenue-Mktplace,5eecc6d6449e4f7cfb1c2708,2023-01-18T00:00:00.000Z,NEFT CR-HSBC0400002-AMAZON SERVICES LLC- SLICK ORGANICS PRIVATE LIMITED-HSBCN2301 8254790,shopping,,net_banking_transfer,21615.72
64142accf8804aea72170b71,50200023535069,-226011.34,60ec41ba55c00300382672d9,HDFC,Marketing Expense,5eecc6d6449e4f7cfb1c2708,2023-01-18T00:00:00.000Z,"NEFT DR-CITI0000006-FACEBOOK INDIA ONLIN E SERVICES PVT LTD-NETBANK, MUM-N0182322 95317575-200000",,,net_banking_transfer,-200000
64142accf8804aea72170b73,50200023535069,-225345.75,60ec41ba55c00300382672d9,HDFC,Revenue-PG-split enabled,5eecc6d6449e4f7cfb1c2708,2023-01-18T00:00:00.000Z,NEFT CR-UTIB0001506-RAZORPAY SOFTWARE PR,,,net_banking_transfer,665.59
64142accf8804aea72170b75,50200023535069,-192139.12,60ec41ba55c00300382672d9,HDFC,Transfer in/Revenue-other,5eecc6d6449e4f7cfb1c2708,2023-01-18T00:00:00.000Z,NEFT CR-YESB0000001-EASEBUZZ PVT LTD NOD AL A/C-SLICK ORGANICS PVT LTD-YESB301865 38515,,,net_banking_transfer,33206.63
64142accf8804aea72170b77,50200023535069,593541.81,60ec41ba55c00300382672d9,HDFC,Revenue-Mktplace,5eecc6d6449e4f7cfb1c2708,2023-01-18T00:00:00.000Z,NEFT CR-HSBC0560002-MYNTRA JABONG INDIA PRIVATE LIMITED-SLICK ORGANICS PRIVATE L IMITED-HSBCN23018309406,shopping,,net_banking_transfer,785680.93
64142accf8804aea72170b79,50200023535069,596531.74,60ec41ba55c00300382672d9,HDFC,Revenue-COD,5eecc6d6449e4f7cfb1c2708,2023-01-18T00:00:00.000Z,NEFT CR-ICIC0000155-SHIPROCKET COD CRF I D 5564101-SLICK ORGANICS PVT LTD-CMS3073 630399,,,net_banking_transfer,2989.93
64142accf8804aea72170b7b,50200023535069,591575.74,60ec41ba55c00300382672d9,HDFC,Marketing Expense,5eecc6d6449e4f7cfb1c2708,2023-01-19T00:00:00.000Z,ME DC SI 514834XXXXXX9486 FACEBOOK INDIA ONLINE,,,Other,-4956
64142accf8804aea72170b7d,50200023535069,592883.31,60ec41ba55c00300382672d9,HDFC,Transfer in/Revenue-other,5eecc6d6449e4f7cfb1c2708,2023-01-19T00:00:00.000Z,IMPS-301904794767-EXCRO PAY ESCROW ACC-Y ESB-XXXXXXXXXXX1807-333112298023,,,net_banking_transfer,1307.57
64142accf8804aea72170b7f,50200023535069,593958.22,60ec41ba55c00300382672d9,HDFC,Revenue-PG-split enabled,5eecc6d6449e4f7cfb1c2708,2023-01-19T00:00:00.000Z,NEFT CR-UTIB0001506-RAZORPAY SOFTWARE PR IVATE LIMITED-SLICK ORGANICS PVT LITD-AX ISCN0199831533,,,net_banking_transfer,1074.91
64142accf8804aea72170b81,50200023535069,593959.22,60ec41ba55c00300382672d9,HDFC,Transfer in/Revenue-other,5eecc6d6449e4f7cfb1c2708,2023-01-19T00:00:00.000Z,IMPS-301928037142-APIBANKING-RATN-XXXXXX XXXXXX0168-ACCOUNTVALIDATION,,,net_banking_transfer,1
64142accf8804aea72170b83,50200023535069,595849.6,60ec41ba55c00300382672d9,HDFC,Transfer in/Revenue-other,5eecc6d6449e4f7cfb1c2708,2023-01-19T00:00:00.000Z,NEFT CR-UTIB0000114-ONE SIGMA TECHNOLOGI ES PRIVATE LIM-SLICK ORGANICS PRIVATE LI MITED-AXISP00355945827,bnpl,,net_banking_transfer,1890.38
64142accf8804aea72170b85,50200023535069,594669.6,60ec41ba55c00300382672d9,HDFC,Marketing Expense,5eecc6d6449e4f7cfb1c2708,2023-01-19T00:00:00.000Z,ME DC SI 514834XXXXXX9486 LINKEDIN (PGSI ),,,Other,-1180
64142accf8804aea72170b87,50200023535069,304206.38,60ec41ba55c00300382672d9,HDFC,direct expenses,5eecc6d6449e4f7cfb1c2708,2023-01-19T00:00:00.000Z,POS 514834XXXXXX9486 E-COMMERCE RP,,,debit_card,-290463.22
64142accf8804aea72170b89,50200023535069,207006.38,60ec41ba55c00300382672d9,HDFC,direct expenses,5eecc6d6449e4f7cfb1c2708,2023-01-19T00:00:00.000Z,00321000085687-TPT-97200-SAMEER AHUJA,,,net_banking_transfer,-97200
64142accf8804aea72170b8b,50200023535069,158406.38,60ec41ba55c00300382672d9,HDFC,direct expenses,5eecc6d6449e4f7cfb1c2708,2023-01-19T00:00:00.000Z,00918630000430-TPT-48600-UNICOMMERCE ESO LUTIONS PRIVATE LIMITED,,,net_banking_transfer,-48600
64142accf8804aea72170b8d,50200023535069,58406.38,60ec41ba55c00300382672d9,HDFC,Marketing Expense,5eecc6d6449e4f7cfb1c2708,2023-01-19T00:00:00.000Z,"NEFT DR-CITI0000006-FACEBOOK INDIA ONLIN E SERVICES PVT LTD-NETBANK, MUM-N0192322 96520173-100000",,,net_banking_transfer,-100000
64142accf8804aea72170b8f,50200023535069,43736.38,60ec41ba55c00300382672d9,HDFC,direct expenses,5eecc6d6449e4f7cfb1c2708,2023-01-19T00:00:00.000Z,NEFT DR-KKBK0000173-NITISH KUMAR MANDAL-,,,net_banking_transfer,-14670
64142accf8804aea72170b91,50200023535069,-8063.62,60ec41ba55c00300382672d9,HDFC,direct expenses,5eecc6d6449e4f7cfb1c2708,2023-01-19T00:00:00.000Z,"NEFT DR-INDB0000275-LASH TECHNOLOGIES PR IVATE LIMITED-NETBANK, MUM-N019232296576 206-51800",,,net_banking_transfer,-51800
64142accf8804aea72170b93,50200023535069,-6972.1,60ec41ba55c00300382672d9,HDFC,Transfer in/Revenue-other,5eecc6d6449e4f7cfb1c2708,2023-01-19T00:00:00.000Z,NEFT CR-YESB0000001-EASEBUZZ PVT LTD NOD AL A/C-SLICK ORGANICS PVT LTD-YESB301995 84813,,,net_banking_transfer,1091.52
64142accf8804aea72170b95,50200023535069,-5783.33,60ec41ba55c00300382672d9,HDFC,Revenue-PG-split enabled,5eecc6d6449e4f7cfb1c2708,2023-01-19T00:00:00.000Z,NEFT CR-UTIB0001506-RAZORPAY SOFTWARE PR IVATE LIMITED-SLICK ORGANICS PVT LITD-AX ISCN0200071528,,,net_banking_transfer,1188.77
64142accf8804aea72170b97,50200023535069,65614.35,60ec41ba55c00300382672d9,HDFC,Transfer in/Revenue-other,5eecc6d6449e4f7cfb1c2708,2023-01-19T00:00:00.000Z,NEFT CR-YESB0000001-EASEBUZZ PVT LTD NOD AL A/C-SLICK ORGANICS PVT LTD-YESB301996 11396,,,net_banking_transfer,71397.68
64142accf8804aea72170b99,50200023535069,71188.35,60ec41ba55c00300382672d9,HDFC,Revenue-Mktplace,5eecc6d6449e4f7cfb1c2708,2023-01-19T00:00:00.000Z,NEFT CR-ICIC0000105-MANASH LIFESTYLE PRI VATE LIMITED NO-SLICK ORGANICS PRIVATE L IMITED-ICIJ230190008789,shopping,,net_banking_transfer,5574
64142accf8804aea72170b9b,50200023535069,465629.37,60ec41ba55c00300382672d9,HDFC,Revenue-Mktplace,5eecc6d6449e4f7cfb1c2708,2023-01-19T00:00:00.000Z,NEFT CR-HSBC0560002-MYNTRA JABONG INDIA PRIVATE LIMITED-SLICK ORGANICS PRIVATE L IMITED-HSBCN23019523510,shopping,,net_banking_transfer,394441.02
64142accf8804aea72170b9e,50200023535069,460673.37,60ec41ba55c00300382672d9,HDFC,Marketing Expense,5eecc6d6449e4f7cfb1c2708,2023-01-20T00:00:00.000Z,ME DC SI 514834XXXXXX9486 FACEBOOK INDIA ONLINE,,,Other,-4956
64142accf8804aea72170ba0,50200023535069,462088.07,60ec41ba55c00300382672d9,HDFC,Transfer in/Revenue-other,5eecc6d6449e4f7cfb1c2708,2023-01-20T00:00:00.000Z,IMPS-302004848647-EXCRO PAY ESCROW ACC-Y ESB-XXXXXXXXXXX1807-333112298023,,,net_banking_transfer,1414.7
64142accf8804aea72170ba2,50200023535069,466039.51,60ec41ba55c00300382672d9,HDFC,Transfer in/Revenue-other,5eecc6d6449e4f7cfb1c2708,2023-01-20T00:00:00.000Z,IMPS-302007913232-EXCRO PAY ESCROW ACC-Y ESB-XXXXXXXXXXX1807-333112298023,,,net_banking_transfer,3951.44
64142accf8804aea72170ba4,50200023535069,476576.5,60ec41ba55c00300382672d9,HDFC,Revenue-Mktplace,5eecc6d6449e4f7cfb1c2708,2023-01-20T00:00:00.000Z,NEFT CR-DEUT0797BGL-MYNTRA DESIGNS PRIVA TE LIMITED-SLICK ORGANICS - SJIT-3020007 96GN00048,shopping,,net_banking_transfer,10536.99
64142accf8804aea72170ba6,50200023535069,476653.09,60ec41ba55c00300382672d9,HDFC,Revenue-Mktplace,5eecc6d6449e4f7cfb1c2708,2023-01-20T00:00:00.000Z,NEFT CR-DEUT0797BGL-MYNTRA DESIGNS PRIVA TE LIMITED-SLICK ORGANICS PVT. LTD.-3020 00811GN00228,shopping,,net_banking_transfer,76.59
64142accf8804aea72170ba8,50200023535069,479675.17,60ec41ba55c00300382672d9,HDFC,Revenue-PG-split enabled,5eecc6d6449e4f7cfb1c2708,2023-01-20T00:00:00.000Z,NEFT CR-UTIB0001506-RAZORPAY SOFTWARE PR,,,net_banking_transfer,3022.08
64142accf8804aea72170baa,50200023535069,263675.17,60ec41ba55c00300382672d9,HDFC,direct expenses,5eecc6d6449e4f7cfb1c2708,2023-01-20T00:00:00.000Z,50200063961124-TPT-216000-BEYOND ADS,,,net_banking_transfer,-216000
64142accf8804aea72170bac,50200023535069,231275.17,60ec41ba55c00300382672d9,HDFC,direct expenses,5eecc6d6449e4f7cfb1c2708,2023-01-20T00:00:00.000Z,50200016295776-TPT-32400-V KESHRI AND AS SOCIATES,,,net_banking_transfer,-32400
64142accf8804aea72170bae,50200023535069,244238.41,60ec41ba55c00300382672d9,HDFC,Revenue-PG-non-split,5eecc6d6449e4f7cfb1c2708,2023-01-20T00:00:00.000Z,NEFT CR-SCBL0036001-STRIPE INDIA PRIVATE LIMITED-SLICK ORGANICS PRIVATE LIMITED- IN1ON23012000P5B,,,net_banking_transfer,12963.24
64142accf8804aea72170bb0,50200023535069,251297.05,60ec41ba55c00300382672d9,HDFC,Transfer in/Revenue-other,5eecc6d6449e4f7cfb1c2708,2023-01-20T00:00:00.000Z,NEFT CR-UTIB0000114-ONE SIGMA TECHNOLOGI ES PRIVATE LIM-SLICK ORGANICS PRIVATE LI MITED-AXISP00356144961,bnpl,,net_banking_transfer,7058.64
64142accf8804aea72170bb2,50200023535069,250997.05,60ec41ba55c00300382672d9,HDFC,direct expenses,5eecc6d6449e4f7cfb1c2708,2023-01-20T00:00:00.000Z,POS 514834XXXXXX9486 PAYTM_ADDMONEYTO,ewallet,,debit_card,-300
64142accf8804aea72170bb4,50200023535069,246803.05,60ec41ba55c00300382672d9,HDFC,Tax,5eecc6d6449e4f7cfb1c2708,2023-01-20T00:00:00.000Z,GST/BANK REFERENCE NO: R2302040861131/CI N NO: HDFC23010700276604,tax,gst,Other,-4194
64142accf8804aea72170bb6,50200023535069,249146.05,60ec41ba55c00300382672d9,HDFC,Revenue-Mktplace,5eecc6d6449e4f7cfb1c2708,2023-01-20T00:00:00.000Z,NEFT CR-ICIC0000105-MANASH LIFETYLE PVT LTD-SLICK ORGANICS PRIVATE LIMITED-ICIB2 30200026999,,,net_banking_transfer,2343
64142accf8804aea72170bb8,50200023535069,256807.57,60ec41ba55c00300382672d9,HDFC,Revenue-Mktplace,5eecc6d6449e4f7cfb1c2708,2023-01-20T00:00:00.000Z,NEFT CR-HSBC0400002-AMAZON PAYMENTS UK L IMITED ACCS-SLICK ORGANICS PRIVATE LIMIT ED-HSBCN23020589543,shopping,,net_banking_transfer,7661.52
64142accf8804aea72170bba,50200023535069,263075.99,60ec41ba55c00300382672d9,HDFC,Revenue-COD,5eecc6d6449e4f7cfb1c2708,2023-01-20T00:00:00.000Z,NEFT CR-ICIC0000155-SHIPROCKET COD CRF I D 5576379-SLICK ORGANICS PVT LTD-CMS3077 403896,,,net_banking_transfer,6268.42
64142accf8804aea72170bbc,50200023535069,336603.36,60ec41ba55c00300382672d9,HDFC,Transfer in/Revenue-other,5eecc6d6449e4f7cfb1c2708,2023-01-20T00:00:00.000Z,NEFT CR-YESB0000001-EASEBUZZ PVT LTD NOD AL A/C-SLICK ORGANICS PVT LTD-YESB302028 14881,,,net_banking_transfer,73527.37
64142acdf8804aea72170bbe,50200023535069,337849.76,60ec41ba55c00300382672d9,HDFC,Revenue-PG-split enabled,5eecc6d6449e4f7cfb1c2708,2023-01-20T00:00:00.000Z,NEFT CR-UTIB0001506-RAZORPAY SOFTWARE PR IVATE LIMITED-SLICK ORGANICS PVT LITD-AX ISCN0200452011,,,net_banking_transfer,1246.4
64142acdf8804aea72170bc0,50200023535069,336794.76,60ec41ba55c00300382672d9,HDFC,direct expenses,5eecc6d6449e4f7cfb1c2708,2023-01-20T00:00:00.000Z,POS 514834XXXXXX9486 PTM*PAYTM WALLET,ewallet,,debit_card,-1055
64142acdf8804aea72170bc2,50200023535069,336796.76,60ec41ba55c00300382672d9,HDFC,Transfer in/Revenue-other,5eecc6d6449e4f7cfb1c2708,2023-01-20T00:00:00.000Z,CRV POS 514834******9486 LINKEDIN,,,refund,2
64142acdf8804aea72170bc4,50200023535069,338485.98,60ec41ba55c00300382672d9,HDFC,Transfer in/Revenue-other,5eecc6d6449e4f7cfb1c2708,2023-01-21T00:00:00.000Z,IMPS-302105728316-EXCRO PAY ESCROW ACC-Y,,,net_banking_transfer,1689.22
64142acdf8804aea72170bc6,50200023535069,338795.03,60ec41ba55c00300382672d9,HDFC,Revenue-PG-split enabled,5eecc6d6449e4f7cfb1c2708,2023-01-21T00:00:00.000Z,NEFT CR-UTIB0001506-RAZORPAY SOFTWARE PR IVATE LIMITED-SLICK ORGANICS PVT LITD-AX ISCN0200581690,,,net_banking_transfer,309.05
64142acdf8804aea72170bc8,50200023535069,339510.7,60ec41ba55c00300382672d9,HDFC,Revenue-PG-split enabled,5eecc6d6449e4f7cfb1c2708,2023-01-21T00:00:00.000Z,NEFT CR-UTIB0001506-RAZORPAY SOFTWARE PR IVATE LIMITED-SLICK ORGANICS PVT LITD-AX ISCN0200757274,,,net_banking_transfer,715.67
64142acdf8804aea72170bca,50200023535069,393736.89,60ec41ba55c00300382672d9,HDFC,Transfer in/Revenue-other,5eecc6d6449e4f7cfb1c2708,2023-01-21T00:00:00.000Z,NEFT CR-YESB0000001-EASEBUZZ PVT LTD NOD AL A/C-SLICK ORGANICS PVT LTD-YESB302159 35894,,,net_banking_transfer,54226.19
64142acdf8804aea72170bcc,50200023535069,388780.89,60ec41ba55c00300382672d9,HDFC,Marketing Expense,5eecc6d6449e4f7cfb1c2708,2023-01-22T00:00:00.000Z,ME DC SI 514834XXXXXX9486 FACEBOOK SI,,,Other,-4956
64142acdf8804aea72170bce,50200023535069,390493.31,60ec41ba55c00300382672d9,HDFC,Transfer in/Revenue-other,5eecc6d6449e4f7cfb1c2708,2023-01-22T00:00:00.000Z,IMPS-302203680315-EXCRO PAY ESCROW ACC-Y ESB-XXXXXXXXXXX1807-333112298023,,,net_banking_transfer,1712.42
64142acdf8804aea72170bd0,50200023535069,390393.41,60ec41ba55c00300382672d9,HDFC,direct expenses,5eecc6d6449e4f7cfb1c2708,2023-01-22T00:00:00.000Z,POS 514834XXXXXX9486 PAYTM_AIRTELRECH,bills,,debit_card,-99.9
64142acdf8804aea72170bd2,50200023535069,370393.41,60ec41ba55c00300382672d9,HDFC,direct expenses,5eecc6d6449e4f7cfb1c2708,2023-01-23T00:00:00.000Z,NEFT DR-ICIC0002451-SOUTH COURT CONDOMIN IUM ASSOCIATION-SANDOZ - MUM-N0232322997 12238-NET BANKING SI -20000,,,net_banking_transfer,-20000
64142acdf8804aea72170bd4,50200023535069,372331.13,60ec41ba55c00300382672d9,HDFC,Transfer in/Revenue-other,5eecc6d6449e4f7cfb1c2708,2023-01-23T00:00:00.000Z,IMPS-302304724668-EXCRO PAY ESCROW ACC-Y ESB-XXXXXXXXXXX1807-333112298023,,,net_banking_transfer,1937.72
64142acdf8804aea72170bd6,50200023535069,378491.18,60ec41ba55c00300382672d9,HDFC,Transfer in/Revenue-other,5eecc6d6449e4f7cfb1c2708,2023-01-23T00:00:00.000Z,IMPS-302307786469-EXCRO PAY ESCROW ACC-Y ESB-XXXXXXXXXXX1807-333112298023,,,net_banking_transfer,6160.05
64142acdf8804aea72170bd8,50200023535069,391646.21,60ec41ba55c00300382672d9,HDFC,Revenue-Mktplace,5eecc6d6449e4f7cfb1c2708,2023-01-23T00:00:00.000Z,NEFT CR-DEUT0797BGL-MYNTRA DESIGNS PRIVA TE LIMITED-SLICK ORGANICS - SJIT-3023008 24GN00128,shopping,,net_banking_transfer,13155.03
64142acdf8804aea72170bdb,50200023535069,393327.21,60ec41ba55c00300382672d9,HDFC,Revenue-Mktplace,5eecc6d6449e4f7cfb1c2708,2023-01-23T00:00:00.000Z,NEFT CR-DEUT0797BGL-MYNTRA DESIGNS PRIVA TE LIMITED-SLICK ORGANICS PVT. LTD.-3023 00842GN00072,shopping,,net_banking_transfer,1681
64142acdf8804aea72170bdd,50200023535069,397906.39,60ec41ba55c00300382672d9,HDFC,Revenue-PG-split enabled,5eecc6d6449e4f7cfb1c2708,2023-01-23T00:00:00.000Z,NEFT CR-UTIB0001506-RAZORPAY SOFTWARE PR IVATE LIMITED-SLICK ORGANICS PVT LITD-AX ISCN0201013379,,,net_banking_transfer,4579.18
64142acdf8804aea72170bdf,50200023535069,392950.39,60ec41ba55c00300382672d9,HDFC,Marketing Expense,5eecc6d6449e4f7cfb1c2708,2023-01-23T00:00:00.000Z,ME DC SI 514834XXXXXX9486 FACEBOOK SI,,,Other,-4956
64142acdf8804aea72170be1,50200023535069,398839.63,60ec41ba55c00300382672d9,HDFC,Transfer in/Revenue-other,5eecc6d6449e4f7cfb1c2708,2023-01-23T00:00:00.000Z,NEFT CR-UTIB0000114-ONE SIGMA TECHNOLOGI ES PRIVATE LIM-SLICK ORGANICS PRIVATE LI MITED-AXISP00356588693,bnpl,,net_banking_transfer,5889.24
64142acdf8804aea72170be3,50200023535069,407779.78,60ec41ba55c00300382672d9,HDFC,Transfer in/Revenue-other,5eecc6d6449e4f7cfb1c2708,2023-01-23T00:00:00.000Z,NEFT CR-UTIB0000114-ONE SIGMA TECHNOLOGI ES PRIVATE LIM-SLICK ORGANICS PRIVATE LI MITED-AXISP00356588621,bnpl,,net_banking_transfer,8940.15
64142acdf8804aea72170be5,50200023535069,412373.66,60ec41ba55c00300382672d9,HDFC,Transfer in/Revenue-other,5eecc6d6449e4f7cfb1c2708,2023-01-23T00:00:00.000Z,NEFT CR-UTIB0000114-ONE SIGMA TECHNOLOGI ES PRIVATE LIM-SLICK ORGANICS PRIVATE LI MITED-AXISP00356588630,bnpl,,net_banking_transfer,4593.88
64142acdf8804aea72170be7,50200023535069,418050.66,60ec41ba55c00300382672d9,HDFC,Revenue-Mktplace,5eecc6d6449e4f7cfb1c2708,2023-01-23T00:00:00.000Z,NEFT CR-ICIC0000105-MANASH LIFETYLE PVT LTD-SLICK ORGANICS PRIVATE LIMITED-ICIB2 30230013280,,,net_banking_transfer,5677
64142acdf8804aea72170be9,50200023535069,442366.66,60ec41ba55c00300382672d9,HDFC,Transfer in/Revenue-other,5eecc6d6449e4f7cfb1c2708,2023-01-23T00:00:00.000Z,NEFT CR-HSBC0560002-INNOVATIVE RETAIL CO NCEPTS PRIVATE-SLICK ORGANICS PVT LTD-HS BCN23023889205,,,net_banking_transfer,24316
64142acdf8804aea72170bec,50200023535069,441365.66,60ec41ba55c00300382672d9,HDFC,direct expenses,5eecc6d6449e4f7cfb1c2708,2023-01-23T00:00:00.000Z,POS 514834XXXXXX9486 PTM*PAYTM WALLET,ewallet,,debit_card,-1001
64142acdf8804aea72170bee,50200023535069,441267.66,60ec41ba55c00300382672d9,HDFC,direct expenses,5eecc6d6449e4f7cfb1c2708,2023-01-23T00:00:00.000Z,POS 514834XXXXXX9486 PTM*PAYTM WALLET,ewallet,,debit_card,-98
64142acdf8804aea72170bf0,50200023535069,487184.74,60ec41ba55c00300382672d9,HDFC,Transfer in/Revenue-other,5eecc6d6449e4f7cfb1c2708,2023-01-23T00:00:00.000Z,NEFT CR-YESB0000001-EASEBUZZ PVT LTD NOD AL A/C-SLICK ORGANICS PVT LTD-YESB302315 99484,,,net_banking_transfer,45917.08
64142acdf8804aea72170bf2,50200023535069,489173.97,60ec41ba55c00300382672d9,HDFC,Revenue-PG-split enabled,5eecc6d6449e4f7cfb1c2708,2023-01-23T00:00:00.000Z,NEFT CR-UTIB0001506-RAZORPAY SOFTWARE PR IVATE LIMITED-SLICK ORGANICS PVT LITD-AX ISCN0201246000,,,net_banking_transfer,1989.23
64142acdf8804aea72170bf4,50200023535069,531087.5,60ec41ba55c00300382672d9,HDFC,Revenue-COD,5eecc6d6449e4f7cfb1c2708,2023-01-23T00:00:00.000Z,NEFT CR-ICIC0000155-SHIPROCKET COD CRF I D 5584679-SLICK ORGANICS PVT LTD-CMS3081 553055,,,net_banking_transfer,41913.53
64142acdf8804aea72170bf6,50200023535069,616688.04,60ec41ba55c00300382672d9,HDFC,Transfer in/Revenue-other,5eecc6d6449e4f7cfb1c2708,2023-01-23T00:00:00.000Z,NEFT CR-YESB0000001-EASEBUZZ PVT LTD NOD AL A/C-SLICK ORGANICS PVT LTD-YESB302317 33963,,,net_banking_transfer,85600.54
64142acdf8804aea72170bf8,50200023535069,616839.04,60ec41ba55c00300382672d9,HDFC,Transfer in/Revenue-other,5eecc6d6449e4f7cfb1c2708,2023-01-23T00:00:00.000Z,NEFT CR-SCBL0036001-AXELIA SOLUTIONS PRI,,,net_banking_transfer,151
64142acdf8804aea72170bfa,50200023535069,216839.04,60ec41ba55c00300382672d9,HDFC,Marketing Expense,5eecc6d6449e4f7cfb1c2708,2023-01-24T00:00:00.000Z,NEFT DR-CITI0000006-FACEBOOK INDIA ONLIN E SERVICES PVT LTD-SANDOZ - MUM-N0242323 01037145-NET BANKING SI -400000,,,net_banking_transfer,-400000
64142acdf8804aea72170bfd,50200023535069,-33160.96,60ec41ba55c00300382672d9,HDFC,direct expenses,5eecc6d6449e4f7cfb1c2708,2023-01-24T00:00:00.000Z,NEFT DR-ICIC0000369-BO INTERNATIONAL-SAN DOZ - MUM-N024232301037146-NET BANKING S I -250000,,,net_banking_transfer,-250000
64142acdf8804aea72170bff,50200023535069,-31657.29,60ec41ba55c00300382672d9,HDFC,Transfer in/Revenue-other,5eecc6d6449e4f7cfb1c2708,2023-01-24T00:00:00.000Z,IMPS-302407980057-EXCRO PAY ESCROW ACC-Y ESB-XXXXXXXXXXX1807-333112298023,,,net_banking_transfer,1503.67
64142acdf8804aea72170c01,50200023535069,-281657.29,60ec41ba55c00300382672d9,HDFC,direct expenses,5eecc6d6449e4f7cfb1c2708,2023-01-24T00:00:00.000Z,05892560000649-TPT-250000-DECORPAC INDIA PRIVATE LIMITED,,,net_banking_transfer,-250000
64142acdf8804aea72170c03,50200023535069,-280286.23,60ec41ba55c00300382672d9,HDFC,Revenue-PG-split enabled,5eecc6d6449e4f7cfb1c2708,2023-01-24T00:00:00.000Z,NEFT CR-UTIB0001506-RAZORPAY SOFTWARE PR IVATE LIMITED-SLICK ORGANICS PVT LITD-AX ISCN0201383075,,,net_banking_transfer,1371.06
64142acdf8804aea72170c05,50200023535069,275413.5,60ec41ba55c00300382672d9,HDFC,Transfer in/Revenue-other,5eecc6d6449e4f7cfb1c2708,2023-01-24T00:00:00.000Z,RTGS CR-IDFB0010204-PCPL CENTRAL DISBURS EMENT AC-SLICK ORGANICS PRIVATE LIMITED- IDFBR52023012400392403,,,net_banking_transfer,555699.73
64142acdf8804aea72170c07,50200023535069,280660.5,60ec41ba55c00300382672d9,HDFC,Revenue-Mktplace,5eecc6d6449e4f7cfb1c2708,2023-01-24T00:00:00.000Z,NEFT CR-ICIC0000105-MANASH LIFETYLE PVT LTD-SLICK ORGANICS PRIVATE LIMITED-ICIB2 30240011660,,,net_banking_transfer,5247
64142acdf8804aea72170c09,50200023535069,64660.5,60ec41ba55c00300382672d9,HDFC,direct expenses,5eecc6d6449e4f7cfb1c2708,2023-01-24T00:00:00.000Z,57500001065314-TPT-216000-KRAUTER HEALTH CARE LTD,,,net_banking_transfer,-216000
64142acdf8804aea72170c0b,50200023535069,14660.5,60ec41ba55c00300382672d9,HDFC,direct expenses,5eecc6d6449e4f7cfb1c2708,2023-01-24T00:00:00.000Z,"NEFT DR-BKID0007124-MATRIX PRINTING SOLU TIONS PVT LTD-NETBANK, MUM-N024232301764 827-50000",,,net_banking_transfer,-50000
64142acdf8804aea72170c0d,50200023535069,-85339.5,60ec41ba55c00300382672d9,HDFC,direct expenses,5eecc6d6449e4f7cfb1c2708,2023-01-24T00:00:00.000Z,"NEFT DR-YESB0000551-VISTTA COSMETICS-NET BANK, MUM-N024232301753872-100000",,,net_banking_transfer,-100000
64142acdf8804aea72170c0f,50200023535069,-80623.54,60ec41ba55c00300382672d9,HDFC,Transfer in/Revenue-other,5eecc6d6449e4f7cfb1c2708,2023-01-24T00:00:00.000Z,NEFT CR-UTIB0000114-ONE SIGMA TECHNOLOGI ES PRIVATE LIM-SLICK ORGANICS PRIVATE LI MITED-AXISP00356867254,bnpl,,net_banking_transfer,4715.96
64142acdf8804aea72170c11,50200023535069,-79083.29,60ec41ba55c00300382672d9,HDFC,Revenue-PG-split enabled,5eecc6d6449e4f7cfb1c2708,2023-01-24T00:00:00.000Z,NEFT CR-UTIB0001506-RAZORPAY SOFTWARE PR,,,net_banking_transfer,1540.25
64142acdf8804aea72170c13,50200023535069,-7154.16,60ec41ba55c00300382672d9,HDFC,Transfer in/Revenue-other,5eecc6d6449e4f7cfb1c2708,2023-01-24T00:00:00.000Z,NEFT CR-YESB0000001-EASEBUZZ PVT LTD NOD AL A/C-SLICK ORGANICS PVT LTD-YESB302450 21302,,,net_banking_transfer,71929.13
64142acdf8804aea72170c15,50200023535069,558955.95,60ec41ba55c00300382672d9,HDFC,Revenue-Mktplace,5eecc6d6449e4f7cfb1c2708,2023-01-24T00:00:00.000Z,NEFT CR-HSBC0560002-MYNTRA JABONG INDIA PRIVATE LIMITED-SLICK ORGANICS PRIVATE L IMITED-HSBCN23024131349,shopping,,net_banking_transfer,566110.11
64142acdf8804aea72170c17,50200023535069,565748.9,60ec41ba55c00300382672d9,HDFC,Transfer in/Revenue-other,5eecc6d6449e4f7cfb1c2708,2023-01-25T00:00:00.000Z,IMPS-302507819933-EXCRO PAY ESCROW ACC-Y ESB-XXXXXXXXXXX1807-333112298023,,,net_banking_transfer,6792.95
64142acdf8804aea72170c19,50200023535069,566651.5,60ec41ba55c00300382672d9,HDFC,Revenue-PG-split enabled,5eecc6d6449e4f7cfb1c2708,2023-01-25T00:00:00.000Z,NEFT CR-UTIB0001506-RAZORPAY SOFTWARE PR IVATE LIMITED-SLICK ORGANICS PVT LITD-AX ISCN0201895748,,,net_banking_transfer,902.6
64142acdf8804aea72170c1b,50200023535069,551651.5,60ec41ba55c00300382672d9,HDFC,direct expenses,5eecc6d6449e4f7cfb1c2708,2023-01-25T00:00:00.000Z,50100110669502-TPT-15000-VRITI MALHOTRA,,,net_banking_transfer,-15000
64142acdf8804aea72170c1d,50200023535069,538651.5,60ec41ba55c00300382672d9,HDFC,direct expenses,5eecc6d6449e4f7cfb1c2708,2023-01-25T00:00:00.000Z,"NEFT DR-KKBK0003543-MUHAMMED BILAL QURES HI-NETBANK, MUM-N025232302560423-13000",,,net_banking_transfer,-13000
64142acdf8804aea72170c1f,50200023535069,526651.5,60ec41ba55c00300382672d9,HDFC,direct expenses,5eecc6d6449e4f7cfb1c2708,2023-01-25T00:00:00.000Z,"NEFT DR-KARB0000113-ASHWINI N DIXIT-NETB ANK, MUM-N025232302562677-12000",,,net_banking_transfer,-12000
64142acdf8804aea72170c21,50200023535069,516651.5,60ec41ba55c00300382672d9,HDFC,direct expenses,5eecc6d6449e4f7cfb1c2708,2023-01-25T00:00:00.000Z,"NEFT DR-UTIB0001719-VANDANA SEHGAL-NETBA NK, MUM-N025232302558855-10000",,,net_banking_transfer,-10000
64142acdf8804aea72170c23,50200023535069,518801.12,60ec41ba55c00300382672d9,HDFC,Transfer in/Revenue-other,5eecc6d6449e4f7cfb1c2708,2023-01-25T00:00:00.000Z,NEFT CR-YESB0000001-EXCRO PAY ESCROW ACC OUNT-SLICKORGANICSPRIVATELIMITED-YESB302 57967804,,,net_banking_transfer,2149.62
64142acdf8804aea72170c25,50200023535069,500801.12,60ec41ba55c00300382672d9,HDFC,direct expenses,5eecc6d6449e4f7cfb1c2708,2023-01-25T00:00:00.000Z,01322000013526-TPT-18000-CLASSIC RACKS,,,net_banking_transfer,-18000
64142acdf8804aea72170c27,50200023535069,501944.65,60ec41ba55c00300382672d9,HDFC,Revenue-Mktplace,5eecc6d6449e4f7cfb1c2708,2023-01-25T00:00:00.000Z,NEFT CR-DEUT0797BGL-MYNTRA DESIGNS PRIVA TE LIMITED-SLICK ORGANICS PVT. LTD.-3025 00816GN00284,shopping,,net_banking_transfer,1143.53
64142acdf8804aea72170c29,50200023535069,512822.42,60ec41ba55c00300382672d9,HDFC,Revenue-Mktplace,5eecc6d6449e4f7cfb1c2708,2023-01-25T00:00:00.000Z,NEFT CR-DEUT0797BGL-MYNTRA DESIGNS PRIVA TE LIMITED-SLICK ORGANICS - SJIT-3025008 66GN00100,shopping,,net_banking_transfer,10877.77
64142acdf8804aea72170c2b,50200023535069,562428.42,60ec41ba55c00300382672d9,HDFC,Revenue-Mktplace,5eecc6d6449e4f7cfb1c2708,2023-01-25T00:00:00.000Z,NEFT CR-SCBL0036001-DREAMPLUG TECHNOLOGI ES PRIVATE LIMITED-SLICK ORGANICS PRIVAT E LIMITEDSLICK-IN1ON23012501OP9,,,net_banking_transfer,49606
64142acdf8804aea72170c2d,50200023535069,534698.42,60ec41ba55c00300382672d9,HDFC,direct expenses,5eecc6d6449e4f7cfb1c2708,2023-01-25T00:00:00.000Z,50200043297657-TPT-27730-AIDC PRODUCTS I,,,net_banking_transfer,-27730
64142acdf8804aea72170c2f,50200023535069,538507.26,60ec41ba55c00300382672d9,HDFC,Revenue-PG-non-split,5eecc6d6449e4f7cfb1c2708,2023-01-25T00:00:00.000Z,NEFT CR-SCBL0036001-STRIPE INDIA PRIVATE LIMITED-SLICK ORGANICS PRIVATE LIMITED- IN1ON23012501T03,,,net_banking_transfer,3808.84
64142acdf8804aea72170c31,50200023535069,540068.68,60ec41ba55c00300382672d9,HDFC,Transfer in/Revenue-other,5eecc6d6449e4f7cfb1c2708,2023-01-25T00:00:00.000Z,NEFT CR-UTIB0000114-ONE SIGMA TECHNOLOGI ES PRIVATE LIM-SLICK ORGANICS PRIVATE LI MITED-AXISP00357184245,bnpl,,net_banking_transfer,1561.42
64142acdf8804aea72170c33,50200023535069,539067.68,60ec41ba55c00300382672d9,HDFC,direct expenses,5eecc6d6449e4f7cfb1c2708,2023-01-25T00:00:00.000Z,POS 514834XXXXXX9486 PAYTM_ADDMONEYTO,ewallet,,debit_card,-1001
64142acef8804aea72170c36,50200023535069,539290.68,60ec41ba55c00300382672d9,HDFC,Revenue-Mktplace,5eecc6d6449e4f7cfb1c2708,2023-01-25T00:00:00.000Z,NEFT CR-ICIC0000985-DIGITAL AGE RETAIL P VT LTD-SLICK ORGANICS PVT LTD-CMS3084391 539,,,net_banking_transfer,223
64142acef8804aea72170c38,50200023535069,537992.68,60ec41ba55c00300382672d9,HDFC,direct expenses,5eecc6d6449e4f7cfb1c2708,2023-01-25T00:00:00.000Z,POS 514834XXXXXX9486 RAJDARBAR REALTY,,,debit_card,-1298
64142acef8804aea72170c3a,50200023535069,544942.68,60ec41ba55c00300382672d9,HDFC,Revenue-Mktplace,5eecc6d6449e4f7cfb1c2708,2023-01-25T00:00:00.000Z,NEFT CR-ICIC0000105-MANASH LIFETYLE PVT LTD-SLICK ORGANICS PRIVATE LIMITED-ICIB2 30250023563,,,net_banking_transfer,6950
64142acef8804aea72170c3c,50200023535069,627603.77,60ec41ba55c00300382672d9,HDFC,Transfer in/Revenue-other,5eecc6d6449e4f7cfb1c2708,2023-01-25T00:00:00.000Z,NEFT CR-YESB0000001-EASEBUZZ PVT LTD NOD AL A/C-SLICK ORGANICS PVT LTD-YESB302583 52185,,,net_banking_transfer,82661.09
64142acef8804aea72170c3e,50200023535069,628553.06,60ec41ba55c00300382672d9,HDFC,Revenue-PG-split enabled,5eecc6d6449e4f7cfb1c2708,2023-01-25T00:00:00.000Z,NEFT CR-UTIB0001506-RAZORPAY SOFTWARE PR IVATE LIMITED-SLICK ORGANICS PVT LITD-AX ISCN0202116776,,,net_banking_transfer,949.29
64142acef8804aea72170c40,50200023535069,709657.42,60ec41ba55c00300382672d9,HDFC,Revenue-Mktplace,5eecc6d6449e4f7cfb1c2708,2023-01-25T00:00:00.000Z,NEFT CR-HSBC0560002-MYNTRA JABONG INDIA PRIVATE LIMITED-SLICK ORGANICS PRIVATE L IMITED-HSBCN23025332669,shopping,,net_banking_transfer,81104.36
64142acef8804aea72170c42,50200023535069,709577.42,60ec41ba55c00300382672d9,HDFC,SAAS/tech expense,5eecc6d6449e4f7cfb1c2708,2023-01-25T00:00:00.000Z,POS 514834XXXXXX9486 MICROSOFT*STORE,,,debit_card,-80
64142acef8804aea72170c44,50200023535069,709657.42,60ec41ba55c00300382672d9,HDFC,Transfer in/Revenue-other,5eecc6d6449e4f7cfb1c2708,2023-01-25T00:00:00.000Z,POS 514834XXXXXX9486 MICROSOFT*STORE,,,debit_card,80
64142acef8804aea72170c46,50200023535069,709508.42,60ec41ba55c00300382672d9,HDFC,SAAS/tech expense,5eecc6d6449e4f7cfb1c2708,2023-01-25T00:00:00.000Z,POS 514834XXXXXX9486 MICROSOFTBUS,,,debit_card,-149
64142acef8804aea72170c48,50200023535069,708491.92,60ec41ba55c00300382672d9,HDFC,Marketing Expense,5eecc6d6449e4f7cfb1c2708,2023-01-26T00:00:00.000Z,ME DC SI 514834XXXXXX9486 FACEBOOK SI,,,Other,-1016.5
64142acef8804aea72170c4a,50200023535069,711929.76,60ec41ba55c00300382672d9,HDFC,Transfer in/Revenue-other,5eecc6d6449e4f7cfb1c2708,2023-01-26T00:00:00.000Z,IMPS BEN- 302604710699-26/01/2023,,,net_banking_transfer,3437.84
64142acef8804aea72170c4c,50200023535069,711607.62,60ec41ba55c00300382672d9,HDFC,Marketing Expense,5eecc6d6449e4f7cfb1c2708,2023-01-26T00:00:00.000Z,ME DC SI 514834XXXXXX9486 FACEBOOK SI,,,Other,-322.14
64142acef8804aea72170c4f,50200023535069,691607.62,60ec41ba55c00300382672d9,HDFC,direct expenses,5eecc6d6449e4f7cfb1c2708,2023-01-27T00:00:00.000Z,NEFT DR-ICIC0002451-SOUTH COURT CONDOMIN IUM ASSOCIATION-SANDOZ - MUM-N0272323041 60211-NET BANKING SI -20000,,,net_banking_transfer,-20000
64142acef8804aea72170c51,50200023535069,693876.62,60ec41ba55c00300382672d9,HDFC,Transfer in/Revenue-other,5eecc6d6449e4f7cfb1c2708,2023-01-27T00:00:00.000Z,IMPS-302705911821-EXCRO PAY ESCROW ACC-Y ESB-XXXXXXXXXXX1807-333112298023,,,net_banking_transfer,2269
64142acef8804aea72170c53,50200023535069,699952.6,60ec41ba55c00300382672d9,HDFC,Transfer in/Revenue-other,5eecc6d6449e4f7cfb1c2708,2023-01-27T00:00:00.000Z,NEFT CR-YESB0000001-EXCRO PAY ESCROW ACC OUNT-SLICKORGANICSPRIVATELIMITED-YESB302 73054770,,,net_banking_transfer,6075.98
64142acef8804aea72170c55,50200023535069,704475.28,60ec41ba55c00300382672d9,HDFC,Revenue-PG-split enabled,5eecc6d6449e4f7cfb1c2708,2023-01-27T00:00:00.000Z,NEFT CR-UTIB0001506-RAZORPAY SOFTWARE PR IVATE LIMITED-SLICK ORGANICS PVT LITD-AX ISCN0202423446,,,net_banking_transfer,4522.68
64142acef8804aea72170c57,50200023535069,704734.85,60ec41ba55c00300382672d9,HDFC,Revenue-Mktplace,5eecc6d6449e4f7cfb1c2708,2023-01-27T00:00:00.000Z,NEFT CR-DEUT0797BGL-MYNTRA DESIGNS PRIVA TE LIMITED-SLICK ORGANICS PVT. LTD.-3027 00949GN00223,shopping,,net_banking_transfer,259.57
64142acef8804aea72170c59,50200023535069,713812.68,60ec41ba55c00300382672d9,HDFC,Revenue-Mktplace,5eecc6d6449e4f7cfb1c2708,2023-01-27T00:00:00.000Z,NEFT CR-DEUT0797BGL-MYNTRA DESIGNS PRIVA TE LIMITED-SLICK ORGANICS - SJIT-3027009 70GN00237,shopping,,net_banking_transfer,9077.83
64142acef8804aea72170c5b,50200023535069,712042.68,60ec41ba55c00300382672d9,HDFC,Marketing Expense,5eecc6d6449e4f7cfb1c2708,2023-01-27T00:00:00.000Z,ME DC SI 514834XXXXXX9486 LINKEDIN (PGSI ),,,Other,-1770
64142acef8804aea72170c5d,50200023535069,718222.68,60ec41ba55c00300382672d9,HDFC,Revenue-Mktplace,5eecc6d6449e4f7cfb1c2708,2023-01-27T00:00:00.000Z,NEFT CR-ICIC0000105-MANASH LIFETYLE PVT LTD-SLICK ORGANICS PRIVATE LIMITED-ICIB2 30270002454,,,net_banking_transfer,6180
64142acef8804aea72170c5f,50200023535069,717940.68,60ec41ba55c00300382672d9,HDFC,direct expenses,5eecc6d6449e4f7cfb1c2708,2023-01-27T00:00:00.000Z,POS 514834XXXXXX9486 PTM*PAYTM WALLET,ewallet,,debit_card,-282
64142acef8804aea72170c61,50200023535069,725406.81,60ec41ba55c00300382672d9,HDFC,Transfer in/Revenue-other,5eecc6d6449e4f7cfb1c2708,2023-01-27T00:00:00.000Z,NEFT CR-HSBC0400002-SOUQ.COM FZ LLC UAE ACCS-SLICK ORGANICS PRIVATE LIMITED-HSBC N23027508356,,,net_banking_transfer,7466.13
64142acef8804aea72170c63,50200023535069,724178.74,60ec41ba55c00300382672d9,HDFC,Marketing Expense,5eecc6d6449e4f7cfb1c2708,2023-01-27T00:00:00.000Z,ME DC SI 514834XXXXXX9486 LINKEDIN (PGSI ),,,Other,-1228.07
64142acef8804aea72170c65,50200023535069,727033.25,60ec41ba55c00300382672d9,HDFC,Transfer in/Revenue-other,5eecc6d6449e4f7cfb1c2708,2023-01-27T00:00:00.000Z,NEFT CR-UTIB0000114-ONE SIGMA TECHNOLOGI ES PRIVATE LIM-SLICK ORGANICS PRIVATE LI MITED-AXISP00357563408,bnpl,,net_banking_transfer,2854.51
64142acef8804aea72170c67,50200023535069,727979.2,60ec41ba55c00300382672d9,HDFC,Transfer in/Revenue-other,5eecc6d6449e4f7cfb1c2708,2023-01-27T00:00:00.000Z,NEFT CR-UTIB0000114-ONE SIGMA TECHNOLOGI,bnpl,,net_banking_transfer,945.95
64142acef8804aea72170c69,50200023535069,827979.2,60ec41ba55c00300382672d9,HDFC,Transfer in/Revenue-other,5eecc6d6449e4f7cfb1c2708,2023-01-27T00:00:00.000Z,NEFT CR-IDFB0010204-GETVANTAGE TECH PRIV ATE LIMITED-SLICK ORGANICS PRIVATE LIMIT ED-IDFBH23027934670,,,net_banking_transfer,100000
64142acef8804aea72170c6b,50200023535069,827996.39,60ec41ba55c00300382672d9,HDFC,Transfer in/Revenue-other,5eecc6d6449e4f7cfb1c2708,2023-01-27T00:00:00.000Z,NEFT CR-ICIC0099999-AXELIA SOLUTIONS PRI VATE LIMITED-SLICK ORGANICS PVT LTD-CMS3 087633563,,,net_banking_transfer,17.19
64142acef8804aea72170c6d,50200023535069,828772.07,60ec41ba55c00300382672d9,HDFC,Revenue-PG-split enabled,5eecc6d6449e4f7cfb1c2708,2023-01-27T00:00:00.000Z,NEFT CR-UTIB0001506-RAZORPAY SOFTWARE PR IVATE LIMITED-SLICK ORGANICS PVT LITD-AX ISCN0202637134,,,net_banking_transfer,775.68
64142acef8804aea72170c6f,50200023535069,828319.03,60ec41ba55c00300382672d9,HDFC,Marketing Expense,5eecc6d6449e4f7cfb1c2708,2023-01-27T00:00:00.000Z,ME DC SI 514834XXXXXX9486 FACEBOOK SI,,,Other,-453.04
64142acef8804aea72170c71,50200023535069,973486.27,60ec41ba55c00300382672d9,HDFC,Transfer in/Revenue-other,5eecc6d6449e4f7cfb1c2708,2023-01-27T00:00:00.000Z,NEFT CR-YESB0000001-EASEBUZZ PVT LTD NOD AL A/C-SLICK ORGANICS PVT LTD-YESB302742 30643,,,net_banking_transfer,145167.24
64142acef8804aea72170c73,50200023535069,992684.05,60ec41ba55c00300382672d9,HDFC,Revenue-COD,5eecc6d6449e4f7cfb1c2708,2023-01-27T00:00:00.000Z,NEFT CR-ICIC0000155-SHIPROCKET COD CRF I D 5617357-SLICK ORGANICS PVT LTD-CMS3087 137186,,,net_banking_transfer,19197.78
64142acef8804aea72170c75,50200023535069,995696.68,60ec41ba55c00300382672d9,HDFC,Transfer in/Revenue-other,5eecc6d6449e4f7cfb1c2708,2023-01-28T00:00:00.000Z,NEFT CR-YESB0000001-EXCRO PAY ESCROW ACC OUNT-SLICKORGANICSPRIVATELIMITED-YESB302 87161657,,,net_banking_transfer,3012.63
64142acef8804aea72170c77,50200023535069,995624.68,60ec41ba55c00300382672d9,HDFC,direct expenses,5eecc6d6449e4f7cfb1c2708,2023-01-28T00:00:00.000Z,POS 514834XXXXXX9486 PTM*PAYTM WALLET,ewallet,,debit_card,-72
64142acef8804aea72170c7a,50200023535069,995320.68,60ec41ba55c00300382672d9,HDFC,direct expenses,5eecc6d6449e4f7cfb1c2708,2023-01-28T00:00:00.000Z,POS 514834XXXXXX9486 PTM*PAYTM WALLET,ewallet,,debit_card,-304
64142acef8804aea72170c7c,50200023535069,923104.68,60ec41ba55c00300382672d9,HDFC,direct expenses,5eecc6d6449e4f7cfb1c2708,2023-01-28T00:00:00.000Z,"NEFT DR-ICIC0006643-KRISHNA PACKAGING CO MPANY-NETBANK, MUM-N028232306054529-7221 6",,,net_banking_transfer,-72216
64142acef8804aea72170c7e,50200023535069,858304.68,60ec41ba55c00300382672d9,HDFC,direct expenses,5eecc6d6449e4f7cfb1c2708,2023-01-28T00:00:00.000Z,"NEFT DR-KKBK0001393-MASCOT SPINCONTROL I NDIA PVT LTD-NETBANK, MUM-N0282323060704 85-64800",,,net_banking_transfer,-64800
64142acef8804aea72170c80,50200023535069,848864.68,60ec41ba55c00300382672d9,HDFC,direct expenses,5eecc6d6449e4f7cfb1c2708,2023-01-28T00:00:00.000Z,NEFT DR-UTIB0000032-SKUMAR MULTIPRODUCTS,,,net_banking_transfer,-9440
64142acef8804aea72170c82,50200023535069,852147.88,60ec41ba55c00300382672d9,HDFC,Transfer in/Revenue-other,5eecc6d6449e4f7cfb1c2708,2023-01-29T00:00:00.000Z,IMPS-302904925947-EXCRO PAY ESCROW ACC-Y ESB-XXXXXXXXXXX1807-333112298023,,,net_banking_transfer,3283.2
64142acef8804aea72170c84,50200023535069,854423.31,60ec41ba55c00300382672d9,HDFC,Transfer in/Revenue-other,5eecc6d6449e4f7cfb1c2708,2023-01-30T00:00:00.000Z,IMPS-303004979266-EXCRO PAY ESCROW ACC-Y ESB-XXXXXXXXXXX1807-333112298023,,,net_banking_transfer,2275.43
64142acef8804aea72170c86,50200023535069,837616.31,60ec41ba55c00300382672d9,HDFC,direct expenses,5eecc6d6449e4f7cfb1c2708,2023-01-30T00:00:00.000Z,NEFT DR-ICIC0003431-WAVICLE TECHNOLOGIES PVT LTD-SANDOZ - MUM-N030232306565609-N ET BANKING SI -16807,,,net_banking_transfer,-16807
64142acef8804aea72170c88,50200023535069,817847.31,60ec41ba55c00300382672d9,HDFC,direct expenses,5eecc6d6449e4f7cfb1c2708,2023-01-30T00:00:00.000Z,NEFT DR-ICIC0003431-WAVICLE TECHNOLOGIES PVT LTD-SANDOZ - MUM-N030232306565611-N ET BANKING SI -19769,,,net_banking_transfer,-19769
64142acef8804aea72170c8a,50200023535069,840315.16,60ec41ba55c00300382672d9,HDFC,Revenue-Mktplace,5eecc6d6449e4f7cfb1c2708,2023-01-30T00:00:00.000Z,NEFT CR-DEUT0797BGL-MYNTRA DESIGNS PRIVA TE LIMITED-SLICK ORGANICS - SJIT-3030006 57GN00013,shopping,,net_banking_transfer,22467.85
64142acef8804aea72170c8c,50200023535069,840861.3,60ec41ba55c00300382672d9,HDFC,Revenue-Mktplace,5eecc6d6449e4f7cfb1c2708,2023-01-30T00:00:00.000Z,NEFT CR-DEUT0797BGL-MYNTRA DESIGNS PRIVA TE LIMITED-SLICK ORGANICS PVT. LTD.-3030 00660GN00282,shopping,,net_banking_transfer,546.14
64142acef8804aea72170c8e,50200023535069,848809,60ec41ba55c00300382672d9,HDFC,Revenue-PG-split enabled,5eecc6d6449e4f7cfb1c2708,2023-01-30T00:00:00.000Z,NEFT CR-UTIB0001506-RAZORPAY SOFTWARE PR IVATE LIMITED-SLICK ORGANICS PVT LITD-AX ISCN0203144796,,,net_banking_transfer,7947.7
64142acef8804aea72170c91,50200023535069,848459,60ec41ba55c00300382672d9,HDFC,direct expenses,5eecc6d6449e4f7cfb1c2708,2023-01-30T00:00:00.000Z,"NEFT DR-KKBK0000183-PANDEY INFOTECH PRIV ATE LIMITED-NETBANK, MUM-N03023230677374 2-350",,,net_banking_transfer,-350
64142acef8804aea72170c93,50200023535069,848460,60ec41ba55c00300382672d9,HDFC,Revenue-PG-split enabled,5eecc6d6449e4f7cfb1c2708,2023-01-30T00:00:00.000Z,IMPS-303016667293-CASHFREE PAYMENTS IN-I CIC-XXXXXXXX0293-DREAMPLUG TECHNOLOGY BA NK DETAILS VALIDATION CF,,,net_banking_transfer,1
64142acef8804aea72170c95,50200023535069,852657,60ec41ba55c00300382672d9,HDFC,Revenue-Mktplace,5eecc6d6449e4f7cfb1c2708,2023-01-30T00:00:00.000Z,NEFT CR-ICIC0000105-MANASH LIFETYLE PVT LTD-SLICK ORGANICS PRIVATE LIMITED-ICIB2 30300026506,,,net_banking_transfer,4197
64142acef8804aea72170c97,50200023535069,1003354.76,60ec41ba55c00300382672d9,HDFC,Transfer in/Revenue-other,5eecc6d6449e4f7cfb1c2708,2023-01-30T00:00:00.000Z,NEFT CR-YESB0000001-EASEBUZZ PVT LTD NOD,,,net_banking_transfer,150697.76
64142acef8804aea72170c99,50200023535069,1009976.41,60ec41ba55c00300382672d9,HDFC,Transfer in/Revenue-other,5eecc6d6449e4f7cfb1c2708,2023-01-30T00:00:00.000Z,NEFT CR-UTIB0000114-ONE SIGMA TECHNOLOGI ES PRIVATE LIM-SLICK ORGANICS PRIVATE LI MITED-AXISP00358129390,bnpl,,net_banking_transfer,6621.65
64142acef8804aea72170c9b,50200023535069,1022391.74,60ec41ba55c00300382672d9,HDFC,Transfer in/Revenue-other,5eecc6d6449e4f7cfb1c2708,2023-01-30T00:00:00.000Z,NEFT CR-UTIB0000114-ONE SIGMA TECHNOLOGI ES PRIVATE LIM-SLICK ORGANICS PRIVATE LI MITED-AXISP00358129740,bnpl,,net_banking_transfer,12415.33
64142acef8804aea72170c9d,50200023535069,1103302.29,60ec41ba55c00300382672d9,HDFC,Revenue-COD,5eecc6d6449e4f7cfb1c2708,2023-01-30T00:00:00.000Z,NEFT CR-ICIC0000155-SHIPROCKET COD CRF I D 5625634-SLICK ORGANICS PVT LTD-CMS3091 456947,,,net_banking_transfer,80910.55
64142acef8804aea72170c9f,50200023535069,1203852.29,60ec41ba55c00300382672d9,HDFC,Transfer in/Revenue-other,5eecc6d6449e4f7cfb1c2708,2023-01-30T00:00:00.000Z,NEFT CR-YESB0000001-EASEBUZZ PVT LTD NOD AL A/C-SLICK ORGANICS PVT LTD-YESB303032 87831,,,net_banking_transfer,100550
64142acef8804aea72170ca1,50200023535069,1205744.19,60ec41ba55c00300382672d9,HDFC,Transfer in/Revenue-other,5eecc6d6449e4f7cfb1c2708,2023-01-30T00:00:00.000Z,NEFT CR-UTIB0000114-ONE SIGMA TECHNOLOGI ES PRIVATE LIM-SLICK ORGANICS PRIVATE LI MITED-AXISP00358129636,bnpl,,net_banking_transfer,1891.9
64142acef8804aea72170ca3,50200023535069,1206665.56,60ec41ba55c00300382672d9,HDFC,Revenue-PG-split enabled,5eecc6d6449e4f7cfb1c2708,2023-01-30T00:00:00.000Z,NEFT CR-UTIB0001506-RAZORPAY SOFTWARE PR IVATE LIMITED-SLICK ORGANICS PVT LITD-AX ISCN0203478465,,,net_banking_transfer,921.37
64142acef8804aea72170ca5,50200023535069,1206486.56,60ec41ba55c00300382672d9,HDFC,SAAS/tech expense,5eecc6d6449e4f7cfb1c2708,2023-01-30T00:00:00.000Z,ME DC SI 514834XXXXXX9486 AMAZON INDIA C YBS SI,shopping,,Other,-179
64142acef8804aea72170ca7,50200023535069,956486.56,60ec41ba55c00300382672d9,HDFC,direct expenses,5eecc6d6449e4f7cfb1c2708,2023-01-31T00:00:00.000Z,NEFT DR-ICIC0000369-BO INTERNATIONAL-SAN DOZ - MUM-N031232308300196-NET BANKING S I -250000,,,net_banking_transfer,-250000
64142acef8804aea72170ca9,50200023535069,917331.56,60ec41ba55c00300382672d9,HDFC,direct expenses,5eecc6d6449e4f7cfb1c2708,2023-01-31T00:00:00.000Z,NEFT DR-UTIB0001696-EMIZA SUPPLY CHAIN S ERVICES PRIVATE LIMI-SANDOZ - MUM-N03123 2308300199-NET BANKING SI -39155,,,net_banking_transfer,-39155
64142acff8804aea72170cab,50200023535069,742106.56,60ec41ba55c00300382672d9,HDFC,direct expenses,5eecc6d6449e4f7cfb1c2708,2023-01-31T00:00:00.000Z,NEFT DR-UTIB0000119-SAFEXPRESS-SANDOZ - MUM-N031232308300200-NET BANKING SI -175 225,,,net_banking_transfer,-175225
64142acff8804aea72170cad,50200023535069,492106.56,60ec41ba55c00300382672d9,HDFC,direct expenses,5eecc6d6449e4f7cfb1c2708,2023-01-31T00:00:00.000Z,05892560000649-TPT-250000-DECORPAC INDIA,,,net_banking_transfer,-250000
64142acff8804aea72170caf,50200023535069,192106.56,60ec41ba55c00300382672d9,HDFC,direct expenses,5eecc6d6449e4f7cfb1c2708,2023-01-31T00:00:00.000Z,"NEFT DR-ICIC0000024-TAKE MOTO YOHKI INDI A PRIVATE LIMITED-NETBANK, MUM-N03123230 8547565-300000",travel,,net_banking_transfer,-300000
64142acff8804aea72170cb1,50200023535069,-107893.44,60ec41ba55c00300382672d9,HDFC,direct expenses,5eecc6d6449e4f7cfb1c2708,2023-01-31T00:00:00.000Z,"NEFT DR-SRCB0000281-3D TECHNOPACK PRIVAT E LIMITED-NETBANK, MUM-N031232308548104- 300000",,,net_banking_transfer,-300000
64142acff8804aea72170cb3,50200023535069,-207893.44,60ec41ba55c00300382672d9,HDFC,direct expenses,5eecc6d6449e4f7cfb1c2708,2023-01-31T00:00:00.000Z,"NEFT DR-YESB0000551-VISTTA COSMETICS-NET BANK, MUM-N031232308555542-100000",,,net_banking_transfer,-100000
64142acff8804aea72170cb5,50200023535069,-272659.44,60ec41ba55c00300382672d9,HDFC,direct expenses,5eecc6d6449e4f7cfb1c2708,2023-01-31T00:00:00.000Z,"NEFT DR-KKBK0000184-ARHAM INTERNATIONAL- NETBANK, MUM-N031232308554578-64766",,,net_banking_transfer,-64766
64142acff8804aea72170cb7,50200023535069,-271715.24,60ec41ba55c00300382672d9,HDFC,Revenue-PG-split enabled,5eecc6d6449e4f7cfb1c2708,2023-01-31T00:00:00.000Z,NEFT CR-UTIB0001506-RAZORPAY SOFTWARE PR IVATE LIMITED-SLICK ORGANICS PVT LITD-AX ISCN0203667232,,,net_banking_transfer,944.2
64142acff8804aea72170cb9,50200023535069,-272716.24,60ec41ba55c00300382672d9,HDFC,direct expenses,5eecc6d6449e4f7cfb1c2708,2023-01-31T00:00:00.000Z,POS 514834XXXXXX9486 PAYTM PAYMENTS S,ewallet,,debit_card,-1001
64142acff8804aea72170cbb,50200023535069,-272598.36,60ec41ba55c00300382672d9,HDFC,Transfer in/Revenue-other,5eecc6d6449e4f7cfb1c2708,2023-01-31T00:00:00.000Z,NEFT CR-UTIB0000114-ONE SIGMA TECHNOLOGI ES PRIVATE LIM-SLICK ORGANICS PRIVATE LI MITED-AXISP00358377445,bnpl,,net_banking_transfer,117.88
64142acff8804aea72170cbd,50200023535069,-271482.36,60ec41ba55c00300382672d9,HDFC,Revenue-Mktplace,5eecc6d6449e4f7cfb1c2708,2023-01-31T00:00:00.000Z,NEFT CR-ICIC0000105-MANASH LIFETYLE PVT LTD-SLICK ORGANICS PRIVATE LIMITED-ICIB2 30310004910,,,net_banking_transfer,1116
64142acff8804aea72170cbf,50200023535069,303592.15,60ec41ba55c00300382672d9,HDFC,Transfer in/Revenue-other,5eecc6d6449e4f7cfb1c2708,2023-01-31T00:00:00.000Z,RTGS CR-IDFB0010204-PCPL CENTRAL DISBURS EMENT AC-SLICK ORGANICS PRIVATE LIMITED- IDFBR52023013100453737,,,net_banking_transfer,575074.51
64142acff8804aea72170cc1,50200023535069,305481.21,60ec41ba55c00300382672d9,HDFC,Transfer in/Revenue-other,5eecc6d6449e4f7cfb1c2708,2023-01-31T00:00:00.000Z,NEFT CR-YESB0000001-EXCRO PAY ESCROW ACC OUNT-SLICKORGANICSPRIVATELIMITED-YESB303 16509634,,,net_banking_transfer,1889.06
64142acff8804aea72170cc3,50200023535069,305922.77,60ec41ba55c00300382672d9,HDFC,Revenue-PG-split enabled,5eecc6d6449e4f7cfb1c2708,2023-01-31T00:00:00.000Z,NEFT CR-UTIB0001506-RAZORPAY SOFTWARE PR IVATE LIMITED-SLICK ORGANICS PVT LITD-AX ISCN0203920448,,,net_banking_transfer,441.56
64142acff8804aea72170cc5,50200023535069,388902.7,60ec41ba55c00300382672d9,HDFC,Transfer in/Revenue-other,5eecc6d6449e4f7cfb1c2708,2023-01-31T00:00:00.000Z,NEFT CR-YESB0000001-EASEBUZZ PVT LTD NOD,,,net_banking_transfer,82979.93
64142acff8804aea72170cc7,50200023535069,888902.7,60ec41ba55c00300382672d9,HDFC,Transfer in/Revenue-other,5eecc6d6449e4f7cfb1c2708,2023-01-31T00:00:00.000Z,IMPS-303121651533-PCPL CENTRAL DISBUR-I DFB-XXXXXXX1507-IMPSTXN,,,net_banking_transfer,500000
64142acff8804aea72170cc9,50200023535069,1388902.7,60ec41ba55c00300382672d9,HDFC,Transfer in/Revenue-other,5eecc6d6449e4f7cfb1c2708,2023-01-31T00:00:00.000Z,IMPS-303121651657-PCPL CENTRAL DISBUR-I DFB-XXXXXXX1507-IMPSTXN,,,net_banking_transfer,500000
64142acff8804aea72170ccb,50200023535069,1888902.7,60ec41ba55c00300382672d9,HDFC,Transfer in/Revenue-other,5eecc6d6449e4f7cfb1c2708,2023-01-31T00:00:00.000Z,IMPS-303121651698-PCPL CENTRAL DISBUR-I DFB-XXXXXXX1507-IMPSTXN,,,net_banking_transfer,500000
64142acff8804aea72170ccd,50200023535069,2388902.7,60ec41ba55c00300382672d9,HDFC,Transfer in/Revenue-other,5eecc6d6449e4f7cfb1c2708,2023-01-31T00:00:00.000Z,IMPS-303121651845-PCPL CENTRAL DISBUR-I DFB-XXXXXXX1507-IMPSTXN,,,net_banking_transfer,500000
64142acff8804aea72170ccf,50200023535069,2888902.7,60ec41ba55c00300382672d9,HDFC,Transfer in/Revenue-other,5eecc6d6449e4f7cfb1c2708,2023-01-31T00:00:00.000Z,IMPS-303121651964-PCPL CENTRAL DISBUR-I DFB-XXXXXXX1507-IMPSTXN,,,net_banking_transfer,500000
64142acff8804aea72170cd1,50200023535069,3388902.7,60ec41ba55c00300382672d9,HDFC,Transfer in/Revenue-other,5eecc6d6449e4f7cfb1c2708,2023-01-31T00:00:00.000Z,IMPS-303121651996-PCPL CENTRAL DISBUR-I DFB-XXXXXXX1507-IMPSTXN,,,net_banking_transfer,500000
64142acff8804aea72170cd3,50200023535069,3399202.7,60ec41ba55c00300382672d9,HDFC,Transfer in/Revenue-other,5eecc6d6449e4f7cfb1c2708,2023-01-31T00:00:00.000Z,IMPS-303121652007-PCPL CENTRAL DISBUR-I DFB-XXXXXXX1507-IMPSTXN,,,net_banking_transfer,10300
64142acff8804aea72170cd6,50200023535069,3899202.7,60ec41ba55c00300382672d9,HDFC,Transfer in/Revenue-other,5eecc6d6449e4f7cfb1c2708,2023-01-31T00:00:00.000Z,IMPS-303121652094-PCPL CENTRAL DISBUR-I DFB-XXXXXXX1507-IMPSTXN,,,net_banking_transfer,500000
64142acff8804aea72170cd8,50200023535069,4399202.7,60ec41ba55c00300382672d9,HDFC,Transfer in/Revenue-other,5eecc6d6449e4f7cfb1c2708,2023-01-31T00:00:00.000Z,IMPS-303121652100-PCPL CENTRAL DISBUR-I DFB-XXXXXXX1507-IMPSTXN,,,net_banking_transfer,500000
64142acff8804aea72170cda,50200023535069,4899202.7,60ec41ba55c00300382672d9,HDFC,Transfer in/Revenue-other,5eecc6d6449e4f7cfb1c2708,2023-01-31T00:00:00.000Z,IMPS-303121652070-PCPL CENTRAL DISBUR-I,,,net_banking_transfer,500000
64142acff8804aea72170cdc,50200023535069,4814495.7,60ec41ba55c00300382672d9,HDFC,direct expenses,5eecc6d6449e4f7cfb1c2708,2023-02-01T00:00:00.000Z,02711600008220 NET BANKING SI -84707,,,Other,-84707
64142acff8804aea72170cde,50200023535069,4826006.08,60ec41ba55c00300382672d9,HDFC,Transfer in/Revenue-other,5eecc6d6449e4f7cfb1c2708,2023-02-01T00:00:00.000Z,IMPS-303207915845-EXCRO PAY ESCROW ACC-Y ESB-XXXXXXXXXXX1807-333112298023,,,net_banking_transfer,11510.38
64142acff8804aea72170ce0,50200023535069,3050273.08,60ec41ba55c00300382672d9,HDFC,Marketing Expense,5eecc6d6449e4f7cfb1c2708,2023-02-01T00:00:00.000Z,"NEFT DR-CITI0000006-FACEBOOK INDIA ONLIN E SERVICES PVT LTD-NETBANK, MUM-N0322323 10789510-1775733",,,net_banking_transfer,-1775733
64142acff8804aea72170ce3,50200023535069,2550273.08,60ec41ba55c00300382672d9,HDFC,direct expenses,5eecc6d6449e4f7cfb1c2708,2023-02-01T00:00:00.000Z,"NEFT DR-ICIC0000369-BO INTERNATIONAL-NET BANK, MUM-N032232310784668-500000",,,net_banking_transfer,-500000
64142acff8804aea72170ce5,50200023535069,2085936.08,60ec41ba55c00300382672d9,HDFC,Marketing Expense,5eecc6d6449e4f7cfb1c2708,2023-02-01T00:00:00.000Z,"NEFT DR-CITI0100000-GOOGLE INDIA PVT LTD -NETBANK, MUM-N032232310799188-464337",,,net_banking_transfer,-464337
64142acff8804aea72170ce7,50200023535069,2095107.02,60ec41ba55c00300382672d9,HDFC,Revenue-Mktplace,5eecc6d6449e4f7cfb1c2708,2023-02-01T00:00:00.000Z,NEFT CR-DEUT0797BGL-MYNTRA DESIGNS PRIVA TE LIMITED-SLICK ORGANICS - SJIT-3032041 28GN00050,shopping,,net_banking_transfer,9170.94
64142acff8804aea72170ce9,50200023535069,2092669.02,60ec41ba55c00300382672d9,HDFC,direct expenses,5eecc6d6449e4f7cfb1c2708,2023-02-01T00:00:00.000Z,"NEFT DR-UBIN0541214-GUPTA STATIONERY SUI TE-NETBANK, MUM-N032232311041135-2438",,,net_banking_transfer,-2438
64142acff8804aea72170ceb,50200023535069,2093528.69,60ec41ba55c00300382672d9,HDFC,Revenue-Mktplace,5eecc6d6449e4f7cfb1c2708,2023-02-01T00:00:00.000Z,NEFT CR-DEUT0797BGL-MYNTRA DESIGNS PRIVA TE LIMITED-SLICK ORGANICS PVT. LTD.-3032 04178GN00053,shopping,,net_banking_transfer,859.67
64142acff8804aea72170ced,50200023535069,2095745.1,60ec41ba55c00300382672d9,HDFC,Transfer in/Revenue-other,5eecc6d6449e4f7cfb1c2708,2023-02-01T00:00:00.000Z,NEFT CR-YESB0000001-EXCRO PAY ESCROW ACC OUNT-SLICKORGANICSPRIVATELIMITED-YESB303 29610787,,,net_banking_transfer,2216.41
64142acff8804aea72170cef,50200023535069,2047145.1,60ec41ba55c00300382672d9,HDFC,direct expenses,5eecc6d6449e4f7cfb1c2708,2023-02-01T00:00:00.000Z,00918630000430-TPT-48600-UNICOMMERCE ESO LUTIONS PRIVATE LIMITED,,,net_banking_transfer,-48600
64142acff8804aea72170cf1,50200023535069,2049205.5,60ec41ba55c00300382672d9,HDFC,Revenue-PG-split enabled,5eecc6d6449e4f7cfb1c2708,2023-02-01T00:00:00.000Z,NEFT CR-UTIB0001506-RAZORPAY SOFTWARE PR IVATE LIMITED-SLICK ORGANICS PVT LITD-AX ISCN0204146232,,,net_banking_transfer,2060.4
64142acff8804aea72170cf3,50200023535069,2093264.37,60ec41ba55c00300382672d9,HDFC,Revenue-Mktplace,5eecc6d6449e4f7cfb1c2708,2023-02-01T00:00:00.000Z,NEFT CR-HSBC0400002-AMAZON SERVICES LLC- SLICK ORGANICS PRIVATE LIMITED-HSBCN2303 2779745,shopping,,net_banking_transfer,44058.87
64142acff8804aea72170cf5,50200023535069,2092493.83,60ec41ba55c00300382672d9,HDFC,bank charges,5eecc6d6449e4f7cfb1c2708,2023-02-01T00:00:00.000Z,.DC INTL POS TXN MARKUP+ST 301222 010123,,,international_transaction_arbitrage,-770.54
64142acff8804aea72170cf8,50200023535069,2098698.84,60ec41ba55c00300382672d9,HDFC,Transfer in/Revenue-other,5eecc6d6449e4f7cfb1c2708,2023-02-01T00:00:00.000Z,NEFT CR-UTIB0000114-ONE SIGMA TECHNOLOGI ES PRIVATE LIM-SLICK ORGANICS PRIVATE LI MITED-AXISP00359178856,bnpl,,net_banking_transfer,6205.01
64142acff8804aea72170cfa,50200023535069,2012342.84,60ec41ba55c00300382672d9,HDFC,direct expenses,5eecc6d6449e4f7cfb1c2708,2023-02-01T00:00:00.000Z,50200054531492-TPT-86356-ALETA PEOPLE SE RVICES,,,net_banking_transfer,-86356
64142acff8804aea72170cfc,50200023535069,1858982.84,60ec41ba55c00300382672d9,HDFC,direct expenses,5eecc6d6449e4f7cfb1c2708,2023-02-01T00:00:00.000Z,"NEFT DR-DBSS0IN0811-SARANSH KULKARNI-NET BANK, MUM-N032232311702967-153360",,,net_banking_transfer,-153360
64142acff8804aea72170cfe,50200023535069,1862578.84,60ec41ba55c00300382672d9,HDFC,Revenue-Mktplace,5eecc6d6449e4f7cfb1c2708,2023-02-01T00:00:00.000Z,IMPS-303214436244-DREAMPLUGPAYTECHSO-UTI B-XXXXXXXXXXX7853-,,,net_banking_transfer,3596
64142acff8804aea72170d00,50200023535069,1884546.84,60ec41ba55c00300382672d9,HDFC,Transfer in/Revenue-other,5eecc6d6449e4f7cfb1c2708,2023-02-01T00:00:00.000Z,NEFT CR-KKBK0000958-OCTAVOS ENTERPRISE S OLUTIONS PVT-SLICK ORGANICS PRIVATE LIMI TED-CMS0322341496620,,,net_banking_transfer,21968
64142acff8804aea72170d03,50200023535069,1886587.84,60ec41ba55c00300382672d9,HDFC,Revenue-Mktplace,5eecc6d6449e4f7cfb1c2708,2023-02-01T00:00:00.000Z,NEFT CR-ICIC0000105-MANASH LIFETYLE PVT LTD-SLICK ORGANICS PRIVATE LIMITED-ICIB2 30320023991,,,net_banking_transfer,2041
64142acff8804aea72170d06,50200023535069,1939067.86,60ec41ba55c00300382672d9,HDFC,Revenue-COD,5eecc6d6449e4f7cfb1c2708,2023-02-01T00:00:00.000Z,NEFT CR-ICIC0000155-SHIPROCKET COD CRF I D 5646011-SLICK ORGANICS PVT LTD-CMS3097 083368,,,net_banking_transfer,52480.02
64142acff8804aea72170d08,50200023535069,2007222.98,60ec41ba55c00300382672d9,HDFC,Transfer in/Revenue-other,5eecc6d6449e4f7cfb1c2708,2023-02-01T00:00:00.000Z,NEFT CR-YESB0000001-EASEBUZZ PVT LTD NOD AL A/C-SLICK ORGANICS PVT LTD-YESB303201 09807,,,net_banking_transfer,68155.12
64142acff8804aea72170d0a,50200023535069,2008309.3,60ec41ba55c00300382672d9,HDFC,Revenue-PG-split enabled,5eecc6d6449e4f7cfb1c2708,2023-02-01T00:00:00.000Z,NEFT CR-UTIB0001506-RAZORPAY SOFTWARE PR IVATE LIMITED-SLICK ORGANICS PVT LITD-AX ISCN0204386520,,,net_banking_transfer,1086.32
64142acff8804aea72170d0c,50200023535069,2339973.73,60ec41ba55c00300382672d9,HDFC,Revenue-Mktplace,5eecc6d6449e4f7cfb1c2708,2023-02-01T00:00:00.000Z,NEFT CR-HSBC0560002-MYNTRA JABONG INDIA PRIVATE LIMITED-SLICK ORGANICS PRIVATE L IMITED-HSBCN23032103708,shopping,,net_banking_transfer,331664.43
64142acff8804aea72170d0e,50200023535069,2304763.26,60ec41ba55c00300382672d9,HDFC,direct expenses,5eecc6d6449e4f7cfb1c2708,2023-02-02T00:00:00.000Z,POS 514834XXXXXX9486 AMZ*MARKETING SV,,,debit_card,-35210.47
64142acff8804aea72170d10,50200023535069,2306772.3,60ec41ba55c00300382672d9,HDFC,Revenue-PG-split enabled,5eecc6d6449e4f7cfb1c2708,2023-02-02T00:00:00.000Z,NEFT CR-UTIB0001506-RAZORPAY SOFTWARE PR IVATE LIMITED-SLICK ORGANICS PVT LITD-AX ISCN0204559273,,,net_banking_transfer,2009.04
64142acff8804aea72170d13,50200023535069,2294622.3,60ec41ba55c00300382672d9,HDFC,direct expenses,5eecc6d6449e4f7cfb1c2708,2023-02-02T00:00:00.000Z,"NEFT DR-UBIN0531944-URVI SHAH-NETBANK, M UM-N033232313165650-12150",,,net_banking_transfer,-12150
64142acff8804aea72170d15,50200023535069,2295972.43,60ec41ba55c00300382672d9,HDFC,Transfer in/Revenue-other,5eecc6d6449e4f7cfb1c2708,2023-02-02T00:00:00.000Z,NEFT CR-YESB0000001-EXCRO PAY ESCROW ACC OUNT-SLICKORGANICSPRIVATELIMITED-YESB303 33103119,,,net_banking_transfer,1350.13
64142acff8804aea72170d17,50200023535069,2299769.75,60ec41ba55c00300382672d9,HDFC,Transfer in/Revenue-other,5eecc6d6449e4f7cfb1c2708,2023-02-02T00:00:00.000Z,NEFT CR-UTIB0000114-ONE SIGMA TECHNOLOGI ES PRIVATE LIM-SLICK ORGANICS PRIVATE LI MITED-AXISP00359769852,bnpl,,net_banking_transfer,3797.32
64142acff8804aea72170d19,50200023535069,2300967.75,60ec41ba55c00300382672d9,HDFC,Revenue-Mktplace,5eecc6d6449e4f7cfb1c2708,2023-02-02T00:00:00.000Z,IMPS-303314191866-DREAMPLUGPAYTECHSO-UTI B-XXXXXXXXXXX7853-,,,net_banking_transfer,1198
64142acff8804aea72170d1b,50200023535069,2192967.75,60ec41ba55c00300382672d9,HDFC,direct expenses,5eecc6d6449e4f7cfb1c2708,2023-02-02T00:00:00.000Z,"NEFT DR-BARB0VJMATU-ARTISTO DESIGNZ-NETB ANK, MUM-N033232313645369-108000",,,net_banking_transfer,-108000
64142acff8804aea72170d1d,50200023535069,2192968.76,60ec41ba55c00300382672d9,HDFC,Transfer in/Revenue-other,5eecc6d6449e4f7cfb1c2708,2023-02-02T00:00:00.000Z,NEFT CR-YESB0000001-EXCRO PAY ESCROW ACC OUNT-SLICKORGANICSPRIVATELIMITED-YESB303 33286715,,,net_banking_transfer,1.01
64142acff8804aea72170d1f,50200023535069,2297997.49,60ec41ba55c00300382672d9,HDFC,Transfer in/Revenue-other,5eecc6d6449e4f7cfb1c2708,2023-02-02T00:00:00.000Z,NEFT CR-YESB0000001-EASEBUZZ PVT LTD NOD AL A/C-SLICK ORGANICS PVT LTD-YESB303334 21458,,,net_banking_transfer,105028.73
64142ad0f8804aea72170d21,50200023535069,2298999.84,60ec41ba55c00300382672d9,HDFC,Revenue-PG-split enabled,5eecc6d6449e4f7cfb1c2708,2023-02-02T00:00:00.000Z,NEFT CR-UTIB0001506-RAZORPAY SOFTWARE PR IVATE LIMITED-SLICK ORGANICS PVT LITD-AX ISCN0204800957,,,net_banking_transfer,1002.35
64142ad0f8804aea72170d23,50200023535069,2262975.38,60ec41ba55c00300382672d9,HDFC,SAAS/tech expense,5eecc6d6449e4f7cfb1c2708,2023-02-02T00:00:00.000Z,POS 514834XXXXXX9486 AMAZON.COM,shopping,,debit_card,-36024.46
64142ad0f8804aea72170d26,50200023535069,2265161.39,60ec41ba55c00300382672d9,HDFC,Transfer in/Revenue-other,5eecc6d6449e4f7cfb1c2708,2023-02-03T00:00:00.000Z,IMPS-303404918685-EXCRO PAY ESCROW ACC-Y ESB-XXXXXXXXXXX1807-333112298023,,,net_banking_transfer,2186.01
64142ad0f8804aea72170d28,50200023535069,2241797.39,60ec41ba55c00300382672d9,HDFC,direct expenses,5eecc6d6449e4f7cfb1c2708,2023-02-03T00:00:00.000Z,NEFT DR-PUNB0062910-YADAVPACKAGING-SANDO Z - MUM-N034232314469154-NET BANKING SI -23364,,,net_banking_transfer,-23364
64142ad0f8804aea72170d2a,50200023535069,2245487.52,60ec41ba55c00300382672d9,HDFC,Transfer in/Revenue-other,5eecc6d6449e4f7cfb1c2708,2023-02-03T00:00:00.000Z,IMPS-303407978737-EXCRO PAY ESCROW ACC-Y ESB-XXXXXXXXXXX1807-333112298023,,,net_banking_transfer,3690.13
64142ad0f8804aea72170d2c,50200023535069,2234161.52,60ec41ba55c00300382672d9,HDFC,Utilities/bills,5eecc6d6449e4f7cfb1c2708,2023-02-03T00:00:00.000Z,IB BILLPAY DR-HDFCEB-361011XXXX4399,bills,,Other,-11326
64142ad0f8804aea72170d2e,50200023535069,2241861.27,60ec41ba55c00300382672d9,HDFC,Revenue-Mktplace,5eecc6d6449e4f7cfb1c2708,2023-02-03T00:00:00.000Z,NEFT CR-DEUT0797BGL-MYNTRA DESIGNS PRIVA TE LIMITED-SLICK ORGANICS - SJIT-3034009,shopping,,net_banking_transfer,7699.75
64142ad0f8804aea72170d31,50200023535069,2242797.9,60ec41ba55c00300382672d9,HDFC,Revenue-Mktplace,5eecc6d6449e4f7cfb1c2708,2023-02-03T00:00:00.000Z,NEFT CR-DEUT0797BGL-MYNTRA DESIGNS PRIVA TE LIMITED-SLICK ORGANICS PVT. LTD.-3034 01005GN00068,shopping,,net_banking_transfer,936.63
64142ad0f8804aea72170d33,50200023535069,2249248.34,60ec41ba55c00300382672d9,HDFC,Revenue-PG-split enabled,5eecc6d6449e4f7cfb1c2708,2023-02-03T00:00:00.000Z,NEFT CR-UTIB0001506-RAZORPAY SOFTWARE PR IVATE LIMITED-SLICK ORGANICS PVT LITD-AX ISCN0205059515,,,net_banking_transfer,6450.44
64142ad0f8804aea72170d35,50200023535069,2248706.41,60ec41ba55c00300382672d9,HDFC,Marketing Expense,5eecc6d6449e4f7cfb1c2708,2023-02-03T00:00:00.000Z,ME DC SI 514834XXXXXX9486 LINKEDIN (PGSI ),,,Other,-541.93
64142ad0f8804aea72170d37,50200023535069,2251965.14,60ec41ba55c00300382672d9,HDFC,Revenue-PG-non-split,5eecc6d6449e4f7cfb1c2708,2023-02-03T00:00:00.000Z,NEFT CR-SCBL0036001-STRIPE INDIA PRIVATE LIMITED-SLICK ORGANICS PRIVATE LIMITED- IN1ON23020301NXY,,,net_banking_transfer,3258.73
64142ad0f8804aea72170d39,50200023535069,2241965.14,60ec41ba55c00300382672d9,HDFC,Refund,5eecc6d6449e4f7cfb1c2708,2023-02-03T00:00:00.000Z,"NEFT DR-RATN0VAAPIS-RAZORPAY REFUND CRED ITS TOPUP-NETBANK, MUM-N034232315247003- 10000",,,net_banking_transfer,-10000
64142ad0f8804aea72170d3b,50200023535069,2247955.14,60ec41ba55c00300382672d9,HDFC,Revenue-Mktplace,5eecc6d6449e4f7cfb1c2708,2023-02-03T00:00:00.000Z,IMPS-303414936810-DREAMPLUGPAYTECHSO-UTI B-XXXXXXXXXXX7853-,,,net_banking_transfer,5990
64142ad0f8804aea72170d3d,50200023535069,2250690.74,60ec41ba55c00300382672d9,HDFC,Transfer in/Revenue-other,5eecc6d6449e4f7cfb1c2708,2023-02-03T00:00:00.000Z,NEFT CR-UTIB0000114-ONE SIGMA TECHNOLOGI ES PRIVATE LIM-SLICK ORGANICS PRIVATE LI MITED-AXISP00360092746,bnpl,,net_banking_transfer,2735.6
64142ad0f8804aea72170d3f,50200023535069,2254986.74,60ec41ba55c00300382672d9,HDFC,Revenue-Mktplace,5eecc6d6449e4f7cfb1c2708,2023-02-03T00:00:00.000Z,NEFT CR-ICIC0000105-MANASH LIFESTYLE PRI VATE LIMITED NO-SLICK ORGANICS PRIVATE L IMITED-ICIJ230340006328,shopping,,net_banking_transfer,4296
64142ad0f8804aea72170d42,50200023535069,2433846.74,60ec41ba55c00300382672d9,HDFC,Transfer in/Revenue-other,5eecc6d6449e4f7cfb1c2708,2023-02-03T00:00:00.000Z,NEFT CR-YESB0000001-NCOME TECH SOLUTIONS PRIVATE LIMITE-SLICK ORGANICS PVT LTD-Y ESB30346752674,,,net_banking_transfer,178860
64142ad0f8804aea72170d44,50200023535069,2433994.75,60ec41ba55c00300382672d9,HDFC,Revenue-PG-split enabled,5eecc6d6449e4f7cfb1c2708,2023-02-03T00:00:00.000Z,NEFT CR-UTIB0001506-RAZORPAY SOFTWARE PR IVATE LIMITED-SLICK ORGANICS PVT LITD-AX ISCN0205258530,,,net_banking_transfer,148.01
64142ad0f8804aea72170d47,50200023535069,2522453.88,60ec41ba55c00300382672d9,HDFC,Transfer in/Revenue-other,5eecc6d6449e4f7cfb1c2708,2023-02-03T00:00:00.000Z,NEFT CR-YESB0000001-EASEBUZZ PVT LTD NOD AL A/C-SLICK ORGANICS PVT LTD-YESB303468 36985,,,net_banking_transfer,88459.13
64142ad0f8804aea72170d49,50200023535069,2530154.16,60ec41ba55c00300382672d9,HDFC,Revenue-Mktplace,5eecc6d6449e4f7cfb1c2708,2023-02-03T00:00:00.000Z,NEFT CR-HSBC0400002-AMAZON PAYMENTS UK L IMITED ACCS-SLICK ORGANICS PRIVATE LIMIT ED-HSBCN23034360789,shopping,,net_banking_transfer,7700.28
64142ad0f8804aea72170d4b,50200023535069,2566347.01,60ec41ba55c00300382672d9,HDFC,Revenue-COD,5eecc6d6449e4f7cfb1c2708,2023-02-03T00:00:00.000Z,NEFT CR-ICIC0000155-SHIPROCKET COD CRF I D 5658297-SLICK ORGANICS PVT LTD-CMS3101 468425,,,net_banking_transfer,36192.85
64142ad0f8804aea72170d4d,50200023535069,2568786.37,60ec41ba55c00300382672d9,HDFC,Transfer in/Revenue-other,5eecc6d6449e4f7cfb1c2708,2023-02-04T00:00:00.000Z,IMPS-303504812754-EXCRO PAY ESCROW ACC-Y ESB-XXXXXXXXXXX1807-333112298023,,,net_banking_transfer,2439.36
64142ad0f8804aea72170d4f,50200023535069,2518786.37,60ec41ba55c00300382672d9,HDFC,direct expenses,5eecc6d6449e4f7cfb1c2708,2023-02-04T00:00:00.000Z,50100108772229 NET BANKING SI -50000,,,Other,-50000
64142ad0f8804aea72170d51,50200023535069,2539950.37,60ec41ba55c00300382672d9,HDFC,Transfer in/Revenue-other,5eecc6d6449e4f7cfb1c2708,2023-02-04T00:00:00.000Z,NEFT CR-UTIB0000020-EMIZA SUPPLY CHAIN S ERVICES PRIVAT-SLICK ORGANICS PRIVATE LI MITED-AXISP00360345030,,,net_banking_transfer,21164
64142ad0f8804aea72170d53,50200023535069,2540995.92,60ec41ba55c00300382672d9,HDFC,Revenue-PG-split enabled,5eecc6d6449e4f7cfb1c2708,2023-02-04T00:00:00.000Z,NEFT CR-UTIB0001506-RAZORPAY SOFTWARE PR IVATE LIMITED-SLICK ORGANICS PVT LITD-AX ISCN0205484001,,,net_banking_transfer,1045.55
64142ad0f8804aea72170d55,50200023535069,2543391.92,60ec41ba55c00300382672d9,HDFC,Revenue-Mktplace,5eecc6d6449e4f7cfb1c2708,2023-02-04T00:00:00.000Z,IMPS-303514653904-DREAMPLUGPAYTECHSO-UTI B-XXXXXXXXXXX7853-,,,net_banking_transfer,2396
64142ad0f8804aea72170d57,50200023535069,2543570.67,60ec41ba55c00300382672d9,HDFC,Transfer in/Revenue-other,5eecc6d6449e4f7cfb1c2708,2023-02-04T00:00:00.000Z,NEFT CR-SCBL0036001-AXELIA SOLUTIONS PRI VATE LIMITED-SLICK ORGANICS PVT LTD-IN1O N230204079YB,,,net_banking_transfer,178.75
64142ad0f8804aea72170d59,50200023535069,2626254.13,60ec41ba55c00300382672d9,HDFC,Transfer in/Revenue-other,5eecc6d6449e4f7cfb1c2708,2023-02-04T00:00:00.000Z,NEFT CR-YESB0000001-EASEBUZZ PVT LTD NOD AL A/C-SLICK ORGANICS PVT LTD-YESB303595 17681,,,net_banking_transfer,82683.46
64142ad0f8804aea72170d5b,50200023535069,2626799.74,60ec41ba55c00300382672d9,HDFC,Revenue-PG-split enabled,5eecc6d6449e4f7cfb1c2708,2023-02-04T00:00:00.000Z,NEFT CR-UTIB0001506-RAZORPAY SOFTWARE PR IVATE LIMITED-SLICK ORGANICS PVT LITD-AX ISCN0205653706,,,net_banking_transfer,545.61
64142ad0f8804aea72170d5d,50200023535069,2628503.58,60ec41ba55c00300382672d9,HDFC,Transfer in/Revenue-other,5eecc6d6449e4f7cfb1c2708,2023-02-05T00:00:00.000Z,IMPS-303605715145-EXCRO PAY ESCROW ACC-Y ESB-XXXXXXXXXXX1807-333112298023,,,net_banking_transfer,1703.84
64142ad0f8804aea72170d5f,50200023535069,2609543.58,60ec41ba55c00300382672d9,HDFC,direct expenses,5eecc6d6449e4f7cfb1c2708,2023-02-05T00:00:00.000Z,00918630000430-TPT-18960-UNICOMMERCE ESO LUTIONS PRIVATE LIMITED,,,net_banking_transfer,-18960
64142ad0f8804aea72170d61,50200023535069,2613326.1,60ec41ba55c00300382672d9,HDFC,Transfer in/Revenue-other,5eecc6d6449e4f7cfb1c2708,2023-02-06T00:00:00.000Z,IMPS-303705813105-EXCRO PAY ESCROW ACC-Y ESB-XXXXXXXXXXX1807-333112298023,,,net_banking_transfer,3782.52
64142ad0f8804aea72170d63,50200023535069,2618176.72,60ec41ba55c00300382672d9,HDFC,Revenue-PG-split enabled,5eecc6d6449e4f7cfb1c2708,2023-02-06T00:00:00.000Z,NEFT CR-UTIB0001506-RAZORPAY SOFTWARE PR IVATE LIMITED-SLICK ORGANICS PVT LITD-AX ISCN0206050096,,,net_banking_transfer,4850.62
64142ad0f8804aea72170d65,50200023535069,2623314.56,60ec41ba55c00300382672d9,HDFC,Transfer in/Revenue-other,5eecc6d6449e4f7cfb1c2708,2023-02-06T00:00:00.000Z,NEFT CR-YESB0000001-EXCRO PAY ESCROW ACC OUNT-SLICKORGANICSPRIVATELIMITED-YESB303 75026295,,,net_banking_transfer,5137.84
64142ad0f8804aea72170d67,50200023535069,2619328.56,60ec41ba55c00300382672d9,HDFC,direct expenses,5eecc6d6449e4f7cfb1c2708,2023-02-06T00:00:00.000Z,"NEFT DR-ICIC0000369-BO INTERNATIONAL-NET BANK, MUM-N037232318524333-3986",,,net_banking_transfer,-3986
64142ad0f8804aea72170d69,50200023535069,2627076.56,60ec41ba55c00300382672d9,HDFC,Revenue-Mktplace,5eecc6d6449e4f7cfb1c2708,2023-02-06T00:00:00.000Z,NEFT CR-ICIC0000105-MANASH LIFETYLE PVT LTD-SLICK ORGANICS PRIVATE LIMITED-ICIB2 30370014955,,,net_banking_transfer,7748
64142ad0f8804aea72170d6b,50200023535069,2637058.31,60ec41ba55c00300382672d9,HDFC,Revenue-Mktplace,5eecc6d6449e4f7cfb1c2708,2023-02-06T00:00:00.000Z,IMPS-303714966686-DREAMPLUGPAYTECHSO-UTI B-XXXXXXXXXXX7853-,,,net_banking_transfer,9981.75
64142ad0f8804aea72170d6d,50200023535069,2639892.85,60ec41ba55c00300382672d9,HDFC,Transfer in/Revenue-other,5eecc6d6449e4f7cfb1c2708,2023-02-06T00:00:00.000Z,NEFT CR-UTIB0000114-ONE SIGMA TECHNOLOGI ES PRIVATE LIM-SLICK ORGANICS PRIVATE LI MITED-AXISP00360704224,bnpl,,net_banking_transfer,2834.54
64142ad0f8804aea72170d6f,50200023535069,2640862,60ec41ba55c00300382672d9,HDFC,Transfer in/Revenue-other,5eecc6d6449e4f7cfb1c2708,2023-02-06T00:00:00.000Z,NEFT CR-UTIB0000114-ONE SIGMA TECHNOLOGI ES PRIVATE LIM-SLICK ORGANICS PRIVATE LI MITED-AXISP00360704000,bnpl,,net_banking_transfer,969.15
64142ad0f8804aea72170d72,50200023535069,2643130.78,60ec41ba55c00300382672d9,HDFC,Transfer in/Revenue-other,5eecc6d6449e4f7cfb1c2708,2023-02-06T00:00:00.000Z,NEFT CR-UTIB0000114-ONE SIGMA TECHNOLOGI ES PRIVATE LIM-SLICK ORGANICS PRIVATE LI MITED-AXISP00360703796,bnpl,,net_banking_transfer,2268.78
64142ad0f8804aea72170d74,50200023535069,2744516.47,60ec41ba55c00300382672d9,HDFC,Transfer in/Revenue-other,5eecc6d6449e4f7cfb1c2708,2023-02-06T00:00:00.000Z,NEFT CR-YESB0000001-EASEBUZZ PVT LTD NOD AL A/C-SLICK ORGANICS PVT LTD-YESB303751 76716,,,net_banking_transfer,101385.69
64142ad0f8804aea72170d76,50200023535069,2750227.24,60ec41ba55c00300382672d9,HDFC,Revenue-Mktplace,5eecc6d6449e4f7cfb1c2708,2023-02-06T00:00:00.000Z,NEFT CR-DEUT0797BGL-MYNTRA DESIGNS PRIVA TE LIMITED-SLICK ORGANICS - SJIT-3037012 36GN00054,shopping,,net_banking_transfer,5710.77
64142ad0f8804aea72170d78,50200023535069,2750137.24,60ec41ba55c00300382672d9,HDFC,direct expenses,5eecc6d6449e4f7cfb1c2708,2023-02-06T00:00:00.000Z,POS 514834XXXXXX9486 PTM*PAYTM WALLET,ewallet,,debit_card,-90
64142ad0f8804aea72170d7a,50200023535069,2751758.65,60ec41ba55c00300382672d9,HDFC,Revenue-Mktplace,5eecc6d6449e4f7cfb1c2708,2023-02-06T00:00:00.000Z,NEFT CR-DEUT0797BGL-MYNTRA DESIGNS PRIVA TE LIMITED-SLICK ORGANICS PVT. LTD.-3037 01264GN00119,shopping,,net_banking_transfer,1621.41
64142ad0f8804aea72170d7c,50200023535069,2750712.65,60ec41ba55c00300382672d9,HDFC,direct expenses,5eecc6d6449e4f7cfb1c2708,2023-02-06T00:00:00.000Z,POS 514834XXXXXX9486 PAYTM PAYMENTS S,ewallet,,debit_card,-1046
64142ad0f8804aea72170d7e,50200023535069,2918965.76,60ec41ba55c00300382672d9,HDFC,Revenue-COD,5eecc6d6449e4f7cfb1c2708,2023-02-06T00:00:00.000Z,NEFT CR-ICIC0000155-SHIPROCKET COD CRF I D 5666593-SLICK ORGANICS PVT LTD-CMS3106 195590,,,net_banking_transfer,168253.11
64142ad0f8804aea72170d81,50200023535069,2925241.76,60ec41ba55c00300382672d9,HDFC,Revenue-Mktplace,5eecc6d6449e4f7cfb1c2708,2023-02-06T00:00:00.000Z,NEFT CR-SCBL0036001-DREAMPLUG TECHNOLOGI ES PRIVATE LIMITED-SLICK ORGANICS PRIVAT E LIMITEDSLICK-IN1ON230206031XG,,,net_banking_transfer,6276
64142ad0f8804aea72170d83,50200023535069,3044995.68,60ec41ba55c00300382672d9,HDFC,Transfer in/Revenue-other,5eecc6d6449e4f7cfb1c2708,2023-02-06T00:00:00.000Z,NEFT CR-YESB0000001-EASEBUZZ PVT LTD NOD AL A/C-SLICK ORGANICS PVT LTD-YESB303753 66430,,,net_banking_transfer,119753.92
64142ad0f8804aea72170d85,50200023535069,3046859.43,60ec41ba55c00300382672d9,HDFC,Revenue-PG-split enabled,5eecc6d6449e4f7cfb1c2708,2023-02-06T00:00:00.000Z,NEFT CR-UTIB0001506-RAZORPAY SOFTWARE PR IVATE LIMITED-SLICK ORGANICS PVT LITD-AX ISCN0206325000,,,net_banking_transfer,1863.75
64142ad0f8804aea72170d87,50200023535069,3055627.05,60ec41ba55c00300382672d9,HDFC,Transfer in/Revenue-other,5eecc6d6449e4f7cfb1c2708,2023-02-06T00:00:00.000Z,NEFT CR-HSBC0110005-HANDS ON TRADES PRIV ATE LIMITED-SLICK ORGANICS PRIVATE LIMIT ED-HSBCN23037855142,,,net_banking_transfer,8767.62
64142ad0f8804aea72170d89,50200023535069,3122441.23,60ec41ba55c00300382672d9,HDFC,Transfer in/Revenue-other,5eecc6d6449e4f7cfb1c2708,2023-02-06T00:00:00.000Z,NEFT CR-HSBC0110005-HANDS ON TRADES PRIV ATE LIMITED-SLICK ORGANICS PRIVATE LIMIT ED-HSBCN23037855170,,,net_banking_transfer,66814.18
64142ad0f8804aea72170d8b,50200023535069,3125320.95,60ec41ba55c00300382672d9,HDFC,Transfer in/Revenue-other,5eecc6d6449e4f7cfb1c2708,2023-02-07T00:00:00.000Z,IMPS-303803660530-EXCRO PAY ESCROW ACC-Y ESB-XXXXXXXXXXX1807-333112298023,,,net_banking_transfer,2879.72
64142ad0f8804aea72170d8d,50200023535069,2951801.95,60ec41ba55c00300382672d9,HDFC,direct expenses,5eecc6d6449e4f7cfb1c2708,2023-02-07T00:00:00.000Z,50100155115510 NET BANKING SI -173519,,,Other,-173519
64142ad0f8804aea72170d8f,50200023535069,2889301.95,60ec41ba55c00300382672d9,HDFC,direct expenses,5eecc6d6449e4f7cfb1c2708,2023-02-07T00:00:00.000Z,50100064106714 NET BANKING SI -62500,,,Other,-62500
64142ad0f8804aea72170d91,50200023535069,2839301.95,60ec41ba55c00300382672d9,HDFC,direct expenses,5eecc6d6449e4f7cfb1c2708,2023-02-07T00:00:00.000Z,50100108772229 NET BANKING SI -50000,,,Other,-50000
64142ad0f8804aea72170d93,50200023535069,2793468.95,60ec41ba55c00300382672d9,HDFC,direct expenses,5eecc6d6449e4f7cfb1c2708,2023-02-07T00:00:00.000Z,50100482015380 NET BANKING SI -45833,,,Other,-45833
64142ad0f8804aea72170d95,50200023535069,2716483.95,60ec41ba55c00300382672d9,HDFC,direct expenses,5eecc6d6449e4f7cfb1c2708,2023-02-07T00:00:00.000Z,50100293329616 NET BANKING SI -76985,,,Other,-76985
64142ad0f8804aea72170d97,50200023535069,2657353.95,60ec41ba55c00300382672d9,HDFC,direct expenses,5eecc6d6449e4f7cfb1c2708,2023-02-07T00:00:00.000Z,50100349886722 NET BANKING SI -59130,,,Other,-59130
64142ad1f8804aea72170d99,50200023535069,2619337.95,60ec41ba55c00300382672d9,HDFC,direct expenses,5eecc6d6449e4f7cfb1c2708,2023-02-07T00:00:00.000Z,00901610080520 NET BANKING SI -38016,,,Other,-38016
64142ad1f8804aea72170d9b,50200023535069,2477692.95,60ec41ba55c00300382672d9,HDFC,direct expenses,5eecc6d6449e4f7cfb1c2708,2023-02-07T00:00:00.000Z,50100093802387 NET BANKING SI -141645,,,Other,-141645
64142ad1f8804aea72170d9d,50200023535069,2424625.95,60ec41ba55c00300382672d9,HDFC,direct expenses,5eecc6d6449e4f7cfb1c2708,2023-02-07T00:00:00.000Z,50100312215410 NET BANKING SI -53067,,,Other,-53067
64142ad1f8804aea72170d9f,50200023535069,2404775.95,60ec41ba55c00300382672d9,HDFC,direct expenses,5eecc6d6449e4f7cfb1c2708,2023-02-07T00:00:00.000Z,02711600008220 NET BANKING SI -19850,,,Other,-19850
64142ad1f8804aea72170da1,50200023535069,2154775.95,60ec41ba55c00300382672d9,HDFC,direct expenses,5eecc6d6449e4f7cfb1c2708,2023-02-07T00:00:00.000Z,05892560000649 NET BANKING SI -250000,,,Other,-250000
64142ad1f8804aea72170da3,50200023535069,1904775.95,60ec41ba55c00300382672d9,HDFC,direct expenses,5eecc6d6449e4f7cfb1c2708,2023-02-07T00:00:00.000Z,57500001065314 NET BANKING SI -250000,,,Other,-250000
64142ad1f8804aea72170da5,50200023535069,1872915.95,60ec41ba55c00300382672d9,HDFC,direct expenses,5eecc6d6449e4f7cfb1c2708,2023-02-07T00:00:00.000Z,50200016295776 NET BANKING SI -31860,,,Other,-31860
64142ad1f8804aea72170da7,50200023535069,1678868.95,60ec41ba55c00300382672d9,HDFC,direct expenses,5eecc6d6449e4f7cfb1c2708,2023-02-07T00:00:00.000Z,NEFT DR-KKBK0000261-TANVI TANEJA-SANDOZ - MUM-N038232320100376-NET BANKING SI -1 94047,,,net_banking_transfer,-194047
64142ad1f8804aea72170da9,50200023535069,1547814.95,60ec41ba55c00300382672d9,HDFC,direct expenses,5eecc6d6449e4f7cfb1c2708,2023-02-07T00:00:00.000Z,NEFT DR-ICIC0000021-AKHILESH DIXIT-SANDO Z - MUM-N038232320100377-NET BANKING SI -131054,,,net_banking_transfer,-131054
64142ad1f8804aea72170dab,50200023535069,1532489.95,60ec41ba55c00300382672d9,HDFC,direct expenses,5eecc6d6449e4f7cfb1c2708,2023-02-07T00:00:00.000Z,NEFT DR-ICIC0000021-AKHILESH DIXIT-SANDO Z - MUM-N038232320100378-NET BANKING SI -15325,,,net_banking_transfer,-15325
64142ad1f8804aea72170dad,50200023535069,1487489.95,60ec41ba55c00300382672d9,HDFC,direct expenses,5eecc6d6449e4f7cfb1c2708,2023-02-07T00:00:00.000Z,NEFT DR-ICIC0000314-ATUL VAISHNAV-SANDOZ - MUM-N038232320100379-NET BANKING SI - 45000,,,net_banking_transfer,-45000
64142ad1f8804aea72170daf,50200023535069,1458489.95,60ec41ba55c00300382672d9,HDFC,direct expenses,5eecc6d6449e4f7cfb1c2708,2023-02-07T00:00:00.000Z,NEFT DR-SIBL0000555-JAIVEER KUMAR-SANDOZ - MUM-N038232320100380-NET BANKING SI - 29000,,,net_banking_transfer,-29000
64142ad1f8804aea72170db1,50200023535069,1434489.95,60ec41ba55c00300382672d9,HDFC,direct expenses,5eecc6d6449e4f7cfb1c2708,2023-02-07T00:00:00.000Z,NEFT DR-PUNB0482100-RAM BHAVAN YADAV-SAN DOZ - MUM-N038232320100381-NET BANKING S I -24000,,,net_banking_transfer,-24000
64142ad1f8804aea72170db3,50200023535069,1354939.95,60ec41ba55c00300382672d9,HDFC,direct expenses,5eecc6d6449e4f7cfb1c2708,2023-02-07T00:00:00.000Z,NEFT DR-SBIN0070392-APARNA MOHANAN KONAT -SANDOZ - MUM-N038232320100382-NET BANKI NG SI -79550,,,net_banking_transfer,-79550
64142ad1f8804aea72170db5,50200023535069,1328779.95,60ec41ba55c00300382672d9,HDFC,direct expenses,5eecc6d6449e4f7cfb1c2708,2023-02-07T00:00:00.000Z,NEFT DR-ICIC0002697-NITISH KUMAR-SANDOZ - MUM-N038232320100383-NET BANKING SI -2 6160,,,net_banking_transfer,-26160
64142ad1f8804aea72170db7,50200023535069,1302379.95,60ec41ba55c00300382672d9,HDFC,direct expenses,5eecc6d6449e4f7cfb1c2708,2023-02-07T00:00:00.000Z,NEFT DR-UTIB0000120-ADNAN ALI-SANDOZ - M UM-N038232320100384-NET BANKING SI -2640 0,,,net_banking_transfer,-26400
64142ad1f8804aea72170dbb,50200023535069,1255979.95,60ec41ba55c00300382672d9,HDFC,direct expenses,5eecc6d6449e4f7cfb1c2708,2023-02-07T00:00:00.000Z,NEFT DR-KKBK0008066-KUSHAGRA SINGH-SANDO Z - MUM-N038232320100385-NET BANKING SI -46400,,,net_banking_transfer,-46400
64142ad1f8804aea72170dbd,50200023535069,1221629.95,60ec41ba55c00300382672d9,HDFC,direct expenses,5eecc6d6449e4f7cfb1c2708,2023-02-07T00:00:00.000Z,NEFT DR-SBIN0008079-DHARAMVEER-SANDOZ - MUM-N038232320100386-NET BANKING SI -343 50,,,net_banking_transfer,-34350
64142ad1f8804aea72170dc0,50200023535069,1202551.95,60ec41ba55c00300382672d9,HDFC,N-ACH payments,5eecc6d6449e4f7cfb1c2708,2023-02-07T00:00:00.000Z,NEFT DR-DBSS0IN0811-SACHIN SINGH-SANDOZ - MUM-N038232320100387-NET BANKING SI -1 9078,,,net_banking_transfer,-19078
64142ad1f8804aea72170dc2,50200023535069,1184381.95,60ec41ba55c00300382672d9,HDFC,direct expenses,5eecc6d6449e4f7cfb1c2708,2023-02-07T00:00:00.000Z,NEFT DR-PUNB0307800-SANJEEV NIRMANIA-SAN DOZ - MUM-N038232320100388-NET BANKING S I -18170,,,net_banking_transfer,-18170
64142ad1f8804aea72170dc4,50200023535069,1169118.95,60ec41ba55c00300382672d9,HDFC,direct expenses,5eecc6d6449e4f7cfb1c2708,2023-02-07T00:00:00.000Z,NEFT DR-CNRB0019016-MANEESH-SANDOZ - MUM -N038232320100389-NET BANKING SI -15263,,,net_banking_transfer,-15263
64142ad1f8804aea72170dc6,50200023535069,1153855.95,60ec41ba55c00300382672d9,HDFC,direct expenses,5eecc6d6449e4f7cfb1c2708,2023-02-07T00:00:00.000Z,NEFT DR-SCBL0036023-VIVEK YADAV-SANDOZ - MUM-N038232320100390-NET BANKING SI -15 263,,,net_banking_transfer,-15263
64142ad1f8804aea72170dc8,50200023535069,1151445.95,60ec41ba55c00300382672d9,HDFC,direct expenses,5eecc6d6449e4f7cfb1c2708,2023-02-07T00:00:00.000Z,NEFT DR-PUNB0307800-SANJEEV NIRMANIA-SAN DOZ - MUM-N038232320100391-NET BANKING S I -2410,,,net_banking_transfer,-2410
64142ad1f8804aea72170dca,50200023535069,1136182.95,60ec41ba55c00300382672d9,HDFC,direct expenses,5eecc6d6449e4f7cfb1c2708,2023-02-07T00:00:00.000Z,NEFT DR-SCBL0036028-SHUBHAM SINGH PANWAR -SANDOZ - MUM-N038232320100392-NET BANKI NG SI -15263,,,net_banking_transfer,-15263
64142ad1f8804aea72170dcc,50200023535069,1115340.95,60ec41ba55c00300382672d9,HDFC,direct expenses,5eecc6d6449e4f7cfb1c2708,2023-02-07T00:00:00.000Z,NEFT DR-KKBK0005032-DEEPAK YADAV-SANDOZ - MUM-N038232320100393-NET BANKING SI -2 0842,,,net_banking_transfer,-20842
64142ad1f8804aea72170dce,50200023535069,1095490.95,60ec41ba55c00300382672d9,HDFC,direct expenses,5eecc6d6449e4f7cfb1c2708,2023-02-07T00:00:00.000Z,NEFT DR-PUNB0494300-KUNDAN PRASAD-SANDOZ - MUM-N038232320100394-NET BANKING SI - 19850,,,net_banking_transfer,-19850
64142ad1f8804aea72170dd0,50200023535069,1076633.95,60ec41ba55c00300382672d9,HDFC,direct expenses,5eecc6d6449e4f7cfb1c2708,2023-02-07T00:00:00.000Z,NEFT DR-PUNB0151400-BHUWAN CHANDER JOSHI -SANDOZ - MUM-N038232320100395-NET BANKI NG SI -18857,,,net_banking_transfer,-18857
64142ad1f8804aea72170dd2,50200023535069,1057776.95,60ec41ba55c00300382672d9,HDFC,direct expenses,5eecc6d6449e4f7cfb1c2708,2023-02-07T00:00:00.000Z,NEFT DR-PUNB0MBGB06-MD ARIF RAZA-SANDOZ - MUM-N038232320100396-NET BANKING SI -1 8857,,,net_banking_transfer,-18857
64142ad1f8804aea72170dd4,50200023535069,1047468.95,60ec41ba55c00300382672d9,HDFC,agency/vendor expense,5eecc6d6449e4f7cfb1c2708,2023-02-07T00:00:00.000Z,NEFT DR-UTIB0003557-INCOSEC LEGAL-SANDOZ - MUM-N038232320100397-NET BANKING SI - 10308,,,net_banking_transfer,-10308
64142ad1f8804aea72170dd6,50200023535069,797468.95,60ec41ba55c00300382672d9,HDFC,direct expenses,5eecc6d6449e4f7cfb1c2708,2023-02-07T00:00:00.000Z,NEFT DR-ICIC0000369-BO INTERNATIONAL-SAN DOZ - MUM-N038232320100398-NET BANKING S I -250000,,,net_banking_transfer,-250000
64142ad1f8804aea72170dd8,50200023535069,697468.95,60ec41ba55c00300382672d9,HDFC,direct expenses,5eecc6d6449e4f7cfb1c2708,2023-02-07T00:00:00.000Z,NEFT DR-YESB0000551-VISTTA COSMETICS-SAN DOZ - MUM-N038232320100399-NET BANKING S I -100000,,,net_banking_transfer,-100000
64142ad1f8804aea72170ddb,50200023535069,634401.95,60ec41ba55c00300382672d9,HDFC,direct expenses,5eecc6d6449e4f7cfb1c2708,2023-02-07T00:00:00.000Z,NEFT DR-PUNB0150400-SAGARIKA DEBNATH-SA NDOZ - MUM-N038232320100400-NET BANKING SI -63067,,,net_banking_transfer,-63067
64142ad1f8804aea72170ddd,50200023535069,603334.95,60ec41ba55c00300382672d9,HDFC,direct expenses,5eecc6d6449e4f7cfb1c2708,2023-02-07T00:00:00.000Z,NEFT DR-KKBK0004266-NIDHI PANDEY-SANDOZ - MUM-N038232320100401-NET BANKING SI -3 1067,,,net_banking_transfer,-31067
64142ad1f8804aea72170ddf,50200023535069,589150.95,60ec41ba55c00300382672d9,HDFC,direct expenses,5eecc6d6449e4f7cfb1c2708,2023-02-07T00:00:00.000Z,NEFT DR-KKBK0004632-DOLLY JAIN-SANDOZ - MUM-N038232320100402-NET BANKING SI -141 84,,,net_banking_transfer,-14184
64142ad1f8804aea72170de1,50200023535069,573887.95,60ec41ba55c00300382672d9,HDFC,direct expenses,5eecc6d6449e4f7cfb1c2708,2023-02-07T00:00:00.000Z,NEFT DR-UBIN0919721-PINKU-SANDOZ - MUM-N 038232320100403-NET BANKING SI -15263,,,net_banking_transfer,-15263
64142ad1f8804aea72170de3,50200023535069,485487.95,60ec41ba55c00300382672d9,HDFC,direct expenses,5eecc6d6449e4f7cfb1c2708,2023-02-07T00:00:00.000Z,NEFT DR-IOBA0001445-PRIYANKA GOPAL-SANDO Z - MUM-N038232320100404-NET BANKING SI -88400,,,net_banking_transfer,-88400
64142ad1f8804aea72170de5,50200023535069,235387.95,60ec41ba55c00300382672d9,HDFC,direct expenses,5eecc6d6449e4f7cfb1c2708,2023-02-07T00:00:00.000Z,NEFT DR-ICIC0000369-BO INTERNATIONAL-SAN DOZ - MUM-N038232320100405-NET BANKING S I -250100,,,net_banking_transfer,-250100
64142ad1f8804aea72170de7,50200023535069,138187.95,60ec41ba55c00300382672d9,HDFC,direct expenses,5eecc6d6449e4f7cfb1c2708,2023-02-07T00:00:00.000Z,00321000085687-TPT-97200-SAMEER AHUJA,,,net_banking_transfer,-97200
64142ad1f8804aea72170de9,50200023535069,19387.95,60ec41ba55c00300382672d9,HDFC,direct expenses,5eecc6d6449e4f7cfb1c2708,2023-02-07T00:00:00.000Z,50200063349422-TPT-118800-COHORT E-COMME RCE CONSULTING LLP,,,net_banking_transfer,-118800
64142ad1f8804aea72170dec,50200023535069,20563.6,60ec41ba55c00300382672d9,HDFC,Revenue-PG-split enabled,5eecc6d6449e4f7cfb1c2708,2023-02-07T00:00:00.000Z,NEFT CR-UTIB0001506-RAZORPAY SOFTWARE PR IVATE LIMITED-SLICK ORGANICS PVT LITD-AX ISCN0206542343,,,net_banking_transfer,1175.65
64142ad1f8804aea72170dee,50200023535069,18050.6,60ec41ba55c00300382672d9,HDFC,direct expenses,5eecc6d6449e4f7cfb1c2708,2023-02-07T00:00:00.000Z,"NEFT DR-ICIC0001842-SOM SINGH-NETBANK, M UM-N038232320525716-2513",,,net_banking_transfer,-2513
64142ad1f8804aea72170df0,50200023535069,17401.6,60ec41ba55c00300382672d9,HDFC,direct expenses,5eecc6d6449e4f7cfb1c2708,2023-02-07T00:00:00.000Z,"NEFT DR-SBIN0020566-SAI MEGHANA-NETBANK, MUM-N038232320526200-649",,,net_banking_transfer,-649
64142ad1f8804aea72170df2,50200023535069,-1592.4,60ec41ba55c00300382672d9,HDFC,direct expenses,5eecc6d6449e4f7cfb1c2708,2023-02-07T00:00:00.000Z,01322000013526-TPT-18994-CLASSIC RACKS,,,net_banking_transfer,-18994
64142ad1f8804aea72170df4,50200023535069,-2115.26,60ec41ba55c00300382672d9,HDFC,Marketing Expense,5eecc6d6449e4f7cfb1c2708,2023-02-07T00:00:00.000Z,ME DC SI 514834XXXXXX9486 FACEBOOK SI,,,Other,-522.86
64142ad1f8804aea72170df6,50200023535069,-52115.26,60ec41ba55c00300382672d9,HDFC,Tax,5eecc6d6449e4f7cfb1c2708,2023-02-07T00:00:00.000Z,051030807022391823- CBDT TAX,,,Other,-50000
64142ad1f8804aea72170df8,50200023535069,-51576.7,60ec41ba55c00300382672d9,HDFC,Transfer in/Revenue-other,5eecc6d6449e4f7cfb1c2708,2023-02-07T00:00:00.000Z,NEFT CR-UTIB0000114-ONE SIGMA TECHNOLOGI ES PRIVATE LIM-SLICK ORGANICS PRIVATE LI MITED-AXISP00361076273,bnpl,,net_banking_transfer,538.56
64142ad1f8804aea72170dfa,50200023535069,-47982.7,60ec41ba55c00300382672d9,HDFC,Revenue-Mktplace,5eecc6d6449e4f7cfb1c2708,2023-02-07T00:00:00.000Z,IMPS-303814496400-DREAMPLUGPAYTECHSO-UTI B-XXXXXXXXXXX7853-,,,net_banking_transfer,3594
64142ad1f8804aea72170dfc,50200023535069,371811.18,60ec41ba55c00300382672d9,HDFC,Transfer in/Revenue-other,5eecc6d6449e4f7cfb1c2708,2023-02-07T00:00:00.000Z,RTGS CR-IDFB0010204-PCPL CENTRAL DISBURS EMENT AC-SLICK ORGANICS PRIVATE LIMITED- IDFBR52023020700526986,,,net_banking_transfer,419793.88
64142ad1f8804aea72170dfe,50200023535069,373135.18,60ec41ba55c00300382672d9,HDFC,Revenue-Mktplace,5eecc6d6449e4f7cfb1c2708,2023-02-07T00:00:00.000Z,NEFT CR-ICIC0000105-MANASH LIFETYLE PVT LTD-SLICK ORGANICS PRIVATE LIMITED-ICIB2 30380072590,,,net_banking_transfer,1324
64142ad1f8804aea72170e00,50200023535069,375449.42,60ec41ba55c00300382672d9,HDFC,Revenue-PG-split enabled,5eecc6d6449e4f7cfb1c2708,2023-02-07T00:00:00.000Z,NEFT CR-UTIB0001506-RAZORPAY SOFTWARE PR IVATE LIMITED-SLICK ORGANICS PVT LITD-AX ISCN0206762404,,,net_banking_transfer,2314.24
64142ad1f8804aea72170e02,50200023535069,377966.61,60ec41ba55c00300382672d9,HDFC,Transfer in/Revenue-other,5eecc6d6449e4f7cfb1c2708,2023-02-08T00:00:00.000Z,IMPS-303904875099-EXCRO PAY ESCROW ACC-Y ESB-XXXXXXXXXXX1807-333112298023,,,net_banking_transfer,2517.19
64142ad1f8804aea72170e04,50200023535069,268790.61,60ec41ba55c00300382672d9,HDFC,direct expenses,5eecc6d6449e4f7cfb1c2708,2023-02-08T00:00:00.000Z,00921000075586 NET BANKING SI -109176,,,Other,-109176
64142ad1f8804aea72170e06,50200023535069,222580.61,60ec41ba55c00300382672d9,HDFC,direct expenses,5eecc6d6449e4f7cfb1c2708,2023-02-08T00:00:00.000Z,NEFT DR-KKBK0000187-APPLIED LIFE PRIVATE LIMITED-SANDOZ - MUM-N039232322467237-N ET BANKING SI -46210,,,net_banking_transfer,-46210
64142ad1f8804aea72170e08,50200023535069,226837.34,60ec41ba55c00300382672d9,HDFC,Transfer in/Revenue-other,5eecc6d6449e4f7cfb1c2708,2023-02-08T00:00:00.000Z,IMPS-303907913831-EXCRO PAY ESCROW ACC-Y ESB-XXXXXXXXXXX1807-333112298023,,,net_banking_transfer,4256.73
64142ad1f8804aea72170e0a,50200023535069,211837.34,60ec41ba55c00300382672d9,HDFC,direct expenses,5eecc6d6449e4f7cfb1c2708,2023-02-08T00:00:00.000Z,"NEFT DR-ICIC0006956-LAKSHAY CARRYING COR PORATION-NETBANK, MUM-N039232322807955-1",,,net_banking_transfer,-15000
64142ad1f8804aea72170e0c,50200023535069,214835.09,60ec41ba55c00300382672d9,HDFC,Revenue-Mktplace,5eecc6d6449e4f7cfb1c2708,2023-02-08T00:00:00.000Z,NEFT CR-DEUT0797BGL-MYNTRA DESIGNS PRIVA TE LIMITED-SLICK ORGANICS - SJIT-3039009 01GN00238,shopping,,net_banking_transfer,2997.75
64142ad2f8804aea72170e0e,50200023535069,215285.81,60ec41ba55c00300382672d9,HDFC,Revenue-Mktplace,5eecc6d6449e4f7cfb1c2708,2023-02-08T00:00:00.000Z,NEFT CR-DEUT0797BGL-MYNTRA DESIGNS PRIVA TE LIMITED-SLICK ORGANICS PVT. LTD.-3039 00912GN00284,shopping,,net_banking_transfer,450.72
64142ad2f8804aea72170e11,50200023535069,216010.87,60ec41ba55c00300382672d9,HDFC,Revenue-PG-split enabled,5eecc6d6449e4f7cfb1c2708,2023-02-08T00:00:00.000Z,NEFT CR-UTIB0001506-RAZORPAY SOFTWARE PR IVATE LIMITED-SLICK ORGANICS PVT LITD-AX ISCN0207007612,,,net_banking_transfer,725.06
64142ad2f8804aea72170e13,50200023535069,235962.87,60ec41ba55c00300382672d9,HDFC,Transfer in/Revenue-other,5eecc6d6449e4f7cfb1c2708,2023-02-08T00:00:00.000Z,NEFT CR-HSBC0560002-INNOVATIVE RETAIL CO NCEPTS PRIVATE-SLICK ORGANICS PVT LTD-HS BCN23039371216,,,net_banking_transfer,19952
64142ad2f8804aea72170e15,50200023535069,243948.47,60ec41ba55c00300382672d9,HDFC,Revenue-Mktplace,5eecc6d6449e4f7cfb1c2708,2023-02-08T00:00:00.000Z,IMPS-303914413522-DREAMPLUGPAYTECHSO-UTI B-XXXXXXXXXXX7853-,,,net_banking_transfer,7985.6
64142ad2f8804aea72170e17,50200023535069,288547.93,60ec41ba55c00300382672d9,HDFC,Revenue-COD,5eecc6d6449e4f7cfb1c2708,2023-02-08T00:00:00.000Z,NEFT CR-ICIC0000155-SHIPROCKET COD CRF I D 5686961-SLICK ORGANICS PVT LTD-CMS3110 506248,,,net_banking_transfer,44599.46
64142ad2f8804aea72170e19,50200023535069,289759.49,60ec41ba55c00300382672d9,HDFC,Transfer in/Revenue-other,5eecc6d6449e4f7cfb1c2708,2023-02-08T00:00:00.000Z,NEFT CR-UTIB0000114-ONE SIGMA TECHNOLOGI ES PRIVATE LIM-SLICK ORGANICS PRIVATE LI MITED-AXISP00361630136,bnpl,,net_banking_transfer,1211.56
64142ad2f8804aea72170e1b,50200023535069,295137.49,60ec41ba55c00300382672d9,HDFC,Revenue-Mktplace,5eecc6d6449e4f7cfb1c2708,2023-02-08T00:00:00.000Z,NEFT CR-ICIC0000105-MANASH LIFETYLE PVT LTD-SLICK ORGANICS PRIVATE LIMITED-ICIB2 30390034099,,,net_banking_transfer,5378
64142ad2f8804aea72170e1d,50200023535069,392531.7,60ec41ba55c00300382672d9,HDFC,Transfer in/Revenue-other,5eecc6d6449e4f7cfb1c2708,2023-02-08T00:00:00.000Z,NEFT CR-YESB0000001-EASEBUZZ PVT LTD NOD AL A/C-SLICK ORGANICS PVT LTD-YESB303926 07826,,,net_banking_transfer,97394.21
64142ad2f8804aea72170e1f,50200023535069,393056.35,60ec41ba55c00300382672d9,HDFC,Revenue-PG-split enabled,5eecc6d6449e4f7cfb1c2708,2023-02-08T00:00:00.000Z,NEFT CR-UTIB0001506-RAZORPAY SOFTWARE PR IVATE LIMITED-SLICK ORGANICS PVT LITD-AX ISCN0207200628,,,net_banking_transfer,524.65
64142ad2f8804aea72170e21,50200023535069,392890.9,60ec41ba55c00300382672d9,HDFC,bank charges,5eecc6d6449e4f7cfb1c2708,2023-02-08T00:00:00.000Z,.DC INTL POS TXN MARKUP+ST 120123 140123 -CDT2303914075221,,,international_transaction_arbitrage,-165.45
64142ad2f8804aea72170e23,50200023535069,483422.16,60ec41ba55c00300382672d9,HDFC,Transfer in/Revenue-other,5eecc6d6449e4f7cfb1c2708,2023-02-08T00:00:00.000Z,NEFT CR-YESB0000001-EASEBUZZ PVT LTD NOD AL A/C-SLICK ORGANICS PVT LTD-YESB303926 80342,,,net_banking_transfer,90531.26
64142ad2f8804aea72170e25,50200023535069,366814.16,60ec41ba55c00300382672d9,HDFC,Salary/Emp/consultant Expense,5eecc6d6449e4f7cfb1c2708,2023-02-08T00:00:00.000Z,2041495368/EPFO,,,Other,-116608
64142ad2f8804aea72170e27,50200023535069,358524.16,60ec41ba55c00300382672d9,HDFC,direct expenses,5eecc6d6449e4f7cfb1c2708,2023-02-08T00:00:00.000Z,02023104642075/ESIC,,,Other,-8290
64142ad2f8804aea72170e29,50200023535069,352123.16,60ec41ba55c00300382672d9,HDFC,direct expenses,5eecc6d6449e4f7cfb1c2708,2023-02-08T00:00:00.000Z,"NEFT DR-KKBK0005619-VIKASH KUMAR-NETBANK , MUM-N039232324541568-6401",,,net_banking_transfer,-6401
64142ad2f8804aea72170e2b,50200023535069,152123.16,60ec41ba55c00300382672d9,HDFC,direct expenses,5eecc6d6449e4f7cfb1c2708,2023-02-08T00:00:00.000Z,POS 514834XXXXXX9486 E-COMMERCE RP,,,debit_card,-200000
64142ad2f8804aea72170e2d,50200023535069,154864.25,60ec41ba55c00300382672d9,HDFC,Transfer in/Revenue-other,5eecc6d6449e4f7cfb1c2708,2023-02-09T00:00:00.000Z,IMPS-304004724475-EXCRO PAY ESCROW ACC-Y ESB-XXXXXXXXXXX1807-333112298023,,,net_banking_transfer,2741.09
64142ad2f8804aea72170e2f,50200023535069,46864.25,60ec41ba55c00300382672d9,HDFC,direct expenses,5eecc6d6449e4f7cfb1c2708,2023-02-09T00:00:00.000Z,50200054531492 NET BANKING SI -108000,,,Other,-108000
64142ad2f8804aea72170e31,50200023535069,-203135.75,60ec41ba55c00300382672d9,HDFC,direct expenses,5eecc6d6449e4f7cfb1c2708,2023-02-09T00:00:00.000Z,NEFT DR-ICIC0000369-BO INTERNATIONAL-SAN DOZ - MUM-N040232324661728-NET BANKING S I -250000,,,net_banking_transfer,-250000
64142ad2f8804aea72170e33,50200023535069,-202316.26,60ec41ba55c00300382672d9,HDFC,Revenue-PG-split enabled,5eecc6d6449e4f7cfb1c2708,2023-02-09T00:00:00.000Z,NEFT CR-UTIB0001506-RAZORPAY SOFTWARE PR IVATE LIMITED-SLICK ORGANICS PVT LITD-AX ISCN0207424169,,,net_banking_transfer,819.49
64142ad2f8804aea72170e35,50200023535069,-237956.26,60ec41ba55c00300382672d9,HDFC,direct expenses,5eecc6d6449e4f7cfb1c2708,2023-02-09T00:00:00.000Z,"NEFT DR-UTIB0004445-BUZZLER DIGITAL-NETB ANK, MUM-N040232324946938-35640",,,net_banking_transfer,-35640
64142ad2f8804aea72170e37,50200023535069,-231718.07,60ec41ba55c00300382672d9,HDFC,Transfer in/Revenue-other,5eecc6d6449e4f7cfb1c2708,2023-02-09T00:00:00.000Z,NEFT CR-UTIB0000114-ONE SIGMA TECHNOLOGI ES PRIVATE LIM-SLICK ORGANICS PRIVATE LI MITED-AXISP00361904546,bnpl,,net_banking_transfer,6238.19
64142ad2f8804aea72170e39,50200023535069,-227893.07,60ec41ba55c00300382672d9,HDFC,Revenue-Mktplace,5eecc6d6449e4f7cfb1c2708,2023-02-09T00:00:00.000Z,NEFT CR-ICIC0000105-MANASH LIFETYLE PVT LTD-SLICK ORGANICS PRIVATE LIMITED-ICIB2 30400033822,,,net_banking_transfer,3825
64142ad2f8804aea72170e3b,50200023535069,-228020.07,60ec41ba55c00300382672d9,HDFC,direct expenses,5eecc6d6449e4f7cfb1c2708,2023-02-09T00:00:00.000Z,POS 514834XXXXXX9486 PTM*PAYTM WALLET,ewallet,,debit_card,-127
64142ad2f8804aea72170e3d,50200023535069,-226189.33,60ec41ba55c00300382672d9,HDFC,Revenue-PG-split enabled,5eecc6d6449e4f7cfb1c2708,2023-02-09T00:00:00.000Z,NEFT CR-UTIB0001506-RAZORPAY SOFTWARE PR IVATE LIMITED-SLICK ORGANICS PVT LITD-AX ISCN0207620188,,,net_banking_transfer,1830.74
64142ad2f8804aea72170e3f,50200023535069,-153757.62,60ec41ba55c00300382672d9,HDFC,Transfer in/Revenue-other,5eecc6d6449e4f7cfb1c2708,2023-02-09T00:00:00.000Z,NEFT CR-YESB0000001-EASEBUZZ PVT LTD NOD AL A/C-SLICK ORGANICS PVT LTD-YESB304060 71289,,,net_banking_transfer,72431.71
64142ad2f8804aea72170e41,50200023535069,-152961.62,60ec41ba55c00300382672d9,HDFC,Transfer in/Revenue-other,5eecc6d6449e4f7cfb1c2708,2023-02-10T00:00:00.000Z,INT. ON SWCR ON-50300720580141,,,Other,796
64142ad2f8804aea72170e43,50200023535069,796.38,60ec41ba55c00300382672d9,HDFC,Loan-in,5eecc6d6449e4f7cfb1c2708,2023-02-10T00:00:00.000Z,SWEEP-IN CREDIT - 50300720580141,,,self_transfer,153758
64142ad2f8804aea72170e45,50200023535069,19359.38,60ec41ba55c00300382672d9,HDFC,Transfer in/Revenue-other,5eecc6d6449e4f7cfb1c2708,2023-02-10T00:00:00.000Z,FT- REMITTANCE OG JAN 23-50200050675669 - HOUZ OF NATURE PVT LTD -,,,Other,18563
64142ad2f8804aea72170e47,50200023535069,21143.75,60ec41ba55c00300382672d9,HDFC,Transfer in/Revenue-other,5eecc6d6449e4f7cfb1c2708,2023-02-10T00:00:00.000Z,IMPS-304105879855-EXCRO PAY ESCROW ACC-Y ESB-XXXXXXXXXXX1807-333112298023,,,net_banking_transfer,1784.37
64142ad2f8804aea72170e49,50200023535069,-13902.25,60ec41ba55c00300382672d9,HDFC,direct expenses,5eecc6d6449e4f7cfb1c2708,2023-02-10T00:00:00.000Z,NEFT DR-PUNB0062910-YADAVPACKAGING-SANDO Z - MUM-N041232326344991-NET BANKING SI -35046,,,net_banking_transfer,-35046
64142ad2f8804aea72170e4b,50200023535069,-9185.71,60ec41ba55c00300382672d9,HDFC,Transfer in/Revenue-other,5eecc6d6449e4f7cfb1c2708,2023-02-10T00:00:00.000Z,IMPS-304107937544-EXCRO PAY ESCROW ACC-Y ESB-XXXXXXXXXXX1807-333112298023,,,net_banking_transfer,4716.54
64142ad2f8804aea72170e4d,50200023535069,-5078.22,60ec41ba55c00300382672d9,HDFC,Revenue-Mktplace,5eecc6d6449e4f7cfb1c2708,2023-02-10T00:00:00.000Z,NEFT CR-DEUT0797BGL-MYNTRA DESIGNS PRIVA TE LIMITED-SLICK ORGANICS - SJIT-3041010 38GN00147,shopping,,net_banking_transfer,4107.49
64142ad2f8804aea72170e4f,50200023535069,-4169.77,60ec41ba55c00300382672d9,HDFC,Revenue-Mktplace,5eecc6d6449e4f7cfb1c2708,2023-02-10T00:00:00.000Z,NEFT CR-DEUT0797BGL-MYNTRA DESIGNS PRIVA TE LIMITED-SLICK ORGANICS PVT. LTD.-3041 01057GN00239,shopping,,net_banking_transfer,908.45
64142ad2f8804aea72170e51,50200023535069,-2214.09,60ec41ba55c00300382672d9,HDFC,Revenue-PG-split enabled,5eecc6d6449e4f7cfb1c2708,2023-02-10T00:00:00.000Z,NEFT CR-UTIB0001506-RAZORPAY SOFTWARE PR IVATE LIMITED-SLICK ORGANICS PVT LITD-AX ISCN0207876399,,,net_banking_transfer,1955.68
64142ad2f8804aea72170e53,50200023535069,-2213.09,60ec41ba55c00300382672d9,HDFC,Transfer in/Revenue-other,5eecc6d6449e4f7cfb1c2708,2023-02-10T00:00:00.000Z,IMPS-304127028475-APIBANKING-RATN-XXXXXX XXXXXX0168-ACCOUNTVALIDATION,,,net_banking_transfer,1
64142ad2f8804aea72170e55,50200023535069,3102.91,60ec41ba55c00300382672d9,HDFC,Transfer in/Revenue-other,5eecc6d6449e4f7cfb1c2708,2023-02-10T00:00:00.000Z,NEFT CR-HSBC0110002-NAPSA PRIVATE LIMITE D-SLICK ORGANICS PVT. LTD.-HSBCN23041792 746,,,net_banking_transfer,5316
64142ad2f8804aea72170e57,50200023535069,5792.91,60ec41ba55c00300382672d9,HDFC,Revenue-Mktplace,5eecc6d6449e4f7cfb1c2708,2023-02-10T00:00:00.000Z,IMPS-304114258396-DREAMPLUGPAYTECHSO-UTI B-XXXXXXXXXXX7853-,,,net_banking_transfer,2690
64142ad2f8804aea72170e59,50200023535069,115085.79,60ec41ba55c00300382672d9,HDFC,Revenue-COD,5eecc6d6449e4f7cfb1c2708,2023-02-10T00:00:00.000Z,NEFT CR-ICIC0000155-SHIPROCKET COD CRF I D 5699276-SLICK ORGANICS PVT LTD-CMS3115 215077,,,net_banking_transfer,109292.88
64142ad2f8804aea72170e5b,50200023535069,130339.75,60ec41ba55c00300382672d9,HDFC,Transfer in/Revenue-other,5eecc6d6449e4f7cfb1c2708,2023-02-10T00:00:00.000Z,NEFT CR-SCBL0036001-HEALTH GLOW PRIVATE LIMITED-SLICK ORGANICS PVT LTD-ARATA-IN,,,net_banking_transfer,15253.96
64142ad2f8804aea72170e5d,50200023535069,132608.53,60ec41ba55c00300382672d9,HDFC,Transfer in/Revenue-other,5eecc6d6449e4f7cfb1c2708,2023-02-10T00:00:00.000Z,NEFT CR-UTIB0000114-ONE SIGMA TECHNOLOGI ES PRIVATE LIM-SLICK ORGANICS PRIVATE LI MITED-AXISP00362298284,bnpl,,net_banking_transfer,2268.78
64142ad2f8804aea72170e5f,50200023535069,133830.53,60ec41ba55c00300382672d9,HDFC,Revenue-Mktplace,5eecc6d6449e4f7cfb1c2708,2023-02-10T00:00:00.000Z,NEFT CR-ICIC0000105-MANASH LIFETYLE PVT LTD-SLICK ORGANICS PRIVATE LIMITED-ICIB2 30410047027,,,net_banking_transfer,1222
64142ad2f8804aea72170e61,50200023535069,137378.53,60ec41ba55c00300382672d9,HDFC,cash/cheque deposit/transfer in,5eecc6d6449e4f7cfb1c2708,2023-02-10T00:00:00.000Z,CHQ DEP - MICR CLG - DUGARI: STATE BANK OF INDIA :STATE BANK OF INDIA,,,chq,3548
64142ad2f8804aea72170e63,50200023535069,208414.69,60ec41ba55c00300382672d9,HDFC,Transfer in/Revenue-other,5eecc6d6449e4f7cfb1c2708,2023-02-10T00:00:00.000Z,NEFT CR-YESB0000001-EASEBUZZ PVT LTD NOD AL A/C-SLICK ORGANICS PVT LTD-YESB304191 80924,,,net_banking_transfer,71036.16
64142ad2f8804aea72170e65,50200023535069,209677.85,60ec41ba55c00300382672d9,HDFC,Revenue-PG-split enabled,5eecc6d6449e4f7cfb1c2708,2023-02-10T00:00:00.000Z,NEFT CR-UTIB0001506-RAZORPAY SOFTWARE PR IVATE LIMITED-SLICK ORGANICS PVT LITD-AX ISCN0208084129,,,net_banking_transfer,1263.16
64142ad2f8804aea72170e67,50200023535069,210868.78,60ec41ba55c00300382672d9,HDFC,Transfer in/Revenue-other,5eecc6d6449e4f7cfb1c2708,2023-02-10T00:00:00.000Z,NEFT CR-YESB0000001-EASEBUZZ PVT LTD NOD AL A/C-SLICK ORGANICS PVT LTD-YESB304193 57699,,,net_banking_transfer,1190.93
64142ad2f8804aea72170e69,50200023535069,213570,60ec41ba55c00300382672d9,HDFC,Transfer in/Revenue-other,5eecc6d6449e4f7cfb1c2708,2023-02-11T00:00:00.000Z,IMPS-304204930873-EXCRO PAY ESCROW ACC-Y ESB-XXXXXXXXXXX1807-333112298023,,,net_banking_transfer,2701.22
64142ad2f8804aea72170e6b,50200023535069,212229.64,60ec41ba55c00300382672d9,HDFC,Marketing Expense,5eecc6d6449e4f7cfb1c2708,2023-02-11T00:00:00.000Z,ME DC SI 514834XXXXXX9486 LINKEDIN (PGSI ),,,Other,-1340.36
64142ad2f8804aea72170e6e,50200023535069,213884.15,60ec41ba55c00300382672d9,HDFC,Transfer in/Revenue-other,5eecc6d6449e4f7cfb1c2708,2023-02-12T00:00:00.000Z,IMPS-304305663100-EXCRO PAY ESCROW ACC-Y ESB-XXXXXXXXXXX1807-333112298023,,,net_banking_transfer,1654.51
64142ad2f8804aea72170e70,50200023535069,211855.15,60ec41ba55c00300382672d9,HDFC,direct expenses,5eecc6d6449e4f7cfb1c2708,2023-02-12T00:00:00.000Z,ME DC SI 514834XXXXXX9486 ADOBE SYSTEMS SOFTWARE,,,Other,-2029
64142ad2f8804aea72170e72,50200023535069,206899.15,60ec41ba55c00300382672d9,HDFC,Marketing Expense,5eecc6d6449e4f7cfb1c2708,2023-02-12T00:00:00.000Z,ME DC SI 514834XXXXXX9486 FACEBOOK INDIA ONLINE,,,Other,-4956
64142ad2f8804aea72170e74,50200023535069,209021.19,60ec41ba55c00300382672d9,HDFC,Transfer in/Revenue-other,5eecc6d6449e4f7cfb1c2708,2023-02-13T00:00:00.000Z,IMPS-304404714800-EXCRO PAY ESCROW ACC-Y ESB-XXXXXXXXXXX1807-333112298023,,,net_banking_transfer,2122.04
64142ad2f8804aea72170e76,50200023535069,215443.58,60ec41ba55c00300382672d9,HDFC,Transfer in/Revenue-other,5eecc6d6449e4f7cfb1c2708,2023-02-13T00:00:00.000Z,IMPS-304407771877-EXCRO PAY ESCROW ACC-Y ESB-XXXXXXXXXXX1807-333112298023,,,net_banking_transfer,6422.39
64142ad2f8804aea72170e78,50200023535069,273747.41,60ec41ba55c00300382672d9,HDFC,Transfer in/Revenue-other,5eecc6d6449e4f7cfb1c2708,2023-02-13T00:00:00.000Z,NEFT CR-UTIB0000020-EMIZA SUPPLY CHAIN S ERVICES PRIVAT-SLICK ORGANICS PRIVATE LI MITED-AXISP00362548755,,,net_banking_transfer,58303.83
64142ad2f8804aea72170e7a,50200023535069,280572.92,60ec41ba55c00300382672d9,HDFC,Revenue-Mktplace,5eecc6d6449e4f7cfb1c2708,2023-02-13T00:00:00.000Z,NEFT CR-DEUT0797BGL-MYNTRA DESIGNS PRIVA TE LIMITED-SLICK ORGANICS - SJIT-3044011 09GN00061,shopping,,net_banking_transfer,6825.51
64142ad2f8804aea72170e7c,50200023535069,281214.06,60ec41ba55c00300382672d9,HDFC,Revenue-Mktplace,5eecc6d6449e4f7cfb1c2708,2023-02-13T00:00:00.000Z,NEFT CR-DEUT0797BGL-MYNTRA DESIGNS PRIVA TE LIMITED-SLICK ORGANICS PVT. LTD.-3044 01140GN00031,shopping,,net_banking_transfer,641.14
64142ad3f8804aea72170e7e,50200023535069,284936.81,60ec41ba55c00300382672d9,HDFC,Revenue-PG-split enabled,5eecc6d6449e4f7cfb1c2708,2023-02-13T00:00:00.000Z,NEFT CR-UTIB0001506-RAZORPAY SOFTWARE PR IVATE LIMITED-SLICK ORGANICS PVT LITD-AX ISCN0208788599,,,net_banking_transfer,3722.75
64142ad3f8804aea72170e80,50200023535069,304005.81,60ec41ba55c00300382672d9,HDFC,Revenue-Mktplace,5eecc6d6449e4f7cfb1c2708,2023-02-13T00:00:00.000Z,IMPS-304414223919-DREAMPLUGPAYTECHSO-UTI B-XXXXXXXXXXX7853-,,,net_banking_transfer,19069
64142ad3f8804aea72170e82,50200023535069,472474.92,60ec41ba55c00300382672d9,HDFC,Transfer in/Revenue-other,5eecc6d6449e4f7cfb1c2708,2023-02-13T00:00:00.000Z,NEFT CR-YESB0000001-EASEBUZZ PVT LTD NOD AL A/C-SLICK ORGANICS PVT LTD-YESB304482 39236,,,net_banking_transfer,168469.11
64142ad3f8804aea72170e84,50200023535069,473609.31,60ec41ba55c00300382672d9,HDFC,Transfer in/Revenue-other,5eecc6d6449e4f7cfb1c2708,2023-02-13T00:00:00.000Z,NEFT CR-UTIB0000114-ONE SIGMA TECHNOLOGI ES PRIVATE LIM-SLICK ORGANICS PRIVATE LI MITED-AXISP00362750567,bnpl,,net_banking_transfer,1134.39
64142ad3f8804aea72170e86,50200023535069,478146.87,60ec41ba55c00300382672d9,HDFC,Transfer in/Revenue-other,5eecc6d6449e4f7cfb1c2708,2023-02-13T00:00:00.000Z,NEFT CR-UTIB0000114-ONE SIGMA TECHNOLOGI ES PRIVATE LIM-SLICK ORGANICS PRIVATE LI MITED-AXISP00362750502,bnpl,,net_banking_transfer,4537.56
64142ad3f8804aea72170e88,50200023535069,480839.86,60ec41ba55c00300382672d9,HDFC,Transfer in/Revenue-other,5eecc6d6449e4f7cfb1c2708,2023-02-13T00:00:00.000Z,NEFT CR-UTIB0000114-ONE SIGMA TECHNOLOGI ES PRIVATE LIM-SLICK ORGANICS PRIVATE LI MITED-AXISP00362750519,bnpl,,net_banking_transfer,2692.99
64142ad3f8804aea72170e8b,50200023535069,754303.42,60ec41ba55c00300382672d9,HDFC,Revenue-COD,5eecc6d6449e4f7cfb1c2708,2023-02-13T00:00:00.000Z,NEFT CR-ICIC0000155-SHIPROCKET COD CRF I D 5707534-SLICK ORGANICS PVT LTD-CMS3119 396376,,,net_banking_transfer,273463.56
64142ad3f8804aea72170e8d,50200023535069,754750.42,60ec41ba55c00300382672d9,HDFC,Transfer in/Revenue-other,5eecc6d6449e4f7cfb1c2708,2023-02-13T00:00:00.000Z,NEFT CR-SCBL0036001-HEALTH GLOW PRIVATE LIMITED-SLICK ORGANICS PVT LTD-ARATA-IN 1ON23021301WA8,,,net_banking_transfer,447
64142ad3f8804aea72170e91,50200023535069,760244.24,60ec41ba55c00300382672d9,HDFC,Transfer in/Revenue-other,5eecc6d6449e4f7cfb1c2708,2023-02-13T00:00:00.000Z,NEFT CR-SCBL0036001-HEALTH GLOW PRIVATE LIMITED-SLICK ORGANICS PVT LTD-ARATA-IN 1ON23021301WAO,,,net_banking_transfer,5493.82
64142ad3f8804aea72170e93,50200023535069,762879.79,60ec41ba55c00300382672d9,HDFC,Transfer in/Revenue-other,5eecc6d6449e4f7cfb1c2708,2023-02-13T00:00:00.000Z,NEFT CR-SCBL0036001-HEALTH GLOW PRIVATE LIMITED-SLICK ORGANICS PVT LTD-ARATA-IN 1ON23021301WD2,,,net_banking_transfer,2635.55
64142ad3f8804aea72170e95,50200023535069,750547.79,60ec41ba55c00300382672d9,HDFC,direct expenses,5eecc6d6449e4f7cfb1c2708,2023-02-13T00:00:00.000Z,50100110669502-TPT-12332-VRITI MALHOTRA,,,net_banking_transfer,-12332
64142ad3f8804aea72170e97,50200023535069,740060.79,60ec41ba55c00300382672d9,HDFC,direct expenses,5eecc6d6449e4f7cfb1c2708,2023-02-13T00:00:00.000Z,"NEFT DR-CITI0000002-OMG NETWORK INDIA PR IVATE LIMITED-NETBANK, MUM-N044232330493 680-10487",,,net_banking_transfer,-10487
64142ad3f8804aea72170e9a,50200023535069,798812.34,60ec41ba55c00300382672d9,HDFC,Transfer in/Revenue-other,5eecc6d6449e4f7cfb1c2708,2023-02-13T00:00:00.000Z,NEFT CR-YESB0000001-EASEBUZZ PVT LTD NOD AL A/C-SLICK ORGANICS PVT LTD-YESB304485 54496,,,net_banking_transfer,58751.55
64142ad3f8804aea72170e9c,50200023535069,740034.34,60ec41ba55c00300382672d9,HDFC,direct expenses,5eecc6d6449e4f7cfb1c2708,2023-02-13T00:00:00.000Z,50200076217337-TPT-58778-MARKETING MANTR A SOLUTIONS,,,net_banking_transfer,-58778
64142ad3f8804aea72170e9e,50200023535069,740887.78,60ec41ba55c00300382672d9,HDFC,Revenue-PG-split enabled,5eecc6d6449e4f7cfb1c2708,2023-02-13T00:00:00.000Z,NEFT CR-UTIB0001506-RAZORPAY SOFTWARE PR IVATE LIMITED-SLICK ORGANICS PVT LITD-AX ISCN0209021463,,,net_banking_transfer,853.44
64142ad3f8804aea72170ea0,50200023535069,744836.78,60ec41ba55c00300382672d9,HDFC,Revenue-Mktplace,5eecc6d6449e4f7cfb1c2708,2023-02-13T00:00:00.000Z,NEFT CR-ICIC0000105-MANASH LIFETYLE PVT LTD-SLICK ORGANICS PRIVATE LIMITED-ICIB2 30440015223,,,net_banking_transfer,3949
64142ad3f8804aea72170ea2,50200023535069,726065.78,60ec41ba55c00300382672d9,HDFC,direct expenses,5eecc6d6449e4f7cfb1c2708,2023-02-14T00:00:00.000Z,NEFT DR-ICIC0003431-WAVICLE TECHNOLOGIES PVT LTD-SANDOZ - MUM-N045232330956424-N ET BANKING SI -18771,,,net_banking_transfer,-18771
64142ad3f8804aea72170ea4,50200023535069,704493.78,60ec41ba55c00300382672d9,HDFC,direct expenses,5eecc6d6449e4f7cfb1c2708,2023-02-14T00:00:00.000Z,NEFT DR-ICIC0003431-WAVICLE TECHNOLOGIES PVT LTD-SANDOZ - MUM-N045232330956426-N ET BANKING SI -21572,,,net_banking_transfer,-21572
64142ad3f8804aea72170ea6,50200023535069,449493.78,60ec41ba55c00300382672d9,HDFC,direct expenses,5eecc6d6449e4f7cfb1c2708,2023-02-14T00:00:00.000Z,NEFT DR-ICIC0000004-MUKESH GOYAL-SANDOZ - MUM-N045232330956428-NET BANKING SI -2 55000,,,net_banking_transfer,-255000
64142ad3f8804aea72170ea8,50200023535069,199493.78,60ec41ba55c00300382672d9,HDFC,direct expenses,5eecc6d6449e4f7cfb1c2708,2023-02-14T00:00:00.000Z,NEFT DR-ICIC0000369-BO INTERNATIONAL-SAN DOZ - MUM-N045232330956430-NET BANKING S,,,net_banking_transfer,-250000
64142ad3f8804aea72170eaa,50200023535069,99493.78,60ec41ba55c00300382672d9,HDFC,direct expenses,5eecc6d6449e4f7cfb1c2708,2023-02-14T00:00:00.000Z,NEFT DR-YESB0000551-VISTTA COSMETICS-SAN DOZ - MUM-N045232330956433-NET BANKING S I -100000,,,net_banking_transfer,-100000
64142ad3f8804aea72170eac,50200023535069,99669.59,60ec41ba55c00300382672d9,HDFC,Transfer in/Revenue-other,5eecc6d6449e4f7cfb1c2708,2023-02-14T00:00:00.000Z,NEFT CR-SCBL0036001-AXELIA SOLUTIONS PRI VATE LIMITED-SLICK ORGANICS PVT LTD-IN1O N230213036NY,,,net_banking_transfer,175.81
64142ad3f8804aea72170eae,50200023535069,51069.59,60ec41ba55c00300382672d9,HDFC,direct expenses,5eecc6d6449e4f7cfb1c2708,2023-02-14T00:00:00.000Z,"NEFT DR-CNRB0015170-SNEHAL TAYDE-NETBANK , MUM-N045232331214005-48600",,,net_banking_transfer,-48600
64142ad3f8804aea72170eb0,50200023535069,52229.64,60ec41ba55c00300382672d9,HDFC,Transfer in/Revenue-other,5eecc6d6449e4f7cfb1c2708,2023-02-14T00:00:00.000Z,NEFT CR-YESB0000001-EXCRO PAY ESCROW ACC OUNT-SLICKORGANICSPRIVATELIMITED-YESB304 51606369,,,net_banking_transfer,1160.05
64142ad3f8804aea72170eb2,50200023535069,53678.44,60ec41ba55c00300382672d9,HDFC,Revenue-PG-split enabled,5eecc6d6449e4f7cfb1c2708,2023-02-14T00:00:00.000Z,NEFT CR-UTIB0001506-RAZORPAY SOFTWARE PR IVATE LIMITED-SLICK ORGANICS PVT LITD-AX ISCN0209124344,,,net_banking_transfer,1448.8
64142ad3f8804aea72170eb4,50200023535069,51899.87,60ec41ba55c00300382672d9,HDFC,direct expenses,5eecc6d6449e4f7cfb1c2708,2023-02-14T00:00:00.000Z,POS 514834XXXXXX9486 PAYTM PAYMENTS S,ewallet,,debit_card,-1778.57
64142ad3f8804aea72170eb6,50200023535069,51588.87,60ec41ba55c00300382672d9,HDFC,direct expenses,5eecc6d6449e4f7cfb1c2708,2023-02-14T00:00:00.000Z,POS 514834XXXXXX9486 PAYTM PAYMENTS S,ewallet,,debit_card,-311
64142ad3f8804aea72170eb8,50200023535069,54146.87,60ec41ba55c00300382672d9,HDFC,Revenue-Mktplace,5eecc6d6449e4f7cfb1c2708,2023-02-14T00:00:00.000Z,NEFT CR-ICIC0000105-MANASH LIFETYLE PVT LTD-SLICK ORGANICS PRIVATE LIMITED-ICIB2 30450011117,,,net_banking_transfer,2558
64142ad3f8804aea72170eba,50200023535069,57739.87,60ec41ba55c00300382672d9,HDFC,Revenue-Mktplace,5eecc6d6449e4f7cfb1c2708,2023-02-14T00:00:00.000Z,IMPS-304514590349-DREAMPLUGPAYTECHSO-UTI B-XXXXXXXXXXX7853-,,,net_banking_transfer,3593
64142ad3f8804aea72170ebc,50200023535069,61094.74,60ec41ba55c00300382672d9,HDFC,Transfer in/Revenue-other,5eecc6d6449e4f7cfb1c2708,2023-02-14T00:00:00.000Z,NEFT CR-UTIB0000114-ONE SIGMA TECHNOLOGI ES PRIVATE LIM-SLICK ORGANICS PRIVATE LI MITED-AXISP00363054166,bnpl,,net_banking_transfer,3354.87
64142ad3f8804aea72170ebe,50200023535069,65594.74,60ec41ba55c00300382672d9,HDFC,Transfer in/Revenue-other,5eecc6d6449e4f7cfb1c2708,2023-02-14T00:00:00.000Z,CLOVE LEGAL,,,Other,4500
64142ad3f8804aea72170ec0,50200023535069,287499.41,60ec41ba55c00300382672d9,HDFC,Transfer in/Revenue-other,5eecc6d6449e4f7cfb1c2708,2023-02-14T00:00:00.000Z,RTGS CR-IDFB0010204-PCPL CENTRAL DISBURS EMENT AC-SLICK ORGANICS PRIVATE LIMITED- IDFBR52023021400591800,,,net_banking_transfer,221904.67
64142ad3f8804aea72170ec2,50200023535069,288263.41,60ec41ba55c00300382672d9,HDFC,Transfer in/Revenue-other,5eecc6d6449e4f7cfb1c2708,2023-02-14T00:00:00.000Z,FT - CR - 50200038726231 - HOUSE OF BEAU TY PRIVATE LIMITED,,,Other,764
64142ad3f8804aea72170ec4,50200023535069,38163.41,60ec41ba55c00300382672d9,HDFC,direct expenses,5eecc6d6449e4f7cfb1c2708,2023-02-14T00:00:00.000Z,NEFT DR-ICIC0000369-BO INTERNATIONAL-NET,,,net_banking_transfer,-250100
64142ad3f8804aea72170ec7,50200023535069,96236.41,60ec41ba55c00300382672d9,HDFC,Transfer in/Revenue-other,5eecc6d6449e4f7cfb1c2708,2023-02-14T00:00:00.000Z,00640330000510-SLICK ORGANICS PVT L,,,Other,58073
64142ad3f8804aea72170ec9,50200023535069,120561.41,60ec41ba55c00300382672d9,HDFC,Revenue-Mktplace,5eecc6d6449e4f7cfb1c2708,2023-02-14T00:00:00.000Z,NEFT CR-ICIC0000985-DIGITAL AGE RETAIL P VT LTD-SLICK ORGANICS PVT LTD-CMS3119488 858,,,net_banking_transfer,24325
64142ad3f8804aea72170ecb,50200023535069,156979.61,60ec41ba55c00300382672d9,HDFC,Transfer in/Revenue-other,5eecc6d6449e4f7cfb1c2708,2023-02-14T00:00:00.000Z,59209873901899-TPT-INV 233-NYNM ORGANICS PVT LTD,,,net_banking_transfer,36418.2
64142ad3f8804aea72170ecd,50200023535069,154179.61,60ec41ba55c00300382672d9,HDFC,Rental expense,5eecc6d6449e4f7cfb1c2708,2023-02-14T00:00:00.000Z,POS 514834XXXXXX9486 CARZONRENT INDIA,,,debit_card,-2800
64142ad3f8804aea72170ecf,50200023535069,155476.6,60ec41ba55c00300382672d9,HDFC,Revenue-PG-split enabled,5eecc6d6449e4f7cfb1c2708,2023-02-14T00:00:00.000Z,NEFT CR-UTIB0001506-RAZORPAY SOFTWARE PR IVATE LIMITED-SLICK ORGANICS PVT LITD-AX ISCN0209366096,,,net_banking_transfer,1296.99
64142ad3f8804aea72170ed1,50200023535069,141906.6,60ec41ba55c00300382672d9,HDFC,direct expenses,5eecc6d6449e4f7cfb1c2708,2023-02-14T00:00:00.000Z,POS 514834XXXXXX9486 NOVOTEL HOTEL,travel,,debit_card,-13570
64142ad3f8804aea72170ed3,50200023535069,139324.28,60ec41ba55c00300382672d9,HDFC,direct expenses,5eecc6d6449e4f7cfb1c2708,2023-02-14T00:00:00.000Z,POS 514834XXXXXX9486 NOVOTEL HOTEL,travel,,debit_card,-2582.32
64142ad3f8804aea72170ed5,50200023535069,141162.17,60ec41ba55c00300382672d9,HDFC,Transfer in/Revenue-other,5eecc6d6449e4f7cfb1c2708,2023-02-15T00:00:00.000Z,IMPS-304604753366-EXCRO PAY ESCROW ACC-Y ESB-XXXXXXXXXXX1807-333112298023,,,net_banking_transfer,1837.89
64142ad3f8804aea72170ed7,50200023535069,41162.17,60ec41ba55c00300382672d9,HDFC,direct expenses,5eecc6d6449e4f7cfb1c2708,2023-02-15T00:00:00.000Z,57500001065314 NET BANKING SI -100000,,,Other,-100000
64142ad3f8804aea72170ed9,50200023535069,24878.17,60ec41ba55c00300382672d9,HDFC,direct expenses,5eecc6d6449e4f7cfb1c2708,2023-02-15T00:00:00.000Z,50200043297657 NET BANKING SI -16284,,,Other,-16284
64142ad3f8804aea72170edb,50200023535069,-805.83,60ec41ba55c00300382672d9,HDFC,direct expenses,5eecc6d6449e4f7cfb1c2708,2023-02-15T00:00:00.000Z,NEFT DR-CITI0000002-OMG NETWORK INDIA PR IVATE LIMITED-SANDOZ - MUM-N046232332632 032-NET BANKING SI -25684,,,net_banking_transfer,-25684
64142ad3f8804aea72170ede,50200023535069,2884.17,60ec41ba55c00300382672d9,HDFC,Transfer in/Revenue-other,5eecc6d6449e4f7cfb1c2708,2023-02-15T00:00:00.000Z,IMPS-304607834439-EXCRO PAY ESCROW ACC-Y ESB-XXXXXXXXXXX1807-333112298023,,,net_banking_transfer,3690
64142ad3f8804aea72170ee0,50200023535069,8369.69,60ec41ba55c00300382672d9,HDFC,Revenue-Mktplace,5eecc6d6449e4f7cfb1c2708,2023-02-15T00:00:00.000Z,NEFT CR-DEUT0797BGL-MYNTRA DESIGNS PRIVA TE LIMITED-SLICK ORGANICS - SJIT-3046011 32GN00155,shopping,,net_banking_transfer,5485.52
64142ad3f8804aea72170ee2,50200023535069,3413.69,60ec41ba55c00300382672d9,HDFC,Marketing Expense,5eecc6d6449e4f7cfb1c2708,2023-02-15T00:00:00.000Z,ME DC SI 514834XXXXXX9486 FACEBOOK SI,,,Other,-4956
64142ad3f8804aea72170ee4,50200023535069,5030.54,60ec41ba55c00300382672d9,HDFC,Revenue-PG-split enabled,5eecc6d6449e4f7cfb1c2708,2023-02-15T00:00:00.000Z,NEFT CR-UTIB0001506-RAZORPAY SOFTWARE PR IVATE LIMITED-SLICK ORGANICS PVT LITD-AX ISCN0209616059,,,net_banking_transfer,1616.85
64142ad3f8804aea72170ee6,50200023535069,7299.32,60ec41ba55c00300382672d9,HDFC,Transfer in/Revenue-other,5eecc6d6449e4f7cfb1c2708,2023-02-15T00:00:00.000Z,NEFT CR-UTIB0000114-ONE SIGMA TECHNOLOGI ES PRIVATE LIM-SLICK ORGANICS PRIVATE LI,bnpl,,net_banking_transfer,2268.78
64142ad3f8804aea72170ee9,50200023535069,8006.32,60ec41ba55c00300382672d9,HDFC,Revenue-Mktplace,5eecc6d6449e4f7cfb1c2708,2023-02-15T00:00:00.000Z,NEFT CR-ICIC0000105-MANASH LIFETYLE PVT LTD-SLICK ORGANICS PRIVATE LIMITED-ICIB2 30460006027,,,net_banking_transfer,707
64142ad3f8804aea72170eeb,50200023535069,92995.81,60ec41ba55c00300382672d9,HDFC,Transfer in/Revenue-other,5eecc6d6449e4f7cfb1c2708,2023-02-15T00:00:00.000Z,NEFT CR-YESB0000001-EASEBUZZ PVT LTD NOD AL A/C-SLICK ORGANICS PVT LTD-YESB304653 92995,,,net_banking_transfer,84989.49
64142ad3f8804aea72170eed,50200023535069,96589.81,60ec41ba55c00300382672d9,HDFC,Revenue-Mktplace,5eecc6d6449e4f7cfb1c2708,2023-02-15T00:00:00.000Z,IMPS-304614651167-DREAMPLUGPAYTECHSO-UTI B-XXXXXXXXXXX7853-,,,net_banking_transfer,3594
64142ad3f8804aea72170eef,50200023535069,-28410.19,60ec41ba55c00300382672d9,HDFC,direct expenses,5eecc6d6449e4f7cfb1c2708,2023-02-15T00:00:00.000Z,"NEFT DR-IDFB0040101-ACTIVES ADDITIVES AP PLICATIONS LLP-NETBANK, MUM-N04623233330 7006-125000",,,net_banking_transfer,-125000
64142ad3f8804aea72170ef2,50200023535069,-28707.19,60ec41ba55c00300382672d9,HDFC,direct expenses,5eecc6d6449e4f7cfb1c2708,2023-02-15T00:00:00.000Z,POS 514834XXXXXX9486 PAYTM_PAYTMADDMO,ewallet,,debit_card,-297
64142ad4f8804aea72170ef4,50200023535069,-128707.19,60ec41ba55c00300382672d9,HDFC,direct expenses,5eecc6d6449e4f7cfb1c2708,2023-02-15T00:00:00.000Z,POS 514834XXXXXX9486 E-COMMERCE RP,,,debit_card,-100000
64142ad4f8804aea72170ef6,50200023535069,-129764.19,60ec41ba55c00300382672d9,HDFC,direct expenses,5eecc6d6449e4f7cfb1c2708,2023-02-15T00:00:00.000Z,POS 514834XXXXXX9486 PTM*PAYTM WALLET,ewallet,,debit_card,-1057
64142ad4f8804aea72170ef8,50200023535069,-99255.32,60ec41ba55c00300382672d9,HDFC,Revenue-Mktplace,5eecc6d6449e4f7cfb1c2708,2023-02-15T00:00:00.000Z,NEFT CR-HSBC0400002-AMAZON SERVICES LLC- SLICK ORGANICS PRIVATE LIMITED-HSBCN2304 6491956,shopping,,net_banking_transfer,30508.87
64142ad4f8804aea72170efa,50200023535069,-99338.32,60ec41ba55c00300382672d9,HDFC,direct expenses,5eecc6d6449e4f7cfb1c2708,2023-02-15T00:00:00.000Z,POS 514834XXXXXX9486 PAYTM PAYMENTS S,ewallet,,debit_card,-83
64142ad4f8804aea72170efc,50200023535069,15554.98,60ec41ba55c00300382672d9,HDFC,Revenue-COD,5eecc6d6449e4f7cfb1c2708,2023-02-15T00:00:00.000Z,NEFT CR-ICIC0000155-SHIPROCKET COD CRF I D 5727926-SLICK ORGANICS PVT LTD-CMS3123 432976,,,net_banking_transfer,114893.3
64142ad4f8804aea72170efe,50200023535069,16380.78,60ec41ba55c00300382672d9,HDFC,Revenue-PG-split enabled,5eecc6d6449e4f7cfb1c2708,2023-02-15T00:00:00.000Z,NEFT CR-UTIB0001506-RAZORPAY SOFTWARE PR IVATE LIMITED-SLICK ORGANICS PVT LITD-AX ISCN0209883987,,,net_banking_transfer,825.8
64142ad4f8804aea72170f00,50200023535069,79863.9,60ec41ba55c00300382672d9,HDFC,Transfer in/Revenue-other,5eecc6d6449e4f7cfb1c2708,2023-02-15T00:00:00.000Z,NEFT CR-YESB0000001-EASEBUZZ PVT LTD NOD AL A/C-SLICK ORGANICS PVT LTD-YESB304656 72174,,,net_banking_transfer,63483.12
64142ad4f8804aea72170f02,50200023535069,84172.9,60ec41ba55c00300382672d9,HDFC,Transfer in/Revenue-other,5eecc6d6449e4f7cfb1c2708,2023-02-15T00:00:00.000Z,FT- REMITTANCE OG JAN 23-50200050675669 - HOUZ OF NATURE PVT LTD -,,,Other,4309
64142ad4f8804aea72170f04,50200023535069,76640.6,60ec41ba55c00300382672d9,HDFC,direct expenses,5eecc6d6449e4f7cfb1c2708,2023-02-15T00:00:00.000Z,POS 514834XXXXXX9486 LA ALTAVITA,,,debit_card,-7532.3
64142ad4f8804aea72170f06,50200023535069,78153.03,60ec41ba55c00300382672d9,HDFC,Transfer in/Revenue-other,5eecc6d6449e4f7cfb1c2708,2023-02-16T00:00:00.000Z,NEFT CR-YESB0000001-EXCRO PAY ESCROW ACC,,,net_banking_transfer,1512.43
64142ad4f8804aea72170f08,50200023535069,78889.47,60ec41ba55c00300382672d9,HDFC,Revenue-PG-split enabled,5eecc6d6449e4f7cfb1c2708,2023-02-16T00:00:00.000Z,NEFT CR-UTIB0001506-RAZORPAY SOFTWARE PR IVATE LIMITED-SLICK ORGANICS PVT LITD-AX ISCN0210099853,,,net_banking_transfer,736.44
64142ad4f8804aea72170f0a,50200023535069,68889.47,60ec41ba55c00300382672d9,HDFC,direct expenses,5eecc6d6449e4f7cfb1c2708,2023-02-16T00:00:00.000Z,"NEFT DR-ICIC0000566-VISHAL ISSAR-NETBANK , MUM-N047232334394717-10000",,,net_banking_transfer,-10000
64142ad4f8804aea72170f0c,50200023535069,-29564.7,60ec41ba55c00300382672d9,HDFC,direct expenses,5eecc6d6449e4f7cfb1c2708,2023-02-16T00:00:00.000Z,POS 514834XXXXXX9486 E-COMMERCE RP,,,debit_card,-98454.17
64142ad4f8804aea72170f0e,50200023535069,-32949.7,60ec41ba55c00300382672d9,HDFC,direct expenses,5eecc6d6449e4f7cfb1c2708,2023-02-16T00:00:00.000Z,50100093802387-TPT-3385-ISSHANA MAHAJAN,,,net_banking_transfer,-3385
64142ad4f8804aea72170f10,50200023535069,-47799.7,60ec41ba55c00300382672d9,HDFC,direct expenses,5eecc6d6449e4f7cfb1c2708,2023-02-16T00:00:00.000Z,"NEFT DR-PUNB0307800-SANJEEV NIRMANIA-NET BANK, MUM-N047232334467780-14850",,,net_banking_transfer,-14850
64142ad4f8804aea72170f12,50200023535069,-52799.7,60ec41ba55c00300382672d9,HDFC,direct expenses,5eecc6d6449e4f7cfb1c2708,2023-02-16T00:00:00.000Z,50100188500931-TPT-5000-DEEPIKA JOSHI,,,net_banking_transfer,-5000
64142ad4f8804aea72170f14,50200023535069,-49205.7,60ec41ba55c00300382672d9,HDFC,Revenue-Mktplace,5eecc6d6449e4f7cfb1c2708,2023-02-16T00:00:00.000Z,IMPS-304714411465-DREAMPLUGPAYTECHSO-UTI B-XXXXXXXXXXX7853-,,,net_banking_transfer,3594
64142ad4f8804aea72170f16,50200023535069,-64145.7,60ec41ba55c00300382672d9,HDFC,direct expenses,5eecc6d6449e4f7cfb1c2708,2023-02-16T00:00:00.000Z,"NEFT DR-KKBK0000173-NITISH KUMAR MANDAL- NETBANK, MUM-N047232334714827-14940",,,net_banking_transfer,-14940
64142ad4f8804aea72170f18,50200023535069,-57429.79,60ec41ba55c00300382672d9,HDFC,Transfer in/Revenue-other,5eecc6d6449e4f7cfb1c2708,2023-02-16T00:00:00.000Z,NEFT CR-UTIB0000114-ONE SIGMA TECHNOLOGI ES PRIVATE LIM-SLICK ORGANICS PRIVATE LI MITED-AXISP00363685383,bnpl,,net_banking_transfer,6715.91
64142ad4f8804aea72170f1a,50200023535069,11073.57,60ec41ba55c00300382672d9,HDFC,Transfer in/Revenue-other,5eecc6d6449e4f7cfb1c2708,2023-02-16T00:00:00.000Z,NEFT CR-YESB0000001-EASEBUZZ PVT LTD NOD AL A/C-SLICK ORGANICS PVT LTD-YESB304790 24860,,,net_banking_transfer,68503.36
64142ad4f8804aea72170f1c,50200023535069,-38926.43,60ec41ba55c00300382672d9,HDFC,direct expenses,5eecc6d6449e4f7cfb1c2708,2023-02-17T00:00:00.000Z,NEFT DR-BKID0007124-MATRIX PRINTING SOLU TIONS PVT LTD-SANDOZ - MUM-N048232335570 129-NET BANKING SI -50000,,,net_banking_transfer,-50000
64142ad4f8804aea72170f1e,50200023535069,-37264.23,60ec41ba55c00300382672d9,HDFC,Transfer in/Revenue-other,5eecc6d6449e4f7cfb1c2708,2023-02-17T00:00:00.000Z,IMPS-304804706024-EXCRO PAY ESCROW ACC-Y ESB-XXXXXXXXXXX1807-333112298023,,,net_banking_transfer,1662.2
64142ad4f8804aea72170f20,50200023535069,-33550.98,60ec41ba55c00300382672d9,HDFC,Transfer in/Revenue-other,5eecc6d6449e4f7cfb1c2708,2023-02-17T00:00:00.000Z,IMPS-304807751703-EXCRO PAY ESCROW ACC-Y ESB-XXXXXXXXXXX1807-333112298023,,,net_banking_transfer,3713.25
64142ad4f8804aea72170f22,50200023535069,-34850.98,60ec41ba55c00300382672d9,HDFC,Marketing Expense,5eecc6d6449e4f7cfb1c2708,2023-02-17T00:00:00.000Z,ME DC SI 514834XXXXXX9486 GOOGLE PLAY SE R CYBS S,entertainment,,Other,-1300
64142ad4f8804aea72170f24,50200023535069,-29578.99,60ec41ba55c00300382672d9,HDFC,Revenue-Mktplace,5eecc6d6449e4f7cfb1c2708,2023-02-17T00:00:00.000Z,NEFT CR-DEUT0797BGL-MYNTRA DESIGNS PRIVA,shopping,,net_banking_transfer,5271.99
64142ad4f8804aea72170f26,50200023535069,-29383.74,60ec41ba55c00300382672d9,HDFC,Revenue-Mktplace,5eecc6d6449e4f7cfb1c2708,2023-02-17T00:00:00.000Z,NEFT CR-DEUT0797BGL-MYNTRA DESIGNS PRIVA TE LIMITED-SLICK ORGANICS PVT. LTD.-3048 01054GN00258,shopping,,net_banking_transfer,195.25
64142ad4f8804aea72170f28,50200023535069,-29209.37,60ec41ba55c00300382672d9,HDFC,Revenue-PG-split enabled,5eecc6d6449e4f7cfb1c2708,2023-02-17T00:00:00.000Z,NEFT CR-UTIB0001506-RAZORPAY SOFTWARE PR IVATE LIMITED-SLICK ORGANICS PVT LITD-AX ISCN0210488679,,,net_banking_transfer,174.37
64142ad4f8804aea72170f2a,50200023535069,-44558.37,60ec41ba55c00300382672d9,HDFC,direct expenses,5eecc6d6449e4f7cfb1c2708,2023-02-17T00:00:00.000Z,"NEFT DR-SBIN0032160-KARISHMA NAVLANI-NET BANK, MUM-N048232335954812-15349",,,net_banking_transfer,-15349
64142ad4f8804aea72170f2c,50200023535069,-5706.37,60ec41ba55c00300382672d9,HDFC,Revenue-PG-non-split,5eecc6d6449e4f7cfb1c2708,2023-02-17T00:00:00.000Z,NEFT CR-UTIB0001506-RZPX PRIVATE LIMITED NODAL ACCOUNT-SLICK ORGANICS PRIVATE LI MITED-AXISCN0210608985,,,net_banking_transfer,38852
64142ad4f8804aea72170f2e,50200023535069,-3310.37,60ec41ba55c00300382672d9,HDFC,Revenue-Mktplace,5eecc6d6449e4f7cfb1c2708,2023-02-17T00:00:00.000Z,IMPS-304814455107-DREAMPLUGPAYTECHSO-UTI B-XXXXXXXXXXX7853-,,,net_banking_transfer,2396
64142ad4f8804aea72170f30,50200023535069,722.38,60ec41ba55c00300382672d9,HDFC,Revenue-Mktplace,5eecc6d6449e4f7cfb1c2708,2023-02-17T00:00:00.000Z,NEFT CR-HSBC0400002-AMAZON PAYMENTS UK L IMITED ACCS-SLICK ORGANICS PRIVATE LIMIT ED-HSBCN23048831677,shopping,,net_banking_transfer,4032.75
64142ad4f8804aea72170f32,50200023535069,139009.93,60ec41ba55c00300382672d9,HDFC,Revenue-COD,5eecc6d6449e4f7cfb1c2708,2023-02-17T00:00:00.000Z,NEFT CR-ICIC0000155-SHIPROCKET COD CRF I D 5740222-SLICK ORGANICS PVT LTD-CMS3127 682075,,,net_banking_transfer,138287.55
64142ad4f8804aea72170f34,50200023535069,-110990.07,60ec41ba55c00300382672d9,HDFC,direct expenses,5eecc6d6449e4f7cfb1c2708,2023-02-17T00:00:00.000Z,"NEFT DR-ICIC0000369-BO INTERNATIONAL-NET BANK, MUM-N048232336413509-250000",,,net_banking_transfer,-250000
64142ad4f8804aea72170f36,50200023535069,-103293.27,60ec41ba55c00300382672d9,HDFC,Transfer in/Revenue-other,5eecc6d6449e4f7cfb1c2708,2023-02-17T00:00:00.000Z,NEFT CR-UTIB0000114-ONE SIGMA TECHNOLOGI ES PRIVATE LIM-SLICK ORGANICS PRIVATE LI MITED-AXISP00363998062,bnpl,,net_banking_transfer,7696.8
64142ad4f8804aea72170f38,50200023535069,-38352.71,60ec41ba55c00300382672d9,HDFC,Transfer in/Revenue-other,5eecc6d6449e4f7cfb1c2708,2023-02-17T00:00:00.000Z,NEFT CR-YESB0000001-EASEBUZZ PVT LTD NOD AL A/C-SLICK ORGANICS PVT LTD-YESB304822 33114,,,net_banking_transfer,64940.56
64142ad4f8804aea72170f3a,50200023535069,-37505.59,60ec41ba55c00300382672d9,HDFC,Revenue-PG-split enabled,5eecc6d6449e4f7cfb1c2708,2023-02-17T00:00:00.000Z,NEFT CR-UTIB0001506-RAZORPAY SOFTWARE PR IVATE LIMITED-SLICK ORGANICS PVT LITD-AX ISCN0210781311,,,net_banking_transfer,847.12
64142ad4f8804aea72170f3c,50200023535069,-37282.59,60ec41ba55c00300382672d9,HDFC,Transfer in/Revenue-other,5eecc6d6449e4f7cfb1c2708,2023-02-18T00:00:00.000Z,INT. ON SWCR ON-50300720580141,,,Other,223
64142ad4f8804aea72170f3e,50200023535069,223.41,60ec41ba55c00300382672d9,HDFC,Loan-in,5eecc6d6449e4f7cfb1c2708,2023-02-18T00:00:00.000Z,SWEEP-IN CREDIT - 50300720580141,,,self_transfer,37506
64142ad4f8804aea72170f40,50200023535069,1696.8,60ec41ba55c00300382672d9,HDFC,Transfer in/Revenue-other,5eecc6d6449e4f7cfb1c2708,2023-02-18T00:00:00.000Z,IMPS-304905634683-EXCRO PAY ESCROW ACC-Y ESB-XXXXXXXXXXX1807-333112298023,,,net_banking_transfer,1473.39
64142ad4f8804aea72170f43,50200023535069,1694.8,60ec41ba55c00300382672d9,HDFC,Marketing Expense,5eecc6d6449e4f7cfb1c2708,2023-02-18T00:00:00.000Z,ME DC SI 514834XXXXXX9486 LINKEDIN,,,Other,-2
64142ad4f8804aea72170f45,50200023535069,-9105.2,60ec41ba55c00300382672d9,HDFC,direct expenses,5eecc6d6449e4f7cfb1c2708,2023-02-19T00:00:00.000Z,NEFT DR-BARB0ABHAYK-GLOBAL COMPLIANCES-S ANDOZ - MUM-N050232337677495-NET BANKING SI -10800,,,net_banking_transfer,-10800
64142ad4f8804aea72170f47,50200023535069,-29105.2,60ec41ba55c00300382672d9,HDFC,direct expenses,5eecc6d6449e4f7cfb1c2708,2023-02-19T00:00:00.000Z,NEFT DR-ICIC0002451-SOUTH COURT CONDOMIN IUM ASSOCIATION-SANDOZ - MUM-N0502323376 77498-NET BANKING SI -20000,,,net_banking_transfer,-20000
64142ad4f8804aea72170f49,50200023535069,-34061.2,60ec41ba55c00300382672d9,HDFC,Marketing Expense,5eecc6d6449e4f7cfb1c2708,2023-02-19T00:00:00.000Z,ME DC SI 514834XXXXXX9486 FACEBOOK SI,,,Other,-4956
64142ad4f8804aea72170f4b,50200023535069,-32347.48,60ec41ba55c00300382672d9,HDFC,Transfer in/Revenue-other,5eecc6d6449e4f7cfb1c2708,2023-02-19T00:00:00.000Z,IMPS-305009732215-EXCRO PAY ESCROW ACC-Y ESB-XXXXXXXXXXX1807-333112298023,,,net_banking_transfer,1713.72
64142ad4f8804aea72170f4d,50200023535069,-32317.48,60ec41ba55c00300382672d9,HDFC,Transfer in/Revenue-other,5eecc6d6449e4f7cfb1c2708,2023-02-20T00:00:00.000Z,INT. ON SWCR ON-50300720580141,,,Other,30
64142ad4f8804aea72170f4f,50200023535069,-27361.48,60ec41ba55c00300382672d9,HDFC,Loan-in,5eecc6d6449e4f7cfb1c2708,2023-02-20T00:00:00.000Z,SWEEP-IN CREDIT - 50300720580141,,,self_transfer,4956
64142ad4f8804aea72170f51,50200023535069,-27193.48,60ec41ba55c00300382672d9,HDFC,Transfer in/Revenue-other,5eecc6d6449e4f7cfb1c2708,2023-02-20T00:00:00.000Z,INT. ON SWCR ON-50300720580141,,,Other,168
64142ad4f8804aea72170f55,50200023535069,168.52,60ec41ba55c00300382672d9,HDFC,Loan-in,5eecc6d6449e4f7cfb1c2708,2023-02-20T00:00:00.000Z,SWEEP-IN CREDIT - 50300720580141,,,self_transfer,27362
64142ad4f8804aea72170f57,50200023535069,3486.65,60ec41ba55c00300382672d9,HDFC,Transfer in/Revenue-other,5eecc6d6449e4f7cfb1c2708,2023-02-20T00:00:00.000Z,IMPS-305103766658-EXCRO PAY ESCROW ACC-Y ESB-XXXXXXXXXXX1807-333112298023,,,net_banking_transfer,3318.13
64142ad4f8804aea72170f59,50200023535069,9424.91,60ec41ba55c00300382672d9,HDFC,Transfer in/Revenue-other,5eecc6d6449e4f7cfb1c2708,2023-02-20T00:00:00.000Z,IMPS-305107823337-EXCRO PAY ESCROW ACC-Y ESB-XXXXXXXXXXX1807-333112298023,,,net_banking_transfer,5938.26
64142ad4f8804aea72170f5b,50200023535069,6350.91,60ec41ba55c00300382672d9,HDFC,direct expenses,5eecc6d6449e4f7cfb1c2708,2023-02-20T00:00:00.000Z,POS 514834XXXXXX9486 WWW HPSHOPPING I,,,debit_card,-3074
64142ad4f8804aea72170f5d,50200023535069,5102.91,60ec41ba55c00300382672d9,HDFC,SAAS/tech expense,5eecc6d6449e4f7cfb1c2708,2023-02-20T00:00:00.000Z,POS 514834XXXXXX9486 AMAZONIN,shopping,,debit_card,-1248
64142ad4f8804aea72170f5f,50200023535069,4602.91,60ec41ba55c00300382672d9,HDFC,direct expenses,5eecc6d6449e4f7cfb1c2708,2023-02-20T00:00:00.000Z,POS 514834XXXXXX9486 SMARTSHIFT LOGIS,,,debit_card,-500
64142ad4f8804aea72170f61,50200023535069,5190.35,60ec41ba55c00300382672d9,HDFC,Revenue-Mktplace,5eecc6d6449e4f7cfb1c2708,2023-02-20T00:00:00.000Z,NEFT CR-DEUT0797BGL-MYNTRA DESIGNS PRIVA TE LIMITED-SLICK ORGANICS PVT. LTD.-3051 01713GN00082,shopping,,net_banking_transfer,587.44
64142ad4f8804aea72170f63,50200023535069,10076.02,60ec41ba55c00300382672d9,HDFC,Revenue-Mktplace,5eecc6d6449e4f7cfb1c2708,2023-02-20T00:00:00.000Z,NEFT CR-DEUT0797BGL-MYNTRA DESIGNS PRIVA TE LIMITED-SLICK ORGANICS - SJIT-3051017,shopping,,net_banking_transfer,4885.67
64142ad5f8804aea72170f65,50200023535069,174125.48,60ec41ba55c00300382672d9,HDFC,Transfer in/Revenue-other,5eecc6d6449e4f7cfb1c2708,2023-02-20T00:00:00.000Z,NEFT CR-YESB0000001-EASEBUZZ PVT LTD NOD AL A/C-SLICK ORGANICS PVT LTD-YESB305101 97728,,,net_banking_transfer,164049.46
64142ad5f8804aea72170f67,50200023535069,181313.48,60ec41ba55c00300382672d9,HDFC,Revenue-Mktplace,5eecc6d6449e4f7cfb1c2708,2023-02-20T00:00:00.000Z,IMPS-305114007341-DREAMPLUGPAYTECHSO-UTI B-XXXXXXXXXXX7853-,,,net_banking_transfer,7188
64142ad5f8804aea72170f69,50200023535069,188212.61,60ec41ba55c00300382672d9,HDFC,Transfer in/Revenue-other,5eecc6d6449e4f7cfb1c2708,2023-02-20T00:00:00.000Z,NEFT CR-UTIB0000114-ONE SIGMA TECHNOLOGI ES PRIVATE LIM-SLICK ORGANICS PRIVATE LI MITED-AXISP00364348947,bnpl,,net_banking_transfer,6899.13
64142ad5f8804aea72170f6b,50200023535069,200083.84,60ec41ba55c00300382672d9,HDFC,Transfer in/Revenue-other,5eecc6d6449e4f7cfb1c2708,2023-02-20T00:00:00.000Z,NEFT CR-UTIB0000114-ONE SIGMA TECHNOLOGI ES PRIVATE LIM-SLICK ORGANICS PRIVATE LI MITED-AXISP00364349141,bnpl,,net_banking_transfer,11871.23
64142ad5f8804aea72170f6d,50200023535069,229814.84,60ec41ba55c00300382672d9,HDFC,Revenue-Mktplace,5eecc6d6449e4f7cfb1c2708,2023-02-20T00:00:00.000Z,NEFT CR-SCBL0036001-DREAMPLUG TECHNOLOGI ES PRIVATE LIMITED-SLICK ORGANICS PRIVAT E LIMITEDSLICK-IN1ON23022001AGC,,,net_banking_transfer,29731
64142ad5f8804aea72170f6f,50200023535069,237598.7,60ec41ba55c00300382672d9,HDFC,Transfer in/Revenue-other,5eecc6d6449e4f7cfb1c2708,2023-02-20T00:00:00.000Z,NEFT CR-UTIB0000114-ONE SIGMA TECHNOLOGI ES PRIVATE LIM-SLICK ORGANICS PRIVATE LI MITED-AXISP00364349061,bnpl,,net_banking_transfer,7783.86
64142ad5f8804aea72170f71,50200023535069,443042.11,60ec41ba55c00300382672d9,HDFC,Revenue-COD,5eecc6d6449e4f7cfb1c2708,2023-02-20T00:00:00.000Z,NEFT CR-ICIC0000155-SHIPROCKET COD CRF I D 5748502-SLICK ORGANICS PVT LTD-CMS3132 375890,,,net_banking_transfer,205443.41
64142ad5f8804aea72170f73,50200023535069,521926.73,60ec41ba55c00300382672d9,HDFC,Transfer in/Revenue-other,5eecc6d6449e4f7cfb1c2708,2023-02-20T00:00:00.000Z,NEFT CR-YESB0000001-EASEBUZZ PVT LTD NOD AL A/C-SLICK ORGANICS PVT LTD-YESB305105 10921,,,net_banking_transfer,78884.62
64142ad5f8804aea72170f75,50200023535069,521924.73,60ec41ba55c00300382672d9,HDFC,Marketing Expense,5eecc6d6449e4f7cfb1c2708,2023-02-20T00:00:00.000Z,ME DC SI 514834XXXXXX9486 LINKEDIN,,,Other,-2
64142ad5f8804aea72170f77,50200023535069,520394.73,60ec41ba55c00300382672d9,HDFC,SAAS/tech expense,5eecc6d6449e4f7cfb1c2708,2023-02-20T00:00:00.000Z,POS 514834XXXXXX9486 AMAZON PAY INDIA,shopping,,debit_card,-1530
64142ad5f8804aea72170f79,50200023535069,495394.73,60ec41ba55c00300382672d9,HDFC,direct expenses,5eecc6d6449e4f7cfb1c2708,2023-02-21T00:00:00.000Z,NEFT DR-YESB0000236-DELIGHT VACATION PVT LTD-SANDOZ - MUM-N052232339298134-NET B ANKING SI -25000,,,net_banking_transfer,-25000
64142ad5f8804aea72170f7b,50200023535069,476314.73,60ec41ba55c00300382672d9,HDFC,direct expenses,5eecc6d6449e4f7cfb1c2708,2023-02-21T00:00:00.000Z,"NEFT DR-KKBK0000173-NITISH KUMAR MANDAL- NETBANK, MUM-N052232339435020-19080",,,net_banking_transfer,-19080
64142ad5f8804aea72170f7d,50200023535069,476878.07,60ec41ba55c00300382672d9,HDFC,Revenue-PG-split enabled,5eecc6d6449e4f7cfb1c2708,2023-02-21T00:00:00.000Z,NEFT CR-UTIB0001506-RAZORPAY SOFTWARE PR IVATE LIMITED-SLICK ORGANICS PVT LITD-AX ISCN0211879119,,,net_banking_transfer,563.34
64142ad5f8804aea72170f7f,50200023535069,475379.07,60ec41ba55c00300382672d9,HDFC,SAAS/tech expense,5eecc6d6449e4f7cfb1c2708,2023-02-21T00:00:00.000Z,POS 514834XXXXXX9486 AMAZON PAY INDIA,shopping,,debit_card,-1499
64142ad5f8804aea72170f81,50200023535069,860404.8,60ec41ba55c00300382672d9,HDFC,Transfer in/Revenue-other,5eecc6d6449e4f7cfb1c2708,2023-02-21T00:00:00.000Z,RTGS CR-IDFB0010204-PCPL CENTRAL DISBURS EMENT AC-SLICK ORGANICS PRIVATE LIMITED- IDFBR52023022100656742,,,net_banking_transfer,385025.73
64142ad5f8804aea72170f83,50200023535069,660404.8,60ec41ba55c00300382672d9,HDFC,direct expenses,5eecc6d6449e4f7cfb1c2708,2023-02-21T00:00:00.000Z,POS 514834XXXXXX9486 E-COMMERCE RP,,,debit_card,-200000
64142ad5f8804aea72170f85,50200023535069,665233.9,60ec41ba55c00300382672d9,HDFC,Revenue-Mktplace,5eecc6d6449e4f7cfb1c2708,2023-02-21T00:00:00.000Z,IMPS-305214386324-DREAMPLUGPAYTECHSO-UTI B-XXXXXXXXXXX7853-,,,net_banking_transfer,4829.1
64142ad5f8804aea72170f87,50200023535069,465233.9,60ec41ba55c00300382672d9,HDFC,direct expenses,5eecc6d6449e4f7cfb1c2708,2023-02-21T00:00:00.000Z,POS 514834XXXXXX9486 E-COMMERCE RP,,,debit_card,-200000
64142ad5f8804aea72170f89,50200023535069,466368.29,60ec41ba55c00300382672d9,HDFC,Transfer in/Revenue-other,5eecc6d6449e4f7cfb1c2708,2023-02-21T00:00:00.000Z,NEFT CR-UTIB0000114-ONE SIGMA TECHNOLOGI ES PRIVATE LIMI-SLICK ORGANICS PRIVATE L IMITED-AXISP00364561479,bnpl,,net_banking_transfer,1134.39
64142ad5f8804aea72170f8b,50200023535069,470741.43,60ec41ba55c00300382672d9,HDFC,Revenue-Mktplace,5eecc6d6449e4f7cfb1c2708,2023-02-21T00:00:00.000Z,NEFT CR-ICIC0000105-MANASH LIFESTYLE PRI VATE LIMITED NO-SLICK ORGANICS PRIVATE L IMITED-ICIJ230520001904,shopping,,net_banking_transfer,4373.14
64142ad5f8804aea72170f8d,50200023535069,473780.26,60ec41ba55c00300382672d9,HDFC,Transfer in/Revenue-other,5eecc6d6449e4f7cfb1c2708,2023-02-21T00:00:00.000Z,IMPS-305218694678-EXCRO PAY ESCROW ACC-Y ESB-XXXXXXXXXXX1807-333112298023,,,net_banking_transfer,3038.83
64142ad5f8804aea72170f8f,50200023535069,557537.04,60ec41ba55c00300382672d9,HDFC,Transfer in/Revenue-other,5eecc6d6449e4f7cfb1c2708,2023-02-21T00:00:00.000Z,NEFT CR-YESB0000001-EASEBUZZ PVT LTD NOD AL A/C-SLICK ORGANICS PVT LTD-YESB305241 29488,,,net_banking_transfer,83756.78
64142ad5f8804aea72170f91,50200023535069,571156.04,60ec41ba55c00300382672d9,HDFC,Transfer in/Revenue-other,5eecc6d6449e4f7cfb1c2708,2023-02-22T00:00:00.000Z,NEFT CR-KKBK0000958-OCTAVOS ENTERPRISE S OLUTIONS PVT-SLICK ORGANICS PRIVATE LIMI TED-CMS0532343861321,,,net_banking_transfer,13619
64142ad5f8804aea72170f93,50200023535069,382373.78,60ec41ba55c00300382672d9,HDFC,direct expenses,5eecc6d6449e4f7cfb1c2708,2023-02-22T00:00:00.000Z,POS 514834XXXXXX9486 E-COMMERCE RP,,,debit_card,-188782.26
64142ad5f8804aea72170f95,50200023535069,174242.18,60ec41ba55c00300382672d9,HDFC,direct expenses,5eecc6d6449e4f7cfb1c2708,2023-02-22T00:00:00.000Z,POS 514834XXXXXX9486 E-COMMERCE RP,,,debit_card,-208131.6
64142ad5f8804aea72170f97,50200023535069,177714.9,60ec41ba55c00300382672d9,HDFC,Transfer in/Revenue-other,5eecc6d6449e4f7cfb1c2708,2023-02-22T00:00:00.000Z,IMPS-305307748461-EXCRO PAY ESCROW ACC-Y ESB-XXXXXXXXXXX1807-333112298023,,,net_banking_transfer,3472.72
64142ad5f8804aea72170f99,50200023535069,151954.9,60ec41ba55c00300382672d9,HDFC,direct expenses,5eecc6d6449e4f7cfb1c2708,2023-02-22T00:00:00.000Z,"NEFT DR-ICIC0000715-GAJENDRA BAHADUR SIN GH-NETBANK, MUM-N053232340974388-25760",,,net_banking_transfer,-25760
64142ad5f8804aea72170f9b,50200023535069,154169,60ec41ba55c00300382672d9,HDFC,Transfer in/Revenue-other,5eecc6d6449e4f7cfb1c2708,2023-02-22T00:00:00.000Z,NEFT CR-YESB0000001-EXCRO PAY ESCROW ACC,,,net_banking_transfer,2214.1
64142ad5f8804aea72170f9d,50200023535069,154231.77,60ec41ba55c00300382672d9,HDFC,Revenue-PG-split enabled,5eecc6d6449e4f7cfb1c2708,2023-02-22T00:00:00.000Z,NEFT CR-UTIB0001506-RAZORPAY SOFTWARE PR IVATE LIMITED-SLICK ORGANICS PVT LITD-AX ISCN0212402976,,,net_banking_transfer,62.77
64142ad5f8804aea72170f9f,50200023535069,77231.77,60ec41ba55c00300382672d9,HDFC,direct expenses,5eecc6d6449e4f7cfb1c2708,2023-02-22T00:00:00.000Z,"NEFT DR-DBSS0IN0811-SARANSH KULKARNI-NET BANK, MUM-N053232341291484-77000",,,net_banking_transfer,-77000
64142ad5f8804aea72170fa1,50200023535069,27231.77,60ec41ba55c00300382672d9,HDFC,direct expenses,5eecc6d6449e4f7cfb1c2708,2023-02-22T00:00:00.000Z,"NEFT DR-INDB0001025-GROWLYTICS TECHNOLOG IES PVT LTD-NETBANK, MUM-N05323234132231 5-50000",,,net_banking_transfer,-50000
64142ad5f8804aea72170fa3,50200023535069,19231.77,60ec41ba55c00300382672d9,HDFC,direct expenses,5eecc6d6449e4f7cfb1c2708,2023-02-22T00:00:00.000Z,50100230430690-TPT-8000-HARSHITA MODI,,,net_banking_transfer,-8000
64142ad5f8804aea72170fa5,50200023535069,19615.86,60ec41ba55c00300382672d9,HDFC,Revenue-Mktplace,5eecc6d6449e4f7cfb1c2708,2023-02-22T00:00:00.000Z,NEFT CR-ICIC0000105-MANASH LIFESTYLE PRI VATE LIMITED NO-SLICK ORGANICS PRIVATE L IMITED-ICIJ230530001370,shopping,,net_banking_transfer,384.09
64142ad5f8804aea72170fa7,50200023535069,23209.86,60ec41ba55c00300382672d9,HDFC,Revenue-Mktplace,5eecc6d6449e4f7cfb1c2708,2023-02-22T00:00:00.000Z,IMPS-305314906386-DREAMPLUGPAYTECHSO-UTI B-XXXXXXXXXXX7853-,,,net_banking_transfer,3594
64142ad5f8804aea72170fa9,50200023535069,32597.41,60ec41ba55c00300382672d9,HDFC,Transfer in/Revenue-other,5eecc6d6449e4f7cfb1c2708,2023-02-22T00:00:00.000Z,NEFT CR-UTIB0000114-ONE SIGMA TECHNOLOGI ES PRIVATE LIMI-SLICK ORGANICS PRIVATE L IMITED-AXISP00364837955,bnpl,,net_banking_transfer,9387.55
64142ad5f8804aea72170fab,50200023535069,36641.68,60ec41ba55c00300382672d9,HDFC,Revenue-Mktplace,5eecc6d6449e4f7cfb1c2708,2023-02-22T00:00:00.000Z,NEFT CR-DEUT0797BGL-MYNTRA DESIGNS PRIVA TE LIMITED-SLICK ORGANICS - SJIT-3053017 19GN00254,shopping,,net_banking_transfer,4044.27
64142ad5f8804aea72170fad,50200023535069,37088.18,60ec41ba55c00300382672d9,HDFC,Revenue-Mktplace,5eecc6d6449e4f7cfb1c2708,2023-02-22T00:00:00.000Z,NEFT CR-DEUT0797BGL-MYNTRA DESIGNS PRIVA TE LIMITED-SLICK ORGANICS PVT. LTD.-3053 01721GN00015,shopping,,net_banking_transfer,446.5
64142ad5f8804aea72170faf,50200023535069,36564.18,60ec41ba55c00300382672d9,HDFC,direct expenses,5eecc6d6449e4f7cfb1c2708,2023-02-22T00:00:00.000Z,POS 514834XXXXXX9486 SLACK T04BDEL5UF,,,debit_card,-524
64142ad5f8804aea72170fb1,50200023535069,156625.68,60ec41ba55c00300382672d9,HDFC,Revenue-COD,5eecc6d6449e4f7cfb1c2708,2023-02-22T00:00:00.000Z,NEFT CR-ICIC0000155-SHIPROCKET COD CRF I D 5768866-SLICK ORGANICS PVT LTD-CMS3136 387495,,,net_banking_transfer,120061.5
64142ad5f8804aea72170fb3,50200023535069,157994.05,60ec41ba55c00300382672d9,HDFC,Revenue-PG-split enabled,5eecc6d6449e4f7cfb1c2708,2023-02-22T00:00:00.000Z,NEFT CR-UTIB0001506-RAZORPAY SOFTWARE PR,,,net_banking_transfer,1368.37
64142ad5f8804aea72170fb5,50200023535069,246172.6,60ec41ba55c00300382672d9,HDFC,Transfer in/Revenue-other,5eecc6d6449e4f7cfb1c2708,2023-02-22T00:00:00.000Z,NEFT CR-YESB0000001-EASEBUZZ PVT LTD NOD AL A/C-SLICK ORGANICS PVT LTD-YESB305377 94263,,,net_banking_transfer,88178.55
64142ad5f8804aea72170fb7,50200023535069,246174.6,60ec41ba55c00300382672d9,HDFC,Transfer in/Revenue-other,5eecc6d6449e4f7cfb1c2708,2023-02-22T00:00:00.000Z,CRV POS 514834******9486 LINKEDIN,,,refund,2
64142ad5f8804aea72170fb9,50200023535069,247704.6,60ec41ba55c00300382672d9,HDFC,Revenue-Mktplace,5eecc6d6449e4f7cfb1c2708,2023-02-22T00:00:00.000Z,CRV POS 514834******9486 AMAZON PAY INDI,shopping,,refund,1530
64142ad5f8804aea72170fbb,50200023535069,248952.6,60ec41ba55c00300382672d9,HDFC,Revenue-Mktplace,5eecc6d6449e4f7cfb1c2708,2023-02-22T00:00:00.000Z,CRV POS-514834******9486-0220-AMAZONIN,shopping,,refund,1248
64142ad5f8804aea72170fbd,50200023535069,250704,60ec41ba55c00300382672d9,HDFC,Investment/FD redeem,5eecc6d6449e4f7cfb1c2708,2023-02-23T00:00:00.000Z,PRIN AND INT AUTO_REDEEM 50300498262188,,,investment_cashin,1751.4
64142ad5f8804aea72170fbf,50200023535069,252949.43,60ec41ba55c00300382672d9,HDFC,Transfer in/Revenue-other,5eecc6d6449e4f7cfb1c2708,2023-02-23T00:00:00.000Z,IMPS-305405953800-EXCRO PAY ESCROW ACC-Y ESB-XXXXXXXXXXX1807-333112298023,,,net_banking_transfer,2245.43
64142ad5f8804aea72170fc1,50200023535069,247349.43,60ec41ba55c00300382672d9,HDFC,direct expenses,5eecc6d6449e4f7cfb1c2708,2023-02-23T00:00:00.000Z,"NEFT DR-SBIN0001211-URJA TANTA-NETBANK, MUM-N054232342396850-5600",,,net_banking_transfer,-5600
64142ad5f8804aea72170fc3,50200023535069,248219.19,60ec41ba55c00300382672d9,HDFC,Revenue-PG-split enabled,5eecc6d6449e4f7cfb1c2708,2023-02-23T00:00:00.000Z,NEFT CR-UTIB0001506-RAZORPAY SOFTWARE PR IVATE LIMITED --SLICK ORGANICS PVT LITD- AXISCN0212880102,,,net_banking_transfer,869.76
64142ad5f8804aea72170fc5,50200023535069,215803.19,60ec41ba55c00300382672d9,HDFC,direct expenses,5eecc6d6449e4f7cfb1c2708,2023-02-23T00:00:00.000Z,50100301160692-TPT-32416-TARUN GARG,,,net_banking_transfer,-32416
64142ad5f8804aea72170fc7,50200023535069,165803.19,60ec41ba55c00300382672d9,HDFC,direct expenses,5eecc6d6449e4f7cfb1c2708,2023-02-23T00:00:00.000Z,50200076217337-TPT-50000-MARKETING MANTR A SOLUTIONS,,,net_banking_transfer,-50000
64142ad5f8804aea72170fca,50200023535069,116098.19,60ec41ba55c00300382672d9,HDFC,direct expenses,5eecc6d6449e4f7cfb1c2708,2023-02-23T00:00:00.000Z,50200076217337-TPT-49705-MARKETING MANTR A SOLUTIONS,,,net_banking_transfer,-49705
64142ad5f8804aea72170fcc,50200023535069,118892.19,60ec41ba55c00300382672d9,HDFC,Revenue-Mktplace,5eecc6d6449e4f7cfb1c2708,2023-02-23T00:00:00.000Z,IMPS-305414132739-DREAMPLUGPAYTECHSO-UTI B-XXXXXXXXXXX7853-,,,net_banking_transfer,2794
64142ad5f8804aea72170fce,50200023535069,120391.88,60ec41ba55c00300382672d9,HDFC,Transfer in/Revenue-other,5eecc6d6449e4f7cfb1c2708,2023-02-23T00:00:00.000Z,NEFT CR-YESB0000001-EXCRO PAY ESCROW ACC OUNT-SLICKORGANICSPRIVATELIMITED-YESB305 40903060,,,net_banking_transfer,1499.69
64142ad5f8804aea72170fd0,50200023535069,120604.63,60ec41ba55c00300382672d9,HDFC,Transfer in/Revenue-other,5eecc6d6449e4f7cfb1c2708,2023-02-23T00:00:00.000Z,NEFT CR-YESB0000001-EXCRO PAY ESCROW ACC OUNT-SLICKORGANICSPRIVATELIMITED-YESB305 40904006,,,net_banking_transfer,212.75
64142ad5f8804aea72170fd2,50200023535069,123815.22,60ec41ba55c00300382672d9,HDFC,Revenue-Mktplace,5eecc6d6449e4f7cfb1c2708,2023-02-23T00:00:00.000Z,NEFT CR-ICIC0000105-MANASH LIFESTYLE PRI VATE-SLICK ORGANICS PRIVATE LIMITED-ICIB,shopping,,net_banking_transfer,3210.59
64142ad5f8804aea72170fd4,50200023535069,125230.83,60ec41ba55c00300382672d9,HDFC,Revenue-PG-split enabled,5eecc6d6449e4f7cfb1c2708,2023-02-23T00:00:00.000Z,NEFT CR-UTIB0001506-RAZORPAY SOFTWARE PR IVATE LIMITED --SLICK ORGANICS PVT LITD- AXISCN0213118624,,,net_banking_transfer,1415.61
64142ad6f8804aea72170fd6,50200023535069,129873.83,60ec41ba55c00300382672d9,HDFC,Revenue-Mktplace,5eecc6d6449e4f7cfb1c2708,2023-02-23T00:00:00.000Z,NEFT CR-ICIC0000985-DIGITAL AGE RETAIL P VT LTD-SLICK ORGANICS PVT LTD DS-CMS31 37590330,,,net_banking_transfer,4643
64142ad6f8804aea72170fd8,50200023535069,159008.83,60ec41ba55c00300382672d9,HDFC,Transfer in/Revenue-other,5eecc6d6449e4f7cfb1c2708,2023-02-23T00:00:00.000Z,NEFT CR-HSBC0560002-INNOVATIVE RETAIL CO NCEPTS PRIVATE-SLICK ORGANICS PVT LTD-HS BCN23054727815,,,net_banking_transfer,29135
64142ad6f8804aea72170fda,50200023535069,229654.43,60ec41ba55c00300382672d9,HDFC,Transfer in/Revenue-other,5eecc6d6449e4f7cfb1c2708,2023-02-23T00:00:00.000Z,NEFT CR-YESB0000001-EASEBUZZ PVT LTD NOD AL A/C-SLICK ORGANICS PVT LTD-YESB305411 22558,,,net_banking_transfer,70645.6
64142ad6f8804aea72170fdc,50200023535069,240101.43,60ec41ba55c00300382672d9,HDFC,Transfer in/Revenue-other,5eecc6d6449e4f7cfb1c2708,2023-02-23T00:00:00.000Z,NEFT CR-HSBC0560002-INNOVATIVE RETAIL CO NCEPTS PRIVATE-SLICK ORGANICS PVT LTD-HS BCN23054728392,,,net_banking_transfer,10447
64142ad6f8804aea72170fde,50200023535069,240103.43,60ec41ba55c00300382672d9,HDFC,Transfer in/Revenue-other,5eecc6d6449e4f7cfb1c2708,2023-02-23T00:00:00.000Z,CRV POS 514834******9486 LINKEDIN,,,refund,2
64142ad6f8804aea72170fe0,50200023535069,241291.66,60ec41ba55c00300382672d9,HDFC,Transfer in/Revenue-other,5eecc6d6449e4f7cfb1c2708,2023-02-24T00:00:00.000Z,IMPS-305503701830-EXCRO PAY ESCROW ACC-Y ESB-XXXXXXXXXXX1807-333112298023,,,net_banking_transfer,1188.23
64142ad6f8804aea72170fe2,50200023535069,245423.11,60ec41ba55c00300382672d9,HDFC,Transfer in/Revenue-other,5eecc6d6449e4f7cfb1c2708,2023-02-24T00:00:00.000Z,IMPS-305507762117-EXCRO PAY ESCROW ACC-Y ESB-XXXXXXXXXXX1807-333112298023,,,net_banking_transfer,4131.45
64142ad6f8804aea72170fe4,50200023535069,248919.91,60ec41ba55c00300382672d9,HDFC,Revenue-Mktplace,5eecc6d6449e4f7cfb1c2708,2023-02-24T00:00:00.000Z,NEFT CR-DEUT0797BGL-MYNTRA DESIGNS PRIVA TE LIMITED-SLICK ORGANICS - SJIT-3055011 17GN00175,shopping,,net_banking_transfer,3496.8
64142ad6f8804aea72170fe6,50200023535069,250022.99,60ec41ba55c00300382672d9,HDFC,Revenue-Mktplace,5eecc6d6449e4f7cfb1c2708,2023-02-24T00:00:00.000Z,NEFT CR-DEUT0797BGL-MYNTRA DESIGNS PRIVA TE LIMITED-SLICK ORGANICS PVT. LTD.-3055 01129GN00289,shopping,,net_banking_transfer,1103.08
64142ad6f8804aea72170fe8,50200023535069,250884.56,60ec41ba55c00300382672d9,HDFC,Revenue-PG-split enabled,5eecc6d6449e4f7cfb1c2708,2023-02-24T00:00:00.000Z,NEFT CR-UTIB0001506-RAZORPAY SOFTWARE PR IVATE LIMITED --SLICK ORGANICS PVT LITD- AXISCN0213496903,,,net_banking_transfer,861.57
64142ad6f8804aea72170fea,50200023535069,252675.67,60ec41ba55c00300382672d9,HDFC,Transfer in/Revenue-other,5eecc6d6449e4f7cfb1c2708,2023-02-24T00:00:00.000Z,NEFT CR-HSBC0400002-SOUQ.COM FZ LLC UAE ACCS-SLICK ORGANICS PRIVATE LIMITED-HSBC,,,net_banking_transfer,1791.11
64142ad6f8804aea72170fec,50200023535069,252453.67,60ec41ba55c00300382672d9,HDFC,direct expenses,5eecc6d6449e4f7cfb1c2708,2023-02-24T00:00:00.000Z,POS 514834XXXXXX9486 PTM*PAYTM WALLET,ewallet,,debit_card,-222
64142ad6f8804aea72170fee,50200023535069,255992.02,60ec41ba55c00300382672d9,HDFC,Revenue-Mktplace,5eecc6d6449e4f7cfb1c2708,2023-02-24T00:00:00.000Z,IMPS-305514260329-DREAMPLUGPAYTECHSO-UTI B-XXXXXXXXXXX7853-,,,net_banking_transfer,3538.35
64142ad6f8804aea72170ff0,50200023535069,257041.69,60ec41ba55c00300382672d9,HDFC,Revenue-Mktplace,5eecc6d6449e4f7cfb1c2708,2023-02-24T00:00:00.000Z,NEFT CR-ICIC0000105-MANASH LIFESTYLE PRI VATE-SLICK ORGANICS PRIVATE LIMITED-ICIB 230550012166,shopping,,net_banking_transfer,1049.67
64142ad6f8804aea72170ff2,50200023535069,233541.69,60ec41ba55c00300382672d9,HDFC,direct expenses,5eecc6d6449e4f7cfb1c2708,2023-02-24T00:00:00.000Z,"NEFT DR-UTIB0001360-PUSHKAR BISHTT-NETBA NK, MUM-N055232344194052-23500",,,net_banking_transfer,-23500
64142ad6f8804aea72170ff4,50200023535069,234676.08,60ec41ba55c00300382672d9,HDFC,Transfer in/Revenue-other,5eecc6d6449e4f7cfb1c2708,2023-02-24T00:00:00.000Z,NEFT CR-UTIB0000114-ONE SIGMA TECHNOLOGI ES PRIVATE LIMI-SLICK ORGANICS PRIVATE L IMITED-AXISP00365422907,bnpl,,net_banking_transfer,1134.39
64142ad6f8804aea72170ff6,50200023535069,291244.08,60ec41ba55c00300382672d9,HDFC,Transfer in/Revenue-other,5eecc6d6449e4f7cfb1c2708,2023-02-24T00:00:00.000Z,50200048957911-TPT-ARATA AGAINST INVOIC- NISH HAIR,,,net_banking_transfer,56568
64142ad6f8804aea72170ff8,50200023535069,378375.6,60ec41ba55c00300382672d9,HDFC,Transfer in/Revenue-other,5eecc6d6449e4f7cfb1c2708,2023-02-24T00:00:00.000Z,NEFT CR-YESB0000001-EASEBUZZ PVT LTD NOD AL A/C-SLICK ORGANICS PVT LTD-YESB305544 50650,,,net_banking_transfer,87131.52
64142ad6f8804aea72170ffc,50200023535069,380319.68,60ec41ba55c00300382672d9,HDFC,Revenue-PG-split enabled,5eecc6d6449e4f7cfb1c2708,2023-02-24T00:00:00.000Z,NEFT CR-UTIB0001506-RAZORPAY SOFTWARE PR IVATE LIMITED --SLICK ORGANICS PVT LITD- AXISCN0213728035,,,net_banking_transfer,1944.08
64142ad6f8804aea72170ffe,50200023535069,475786.01,60ec41ba55c00300382672d9,HDFC,Revenue-COD,5eecc6d6449e4f7cfb1c2708,2023-02-24T00:00:00.000Z,NEFT CR-ICIC0000155-SHIPROCKET COD CRF I D 5781167-SLICK ORGANICS PVT LTD-CMS3140 677373,,,net_banking_transfer,95466.33
64142ad6f8804aea72171000,50200023535069,1044587.23,60ec41ba55c00300382672d9,HDFC,Transfer in/Revenue-other,5eecc6d6449e4f7cfb1c2708,2023-02-24T00:00:00.000Z,NEFT CR-HSBC0400002-GTRF FUNDS TRANSFER- SLICK ORGANICS PRIVATE LIMITED-HSBCN2305 5974998,,,net_banking_transfer,568801.22
64142ad6f8804aea72171002,50200023535069,1046878.16,60ec41ba55c00300382672d9,HDFC,Transfer in/Revenue-other,5eecc6d6449e4f7cfb1c2708,2023-02-25T00:00:00.000Z,IMPS-305604773800-EXCRO PAY ESCROW ACC-Y ESB-XXXXXXXXXXX1807-333112298023,,,net_banking_transfer,2290.93
64142ad6f8804aea72171004,50200023535069,746878.16,60ec41ba55c00300382672d9,HDFC,direct expenses,5eecc6d6449e4f7cfb1c2708,2023-02-25T00:00:00.000Z,"NEFT DR-ICIC0000369-BO INTERNATIONAL-NET BANK, MUM-N056232345117403-300000",,,net_banking_transfer,-300000
64142ad6f8804aea72171006,50200023535069,346878.16,60ec41ba55c00300382672d9,HDFC,direct expenses,5eecc6d6449e4f7cfb1c2708,2023-02-25T00:00:00.000Z,"NEFT DR-SRCB0000281-3D TECHNOPACK PRIVAT E LIMITED-NETBANK, MUM-N056232345093664-",,,net_banking_transfer,-400000
64142ad6f8804aea72171008,50200023535069,344113.16,60ec41ba55c00300382672d9,HDFC,direct expenses,5eecc6d6449e4f7cfb1c2708,2023-02-25T00:00:00.000Z,POS 514834XXXXXX9486 PAYTM PAYMENTS S,ewallet,,debit_card,-2765
64142ad6f8804aea7217100a,50200023535069,341124.16,60ec41ba55c00300382672d9,HDFC,direct expenses,5eecc6d6449e4f7cfb1c2708,2023-02-25T00:00:00.000Z,POS 514834XXXXXX9486 PAYTM PAYMENTS S,ewallet,,debit_card,-2989
64142ad6f8804aea7217100c,50200023535069,339187.56,60ec41ba55c00300382672d9,HDFC,Marketing Expense,5eecc6d6449e4f7cfb1c2708,2023-02-26T00:00:00.000Z,ME DC SI 514834XXXXXX9486 FACEBOOK SI,,,Other,-1936.6
64142ad6f8804aea7217100e,50200023535069,338996.44,60ec41ba55c00300382672d9,HDFC,Marketing Expense,5eecc6d6449e4f7cfb1c2708,2023-02-26T00:00:00.000Z,ME DC SI 514834XXXXXX9486 FACEBOOK SI,,,Other,-191.12
64142ad6f8804aea72171010,50200023535069,338816.44,60ec41ba55c00300382672d9,HDFC,direct expenses,5eecc6d6449e4f7cfb1c2708,2023-02-26T00:00:00.000Z,POS 514834XXXXXX9486 PAYTM PAYMENTS S,ewallet,,debit_card,-180
64142ad6f8804aea72171012,50200023535069,307465.44,60ec41ba55c00300382672d9,HDFC,direct expenses,5eecc6d6449e4f7cfb1c2708,2023-02-26T00:00:00.000Z,"NEFT DR-YESB0000551-VISTTA COSMETICS-NET BANK, MUM-N057232345774531-31351",,,net_banking_transfer,-31351
64142ad6f8804aea72171014,50200023535069,288959.44,60ec41ba55c00300382672d9,HDFC,direct expenses,5eecc6d6449e4f7cfb1c2708,2023-02-27T00:00:00.000Z,00918630000430 NET BANKING SI -18506,,,Other,-18506
64142ad6f8804aea72171016,50200023535069,291962.46,60ec41ba55c00300382672d9,HDFC,Transfer in/Revenue-other,5eecc6d6449e4f7cfb1c2708,2023-02-27T00:00:00.000Z,IMPS-305804825823-EXCRO PAY ESCROW ACC-Y ESB-XXXXXXXXXXX1807-333112298023,,,net_banking_transfer,3003.02
64142ad6f8804aea72171018,50200023535069,268630.46,60ec41ba55c00300382672d9,HDFC,direct expenses,5eecc6d6449e4f7cfb1c2708,2023-02-27T00:00:00.000Z,NEFT DR-ICIC0003431-WAVICLE TECHNOLOGIES PVT LTD-SANDOZ - MUM-N058232345824044-N ET BANKING SI -23332,,,net_banking_transfer,-23332
64142ad6f8804aea7217101a,50200023535069,245234.46,60ec41ba55c00300382672d9,HDFC,direct expenses,5eecc6d6449e4f7cfb1c2708,2023-02-27T00:00:00.000Z,NEFT DR-ICIC0003431-WAVICLE TECHNOLOGIES PVT LTD-SANDOZ - MUM-N058232345824046-N ET BANKING SI -23396,,,net_banking_transfer,-23396
64142ad6f8804aea7217101c,50200023535069,225234.46,60ec41ba55c00300382672d9,HDFC,direct expenses,5eecc6d6449e4f7cfb1c2708,2023-02-27T00:00:00.000Z,NEFT DR-ICIC0002451-SOUTH COURT CONDOMIN IUM ASSOCIATION-SANDOZ - MUM-N0582323458 24048-NET BANKING SI -20000,,,net_banking_transfer,-20000
64142ad6f8804aea7217101e,50200023535069,229670.03,60ec41ba55c00300382672d9,HDFC,Transfer in/Revenue-other,5eecc6d6449e4f7cfb1c2708,2023-02-27T00:00:00.000Z,IMPS-305807888669-EXCRO PAY ESCROW ACC-Y ESB-XXXXXXXXXXX1807-333112298023,,,net_banking_transfer,4435.57
64142ad6f8804aea72171020,50200023535069,257560.43,60ec41ba55c00300382672d9,HDFC,Transfer in/Revenue-other,5eecc6d6449e4f7cfb1c2708,2023-02-27T00:00:00.000Z,NEFT CR-UTIB0000020-EMIZA SUPPLY CHAIN S ERVICES PRIVATE-SLICK ORGANICS PRIVATE L IMITED-AXISP00365655187,,,net_banking_transfer,27890.4
64142ad6f8804aea72171022,50200023535069,257715.77,60ec41ba55c00300382672d9,HDFC,Revenue-Mktplace,5eecc6d6449e4f7cfb1c2708,2023-02-27T00:00:00.000Z,NEFT CR-DEUT0797BGL-MYNTRA DESIGNS PRIVA TE LIMITED-SLICK ORGANICS PVT. LTD.-3058 01095GN00034,shopping,,net_banking_transfer,155.34
64142ad6f8804aea72171024,50200023535069,268566.88,60ec41ba55c00300382672d9,HDFC,Revenue-PG-split enabled,5eecc6d6449e4f7cfb1c2708,2023-02-27T00:00:00.000Z,NEFT CR-UTIB0001506-RAZORPAY SOFTWARE PR IVATE LIMITED --SLICK ORGANICS PVT LITD-,,,net_banking_transfer,10851.11
64142ad6f8804aea72171027,50200023535069,283241.66,60ec41ba55c00300382672d9,HDFC,Revenue-Mktplace,5eecc6d6449e4f7cfb1c2708,2023-02-27T00:00:00.000Z,NEFT CR-DEUT0797BGL-MYNTRA DESIGNS PRIVA TE LIMITED-SLICK ORGANICS - SJIT-3058010 61GN00005,shopping,,net_banking_transfer,14674.78
64142ad6f8804aea72171029,50200023535069,279221.66,60ec41ba55c00300382672d9,HDFC,direct expenses,5eecc6d6449e4f7cfb1c2708,2023-02-27T00:00:00.000Z,POS 514834XXXXXX9486 PAYTM PAYMENTS S,ewallet,,debit_card,-4020
64142ad6f8804aea7217102b,50200023535069,308765.66,60ec41ba55c00300382672d9,HDFC,Revenue-Mktplace,5eecc6d6449e4f7cfb1c2708,2023-02-27T00:00:00.000Z,NEFT CR-SCBL0036001-DREAMPLUG TECHNOLOGI ES PRIVATE LIMITED-SLICK ORGANICS PRIVAT E LIMITEDSLICK-IN1ON23022701Z2P,,,net_banking_transfer,29544
64142ad6f8804aea7217102d,50200023535069,256705.66,60ec41ba55c00300382672d9,HDFC,direct expenses,5eecc6d6449e4f7cfb1c2708,2023-02-27T00:00:00.000Z,"NEFT DR-INDB0001025-GROWLYTICS TECHNOLOG IES PVT LTD-NETBANK, MUM-N05823234633925 4-52060",,,net_banking_transfer,-52060
64142ad6f8804aea7217102f,50200023535069,267927.66,60ec41ba55c00300382672d9,HDFC,Revenue-Mktplace,5eecc6d6449e4f7cfb1c2708,2023-02-27T00:00:00.000Z,IMPS-305814452443-DREAMPLUGPAYTECHSO-UTI B-XXXXXXXXXXX7853-,,,net_banking_transfer,11222
64142ad6f8804aea72171031,50200023535069,-64167.34,60ec41ba55c00300382672d9,HDFC,direct expenses,5eecc6d6449e4f7cfb1c2708,2023-02-27T00:00:00.000Z,02711600008220-TPT-332095-VARUN SINGH,,,net_banking_transfer,-332095
64142ad6f8804aea72171033,50200023535069,-64439.34,60ec41ba55c00300382672d9,HDFC,direct expenses,5eecc6d6449e4f7cfb1c2708,2023-02-27T00:00:00.000Z,POS 514834XXXXXX9486 PTM*PAYTM WALLET,ewallet,,debit_card,-272
64142ad6f8804aea72171035,50200023535069,-52567.18,60ec41ba55c00300382672d9,HDFC,Transfer in/Revenue-other,5eecc6d6449e4f7cfb1c2708,2023-02-27T00:00:00.000Z,NEFT CR-UTIB0000114-ONE SIGMA TECHNOLOGI ES PRIVATE LIMI-SLICK ORGANICS PRIVATE L IMITED-AXISP00365856910,bnpl,,net_banking_transfer,11872.16
64142ad6f8804aea72171037,50200023535069,-51432.79,60ec41ba55c00300382672d9,HDFC,Transfer in/Revenue-other,5eecc6d6449e4f7cfb1c2708,2023-02-27T00:00:00.000Z,NEFT CR-UTIB0000114-ONE SIGMA TECHNOLOGI ES PRIVATE LIMI-SLICK ORGANICS PRIVATE L IMITED-AXISP00365857215,bnpl,,net_banking_transfer,1134.39
64142ad6f8804aea72171039,50200023535069,-43492.06,60ec41ba55c00300382672d9,HDFC,Transfer in/Revenue-other,5eecc6d6449e4f7cfb1c2708,2023-02-27T00:00:00.000Z,NEFT CR-UTIB0000114-ONE SIGMA TECHNOLOGI ES PRIVATE LIMI-SLICK ORGANICS PRIVATE L IMITED-AXISP00365857254,bnpl,,net_banking_transfer,7940.73
64142ad6f8804aea7217103b,50200023535069,141839.47,60ec41ba55c00300382672d9,HDFC,Transfer in/Revenue-other,5eecc6d6449e4f7cfb1c2708,2023-02-27T00:00:00.000Z,NEFT CR-YESB0000001-EASEBUZZ PVT LTD NOD AL A/C-SLICK ORGANICS PVT LTD-YESB305837 18964,,,net_banking_transfer,185331.53
64142ad6f8804aea7217103d,50200023535069,145915.82,60ec41ba55c00300382672d9,HDFC,Revenue-Mktplace,5eecc6d6449e4f7cfb1c2708,2023-02-27T00:00:00.000Z,NEFT CR-ICIC0000105-MANASH LIFETYLE PVT LTD-SLICK ORGANICS PRIVATE LIMITED-ICIB2 30580012282,,,net_banking_transfer,4076.35
64142ad6f8804aea7217103f,50200023535069,147877.67,60ec41ba55c00300382672d9,HDFC,Revenue-PG-split enabled,5eecc6d6449e4f7cfb1c2708,2023-02-27T00:00:00.000Z,NEFT CR-UTIB0001506-RAZORPAY SOFTWARE PR IVATE LIMITED --SLICK ORGANICS PVT LITD-,,,net_banking_transfer,1961.85
64142ad6f8804aea72171041,50200023535069,148889.67,60ec41ba55c00300382672d9,HDFC,Transfer in/Revenue-other,5eecc6d6449e4f7cfb1c2708,2023-02-27T00:00:00.000Z,00640330000510-SLICK ORGANICS PVT L,,,Other,1012
64142ad6f8804aea72171043,50200023535069,148731.77,60ec41ba55c00300382672d9,HDFC,Marketing Expense,5eecc6d6449e4f7cfb1c2708,2023-02-27T00:00:00.000Z,ME DC SI 514834XXXXXX9486 FACEBOOK SI,,,Other,-157.9
64142ad7f8804aea72171045,50200023535069,278726.79,60ec41ba55c00300382672d9,HDFC,Revenue-COD,5eecc6d6449e4f7cfb1c2708,2023-02-27T00:00:00.000Z,NEFT CR-ICIC0000155-SHIPROCKET COD CRF I D 5789467-SLICK ORGANICS PVT LTD-CMS3145 214780,,,net_banking_transfer,129995.02
64142ad7f8804aea72171047,50200023535069,384910.02,60ec41ba55c00300382672d9,HDFC,Transfer in/Revenue-other,5eecc6d6449e4f7cfb1c2708,2023-02-27T00:00:00.000Z,NEFT CR-YESB0000001-EASEBUZZ PVT LTD NOD AL A/C-SLICK ORGANICS PVT LTD-YESB305839 61928,,,net_banking_transfer,106183.23
64142ad7f8804aea72171049,50200023535069,387006.41,60ec41ba55c00300382672d9,HDFC,Transfer in/Revenue-other,5eecc6d6449e4f7cfb1c2708,2023-02-28T00:00:00.000Z,IMPS-305904631966-EXCRO PAY ESCROW ACC-Y ESB-XXXXXXXXXXX1807-333112298023,,,net_banking_transfer,2096.39
64142ad7f8804aea7217104b,50200023535069,333973.41,60ec41ba55c00300382672d9,HDFC,direct expenses,5eecc6d6449e4f7cfb1c2708,2023-02-28T00:00:00.000Z,"NEFT DR-CITI0000002-OMG NETWORK INDIA PR IVATE LIMITED-NETBANK, MUM-N059232347729 483-53033",,,net_banking_transfer,-53033
64142ad7f8804aea7217104d,50200023535069,263821.41,60ec41ba55c00300382672d9,HDFC,direct expenses,5eecc6d6449e4f7cfb1c2708,2023-02-28T00:00:00.000Z,"NEFT DR-SBIN0041003-CHAYA TRADERS-NETBAN K, MUM-N059232347729602-70152",travel,,net_banking_transfer,-70152
64142ad7f8804aea7217104f,50200023535069,264913.87,60ec41ba55c00300382672d9,HDFC,Revenue-PG-split enabled,5eecc6d6449e4f7cfb1c2708,2023-02-28T00:00:00.000Z,NEFT CR-UTIB0001506-RAZORPAY SOFTWARE PR IVATE LIMITED --SLICK ORGANICS PVT LITD- AXISCN0215126258,,,net_banking_transfer,1092.46
64142ad7f8804aea72171051,50200023535069,271038.42,60ec41ba55c00300382672d9,HDFC,Transfer in/Revenue-other,5eecc6d6449e4f7cfb1c2708,2023-02-28T00:00:00.000Z,NEFT CR-UTIB0000114-ONE SIGMA TECHNOLOGI ES PRIVATE LIMI-SLICK ORGANICS PRIVATE L IMITED-AXISP00366185703,bnpl,,net_banking_transfer,6124.55
64142ad7f8804aea72171053,50200023535069,274632.42,60ec41ba55c00300382672d9,HDFC,Revenue-Mktplace,5eecc6d6449e4f7cfb1c2708,2023-02-28T00:00:00.000Z,IMPS-305914867403-DREAMPLUGPAYTECHSO-UTI B-XXXXXXXXXXX7853-,,,net_banking_transfer,3594
64142ad7f8804aea72171055,50200023535069,278913.42,60ec41ba55c00300382672d9,HDFC,Revenue-Mktplace,5eecc6d6449e4f7cfb1c2708,2023-02-28T00:00:00.000Z,NEFT CR-ICIC0000105-MANASH LIFETYLE PVT LTD-SLICK ORGANICS PRIVATE LIMITED-ICIB2 30590016853,,,net_banking_transfer,4281
64142ad7f8804aea72171057,50200023535069,236787.42,60ec41ba55c00300382672d9,HDFC,direct expenses,5eecc6d6449e4f7cfb1c2708,2023-02-28T00:00:00.000Z,"NEFT DR-YESB0000551-VISTTA COSMETICS-NET BANK, MUM-N059232348872366-42126",,,net_banking_transfer,-42126
64142ad7f8804aea72171059,50200023535069,178287.42,60ec41ba55c00300382672d9,HDFC,direct expenses,5eecc6d6449e4f7cfb1c2708,2023-02-28T00:00:00.000Z,50200076217337-TPT-58500-MARKETING MANTR A SOLUTIONS,,,net_banking_transfer,-58500
64142ad7f8804aea7217105b,50200023535069,108287.42,60ec41ba55c00300382672d9,HDFC,direct expenses,5eecc6d6449e4f7cfb1c2708,2023-02-28T00:00:00.000Z,"NEFT DR-IDFB0040101-ACTIVES ADDITIVES AP PLICATIONS LLP-NETBANK, MUM-N05923234888 9843-70000",,,net_banking_transfer,-70000
64142ad7f8804aea7217105d,50200023535069,45916.42,60ec41ba55c00300382672d9,HDFC,direct expenses,5eecc6d6449e4f7cfb1c2708,2023-02-28T00:00:00.000Z,"NEFT DR-UTIB0000032-SKUMAR MULTIPRODUCTS PVT LTD-NETBANK, MUM-N059232348899839-6 2371",,,net_banking_transfer,-62371
64142ad7f8804aea7217105f,50200023535069,-54083.58,60ec41ba55c00300382672d9,HDFC,direct expenses,5eecc6d6449e4f7cfb1c2708,2023-02-28T00:00:00.000Z,05892560000649-TPT-100000-DECORPAC INDIA PRIVATE LIMITED,,,net_banking_transfer,-100000
64142ad7f8804aea72171061,50200023535069,-52356.81,60ec41ba55c00300382672d9,HDFC,Revenue-PG-split enabled,5eecc6d6449e4f7cfb1c2708,2023-02-28T00:00:00.000Z,NEFT CR-UTIB0001506-RAZORPAY SOFTWARE PR IVATE LIMITED --SLICK ORGANICS PVT LITD- AXISCN0215650128,,,net_banking_transfer,1726.77
64142ad7f8804aea72171063,50200023535069,37582.24,60ec41ba55c00300382672d9,HDFC,Transfer in/Revenue-other,5eecc6d6449e4f7cfb1c2708,2023-02-28T00:00:00.000Z,NEFT CR-YESB0000001-EASEBUZZ PVT LTD NOD AL A/C-SLICK ORGANICS PVT LTD-YESB305974 46457,,,net_banking_transfer,89939.05
64142ad7f8804aea72171065,50200023535069,493384.87,60ec41ba55c00300382672d9,HDFC,Transfer in/Revenue-other,5eecc6d6449e4f7cfb1c2708,2023-02-28T00:00:00.000Z,NEFT CR-IDFB0010204-PCPL CENTRAL DISBURS EMENT AC-SLICK ORGANICS PRIVATE LIMITED- IDFBH23059796113,,,net_banking_transfer,455802.63
64142ad7f8804aea72171067,50200023535069,93384.87,60ec41ba55c00300382672d9,HDFC,direct expenses,5eecc6d6449e4f7cfb1c2708,2023-02-28T00:00:00.000Z,"NEFT DR-ICIC0000024-TAKE MOTO YOHKI INDI A PRIVATE LIMITED-NETBANK, MUM-N05923234 9328402-400000",travel,,net_banking_transfer,-400000
64142ad7f8804aea72171069,50200023535069,33384.87,60ec41ba55c00300382672d9,HDFC,direct expenses,5eecc6d6449e4f7cfb1c2708,2023-02-28T00:00:00.000Z,"NEFT DR-KKBK0000180-VEDIC COSMECEUTICALS PVT LTD-NETBANK, MUM-N059232349329426-6 0000",,,net_banking_transfer,-60000
64142ad7f8804aea7217106c,50200023535069,-66615.13,60ec41ba55c00300382672d9,HDFC,direct expenses,5eecc6d6449e4f7cfb1c2708,2023-02-28T00:00:00.000Z,05892560000649-TPT-100000-DECORPAC INDIA PRIVATE LIMITED,,,net_banking_transfer,-100000
64142ad7f8804aea72171070,50200023535069,-66236.13,60ec41ba55c00300382672d9,HDFC,Transfer in/Revenue-other,5eecc6d6449e4f7cfb1c2708,2023-03-01T00:00:00.000Z,INT. ON SWCR ON-50300720580141,,,Other,379
64142ad7f8804aea72171073,50200023535069,-12152.13,60ec41ba55c00300382672d9,HDFC,Loan-in,5eecc6d6449e4f7cfb1c2708,2023-03-01T00:00:00.000Z,SWEEP-IN CREDIT - 50300720580141,,,self_transfer,54084
64142ad7f8804aea72171075,50200023535069,-12067.13,60ec41ba55c00300382672d9,HDFC,Transfer in/Revenue-other,5eecc6d6449e4f7cfb1c2708,2023-03-01T00:00:00.000Z,INT. ON SWCR ON-50300720580141,,,Other,85
64142ad7f8804aea72171077,50200023535069,85.87,60ec41ba55c00300382672d9,HDFC,Loan-in,5eecc6d6449e4f7cfb1c2708,2023-03-01T00:00:00.000Z,SWEEP-IN CREDIT - 50300720580141 STATEMENT SUMMARY :-,,,self_transfer,12153
64142ad7f8804aea72171079,50200023535069,1981.9,60ec41ba55c00300382672d9,HDFC,Transfer in/Revenue-other,5eecc6d6449e4f7cfb1c2708,2023-03-01T00:00:00.000Z,IMPS-306003815482-EXCRO PAY ESCROW ACC-Y ESB-XXXXXXXXXXX1807-333112298023,,,net_banking_transfer,1896.03
64142ad7f8804aea7217107b,50200023535069,5893.59,60ec41ba55c00300382672d9,HDFC,Transfer in/Revenue-other,5eecc6d6449e4f7cfb1c2708,2023-03-01T00:00:00.000Z,IMPS-306007915572-EXCRO PAY ESCROW ACC-Y ESB-XXXXXXXXXXX1807-333112298023,,,net_banking_transfer,3911.69
64142ad7f8804aea7217107d,50200023535069,-106.41,60ec41ba55c00300382672d9,HDFC,direct expenses,5eecc6d6449e4f7cfb1c2708,2023-03-01T00:00:00.000Z,"NEFT DR-IOBA0002747-TALIYA UGBO-NETBANK, MUM-N060232350001174-6000",,,net_banking_transfer,-6000
64142ad7f8804aea7217107f,50200023535069,6499.55,60ec41ba55c00300382672d9,HDFC,Revenue-Mktplace,5eecc6d6449e4f7cfb1c2708,2023-03-01T00:00:00.000Z,NEFT CR-DEUT0797BGL-MYNTRA DESIGNS PRIVA TE LIMITED-SLICK ORGANICS - SJIT-3060011 06GN00065,shopping,,net_banking_transfer,6605.96
64142ad7f8804aea72171081,50200023535069,9954.04,60ec41ba55c00300382672d9,HDFC,Revenue-PG-split enabled,5eecc6d6449e4f7cfb1c2708,2023-03-01T00:00:00.000Z,NEFT CR-UTIB0001506-RAZORPAY SOFTWARE PR IVATE LIMITED --SLICK ORGANICS PVT LITD- AXISCN0216285292,,,net_banking_transfer,3454.49
64142ad7f8804aea72171083,50200023535069,10632.33,60ec41ba55c00300382672d9,HDFC,Revenue-Mktplace,5eecc6d6449e4f7cfb1c2708,2023-03-01T00:00:00.000Z,NEFT CR-DEUT0797BGL-MYNTRA DESIGNS PRIVA TE LIMITED-SLICK ORGANICS PVT. LTD.-3060 01138GN00045,shopping,,net_banking_transfer,678.29
64142ad7f8804aea72171086,50200023535069,9434.33,60ec41ba55c00300382672d9,HDFC,direct expenses,5eecc6d6449e4f7cfb1c2708,2023-03-01T00:00:00.000Z,"NEFT DR-BARB0SANJAI-JAYA BALANI-NETBANK, MUM-N060232350838395-1198",,,net_banking_transfer,-1198
64142ad7f8804aea72171088,50200023535069,11830.33,60ec41ba55c00300382672d9,HDFC,Revenue-Mktplace,5eecc6d6449e4f7cfb1c2708,2023-03-01T00:00:00.000Z,IMPS-306014161334-DREAMPLUGPAYTECHSO-UTI B-XXXXXXXXXXX7853-,,,net_banking_transfer,2396
64142ad7f8804aea7217108a,50200023535069,52444.34,60ec41ba55c00300382672d9,HDFC,Revenue-Mktplace,5eecc6d6449e4f7cfb1c2708,2023-03-01T00:00:00.000Z,NEFT CR-HSBC0400002-AMAZON SERVICES LLC- SLICK ORGANICS PRIVATE LIMITED-HSBCN2306 0322550,shopping,,net_banking_transfer,40614.01
64142ad7f8804aea7217108c,50200023535069,53425.33,60ec41ba55c00300382672d9,HDFC,Transfer in/Revenue-other,5eecc6d6449e4f7cfb1c2708,2023-03-01T00:00:00.000Z,NEFT CR-UTIB0000114-ONE SIGMA TECHNOLOGI ES PRIVATE LIMI-SLICK ORGANICS PRIVATE L IMITED-AXISP00367214549,bnpl,,net_banking_transfer,980.99
64142ad7f8804aea7217108e,50200023535069,54642.33,60ec41ba55c00300382672d9,HDFC,Revenue-Mktplace,5eecc6d6449e4f7cfb1c2708,2023-03-01T00:00:00.000Z,NEFT CR-ICIC0000105-MANASH LIFETYLE PVT LTD-SLICK ORGANICS PRIVATE LIMITED-ICIB2 30600006787,,,net_banking_transfer,1217
64142ad7f8804aea72171090,50200023535069,76701.12,60ec41ba55c00300382672d9,HDFC,Revenue-COD,5eecc6d6449e4f7cfb1c2708,2023-03-01T00:00:00.000Z,NEFT CR-ICIC0000155-SHIPROCKET COD CRF I D 5809828-SLICK ORGANICS PVT LTD-CMS3152,,,net_banking_transfer,22058.79
64142ad7f8804aea72171092,50200023535069,78740.63,60ec41ba55c00300382672d9,HDFC,Revenue-PG-split enabled,5eecc6d6449e4f7cfb1c2708,2023-03-01T00:00:00.000Z,NEFT CR-UTIB0001506-RAZORPAY SOFTWARE PR IVATE LIMITED --SLICK ORGANICS PVT LITD- AXISCN0216699780,,,net_banking_transfer,2039.51
64142ad7f8804aea72171094,50200023535069,175705.69,60ec41ba55c00300382672d9,HDFC,Transfer in/Revenue-other,5eecc6d6449e4f7cfb1c2708,2023-03-01T00:00:00.000Z,NEFT CR-YESB0000001-EASEBUZZ PVT LTD NOD AL A/C-SLICK ORGANICS PVT LTD-YESB306010 09816,,,net_banking_transfer,96965.06
64142ad7f8804aea72171097,50200023535069,75705.69,60ec41ba55c00300382672d9,HDFC,direct expenses,5eecc6d6449e4f7cfb1c2708,2023-03-01T00:00:00.000Z,"NEFT DR-YESB0000551-VISTTA COSMETICS-NET BANK, MUM-N060232351970494-100000",,,net_banking_transfer,-100000
64142ad7f8804aea72171099,50200023535069,131246.69,60ec41ba55c00300382672d9,HDFC,Transfer in/Revenue-other,5eecc6d6449e4f7cfb1c2708,2023-03-02T00:00:00.000Z,NEFT CR-SCBL0036001-AARDAE PTE LTD-SLICK ORGANICS PVT LTD-IT36702302286068,,,net_banking_transfer,55541
64142ad7f8804aea7217109b,50200023535069,117746.69,60ec41ba55c00300382672d9,HDFC,direct expenses,5eecc6d6449e4f7cfb1c2708,2023-03-02T00:00:00.000Z,50100110669502-TPT-13500-VRITI MALHOTRA,,,net_banking_transfer,-13500
64142ad7f8804aea7217109d,50200023535069,97252.69,60ec41ba55c00300382672d9,HDFC,direct expenses,5eecc6d6449e4f7cfb1c2708,2023-03-02T00:00:00.000Z,"NEFT DR-SBIN0008078-PANDIT PLASTICS-NETB ANK, MUM-N061232352502187-20494",,,net_banking_transfer,-20494
64142ad7f8804aea7217109f,50200023535069,99494.47,60ec41ba55c00300382672d9,HDFC,Revenue-PG-split enabled,5eecc6d6449e4f7cfb1c2708,2023-03-02T00:00:00.000Z,NEFT CR-UTIB0001506-RAZORPAY SOFTWARE PR IVATE LIMITED --SLICK ORGANICS PVT LITD- AXISCN0217128988,,,net_banking_transfer,2241.78
64142ad7f8804aea721710a1,50200023535069,102440.45,60ec41ba55c00300382672d9,HDFC,Transfer in/Revenue-other,5eecc6d6449e4f7cfb1c2708,2023-03-02T00:00:00.000Z,NEFT CR-YESB0000001-EXCRO PAY ESCROW ACC OUNT-SLICKORGANICSPRIVATELIMITED-YESB306 14019895,,,net_banking_transfer,2945.98
64142ad7f8804aea721710a3,50200023535069,104019.18,60ec41ba55c00300382672d9,HDFC,Transfer in/Revenue-other,5eecc6d6449e4f7cfb1c2708,2023-03-02T00:00:00.000Z,NEFT CR-YESB0000001-EXCRO PAY ESCROW ACC OUNT-SLICKORGANICSPRIVATELIMITED-YESB306 14084037,,,net_banking_transfer,1578.73
64142ad7f8804aea721710a5,50200023535069,108556.74,60ec41ba55c00300382672d9,HDFC,Transfer in/Revenue-other,5eecc6d6449e4f7cfb1c2708,2023-03-02T00:00:00.000Z,NEFT CR-UTIB0000114-ONE SIGMA TECHNOLOGI ES PRIVATE LIMI-SLICK ORGANICS PRIVATE L IMITED-AXISP00367747970,bnpl,,net_banking_transfer,4537.56
64142ad7f8804aea721710a7,50200023535069,117161.53,60ec41ba55c00300382672d9,HDFC,Revenue-Mktplace,5eecc6d6449e4f7cfb1c2708,2023-03-02T00:00:00.000Z,IMPS-306114188988-DREAMPLUGPAYTECHSO-UTI B-XXXXXXXXXXX7853-,,,net_banking_transfer,8604.79
64142ad7f8804aea721710a9,50200023535069,119040.53,60ec41ba55c00300382672d9,HDFC,Revenue-Mktplace,5eecc6d6449e4f7cfb1c2708,2023-03-02T00:00:00.000Z,NEFT CR-ICIC0000105-MANASH LIFETYLE PVT LTD-SLICK ORGANICS PRIVATE LIMITED-ICIB2 30610051766,,,net_banking_transfer,1879
64142ad7f8804aea721710ab,50200023535069,120146.02,60ec41ba55c00300382672d9,HDFC,Revenue-PG-split enabled,5eecc6d6449e4f7cfb1c2708,2023-03-02T00:00:00.000Z,NEFT CR-UTIB0001506-RAZORPAY SOFTWARE PR,,,net_banking_transfer,1105.49
64142ad7f8804aea721710ad,50200023535069,243658.41,60ec41ba55c00300382672d9,HDFC,Transfer in/Revenue-other,5eecc6d6449e4f7cfb1c2708,2023-03-02T00:00:00.000Z,NEFT CR-YESB0000001-EASEBUZZ PVT LTD NOD AL A/C-SLICK ORGANICS PVT LTD-YESB306143 97477,,,net_banking_transfer,123512.39
64142ad7f8804aea721710af,50200023535069,1412141.09,60ec41ba55c00300382672d9,HDFC,Revenue-Mktplace,5eecc6d6449e4f7cfb1c2708,2023-03-02T00:00:00.000Z,NEFT CR-HSBC0560002-MYNTRA JABONG INDIA PRIVATE LIMITED-SLICK ORGANICS PRIVATE L IMITED-HSBCN23061865843,shopping,,net_banking_transfer,1168482.68
64142ad7f8804aea721710b1,50200023535069,1410020.63,60ec41ba55c00300382672d9,HDFC,direct expenses,5eecc6d6449e4f7cfb1c2708,2023-03-03T00:00:00.000Z,3030312057902240769/PAYTMWALLETLOADING,ewallet,,Other,-2120.46
64142ad7f8804aea721710b3,50200023535069,1413804.27,60ec41ba55c00300382672d9,HDFC,Transfer in/Revenue-other,5eecc6d6449e4f7cfb1c2708,2023-03-03T00:00:00.000Z,IMPS-306207957078-EXCRO PAY ESCROW ACC-Y ESB-XXXXXXXXXXX1807-333112298023,,,net_banking_transfer,3783.64
64142ad7f8804aea721710b5,50200023535069,1416835.7,60ec41ba55c00300382672d9,HDFC,Transfer in/Revenue-other,5eecc6d6449e4f7cfb1c2708,2023-03-03T00:00:00.000Z,NEFT CR-YESB0000001-EXCRO PAY ESCROW ACC OUNT-SLICKORGANICSPRIVATELIMITED-YESB306 27109641,,,net_banking_transfer,3031.43
64142ad7f8804aea721710b7,50200023535069,1420452.87,60ec41ba55c00300382672d9,HDFC,Revenue-Mktplace,5eecc6d6449e4f7cfb1c2708,2023-03-03T00:00:00.000Z,NEFT CR-DEUT0797BGL-MYNTRA DESIGNS PRIVA TE LIMITED-SLICK ORGANICS - SJIT-3062010 25GN00009,shopping,,net_banking_transfer,3617.17
64142ad8f8804aea721710b9,50200023535069,1420743.97,60ec41ba55c00300382672d9,HDFC,Revenue-Mktplace,5eecc6d6449e4f7cfb1c2708,2023-03-03T00:00:00.000Z,NEFT CR-DEUT0797BGL-MYNTRA DESIGNS PRIVA TE LIMITED-SLICK ORGANICS PVT. LTD.-3062 01041GN00244,shopping,,net_banking_transfer,291.1
64142ad8f8804aea721710bc,50200023535069,1429700.23,60ec41ba55c00300382672d9,HDFC,Revenue-PG-split enabled,5eecc6d6449e4f7cfb1c2708,2023-03-03T00:00:00.000Z,NEFT CR-UTIB0001506-RAZORPAY SOFTWARE PR IVATE LIMITED --SLICK ORGANICS PVT LITD- AXISCN0218100438,,,net_banking_transfer,8956.26
64142ad8f8804aea721710be,50200023535069,1404700.23,60ec41ba55c00300382672d9,HDFC,direct expenses,5eecc6d6449e4f7cfb1c2708,2023-03-03T00:00:00.000Z,"NEFT DR-YESB0000236-DELIGHT VACATION PVT LTD-NETBANK, MUM-N062232354799166-25000",,,net_banking_transfer,-25000
64142ad8f8804aea721710c0,50200023535069,1393396.23,60ec41ba55c00300382672d9,HDFC,Utilities/bills,5eecc6d6449e4f7cfb1c2708,2023-03-03T00:00:00.000Z,IB BILLPAY DR-HDFCEB-361011XXXX4399,bills,,Other,-11304
64142ad8f8804aea721710c2,50200023535069,1306067.23,60ec41ba55c00300382672d9,HDFC,direct expenses,5eecc6d6449e4f7cfb1c2708,2023-03-03T00:00:00.000Z,"NEFT DR-YESB0CMSNOC-A6466419 001 ARATA R OUND 01 SLICK ORGANI-NETBANK, MUM-N06223 2354873384-87329",,,net_banking_transfer,-87329
64142ad8f8804aea721710c4,50200023535069,1318221.33,60ec41ba55c00300382672d9,HDFC,Revenue-Mktplace,5eecc6d6449e4f7cfb1c2708,2023-03-03T00:00:00.000Z,IMPS-306214142613-DREAMPLUGPAYTECHSO-UTI B-XXXXXXXXXXX7853-,,,net_banking_transfer,12154.1
64142ad8f8804aea721710c6,50200023535069,1321624.5,60ec41ba55c00300382672d9,HDFC,Transfer in/Revenue-other,5eecc6d6449e4f7cfb1c2708,2023-03-03T00:00:00.000Z,NEFT CR-UTIB0000114-ONE SIGMA TECHNOLOGI,bnpl,,net_banking_transfer,3403.17
64142ad8f8804aea721710c8,50200023535069,1271624.5,60ec41ba55c00300382672d9,HDFC,Tax,5eecc6d6449e4f7cfb1c2708,2023-03-03T00:00:00.000Z,051030803032328978- CBDT TAX,,,Other,-50000
64142ad8f8804aea721710ca,50200023535069,1377978.48,60ec41ba55c00300382672d9,HDFC,Revenue-COD,5eecc6d6449e4f7cfb1c2708,2023-03-03T00:00:00.000Z,NEFT CR-ICIC0000155-SHIPROCKET COD CRF I D 5822111-SLICK ORGANICS PVT LTD-CMS3156 768305,,,net_banking_transfer,106353.98
64142ad8f8804aea721710cd,50200023535069,1229978.48,60ec41ba55c00300382672d9,HDFC,direct expenses,5eecc6d6449e4f7cfb1c2708,2023-03-03T00:00:00.000Z,57500001065314-TPT-148000-KRAUTER HEALTH CARE LTD,,,net_banking_transfer,-148000
64142ad8f8804aea721710cf,50200023535069,1315388.02,60ec41ba55c00300382672d9,HDFC,Transfer in/Revenue-other,5eecc6d6449e4f7cfb1c2708,2023-03-03T00:00:00.000Z,NEFT CR-YESB0000001-EASEBUZZ PVT LTD NOD AL A/C-SLICK ORGANICS PVT LTD-YESB306273 98502,,,net_banking_transfer,85409.54
64142ad8f8804aea721710d1,50200023535069,1316127.39,60ec41ba55c00300382672d9,HDFC,Revenue-PG-split enabled,5eecc6d6449e4f7cfb1c2708,2023-03-03T00:00:00.000Z,NEFT CR-UTIB0001506-RAZORPAY SOFTWARE PR IVATE LIMITED --SLICK ORGANICS PVT LITD- AXISCN0218505202,,,net_banking_transfer,739.37
64142ad8f8804aea721710d4,50200023535069,1316128.39,60ec41ba55c00300382672d9,HDFC,Transfer in/Revenue-other,5eecc6d6449e4f7cfb1c2708,2023-03-03T00:00:00.000Z,IMPS-306228104732-APIBANKING-RATN-XXXXXX XXXXXX0168-ACCOUNTVALIDATION,,,net_banking_transfer,1
64142ad8f8804aea721710d6,50200023535069,1317976.78,60ec41ba55c00300382672d9,HDFC,Transfer in/Revenue-other,5eecc6d6449e4f7cfb1c2708,2023-03-04T00:00:00.000Z,IMPS-306305742918-EXCRO PAY ESCROW ACC-Y ESB-XXXXXXXXXXX1807-333112298023,,,net_banking_transfer,1848.39
64142ad8f8804aea721710d8,50200023535069,1356640.75,60ec41ba55c00300382672d9,HDFC,Transfer in/Revenue-other,5eecc6d6449e4f7cfb1c2708,2023-03-04T00:00:00.000Z,NEFT CR-UTIB0000020-EMIZA SUPPLY CHAIN S ERVICES PRIVATE-SLICK ORGANICS PRIVATE L IMITED-AXISP00368441356,,,net_banking_transfer,38663.97
64142ad8f8804aea721710da,50200023535069,1358469.19,60ec41ba55c00300382672d9,HDFC,Revenue-PG-split enabled,5eecc6d6449e4f7cfb1c2708,2023-03-04T00:00:00.000Z,NEFT CR-UTIB0001506-RAZORPAY SOFTWARE PR IVATE LIMITED --SLICK ORGANICS PVT LITD- AXISCN0218648982,,,net_banking_transfer,1828.44
64142ad8f8804aea721710dc,50200023535069,1359667.19,60ec41ba55c00300382672d9,HDFC,Revenue-Mktplace,5eecc6d6449e4f7cfb1c2708,2023-03-04T00:00:00.000Z,IMPS-306314303689-DREAMPLUGPAYTECHSO-UTI B-XXXXXXXXXXX7853-,,,net_banking_transfer,1198
64142ad8f8804aea721710de,50200023535069,1360706.51,60ec41ba55c00300382672d9,HDFC,Revenue-PG-split enabled,5eecc6d6449e4f7cfb1c2708,2023-03-04T00:00:00.000Z,NEFT CR-UTIB0001506-RAZORPAY SOFTWARE PR IVATE LIMITED --SLICK ORGANICS PVT LITD- AXISCN0218909557,,,net_banking_transfer,1039.32
64142ad8f8804aea721710e0,50200023535069,1429885.84,60ec41ba55c00300382672d9,HDFC,Transfer in/Revenue-other,5eecc6d6449e4f7cfb1c2708,2023-03-04T00:00:00.000Z,NEFT CR-YESB0000001-EASEBUZZ PVT LTD NOD AL A/C-SLICK ORGANICS PVT LTD-YESB306308 76773,,,net_banking_transfer,69179.33
64142ad8f8804aea721710e2,50200023535069,1430692.63,60ec41ba55c00300382672d9,HDFC,Transfer in/Revenue-other,5eecc6d6449e4f7cfb1c2708,2023-03-05T00:00:00.000Z,IMPS-306404729537-EXCRO PAY ESCROW ACC-Y ESB-XXXXXXXXXXX1807-333112298023,,,net_banking_transfer,806.79
64142ad8f8804aea721710e4,50200023535069,1433307.92,60ec41ba55c00300382672d9,HDFC,Transfer in/Revenue-other,5eecc6d6449e4f7cfb1c2708,2023-03-06T00:00:00.000Z,IMPS-306506604048-EXCRO PAY ESCROW ACC-Y ESB-XXXXXXXXXXX1807-333112298023,,,net_banking_transfer,2615.29
64142ad8f8804aea721710e6,50200023535069,1440378.9,60ec41ba55c00300382672d9,HDFC,Transfer in/Revenue-other,5eecc6d6449e4f7cfb1c2708,2023-03-06T00:00:00.000Z,IMPS-306507630417-EXCRO PAY ESCROW ACC-Y ESB-XXXXXXXXXXX1807-333112298023,,,net_banking_transfer,7070.98
64142ad8f8804aea721710e8,50200023535069,1449403.42,60ec41ba55c00300382672d9,HDFC,Revenue-Mktplace,5eecc6d6449e4f7cfb1c2708,2023-03-06T00:00:00.000Z,NEFT CR-DEUT0797BGL-MYNTRA DESIGNS PRIVA TE LIMITED-SLICK ORGANICS - SJIT-3065010 47GN00141,shopping,,net_banking_transfer,9024.52
64142ad8f8804aea721710ea,50200023535069,1449574.22,60ec41ba55c00300382672d9,HDFC,Revenue-Mktplace,5eecc6d6449e4f7cfb1c2708,2023-03-06T00:00:00.000Z,NEFT CR-DEUT0797BGL-MYNTRA DESIGNS PRIVA TE LIMITED-SLICK ORGANICS PVT. LTD.-3065 01069GN00042,shopping,,net_banking_transfer,170.8
64142ad8f8804aea721710ec,50200023535069,1454370.68,60ec41ba55c00300382672d9,HDFC,Revenue-PG-split enabled,5eecc6d6449e4f7cfb1c2708,2023-03-06T00:00:00.000Z,NEFT CR-UTIB0001506-RAZORPAY SOFTWARE PR IVATE LIMITED --SLICK ORGANICS PVT LITD- AXISCN0219226177,,,net_banking_transfer,4796.46
64142ad8f8804aea721710ee,50200023535069,1459988.98,60ec41ba55c00300382672d9,HDFC,Revenue-Mktplace,5eecc6d6449e4f7cfb1c2708,2023-03-06T00:00:00.000Z,IMPS-306514797613-DREAMPLUGPAYTECHSO-UTI B-XXXXXXXXXXX7853-,,,net_banking_transfer,5618.3
64142ad8f8804aea721710f0,50200023535069,1464318.73,60ec41ba55c00300382672d9,HDFC,Transfer in/Revenue-other,5eecc6d6449e4f7cfb1c2708,2023-03-06T00:00:00.000Z,NEFT CR-UTIB0000114-ONE SIGMA TECHNOLOGI ES PRIVATE LIMI-SLICK ORGANICS PRIVATE L IMITED-AXISP00368871362,bnpl,,net_banking_transfer,4329.75
64142ad8f8804aea721710f2,50200023535069,1476182.47,60ec41ba55c00300382672d9,HDFC,Transfer in/Revenue-other,5eecc6d6449e4f7cfb1c2708,2023-03-06T00:00:00.000Z,NEFT CR-UTIB0000114-ONE SIGMA TECHNOLOGI ES PRIVATE LIMI-SLICK ORGANICS PRIVATE L IMITED-AXISP00368871446,bnpl,,net_banking_transfer,11863.74
64142ad8f8804aea721710f4,50200023535069,1553564.27,60ec41ba55c00300382672d9,HDFC,Transfer in/Revenue-other,5eecc6d6449e4f7cfb1c2708,2023-03-06T00:00:00.000Z,NEFT CR-YESB0000001-EASEBUZZ PVT LTD NOD AL A/C-SLICK ORGANICS PVT LTD-YESB306566 12703,,,net_banking_transfer,77381.8
64142ad8f8804aea721710f6,50200023535069,1555340.27,60ec41ba55c00300382672d9,HDFC,Revenue-Mktplace,5eecc6d6449e4f7cfb1c2708,2023-03-06T00:00:00.000Z,NEFT CR-ICIC0000105-MANASH LIFETYLE PVT LTD-SLICK ORGANICS PRIVATE LIMITED-ICIB2 30650024808,,,net_banking_transfer,1776
64142ad8f8804aea721710f8,50200023535069,1738468.29,60ec41ba55c00300382672d9,HDFC,Revenue-COD,5eecc6d6449e4f7cfb1c2708,2023-03-06T00:00:00.000Z,NEFT CR-ICIC0000155-SHIPROCKET COD CRF I D 5830397-SLICK ORGANICS PVT LTD-CMS3163 594142,,,net_banking_transfer,183128.02
64142ad8f8804aea721710fa,50200023535069,1739268.29,60ec41ba55c00300382672d9,HDFC,Transfer in/Revenue-other,5eecc6d6449e4f7cfb1c2708,2023-03-06T00:00:00.000Z,IMPS-306516936355-MAILMODO TECHNOLOGIE-I CIC-XXXXXXXX6066-BULD22054834,,,net_banking_transfer,800
64142ad8f8804aea721710fc,50200023535069,1740349.05,60ec41ba55c00300382672d9,HDFC,Revenue-PG-split enabled,5eecc6d6449e4f7cfb1c2708,2023-03-06T00:00:00.000Z,NEFT CR-UTIB0001506-RAZORPAY SOFTWARE PR IVATE LIMITED --SLICK ORGANICS PVT LITD- AXISCN0219704457,,,net_banking_transfer,1080.76
64142ad8f8804aea721710fe,50200023535069,1761293.05,60ec41ba55c00300382672d9,HDFC,Revenue-Mktplace,5eecc6d6449e4f7cfb1c2708,2023-03-06T00:00:00.000Z,NEFT CR-SCBL0036001-DREAMPLUG TECHNOLOGI ES PRIVATE LIMITED-SLICK ORGANICS PRIVAT E LIMITEDSLICK-IN1ON23030602WWO,,,net_banking_transfer,20944
64142ad8f8804aea72171100,50200023535069,1854704.77,60ec41ba55c00300382672d9,HDFC,Transfer in/Revenue-other,5eecc6d6449e4f7cfb1c2708,2023-03-06T00:00:00.000Z,NEFT CR-YESB0000001-EASEBUZZ PVT LTD NOD AL A/C-SLICK ORGANICS PVT LTD-YESB306567 99582,,,net_banking_transfer,93411.72
64142ad8f8804aea72171102,50200023535069,1856307.44,60ec41ba55c00300382672d9,HDFC,Transfer in/Revenue-other,5eecc6d6449e4f7cfb1c2708,2023-03-07T00:00:00.000Z,IMPS-306603989991-EXCRO PAY ESCROW ACC-Y ESB-XXXXXXXXXXX1807-333112298023,,,net_banking_transfer,1602.67
64142ad8f8804aea72171104,50200023535069,1806307.44,60ec41ba55c00300382672d9,HDFC,direct expenses,5eecc6d6449e4f7cfb1c2708,2023-03-07T00:00:00.000Z,50100108772229 NET BANKING SI -50000,,,Other,-50000
64142ad8f8804aea72171107,50200023535069,1768291.44,60ec41ba55c00300382672d9,HDFC,direct expenses,5eecc6d6449e4f7cfb1c2708,2023-03-07T00:00:00.000Z,00901610080520 NET BANKING SI -38016,,,Other,-38016
64142ad8f8804aea7217110a,50200023535069,1715224.44,60ec41ba55c00300382672d9,HDFC,direct expenses,5eecc6d6449e4f7cfb1c2708,2023-03-07T00:00:00.000Z,50100312215410 NET BANKING SI -53067,,,Other,-53067
64142ad8f8804aea7217110c,50200023535069,1669391.44,60ec41ba55c00300382672d9,HDFC,direct expenses,5eecc6d6449e4f7cfb1c2708,2023-03-07T00:00:00.000Z,50100482015380 NET BANKING SI -45833,,,Other,-45833
64142ad8f8804aea7217110e,50200023535069,1495872.44,60ec41ba55c00300382672d9,HDFC,direct expenses,5eecc6d6449e4f7cfb1c2708,2023-03-07T00:00:00.000Z,50100155115510 NET BANKING SI -173519,,,Other,-173519
64142ad8f8804aea72171110,50200023535069,1435510.44,60ec41ba55c00300382672d9,HDFC,direct expenses,5eecc6d6449e4f7cfb1c2708,2023-03-07T00:00:00.000Z,50100293329616 NET BANKING SI -60362,,,Other,-60362
64142ad8f8804aea72171112,50200023535069,1373910.44,60ec41ba55c00300382672d9,HDFC,direct expenses,5eecc6d6449e4f7cfb1c2708,2023-03-07T00:00:00.000Z,50100349886722 NET BANKING SI -61600,,,Other,-61600
64142ad8f8804aea72171115,50200023535069,1175602.44,60ec41ba55c00300382672d9,HDFC,direct expenses,5eecc6d6449e4f7cfb1c2708,2023-03-07T00:00:00.000Z,50100093802387 NET BANKING SI -198308,,,Other,-198308
64142ad8f8804aea72171117,50200023535069,1155752.44,60ec41ba55c00300382672d9,HDFC,direct expenses,5eecc6d6449e4f7cfb1c2708,2023-03-07T00:00:00.000Z,02711600008220 NET BANKING SI -19850,,,Other,-19850
64142ad8f8804aea72171119,50200023535069,1110752.44,60ec41ba55c00300382672d9,HDFC,direct expenses,5eecc6d6449e4f7cfb1c2708,2023-03-07T00:00:00.000Z,NEFT DR-ICIC0000314-ATUL VAISHNAV-SANDOZ - MUM-N066232360941856-NET BANKING SI - 45000,,,net_banking_transfer,-45000
64142ad8f8804aea7217111b,50200023535069,1081752.44,60ec41ba55c00300382672d9,HDFC,direct expenses,5eecc6d6449e4f7cfb1c2708,2023-03-07T00:00:00.000Z,NEFT DR-SIBL0000555-JAIVEER KUMAR-SANDOZ - MUM-N066232360941857-NET BANKING SI - 29000,,,net_banking_transfer,-29000
64142ad8f8804aea7217111d,50200023535069,1056752.44,60ec41ba55c00300382672d9,HDFC,direct expenses,5eecc6d6449e4f7cfb1c2708,2023-03-07T00:00:00.000Z,NEFT DR-BARB0VJGRKA-OM PRASAD PANDEY-SAN DOZ - MUM-N066232360941858-NET BANKING S I -25000,,,net_banking_transfer,-25000
64142ad8f8804aea7217111f,50200023535069,1032752.44,60ec41ba55c00300382672d9,HDFC,direct expenses,5eecc6d6449e4f7cfb1c2708,2023-03-07T00:00:00.000Z,NEFT DR-PUNB0482100-RAM BHAVAN YADAV-SAN,,,net_banking_transfer,-24000
64142ad8f8804aea72171121,50200023535069,1006592.44,60ec41ba55c00300382672d9,HDFC,direct expenses,5eecc6d6449e4f7cfb1c2708,2023-03-07T00:00:00.000Z,NEFT DR-ICIC0002697-NITISH KUMAR-SANDOZ - MUM-N066232360941860-NET BANKING SI -2 6160,,,net_banking_transfer,-26160
64142ad8f8804aea72171123,50200023535069,943525.44,60ec41ba55c00300382672d9,HDFC,direct expenses,5eecc6d6449e4f7cfb1c2708,2023-03-07T00:00:00.000Z,NEFT DR-PUNB0150400-SAGARIKA DEBNATH-SA NDOZ - MUM-N066232360941861-NET BANKING SI -63067,,,net_banking_transfer,-63067
64142ad8f8804aea72171125,50200023535069,912458.44,60ec41ba55c00300382672d9,HDFC,direct expenses,5eecc6d6449e4f7cfb1c2708,2023-03-07T00:00:00.000Z,NEFT DR-KKBK0004266-NIDHI PANDEY-SANDOZ - MUM-N066232360941862-NET BANKING SI -3 1067,,,net_banking_transfer,-31067
64142ad8f8804aea72171127,50200023535069,832908.44,60ec41ba55c00300382672d9,HDFC,direct expenses,5eecc6d6449e4f7cfb1c2708,2023-03-07T00:00:00.000Z,NEFT DR-SBIN0070392-APARNA MOHANAN KONAT -SANDOZ - MUM-N066232360941863-NET BANKI NG SI -79550,,,net_banking_transfer,-79550
64142ad8f8804aea72171129,50200023535069,639171.44,60ec41ba55c00300382672d9,HDFC,direct expenses,5eecc6d6449e4f7cfb1c2708,2023-03-07T00:00:00.000Z,NEFT DR-KKBK0000261-TANVI TANEJA-SANDOZ - MUM-N066232360941864-NET BANKING SI -1 93737,,,net_banking_transfer,-193737
64142ad8f8804aea7217112b,50200023535069,508117.44,60ec41ba55c00300382672d9,HDFC,direct expenses,5eecc6d6449e4f7cfb1c2708,2023-03-07T00:00:00.000Z,NEFT DR-ICIC0000021-AKHILESH DIXIT-SANDO Z - MUM-N066232360941865-NET BANKING SI -131054,,,net_banking_transfer,-131054
64142ad9f8804aea7217112d,50200023535069,498117.44,60ec41ba55c00300382672d9,HDFC,direct expenses,5eecc6d6449e4f7cfb1c2708,2023-03-07T00:00:00.000Z,NEFT DR-ICIC0004109-ASHRAFI ASSOCIATES-S ANDOZ - MUM-N066232360941866-NET BANKING SI -10000,,,net_banking_transfer,-10000
64142ad9f8804aea72171130,50200023535069,451717.44,60ec41ba55c00300382672d9,HDFC,direct expenses,5eecc6d6449e4f7cfb1c2708,2023-03-07T00:00:00.000Z,NEFT DR-KKBK0008066-KUSHAGRA SINGH-SANDO Z - MUM-N066232360941867-NET BANKING SI -46400,,,net_banking_transfer,-46400
64142ad9f8804aea72171132,50200023535069,417367.44,60ec41ba55c00300382672d9,HDFC,direct expenses,5eecc6d6449e4f7cfb1c2708,2023-03-07T00:00:00.000Z,NEFT DR-SBIN0008079-DHARAMVEER-SANDOZ - MUM-N066232360941868-NET BANKING SI -343 50,,,net_banking_transfer,-34350
64142ad9f8804aea72171134,50200023535069,398289.44,60ec41ba55c00300382672d9,HDFC,N-ACH payments,5eecc6d6449e4f7cfb1c2708,2023-03-07T00:00:00.000Z,NEFT DR-DBSS0IN0811-SACHIN SINGH-SANDOZ - MUM-N066232360941869-NET BANKING SI -1 9078,,,net_banking_transfer,-19078
64142ad9f8804aea72171136,50200023535069,380119.44,60ec41ba55c00300382672d9,HDFC,direct expenses,5eecc6d6449e4f7cfb1c2708,2023-03-07T00:00:00.000Z,NEFT DR-PUNB0307800-SANJEEV NIRMANIA-SAN DOZ - MUM-N066232360941870-NET BANKING S I -18170,,,net_banking_transfer,-18170
64142ad9f8804aea72171138,50200023535069,364856.44,60ec41ba55c00300382672d9,HDFC,direct expenses,5eecc6d6449e4f7cfb1c2708,2023-03-07T00:00:00.000Z,NEFT DR-SCBL0036023-VIVEK YADAV-SANDOZ - MUM-N066232360941871-NET BANKING SI -15 263,,,net_banking_transfer,-15263
64142ad9f8804aea7217113a,50200023535069,345999.44,60ec41ba55c00300382672d9,HDFC,direct expenses,5eecc6d6449e4f7cfb1c2708,2023-03-07T00:00:00.000Z,NEFT DR-PUNB0MBGB06-MD ARIF RAZA-SANDOZ - MUM-N066232360941872-NET BANKING SI -1 8857,,,net_banking_transfer,-18857
64142ad9f8804aea7217113c,50200023535069,327142.44,60ec41ba55c00300382672d9,HDFC,direct expenses,5eecc6d6449e4f7cfb1c2708,2023-03-07T00:00:00.000Z,NEFT DR-PUNB0151400-BHUWAN CHANDER JOSHI -SANDOZ - MUM-N066232360941873-NET BANKI NG SI -18857,,,net_banking_transfer,-18857
64142ad9f8804aea7217113e,50200023535069,307292.44,60ec41ba55c00300382672d9,HDFC,direct expenses,5eecc6d6449e4f7cfb1c2708,2023-03-07T00:00:00.000Z,NEFT DR-PUNB0494300-KUNDAN PRASAD-SANDOZ - MUM-N066232360941874-NET BANKING SI - 19850,,,net_banking_transfer,-19850
64142ad9f8804aea72171140,50200023535069,286450.44,60ec41ba55c00300382672d9,HDFC,direct expenses,5eecc6d6449e4f7cfb1c2708,2023-03-07T00:00:00.000Z,NEFT DR-KKBK0005032-DEEPAK YADAV-SANDOZ - MUM-N066232360941875-NET BANKING SI -2 0842,,,net_banking_transfer,-20842
64142ad9f8804aea72171142,50200023535069,271187.44,60ec41ba55c00300382672d9,HDFC,direct expenses,5eecc6d6449e4f7cfb1c2708,2023-03-07T00:00:00.000Z,NEFT DR-UBIN0919721-PINKU-SANDOZ - MUM-N 066232360941876-NET BANKING SI -15263,,,net_banking_transfer,-15263
64142ad9f8804aea72171144,50200023535069,255617.44,60ec41ba55c00300382672d9,HDFC,direct expenses,5eecc6d6449e4f7cfb1c2708,2023-03-07T00:00:00.000Z,"NEFT DR-KKBK0000173-NITISH KUMAR MANDAL- NETBANK, MUM-N066232361058372-15570",,,net_banking_transfer,-15570
64142ad9f8804aea72171146,50200023535069,240354.44,60ec41ba55c00300382672d9,HDFC,direct expenses,5eecc6d6449e4f7cfb1c2708,2023-03-07T00:00:00.000Z,"NEFT DR-CNRB0019016-MANEESH-NETBANK, MUM -N066232361065088-15263",,,net_banking_transfer,-15263
64142ad9f8804aea72171148,50200023535069,223093.44,60ec41ba55c00300382672d9,HDFC,direct expenses,5eecc6d6449e4f7cfb1c2708,2023-03-07T00:00:00.000Z,"NEFT DR-SBIN0017746-MANOJ KUMAR-NETBANK, MUM-N066232361090750-17261",,,net_banking_transfer,-17261
64142ad9f8804aea7217114a,50200023535069,198093.44,60ec41ba55c00300382672d9,HDFC,direct expenses,5eecc6d6449e4f7cfb1c2708,2023-03-07T00:00:00.000Z,"NEFT DR-BARB0VJGRKA-OM PRASAD PANDEY-NET BANK, MUM-N066232361092716-25000",,,net_banking_transfer,-25000
64142ad9f8804aea7217114c,50200023535069,182830.44,60ec41ba55c00300382672d9,HDFC,direct expenses,5eecc6d6449e4f7cfb1c2708,2023-03-07T00:00:00.000Z,"NEFT DR-KKBK0005619-VIKASH KUMAR-NETBANK , MUM-N066232361097672-15263",,,net_banking_transfer,-15263
64142ad9f8804aea7217114e,50200023535069,82830.44,60ec41ba55c00300382672d9,HDFC,direct expenses,5eecc6d6449e4f7cfb1c2708,2023-03-07T00:00:00.000Z,"NEFT DR-YESB0000551-VISTTA COSMETICS-NET BANK, MUM-N066232361106722-100000",,,net_banking_transfer,-100000
64142ad9f8804aea72171150,50200023535069,88506.39,60ec41ba55c00300382672d9,HDFC,Transfer in/Revenue-other,5eecc6d6449e4f7cfb1c2708,2023-03-07T00:00:00.000Z,NEFT CR-UTIB0000114-ONE SIGMA TECHNOLOGI ES PRIVATE LIMI-SLICK ORGANICS PRIVATE L IMITED-AXISP00369393218,bnpl,,net_banking_transfer,5675.95
64142ad9f8804aea72171152,50200023535069,94496.39,60ec41ba55c00300382672d9,HDFC,Revenue-Mktplace,5eecc6d6449e4f7cfb1c2708,2023-03-07T00:00:00.000Z,IMPS-306614153654-DREAMPLUGPAYTECHSO-UTI B-XXXXXXXXXXX7853-,,,net_banking_transfer,5990
64142ad9f8804aea72171154,50200023535069,8496.39,60ec41ba55c00300382672d9,HDFC,direct expenses,5eecc6d6449e4f7cfb1c2708,2023-03-07T00:00:00.000Z,50200063961124-TPT-86000-BEYOND ADS,,,net_banking_transfer,-86000
64142ad9f8804aea72171156,50200023535069,11883.74,60ec41ba55c00300382672d9,HDFC,Transfer in/Revenue-other,5eecc6d6449e4f7cfb1c2708,2023-03-08T00:00:00.000Z,IMPS-306704786203-EXCRO PAY ESCROW ACC-Y ESB-XXXXXXXXXXX1807-333112298023,,,net_banking_transfer,3387.35
64142ad9f8804aea72171159,50200023535069,15747.46,60ec41ba55c00300382672d9,HDFC,Transfer in/Revenue-other,5eecc6d6449e4f7cfb1c2708,2023-03-08T00:00:00.000Z,IMPS-306707852826-EXCRO PAY ESCROW ACC-Y ESB-XXXXXXXXXXX1807-333112298023,,,net_banking_transfer,3863.72
64142ad9f8804aea7217115b,50200023535069,20398.97,60ec41ba55c00300382672d9,HDFC,Revenue-Mktplace,5eecc6d6449e4f7cfb1c2708,2023-03-08T00:00:00.000Z,NEFT CR-DEUT0797BGL-MYNTRA DESIGNS PRIVA TE LIMITED-SLICK ORGANICS - SJIT-3067010 10GN00023,shopping,,net_banking_transfer,4651.51
64142ad9f8804aea7217115e,50200023535069,21048.61,60ec41ba55c00300382672d9,HDFC,Revenue-Mktplace,5eecc6d6449e4f7cfb1c2708,2023-03-08T00:00:00.000Z,NEFT CR-DEUT0797BGL-MYNTRA DESIGNS PRIVA TE LIMITED-SLICK ORGANICS PVT. LTD.-3067 01032GN00285,shopping,,net_banking_transfer,649.64
64142ad9f8804aea72171160,50200023535069,23627.98,60ec41ba55c00300382672d9,HDFC,Revenue-PG-split enabled,5eecc6d6449e4f7cfb1c2708,2023-03-08T00:00:00.000Z,NEFT CR-UTIB0001506-RAZORPAY SOFTWARE PR IVATE LIMITED --SLICK ORGANICS PVT LITD- AXISCN0220224612,,,net_banking_transfer,2579.37
64142ad9f8804aea72171162,50200023535069,41359.98,60ec41ba55c00300382672d9,HDFC,Transfer in/Revenue-other,5eecc6d6449e4f7cfb1c2708,2023-03-08T00:00:00.000Z,NEFT CR-HSBC0560002-INNOVATIVE RETAIL CO NCEPTS PRIVATE-SLICK ORGANICS PVT LTD-HS BCN23067930595,,,net_banking_transfer,17732
64142ad9f8804aea72171164,50200023535069,48027.98,60ec41ba55c00300382672d9,HDFC,Transfer in/Revenue-other,5eecc6d6449e4f7cfb1c2708,2023-03-08T00:00:00.000Z,NEFT CR-HSBC0560002-INNOVATIVE RETAIL CO NCEPTS PRIVATE-SLICK ORGANICS PVT LTD-HS BCN23067930414,,,net_banking_transfer,6668
64142ad9f8804aea72171166,50200023535069,52345.98,60ec41ba55c00300382672d9,HDFC,Revenue-Mktplace,5eecc6d6449e4f7cfb1c2708,2023-03-08T00:00:00.000Z,IMPS-306714955250-DREAMPLUGPAYTECHSO-UTI B-XXXXXXXXXXX7853-,,,net_banking_transfer,4318
64142ad9f8804aea72171168,50200023535069,122602.83,60ec41ba55c00300382672d9,HDFC,Transfer in/Revenue-other,5eecc6d6449e4f7cfb1c2708,2023-03-08T00:00:00.000Z,NEFT CR-YESB0000001-EASEBUZZ PVT LTD NOD AL A/C-SLICK ORGANICS PVT LTD-YESB306735 10881,,,net_banking_transfer,70256.85
64142ad9f8804aea7217116a,50200023535069,124292.34,60ec41ba55c00300382672d9,HDFC,Revenue-PG-split enabled,5eecc6d6449e4f7cfb1c2708,2023-03-08T00:00:00.000Z,NEFT CR-UTIB0001506-RAZORPAY SOFTWARE PR IVATE LIMITED --SLICK ORGANICS PVT LITD-,,,net_banking_transfer,1689.51
64142ad9f8804aea7217116c,50200023535069,129292.34,60ec41ba55c00300382672d9,HDFC,Internal Transfers,5eecc6d6449e4f7cfb1c2708,2023-03-08T00:00:00.000Z,IB FUNDS TRANSFER CR-50200035187206 -SL ICK ORGANICS PVT LTD,,,Other,5000
64142ad9f8804aea7217116e,50200023535069,-707.66,60ec41ba55c00300382672d9,HDFC,direct expenses,5eecc6d6449e4f7cfb1c2708,2023-03-08T00:00:00.000Z,50200063961124-TPT-130000-BEYOND ADS,,,net_banking_transfer,-130000
64142ad9f8804aea72171170,50200023535069,17721.23,60ec41ba55c00300382672d9,HDFC,Transfer in/Revenue-other,5eecc6d6449e4f7cfb1c2708,2023-03-08T00:00:00.000Z,NEFT CR-IDFB0010204-PCPL CENTRAL DISBURS EMENT AC-SLICK ORGANICS PRIVATE LIMITED- IDFBH23067301251,,,net_banking_transfer,18428.89
64142ad9f8804aea72171172,50200023535069,104138.14,60ec41ba55c00300382672d9,HDFC,Transfer in/Revenue-other,5eecc6d6449e4f7cfb1c2708,2023-03-08T00:00:00.000Z,NEFT CR-YESB0000001-EASEBUZZ PVT LTD NOD AL A/C-SLICK ORGANICS PVT LTD-YESB306735 93316,,,net_banking_transfer,86416.91
64142ad9f8804aea72171174,50200023535069,158033.93,60ec41ba55c00300382672d9,HDFC,Transfer in/Revenue-other,5eecc6d6449e4f7cfb1c2708,2023-03-08T00:00:00.000Z,NEFT CR-IDFB0010204-PCPL CENTRAL DISBURS EMENT AC-SLICK ORGANICS PRIVATE LIMITED- IDFBH23067301252,,,net_banking_transfer,53895.79
64142ad9f8804aea72171176,50200023535069,160402.12,60ec41ba55c00300382672d9,HDFC,Transfer in/Revenue-other,5eecc6d6449e4f7cfb1c2708,2023-03-09T00:00:00.000Z,IMPS-306805721978-EXCRO PAY ESCROW ACC-Y ESB-XXXXXXXXXXX1807-333112298023,,,net_banking_transfer,2368.19
64142ad9f8804aea72171178,50200023535069,117076.12,60ec41ba55c00300382672d9,HDFC,direct expenses,5eecc6d6449e4f7cfb1c2708,2023-03-09T00:00:00.000Z,"NEFT DR-KKBK0000187-APPLIED LIFE PRIVATE LIMITED-NETBANK, MUM-N068232364310353-4 3326",,,net_banking_transfer,-43326
64142ad9f8804aea7217117a,50200023535069,117800.06,60ec41ba55c00300382672d9,HDFC,Revenue-PG-split enabled,5eecc6d6449e4f7cfb1c2708,2023-03-09T00:00:00.000Z,NEFT CR-UTIB0001506-RAZORPAY SOFTWARE PR IVATE LIMITED --SLICK ORGANICS PVT LITD- AXISCN0220668813,,,net_banking_transfer,723.94
64142ad9f8804aea7217117c,50200023535069,116345.87,60ec41ba55c00300382672d9,HDFC,bank charges,5eecc6d6449e4f7cfb1c2708,2023-03-09T00:00:00.000Z,.DC INTL POS TXN MARKUP+ST 020223 030223 -CDT2306614610237,,,international_transaction_arbitrage,-1454.19
64142ad9f8804aea7217117e,50200023535069,114858.05,60ec41ba55c00300382672d9,HDFC,bank charges,5eecc6d6449e4f7cfb1c2708,2023-03-09T00:00:00.000Z,.DC INTL POS TXN MARKUP+ST 020223 040223 -CDT2306614610237,,,international_transaction_arbitrage,-1487.82
64142ad9f8804aea72171180,50200023535069,69858.05,60ec41ba55c00300382672d9,HDFC,direct expenses,5eecc6d6449e4f7cfb1c2708,2023-03-09T00:00:00.000Z,"NEFT DR-IOBA0001445-PRIYANKA GOPAL-NETBA NK, MUM-N068232364651420-45000",,,net_banking_transfer,-45000
64142ad9f8804aea72171183,50200023535069,71056.05,60ec41ba55c00300382672d9,HDFC,Revenue-Mktplace,5eecc6d6449e4f7cfb1c2708,2023-03-09T00:00:00.000Z,IMPS-306814085363-DREAMPLUGPAYTECHSO-UTI B-XXXXXXXXXXX7853-,,,net_banking_transfer,1198
64142ad9f8804aea72171186,50200023535069,72995.05,60ec41ba55c00300382672d9,HDFC,Revenue-Mktplace,5eecc6d6449e4f7cfb1c2708,2023-03-09T00:00:00.000Z,NEFT CR-ICIC0000105-MANASH LIFETYLE PVT LTD-SLICK ORGANICS PRIVATE LIMITED-ICIB2 30680016805,,,net_banking_transfer,1939
64142ad9f8804aea72171188,50200023535069,146435.18,60ec41ba55c00300382672d9,HDFC,Revenue-COD,5eecc6d6449e4f7cfb1c2708,2023-03-09T00:00:00.000Z,NEFT CR-ICIC0000155-SHIPROCKET COD CRF I D 5850770-SLICK ORGANICS PVT LTD-CMS3168 852559,,,net_banking_transfer,73440.13
64142ad9f8804aea7217118a,50200023535069,153241.52,60ec41ba55c00300382672d9,HDFC,Transfer in/Revenue-other,5eecc6d6449e4f7cfb1c2708,2023-03-09T00:00:00.000Z,NEFT CR-UTIB0000114-ONE SIGMA TECHNOLOGI ES PRIVATE LIMI-SLICK ORGANICS PRIVATE L IMITED-AXISP00370086492,bnpl,,net_banking_transfer,6806.34
64142ad9f8804aea7217118c,50200023535069,154375.91,60ec41ba55c00300382672d9,HDFC,Transfer in/Revenue-other,5eecc6d6449e4f7cfb1c2708,2023-03-09T00:00:00.000Z,NEFT CR-UTIB0000114-ONE SIGMA TECHNOLOGI ES PRIVATE LIMI-SLICK ORGANICS PRIVATE L IMITED-AXISP00370086516,bnpl,,net_banking_transfer,1134.39
64142ad9f8804aea7217118f,50200023535069,251982.94,60ec41ba55c00300382672d9,HDFC,Transfer in/Revenue-other,5eecc6d6449e4f7cfb1c2708,2023-03-09T00:00:00.000Z,NEFT CR-YESB0000001-EASEBUZZ PVT LTD NOD AL A/C-SLICK ORGANICS PVT LTD-YESB306862 40953,,,net_banking_transfer,97607.03
64142ad9f8804aea72171192,50200023535069,252880.81,60ec41ba55c00300382672d9,HDFC,Revenue-PG-split enabled,5eecc6d6449e4f7cfb1c2708,2023-03-09T00:00:00.000Z,NEFT CR-UTIB0001506-RAZORPAY SOFTWARE PR IVATE LIMITED --SLICK ORGANICS PVT LITD- AXISCN0220950693,,,net_banking_transfer,897.87
64142ad9f8804aea72171194,50200023535069,256874.13,60ec41ba55c00300382672d9,HDFC,Transfer in/Revenue-other,5eecc6d6449e4f7cfb1c2708,2023-03-10T00:00:00.000Z,IMPS-306905868162-EXCRO PAY ESCROW ACC-Y ESB-XXXXXXXXXXX1807-333112298023,,,net_banking_transfer,3993.32
64142ad9f8804aea72171196,50200023535069,261331.99,60ec41ba55c00300382672d9,HDFC,Transfer in/Revenue-other,5eecc6d6449e4f7cfb1c2708,2023-03-10T00:00:00.000Z,NEFT CR-YESB0000001-EXCRO PAY ESCROW ACC OUNT-SLICKORGANICSPRIVATELIMITED-YESB306 99242337,,,net_banking_transfer,4457.86
64142ad9f8804aea72171198,50200023535069,268347.7,60ec41ba55c00300382672d9,HDFC,Revenue-Mktplace,5eecc6d6449e4f7cfb1c2708,2023-03-10T00:00:00.000Z,NEFT CR-DEUT0797BGL-MYNTRA DESIGNS PRIVA TE LIMITED-SLICK ORGANICS - SJIT-3069010 25GN00049,shopping,,net_banking_transfer,7015.71
64142ad9f8804aea7217119a,50200023535069,268970.25,60ec41ba55c00300382672d9,HDFC,Revenue-Mktplace,5eecc6d6449e4f7cfb1c2708,2023-03-10T00:00:00.000Z,NEFT CR-DEUT0797BGL-MYNTRA DESIGNS PRIVA TE LIMITED-SLICK ORGANICS PVT. LTD.-3069 01034GN00275,shopping,,net_banking_transfer,622.55
64142ad9f8804aea7217119c,50200023535069,270232.05,60ec41ba55c00300382672d9,HDFC,Revenue-PG-split enabled,5eecc6d6449e4f7cfb1c2708,2023-03-10T00:00:00.000Z,NEFT CR-UTIB0001506-RAZORPAY SOFTWARE PR IVATE LIMITED --SLICK ORGANICS PVT LITD- AXISCN0221088943,,,net_banking_transfer,1261.8
64142ad9f8804aea7217119e,50200023535069,255102.05,60ec41ba55c00300382672d9,HDFC,direct expenses,5eecc6d6449e4f7cfb1c2708,2023-03-10T00:00:00.000Z,"NEFT DR-KKBK0004632-DOLLY JAIN-NETBANK, MUM-N069232366327060-15130",,,net_banking_transfer,-15130
64142adaf8804aea721711a0,50200023535069,205102.05,60ec41ba55c00300382672d9,HDFC,direct expenses,5eecc6d6449e4f7cfb1c2708,2023-03-10T00:00:00.000Z,50200076217337-TPT-50000-MARKETING MANTR,,,net_banking_transfer,-50000
64142adaf8804aea721711a2,50200023535069,5102.05,60ec41ba55c00300382672d9,HDFC,direct expenses,5eecc6d6449e4f7cfb1c2708,2023-03-10T00:00:00.000Z,"NEFT DR-ICIC0000369-BO INTERNATIONAL-NET BANK, MUM-N069232366358658-200000",,,net_banking_transfer,-200000
64142adaf8804aea721711a4,50200023535069,10102.05,60ec41ba55c00300382672d9,HDFC,Internal Transfers,5eecc6d6449e4f7cfb1c2708,2023-03-10T00:00:00.000Z,IB FUNDS TRANSFER CR-50200035187206 -SL ICK ORGANICS PVT LTD,,,Other,5000
64142adaf8804aea721711a7,50200023535069,15102.05,60ec41ba55c00300382672d9,HDFC,Internal Transfers,5eecc6d6449e4f7cfb1c2708,2023-03-10T00:00:00.000Z,IB FUNDS TRANSFER CR-50200035187206 -SL ICK ORGANICS PVT LTD,,,Other,5000
64142adaf8804aea721711a9,50200023535069,17273.8,60ec41ba55c00300382672d9,HDFC,Transfer in/Revenue-other,5eecc6d6449e4f7cfb1c2708,2023-03-10T00:00:00.000Z,NEFT CR-HSBC0400002-SOUQ.COM FZ LLC UAE ACCS-SLICK ORGANICS PRIVATE LIMITED-HSBC N23069305623,,,net_banking_transfer,2171.75
64142adaf8804aea721711ab,50200023535069,18185.8,60ec41ba55c00300382672d9,HDFC,Revenue-Mktplace,5eecc6d6449e4f7cfb1c2708,2023-03-10T00:00:00.000Z,NEFT CR-ICIC0000105-MANASH LIFETYLE PVT LTD-SLICK ORGANICS PRIVATE LIMITED-ICIB2 30690017501,,,net_banking_transfer,912
64142adaf8804aea721711ad,50200023535069,26571.8,60ec41ba55c00300382672d9,HDFC,Revenue-Mktplace,5eecc6d6449e4f7cfb1c2708,2023-03-10T00:00:00.000Z,IMPS-306914779739-DREAMPLUGPAYTECHSO-UTI B-XXXXXXXXXXX7853-,,,net_banking_transfer,8386
64142adaf8804aea721711b0,50200023535069,34512.53,60ec41ba55c00300382672d9,HDFC,Transfer in/Revenue-other,5eecc6d6449e4f7cfb1c2708,2023-03-10T00:00:00.000Z,NEFT CR-UTIB0000114-ONE SIGMA TECHNOLOGI ES PRIVATE LIMI-SLICK ORGANICS PRIVATE L IMITED-AXISP00370323454,bnpl,,net_banking_transfer,7940.73
64142adaf8804aea721711b2,50200023535069,132352.6,60ec41ba55c00300382672d9,HDFC,Revenue-COD,5eecc6d6449e4f7cfb1c2708,2023-03-10T00:00:00.000Z,NEFT CR-ICIC0000155-SHIPROCKET COD CRF I D 5863055-SLICK ORGANICS PVT LTD-CMS3171 320391,,,net_banking_transfer,97840.07
64142adaf8804aea721711b6,50200023535069,153995.45,60ec41ba55c00300382672d9,HDFC,Transfer in/Revenue-other,5eecc6d6449e4f7cfb1c2708,2023-03-10T00:00:00.000Z,NEFT CR-DBSS0IN0811-EPL LIMITED-SLICK OR GANICS PRIVATE LIMITED-0811OP3116048570,,,net_banking_transfer,21642.85
64142adaf8804aea721711b8,50200023535069,213010.96,60ec41ba55c00300382672d9,HDFC,Transfer in/Revenue-other,5eecc6d6449e4f7cfb1c2708,2023-03-10T00:00:00.000Z,NEFT CR-YESB0000001-EASEBUZZ PVT LTD NOD AL A/C-SLICK ORGANICS PVT LTD-YESB306994 73458,,,net_banking_transfer,59015.51
64142adaf8804aea721711ba,50200023535069,229119.58,60ec41ba55c00300382672d9,HDFC,Transfer in/Revenue-other,5eecc6d6449e4f7cfb1c2708,2023-03-10T00:00:00.000Z,NEFT CR-YESB0000001-EASEBUZZ PVT LTD NOD AL A/C-SLICK ORGANICS PVT LTD-YESB306994 74068,,,net_banking_transfer,16108.62
64142adaf8804aea721711bc,50200023535069,230051.62,60ec41ba55c00300382672d9,HDFC,Revenue-PG-split enabled,5eecc6d6449e4f7cfb1c2708,2023-03-10T00:00:00.000Z,NEFT CR-UTIB0001506-RAZORPAY SOFTWARE PR IVATE LIMITED --SLICK ORGANICS PVT LITD- AXISCN0221397896,,,net_banking_transfer,932.04
64142adaf8804aea721711be,50200023535069,30051.62,60ec41ba55c00300382672d9,HDFC,direct expenses,5eecc6d6449e4f7cfb1c2708,2023-03-10T00:00:00.000Z,POS 514834XXXXXX0472 E-COMMERCE RP,,,debit_card,-200000
64142adaf8804aea721711c0,50200023535069,31502.5,60ec41ba55c00300382672d9,HDFC,Transfer in/Revenue-other,5eecc6d6449e4f7cfb1c2708,2023-03-11T00:00:00.000Z,IMPS-307004892844-EXCRO PAY ESCROW ACC-Y ESB-XXXXXXXXXXX1807-333112298023,,,net_banking_transfer,1450.88
64142adaf8804aea721711c3,50200023535069,21809.5,60ec41ba55c00300382672d9,HDFC,direct expenses,5eecc6d6449e4f7cfb1c2708,2023-03-11T00:00:00.000Z,02023108640257/ESIC,,,Other,-9693
64142adaf8804aea721711c5,50200023535069,-2190.5,60ec41ba55c00300382672d9,HDFC,direct expenses,5eecc6d6449e4f7cfb1c2708,2023-03-11T00:00:00.000Z,POS 514834XXXXXX0472 E-COMMERCE RP,,,debit_card,-24000
64142adaf8804aea721711c8,50200023535069,-3190.5,60ec41ba55c00300382672d9,HDFC,direct expenses,5eecc6d6449e4f7cfb1c2708,2023-03-11T00:00:00.000Z,"NEFT DR-PUNB0062910-YADAVPACKAGING-NETBA NK, MUM-N070232368562816-1000",,,net_banking_transfer,-1000
64142adaf8804aea721711ca,50200023535069,-3172.5,60ec41ba55c00300382672d9,HDFC,Transfer in/Revenue-other,5eecc6d6449e4f7cfb1c2708,2023-03-12T00:00:00.000Z,INT. ON SWCR ON-50300720580141,,,Other,18
64142adaf8804aea721711cc,50200023535069,-981.5,60ec41ba55c00300382672d9,HDFC,Loan-in,5eecc6d6449e4f7cfb1c2708,2023-03-12T00:00:00.000Z,SWEEP-IN CREDIT - 50300720580141,,,self_transfer,2191
64142adaf8804aea721711ce,50200023535069,-973.5,60ec41ba55c00300382672d9,HDFC,Transfer in/Revenue-other,5eecc6d6449e4f7cfb1c2708,2023-03-12T00:00:00.000Z,INT. ON SWCR ON-50300720580141,,,Other,8
64142adaf8804aea721711d0,50200023535069,8.5,60ec41ba55c00300382672d9,HDFC,Loan-in,5eecc6d6449e4f7cfb1c2708,2023-03-12T00:00:00.000Z,SWEEP-IN CREDIT - 50300720580141,,,self_transfer,982
64142adaf8804aea721711d2,50200023535069,2446.03,60ec41ba55c00300382672d9,HDFC,Transfer in/Revenue-other,5eecc6d6449e4f7cfb1c2708,2023-03-12T00:00:00.000Z,IMPS-307108905614-EXCRO PAY ESCROW ACC-Y ESB-XXXXXXXXXXX1807-333112298023,,,net_banking_transfer,2437.53
64142adaf8804aea721711d4,50200023535069,4884.74,60ec41ba55c00300382672d9,HDFC,Transfer in/Revenue-other,5eecc6d6449e4f7cfb1c2708,2023-03-13T00:00:00.000Z,IMPS-307204831497-EXCRO PAY ESCROW ACC-Y ESB-XXXXXXXXXXX1807-333112298023,,,net_banking_transfer,2438.71
64142adaf8804aea721711d6,50200023535069,63137.14,60ec41ba55c00300382672d9,HDFC,Transfer in/Revenue-other,5eecc6d6449e4f7cfb1c2708,2023-03-13T00:00:00.000Z,NEFT CR-UTIB0000020-EMIZA SUPPLY CHAIN S ERVICES PRIVATE-SLICK ORGANICS PRIVATE L IMITED-AXISP00370617383,,,net_banking_transfer,58252.4
64142adaf8804aea721711d8,50200023535069,79638.96,60ec41ba55c00300382672d9,HDFC,Revenue-Mktplace,5eecc6d6449e4f7cfb1c2708,2023-03-13T00:00:00.000Z,NEFT CR-DEUT0797BGL-MYNTRA DESIGNS PRIVA TE LIMITED-SLICK ORGANICS - SJIT-3072007 41GN00083,shopping,,net_banking_transfer,16501.82
64142adaf8804aea721711da,50200023535069,84591.25,60ec41ba55c00300382672d9,HDFC,Revenue-Mktplace,5eecc6d6449e4f7cfb1c2708,2023-03-13T00:00:00.000Z,NEFT CR-DEUT0797BGL-MYNTRA DESIGNS PRIVA TE LIMITED-SLICK ORGANICS PVT. LTD.-3072 00761GN00123,shopping,,net_banking_transfer,4952.29
64142adaf8804aea721711dc,50200023535069,89540.5,60ec41ba55c00300382672d9,HDFC,Revenue-PG-split enabled,5eecc6d6449e4f7cfb1c2708,2023-03-13T00:00:00.000Z,NEFT CR-UTIB0001506-RAZORPAY SOFTWARE PR IVATE LIMITED --SLICK ORGANICS PVT LITD- AXISCN0221831084,,,net_banking_transfer,4949.25
64142adaf8804aea721711de,50200023535069,102783.46,60ec41ba55c00300382672d9,HDFC,Transfer in/Revenue-other,5eecc6d6449e4f7cfb1c2708,2023-03-13T00:00:00.000Z,NEFT CR-SCBL0036001-HEALTH GLOW PRIVATE LIMITED-SLICK ORGANICS PVT LTD-ARATA-IN 1ON23031301580,,,net_banking_transfer,13242.96
64142adaf8804aea721711e7,50200023535069,106241.46,60ec41ba55c00300382672d9,HDFC,Revenue-Mktplace,5eecc6d6449e4f7cfb1c2708,2023-03-13T00:00:00.000Z,NEFT CR-ICIC0000105-MANASH LIFETYLE PVT LTD-SLICK ORGANICS PRIVATE LIMITED-ICIB2,,,net_banking_transfer,3458
64142adaf8804aea721711e9,50200023535069,266154.23,60ec41ba55c00300382672d9,HDFC,Transfer in/Revenue-other,5eecc6d6449e4f7cfb1c2708,2023-03-13T00:00:00.000Z,NEFT CR-YESB0000001-EASEBUZZ PVT LTD NOD AL A/C-SLICK ORGANICS PVT LTD-YESB307286 32407,,,net_banking_transfer,159912.77
64142adaf8804aea721711eb,50200023535069,279082.33,60ec41ba55c00300382672d9,HDFC,Revenue-Mktplace,5eecc6d6449e4f7cfb1c2708,2023-03-13T00:00:00.000Z,IMPS-307214802432-DREAMPLUGPAYTECHSO-UTI B-XXXXXXXXXXX7853-,,,net_banking_transfer,12928.1
64142adaf8804aea721711ed,50200023535069,163780.33,60ec41ba55c00300382672d9,HDFC,Salary/Emp/consultant Expense,5eecc6d6449e4f7cfb1c2708,2023-03-13T00:00:00.000Z,2079821606/EPFO,,,Other,-115302
64142adaf8804aea721711ef,50200023535069,161644.33,60ec41ba55c00300382672d9,HDFC,direct expenses,5eecc6d6449e4f7cfb1c2708,2023-03-13T00:00:00.000Z,2079825020/EPFO,,,Other,-2136
64142adaf8804aea721711f1,50200023535069,162474.33,60ec41ba55c00300382672d9,HDFC,Transfer in/Revenue-other,5eecc6d6449e4f7cfb1c2708,2023-03-13T00:00:00.000Z,NEFT CR-SCBL0036001-HEALTH GLOW PRIVATE LIMITED-SLICK ORGANICS PVT LTD-ARATA-IN 1ON23031301JIQ,,,net_banking_transfer,830
64142adaf8804aea721711f3,50200023535069,167234.33,60ec41ba55c00300382672d9,HDFC,Transfer in/Revenue-other,5eecc6d6449e4f7cfb1c2708,2023-03-13T00:00:00.000Z,NEFT CR-SCBL0036001-HEALTH GLOW PRIVATE LIMITED-SLICK ORGANICS PVT LTD-ARATA-IN 1ON23031301JH5,,,net_banking_transfer,4760
64142adaf8804aea721711f5,50200023535069,16788.33,60ec41ba55c00300382672d9,HDFC,direct expenses,5eecc6d6449e4f7cfb1c2708,2023-03-13T00:00:00.000Z,POS 514834XXXXXX0472 E-COMMERCE RP,,,debit_card,-150446
64142adaf8804aea721711f8,50200023535069,1016788.33,60ec41ba55c00300382672d9,HDFC,Internal Transfers,5eecc6d6449e4f7cfb1c2708,2023-03-13T00:00:00.000Z,IB FUNDS TRANSFER CR-50200035187206 -SL ICK ORGANICS PVT LTD,,,Other,1000000
64142adaf8804aea721711fa,50200023535069,1016302.87,60ec41ba55c00300382672d9,HDFC,SAAS/tech expense,5eecc6d6449e4f7cfb1c2708,2023-03-13T00:00:00.000Z,POS 514834XXXXXX0472 AMAZONIN,shopping,,debit_card,-485.46
64142adaf8804aea721711fc,50200023535069,1022982.45,60ec41ba55c00300382672d9,HDFC,Transfer in/Revenue-other,5eecc6d6449e4f7cfb1c2708,2023-03-13T00:00:00.000Z,NEFT CR-YESB0000001-EXCRO PAY ESCROW ACC OUNT-SLICKORGANICSPRIVATELIMITED-YESB307 28688903,,,net_banking_transfer,6679.58
64142adaf8804aea721711fe,50200023535069,1027142.18,60ec41ba55c00300382672d9,HDFC,Transfer in/Revenue-other,5eecc6d6449e4f7cfb1c2708,2023-03-13T00:00:00.000Z,NEFT CR-UTIB0000114-ONE SIGMA TECHNOLOGI ES PRIVATE LIMI-SLICK ORGANICS PRIVATE L IMITED-AXISP00370808290,bnpl,,net_banking_transfer,4159.73
64142adaf8804aea72171200,50200023535069,1032814.13,60ec41ba55c00300382672d9,HDFC,Transfer in/Revenue-other,5eecc6d6449e4f7cfb1c2708,2023-03-13T00:00:00.000Z,NEFT CR-UTIB0000114-ONE SIGMA TECHNOLOGI ES PRIVATE LIMI-SLICK ORGANICS PRIVATE L IMITED-AXISP00370808516,bnpl,,net_banking_transfer,5671.95
64142adaf8804aea72171202,50200023535069,1040754.86,60ec41ba55c00300382672d9,HDFC,Transfer in/Revenue-other,5eecc6d6449e4f7cfb1c2708,2023-03-13T00:00:00.000Z,NEFT CR-UTIB0000114-ONE SIGMA TECHNOLOGI ES PRIVATE LIMI-SLICK ORGANICS PRIVATE L IMITED-AXISP00370807878,bnpl,,net_banking_transfer,7940.73
64142adaf8804aea72171205,50200023535069,850754.86,60ec41ba55c00300382672d9,HDFC,direct expenses,5eecc6d6449e4f7cfb1c2708,2023-03-13T00:00:00.000Z,POS 514834XXXXXX0472 E-COMMERCE RP,,,debit_card,-190000
64142adaf8804aea72171207,50200023535069,740754.86,60ec41ba55c00300382672d9,HDFC,direct expenses,5eecc6d6449e4f7cfb1c2708,2023-03-13T00:00:00.000Z,POS 514834XXXXXX0472 E-COMMERCE RP,,,debit_card,-110000
64142adaf8804aea72171209,50200023535069,881653.93,60ec41ba55c00300382672d9,HDFC,Revenue-COD,5eecc6d6449e4f7cfb1c2708,2023-03-13T00:00:00.000Z,NEFT CR-ICIC0000155-SHIPROCKET COD CRF I D 5871358-SLICK ORGANICS PVT LTD-CMS3175 557508,,,net_banking_transfer,140899.07
64142adaf8804aea7217120b,50200023535069,31653.93,60ec41ba55c00300382672d9,HDFC,direct expenses,5eecc6d6449e4f7cfb1c2708,2023-03-13T00:00:00.000Z,"NEFT DR-RATN0VAAPIS-CR CARD COLLECTION P ARKING GL-NETBANK, MUM-N072232370271791- BY SLICK ORGANICS",,,net_banking_transfer,-850000
64142adaf8804aea7217120d,50200023535069,31650.93,60ec41ba55c00300382672d9,HDFC,Marketing Expense,5eecc6d6449e4f7cfb1c2708,2023-03-13T00:00:00.000Z,ME DC SI 514834XXXXXX0472 FACEBOOK,,,Other,-3
64142adaf8804aea7217120f,50200023535069,32512.81,60ec41ba55c00300382672d9,HDFC,Revenue-PG-split enabled,5eecc6d6449e4f7cfb1c2708,2023-03-13T00:00:00.000Z,NEFT CR-UTIB0001506-RAZORPAY SOFTWARE PR IVATE LIMITED --SLICK ORGANICS PVT LITD- AXISCN0222204291,,,net_banking_transfer,861.88
64142adaf8804aea72171213,50200023535069,42512.81,60ec41ba55c00300382672d9,HDFC,Internal Transfers,5eecc6d6449e4f7cfb1c2708,2023-03-13T00:00:00.000Z,IB FUNDS TRANSFER CR-50200035187206 -SL ICK ORGANICS PVT LTD,,,Other,10000
64142adaf8804aea72171215,50200023535069,52512.81,60ec41ba55c00300382672d9,HDFC,Internal Transfers,5eecc6d6449e4f7cfb1c2708,2023-03-13T00:00:00.000Z,IB FUNDS TRANSFER CR-50200050976833 -SL ICK ORGANICS PVT LTD,,,Other,10000
64142adaf8804aea72171217,50200023535069,138000.62,60ec41ba55c00300382672d9,HDFC,Transfer in/Revenue-other,5eecc6d6449e4f7cfb1c2708,2023-03-13T00:00:00.000Z,NEFT CR-YESB0000001-EASEBUZZ PVT LTD NOD AL A/C-SLICK ORGANICS PVT LTD-YESB307288 48709,,,net_banking_transfer,85487.81
64142adaf8804aea72171219,50200023535069,88000.62,60ec41ba55c00300382672d9,HDFC,direct expenses,5eecc6d6449e4f7cfb1c2708,2023-03-13T00:00:00.000Z,IMPS-307218165565-CR CARD COLLECTION PAR KING GL-RATN-XXXXXXXXXXXX6206-SLICK ORGA NICS PVT LTD,,,net_banking_transfer,-50000
64142adaf8804aea7217121b,50200023535069,94000.62,60ec41ba55c00300382672d9,HDFC,Internal Transfers,5eecc6d6449e4f7cfb1c2708,2023-03-13T00:00:00.000Z,IB FUNDS TRANSFER CR-50200050976833 -SL ICK ORGANICS PVT LTD,,,Other,6000
64142adbf8804aea7217121d,50200023535069,4000.62,60ec41ba55c00300382672d9,HDFC,direct expenses,5eecc6d6449e4f7cfb1c2708,2023-03-13T00:00:00.000Z,"NEFT DR-UBIN0820296-HITESH ARORA-NETBANK , MUM-N072232370584803-BY SLICK",,,net_banking_transfer,-90000
64142adbf8804aea7217121f,50200023535069,5897.56,60ec41ba55c00300382672d9,HDFC,Transfer in/Revenue-other,5eecc6d6449e4f7cfb1c2708,2023-03-14T00:00:00.000Z,IMPS-307304653256-EXCRO PAY ESCROW ACC-Y ESB-XXXXXXXXXXX1807-333112298023,,,net_banking_transfer,1896.94
64142adbf8804aea72171221,50200023535069,6688.05,60ec41ba55c00300382672d9,HDFC,Revenue-PG-split enabled,5eecc6d6449e4f7cfb1c2708,2023-03-14T00:00:00.000Z,NEFT CR-UTIB0001506-RAZORPAY SOFTWARE PR IVATE LIMITED --SLICK ORGANICS PVT LITD- AXISCN0222352804,,,net_banking_transfer,790.49
64142adbf8804aea72171223,50200023535069,10282.05,60ec41ba55c00300382672d9,HDFC,Revenue-Mktplace,5eecc6d6449e4f7cfb1c2708,2023-03-14T00:00:00.000Z,IMPS-307314987397-DREAMPLUGPAYTECHSO-UTI B-XXXXXXXXXXX7853-,,,net_banking_transfer,3594
64142adbf8804aea72171225,50200023535069,12550.83,60ec41ba55c00300382672d9,HDFC,Transfer in/Revenue-other,5eecc6d6449e4f7cfb1c2708,2023-03-14T00:00:00.000Z,NEFT CR-UTIB0000114-ONE SIGMA TECHNOLOGI ES PRIVATE LIMI-SLICK ORGANICS PRIVATE L IMITED-AXISP00371136852,bnpl,,net_banking_transfer,2268.78
64142adbf8804aea72171227,50200023535069,18988.83,60ec41ba55c00300382672d9,HDFC,Transfer in/Revenue-other,5eecc6d6449e4f7cfb1c2708,2023-03-14T00:00:00.000Z,NEFT CR-HSBC0110002-NAPSA PRIVATE LIMITE D-SLICK ORGANICS PVT. LTD.-HSBCN23073861 580,,,net_banking_transfer,6438
64142adbf8804aea72171229,50200023535069,19356.83,60ec41ba55c00300382672d9,HDFC,Revenue-Mktplace,5eecc6d6449e4f7cfb1c2708,2023-03-14T00:00:00.000Z,NEFT CR-ICIC0000105-MANASH LIFESTYLE PRI VATE LIMITED NO-SLICK ORGANICS PRIVATE L IMITED-ICIJ230730001944,shopping,,net_banking_transfer,368
64142adbf8804aea7217122b,50200023535069,28569.18,60ec41ba55c00300382672d9,HDFC,Transfer in/Revenue-other,5eecc6d6449e4f7cfb1c2708,2023-03-14T00:00:00.000Z,NEFT CR-IDFB0010204-PCPL CENTRAL DISBURS EMENT AC-SLICK ORGANICS PRIVATE LIMITED- IDFBH23073227668,,,net_banking_transfer,9212.35
64142adbf8804aea7217122d,50200023535069,83836.91,60ec41ba55c00300382672d9,HDFC,Transfer in/Revenue-other,5eecc6d6449e4f7cfb1c2708,2023-03-14T00:00:00.000Z,NEFT CR-IDFB0010204-PCPL CENTRAL DISBURS EMENT AC-SLICK ORGANICS PRIVATE LIMITED- IDFBH23073227667,,,net_banking_transfer,55267.73
64142adbf8804aea7217122f,50200023535069,84442.93,60ec41ba55c00300382672d9,HDFC,Revenue-PG-split enabled,5eecc6d6449e4f7cfb1c2708,2023-03-14T00:00:00.000Z,NEFT CR-UTIB0001506-RAZORPAY SOFTWARE PR IVATE LIMITED --SLICK ORGANICS PVT LITD- AXISCN0222676214,,,net_banking_transfer,606.02
64142adbf8804aea72171231,50200023535069,103616.99,60ec41ba55c00300382672d9,HDFC,Transfer in/Revenue-other,5eecc6d6449e4f7cfb1c2708,2023-03-14T00:00:00.000Z,NEFT CR-YESB0000001-EASEBUZZ PVT LTD NOD AL A/C-SLICK ORGANICS PVT LTD-YESB307323 00476,,,net_banking_transfer,19174.06
64142adbf8804aea72171233,50200023535069,158359.1,60ec41ba55c00300382672d9,HDFC,Transfer in/Revenue-other,5eecc6d6449e4f7cfb1c2708,2023-03-14T00:00:00.000Z,NEFT CR-YESB0000001-EASEBUZZ PVT LTD NOD AL A/C-SLICK ORGANICS PVT LTD-YESB307323 01056,,,net_banking_transfer,54742.11
64142adbf8804aea72171235,50200023535069,160790.23,60ec41ba55c00300382672d9,HDFC,Transfer in/Revenue-other,5eecc6d6449e4f7cfb1c2708,2023-03-15T00:00:00.000Z,IMPS-307407884669-EXCRO PAY ESCROW ACC-Y ESB-XXXXXXXXXXX1807-333112298023,,,net_banking_transfer,2431.13
64142adbf8804aea72171237,50200023535069,169544.55,60ec41ba55c00300382672d9,HDFC,Revenue-Mktplace,5eecc6d6449e4f7cfb1c2708,2023-03-15T00:00:00.000Z,NEFT CR-DEUT0797BGL-MYNTRA DESIGNS PRIVA TE LIMITED-SLICK ORGANICS - SJIT-3074010 41GN00030,shopping,,net_banking_transfer,8754.32
64142adbf8804aea72171239,50200023535069,170336.99,60ec41ba55c00300382672d9,HDFC,Revenue-PG-split enabled,5eecc6d6449e4f7cfb1c2708,2023-03-15T00:00:00.000Z,NEFT CR-UTIB0001506-RAZORPAY SOFTWARE PR IVATE LIMITED --SLICK ORGANICS PVT LITD- AXISCN0222929580,,,net_banking_transfer,792.44
64142adbf8804aea7217123b,50200023535069,222531.23,60ec41ba55c00300382672d9,HDFC,Revenue-Mktplace,5eecc6d6449e4f7cfb1c2708,2023-03-15T00:00:00.000Z,NEFT CR-DEUT0797BGL-MYNTRA DESIGNS PRIVA TE LIMITED-SLICK ORGANICS PVT. LTD.-3074 01079GN00116,shopping,,net_banking_transfer,52194.24
64142adbf8804aea72171240,50200023535069,2531.23,60ec41ba55c00300382672d9,HDFC,direct expenses,5eecc6d6449e4f7cfb1c2708,2023-03-15T00:00:00.000Z,"NEFT DR-ICIC0000369-BO INTERNATIONAL-NET BANK, MUM-N074232372680563-220000",,,net_banking_transfer,-220000
64142adbf8804aea72171243,50200023535069,4513.01,60ec41ba55c00300382672d9,HDFC,Transfer in/Revenue-other,5eecc6d6449e4f7cfb1c2708,2023-03-15T00:00:00.000Z,NEFT CR-YESB0000001-EXCRO PAY ESCROW ACC OUNT-SLICKORGANICSPRIVATELIMITED-YESB307 45292836,,,net_banking_transfer,1981.78
64142adbf8804aea72171245,50200023535069,4888.01,60ec41ba55c00300382672d9,HDFC,Revenue-Mktplace,5eecc6d6449e4f7cfb1c2708,2023-03-15T00:00:00.000Z,NEFT CR-ICIC0000105-MANASH LIFESTYLE PRI VATE LIMITED NO-SLICK ORGANICS PRIVATE L IMITED-ICIJ230740000510,shopping,,net_banking_transfer,375
64142adbf8804aea72171248,50200023535069,8371.91,60ec41ba55c00300382672d9,HDFC,Revenue-Mktplace,5eecc6d6449e4f7cfb1c2708,2023-03-15T00:00:00.000Z,IMPS-307414836541-DREAMPLUGPAYTECHSO-UTI B-XXXXXXXXXXX7853-,,,net_banking_transfer,3483.9
64142adbf8804aea7217124a,50200023535069,15696.11,60ec41ba55c00300382672d9,HDFC,Transfer in/Revenue-other,5eecc6d6449e4f7cfb1c2708,2023-03-15T00:00:00.000Z,NEFT CR-UTIB0000114-ONE SIGMA TECHNOLOGI ES PRIVATE LIMI-SLICK ORGANICS PRIVATE L IMITED-AXISP00371481658,bnpl,,net_banking_transfer,7324.2
64142adbf8804aea7217124c,50200023535069,88726.67,60ec41ba55c00300382672d9,HDFC,Transfer in/Revenue-other,5eecc6d6449e4f7cfb1c2708,2023-03-15T00:00:00.000Z,NEFT CR-YESB0000001-EASEBUZZ PVT LTD NOD AL A/C-SLICK ORGANICS PVT LTD-YESB307454 26216,,,net_banking_transfer,73030.56
64142adbf8804aea7217124e,50200023535069,768959.69,60ec41ba55c00300382672d9,HDFC,Transfer in/Revenue-other,5eecc6d6449e4f7cfb1c2708,2023-03-15T00:00:00.000Z,RTGS CR-HSBC0400001-GTRF FUNDS TRANSFER- SLICK ORGANICS PRIVATE LIMITED-HSBCR2202 3031519500397,,,net_banking_transfer,680233.02
64142adbf8804aea72171250,50200023535069,776991.69,60ec41ba55c00300382672d9,HDFC,Revenue-Mktplace,5eecc6d6449e4f7cfb1c2708,2023-03-15T00:00:00.000Z,NEFT CR-ICIC0000985-DIGITAL AGE RETAIL P VT LTD-SLICK ORGANICS PVT LTD DS-CMS31 80874691,,,net_banking_transfer,8032
64142adbf8804aea72171252,50200023535069,777991.06,60ec41ba55c00300382672d9,HDFC,Revenue-PG-split enabled,5eecc6d6449e4f7cfb1c2708,2023-03-15T00:00:00.000Z,NEFT CR-UTIB0001506-RAZORPAY SOFTWARE PR IVATE LIMITED --SLICK ORGANICS PVT LITD- AXISCN0223298106,,,net_banking_transfer,999.37
64142adbf8804aea72171254,50200023535069,627991.06,60ec41ba55c00300382672d9,HDFC,direct expenses,5eecc6d6449e4f7cfb1c2708,2023-03-15T00:00:00.000Z,"NEFT DR-YESB0000551-VISTTA COSMETICS-NET BANK, MUM-N074232373853577-150000",,,net_banking_transfer,-150000
64142adbf8804aea72171256,50200023535069,372991.06,60ec41ba55c00300382672d9,HDFC,direct expenses,5eecc6d6449e4f7cfb1c2708,2023-03-15T00:00:00.000Z,"NEFT DR-ICIC0000004-MUKESH GOYAL-NETBANK , MUM-N074232373867175-255000",,,net_banking_transfer,-255000
64142adbf8804aea72171258,50200023535069,338991.06,60ec41ba55c00300382672d9,HDFC,direct expenses,5eecc6d6449e4f7cfb1c2708,2023-03-15T00:00:00.000Z,"NEFT DR-SCBL0036025-DHRUV MADHOK-NETBANK , MUM-N074232373834486-34000",,,net_banking_transfer,-34000
64142adbf8804aea7217125a,50200023535069,241791.06,60ec41ba55c00300382672d9,HDFC,direct expenses,5eecc6d6449e4f7cfb1c2708,2023-03-15T00:00:00.000Z,00321000085687-TPT-97200-SAMEER AHUJA,,,net_banking_transfer,-97200
64142adbf8804aea7217125c,50200023535069,91791.06,60ec41ba55c00300382672d9,HDFC,direct expenses,5eecc6d6449e4f7cfb1c2708,2023-03-15T00:00:00.000Z,"NEFT DR-IDFB0040101-ACTIVES ADDITIVES AP PLICATIONS LLP-NETBANK, MUM-N07423237391 1009-150000",,,net_banking_transfer,-150000
64142adbf8804aea7217125e,50200023535069,76361.06,60ec41ba55c00300382672d9,HDFC,Salary/Emp/consultant Expense,5eecc6d6449e4f7cfb1c2708,2023-03-15T00:00:00.000Z,"NEFT DR-UTIB0000404-ELIZABETH THOMAS ALE X-NETBANK, MUM-N074232373934042-15430",,,net_banking_transfer,-15430
64142adbf8804aea72171262,50200023535069,16361.06,60ec41ba55c00300382672d9,HDFC,direct expenses,5eecc6d6449e4f7cfb1c2708,2023-03-15T00:00:00.000Z,05892560000649-TPT-60000-DECORPAC INDIA PRIVATE LIMITED,,,net_banking_transfer,-60000
64142adbf8804aea72171264,50200023535069,9001.06,60ec41ba55c00300382672d9,HDFC,direct expenses,5eecc6d6449e4f7cfb1c2708,2023-03-15T00:00:00.000Z,POS 514834XXXXXX0472 PAYTM PAYMENTS S,ewallet,,debit_card,-7360
64142adbf8804aea72171266,50200023535069,9004.06,60ec41ba55c00300382672d9,HDFC,Transfer in/Revenue-other,5eecc6d6449e4f7cfb1c2708,2023-03-15T00:00:00.000Z,CRV POS-514834******0472-0313-FACEBOOK STATEMENT SUMMARY :-,,,refund,3
64142b7af8804aea72176c39,50200050976833,27646.05,60ec41a455c0030038267236,HDFC,Revenue-PG-non-split,5eecc6d6449e4f7cfb1c2708,2022-12-14T00:00:00.000Z,NEFT CR-CITI0100000-PAYPAL PAYMENTS PL-O PGSP COLL AC-SLICK ORGANICS PRIVATE LIMI TED-CITIN22380640692,,,net_banking_transfer,3133.21
64142b7af8804aea72176c3b,50200050976833,30781.05,60ec41a455c0030038267236,HDFC,Revenue-PG-non-split,5eecc6d6449e4f7cfb1c2708,2023-01-06T00:00:00.000Z,NEFT CR-CITI0100000-PAYPAL PAYMENTS PL-O PGSP COLL AC-SLICK ORGANICS PRIVATE LIMI TED-CITIN23303063882,,,net_banking_transfer,3135
64142b7af8804aea72176c3d,50200050976833,34548.53,60ec41a455c0030038267236,HDFC,Revenue-PG-non-split,5eecc6d6449e4f7cfb1c2708,2023-01-13T00:00:00.000Z,NEFT CR-CITI0100000-PAYPAL PAYMENTS PL-O PGSP COLL AC-SLICK ORGANICS PRIVATE LIMI TED-CITIN23305922569,,,net_banking_transfer,3767.48
64142b7af8804aea72176c3f,50200050976833,37686.9,60ec41a455c0030038267236,HDFC,Revenue-PG-non-split,5eecc6d6449e4f7cfb1c2708,2023-02-13T00:00:00.000Z,NEFT CR-CITI0100000-PAYPAL PAYMENTS PL-O PGSP COLL AC-SLICK ORGANICS PRIVATE LIMI TED-CITIN23320271290,,,net_banking_transfer,3138.37
64142b7af8804aea72176c41,50200050976833,41313.79,60ec41a455c0030038267236,HDFC,Revenue-PG-non-split,5eecc6d6449e4f7cfb1c2708,2023-02-15T00:00:00.000Z,NEFT CR-CITI0100000-PAYPAL PAYMENTS PL-O PGSP COLL AC-SLICK ORGANICS PRIVATE LIMI TED-CITIN23321064440 STATEMENT SUMMARY :-,,,net_banking_transfer,3626.89
64142b7af8804aea72176c43,50200050976833,31313.79,60ec41a455c0030038267236,HDFC,Internal Transfers,5eecc6d6449e4f7cfb1c2708,2023-03-13T00:00:00.000Z,IB FUNDS TRANSFER DR-50200023535069 -SL ICK ORGANICS PVT LTD,,,net_banking_transfer,-10000
64142b7af8804aea72176c45,50200050976833,25313.79,60ec41a455c0030038267236,HDFC,Internal Transfers,5eecc6d6449e4f7cfb1c2708,2023-03-13T00:00:00.000Z,IB FUNDS TRANSFER DR-50200023535069 -SL ICK ORGANICS PVT LTD STATEMENT SUMMARY :-,,,net_banking_transfer,-6000
645df4f7f8804aea72c2466e,50200035187206,25073,60ec419255c00300382671a5,HDFC,Transfer in/Revenue-other,5eecc6d6449e4f7cfb1c2708,2023-03-27T00:00:00.000Z,IMPS-308614823384-DIGIOTECH SOLUTIONS -I NDB-XXXXXXXX1214-P2AMOB,,,net_banking_transfer,1
645df4f7f8804aea72c24670,50200035187206,1966143,60ec419255c00300382671a5,HDFC,Transfer in/Revenue-other,5eecc6d6449e4f7cfb1c2708,2023-03-30T00:00:00.000Z,NEFT CR-YESB0000001-TYKE MITCON ESCROW A CCOUNT-SLICKORGANICSPVT-YESB30891188127,,,net_banking_transfer,1941070
645df4f7f8804aea72c24672,50200035187206,66143,60ec419255c00300382671a5,HDFC,Internal Transfers,5eecc6d6449e4f7cfb1c2708,2023-03-31T00:00:00.000Z,IB FUNDS TRANSFER DR-50200023535069 -SL ICK ORGANICS PVT LTD,,,net_banking_transfer,-1900000
645df4f7f8804aea72c24674,50200035187206,98694.8,60ec419255c00300382671a5,HDFC,Transfer in/Revenue-other,5eecc6d6449e4f7cfb1c2708,2023-03-31T00:00:00.000Z,NEFT CR-ICIC0SF0002-WHITE WIZARD TECHNOL -SLICK ORGANICS PRIVATE LIMITED-31689490 861DC,,,net_banking_transfer,32551.8
645df4f7f8804aea72c24676,50200035187206,186161.45,60ec419255c00300382671a5,HDFC,Transfer in/Revenue-other,5eecc6d6449e4f7cfb1c2708,2023-03-31T00:00:00.000Z,NEFT CR-ICIC0SF0002-WHITE WIZARD TECHNOL -SLICK ORGANICS PRIVATE LIMITED-31689492 111DC,,,net_banking_transfer,87466.65
645df4f7f8804aea72c24678,50200035187206,6186161.45,60ec419255c00300382671a5,HDFC,Loan-in,5eecc6d6449e4f7cfb1c2708,2023-03-31T00:00:00.000Z,FT- LIQVEL21801-50200029943037 - TRILLIO NLOANS FINTECH PRIVATE LIMITED - STATEMENT SUMMARY :-,loans,lender_transaction,Other,6000000
645df4f7f8804aea72c2467a,50200035187206,86161.45,60ec419255c00300382671a5,HDFC,Internal Transfers,5eecc6d6449e4f7cfb1c2708,2023-04-01T00:00:00.000Z,IB FUNDS TRANSFER DR-50200023535069 -SL ICK ORGANICS PVT LTD,,Transfer to SL ICK ORGANICS PVT LTD,net_banking_transfer,-6100000
645df4f7f8804aea72c2467c,50200035187206,165985.02,60ec419255c00300382671a5,HDFC,Transfer in/Revenue-other,5eecc6d6449e4f7cfb1c2708,2023-04-03T00:00:00.000Z,NEFT CR-ICIC0SF0002-WHITE WIZARD TECHNOL -SLICK ORGANICS PRIVATE LIMITED-31719118 151DC,,Transfer from WHITE WIZARD TECHNOL ,net_banking_transfer,79823.57
645df4f7f8804aea72c2467e,50200035187206,35985.02,60ec419255c00300382671a5,HDFC,Internal Transfers,5eecc6d6449e4f7cfb1c2708,2023-04-06T00:00:00.000Z,IB FUNDS TRANSFER DR-50200023535069 -SL ICK ORGANICS PVT LTD,,Transfer to SL ICK ORGANICS PVT LTD,net_banking_transfer,-130000
645df4f7f8804aea72c24680,50200035187206,1012487.02,60ec419255c00300382671a5,HDFC,Transfer in/Revenue-other,5eecc6d6449e4f7cfb1c2708,2023-04-10T00:00:00.000Z,NEFT CR-YESB0000001-TYKE MITCON ESCROW A CCOUNT-SLICKORGANICSPVT-YESB31007775147,,Transfer from TYKE MITCON ESCROW A CCOUNT,net_banking_transfer,976502
645df4f7f8804aea72c24682,50200035187206,35985.02,60ec419255c00300382671a5,HDFC,Internal Transfers,5eecc6d6449e4f7cfb1c2708,2023-04-10T00:00:00.000Z,IB FUNDS TRANSFER DR-50200023535069 -SL ICK ORGANICS PVT LTD,,Transfer to SL ICK ORGANICS PVT LTD,net_banking_transfer,-976502
645df4f7f8804aea72c24684,50200035187206,25985.02,60ec419255c00300382671a5,HDFC,Internal Transfers,5eecc6d6449e4f7cfb1c2708,2023-04-10T00:00:00.000Z,IB FUNDS TRANSFER DR-50200023535069 -SL ICK ORGANICS PVT LTD,,Transfer to SL ICK ORGANICS PVT LTD,net_banking_transfer,-10000
645df4f7f8804aea72c24686,50200035187206,10985.02,60ec419255c00300382671a5,HDFC,Internal Transfers,5eecc6d6449e4f7cfb1c2708,2023-04-13T00:00:00.000Z,IB FUNDS TRANSFER DR-50200023535069 -SL ICK ORGANICS PVT LTD,,Transfer to SL ICK ORGANICS PVT LTD,net_banking_transfer,-15000
645df4f7f8804aea72c24688,50200035187206,5985.02,60ec419255c00300382671a5,HDFC,Internal Transfers,5eecc6d6449e4f7cfb1c2708,2023-04-13T00:00:00.000Z,IB FUNDS TRANSFER DR-50200023535069 -SL ICK ORGANICS PVT LTD,,Transfer to SL ICK ORGANICS PVT LTD,net_banking_transfer,-5000
645df4f7f8804aea72c2468a,50200035187206,55985.02,60ec419255c00300382671a5,HDFC,Internal Transfers,5eecc6d6449e4f7cfb1c2708,2023-04-24T00:00:00.000Z,IB FUNDS TRANSFER CR-50200023535069 -SL ICK ORGANICS PVT LTD STATEMENT SUMMARY :-,,,Other,50000
645df60df8804aea72c2de52,50200023535069,9648.41,60ec41ba55c00300382672d9,HDFC,Transfer in/Revenue-other,5eecc6d6449e4f7cfb1c2708,2023-03-16T00:00:00.000Z,NEFT CR-YESB0000001-EXCRO PAY ESCROW ACC OUNT-SLICKORGANICSPRIVATELIMITED-YESB307 58660674,,,net_banking_transfer,644.35
645df60df8804aea72c2de54,50200023535069,10175.06,60ec41ba55c00300382672d9,HDFC,Revenue-PG-split enabled,5eecc6d6449e4f7cfb1c2708,2023-03-16T00:00:00.000Z,NEFT CR-UTIB0001506-RAZORPAY SOFTWARE PR IVATE LIMITED --SLICK ORGANICS PVT LITD- AXISCN0223492254,,,net_banking_transfer,526.65
645df60df8804aea72c2de56,50200023535069,35175.06,60ec41ba55c00300382672d9,HDFC,Internal Transfers,5eecc6d6449e4f7cfb1c2708,2023-03-16T00:00:00.000Z,IB FUNDS TRANSFER CR-50200050976833 -SL ICK ORGANICS PVT LTD,,,Other,25000
645df60df8804aea72c2de58,50200023535069,21675.06,60ec41ba55c00300382672d9,HDFC,direct expenses,5eecc6d6449e4f7cfb1c2708,2023-03-16T00:00:00.000Z,"NEFT DR-KARB0000113-ASHWINI N DIXIT-NETB ANK, MUM-N075232374453173-13500",,,net_banking_transfer,-13500
645df60df8804aea72c2de5a,50200023535069,29146.98,60ec41ba55c00300382672d9,HDFC,Transfer in/Revenue-other,5eecc6d6449e4f7cfb1c2708,2023-03-16T00:00:00.000Z,NEFT CR-UTIB0000114-ONE SIGMA TECHNOLOGI ES PRIVATE LIMI-SLICK ORGANICS PRIVATE L IMITED-AXISP00371795312,bnpl,,net_banking_transfer,7471.92
645df60df8804aea72c2de5c,50200023535069,41036.18,60ec41ba55c00300382672d9,HDFC,Revenue-Mktplace,5eecc6d6449e4f7cfb1c2708,2023-03-16T00:00:00.000Z,IMPS-307514527858-DREAMPLUGPAYTECHSO-UTI B-XXXXXXXXXXX7853-,,,net_banking_transfer,11889.2
645df60df8804aea72c2de5e,50200023535069,44001.18,60ec41ba55c00300382672d9,HDFC,Revenue-Mktplace,5eecc6d6449e4f7cfb1c2708,2023-03-16T00:00:00.000Z,NEFT CR-ICIC0000105-MANASH LIFETYLE PVT LTD-SLICK ORGANICS PRIVATE LIMITED-ICIB2 30750012332,,,net_banking_transfer,2965
645df60df8804aea72c2de61,50200023535069,45322.74,60ec41ba55c00300382672d9,HDFC,Revenue-PG-split enabled,5eecc6d6449e4f7cfb1c2708,2023-03-16T00:00:00.000Z,NEFT CR-UTIB0001506-RAZORPAY SOFTWARE PR IVATE LIMITED --SLICK ORGANICS PVT LITD-,,,net_banking_transfer,1321.56
645df60df8804aea72c2de64,50200023535069,105682.53,60ec41ba55c00300382672d9,HDFC,Transfer in/Revenue-other,5eecc6d6449e4f7cfb1c2708,2023-03-16T00:00:00.000Z,NEFT CR-YESB0000001-EASEBUZZ PVT LTD NOD AL A/C-SLICK ORGANICS PVT LTD-YESB307588 97491,,,net_banking_transfer,60359.79
645df60df8804aea72c2de67,50200023535069,107716.13,60ec41ba55c00300382672d9,HDFC,Transfer in/Revenue-other,5eecc6d6449e4f7cfb1c2708,2023-03-17T00:00:00.000Z,IMPS-307605721685-EXCRO PAY ESCROW ACC-Y ESB-XXXXXXXXXXX1807-333112298023,,,net_banking_transfer,2033.6
645df60df8804aea72c2de69,50200023535069,102760.13,60ec41ba55c00300382672d9,HDFC,Marketing Expense,5eecc6d6449e4f7cfb1c2708,2023-03-17T00:00:00.000Z,ME DC SI 514834XXXXXX0472 FACEBOOK SI,,,Other,-4956
645df60df8804aea72c2de6b,50200023535069,108911.07,60ec41ba55c00300382672d9,HDFC,Transfer in/Revenue-other,5eecc6d6449e4f7cfb1c2708,2023-03-17T00:00:00.000Z,IMPS-307607759037-EXCRO PAY ESCROW ACC-Y ESB-XXXXXXXXXXX1807-333112298023,,,net_banking_transfer,6150.94
645df60df8804aea72c2de6d,50200023535069,134451.07,60ec41ba55c00300382672d9,HDFC,Transfer in/Revenue-other,5eecc6d6449e4f7cfb1c2708,2023-03-17T00:00:00.000Z,NEFT CR-UTIB0004405-WOOVLY INDIA PRIVATE LIMITED-ARATA-AXISP00372063503,,,net_banking_transfer,25540
645df60df8804aea72c2de6f,50200023535069,135619.29,60ec41ba55c00300382672d9,HDFC,Revenue-PG-split enabled,5eecc6d6449e4f7cfb1c2708,2023-03-17T00:00:00.000Z,NEFT CR-UTIB0001506-RAZORPAY SOFTWARE PR IVATE LIMITED --SLICK ORGANICS PVT LITD- AXISCN0224020846,,,net_banking_transfer,1168.22
645df60df8804aea72c2de71,50200023535069,122119.29,60ec41ba55c00300382672d9,HDFC,direct expenses,5eecc6d6449e4f7cfb1c2708,2023-03-17T00:00:00.000Z,50100110669502-TPT-13500-VRITI MALHOTRA,,,net_banking_transfer,-13500
645df60df8804aea72c2de73,50200023535069,113119.29,60ec41ba55c00300382672d9,HDFC,direct expenses,5eecc6d6449e4f7cfb1c2708,2023-03-17T00:00:00.000Z,"NEFT DR-SBIN0001211-URJA TANTA-NETBANK, MUM-N076232375865830-9000",,,net_banking_transfer,-9000
645df60df8804aea72c2de75,50200023535069,119557.29,60ec41ba55c00300382672d9,HDFC,Transfer in/Revenue-other,5eecc6d6449e4f7cfb1c2708,2023-03-17T00:00:00.000Z,50200050241205-TPT-ARATA-NAPSA PRIVATE L IMITED,,,net_banking_transfer,6438
645df60df8804aea72c2de78,50200023535069,123345.52,60ec41ba55c00300382672d9,HDFC,Revenue-Mktplace,5eecc6d6449e4f7cfb1c2708,2023-03-17T00:00:00.000Z,NEFT CR-DEUT0797BGL-MYNTRA DESIGNS PRIVA TE LIMITED-SLICK ORGANICS - SJIT-3076011 93GN00110,shopping,,net_banking_transfer,3788.23
645df60df8804aea72c2de7a,50200023535069,171648.24,60ec41ba55c00300382672d9,HDFC,Revenue-Mktplace,5eecc6d6449e4f7cfb1c2708,2023-03-17T00:00:00.000Z,NEFT CR-DEUT0797BGL-MYNTRA DESIGNS PRIVA TE LIMITED-SLICK ORGANICS PVT. LTD.-3076 01202GN00088,shopping,,net_banking_transfer,48302.72
645df60df8804aea72c2de7c,50200023535069,174044.24,60ec41ba55c00300382672d9,HDFC,Revenue-Mktplace,5eecc6d6449e4f7cfb1c2708,2023-03-17T00:00:00.000Z,IMPS-307614998558-DREAMPLUGPAYTECHSO-UTI B-XXXXXXXXXXX7853-,,,net_banking_transfer,2396
645df60df8804aea72c2de7e,50200023535069,178391.66,60ec41ba55c00300382672d9,HDFC,Transfer in/Revenue-other,5eecc6d6449e4f7cfb1c2708,2023-03-17T00:00:00.000Z,NEFT CR-UTIB0000114-ONE SIGMA TECHNOLOGI ES PRIVATE LIMI-SLICK ORGANICS PRIVATE L IMITED-AXISP00372174332,bnpl,,net_banking_transfer,4347.42
645df60df8804aea72c2de81,50200023535069,207351.3,60ec41ba55c00300382672d9,HDFC,Revenue-COD,5eecc6d6449e4f7cfb1c2708,2023-03-17T00:00:00.000Z,NEFT CR-ICIC0000155-SHIPROCKET COD CRF I,,,net_banking_transfer,28959.64
645df60df8804aea72c2de84,50200023535069,242055.3,60ec41ba55c00300382672d9,HDFC,Revenue-Mktplace,5eecc6d6449e4f7cfb1c2708,2023-03-17T00:00:00.000Z,NEFT CR-SCBL0036001-DREAMPLUG TECHNOLOGI ES PRIVATE LIMITED-SLICK ORGANICS PRIVAT E LIMITEDSLICK-IN1ON230317021BP,,,net_banking_transfer,34704
645df60df8804aea72c2de86,50200023535069,242145.3,60ec41ba55c00300382672d9,HDFC,Investment/FD redeem,5eecc6d6449e4f7cfb1c2708,2023-03-17T00:00:00.000Z,FD REDEEM PRINCIPAL -50300462137427/1,,,Other,90
645df60df8804aea72c2de89,50200023535069,242133.3,60ec41ba55c00300382672d9,HDFC,direct expenses,5eecc6d6449e4f7cfb1c2708,2023-03-17T00:00:00.000Z,FD REDEEM INTEREST -50300571891040/2,,,Other,-12
645df60df8804aea72c2de8b,50200023535069,244587.3,60ec41ba55c00300382672d9,HDFC,Investment/FD redeem,5eecc6d6449e4f7cfb1c2708,2023-03-17T00:00:00.000Z,FD REDEEM PRINCIPAL -50300571891040/2,,,Other,2454
645df60df8804aea72c2de8d,50200023535069,244589.3,60ec41ba55c00300382672d9,HDFC,Investment/FD redeem,5eecc6d6449e4f7cfb1c2708,2023-03-17T00:00:00.000Z,FD REDEEM INTEREST -50300720580141/1,,,Other,2
645df60df8804aea72c2de8f,50200023535069,244836.3,60ec41ba55c00300382672d9,HDFC,Investment/FD redeem,5eecc6d6449e4f7cfb1c2708,2023-03-17T00:00:00.000Z,FD REDEEM PRINCIPAL -50300720580141/1,,,Other,247
645df60df8804aea72c2de91,50200023535069,307346.55,60ec41ba55c00300382672d9,HDFC,Transfer in/Revenue-other,5eecc6d6449e4f7cfb1c2708,2023-03-17T00:00:00.000Z,NEFT CR-YESB0000001-EASEBUZZ PVT LTD NOD AL A/C-SLICK ORGANICS PVT LTD-YESB307622 47461,,,net_banking_transfer,62510.25
645df60df8804aea72c2de94,50200023535069,309225.47,60ec41ba55c00300382672d9,HDFC,Revenue-PG-split enabled,5eecc6d6449e4f7cfb1c2708,2023-03-17T00:00:00.000Z,NEFT CR-UTIB0001506-RAZORPAY SOFTWARE PR IVATE LIMITED --SLICK ORGANICS PVT LITD- AXISCN0224337554,,,net_banking_transfer,1878.92
645df60df8804aea72c2de97,50200023535069,310262.35,60ec41ba55c00300382672d9,HDFC,Transfer in/Revenue-other,5eecc6d6449e4f7cfb1c2708,2023-03-18T00:00:00.000Z,IMPS-307704955866-EXCRO PAY ESCROW ACC-Y ESB-XXXXXXXXXXX1807-333112298023,,,net_banking_transfer,1036.88
645df60df8804aea72c2de99,50200023535069,311667.9,60ec41ba55c00300382672d9,HDFC,Revenue-PG-split enabled,5eecc6d6449e4f7cfb1c2708,2023-03-18T00:00:00.000Z,NEFT CR-UTIB0001506-RAZORPAY SOFTWARE PR IVATE LIMITED --SLICK ORGANICS PVT LITD- AXISCN0224463747,,,net_banking_transfer,1405.55
645df60df8804aea72c2de9b,50200023535069,372946.1,60ec41ba55c00300382672d9,HDFC,Transfer in/Revenue-other,5eecc6d6449e4f7cfb1c2708,2023-03-18T00:00:00.000Z,NEFT CR-UTIB0000020-EMIZA SUPPLY CHAIN S ERVICES PRIVATE-SLICK ORGANICS PRIVATE L IMITED-AXISP00372393041,,,net_banking_transfer,61278.2
645df60df8804aea72c2de9d,50200023535069,376155,60ec41ba55c00300382672d9,HDFC,Revenue-Mktplace,5eecc6d6449e4f7cfb1c2708,2023-03-18T00:00:00.000Z,IMPS-307714619336-DREAMPLUGPAYTECHSO-UTI B-XXXXXXXXXXX7853-,,,net_banking_transfer,3208.9
645df60df8804aea72c2de9f,50200023535069,377859.54,60ec41ba55c00300382672d9,HDFC,Transfer in/Revenue-other,5eecc6d6449e4f7cfb1c2708,2023-03-18T00:00:00.000Z,EASEBUZZ PRIVA-B192180323PSB1R0LC35,,,Other,1704.54
645df60df8804aea72c2dea1,50200023535069,382687.59,60ec41ba55c00300382672d9,HDFC,Revenue-PG-split enabled,5eecc6d6449e4f7cfb1c2708,2023-03-18T00:00:00.000Z,NEFT CR-UTIB0001506-RAZORPAY SOFTWARE PR IVATE LIMITED --SLICK ORGANICS PVT LITD- AXISCN0224696545,,,net_banking_transfer,4828.05
645df60df8804aea72c2dea3,50200023535069,462085.2,60ec41ba55c00300382672d9,HDFC,Transfer in/Revenue-other,5eecc6d6449e4f7cfb1c2708,2023-03-18T00:00:00.000Z,NEFT CR-YESB0000001-EASEBUZZ PVT LTD NOD AL A/C-SLICK ORGANICS PVT LTD-YESB307755,,,net_banking_transfer,79397.61
645df60df8804aea72c2dea6,50200023535069,464390.25,60ec41ba55c00300382672d9,HDFC,Transfer in/Revenue-other,5eecc6d6449e4f7cfb1c2708,2023-03-19T00:00:00.000Z,IMPS-307804655446-EXCRO PAY ESCROW ACC-Y ESB-XXXXXXXXXXX1807-333112298023,,,net_banking_transfer,2305.05
645df60df8804aea72c2dea8,50200023535069,414390.25,60ec41ba55c00300382672d9,HDFC,Internal Transfers,5eecc6d6449e4f7cfb1c2708,2023-03-19T00:00:00.000Z,IB FUNDS TRANSFER DR-50200050976833 -SL ICK ORGANICS PVT LTD,,,net_banking_transfer,-50000
645df60df8804aea72c2deaa,50200023535069,403590.25,60ec41ba55c00300382672d9,HDFC,direct expenses,5eecc6d6449e4f7cfb1c2708,2023-03-19T00:00:00.000Z,NEFT DR-BARB0ABHAYK-GLOBAL COMPLIANCES-S ANDOZ - MUM-N078232378223675-NET BANKING SI -10800,,,net_banking_transfer,-10800
645df60df8804aea72c2deac,50200023535069,406169.96,60ec41ba55c00300382672d9,HDFC,Transfer in/Revenue-other,5eecc6d6449e4f7cfb1c2708,2023-03-20T00:00:00.000Z,IMPS-307903939499-EXCRO PAY ESCROW ACC-Y ESB-XXXXXXXXXXX1807-333112298023,,,net_banking_transfer,2579.71
645df60df8804aea72c2deaf,50200023535069,412322.68,60ec41ba55c00300382672d9,HDFC,Transfer in/Revenue-other,5eecc6d6449e4f7cfb1c2708,2023-03-20T00:00:00.000Z,IMPS-307907617926-EXCRO PAY ESCROW ACC-Y ESB-XXXXXXXXXXX1807-333112298023,,,net_banking_transfer,6152.72
645df60df8804aea72c2deb1,50200023535069,417307.58,60ec41ba55c00300382672d9,HDFC,Revenue-Mktplace,5eecc6d6449e4f7cfb1c2708,2023-03-20T00:00:00.000Z,NEFT CR-DEUT0797BGL-MYNTRA DESIGNS PRIVA TE LIMITED-SLICK ORGANICS - SJIT-3079010 95GN00012,shopping,,net_banking_transfer,4984.9
645df60df8804aea72c2deb4,50200023535069,444164.74,60ec41ba55c00300382672d9,HDFC,Revenue-Mktplace,5eecc6d6449e4f7cfb1c2708,2023-03-20T00:00:00.000Z,NEFT CR-DEUT0797BGL-MYNTRA DESIGNS PRIVA TE LIMITED-SLICK ORGANICS PVT. LTD.-3079 01127GN00128,shopping,,net_banking_transfer,26857.16
645df60df8804aea72c2deb6,50200023535069,447622.58,60ec41ba55c00300382672d9,HDFC,Revenue-PG-split enabled,5eecc6d6449e4f7cfb1c2708,2023-03-20T00:00:00.000Z,NEFT CR-UTIB0001506-RAZORPAY SOFTWARE PR IVATE LIMITED --SLICK ORGANICS PVT LITD- AXISCN0224900960,,,net_banking_transfer,3457.84
645df60df8804aea72c2deb8,50200023535069,445593.58,60ec41ba55c00300382672d9,HDFC,direct expenses,5eecc6d6449e4f7cfb1c2708,2023-03-20T00:00:00.000Z,ME DC SI 514834XXXXXX0472 ADOBE SYSTEMS SOFTWARE,,,Other,-2029
645df60df8804aea72c2deba,50200023535069,443473.12,60ec41ba55c00300382672d9,HDFC,direct expenses,5eecc6d6449e4f7cfb1c2708,2023-03-20T00:00:00.000Z,POS 514834XXXXXX0472 PAYTM PAYMENTS S,ewallet,,debit_card,-2120.46
645df60df8804aea72c2debc,50200023535069,303473.12,60ec41ba55c00300382672d9,HDFC,direct expenses,5eecc6d6449e4f7cfb1c2708,2023-03-20T00:00:00.000Z,05892560000649-TPT-140000-DECORPAC INDIA PRIVATE LIMITED,,,net_banking_transfer,-140000
645df60df8804aea72c2debe,50200023535069,304656.98,60ec41ba55c00300382672d9,HDFC,Transfer in/Revenue-other,5eecc6d6449e4f7cfb1c2708,2023-03-20T00:00:00.000Z,EASEBUZZ PRIVA-A274200323PSTHEY36LH,,,Other,1183.86
645df60df8804aea72c2dec0,50200023535069,379979.83,60ec41ba55c00300382672d9,HDFC,Transfer in/Revenue-other,5eecc6d6449e4f7cfb1c2708,2023-03-20T00:00:00.000Z,NEFT CR-YESB0000001-EASEBUZZ PVT LTD NOD AL A/C-SLICK ORGANICS PVT LTD-YESB307909 67396,,,net_banking_transfer,75322.85
645df60ef8804aea72c2dec2,50200023535069,394355.83,60ec41ba55c00300382672d9,HDFC,Revenue-Mktplace,5eecc6d6449e4f7cfb1c2708,2023-03-20T00:00:00.000Z,IMPS-307914357806-DREAMPLUGPAYTECHSO-UTI B-XXXXXXXXXXX7853-,,,net_banking_transfer,14376
645df60ef8804aea72c2dec4,50200023535069,400008.08,60ec41ba55c00300382672d9,HDFC,Transfer in/Revenue-other,5eecc6d6449e4f7cfb1c2708,2023-03-20T00:00:00.000Z,NEFT CR-UTIB0000114-ONE SIGMA TECHNOLOGI ES PRIVATE LIMI-SLICK ORGANICS PRIVATE L IMITED-AXISP00372603925,bnpl,,net_banking_transfer,5652.25
645df60ef8804aea72c2dec6,50200023535069,404180.99,60ec41ba55c00300382672d9,HDFC,Transfer in/Revenue-other,5eecc6d6449e4f7cfb1c2708,2023-03-20T00:00:00.000Z,NEFT CR-UTIB0000114-ONE SIGMA TECHNOLOGI ES PRIVATE LIMI-SLICK ORGANICS PRIVATE L IMITED-AXISP00372604072,bnpl,,net_banking_transfer,4172.91
645df60ef8804aea72c2dec8,50200023535069,411298.56,60ec41ba55c00300382672d9,HDFC,Transfer in/Revenue-other,5eecc6d6449e4f7cfb1c2708,2023-03-20T00:00:00.000Z,NEFT CR-UTIB0000114-ONE SIGMA TECHNOLOGI ES PRIVATE LIMI-SLICK ORGANICS PRIVATE L IMITED-AXISP00372603865,bnpl,,net_banking_transfer,7117.57
645df60ef8804aea72c2deca,50200023535069,572016.94,60ec41ba55c00300382672d9,HDFC,Revenue-COD,5eecc6d6449e4f7cfb1c2708,2023-03-20T00:00:00.000Z,NEFT CR-ICIC0000155-SHIPROCKET COD CRF I D 5912315-SLICK ORGANICS PVT LTD-CMS3189 537641,,,net_banking_transfer,160718.38
645df60ef8804aea72c2decd,50200023535069,573916.94,60ec41ba55c00300382672d9,HDFC,Revenue-Mktplace,5eecc6d6449e4f7cfb1c2708,2023-03-20T00:00:00.000Z,NEFT CR-ICIC0000105-MANASH LIFESTYLE PRI VATE LIMITED NO-SLICK ORGANICS PRIVATE L IMITED-ICIJ230790001553,shopping,,net_banking_transfer,1900
645df60ef8804aea72c2ded1,50200023535069,576918.94,60ec41ba55c00300382672d9,HDFC,Revenue-Mktplace,5eecc6d6449e4f7cfb1c2708,2023-03-20T00:00:00.000Z,NEFT CR-ICIC0000105-MANASH LIFESTYLE PRI VATE LIMITED NO-SLICK ORGANICS PRIVATE L IMITED-ICIJ230790003547,shopping,,net_banking_transfer,3002
645df60ef8804aea72c2ded3,50200023535069,588392.23,60ec41ba55c00300382672d9,HDFC,Transfer in/Revenue-other,5eecc6d6449e4f7cfb1c2708,2023-03-20T00:00:00.000Z,NEFT CR-YESB0000001-EASEBUZZ PVT LTD NOD AL A/C-SLICK ORGANICS PVT LTD-YESB307911 15805,,,net_banking_transfer,11473.29
645df60ef8804aea72c2ded5,50200023535069,650088.76,60ec41ba55c00300382672d9,HDFC,Transfer in/Revenue-other,5eecc6d6449e4f7cfb1c2708,2023-03-20T00:00:00.000Z,NEFT CR-YESB0000001-EASEBUZZ PVT LTD NOD AL A/C-SLICK ORGANICS PVT LTD-YESB307911 15791,,,net_banking_transfer,61696.53
645df60ef8804aea72c2ded7,50200023535069,651690.29,60ec41ba55c00300382672d9,HDFC,Revenue-PG-split enabled,5eecc6d6449e4f7cfb1c2708,2023-03-20T00:00:00.000Z,NEFT CR-UTIB0001506-RAZORPAY SOFTWARE PR IVATE LIMITED --SLICK ORGANICS PVT LITD- AXISCN0225219908,,,net_banking_transfer,1601.53
645df60ef8804aea72c2ded9,50200023535069,574590.29,60ec41ba55c00300382672d9,HDFC,direct expenses,5eecc6d6449e4f7cfb1c2708,2023-03-20T00:00:00.000Z,"NEFT DR-SRCB0000281-3D TECHNOPACK PRIVAT E LIMITED-NETBANK, MUM-N079232379598188- 77100",,,net_banking_transfer,-77100
645df60ef8804aea72c2dedb,50200023535069,374590.29,60ec41ba55c00300382672d9,HDFC,Marketing Expense,5eecc6d6449e4f7cfb1c2708,2023-03-20T00:00:00.000Z,"NEFT DR-CITI0000006-FACEBOOK INDIA ONLIN E SERVICES PVT LTD-NETBANK, MUM-N0792323",,,net_banking_transfer,-200000
645df60ef8804aea72c2dedd,50200023535069,376728.14,60ec41ba55c00300382672d9,HDFC,Transfer in/Revenue-other,5eecc6d6449e4f7cfb1c2708,2023-03-21T00:00:00.000Z,IMPS-308004622039-EXCRO PAY ESCROW ACC-Y ESB-XXXXXXXXXXX1807-333112298023,,,net_banking_transfer,2137.85
645df60ef8804aea72c2dedf,50200023535069,378117.29,60ec41ba55c00300382672d9,HDFC,Revenue-PG-split enabled,5eecc6d6449e4f7cfb1c2708,2023-03-21T00:00:00.000Z,NEFT CR-UTIB0001506-RAZORPAY SOFTWARE PR IVATE LIMITED --SLICK ORGANICS PVT LITD- AXISCN0225450770,,,net_banking_transfer,1389.15
645df60ef8804aea72c2dee1,50200023535069,278117.29,60ec41ba55c00300382672d9,HDFC,direct expenses,5eecc6d6449e4f7cfb1c2708,2023-03-21T00:00:00.000Z,05892560000649-TPT-100000-DECORPAC INDIA PRIVATE LIMITED,,,net_banking_transfer,-100000
645df60ef8804aea72c2dee3,50200023535069,178117.29,60ec41ba55c00300382672d9,HDFC,direct expenses,5eecc6d6449e4f7cfb1c2708,2023-03-21T00:00:00.000Z,"NEFT DR-YESB0000551-VISTTA COSMETICS-NET BANK, MUM-N080232380157204-100000",,,net_banking_transfer,-100000
645df60ef8804aea72c2dee5,50200023535069,181520.46,60ec41ba55c00300382672d9,HDFC,Transfer in/Revenue-other,5eecc6d6449e4f7cfb1c2708,2023-03-21T00:00:00.000Z,NEFT CR-UTIB0000114-ONE SIGMA TECHNOLOGI ES PRIVATE LIMI-SLICK ORGANICS PRIVATE L IMITED-AXISP00373030324,bnpl,,net_banking_transfer,3403.17
645df60ef8804aea72c2dee7,50200023535069,181739.46,60ec41ba55c00300382672d9,HDFC,Revenue-Mktplace,5eecc6d6449e4f7cfb1c2708,2023-03-21T00:00:00.000Z,NEFT CR-ICIC0000105-MANASH LIFETYLE PVT LTD-SLICK ORGANICS PRIVATE LIMITED-ICIB2 30800005285,,,net_banking_transfer,219
645df60ef8804aea72c2dee9,50200023535069,194184.66,60ec41ba55c00300382672d9,HDFC,Revenue-Mktplace,5eecc6d6449e4f7cfb1c2708,2023-03-21T00:00:00.000Z,IMPS-308014009209-DREAMPLUGPAYTECHSO-UTI B-XXXXXXXXXXX7853-,,,net_banking_transfer,12445.2
645df60ef8804aea72c2deeb,50200023535069,186684.66,60ec41ba55c00300382672d9,HDFC,cash expense,5eecc6d6449e4f7cfb1c2708,2023-03-21T00:00:00.000Z,"NEFT DR-DBSS0IN0811-VEDIKA SUKHATME-NETB ANK, MUM-N080232380865349-7500",,,net_banking_transfer,-7500
645df60ef8804aea72c2deed,50200023535069,194184.66,60ec41ba55c00300382672d9,HDFC,Adjustments/Reversal,5eecc6d6449e4f7cfb1c2708,2023-03-21T00:00:00.000Z,NEFT RETURN-ACCOUNT DOES NOT EXIST-VEDIK A SUKHATME-0811IP3111398008,,neft_return,refund,7500
645df60ef8804aea72c2deef,50200023535069,194668.77,60ec41ba55c00300382672d9,HDFC,Revenue-PG-split enabled,5eecc6d6449e4f7cfb1c2708,2023-03-21T00:00:00.000Z,NEFT CR-UTIB0001506-RAZORPAY SOFTWARE PR IVATE LIMITED --SLICK ORGANICS PVT LITD- AXISCN0225764717,,,net_banking_transfer,484.11
645df60ef8804aea72c2def1,50200023535069,235919.3,60ec41ba55c00300382672d9,HDFC,Transfer in/Revenue-other,5eecc6d6449e4f7cfb1c2708,2023-03-21T00:00:00.000Z,NEFT CR-YESB0000001-EASEBUZZ PVT LTD NOD AL A/C-SLICK ORGANICS PVT LTD-YESB308042 40040,,,net_banking_transfer,41250.53
645df60ef8804aea72c2def3,50200023535069,273559.75,60ec41ba55c00300382672d9,HDFC,Transfer in/Revenue-other,5eecc6d6449e4f7cfb1c2708,2023-03-21T00:00:00.000Z,NEFT CR-YESB0000001-EASEBUZZ PVT LTD NOD AL A/C-SLICK ORGANICS PVT LTD-YESB308042 39423,,,net_banking_transfer,37640.45
645df60ef8804aea72c2def5,50200023535069,102987.75,60ec41ba55c00300382672d9,HDFC,direct expenses,5eecc6d6449e4f7cfb1c2708,2023-03-22T00:00:00.000Z,CHQ PAID-MICR CTS-NO-BO INTERNATIONAL,,,chq,-170572
645df60ef8804aea72c2def7,50200023535069,105026.1,60ec41ba55c00300382672d9,HDFC,Transfer in/Revenue-other,5eecc6d6449e4f7cfb1c2708,2023-03-22T00:00:00.000Z,IMPS-308105882806-EXCRO PAY ESCROW ACC-Y ESB-XXXXXXXXXXX1807-333112298023,,,net_banking_transfer,2038.35
645df60ef8804aea72c2def9,50200023535069,100614.1,60ec41ba55c00300382672d9,HDFC,direct expenses,5eecc6d6449e4f7cfb1c2708,2023-03-22T00:00:00.000Z,"NEFT DR-ICIC0006956-LAKSHAY CARRYING COR PORATION-NETBANK, MUM-N081232381621439-4 412",,,net_banking_transfer,-4412
645df60ef8804aea72c2defb,50200023535069,90614.1,60ec41ba55c00300382672d9,HDFC,direct expenses,5eecc6d6449e4f7cfb1c2708,2023-03-22T00:00:00.000Z,"NEFT DR-BARB0ABHAYK-GLOBAL COMPLIANCES-N ETBANK, MUM-N081232381598151-10000",,,net_banking_transfer,-10000
645df60ef8804aea72c2defd,50200023535069,80614.1,60ec41ba55c00300382672d9,HDFC,direct expenses,5eecc6d6449e4f7cfb1c2708,2023-03-22T00:00:00.000Z,"NEFT DR-BARB0ABHAYK-GLOBAL COMPLIANCES-N ETBANK, MUM-N081232381611782-10000",,,net_banking_transfer,-10000
645df60ef8804aea72c2deff,50200023535069,72826.1,60ec41ba55c00300382672d9,HDFC,direct expenses,5eecc6d6449e4f7cfb1c2708,2023-03-22T00:00:00.000Z,50200043297657-TPT-7788-AIDC PRODUCTS IN DIA PRIVATE LIMITED,,,net_banking_transfer,-7788
645df60ef8804aea72c2df01,50200023535069,65326.1,60ec41ba55c00300382672d9,HDFC,cash expense,5eecc6d6449e4f7cfb1c2708,2023-03-22T00:00:00.000Z,"NEFT DR-DBSS0IN0811-VEDIKA SUKHATME-NETB ANK, MUM-N081232381598432-7500",,,net_banking_transfer,-7500
645df60ef8804aea72c2df04,50200023535069,48226.1,60ec41ba55c00300382672d9,HDFC,direct expenses,5eecc6d6449e4f7cfb1c2708,2023-03-22T00:00:00.000Z,"NEFT DR-BKID0000541-NAINA AHLUWALIA-NETB ANK, MUM-N081232381613837-17100",,,net_banking_transfer,-17100
645df60ef8804aea72c2df06,50200023535069,55726.1,60ec41ba55c00300382672d9,HDFC,Adjustments/Reversal,5eecc6d6449e4f7cfb1c2708,2023-03-22T00:00:00.000Z,NEFT RETURN-ACCOUNT DOES NOT EXIST-VEDIK A SUKHATME-0811IP3111419429,,neft_return,refund,7500
645df60ef8804aea72c2df08,50200023535069,37816.1,60ec41ba55c00300382672d9,HDFC,direct expenses,5eecc6d6449e4f7cfb1c2708,2023-03-22T00:00:00.000Z,"NEFT DR-KKBK0000173-NITISH KUMAR MANDAL- NETBANK, MUM-N081232381615173-17910",,,net_banking_transfer,-17910
645df60ef8804aea72c2df0a,50200023535069,27816.1,60ec41ba55c00300382672d9,HDFC,direct expenses,5eecc6d6449e4f7cfb1c2708,2023-03-22T00:00:00.000Z,"NEFT DR-ICIC0000021-AKHILESH DIXIT-NETBA NK, MUM-N081232381632035-10000",,,net_banking_transfer,-10000
645df60ef8804aea72c2df0c,50200023535069,14816.1,60ec41ba55c00300382672d9,HDFC,direct expenses,5eecc6d6449e4f7cfb1c2708,2023-03-22T00:00:00.000Z,50100475775016-TPT-13000-SWARA BIJU,,,net_banking_transfer,-13000
645df60ef8804aea72c2df0e,50200023535069,4816.1,60ec41ba55c00300382672d9,HDFC,direct expenses,5eecc6d6449e4f7cfb1c2708,2023-03-22T00:00:00.000Z,"NEFT DR-SBIN0007382-JOYASWINEE KOCH-NETB ANK, MUM-N081232381672885-10000",alchohol,,net_banking_transfer,-10000
645df60ef8804aea72c2df10,50200023535069,1982.1,60ec41ba55c00300382672d9,HDFC,SAAS/tech expense,5eecc6d6449e4f7cfb1c2708,2023-03-22T00:00:00.000Z,POS 514834XXXXXX0472 AMAZON PAY INDIA,shopping,,debit_card,-2834
645df60ef8804aea72c2df12,50200023535069,6774.1,60ec41ba55c00300382672d9,HDFC,Revenue-Mktplace,5eecc6d6449e4f7cfb1c2708,2023-03-22T00:00:00.000Z,IMPS-308114146047-DREAMPLUGPAYTECHSO-UTI B-XXXXXXXXXXX7853-,,,net_banking_transfer,4792
645df60ef8804aea72c2df14,50200023535069,82025.73,60ec41ba55c00300382672d9,HDFC,Revenue-COD,5eecc6d6449e4f7cfb1c2708,2023-03-22T00:00:00.000Z,NEFT CR-ICIC0000155-SHIPROCKET COD CRF I D 5932693-SLICK ORGANICS PVT LTD-CMS3193 507617,,,net_banking_transfer,75251.63
645df60ef8804aea72c2df16,50200023535069,69608.73,60ec41ba55c00300382672d9,HDFC,direct expenses,5eecc6d6449e4f7cfb1c2708,2023-03-22T00:00:00.000Z,"NEFT DR-UTIB0CCH274-AXIS BANK LTD-NETBAN K, MUM-N081232382416298-12417",,,net_banking_transfer,-12417
645df60ef8804aea72c2df18,50200023535069,55208.73,60ec41ba55c00300382672d9,HDFC,direct expenses,5eecc6d6449e4f7cfb1c2708,2023-03-22T00:00:00.000Z,50100375208010-TPT-14400-DISHA BATRA,,,net_banking_transfer,-14400
645df60ef8804aea72c2df1a,50200023535069,58115.23,60ec41ba55c00300382672d9,HDFC,Transfer in/Revenue-other,5eecc6d6449e4f7cfb1c2708,2023-03-23T00:00:00.000Z,IMPS-308204720792-EXCRO PAY ESCROW ACC-Y ESB-XXXXXXXXXXX1807-333112298023,,,net_banking_transfer,2906.5
645df60ef8804aea72c2df1c,50200023535069,59372.67,60ec41ba55c00300382672d9,HDFC,Revenue-Mktplace,5eecc6d6449e4f7cfb1c2708,2023-03-23T00:00:00.000Z,NEFT CR-DEUT0797BGL-MYNTRA DESIGNS PRIVA TE LIMITED-SLICK ORGANICS - SJIT-3082007 02GN00078,shopping,,net_banking_transfer,1257.44
645df60ef8804aea72c2df1e,50200023535069,61867.37,60ec41ba55c00300382672d9,HDFC,Revenue-PG-split enabled,5eecc6d6449e4f7cfb1c2708,2023-03-23T00:00:00.000Z,NEFT CR-UTIB0001506-RAZORPAY SOFTWARE PR IVATE LIMITED --SLICK ORGANICS PVT LITD- AXISCN0226234356,,,net_banking_transfer,2494.7
645df60ef8804aea72c2df20,50200023535069,54367.37,60ec41ba55c00300382672d9,HDFC,cash expense,5eecc6d6449e4f7cfb1c2708,2023-03-23T00:00:00.000Z,"NEFT DR-DBSS0IN0811-VEDIKA SHRIVARDHAN S UKHATME-NETBANK, MUM-N082232382800549-75 00",,,net_banking_transfer,-7500
645df60ef8804aea72c2df23,50200023535069,22677.37,60ec41ba55c00300382672d9,HDFC,direct expenses,5eecc6d6449e4f7cfb1c2708,2023-03-23T00:00:00.000Z,02711600008220-TPT-31690-VARUN SINGH,,,net_banking_transfer,-31690
645df60ef8804aea72c2df25,50200023535069,20758.37,60ec41ba55c00300382672d9,HDFC,direct expenses,5eecc6d6449e4f7cfb1c2708,2023-03-23T00:00:00.000Z,POS 514834XXXXXX0472 PAYTM PAYMENTS S,ewallet,,debit_card,-1919
645df60ef8804aea72c2df27,50200023535069,23137.37,60ec41ba55c00300382672d9,HDFC,Revenue-Mktplace,5eecc6d6449e4f7cfb1c2708,2023-03-23T00:00:00.000Z,NEFT CR-ICIC0000105-MANASH LIFETYLE PVT LTD-SLICK ORGANICS PRIVATE LIMITED-ICIB2 30820008711,,,net_banking_transfer,2379
645df60ef8804aea72c2df29,50200023535069,29127.37,60ec41ba55c00300382672d9,HDFC,Revenue-Mktplace,5eecc6d6449e4f7cfb1c2708,2023-03-23T00:00:00.000Z,IMPS-308214523541-DREAMPLUGPAYTECHSO-UTI B-XXXXXXXXXXX7853-,,,net_banking_transfer,5990
645df60ef8804aea72c2df2b,50200023535069,29034.37,60ec41ba55c00300382672d9,HDFC,direct expenses,5eecc6d6449e4f7cfb1c2708,2023-03-23T00:00:00.000Z,POS 514834XXXXXX0472 PTM*PAYTM WALLET,ewallet,,debit_card,-93
645df60ef8804aea72c2df2e,50200023535069,30938.5,60ec41ba55c00300382672d9,HDFC,Transfer in/Revenue-other,5eecc6d6449e4f7cfb1c2708,2023-03-23T00:00:00.000Z,NEFT CR-UTIB0000114-ONE SIGMA TECHNOLOGI ES PRIVATE LIMI-SLICK ORGANICS PRIVATE L IMITED-AXISP00373659943,bnpl,,net_banking_transfer,1904.13
645df60ef8804aea72c2df30,50200023535069,32072.89,60ec41ba55c00300382672d9,HDFC,Transfer in/Revenue-other,5eecc6d6449e4f7cfb1c2708,2023-03-23T00:00:00.000Z,NEFT CR-UTIB0000114-ONE SIGMA TECHNOLOGI ES PRIVATE LIMI-SLICK ORGANICS PRIVATE L IMITED-AXISP00373659990,bnpl,,net_banking_transfer,1134.39
645df60ef8804aea72c2df32,50200023535069,66811.39,60ec41ba55c00300382672d9,HDFC,Transfer in/Revenue-other,5eecc6d6449e4f7cfb1c2708,2023-03-23T00:00:00.000Z,NEFT CR-HSBC0560002-INNOVATIVE RETAIL CO NCEPTS PRIVATE-SLICK ORGANICS PVT LTD-HS BCN23082836943,,,net_banking_transfer,34738.5
645df60ef8804aea72c2df34,50200023535069,105125.86,60ec41ba55c00300382672d9,HDFC,Transfer in/Revenue-other,5eecc6d6449e4f7cfb1c2708,2023-03-23T00:00:00.000Z,NEFT CR-YESB0000001-EASEBUZZ PVT LTD NOD AL A/C-SLICK ORGANICS PVT LTD-YESB308205 16017,,,net_banking_transfer,38314.47
645df60ff8804aea72c2df36,50200023535069,129025.81,60ec41ba55c00300382672d9,HDFC,Transfer in/Revenue-other,5eecc6d6449e4f7cfb1c2708,2023-03-23T00:00:00.000Z,NEFT CR-YESB0000001-EASEBUZZ PVT LTD NOD AL A/C-SLICK ORGANICS PVT LTD-YESB308205 15914,,,net_banking_transfer,23899.95
645df60ff8804aea72c2df38,50200023535069,127013.81,60ec41ba55c00300382672d9,HDFC,direct expenses,5eecc6d6449e4f7cfb1c2708,2023-03-23T00:00:00.000Z,POS 514834XXXXXX0472 PAYTM PAYMENTS S,ewallet,,debit_card,-2012
645df60ff8804aea72c2df3b,50200023535069,126437.81,60ec41ba55c00300382672d9,HDFC,direct expenses,5eecc6d6449e4f7cfb1c2708,2023-03-23T00:00:00.000Z,POS 514834XXXXXX0472 PAYTM PAYMENTS S,ewallet,,debit_card,-576
645df60ff8804aea72c2df3d,50200023535069,127606.83,60ec41ba55c00300382672d9,HDFC,Transfer in/Revenue-other,5eecc6d6449e4f7cfb1c2708,2023-03-23T00:00:00.000Z,EASEBUZZ PRIVA-A311230323PSNOXGU3JC,,,Other,1169.02
645df60ff8804aea72c2df3f,50200023535069,128340.39,60ec41ba55c00300382672d9,HDFC,Transfer in/Revenue-other,5eecc6d6449e4f7cfb1c2708,2023-03-23T00:00:00.000Z,NEFT CR-YESB0000001-EASEBUZZ PVT LTD NOD AL A/C-SLICK ORGANICS PVT LTD-YESB308205 43973,,,net_banking_transfer,733.56
645df60ff8804aea72c2df41,50200023535069,200381.89,60ec41ba55c00300382672d9,HDFC,Transfer in/Revenue-other,5eecc6d6449e4f7cfb1c2708,2023-03-23T00:00:00.000Z,NEFT CR-YESB0000001-EASEBUZZ PVT LTD NOD AL A/C-SLICK ORGANICS PVT LTD-YESB308205 60376,,,net_banking_transfer,72041.5
645df60ff8804aea72c2df44,50200023535069,203954.68,60ec41ba55c00300382672d9,HDFC,Transfer in/Revenue-other,5eecc6d6449e4f7cfb1c2708,2023-03-23T00:00:00.000Z,NEFT CR-YESB0000001-EASEBUZZ PVT LTD NOD AL A/C-SLICK ORGANICS PVT LTD-YESB308205 60526,,,net_banking_transfer,3572.79
645df60ff8804aea72c2df47,50200023535069,204913.68,60ec41ba55c00300382672d9,HDFC,Transfer in/Revenue-other,5eecc6d6449e4f7cfb1c2708,2023-03-23T00:00:00.000Z,NEFT CR-SCBL0036001-HEALTH GLOW PRIVATE LIMITED-SLICK ORGANICS PVT LTD-ARATA-IN 1ON23032302AZ0,,,net_banking_transfer,959
645df60ff8804aea72c2df49,50200023535069,206110.53,60ec41ba55c00300382672d9,HDFC,Revenue-PG-split enabled,5eecc6d6449e4f7cfb1c2708,2023-03-23T00:00:00.000Z,NEFT CR-UTIB0001506-RAZORPAY SOFTWARE PR IVATE LIMITED --SLICK ORGANICS PVT LITD- AXISCN0226593457,,,net_banking_transfer,1196.85
645df60ff8804aea72c2df4b,50200023535069,202364.53,60ec41ba55c00300382672d9,HDFC,direct expenses,5eecc6d6449e4f7cfb1c2708,2023-03-23T00:00:00.000Z,POS 514834XXXXXX0472 PTM*PAYTM WALLET,ewallet,,debit_card,-3746
645df60ff8804aea72c2df4d,50200023535069,202958.26,60ec41ba55c00300382672d9,HDFC,Transfer in/Revenue-other,5eecc6d6449e4f7cfb1c2708,2023-03-23T00:00:00.000Z,NEFT CR-SCBL0036001-AXELIA SOLUTIONS PRI VATE LIMITED-SLICK ORGANICS PVT LTD-IN1O N23032302WJB,,,net_banking_transfer,593.73
645df60ff8804aea72c2df4f,50200023535069,27958.26,60ec41ba55c00300382672d9,HDFC,direct expenses,5eecc6d6449e4f7cfb1c2708,2023-03-23T00:00:00.000Z,02711600008220-TPT-175000-VARUN SINGH,,,net_banking_transfer,-175000
645df60ff8804aea72c2df52,50200023535069,29875.39,60ec41ba55c00300382672d9,HDFC,Transfer in/Revenue-other,5eecc6d6449e4f7cfb1c2708,2023-03-24T00:00:00.000Z,IMPS-308303607299-EXCRO PAY ESCROW ACC-Y ESB-XXXXXXXXXXX1807-333112298023,,,net_banking_transfer,1917.13
645df60ff8804aea72c2df54,50200023535069,36460,60ec41ba55c00300382672d9,HDFC,Transfer in/Revenue-other,5eecc6d6449e4f7cfb1c2708,2023-03-24T00:00:00.000Z,IMPS-308307662190-EXCRO PAY ESCROW ACC-Y ESB-XXXXXXXXXXX1807-333112298023,,,net_banking_transfer,6584.61
645df60ff8804aea72c2df56,50200023535069,17139,60ec41ba55c00300382672d9,HDFC,direct expenses,5eecc6d6449e4f7cfb1c2708,2023-03-24T00:00:00.000Z,02711600008220-TPT-19321-VARUN SINGH,,,net_banking_transfer,-19321
645df60ff8804aea72c2df58,50200023535069,18329.33,60ec41ba55c00300382672d9,HDFC,Revenue-Mktplace,5eecc6d6449e4f7cfb1c2708,2023-03-24T00:00:00.000Z,NEFT CR-DEUT0797BGL-MYNTRA DESIGNS PRIVA,shopping,,net_banking_transfer,1190.33
645df60ff8804aea72c2df5a,50200023535069,19150.91,60ec41ba55c00300382672d9,HDFC,Revenue-Mktplace,5eecc6d6449e4f7cfb1c2708,2023-03-24T00:00:00.000Z,NEFT CR-DEUT0797BGL-MYNTRA DESIGNS PRIVA TE LIMITED-SLICK ORGANICS PVT. LTD.-3083 01102GN00213,shopping,,net_banking_transfer,821.58
645df60ff8804aea72c2df5c,50200023535069,19642.91,60ec41ba55c00300382672d9,HDFC,Revenue-PG-split enabled,5eecc6d6449e4f7cfb1c2708,2023-03-24T00:00:00.000Z,NEFT CR-UTIB0001506-RAZORPAY SOFTWARE PR IVATE LIMITED --SLICK ORGANICS PVT LITD- AXISCN0227069267,,,net_banking_transfer,492
645df60ff8804aea72c2df5e,50200023535069,20573.91,60ec41ba55c00300382672d9,HDFC,Revenue-Mktplace,5eecc6d6449e4f7cfb1c2708,2023-03-24T00:00:00.000Z,NEFT CR-ICIC0000105-MANASH LIFETYLE PVT LTD-SLICK ORGANICS PRIVATE LIMITED-ICIB2 30830004134,,,net_banking_transfer,931
645df60ff8804aea72c2df60,50200023535069,27814.51,60ec41ba55c00300382672d9,HDFC,Transfer in/Revenue-other,5eecc6d6449e4f7cfb1c2708,2023-03-24T00:00:00.000Z,NEFT CR-HSBC0400002-SOUQ.COM FZ LLC UAE ACCS-SLICK ORGANICS PRIVATE LIMITED-HSBC N23083018854,,,net_banking_transfer,7240.6
645df60ff8804aea72c2df62,50200023535069,30083.29,60ec41ba55c00300382672d9,HDFC,Transfer in/Revenue-other,5eecc6d6449e4f7cfb1c2708,2023-03-24T00:00:00.000Z,NEFT CR-UTIB0000114-ONE SIGMA TECHNOLOGI ES PRIVATE LIMI-SLICK ORGANICS PRIVATE L IMITED-AXISP00373933939,bnpl,,net_banking_transfer,2268.78
645df60ff8804aea72c2df64,50200023535069,34116.52,60ec41ba55c00300382672d9,HDFC,Transfer in/Revenue-other,5eecc6d6449e4f7cfb1c2708,2023-03-24T00:00:00.000Z,EASEBUZZ PRIVA-A242240323PSAARAUUHW,,,Other,4033.23
645df60ff8804aea72c2df68,50200023535069,8841.52,60ec41ba55c00300382672d9,HDFC,direct expenses,5eecc6d6449e4f7cfb1c2708,2023-03-24T00:00:00.000Z,02711600008220-TPT-25275-VARUN SINGH,,,net_banking_transfer,-25275
645df60ff8804aea72c2df6b,50200023535069,12028.62,60ec41ba55c00300382672d9,HDFC,Revenue-Mktplace,5eecc6d6449e4f7cfb1c2708,2023-03-24T00:00:00.000Z,IMPS-308314331836-DREAMPLUGPAYTECHSO-UTI B-XXXXXXXXXXX7853-,,,net_banking_transfer,3187.1
645df60ff8804aea72c2df6d,50200023535069,11864.62,60ec41ba55c00300382672d9,HDFC,direct expenses,5eecc6d6449e4f7cfb1c2708,2023-03-24T00:00:00.000Z,POS 514834XXXXXX0472 PAYTM PAYMENTS S,ewallet,,debit_card,-164
645df60ff8804aea72c2df6f,50200023535069,63716.73,60ec41ba55c00300382672d9,HDFC,Transfer in/Revenue-other,5eecc6d6449e4f7cfb1c2708,2023-03-24T00:00:00.000Z,NEFT CR-YESB0000001-EASEBUZZ PVT LTD NOD AL A/C-SLICK ORGANICS PVT LTD-YESB308336 03391,,,net_banking_transfer,51852.11
645df60ff8804aea72c2df72,50200023535069,182442.92,60ec41ba55c00300382672d9,HDFC,Revenue-COD,5eecc6d6449e4f7cfb1c2708,2023-03-24T00:00:00.000Z,NEFT CR-ICIC0000155-SHIPROCKET COD CRF I D 5944993-SLICK ORGANICS PVT LTD-CMS3198 170425,,,net_banking_transfer,118726.19
645df60ff8804aea72c2df74,50200023535069,183117.92,60ec41ba55c00300382672d9,HDFC,Revenue-PG-split enabled,5eecc6d6449e4f7cfb1c2708,2023-03-24T00:00:00.000Z,NEFT CR-UTIB0001506-RAZORPAY SOFTWARE PR IVATE LIMITED --SLICK ORGANICS PVT LITD- AXISCN0227473957,,,net_banking_transfer,675
645df60ff8804aea72c2df76,50200023535069,182657.92,60ec41ba55c00300382672d9,HDFC,direct expenses,5eecc6d6449e4f7cfb1c2708,2023-03-24T00:00:00.000Z,NEFT DR-SBIN0018817-RIGHT VISION SECURIT,,,net_banking_transfer,-460
645df60ff8804aea72c2df78,50200023535069,12657.92,60ec41ba55c00300382672d9,HDFC,direct expenses,5eecc6d6449e4f7cfb1c2708,2023-03-24T00:00:00.000Z,02711600008220-TPT-170000-VARUN SINGH,,,net_banking_transfer,-170000
645df60ff8804aea72c2df7a,50200023535069,13791.52,60ec41ba55c00300382672d9,HDFC,Transfer in/Revenue-other,5eecc6d6449e4f7cfb1c2708,2023-03-25T00:00:00.000Z,IMPS-308404758001-EXCRO PAY ESCROW ACC-Y ESB-XXXXXXXXXXX1807-333112298023,,,net_banking_transfer,1133.6
645df60ff8804aea72c2df7c,50200023535069,12213.52,60ec41ba55c00300382672d9,HDFC,direct expenses,5eecc6d6449e4f7cfb1c2708,2023-03-25T00:00:00.000Z,POS 514834XXXXXX0472 PAYTM_PAYTMADDMO,ewallet,,debit_card,-1578
645df60ff8804aea72c2df7e,50200023535069,15351.02,60ec41ba55c00300382672d9,HDFC,Transfer in/Revenue-other,5eecc6d6449e4f7cfb1c2708,2023-03-26T00:00:00.000Z,IMPS-308504925850-EXCRO PAY ESCROW ACC-Y ESB-XXXXXXXXXXX1807-333112298023,,,net_banking_transfer,3137.5
645df60ff8804aea72c2df80,50200023535069,14173.9,60ec41ba55c00300382672d9,HDFC,Marketing Expense,5eecc6d6449e4f7cfb1c2708,2023-03-26T00:00:00.000Z,ME DC SI 514834XXXXXX0472 FACEBOOK SI,,,Other,-1177.12
645df60ff8804aea72c2df82,50200023535069,16392.36,60ec41ba55c00300382672d9,HDFC,Transfer in/Revenue-other,5eecc6d6449e4f7cfb1c2708,2023-03-27T00:00:00.000Z,IMPS-308604970357-EXCRO PAY ESCROW ACC-Y ESB-XXXXXXXXXXX1807-333112298023,,,net_banking_transfer,2218.46
645df60ff8804aea72c2df84,50200023535069,21495.4,60ec41ba55c00300382672d9,HDFC,Transfer in/Revenue-other,5eecc6d6449e4f7cfb1c2708,2023-03-27T00:00:00.000Z,IMPS-308607650254-EXCRO PAY ESCROW ACC-Y ESB-XXXXXXXXXXX1807-333112298023,,,net_banking_transfer,5103.04
645df60ff8804aea72c2df86,50200023535069,23014.69,60ec41ba55c00300382672d9,HDFC,Revenue-Mktplace,5eecc6d6449e4f7cfb1c2708,2023-03-27T00:00:00.000Z,NEFT CR-DEUT0797BGL-MYNTRA DESIGNS PRIVA TE LIMITED-SLICK ORGANICS - SJIT-3086010 05GN00010,shopping,,net_banking_transfer,1519.29
645df60ff8804aea72c2df88,50200023535069,23724.88,60ec41ba55c00300382672d9,HDFC,Revenue-Mktplace,5eecc6d6449e4f7cfb1c2708,2023-03-27T00:00:00.000Z,NEFT CR-DEUT0797BGL-MYNTRA DESIGNS PRIVA TE LIMITED-SLICK ORGANICS PVT. LTD.-3086 01005GN00147,shopping,,net_banking_transfer,710.19
645df60ff8804aea72c2df8a,50200023535069,20639.88,60ec41ba55c00300382672d9,HDFC,direct expenses,5eecc6d6449e4f7cfb1c2708,2023-03-27T00:00:00.000Z,POS 514834XXXXXX0472 PAYTM_PAYTMADDMO,ewallet,,debit_card,-3085
645df60ff8804aea72c2df8c,50200023535069,20344.88,60ec41ba55c00300382672d9,HDFC,bank charges,5eecc6d6449e4f7cfb1c2708,2023-03-27T00:00:00.000Z,DEBIT CARD ANNUAL FEE-FEB-2023 210223-CD T2308415049576,,,bank_charge,-295
645df60ff8804aea72c2df8e,50200023535069,26432.03,60ec41ba55c00300382672d9,HDFC,Revenue-PG-split enabled,5eecc6d6449e4f7cfb1c2708,2023-03-27T00:00:00.000Z,NEFT CR-UTIB0001506-RAZORPAY SOFTWARE PR IVATE LIMITED --SLICK ORGANICS PVT LITD- AXISCN0228333233,,,net_banking_transfer,6087.15
645df60ff8804aea72c2df90,50200023535069,26218.03,60ec41ba55c00300382672d9,HDFC,direct expenses,5eecc6d6449e4f7cfb1c2708,2023-03-27T00:00:00.000Z,POS 514834XXXXXX0472 PAYTM PAYMENTS S,ewallet,,debit_card,-214
645df60ff8804aea72c2df93,50200023535069,31522.03,60ec41ba55c00300382672d9,HDFC,Revenue-Mktplace,5eecc6d6449e4f7cfb1c2708,2023-03-27T00:00:00.000Z,NEFT CR-ICIC0000105-MANASH LIFETYLE PVT LTD-SLICK ORGANICS PRIVATE LIMITED-ICIB2 30860000102,,,net_banking_transfer,5304
645df60ff8804aea72c2df95,50200023535069,30527.03,60ec41ba55c00300382672d9,HDFC,direct expenses,5eecc6d6449e4f7cfb1c2708,2023-03-27T00:00:00.000Z,POS 514834XXXXXX0472 PAYTM PAYMENTS S,ewallet,,debit_card,-995
645df60ff8804aea72c2df97,50200023535069,30232.03,60ec41ba55c00300382672d9,HDFC,direct expenses,5eecc6d6449e4f7cfb1c2708,2023-03-27T00:00:00.000Z,POS 514834XXXXXX0472 PAYTM_PAYTMADDMO,ewallet,,debit_card,-295
645df60ff8804aea72c2df99,50200023535069,151697.64,60ec41ba55c00300382672d9,HDFC,Transfer in/Revenue-other,5eecc6d6449e4f7cfb1c2708,2023-03-27T00:00:00.000Z,NEFT CR-YESB0000001-EASEBUZZ PVT LTD NOD AL A/C-SLICK ORGANICS PVT LTD-YESB308617 28815,,,net_banking_transfer,121465.61
645df60ff8804aea72c2df9c,50200023535069,151161.64,60ec41ba55c00300382672d9,HDFC,direct expenses,5eecc6d6449e4f7cfb1c2708,2023-03-27T00:00:00.000Z,50100108772229-TPT-536-HEMANT GUPTA,,,net_banking_transfer,-536
645df60ff8804aea72c2df9e,50200023535069,11161.64,60ec41ba55c00300382672d9,HDFC,direct expenses,5eecc6d6449e4f7cfb1c2708,2023-03-27T00:00:00.000Z,02711600008220-TPT-1400000-VARUN SINGH,,,net_banking_transfer,-140000
645df60ff8804aea72c2dfa0,50200023535069,23306.54,60ec41ba55c00300382672d9,HDFC,Revenue-Mktplace,5eecc6d6449e4f7cfb1c2708,2023-03-27T00:00:00.000Z,IMPS-308614024951-DREAMPLUGPAYTECHSO-UTI B-XXXXXXXXXXX7853-NA,,,net_banking_transfer,12144.9
645df60ff8804aea72c2dfa2,50200023535069,26709.71,60ec41ba55c00300382672d9,HDFC,Transfer in/Revenue-other,5eecc6d6449e4f7cfb1c2708,2023-03-27T00:00:00.000Z,NEFT CR-UTIB0000114-ONE SIGMA TECHNOLOGI ES PRIVATE LIMI-SLICK ORGANICS PRIVATE L IMITED-AXISP00374361031,bnpl,,net_banking_transfer,3403.17
645df60ff8804aea72c2dfa4,50200023535069,33516.05,60ec41ba55c00300382672d9,HDFC,Transfer in/Revenue-other,5eecc6d6449e4f7cfb1c2708,2023-03-27T00:00:00.000Z,NEFT CR-UTIB0000114-ONE SIGMA TECHNOLOGI ES PRIVATE LIMI-SLICK ORGANICS PRIVATE L IMITED-AXISP00374360372,bnpl,,net_banking_transfer,6806.34
645df60ff8804aea72c2dfa6,50200023535069,39188,60ec41ba55c00300382672d9,HDFC,Transfer in/Revenue-other,5eecc6d6449e4f7cfb1c2708,2023-03-27T00:00:00.000Z,NEFT CR-UTIB0000114-ONE SIGMA TECHNOLOGI ES PRIVATE LIMI-SLICK ORGANICS PRIVATE L IMITED-AXISP00374361047,bnpl,,net_banking_transfer,5671.95
645df60ff8804aea72c2dfa8,50200023535069,49320,60ec41ba55c00300382672d9,HDFC,Transfer in/Revenue-other,5eecc6d6449e4f7cfb1c2708,2023-03-27T00:00:00.000Z,NEFT CR-KKBK0000958-OCTAVOS ENTERPRISE S OLUTIONS PVT-SLICK ORGANICS PVT LTD-CMS0 862347992889,,,net_banking_transfer,10132
645df60ff8804aea72c2dfab,50200023535069,54321.24,60ec41ba55c00300382672d9,HDFC,Transfer in/Revenue-other,5eecc6d6449e4f7cfb1c2708,2023-03-27T00:00:00.000Z,EASEBUZZ PRIVA-A348270323PSBE2DJQK2,,,Other,5001.24
645df60ff8804aea72c2dfad,50200023535069,236066.1,60ec41ba55c00300382672d9,HDFC,Revenue-COD,5eecc6d6449e4f7cfb1c2708,2023-03-27T00:00:00.000Z,NEFT CR-ICIC0000155-SHIPROCKET COD CRF I D 5953277-SLICK ORGANICS PVT LTD-CMS3203 336804,,,net_banking_transfer,181744.86
645df610f8804aea72c2dfaf,50200023535069,237050.1,60ec41ba55c00300382672d9,HDFC,Revenue-PG-split enabled,5eecc6d6449e4f7cfb1c2708,2023-03-27T00:00:00.000Z,NEFT CR-UTIB0001506-RAZORPAY SOFTWARE PR IVATE LIMITED --SLICK ORGANICS PVT LITD- AXISCN0228808323,,,net_banking_transfer,984
645df610f8804aea72c2dfb1,50200023535069,356814.57,60ec41ba55c00300382672d9,HDFC,Transfer in/Revenue-other,5eecc6d6449e4f7cfb1c2708,2023-03-27T00:00:00.000Z,NEFT CR-YESB0000001-EASEBUZZ PVT LTD NOD AL A/C-SLICK ORGANICS PVT LTD-YESB308619 22533,,,net_banking_transfer,119764.47
645df610f8804aea72c2dfb3,50200023535069,356980.87,60ec41ba55c00300382672d9,HDFC,Transfer in/Revenue-other,5eecc6d6449e4f7cfb1c2708,2023-03-27T00:00:00.000Z,NEFT CR-SCBL0036001-AXELIA SOLUTIONS PRI VATE LIMITED-SLICK ORGANICS PVT LTD-IN1O N230327051QY,,,net_banking_transfer,166.3
645df610f8804aea72c2dfb5,50200023535069,358789.32,60ec41ba55c00300382672d9,HDFC,Transfer in/Revenue-other,5eecc6d6449e4f7cfb1c2708,2023-03-28T00:00:00.000Z,IMPS-308704836339-EXCRO PAY ESCROW ACC-Y ESB-XXXXXXXXXXX1807-333112298023,,,net_banking_transfer,1808.45
645df610f8804aea72c2dfb7,50200023535069,369864.76,60ec41ba55c00300382672d9,HDFC,Transfer in/Revenue-other,5eecc6d6449e4f7cfb1c2708,2023-03-28T00:00:00.000Z,4200013518-24 03 2023-HD08868902,,,Other,11075.44
645df610f8804aea72c2dfb9,50200023535069,308979.76,60ec41ba55c00300382672d9,HDFC,direct expenses,5eecc6d6449e4f7cfb1c2708,2023-03-28T00:00:00.000Z,"NEFT DR-UTIB0000400-CC MUKESH GOYAL 3469 -NETBANK, MUM-N087232388541998-60885",,,net_banking_transfer,-60885
645df610f8804aea72c2dfbb,50200023535069,43979.76,60ec41ba55c00300382672d9,HDFC,direct expenses,5eecc6d6449e4f7cfb1c2708,2023-03-28T00:00:00.000Z,02711600008220-TPT-265000-VARUN SINGH,,,net_banking_transfer,-265000
645df610f8804aea72c2dfbd,50200023535069,46150.76,60ec41ba55c00300382672d9,HDFC,Revenue-PG-split enabled,5eecc6d6449e4f7cfb1c2708,2023-03-28T00:00:00.000Z,NEFT CR-UTIB0001506-RAZORPAY SOFTWARE PR IVATE LIMITED --SLICK ORGANICS PVT LITD- AXISCN0228962808,,,net_banking_transfer,2171
645df610f8804aea72c2dfbf,50200023535069,25650.76,60ec41ba55c00300382672d9,HDFC,direct expenses,5eecc6d6449e4f7cfb1c2708,2023-03-28T00:00:00.000Z,"NEFT DR-KKBK0004581-MJ GLOBAL PVT LTD-NE TBANK, MUM-N087232389130900-20500",,,net_banking_transfer,-20500
645df610f8804aea72c2dfc1,50200023535069,30342.76,60ec41ba55c00300382672d9,HDFC,Revenue-Mktplace,5eecc6d6449e4f7cfb1c2708,2023-03-28T00:00:00.000Z,IMPS-308714764615-DREAMPLUGPAYTECHSO-UTI B-XXXXXXXXXXX7853-NA,,,net_banking_transfer,4692
645df610f8804aea72c2dfc7,50200023535069,34880.32,60ec41ba55c00300382672d9,HDFC,Transfer in/Revenue-other,5eecc6d6449e4f7cfb1c2708,2023-03-28T00:00:00.000Z,NEFT CR-UTIB0000114-ONE SIGMA TECHNOLOGI ES PRIVATE LIMI-SLICK ORGANICS PRIVATE L IMITED-AXISP00374974745,bnpl,,net_banking_transfer,4537.56
645df610f8804aea72c2dfc9,50200023535069,36684.32,60ec41ba55c00300382672d9,HDFC,Revenue-Mktplace,5eecc6d6449e4f7cfb1c2708,2023-03-28T00:00:00.000Z,NEFT CR-ICIC0000105-MANASH LIFESTYLE PRI VATE LIMITED NO-SLICK ORGANICS PRIVATE L IMITED-ICIJ230870003101,shopping,,net_banking_transfer,1804
645df610f8804aea72c2dfcb,50200023535069,25884.32,60ec41ba55c00300382672d9,HDFC,direct expenses,5eecc6d6449e4f7cfb1c2708,2023-03-28T00:00:00.000Z,50100230430690-TPT-10800-HARSHITA MODI,,,net_banking_transfer,-10800
645df610f8804aea72c2dfcd,50200023535069,28172.71,60ec41ba55c00300382672d9,HDFC,Transfer in/Revenue-other,5eecc6d6449e4f7cfb1c2708,2023-03-28T00:00:00.000Z,EASEBUZZ PRIVA-A241280323PS0RSYXORR,,,Other,2288.39
645df610f8804aea72c2dfcf,50200023535069,29345.27,60ec41ba55c00300382672d9,HDFC,Transfer in/Revenue-other,5eecc6d6449e4f7cfb1c2708,2023-03-28T00:00:00.000Z,NEFT CR-YESB0000001-EASEBUZZ PVT LTD NOD AL A/C-SLICK ORGANICS PVT LTD-YESB308750 89491,,,net_banking_transfer,1172.56
645df610f8804aea72c2dfd1,50200023535069,17345.27,60ec41ba55c00300382672d9,HDFC,N-ACH payments,5eecc6d6449e4f7cfb1c2708,2023-03-28T00:00:00.000Z,50100323122585-TPT-12000-PARMILA CHHETRI,,,net_banking_transfer,-12000
645df610f8804aea72c2dfd3,50200023535069,67833.27,60ec41ba55c00300382672d9,HDFC,Revenue-Mktplace,5eecc6d6449e4f7cfb1c2708,2023-03-28T00:00:00.000Z,NEFT CR-SCBL0036001-DREAMPLUG TECHNOLOGI ES PRIVATE LIMITED-SLICK ORGANICS PRIVAT E LIMITEDSLICK-IN1ON230328054WJ,,,net_banking_transfer,50488
645df610f8804aea72c2dfd5,50200023535069,69510.77,60ec41ba55c00300382672d9,HDFC,Revenue-PG-split enabled,5eecc6d6449e4f7cfb1c2708,2023-03-28T00:00:00.000Z,NEFT CR-UTIB0001506-RAZORPAY SOFTWARE PR IVATE LIMITED --SLICK ORGANICS PVT LITD- AXISCN0229297702,,,net_banking_transfer,1677.5
645df610f8804aea72c2dfd7,50200023535069,69511.77,60ec41ba55c00300382672d9,HDFC,Transfer in/Revenue-other,5eecc6d6449e4f7cfb1c2708,2023-03-28T00:00:00.000Z,IMPS-308718333323-DIGIOTECH SOLUTIONS -I,,,net_banking_transfer,1
645df610f8804aea72c2dfd9,50200023535069,26951.77,60ec41ba55c00300382672d9,HDFC,direct expenses,5eecc6d6449e4f7cfb1c2708,2023-03-28T00:00:00.000Z,"NEFT DR-ICIC0000047-MAILMODO TECHNOLOGIE S PRIVATE LIMITED-NETBANK, MUM-N08723239 0042011-42560",,,net_banking_transfer,-42560
645df610f8804aea72c2dfdb,50200023535069,65618.5,60ec41ba55c00300382672d9,HDFC,Transfer in/Revenue-other,5eecc6d6449e4f7cfb1c2708,2023-03-28T00:00:00.000Z,NEFT CR-YESB0000001-EASEBUZZ PVT LTD NOD AL A/C-SLICK ORGANICS PVT LTD-YESB308752 07595,,,net_banking_transfer,38666.73
645df610f8804aea72c2dfdd,50200023535069,117322.59,60ec41ba55c00300382672d9,HDFC,Transfer in/Revenue-other,5eecc6d6449e4f7cfb1c2708,2023-03-28T00:00:00.000Z,NEFT CR-YESB0000001-EASEBUZZ PVT LTD NOD AL A/C-SLICK ORGANICS PVT LTD-YESB308752 07227,,,net_banking_transfer,51704.09
645df610f8804aea72c2dfdf,50200023535069,120031.95,60ec41ba55c00300382672d9,HDFC,Transfer in/Revenue-other,5eecc6d6449e4f7cfb1c2708,2023-03-29T00:00:00.000Z,IMPS-308804669711-EXCRO PAY ESCROW ACC-Y ESB-XXXXXXXXXXX1807-333112298023,,,net_banking_transfer,2709.36
645df610f8804aea72c2dfe1,50200023535069,97661.95,60ec41ba55c00300382672d9,HDFC,direct expenses,5eecc6d6449e4f7cfb1c2708,2023-03-29T00:00:00.000Z,"NEFT DR-KKBK0004281-FDM DIGITAL SOLUTION S PVT LTD-NETBANK, MUM-N088232390616708- 22370",,,net_banking_transfer,-22370
645df610f8804aea72c2dfe3,50200023535069,102596.05,60ec41ba55c00300382672d9,HDFC,Transfer in/Revenue-other,5eecc6d6449e4f7cfb1c2708,2023-03-29T00:00:00.000Z,NEFT CR-YESB0000001-EXCRO PAY ESCROW ACC OUNT-SLICKORGANICSPRIVATELIMITED-YESB308 88038323,,,net_banking_transfer,4934.1
645df610f8804aea72c2dfe5,50200023535069,104697.66,60ec41ba55c00300382672d9,HDFC,Revenue-Mktplace,5eecc6d6449e4f7cfb1c2708,2023-03-29T00:00:00.000Z,NEFT CR-DEUT0797BGL-MYNTRA DESIGNS PRIVA TE LIMITED-SLICK ORGANICS PVT. LTD.-3088 01072GN00289,shopping,,net_banking_transfer,2101.61
645df610f8804aea72c2dfe7,50200023535069,107630.97,60ec41ba55c00300382672d9,HDFC,Revenue-Mktplace,5eecc6d6449e4f7cfb1c2708,2023-03-29T00:00:00.000Z,NEFT CR-DEUT0797BGL-MYNTRA DESIGNS PRIVA TE LIMITED-SLICK ORGANICS - SJIT-3088010 91GN00080,shopping,,net_banking_transfer,2933.31
645df610f8804aea72c2dfea,50200023535069,122376.17,60ec41ba55c00300382672d9,HDFC,Revenue-PG-split enabled,5eecc6d6449e4f7cfb1c2708,2023-03-29T00:00:00.000Z,NEFT CR-UTIB0001506-RAZORPAY SOFTWARE PR IVATE LIMITED --SLICK ORGANICS PVT LITD- AXISCN0229491372,,,net_banking_transfer,14745.2
645df610f8804aea72c2dfec,50200023535069,111608.17,60ec41ba55c00300382672d9,HDFC,direct expenses,5eecc6d6449e4f7cfb1c2708,2023-03-29T00:00:00.000Z,"NEFT DR-SBIN0008078-PANDIT PLASTICS-NETB ANK, MUM-N088232390880872-10768",,,net_banking_transfer,-10768
645df610f8804aea72c2dfee,50200023535069,86608.17,60ec41ba55c00300382672d9,HDFC,direct expenses,5eecc6d6449e4f7cfb1c2708,2023-03-29T00:00:00.000Z,POS 514834XXXXXX0472 FLIPKART,shopping,,debit_card,-25000
645df610f8804aea72c2dff0,50200023535069,85528.17,60ec41ba55c00300382672d9,HDFC,direct expenses,5eecc6d6449e4f7cfb1c2708,2023-03-29T00:00:00.000Z,POS 514834XXXXXX0472 PAYTM_PAYTMADDMO,ewallet,,debit_card,-1080
645df610f8804aea72c2dff2,50200023535069,84115.17,60ec41ba55c00300382672d9,HDFC,direct expenses,5eecc6d6449e4f7cfb1c2708,2023-03-29T00:00:00.000Z,POS 514834XXXXXX0472 PTM*PAYTM WALLET,ewallet,,debit_card,-1413
645df610f8804aea72c2dff4,50200023535069,91394,60ec41ba55c00300382672d9,HDFC,Transfer in/Revenue-other,5eecc6d6449e4f7cfb1c2708,2023-03-29T00:00:00.000Z,NEFT CR-UTIB0000114-ONE SIGMA TECHNOLOGI ES PRIVATE LIMI-SLICK ORGANICS PRIVATE L IMITED-AXISP00375409748,bnpl,,net_banking_transfer,7278.83
645df610f8804aea72c2dff6,50200023535069,96235,60ec41ba55c00300382672d9,HDFC,Revenue-Mktplace,5eecc6d6449e4f7cfb1c2708,2023-03-29T00:00:00.000Z,IMPS-308814715746-DREAMPLUGPAYTECHSO-UTI B-XXXXXXXXXXX7853-NA,,,net_banking_transfer,4841
645df610f8804aea72c2dff8,50200023535069,97558,60ec41ba55c00300382672d9,HDFC,Revenue-Mktplace,5eecc6d6449e4f7cfb1c2708,2023-03-29T00:00:00.000Z,NEFT CR-ICIC0000105-MANASH LIFESTYLE PRI VATE LIMITED NO-SLICK ORGANICS PRIVATE L IMITED-ICIJ230880006099,shopping,,net_banking_transfer,1323
645df610f8804aea72c2dffa,50200023535069,98727.02,60ec41ba55c00300382672d9,HDFC,Transfer in/Revenue-other,5eecc6d6449e4f7cfb1c2708,2023-03-29T00:00:00.000Z,EASEBUZZ PRIVA-A235290323PSITCLMR4X,,,Other,1169.02
645df610f8804aea72c2dffc,50200023535069,56607.02,60ec41ba55c00300382672d9,HDFC,direct expenses,5eecc6d6449e4f7cfb1c2708,2023-03-29T00:00:00.000Z,"NEFT DR-INDB0001025-GROWLYTICS TECHNOLOG IES PVT LTD-NETBANK, MUM-N08823239194515 0-SLICK ORGANICS PVT",,,net_banking_transfer,-42120
645df610f8804aea72c2dffe,50200023535069,74811.02,60ec41ba55c00300382672d9,HDFC,Revenue-PG-split enabled,5eecc6d6449e4f7cfb1c2708,2023-03-29T00:00:00.000Z,NEFT CR-UTIB0001506-RAZORPAY SOFTWARE PR IVATE LIMITED --SLICK ORGANICS PVT LITD- AXISCN0229843509,,,net_banking_transfer,18204
645df610f8804aea72c2e000,50200023535069,164224.26,60ec41ba55c00300382672d9,HDFC,Transfer in/Revenue-other,5eecc6d6449e4f7cfb1c2708,2023-03-29T00:00:00.000Z,NEFT CR-YESB0000001-EASEBUZZ PVT LTD NOD AL A/C-SLICK ORGANICS PVT LTD-YESB308885 77038,,,net_banking_transfer,89413.24
645df610f8804aea72c2e002,50200023535069,4224.26,60ec41ba55c00300382672d9,HDFC,direct expenses,5eecc6d6449e4f7cfb1c2708,2023-03-29T00:00:00.000Z,"NEFT DR-RATN0VAAPIS-CC HEMANT GUPTA 3965 -NETBANK, MUM-N088232392207413-160000",,,net_banking_transfer,-160000
645df610f8804aea72c2e005,50200023535069,44712.84,60ec41ba55c00300382672d9,HDFC,Transfer in/Revenue-other,5eecc6d6449e4f7cfb1c2708,2023-03-29T00:00:00.000Z,IMPS-308821402460-PCPL CENTRAL DISBUR-I DFB-XXXXXXX1507-IMPSTXN,,,net_banking_transfer,40488.58
645df610f8804aea72c2e007,50200023535069,47491.59,60ec41ba55c00300382672d9,HDFC,Transfer in/Revenue-other,5eecc6d6449e4f7cfb1c2708,2023-03-30T00:00:00.000Z,IMPS-308904826682-EXCRO PAY ESCROW ACC-Y ESB-XXXXXXXXXXX1807-333112298023,,,net_banking_transfer,2778.75
645df610f8804aea72c2e00a,50200023535069,48299.32,60ec41ba55c00300382672d9,HDFC,Revenue-Mktplace,5eecc6d6449e4f7cfb1c2708,2023-03-30T00:00:00.000Z,NEFT CR-DEUT0797BGL-MYNTRA DESIGNS PRIVA TE LIMITED-SLICK ORGANICS - SJIT-3089006 51GN00046,shopping,,net_banking_transfer,807.73
645df610f8804aea72c2e00e,50200023535069,34290.02,60ec41ba55c00300382672d9,HDFC,direct expenses,5eecc6d6449e4f7cfb1c2708,2023-03-30T00:00:00.000Z,"NEFT DR-RATN0VAAPIS-CC HEMANT GUPTA 3965 -NETBANK, MUM-N089232392572270-14009",,,net_banking_transfer,-14009.3
645df610f8804aea72c2e011,50200023535069,34936.2,60ec41ba55c00300382672d9,HDFC,Revenue-Mktplace,5eecc6d6449e4f7cfb1c2708,2023-03-30T00:00:00.000Z,NEFT CR-DEUT0797BGL-MYNTRA DESIGNS PRIVA TE LIMITED-SLICK ORGANICS PVT. LTD.-3089 00672GN00104,shopping,,net_banking_transfer,646.18
645df610f8804aea72c2e013,50200023535069,4836.76,60ec41ba55c00300382672d9,HDFC,direct expenses,5eecc6d6449e4f7cfb1c2708,2023-03-30T00:00:00.000Z,"NEFT DR-UTIB0000400-CC HEMANT GUPTA 7447 -NETBANK, MUM-N089232392569270-30099",,,net_banking_transfer,-30099.44
645df610f8804aea72c2e016,50200023535069,7105.54,60ec41ba55c00300382672d9,HDFC,Transfer in/Revenue-other,5eecc6d6449e4f7cfb1c2708,2023-03-30T00:00:00.000Z,NEFT CR-UTIB0000114-ONE SIGMA TECHNOLOGI ES PRIVATE LIMI-SLICK ORGANICS PRIVATE L IMITED-AXISP00376418520,bnpl,,net_banking_transfer,2268.78
645df610f8804aea72c2e019,50200023535069,8043.54,60ec41ba55c00300382672d9,HDFC,Revenue-Mktplace,5eecc6d6449e4f7cfb1c2708,2023-03-30T00:00:00.000Z,NEFT CR-ICIC0000105-MANASH LIFESTYLE PRI VATE LIMITED NODAL ACCOUNT-SLICK ORGANIC S PRIVATE LIMITED-ICIB230890031320,shopping,,net_banking_transfer,938
645df610f8804aea72c2e01b,50200023535069,11443.52,60ec41ba55c00300382672d9,HDFC,Transfer in/Revenue-other,5eecc6d6449e4f7cfb1c2708,2023-03-31T00:00:00.000Z,IMPS-309004974911-EXCRO PAY ESCROW ACC-Y ESB-XXXXXXXXXXX1807-333112298023,,,net_banking_transfer,3399.98
645df610f8804aea72c2e01d,50200023535069,1911443.52,60ec41ba55c00300382672d9,HDFC,Internal Transfers,5eecc6d6449e4f7cfb1c2708,2023-03-31T00:00:00.000Z,IB FUNDS TRANSFER CR-50200035187206 -SL ICK ORGANICS PVT LTD,,,Other,1900000
645df610f8804aea72c2e01f,50200023535069,1361443.52,60ec41ba55c00300382672d9,HDFC,direct expenses,5eecc6d6449e4f7cfb1c2708,2023-03-31T00:00:00.000Z,"NEFT DR-KKBK0000180-VEDIC COSMECEUTICALS PVT LTD-NETBANK, MUM-N090232394474012-5 50000",,,net_banking_transfer,-550000
645df610f8804aea72c2e021,50200023535069,1266443.52,60ec41ba55c00300382672d9,HDFC,direct expenses,5eecc6d6449e4f7cfb1c2708,2023-03-31T00:00:00.000Z,"NEFT DR-UTIB0000400-CC HEMANT GUPTA 7447 -NETBANK, MUM-N090232394499411-95000",,,net_banking_transfer,-95000
645df610f8804aea72c2e024,50200023535069,1064107.12,60ec41ba55c00300382672d9,HDFC,direct expenses,5eecc6d6449e4f7cfb1c2708,2023-03-31T00:00:00.000Z,"NEFT DR-RATN0CRCARD-CC HEMANT GUPTA 9467 -NETBANK, MUM-N090232394510400-202336",,,net_banking_transfer,-202336.4
645df610f8804aea72c2e027,50200023535069,564107.12,60ec41ba55c00300382672d9,HDFC,Tax,5eecc6d6449e4f7cfb1c2708,2023-03-31T00:00:00.000Z,051030831032312896- CBDT TAX,,,Other,-500000
645df611f8804aea72c2e02b,50200023535069,268271.06,60ec41ba55c00300382672d9,HDFC,Utilities/bills,5eecc6d6449e4f7cfb1c2708,2023-03-31T00:00:00.000Z,IB BILLPAY DR-HDFCVE-489377XXXXXX1124,bills,,Other,-295836.06
645df611f8804aea72c2e02d,50200023535069,330090.89,60ec41ba55c00300382672d9,HDFC,Revenue-PG-split enabled,5eecc6d6449e4f7cfb1c2708,2023-03-31T00:00:00.000Z,NEFT CR-UTIB0001506-RAZORPAY SOFTWARE PR IVATE LIMITED --SLICK ORGANICS PVT LITD- AXISCN0230404429,,,net_banking_transfer,61819.83
645df611f8804aea72c2e02f,50200023535069,339247.89,60ec41ba55c00300382672d9,HDFC,Revenue-Mktplace,5eecc6d6449e4f7cfb1c2708,2023-03-31T00:00:00.000Z,IMPS-309014918640-DREAMPLUGPAYTECHSO-UTI B-XXXXXXXXXXX7853-NA,,,net_banking_transfer,9157
645df611f8804aea72c2e031,50200023535069,383507.4,60ec41ba55c00300382672d9,HDFC,Transfer in/Revenue-other,5eecc6d6449e4f7cfb1c2708,2023-03-31T00:00:00.000Z,NEFT CR-YESB0000001-EASEBUZZ PVT LTD NOD AL A/C-SLICK ORGANICS PVT LTD-YESB309035 04228,,,net_banking_transfer,44259.51
645df611f8804aea72c2e034,50200023535069,414498.29,60ec41ba55c00300382672d9,HDFC,Transfer in/Revenue-other,5eecc6d6449e4f7cfb1c2708,2023-03-31T00:00:00.000Z,NEFT CR-YESB0000001-EASEBUZZ PVT LTD NOD AL A/C-SLICK ORGANICS PVT LTD-YESB309035 04313,,,net_banking_transfer,30990.89
645df611f8804aea72c2e037,50200023535069,403698.29,60ec41ba55c00300382672d9,HDFC,direct expenses,5eecc6d6449e4f7cfb1c2708,2023-03-31T00:00:00.000Z,"NEFT DR-SBIN0001211-URJA TANTA-NETBANK, MUM-N090232395548775-10800",,,net_banking_transfer,-10800
645df611f8804aea72c2e039,50200023535069,402032.29,60ec41ba55c00300382672d9,HDFC,direct expenses,5eecc6d6449e4f7cfb1c2708,2023-03-31T00:00:00.000Z,"NEFT DR-ICIC0006956-LAKSHAY CARRYING COR PORATION-NETBANK, MUM-N090232395571664-1 666",,,net_banking_transfer,-1666
645df611f8804aea72c2e03b,50200023535069,405223.02,60ec41ba55c00300382672d9,HDFC,Transfer in/Revenue-other,5eecc6d6449e4f7cfb1c2708,2023-03-31T00:00:00.000Z,EASEBUZZ PRIVA-A295310323PSALLIUQBO,,,Other,3190.73
645df611f8804aea72c2e03d,50200023535069,408817.02,60ec41ba55c00300382672d9,HDFC,Revenue-PG-split enabled,5eecc6d6449e4f7cfb1c2708,2023-03-31T00:00:00.000Z,NEFT CR-UTIB0001506-RAZORPAY SOFTWARE PR IVATE LIMITED --SLICK ORGANICS PVT LITD- AXISCN0230773960,,,net_banking_transfer,3594
645df611f8804aea72c2e03f,50200023535069,411740.68,60ec41ba55c00300382672d9,HDFC,Transfer in/Revenue-other,5eecc6d6449e4f7cfb1c2708,2023-03-31T00:00:00.000Z,NEFT CR-YESB0000001-EASEBUZZ PVT LTD NOD AL A/C-SLICK ORGANICS PVT LTD-YESB309037 92961,,,net_banking_transfer,2923.66
645df611f8804aea72c2e042,50200023535069,545327.74,60ec41ba55c00300382672d9,HDFC,Transfer in/Revenue-other,5eecc6d6449e4f7cfb1c2708,2023-03-31T00:00:00.000Z,NEFT CR-YESB0000001-EASEBUZZ PVT LTD NOD AL A/C-SLICK ORGANICS PVT LTD-YESB309037 93661,,,net_banking_transfer,133587.06
645df611f8804aea72c2e044,50200023535069,545354.59,60ec41ba55c00300382672d9,HDFC,Transfer in/Revenue-other,5eecc6d6449e4f7cfb1c2708,2023-03-31T00:00:00.000Z,NEFT CR-ICIC0099999-AXELIA SOLUTIONS PRI VATE LIMITED-SLICK ORGANICS PVT LTD-CMS3 215258328 STATEMENT SUMMARY :-,,,net_banking_transfer,26.85
645df611f8804aea72c2e046,50200023535069,547526.14,60ec41ba55c00300382672d9,HDFC,Transfer in/Revenue-other,5eecc6d6449e4f7cfb1c2708,2023-04-01T00:00:00.000Z,IMPS-309106831995-EXCRO PAY ESCROW ACC-Y ESB-XXXXXXXXXXX1807-333112298023,,Transfer from EXCRO PAY ESCROW ACC,net_banking_transfer,2171.55
645df611f8804aea72c2e048,50200023535069,6647526.14,60ec41ba55c00300382672d9,HDFC,Internal Transfers,5eecc6d6449e4f7cfb1c2708,2023-04-01T00:00:00.000Z,IB FUNDS TRANSFER CR-50200035187206 -SL ICK ORGANICS PVT LTD,,,Other,6100000
645df611f8804aea72c2e04a,50200023535069,6629788.14,60ec41ba55c00300382672d9,HDFC,direct expenses,5eecc6d6449e4f7cfb1c2708,2023-04-01T00:00:00.000Z,"NEFT DR-ICIC0003431-WAVICLE TECHNOLOGIES PVT LTD-NETBANK, MUM-N091232397109222-1 7738",,Transfer to N091232397109222,net_banking_transfer,-17738
645df611f8804aea72c2e04c,50200023535069,6603621.14,60ec41ba55c00300382672d9,HDFC,direct expenses,5eecc6d6449e4f7cfb1c2708,2023-04-01T00:00:00.000Z,"NEFT DR-ICIC0003431-WAVICLE TECHNOLOGIES PVT LTD-NETBANK, MUM-N091232397109300-2 6167",,Transfer to N091232397109300,net_banking_transfer,-26167
645df611f8804aea72c2e04e,50200023535069,6582753.14,60ec41ba55c00300382672d9,HDFC,direct expenses,5eecc6d6449e4f7cfb1c2708,2023-04-01T00:00:00.000Z,"NEFT DR-ICIC0003431-WAVICLE TECHNOLOGIES PVT LTD-NETBANK, MUM-N091232397109455-2 0868",,Transfer to N091232397109455,net_banking_transfer,-20868
645df611f8804aea72c2e050,50200023535069,6557019.14,60ec41ba55c00300382672d9,HDFC,direct expenses,5eecc6d6449e4f7cfb1c2708,2023-04-01T00:00:00.000Z,"NEFT DR-ICIC0003431-WAVICLE TECHNOLOGIES PVT LTD-NETBANK, MUM-N091232397122650-2 5734",,Transfer to N091232397122650,net_banking_transfer,-25734
645df611f8804aea72c2e052,50200023535069,6357019.14,60ec41ba55c00300382672d9,HDFC,direct expenses,5eecc6d6449e4f7cfb1c2708,2023-04-01T00:00:00.000Z,"NEFT DR-YESB0000551-VISTTA COSMETICS-NET BANK, MUM-N091232397113424-200000",,Transfer to N091232397113424,net_banking_transfer,-200000
645df611f8804aea72c2e054,50200023535069,5762236.14,60ec41ba55c00300382672d9,HDFC,direct expenses,5eecc6d6449e4f7cfb1c2708,2023-04-01T00:00:00.000Z,"NEFT DR-SRCB0000281-3D TECHNOPACK PRIVAT E LIMITED-NETBANK, MUM-N091232397110038- 594783",,Transfer to N091232397110038,net_banking_transfer,-594783
645df611f8804aea72c2e056,50200023535069,4485236.14,60ec41ba55c00300382672d9,HDFC,Marketing Expense,5eecc6d6449e4f7cfb1c2708,2023-04-01T00:00:00.000Z,"NEFT DR-CITI0000006-FACEBOOK INDIA ONLIN E SERVICES PVT LTD-NETBANK, MUM-N0912323 97123177-1277000",,Transfer to N0912323 97123177,net_banking_transfer,-1277000
645df611f8804aea72c2e058,50200023535069,3980065.14,60ec41ba55c00300382672d9,HDFC,direct expenses,5eecc6d6449e4f7cfb1c2708,2023-04-01T00:00:00.000Z,"NEFT DR-ICIC0000024-TAKE MOTO YOHKI INDI A PRIVATE LIMITED-NETBANK, MUM-N09123239 7125649-505171",travel,Transfer to N09123239 7125649,net_banking_transfer,-505171
645df611f8804aea72c2e05a,50200023535069,3540065.14,60ec41ba55c00300382672d9,HDFC,direct expenses,5eecc6d6449e4f7cfb1c2708,2023-04-01T00:00:00.000Z,05892560000649-TPT-440000-DECORPAC INDIA PRIVATE LIMITED,,Transfer to DECORPAC INDIA PRIVATE LIMITED,net_banking_transfer,-440000
645df611f8804aea72c2e05c,50200023535069,3240065.14,60ec41ba55c00300382672d9,HDFC,direct expenses,5eecc6d6449e4f7cfb1c2708,2023-04-01T00:00:00.000Z,NEFT DR-IDFB0040101-ACTIVES ADDITIVES AP,,,net_banking_transfer,-300000
645df611f8804aea72c2e05e,50200023535069,3130887.14,60ec41ba55c00300382672d9,HDFC,direct expenses,5eecc6d6449e4f7cfb1c2708,2023-04-01T00:00:00.000Z,00921000075586-TPT-109178-ROET BINDRA,,Transfer to ROET BINDRA,net_banking_transfer,-109178
645df611f8804aea72c2e060,50200023535069,3013269.14,60ec41ba55c00300382672d9,HDFC,direct expenses,5eecc6d6449e4f7cfb1c2708,2023-04-01T00:00:00.000Z,"NEFT DR-UTIB0000119-SAFEXPRESS-NETBANK, MUM-N091232397124429-117618",,Transfer to N091232397124429,net_banking_transfer,-117618
645df611f8804aea72c2e062,50200023535069,2866269.14,60ec41ba55c00300382672d9,HDFC,direct expenses,5eecc6d6449e4f7cfb1c2708,2023-04-01T00:00:00.000Z,"NEFT DR-UBIN0820296-HITESH ARORA-NETBANK , MUM-N091232397131424-147000",,Transfer to N091232397131424,net_banking_transfer,-147000
645df611f8804aea72c2e064,50200023535069,2821421.14,60ec41ba55c00300382672d9,HDFC,direct expenses,5eecc6d6449e4f7cfb1c2708,2023-04-01T00:00:00.000Z,"NEFT DR-PUNB0062910-YADAVPACKAGING-NETBA NK, MUM-N091232397135483-44848",,Transfer to N091232397135483,net_banking_transfer,-44848
645df611f8804aea72c2e066,50200023535069,2775637.14,60ec41ba55c00300382672d9,HDFC,direct expenses,5eecc6d6449e4f7cfb1c2708,2023-04-01T00:00:00.000Z,"NEFT DR-PUNB0062910-YADAVPACKAGING-NETBA NK, MUM-N091232397135810-45784",,Transfer to N091232397135810,net_banking_transfer,-45784
645df611f8804aea72c2e068,50200023535069,2727037.14,60ec41ba55c00300382672d9,HDFC,direct expenses,5eecc6d6449e4f7cfb1c2708,2023-04-01T00:00:00.000Z,00918630000430-TPT-48600-UNICOMMERCE ESO LUTIONS PRIVATE LIMITED,,Transfer to UNICOMMERCE ESO LUTIONS PRIVATE LIMITED,net_banking_transfer,-48600
645df611f8804aea72c2e06a,50200023535069,2715756.14,60ec41ba55c00300382672d9,HDFC,Utilities/bills,5eecc6d6449e4f7cfb1c2708,2023-04-01T00:00:00.000Z,IB BILLPAY DR-HDFCEB-361011XXXX4399,bills,,Other,-11281
645df611f8804aea72c2e06d,50200023535069,2515756.14,60ec41ba55c00300382672d9,HDFC,direct expenses,5eecc6d6449e4f7cfb1c2708,2023-04-01T00:00:00.000Z,"NEFT DR-ICIC0000369-BO INTERNATIONAL-NET BANK, MUM-N091232397330650-200000",,Transfer to N091232397330650,net_banking_transfer,-200000
645df611f8804aea72c2e06f,50200023535069,2272952.46,60ec41ba55c00300382672d9,HDFC,direct expenses,5eecc6d6449e4f7cfb1c2708,2023-04-01T00:00:00.000Z,NEFT DR-YESB0CMSNOC-CC MUKESH GOYAL 7736 -SANDOZ - MUM-N091232397575253-NET BANKI NG SI -242803,,Transfer to NET BANKI NG SI ,net_banking_transfer,-242803.68
645df611f8804aea72c2e071,50200023535069,2275870.74,60ec41ba55c00300382672d9,HDFC,Transfer in/Revenue-other,5eecc6d6449e4f7cfb1c2708,2023-04-02T00:00:00.000Z,IMPS-309212681146-EXCRO PAY ESCROW ACC-Y ESB-XXXXXXXXXXX1807-333112298023,,Transfer from EXCRO PAY ESCROW ACC,net_banking_transfer,2918.28
645df611f8804aea72c2e073,50200023535069,2278955.74,60ec41ba55c00300382672d9,HDFC,Transfer in/Revenue-other,5eecc6d6449e4f7cfb1c2708,2023-04-03T00:00:00.000Z,IMPS-309303654570-EXCRO PAY ESCROW ACC-Y ESB-XXXXXXXXXXX1807-333112298023,,Transfer from EXCRO PAY ESCROW ACC,net_banking_transfer,3085
645df611f8804aea72c2e075,50200023535069,2283543.65,60ec41ba55c00300382672d9,HDFC,Transfer in/Revenue-other,5eecc6d6449e4f7cfb1c2708,2023-04-03T00:00:00.000Z,IMPS-309307747395-EXCRO PAY ESCROW ACC-Y ESB-XXXXXXXXXXX1807-333112298023,,Transfer from EXCRO PAY ESCROW ACC,net_banking_transfer,4587.91
645df611f8804aea72c2e077,50200023535069,2331994.25,60ec41ba55c00300382672d9,HDFC,Revenue-PG-split enabled,5eecc6d6449e4f7cfb1c2708,2023-04-03T00:00:00.000Z,NEFT CR-UTIB0001506-RAZORPAY SOFTWARE PR IVATE LIMITED --SLICK ORGANICS PVT LITD- AXISCN0231225065,,Transfer from RAZORPAY SOFTWARE PR IVATE LIMITED ,net_banking_transfer,48450.6
645df611f8804aea72c2e079,50200023535069,2333985.39,60ec41ba55c00300382672d9,HDFC,Revenue-Mktplace,5eecc6d6449e4f7cfb1c2708,2023-04-03T00:00:00.000Z,NEFT CR-DEUT0797BGL-MYNTRA DESIGNS PRIVA TE LIMITED-SLICK ORGANICS PVT. LTD.-3093 00990GN00237,shopping,Transfer from MYNTRA DESIGNS PRIVA TE LIMITED,net_banking_transfer,1991.14
645df611f8804aea72c2e07b,50200023535069,2337941.4,60ec41ba55c00300382672d9,HDFC,Revenue-Mktplace,5eecc6d6449e4f7cfb1c2708,2023-04-03T00:00:00.000Z,NEFT CR-DEUT0797BGL-MYNTRA DESIGNS PRIVA,shopping,Transfer from MYNTRA DESIGNS PRIVA,net_banking_transfer,3956.01
645df611f8804aea72c2e07d,50200023535069,2370216.05,60ec41ba55c00300382672d9,HDFC,Transfer in/Revenue-other,5eecc6d6449e4f7cfb1c2708,2023-04-03T00:00:00.000Z,NEFT CR-UTIB0000020-EMIZA SUPPLY CHAIN S ERVICES PRIVATE-SLICK ORGANICS PRIVATE L IMITED-AXISP00377943476,,Transfer from EMIZA SUPPLY CHAIN S ERVICES PRIVATE,net_banking_transfer,32274.65
645df611f8804aea72c2e07f,50200023535069,2369256.05,60ec41ba55c00300382672d9,HDFC,direct expenses,5eecc6d6449e4f7cfb1c2708,2023-04-03T00:00:00.000Z,POS 514834XXXXXX0472 PAYTM PAYMENTS S,ewallet,Transfer to PAYTM PAYMENTS S,debit_card,-960
645df611f8804aea72c2e081,50200023535069,2367854.05,60ec41ba55c00300382672d9,HDFC,direct expenses,5eecc6d6449e4f7cfb1c2708,2023-04-03T00:00:00.000Z,POS 514834XXXXXX0472 PAYTM PAYMENTS S,ewallet,Transfer to PAYTM PAYMENTS S,debit_card,-1402
645df611f8804aea72c2e083,50200023535069,2352591.05,60ec41ba55c00300382672d9,HDFC,direct expenses,5eecc6d6449e4f7cfb1c2708,2023-04-03T00:00:00.000Z,"NEFT DR-CNRB0019016-MANEESH-NETBANK, MUM -N093232399232886-15263",,Transfer to N093232399232886,net_banking_transfer,-15263
645df611f8804aea72c2e085,50200023535069,2352419.05,60ec41ba55c00300382672d9,HDFC,direct expenses,5eecc6d6449e4f7cfb1c2708,2023-04-03T00:00:00.000Z,POS 514834XXXXXX0472 PAYTM_PAYTMADDMO,ewallet,Transfer to PAYTM_PAYTMADDMO,debit_card,-172
645df611f8804aea72c2e087,50200023535069,2373653.05,60ec41ba55c00300382672d9,HDFC,Revenue-Mktplace,5eecc6d6449e4f7cfb1c2708,2023-04-03T00:00:00.000Z,IMPS-309314737309-DREAMPLUGPAYTECHSO-UTI B-XXXXXXXXXXX7853-NA,,Transfer from DREAMPLUGPAYTECHSO,net_banking_transfer,21234
645df611f8804aea72c2e089,50200023535069,2354749.05,60ec41ba55c00300382672d9,HDFC,agency/vendor expense,5eecc6d6449e4f7cfb1c2708,2023-04-03T00:00:00.000Z,"NEFT DR-UTIB0003557-INCOSEC LEGAL-NETBAN K, MUM-N093232399294431-18904",,Transfer to N093232399294431,net_banking_transfer,-18904
645df611f8804aea72c2e08b,50200023535069,2578960.89,60ec41ba55c00300382672d9,HDFC,Transfer in/Revenue-other,5eecc6d6449e4f7cfb1c2708,2023-04-03T00:00:00.000Z,NEFT CR-YESB0000001-EASEBUZZ PVT LTD NOD AL A/C-SLICK ORGANICS PVT LTD-YESB309397 64897,,Transfer from EASEBUZZ PVT LTD NOD AL A/C,net_banking_transfer,224211.84
645df611f8804aea72c2e08e,50200023535069,2581415.81,60ec41ba55c00300382672d9,HDFC,Transfer in/Revenue-other,5eecc6d6449e4f7cfb1c2708,2023-04-03T00:00:00.000Z,NEFT CR-YESB0000001-EASEBUZZ PVT LTD NOD AL A/C-SLICK ORGANICS PVT LTD-YESB309397 64766,,Transfer from EASEBUZZ PVT LTD NOD AL A/C,net_banking_transfer,2454.92
645df611f8804aea72c2e090,50200023535069,2586425.86,60ec41ba55c00300382672d9,HDFC,Transfer in/Revenue-other,5eecc6d6449e4f7cfb1c2708,2023-04-03T00:00:00.000Z,NEFT CR-UTIB0000114-ONE SIGMA TECHNOLOGI ES PRIVATE LIMI-SLICK ORGANICS PRIVATE L IMITED-AXISP00378028204,bnpl,Transfer from ONE SIGMA TECHNOLOGI ES PRIVATE LIMI,net_banking_transfer,5010.05
645df611f8804aea72c2e092,50200023535069,2591028.94,60ec41ba55c00300382672d9,HDFC,Transfer in/Revenue-other,5eecc6d6449e4f7cfb1c2708,2023-04-03T00:00:00.000Z,NEFT CR-UTIB0000114-ONE SIGMA TECHNOLOGI ES PRIVATE LIMI-SLICK ORGANICS PRIVATE L IMITED-AXISP00378028587,bnpl,Transfer from ONE SIGMA TECHNOLOGI ES PRIVATE LIMI,net_banking_transfer,4603.08
645df611f8804aea72c2e094,50200023535069,2592635.82,60ec41ba55c00300382672d9,HDFC,Transfer in/Revenue-other,5eecc6d6449e4f7cfb1c2708,2023-04-03T00:00:00.000Z,NEFT CR-UTIB0000114-ONE SIGMA TECHNOLOGI ES PRIVATE LIMI-SLICK ORGANICS PRIVATE L IMITED-AXISP00378028778,bnpl,Transfer from ONE SIGMA TECHNOLOGI ES PRIVATE LIMI,net_banking_transfer,1606.88
645df611f8804aea72c2e096,50200023535069,2600645.82,60ec41ba55c00300382672d9,HDFC,Transfer in/Revenue-other,5eecc6d6449e4f7cfb1c2708,2023-04-03T00:00:00.000Z,NEFT CR-ICIC0000227-SHRIRAM INST FOR IND L RES AUO SSAIR-SLICK ORGANICS PVT LTD-0 00134098495,,Transfer from SHRIRAM INST FOR IND L RES AUO SSAIR,net_banking_transfer,8010
645df611f8804aea72c2e098,50200023535069,2598995.47,60ec41ba55c00300382672d9,HDFC,direct expenses,5eecc6d6449e4f7cfb1c2708,2023-04-03T00:00:00.000Z,POS 514834XXXXXX0472 RAZ*KNOWLARITY,,Transfer to RAZ*KNOWLARITY,debit_card,-1650.35
645df611f8804aea72c2e09a,50200023535069,2604553.32,60ec41ba55c00300382672d9,HDFC,Transfer in/Revenue-other,5eecc6d6449e4f7cfb1c2708,2023-04-03T00:00:00.000Z,EASEBUZZ PRIVA-A394030423PSKQXC7I0H,,,Other,5557.85
645df611f8804aea72c2e09f,50200023535069,2617476.32,60ec41ba55c00300382672d9,HDFC,Revenue-PG-split enabled,5eecc6d6449e4f7cfb1c2708,2023-04-03T00:00:00.000Z,NEFT CR-UTIB0001506-RAZORPAY SOFTWARE PR IVATE LIMITED --SLICK ORGANICS PVT LITD- AXISCN0231510189,,Transfer from RAZORPAY SOFTWARE PR IVATE LIMITED ,net_banking_transfer,12923
645df612f8804aea72c2e0a2,50200023535069,2538231.32,60ec41ba55c00300382672d9,HDFC,direct expenses,5eecc6d6449e4f7cfb1c2708,2023-04-03T00:00:00.000Z,"NEFT DR-ICIC0000369-BO INTERNATIONAL-NET BANK, MUM-N093232400237535-FROM SLICK OR GANIC",,Transfer to N093232400237535,net_banking_transfer,-79245
645df612f8804aea72c2e0a4,50200023535069,2368510.32,60ec41ba55c00300382672d9,HDFC,direct expenses,5eecc6d6449e4f7cfb1c2708,2023-04-03T00:00:00.000Z,"NEFT DR-ICIC0000369-BO INTERNATIONAL-NET BANK, MUM-N093232400240536-SLICK ORGANIC S PVT",,Transfer to N093232400240536,net_banking_transfer,-169721
645df612f8804aea72c2e0a6,50200023535069,2017252.32,60ec41ba55c00300382672d9,HDFC,direct expenses,5eecc6d6449e4f7cfb1c2708,2023-04-03T00:00:00.000Z,"NEFT DR-ICIC0000369-BO INTERNATIONAL-NET BANK, MUM-N093232400235340-SLICK ORGANIC S PVT",,Transfer to N093232400235340,net_banking_transfer,-351258
645df612f8804aea72c2e0a8,50200023535069,2019032.5,60ec41ba55c00300382672d9,HDFC,Transfer in/Revenue-other,5eecc6d6449e4f7cfb1c2708,2023-04-03T00:00:00.000Z,NEFT CR-YESB0000001-EASEBUZZ PVT LTD NOD AL A/C-SLICK ORGANICS PVT LTD-YESB309300 74477,,Transfer from EASEBUZZ PVT LTD NOD AL A/C,net_banking_transfer,1780.18
645df612f8804aea72c2e0aa,50200023535069,2121586.66,60ec41ba55c00300382672d9,HDFC,Transfer in/Revenue-other,5eecc6d6449e4f7cfb1c2708,2023-04-03T00:00:00.000Z,NEFT CR-YESB0000001-EASEBUZZ PVT LTD NOD AL A/C-SLICK ORGANICS PVT LTD-YESB309300 78136,,Transfer from EASEBUZZ PVT LTD NOD AL A/C,net_banking_transfer,102554.16
645df612f8804aea72c2e0ac,50200023535069,2124045.22,60ec41ba55c00300382672d9,HDFC,Transfer in/Revenue-other,5eecc6d6449e4f7cfb1c2708,2023-04-04T00:00:00.000Z,IMPS-309405643006-EXCRO PAY ESCROW ACC-Y ESB-XXXXXXXXXXX1807-333112298023,,Transfer from EXCRO PAY ESCROW ACC,net_banking_transfer,2458.56
645df612f8804aea72c2e0ae,50200023535069,1995299.22,60ec41ba55c00300382672d9,HDFC,direct expenses,5eecc6d6449e4f7cfb1c2708,2023-04-04T00:00:00.000Z,"NEFT DR-YESB0CMSNOC-A6466419 001 ARATA R OUND 01 SLICK ORGANI-NETBANK, MUM-N09423 2400703240-SLICK ORGANICS",,Transfer to N09423 2400703240,net_banking_transfer,-128746
645df612f8804aea72c2e0b0,50200023535069,1989399.22,60ec41ba55c00300382672d9,HDFC,direct expenses,5eecc6d6449e4f7cfb1c2708,2023-04-04T00:00:00.000Z,02711930004579-TPT-SLICK ORGANICS-DHRUV BHASIN,,Transfer to DHRUV BHASIN,net_banking_transfer,-5900
645df612f8804aea72c2e0b2,50200023535069,1984077.33,60ec41ba55c00300382672d9,HDFC,Marketing Expense,5eecc6d6449e4f7cfb1c2708,2023-04-04T00:00:00.000Z,ME DC SI 514834XXXXXX0472 GOOGLEWORKSP,,,Other,-5321.89
645df612f8804aea72c2e0b5,50200023535069,1969352.47,60ec41ba55c00300382672d9,HDFC,Marketing Expense,5eecc6d6449e4f7cfb1c2708,2023-04-04T00:00:00.000Z,POS 514834XXXXXX0472 GOOGLEWORKSP,,Transfer to GOOGLEWORKSP,debit_card,-14724.86
645df612f8804aea72c2e0b8,50200023535069,1941472.47,60ec41ba55c00300382672d9,HDFC,direct expenses,5eecc6d6449e4f7cfb1c2708,2023-04-04T00:00:00.000Z,"NEFT DR-KKBK0004581-MJ GLOBAL PVT LTD-NE TBANK, MUM-N094232401000677-SLICK ORGANI",,Transfer to N094232401000677,net_banking_transfer,-27880
645df612f8804aea72c2e0bb,50200023535069,1803872.47,60ec41ba55c00300382672d9,HDFC,direct expenses,5eecc6d6449e4f7cfb1c2708,2023-04-04T00:00:00.000Z,50100155115510-TPT-SLICK ORGANICS PVT-MU KESH GOYAL,,Transfer to MU KESH GOYAL,net_banking_transfer,-137600
645df612f8804aea72c2e0bd,50200023535069,1777110.47,60ec41ba55c00300382672d9,HDFC,direct expenses,5eecc6d6449e4f7cfb1c2708,2023-04-04T00:00:00.000Z,"NEFT DR-UTIB0000032-SKUMAR MULTIPRODUCTS PVT LTD-NETBANK, MUM-N094232401004222-S LICK ORGANICS PVT",,Transfer to N094232401004222,net_banking_transfer,-26762
645df612f8804aea72c2e0bf,50200023535069,1700010.47,60ec41ba55c00300382672d9,HDFC,direct expenses,5eecc6d6449e4f7cfb1c2708,2023-04-04T00:00:00.000Z,"NEFT DR-SRCB0000281-3D TECHNOPACK PRIVAT E LIMITED-NETBANK, MUM-N094232401012444- SLICK ORGANICS PVT",,Transfer to N094232401012444,net_banking_transfer,-77100
645df612f8804aea72c2e0c1,50200023535069,1702434.35,60ec41ba55c00300382672d9,HDFC,Transfer in/Revenue-other,5eecc6d6449e4f7cfb1c2708,2023-04-04T00:00:00.000Z,NEFT CR-UTIB0000114-ONE SIGMA TECHNOLOGI ES PRIVATE LIMI-SLICK ORGANICS PRIVATE L IMITED-AXISP00378393054,bnpl,Transfer from ONE SIGMA TECHNOLOGI ES PRIVATE LIMI,net_banking_transfer,2423.88
645df612f8804aea72c2e0c3,50200023535069,1700501.35,60ec41ba55c00300382672d9,HDFC,direct expenses,5eecc6d6449e4f7cfb1c2708,2023-04-04T00:00:00.000Z,POS 514834XXXXXX0472 FLIPKART INTER B,shopping,Transfer to FLIPKART INTER B,debit_card,-1933
645df612f8804aea72c2e0c6,50200023535069,1677958.35,60ec41ba55c00300382672d9,HDFC,direct expenses,5eecc6d6449e4f7cfb1c2708,2023-04-04T00:00:00.000Z,"NEFT DR-SRCB0000281-3D TECHNOPACK PRIVAT E LIMITED-NETBANK, MUM-N094232401154742- SLICK ORGANICS PVT",,Transfer to N094232401154742,net_banking_transfer,-22543
645df612f8804aea72c2e0c8,50200023535069,1607099.35,60ec41ba55c00300382672d9,HDFC,direct expenses,5eecc6d6449e4f7cfb1c2708,2023-04-04T00:00:00.000Z,"NEFT DR-ICIC0000024-TAKE MOTO YOHKI INDI A PRIVATE LIMITED-NETBANK, MUM-N09423240 1171657-SLICK ORGANICS PVT",travel,Transfer to N09423240 1171657,net_banking_transfer,-70859
645df612f8804aea72c2e0ca,50200023535069,1606558.35,60ec41ba55c00300382672d9,HDFC,direct expenses,5eecc6d6449e4f7cfb1c2708,2023-04-04T00:00:00.000Z,POS 514834XXXXXX0472 PAY*BLINKIT,,Transfer to PAY*BLINKIT,debit_card,-541
645df612f8804aea72c2e0cc,50200023535069,1607631.79,60ec41ba55c00300382672d9,HDFC,Transfer in/Revenue-other,5eecc6d6449e4f7cfb1c2708,2023-04-05T00:00:00.000Z,IMPS-309504628787-EXCRO PAY ESCROW ACC-Y ESB-XXXXXXXXXXX1807-333112298023,,Transfer from EXCRO PAY ESCROW ACC,net_banking_transfer,1073.44
645df612f8804aea72c2e0ce,50200023535069,1610751.31,60ec41ba55c00300382672d9,HDFC,Transfer in/Revenue-other,5eecc6d6449e4f7cfb1c2708,2023-04-05T00:00:00.000Z,IMPS-309507714387-EXCRO PAY ESCROW ACC-Y ESB-XXXXXXXXXXX1807-333112298023,,Transfer from EXCRO PAY ESCROW ACC,net_banking_transfer,3119.52
645df612f8804aea72c2e0d0,50200023535069,1611728.06,60ec41ba55c00300382672d9,HDFC,Revenue-Mktplace,5eecc6d6449e4f7cfb1c2708,2023-04-05T00:00:00.000Z,NEFT CR-DEUT0797BGL-MYNTRA DESIGNS PRIVA TE LIMITED-SLICK ORGANICS - SJIT-3095010 46GN00136,shopping,Transfer from MYNTRA DESIGNS PRIVA TE LIMITED,net_banking_transfer,976.75
645df612f8804aea72c2e0d3,50200023535069,1611920.06,60ec41ba55c00300382672d9,HDFC,Revenue-Mktplace,5eecc6d6449e4f7cfb1c2708,2023-04-05T00:00:00.000Z,NEFT CR-DEUT0797BGL-MYNTRA DESIGNS PRIVA TE LIMITED-SLICK ORGANICS PVT. LTD.-3095 01065GN00115,shopping,Transfer from MYNTRA DESIGNS PRIVA TE LIMITED,net_banking_transfer,192
645df612f8804aea72c2e0d5,50200023535069,1630054.06,60ec41ba55c00300382672d9,HDFC,Revenue-PG-split enabled,5eecc6d6449e4f7cfb1c2708,2023-04-05T00:00:00.000Z,NEFT CR-UTIB0001506-RAZORPAY SOFTWARE PR IVATE LIMITED --SLICK ORGANICS PVT LITD-,,Transfer from RAZORPAY SOFTWARE PR IVATE LIMITED ,net_banking_transfer,18134
645df612f8804aea72c2e0d7,50200023535069,1629797.06,60ec41ba55c00300382672d9,HDFC,direct expenses,5eecc6d6449e4f7cfb1c2708,2023-04-05T00:00:00.000Z,POS 514834XXXXXX0472 PAY*ZEPTO,,Transfer to PAY*ZEPTO,debit_card,-257
645df612f8804aea72c2e0da,50200023535069,1618697.06,60ec41ba55c00300382672d9,HDFC,direct expenses,5eecc6d6449e4f7cfb1c2708,2023-04-05T00:00:00.000Z,"NEFT DR-KARB0000113-ASHWINI N DIXIT-NETB ANK, MUM-N095232401998153-11100",,Transfer to N095232401998153,net_banking_transfer,-11100
645df612f8804aea72c2e0de,50200023535069,1616694.6,60ec41ba55c00300382672d9,HDFC,direct expenses,5eecc6d6449e4f7cfb1c2708,2023-04-05T00:00:00.000Z,POS 514834XXXXXX0472 PAYTM PAYMENTS S,ewallet,Transfer to PAYTM PAYMENTS S,debit_card,-2002.46
645df612f8804aea72c2e0e0,50200023535069,1550805.03,60ec41ba55c00300382672d9,HDFC,direct expenses,5eecc6d6449e4f7cfb1c2708,2023-04-05T00:00:00.000Z,"NEFT DR-IDFB0040101-GETVANTAGE PROFECTUS COLLECTION ESCROW A-NETBANK, MUM-N09523 2402372510-SLICK ORGANICS PVT",loans,lender_transaction,net_banking_transfer,-65889.57
645df612f8804aea72c2e0e2,50200023535069,1268794.32,60ec41ba55c00300382672d9,HDFC,direct expenses,5eecc6d6449e4f7cfb1c2708,2023-04-05T00:00:00.000Z,"NEFT DR-IDFB0040101-GETVANTAGE PROFECTUS COLLECTION ESCROW A-NETBANK, MUM-N09523 2402379522-SLICK ORGANICD PVT",loans,lender_transaction,net_banking_transfer,-282010.71
645df612f8804aea72c2e0e4,50200023535069,1282420.82,60ec41ba55c00300382672d9,HDFC,Revenue-Mktplace,5eecc6d6449e4f7cfb1c2708,2023-04-05T00:00:00.000Z,IMPS-309514680225-DREAMPLUGPAYTECHSO-UTI B-XXXXXXXXXXX7853-NA,,Transfer from DREAMPLUGPAYTECHSO,net_banking_transfer,13626.5
645df612f8804aea72c2e0e6,50200023535069,1314944.82,60ec41ba55c00300382672d9,HDFC,Revenue-Mktplace,5eecc6d6449e4f7cfb1c2708,2023-04-05T00:00:00.000Z,NEFT CR-SCBL0036001-DREAMPLUG TECHNOLOGI ES PRIVATE LIMITED-SLICK ORGANICS PRIVAT E LIMITEDSLICK-IN1ON23040506AS8,,Transfer from DREAMPLUG TECHNOLOGI ES PRIVATE LIMITED,net_banking_transfer,32524
645df612f8804aea72c2e0ea,50200023535069,1317213.6,60ec41ba55c00300382672d9,HDFC,Transfer in/Revenue-other,5eecc6d6449e4f7cfb1c2708,2023-04-05T00:00:00.000Z,NEFT CR-UTIB0000114-ONE SIGMA TECHNOLOGI ES PRIVATE LIMI-SLICK ORGANICS PRIVATE L IMITED-AXISP00378637329,bnpl,Transfer from ONE SIGMA TECHNOLOGI ES PRIVATE LIMI,net_banking_transfer,2268.78
645df612f8804aea72c2e0ec,50200023535069,1323762.13,60ec41ba55c00300382672d9,HDFC,Transfer in/Revenue-other,5eecc6d6449e4f7cfb1c2708,2023-04-05T00:00:00.000Z,EASEBUZZ PRIVA-A361050423PSWNJNHMAL,,,Other,6548.53
645df612f8804aea72c2e0ee,50200023535069,1335543.13,60ec41ba55c00300382672d9,HDFC,Revenue-PG-split enabled,5eecc6d6449e4f7cfb1c2708,2023-04-05T00:00:00.000Z,NEFT CR-UTIB0001506-RAZORPAY SOFTWARE PR IVATE LIMITED --SLICK ORGANICS PVT LITD- AXISCN0232334949,,Transfer from RAZORPAY SOFTWARE PR IVATE LIMITED ,net_banking_transfer,11781
645df612f8804aea72c2e0f0,50200023535069,1416718.36,60ec41ba55c00300382672d9,HDFC,Transfer in/Revenue-other,5eecc6d6449e4f7cfb1c2708,2023-04-05T00:00:00.000Z,NEFT CR-YESB0000001-EASEBUZZ PVT LTD NOD AL A/C-SLICK ORGANICS PVT LTD-YESB309559 11597,,Transfer from EASEBUZZ PVT LTD NOD AL A/C,net_banking_transfer,81175.23
645df612f8804aea72c2e0f2,50200023535069,1428871.23,60ec41ba55c00300382672d9,HDFC,Transfer in/Revenue-other,5eecc6d6449e4f7cfb1c2708,2023-04-05T00:00:00.000Z,NEFT CR-YESB0000001-EASEBUZZ PVT LTD NOD AL A/C-SLICK ORGANICS PVT LTD-YESB309559 10356,,Transfer from EASEBUZZ PVT LTD NOD AL A/C,net_banking_transfer,12152.87
645df612f8804aea72c2e0f4,50200023535069,1428901.23,60ec41ba55c00300382672d9,HDFC,Transfer in/Revenue-other,5eecc6d6449e4f7cfb1c2708,2023-04-05T00:00:00.000Z,POS REF 514834******0472-04/05 GROFERSC4,groceries,,refund,30
645df612f8804aea72c2e0f7,50200023535069,1481304.01,60ec41ba55c00300382672d9,HDFC,Transfer in/Revenue-other,5eecc6d6449e4f7cfb1c2708,2023-04-05T00:00:00.000Z,NEFT CR-YESB0000001-EASEBUZZ PVT LTD NOD AL A/C-SLICK ORGANICS PVT LTD-YESB309560,,Transfer from EASEBUZZ PVT LTD NOD AL A/C,net_banking_transfer,52402.78
645df612f8804aea72c2e0f9,50200023535069,1487897.77,60ec41ba55c00300382672d9,HDFC,Transfer in/Revenue-other,5eecc6d6449e4f7cfb1c2708,2023-04-05T00:00:00.000Z,NEFT CR-YESB0000001-EASEBUZZ PVT LTD NOD AL A/C-SLICK ORGANICS PVT LTD-YESB309560 27330,,Transfer from EASEBUZZ PVT LTD NOD AL A/C,net_banking_transfer,6593.76
645df612f8804aea72c2e0fb,50200023535069,1489514.87,60ec41ba55c00300382672d9,HDFC,Transfer in/Revenue-other,5eecc6d6449e4f7cfb1c2708,2023-04-06T00:00:00.000Z,IMPS-309604736073-EXCRO PAY ESCROW ACC-Y ESB-XXXXXXXXXXX1807-333112298023,,Transfer from EXCRO PAY ESCROW ACC,net_banking_transfer,1617.1
645df612f8804aea72c2e0fd,50200023535069,1493089.78,60ec41ba55c00300382672d9,HDFC,Revenue-Mktplace,5eecc6d6449e4f7cfb1c2708,2023-04-06T00:00:00.000Z,NEFT CR-DEUT0797BGL-MYNTRA DESIGNS PRIVA TE LIMITED-SLICK ORGANICS - SJIT-3096006 22GN00057,shopping,Transfer from MYNTRA DESIGNS PRIVA TE LIMITED,net_banking_transfer,3574.91
645df612f8804aea72c2e0ff,50200023535069,1497282.24,60ec41ba55c00300382672d9,HDFC,Revenue-Mktplace,5eecc6d6449e4f7cfb1c2708,2023-04-06T00:00:00.000Z,NEFT CR-DEUT0797BGL-MYNTRA DESIGNS PRIVA TE LIMITED-SLICK ORGANICS PVT. LTD.-3096 00622GN00286,shopping,Transfer from MYNTRA DESIGNS PRIVA TE LIMITED,net_banking_transfer,4192.46
645df612f8804aea72c2e101,50200023535069,1504474.14,60ec41ba55c00300382672d9,HDFC,Revenue-PG-split enabled,5eecc6d6449e4f7cfb1c2708,2023-04-06T00:00:00.000Z,NEFT CR-UTIB0001506-RAZORPAY SOFTWARE PR IVATE LIMITED --SLICK ORGANICS PVT LITD- AXISCN0232527416,,Transfer from RAZORPAY SOFTWARE PR IVATE LIMITED ,net_banking_transfer,7191.9
645df612f8804aea72c2e103,50200023535069,1504473.14,60ec41ba55c00300382672d9,HDFC,direct expenses,5eecc6d6449e4f7cfb1c2708,2023-04-06T00:00:00.000Z,ME DC SI 514834XXXXXX0472 ADOBE SYSTEMS SOFTWARE,,,Other,-1
645df612f8804aea72c2e106,50200023535069,1502213.01,60ec41ba55c00300382672d9,HDFC,direct expenses,5eecc6d6449e4f7cfb1c2708,2023-04-06T00:00:00.000Z,POS 514834XXXXXX0472 ZOMATO LTD,food,Transfer to ZOMATO LTD,debit_card,-2260.13
645df612f8804aea72c2e108,50200023535069,1508447.91,60ec41ba55c00300382672d9,HDFC,Revenue-Mktplace,5eecc6d6449e4f7cfb1c2708,2023-04-06T00:00:00.000Z,IMPS-309614919843-DREAMPLUGPAYTECHSO-UTI B-XXXXXXXXXXX7853-NA,,Transfer from DREAMPLUGPAYTECHSO,net_banking_transfer,6234.9
645df612f8804aea72c2e10b,50200023535069,1638447.91,60ec41ba55c00300382672d9,HDFC,Internal Transfers,5eecc6d6449e4f7cfb1c2708,2023-04-06T00:00:00.000Z,IB FUNDS TRANSFER CR-50200035187206 -SL ICK ORGANICS PVT LTD,,,Other,130000
645df612f8804aea72c2e10d,50200023535069,1639630.79,60ec41ba55c00300382672d9,HDFC,Transfer in/Revenue-other,5eecc6d6449e4f7cfb1c2708,2023-04-06T00:00:00.000Z,EASEBUZZ PRIVA-A291060423PSW4S9SJ7V,,,Other,1182.88
645df612f8804aea72c2e10f,50200023535069,1649743.94,60ec41ba55c00300382672d9,HDFC,Transfer in/Revenue-other,5eecc6d6449e4f7cfb1c2708,2023-04-06T00:00:00.000Z,NEFT CR-YESB0000001-EASEBUZZ PVT LTD NOD AL A/C-SLICK ORGANICS PVT LTD-YESB309688 15332,,Transfer from EASEBUZZ PVT LTD NOD AL A/C,net_banking_transfer,10113.15
645df612f8804aea72c2e111,50200023535069,1658172.64,60ec41ba55c00300382672d9,HDFC,Revenue-PG-split enabled,5eecc6d6449e4f7cfb1c2708,2023-04-06T00:00:00.000Z,NEFT CR-UTIB0001506-RAZORPAY SOFTWARE PR IVATE LIMITED --SLICK ORGANICS PVT LITD- AXISCN0232834935,,Transfer from RAZORPAY SOFTWARE PR IVATE LIMITED ,net_banking_transfer,8428.7
645df612f8804aea72c2e113,50200023535069,1727081.88,60ec41ba55c00300382672d9,HDFC,Transfer in/Revenue-other,5eecc6d6449e4f7cfb1c2708,2023-04-06T00:00:00.000Z,NEFT CR-YESB0000001-EASEBUZZ PVT LTD NOD AL A/C-SLICK ORGANICS PVT LTD-YESB309688 17062,,Transfer from EASEBUZZ PVT LTD NOD AL A/C,net_banking_transfer,68909.24
645df612f8804aea72c2e115,50200023535069,1636030.5,60ec41ba55c00300382672d9,HDFC,OD/CC Repayment,5eecc6d6449e4f7cfb1c2708,2023-04-06T00:00:00.000Z,"NEFT DR-CITI0000003-CC MUKESH GOYAL 7982 -NETBANK, MUM-N096232406154193-CREDIT CA RD",,Transfer to N096232406154193,net_banking_transfer,-91051.38
645df612f8804aea72c2e119,50200023535069,1637482.29,60ec41ba55c00300382672d9,HDFC,Transfer in/Revenue-other,5eecc6d6449e4f7cfb1c2708,2023-04-07T00:00:00.000Z,IMPS-309704805276-EXCRO PAY ESCROW ACC-Y ESB-XXXXXXXXXXX1807-333112298023,,Transfer from EXCRO PAY ESCROW ACC,net_banking_transfer,1451.79
645df612f8804aea72c2e11b,50200023535069,1587482.29,60ec41ba55c00300382672d9,HDFC,direct expenses,5eecc6d6449e4f7cfb1c2708,2023-04-07T00:00:00.000Z,50100108772229 NET BANKING SI -50000,,,Other,-50000
645df612f8804aea72c2e11d,50200023535069,1541649.29,60ec41ba55c00300382672d9,HDFC,direct expenses,5eecc6d6449e4f7cfb1c2708,2023-04-07T00:00:00.000Z,50100482015380 NET BANKING SI -45833,,,Other,-45833
645df613f8804aea72c2e11f,50200023535069,1480049.29,60ec41ba55c00300382672d9,HDFC,direct expenses,5eecc6d6449e4f7cfb1c2708,2023-04-07T00:00:00.000Z,50100349886722 NET BANKING SI -61600,,,Other,-61600
645df613f8804aea72c2e121,50200023535069,1442033.29,60ec41ba55c00300382672d9,HDFC,direct expenses,5eecc6d6449e4f7cfb1c2708,2023-04-07T00:00:00.000Z,00901610080520 NET BANKING SI -38016,,,Other,-38016
645df613f8804aea72c2e125,50200023535069,1388966.29,60ec41ba55c00300382672d9,HDFC,direct expenses,5eecc6d6449e4f7cfb1c2708,2023-04-07T00:00:00.000Z,50100312215410 NET BANKING SI -53067,,,Other,-53067
645df613f8804aea72c2e127,50200023535069,1369116.29,60ec41ba55c00300382672d9,HDFC,direct expenses,5eecc6d6449e4f7cfb1c2708,2023-04-07T00:00:00.000Z,02711600008220 NET BANKING SI -19850,,,Other,-19850
645df613f8804aea72c2e129,50200023535069,1263292.29,60ec41ba55c00300382672d9,HDFC,direct expenses,5eecc6d6449e4f7cfb1c2708,2023-04-07T00:00:00.000Z,50100155115510 NET BANKING SI -105824,,,Other,-105824
645df613f8804aea72c2e12b,50200023535069,1201130.29,60ec41ba55c00300382672d9,HDFC,direct expenses,5eecc6d6449e4f7cfb1c2708,2023-04-07T00:00:00.000Z,50100293329616 NET BANKING SI -62162,,,Other,-62162
645df613f8804aea72c2e12d,50200023535069,1021397.29,60ec41ba55c00300382672d9,HDFC,direct expenses,5eecc6d6449e4f7cfb1c2708,2023-04-07T00:00:00.000Z,50100093802387 NET BANKING SI -179733,,,Other,-179733
645df613f8804aea72c2e12f,50200023535069,976397.29,60ec41ba55c00300382672d9,HDFC,direct expenses,5eecc6d6449e4f7cfb1c2708,2023-04-07T00:00:00.000Z,NEFT DR-ICIC0000314-ATUL VAISHNAV-SANDOZ - MUM-N097232406692761-NET BANKING SI - 45000,,Transfer to NET BANKING SI ,net_banking_transfer,-45000
645df613f8804aea72c2e131,50200023535069,944055.29,60ec41ba55c00300382672d9,HDFC,direct expenses,5eecc6d6449e4f7cfb1c2708,2023-04-07T00:00:00.000Z,NEFT DR-SIBL0000555-JAIVEER KUMAR-SANDOZ - MUM-N097232406692773-NET BANKING SI - 32342,,Transfer to NET BANKING SI ,net_banking_transfer,-32342
645df613f8804aea72c2e133,50200023535069,920055.29,60ec41ba55c00300382672d9,HDFC,direct expenses,5eecc6d6449e4f7cfb1c2708,2023-04-07T00:00:00.000Z,NEFT DR-PUNB0482100-RAM BHAVAN YADAV-SAN DOZ - MUM-N097232406692782-NET BANKING S I -24000,,Transfer to NET BANKING S I ,net_banking_transfer,-24000
645df613f8804aea72c2e135,50200023535069,893895.29,60ec41ba55c00300382672d9,HDFC,direct expenses,5eecc6d6449e4f7cfb1c2708,2023-04-07T00:00:00.000Z,NEFT DR-ICIC0002697-NITISH KUMAR-SANDOZ - MUM-N097232406692799-NET BANKING SI -2 6160,,Transfer to NET BANKING SI ,net_banking_transfer,-26160
645df613f8804aea72c2e137,50200023535069,830828.29,60ec41ba55c00300382672d9,HDFC,direct expenses,5eecc6d6449e4f7cfb1c2708,2023-04-07T00:00:00.000Z,NEFT DR-PUNB0150400-SAGARIKA DEBNATH-SA NDOZ - MUM-N097232406692835-NET BANKING SI -63067,,Transfer to NET BANKING SI ,net_banking_transfer,-63067
645df613f8804aea72c2e139,50200023535069,799761.29,60ec41ba55c00300382672d9,HDFC,direct expenses,5eecc6d6449e4f7cfb1c2708,2023-04-07T00:00:00.000Z,NEFT DR-KKBK0004266-NIDHI PANDEY-SANDOZ - MUM-N097232406692869-NET BANKING SI -3 1067,,Transfer to NET BANKING SI ,net_banking_transfer,-31067
645df613f8804aea72c2e13b,50200023535069,753361.29,60ec41ba55c00300382672d9,HDFC,direct expenses,5eecc6d6449e4f7cfb1c2708,2023-04-07T00:00:00.000Z,NEFT DR-KKBK0008066-KUSHAGRA SINGH-SANDO Z - MUM-N097232406692905-NET BANKING SI -46400,,Transfer to NET BANKING SI ,net_banking_transfer,-46400
645df613f8804aea72c2e13d,50200023535069,719011.29,60ec41ba55c00300382672d9,HDFC,direct expenses,5eecc6d6449e4f7cfb1c2708,2023-04-07T00:00:00.000Z,NEFT DR-SBIN0008079-DHARAMVEER-SANDOZ - MUM-N097232406692940-NET BANKING SI -343 50,,Transfer to NET BANKING SI ,net_banking_transfer,-34350
645df613f8804aea72c2e13f,50200023535069,698957.29,60ec41ba55c00300382672d9,HDFC,direct expenses,5eecc6d6449e4f7cfb1c2708,2023-04-07T00:00:00.000Z,NEFT DR-PUNB0307800-SANJEEV NIRMANIA-SAN DOZ - MUM-N097232406692975-NET BANKING S I -20054,,Transfer to NET BANKING S I ,net_banking_transfer,-20054
645df613f8804aea72c2e141,50200023535069,681696.29,60ec41ba55c00300382672d9,HDFC,direct expenses,5eecc6d6449e4f7cfb1c2708,2023-04-07T00:00:00.000Z,NEFT DR-SBIN0017746-MANOJ KUMAR-SANDOZ - MUM-N097232406693011-NET BANKING SI -17 261,,Transfer to NET BANKING SI ,net_banking_transfer,-17261
645df613f8804aea72c2e143,50200023535069,666433.29,60ec41ba55c00300382672d9,HDFC,direct expenses,5eecc6d6449e4f7cfb1c2708,2023-04-07T00:00:00.000Z,NEFT DR-SCBL0036023-VIVEK YADAV-SANDOZ - MUM-N097232406693052-NET BANKING SI -15 263,,Transfer to NET BANKING SI ,net_banking_transfer,-15263
645df613f8804aea72c2e145,50200023535069,651170.29,60ec41ba55c00300382672d9,HDFC,direct expenses,5eecc6d6449e4f7cfb1c2708,2023-04-07T00:00:00.000Z,NEFT DR-KKBK0005619-VIKASH KUMAR-SANDOZ - MUM-N097232406693084-NET BANKING SI -1 5263,,Transfer to NET BANKING SI ,net_banking_transfer,-15263
645df613f8804aea72c2e147,50200023535069,635907.29,60ec41ba55c00300382672d9,HDFC,direct expenses,5eecc6d6449e4f7cfb1c2708,2023-04-07T00:00:00.000Z,NEFT DR-UBIN0919721-PINKU-SANDOZ - MUM-N 097232406693116-NET BANKING SI -15263,,Transfer to NET BANKING SI ,net_banking_transfer,-15263
645df613f8804aea72c2e14a,50200023535069,615065.29,60ec41ba55c00300382672d9,HDFC,direct expenses,5eecc6d6449e4f7cfb1c2708,2023-04-07T00:00:00.000Z,NEFT DR-KKBK0005032-DEEPAK YADAV-SANDOZ - MUM-N097232406693141-NET BANKING SI -2 0842,,Transfer to NET BANKING SI ,net_banking_transfer,-20842
645df613f8804aea72c2e14c,50200023535069,595215.29,60ec41ba55c00300382672d9,HDFC,direct expenses,5eecc6d6449e4f7cfb1c2708,2023-04-07T00:00:00.000Z,NEFT DR-PUNB0494300-KUNDAN PRASAD-SANDOZ - MUM-N097232406693161-NET BANKING SI - 19850,,Transfer to NET BANKING SI ,net_banking_transfer,-19850
645df613f8804aea72c2e14e,50200023535069,576358.29,60ec41ba55c00300382672d9,HDFC,direct expenses,5eecc6d6449e4f7cfb1c2708,2023-04-07T00:00:00.000Z,NEFT DR-PUNB0151400-BHUWAN CHANDER JOSHI -SANDOZ - MUM-N097232406693182-NET BANKI NG SI -18857,,Transfer to NET BANKI NG SI ,net_banking_transfer,-18857
645df613f8804aea72c2e150,50200023535069,557501.29,60ec41ba55c00300382672d9,HDFC,direct expenses,5eecc6d6449e4f7cfb1c2708,2023-04-07T00:00:00.000Z,NEFT DR-PUNB0MBGB06-MD ARIF RAZA-SANDOZ - MUM-N097232406693208-NET BANKING SI -1 8857,,Transfer to NET BANKING SI ,net_banking_transfer,-18857
645df613f8804aea72c2e152,50200023535069,363764.29,60ec41ba55c00300382672d9,HDFC,direct expenses,5eecc6d6449e4f7cfb1c2708,2023-04-07T00:00:00.000Z,NEFT DR-KKBK0000261-TANVI TANEJA-SANDOZ - MUM-N097232406693232-NET BANKING SI -1 93737,,Transfer to NET BANKING SI ,net_banking_transfer,-193737
645df613f8804aea72c2e154,50200023535069,200133.29,60ec41ba55c00300382672d9,HDFC,direct expenses,5eecc6d6449e4f7cfb1c2708,2023-04-07T00:00:00.000Z,NEFT DR-ICIC0000021-AKHILESH DIXIT-SANDO Z - MUM-N097232406693260-NET BANKING SI -163631,,Transfer to NET BANKING SI ,net_banking_transfer,-163631
645df613f8804aea72c2e156,50200023535069,178628.29,60ec41ba55c00300382672d9,HDFC,Salary/Emp/consultant Expense,5eecc6d6449e4f7cfb1c2708,2023-04-07T00:00:00.000Z,NEFT DR-KKBK0000261-SALIL SINGH AGGARWAL -SANDOZ - MUM-N097232406693290-NET BANKI NG SI -SALARY,,Transfer to NET BANKI NG SI ,net_banking_transfer,-21505
645df613f8804aea72c2e158,50200023535069,99428.29,60ec41ba55c00300382672d9,HDFC,direct expenses,5eecc6d6449e4f7cfb1c2708,2023-04-07T00:00:00.000Z,NEFT DR-SBIN0070392-APARNA MOHANAN KONAT -SANDOZ - MUM-N097232406693311-NET BANKI NG SI -79200,,Transfer to NET BANKI NG SI ,net_banking_transfer,-79200
645df613f8804aea72c2e15a,50200023535069,80350.29,60ec41ba55c00300382672d9,HDFC,N-ACH payments,5eecc6d6449e4f7cfb1c2708,2023-04-07T00:00:00.000Z,NEFT DR-DBSS0IN0811-SACHIN SINGH-SANDOZ - MUM-N097232406693335-NET BANKING SI -1 9078,,Transfer to NET BANKING SI ,net_banking_transfer,-19078
645df613f8804aea72c2e15c,50200023535069,55350.29,60ec41ba55c00300382672d9,HDFC,direct expenses,5eecc6d6449e4f7cfb1c2708,2023-04-07T00:00:00.000Z,"NEFT DR-BARB0VJGRKA-OM PRASAD PANDEY-NET BANK, MUM-N097232406866617-25000",,Transfer to N097232406866617,net_banking_transfer,-25000
645df613f8804aea72c2e15f,50200023535069,19832.29,60ec41ba55c00300382672d9,HDFC,direct expenses,5eecc6d6449e4f7cfb1c2708,2023-04-07T00:00:00.000Z,00918630000430-TPT-35518-UNICOMMERCE ESO LUTIONS PRIVATE LIMITED,,Transfer to UNICOMMERCE ESO LUTIONS PRIVATE LIMITED,net_banking_transfer,-35518
645df613f8804aea72c2e161,50200023535069,8962.29,60ec41ba55c00300382672d9,HDFC,direct expenses,5eecc6d6449e4f7cfb1c2708,2023-04-07T00:00:00.000Z,"NEFT DR-PUNB0307800-SANJEEV NIRMANIA-NET BANK, MUM-N097232406923723-10870",,Transfer to N097232406923723,net_banking_transfer,-10870
645df613f8804aea72c2e163,50200023535069,7644.29,60ec41ba55c00300382672d9,HDFC,direct expenses,5eecc6d6449e4f7cfb1c2708,2023-04-07T00:00:00.000Z,"NEFT DR-KKBK0004266-NIDHI PANDEY-NETBANK , MUM-N097232406924440-1318",,Transfer to N097232406924440,net_banking_transfer,-1318
645df613f8804aea72c2e165,50200023535069,8499.23,60ec41ba55c00300382672d9,HDFC,Transfer in/Revenue-other,5eecc6d6449e4f7cfb1c2708,2023-04-08T00:00:00.000Z,IMPS-309804638425-EXCRO PAY ESCROW ACC-Y ESB-XXXXXXXXXXX1807-333112298023,,Transfer from EXCRO PAY ESCROW ACC,net_banking_transfer,854.94
645df613f8804aea72c2e167,50200023535069,8500.23,60ec41ba55c00300382672d9,HDFC,Transfer in/Revenue-other,5eecc6d6449e4f7cfb1c2708,2023-04-08T00:00:00.000Z,CRV POS 514834******0472 ADOBE SYSTEMS S,,,refund,1
645df613f8804aea72c2e169,50200023535069,9155.71,60ec41ba55c00300382672d9,HDFC,Transfer in/Revenue-other,5eecc6d6449e4f7cfb1c2708,2023-04-10T00:00:00.000Z,IMPS-310004750376-EXCRO PAY ESCROW ACC-Y ESB-XXXXXXXXXXX1807-333112298023,,Transfer from EXCRO PAY ESCROW ACC,net_banking_transfer,655.48
645df613f8804aea72c2e16b,50200023535069,17359.05,60ec41ba55c00300382672d9,HDFC,Transfer in/Revenue-other,5eecc6d6449e4f7cfb1c2708,2023-04-10T00:00:00.000Z,IMPS-310007800899-EXCRO PAY ESCROW ACC-Y ESB-XXXXXXXXXXX1807-333112298023,,Transfer from EXCRO PAY ESCROW ACC,net_banking_transfer,8203.34
645df613f8804aea72c2e16d,50200023535069,24923.27,60ec41ba55c00300382672d9,HDFC,Revenue-Mktplace,5eecc6d6449e4f7cfb1c2708,2023-04-10T00:00:00.000Z,NEFT CR-DEUT0797BGL-MYNTRA DESIGNS PRIVA TE LIMITED-SLICK ORGANICS PVT. LTD.-3100,shopping,Transfer from MYNTRA DESIGNS PRIVA TE LIMITED,net_banking_transfer,7564.22
645df613f8804aea72c2e170,50200023535069,30155.22,60ec41ba55c00300382672d9,HDFC,Revenue-Mktplace,5eecc6d6449e4f7cfb1c2708,2023-04-10T00:00:00.000Z,NEFT CR-DEUT0797BGL-MYNTRA DESIGNS PRIVA TE LIMITED-SLICK ORGANICS - SJIT-3100008 07GN00191,shopping,Transfer from MYNTRA DESIGNS PRIVA TE LIMITED,net_banking_transfer,5231.95
645df613f8804aea72c2e172,50200023535069,25199.22,60ec41ba55c00300382672d9,HDFC,Marketing Expense,5eecc6d6449e4f7cfb1c2708,2023-04-10T00:00:00.000Z,ME DC SI 514834XXXXXX0472 FACEBOOK SI,,,Other,-4956
645df613f8804aea72c2e174,50200023535069,47920.92,60ec41ba55c00300382672d9,HDFC,Revenue-PG-split enabled,5eecc6d6449e4f7cfb1c2708,2023-04-10T00:00:00.000Z,NEFT CR-UTIB0001506-RAZORPAY SOFTWARE PR IVATE LIMITED --SLICK ORGANICS PVT LITD- AXISCN0233717155,,Transfer from RAZORPAY SOFTWARE PR IVATE LIMITED ,net_banking_transfer,22721.7
645df613f8804aea72c2e177,50200023535069,47270.92,60ec41ba55c00300382672d9,HDFC,Marketing Expense,5eecc6d6449e4f7cfb1c2708,2023-04-10T00:00:00.000Z,ME DC SI 514834XXXXXX0472 GOOGLEPLAY,entertainment,,Other,-650
645df613f8804aea72c2e179,50200023535069,1023772.92,60ec41ba55c00300382672d9,HDFC,Internal Transfers,5eecc6d6449e4f7cfb1c2708,2023-04-10T00:00:00.000Z,IB FUNDS TRANSFER CR-50200035187206 -SL ICK ORGANICS PVT LTD,,,Other,976502
645df613f8804aea72c2e17b,50200023535069,609848.66,60ec41ba55c00300382672d9,HDFC,direct expenses,5eecc6d6449e4f7cfb1c2708,2023-04-10T00:00:00.000Z,"NEFT DR-ICIC0000004-CC HEMANT GUPTA 7006 -NETBANK, MUM-N100232410778239-HEMANT CC",,Transfer to N100232410778239,net_banking_transfer,-413924.26
645df613f8804aea72c2e17d,50200023535069,584848.66,60ec41ba55c00300382672d9,HDFC,direct expenses,5eecc6d6449e4f7cfb1c2708,2023-04-10T00:00:00.000Z,LC1JRDVMEF2GLQ/RAZPIDFCFIRSTBANK,,,Other,-25000
645df613f8804aea72c2e17f,50200023535069,557848.66,60ec41ba55c00300382672d9,HDFC,direct expenses,5eecc6d6449e4f7cfb1c2708,2023-04-10T00:00:00.000Z,"NEFT DR-CNRB0015170-SNEHAL TAYDE-NETBANK , MUM-N100232410811454-SLICK ORGANICS",,Transfer to N100232410811454,net_banking_transfer,-27000
645df613f8804aea72c2e181,50200023535069,533438.66,60ec41ba55c00300382672d9,HDFC,Salary/Emp/consultant Expense,5eecc6d6449e4f7cfb1c2708,2023-04-10T00:00:00.000Z,"NEFT DR-PYTM0123456-ADNAN ALI-NETBANK, M UM-N100232410814905-SALARY",,Transfer to N100232410814905,net_banking_transfer,-24410
645df613f8804aea72c2e184,50200023535069,436238.66,60ec41ba55c00300382672d9,HDFC,Rental expense,5eecc6d6449e4f7cfb1c2708,2023-04-10T00:00:00.000Z,00321000085687-TPT-RENT 206-SAMEER AHUJA,,Transfer to SAMEER AHUJA,net_banking_transfer,-97200
645df613f8804aea72c2e187,50200023535069,451614.66,60ec41ba55c00300382672d9,HDFC,Revenue-Mktplace,5eecc6d6449e4f7cfb1c2708,2023-04-10T00:00:00.000Z,IMPS-310014608254-DREAMPLUGPAYTECHSO-UTI B-XXXXXXXXXXX7853-NA,,Transfer from DREAMPLUGPAYTECHSO,net_banking_transfer,15376
645df613f8804aea72c2e189,50200023535069,407332.66,60ec41ba55c00300382672d9,HDFC,direct expenses,5eecc6d6449e4f7cfb1c2708,2023-04-10T00:00:00.000Z,"NEFT DR-KKBK0000187-APPLIED LIFE PRIVATE LIMITED-NETBANK, MUM-N100232410851083-B Y ARATA",,Transfer to N100232410851083,net_banking_transfer,-44282
645df613f8804aea72c2e18b,50200023535069,408467.05,60ec41ba55c00300382672d9,HDFC,Transfer in/Revenue-other,5eecc6d6449e4f7cfb1c2708,2023-04-10T00:00:00.000Z,NEFT CR-UTIB0000114-ONE SIGMA TECHNOLOGI ES PRIVATE LIMI-SLICK ORGANICS PRIVATE L IMITED-AXISP00380143989,bnpl,Transfer from ONE SIGMA TECHNOLOGI ES PRIVATE LIMI,net_banking_transfer,1134.39
645df613f8804aea72c2e18e,50200023535069,416502.46,60ec41ba55c00300382672d9,HDFC,Transfer in/Revenue-other,5eecc6d6449e4f7cfb1c2708,2023-04-10T00:00:00.000Z,NEFT CR-UTIB0000114-ONE SIGMA TECHNOLOGI ES PRIVATE LIMI-SLICK ORGANICS PRIVATE L IMITED-AXISP00380144702,bnpl,Transfer from ONE SIGMA TECHNOLOGI ES PRIVATE LIMI,net_banking_transfer,8035.41
645df613f8804aea72c2e190,50200023535069,42708.08,60ec41ba55c00300382672d9,HDFC,direct expenses,5eecc6d6449e4f7cfb1c2708,2023-04-10T00:00:00.000Z,"NEFT DR-ICIC0000004-CC MUKESH GOYAL 4007 -NETBANK, MUM-N100232410882850-MUKESH CC",,Transfer to N100232410882850,net_banking_transfer,-373794.38
645df613f8804aea72c2e192,50200023535069,42603.08,60ec41ba55c00300382672d9,HDFC,direct expenses,5eecc6d6449e4f7cfb1c2708,2023-04-10T00:00:00.000Z,POS 514834XXXXXX0472 PTM*PAYTM WALLET,ewallet,Transfer to PTM*PAYTM WALLET,debit_card,-105
645df614f8804aea72c2e194,50200023535069,171944.07,60ec41ba55c00300382672d9,HDFC,Transfer in/Revenue-other,5eecc6d6449e4f7cfb1c2708,2023-04-10T00:00:00.000Z,NEFT CR-YESB0000001-EASEBUZZ PVT LTD NOD AL A/C-SLICK ORGANICS PVT LTD-YESB310080 66022,,Transfer from EASEBUZZ PVT LTD NOD AL A/C,net_banking_transfer,129340.99
645df614f8804aea72c2e196,50200023535069,174325.93,60ec41ba55c00300382672d9,HDFC,Transfer in/Revenue-other,5eecc6d6449e4f7cfb1c2708,2023-04-10T00:00:00.000Z,NEFT CR-YESB0000001-EASEBUZZ PVT LTD NOD AL A/C-SLICK ORGANICS PVT LTD-YESB310080 67821,,Transfer from EASEBUZZ PVT LTD NOD AL A/C,net_banking_transfer,2381.86
645df614f8804aea72c2e198,50200023535069,222571.69,60ec41ba55c00300382672d9,HDFC,Transfer in/Revenue-other,5eecc6d6449e4f7cfb1c2708,2023-04-10T00:00:00.000Z,NEFT CR-YESB0000001-EASEBUZZ PVT LTD NOD AL A/C-SLICK ORGANICS PVT LTD-YESB310080 67929,,Transfer from EASEBUZZ PVT LTD NOD AL A/C,net_banking_transfer,48245.76
645df614f8804aea72c2e19a,50200023535069,247571.69,60ec41ba55c00300382672d9,HDFC,Internal Transfers,5eecc6d6449e4f7cfb1c2708,2023-04-10T00:00:00.000Z,IB FUNDS TRANSFER CR-50200050976833 -SL ICK ORGANICS PVT LTD,,,Other,25000
645df614f8804aea72c2e19c,50200023535069,257571.69,60ec41ba55c00300382672d9,HDFC,Internal Transfers,5eecc6d6449e4f7cfb1c2708,2023-04-10T00:00:00.000Z,IB FUNDS TRANSFER CR-50200035187206 -SL ICK ORGANICS PVT LTD,,,Other,10000
645df614f8804aea72c2e19e,50200023535069,47571.69,60ec41ba55c00300382672d9,HDFC,direct expenses,5eecc6d6449e4f7cfb1c2708,2023-04-10T00:00:00.000Z,YHDF1833944141/BILLDKAMERICANEXPRES,bills,,Other,-210000
645df614f8804aea72c2e1a0,50200023535069,60937.92,60ec41ba55c00300382672d9,HDFC,Transfer in/Revenue-other,5eecc6d6449e4f7cfb1c2708,2023-04-10T00:00:00.000Z,EASEBUZZ PRIVA-A463100423PSNTIOBYCH,,,Other,13366.23
645df614f8804aea72c2e1a2,50200023535069,63333.92,60ec41ba55c00300382672d9,HDFC,Revenue-PG-split enabled,5eecc6d6449e4f7cfb1c2708,2023-04-10T00:00:00.000Z,NEFT CR-UTIB0001506-RAZORPAY SOFTWARE PR IVATE LIMITED --SLICK ORGANICS PVT LITD- AXISCN0234006101,,Transfer from RAZORPAY SOFTWARE PR IVATE LIMITED ,net_banking_transfer,2396
645df614f8804aea72c2e1a4,50200023535069,44171.92,60ec41ba55c00300382672d9,HDFC,direct expenses,5eecc6d6449e4f7cfb1c2708,2023-04-10T00:00:00.000Z,"NEFT DR-HSBC0560002-FLIPKART INTERNET PV T LTD-NETBANK, MUM-N100232411958069-SLIC K ORGANICS PVT",shopping,Transfer to N100232411958069,net_banking_transfer,-19162
645df614f8804aea72c2e1a6,50200023535069,45343.06,60ec41ba55c00300382672d9,HDFC,Transfer in/Revenue-other,5eecc6d6449e4f7cfb1c2708,2023-04-10T00:00:00.000Z,NEFT CR-YESB0000001-EASEBUZZ PVT LTD NOD AL A/C-SLICK ORGANICS PVT LTD-YESB310083 85235,,Transfer from EASEBUZZ PVT LTD NOD AL A/C,net_banking_transfer,1171.14
645df614f8804aea72c2e1a8,50200023535069,47340.17,60ec41ba55c00300382672d9,HDFC,Transfer in/Revenue-other,5eecc6d6449e4f7cfb1c2708,2023-04-11T00:00:00.000Z,IMPS-310103667156-EXCRO PAY ESCROW ACC-Y ESB-XXXXXXXXXXX1807-333112298023,,Transfer from EXCRO PAY ESCROW ACC,net_banking_transfer,1997.11
645df614f8804aea72c2e1ab,50200023535069,38289.17,60ec41ba55c00300382672d9,HDFC,direct expenses,5eecc6d6449e4f7cfb1c2708,2023-04-11T00:00:00.000Z,02023112443624/ESIC,,,Other,-9051
645df614f8804aea72c2e1ad,50200023535069,50052.67,60ec41ba55c00300382672d9,HDFC,Revenue-PG-split enabled,5eecc6d6449e4f7cfb1c2708,2023-04-11T00:00:00.000Z,NEFT CR-UTIB0001506-RAZORPAY SOFTWARE PR IVATE LIMITED --SLICK ORGANICS PVT LITD-,,Transfer from RAZORPAY SOFTWARE PR IVATE LIMITED ,net_banking_transfer,11763.5
645df614f8804aea72c2e1af,50200023535069,49844.67,60ec41ba55c00300382672d9,HDFC,direct expenses,5eecc6d6449e4f7cfb1c2708,2023-04-11T00:00:00.000Z,POS 514834XXXXXX0472 PAYTM_PAYTMADDMO,ewallet,Transfer to PAYTM_PAYTMADDMO,debit_card,-208
645df614f8804aea72c2e1b1,50200023535069,7200.67,60ec41ba55c00300382672d9,HDFC,direct expenses,5eecc6d6449e4f7cfb1c2708,2023-04-11T00:00:00.000Z,"NEFT DR-UTIB0001696-EMIZA SUPPLY CHAIN S ERVICES PRIVATE LIMI-NETBANK, MUM-N10123 2413060703-42644",,Transfer to N10123 2413060703,net_banking_transfer,-42644
645df614f8804aea72c2e1b3,50200023535069,8722.06,60ec41ba55c00300382672d9,HDFC,Transfer in/Revenue-other,5eecc6d6449e4f7cfb1c2708,2023-04-11T00:00:00.000Z,NEFT CR-YESB0000001-EXCRO PAY ESCROW ACC OUNT-SLICKORGANICSPRIVATELIMITED-YESB310 10810953,,Transfer from EXCRO PAY ESCROW ACC OUNT,net_banking_transfer,1521.39
645df614f8804aea72c2e1b5,50200023535069,7420.06,60ec41ba55c00300382672d9,HDFC,direct expenses,5eecc6d6449e4f7cfb1c2708,2023-04-11T00:00:00.000Z,POS 514834XXXXXX0472 PTM*PAYTM WALLET,ewallet,Transfer to PTM*PAYTM WALLET,debit_card,-1302
645df614f8804aea72c2e1b8,50200023535069,7270.06,60ec41ba55c00300382672d9,HDFC,direct expenses,5eecc6d6449e4f7cfb1c2708,2023-04-11T00:00:00.000Z,POS 514834XXXXXX0472 PTM*PAYTM WALLET,ewallet,Transfer to PTM*PAYTM WALLET,debit_card,-150
645df614f8804aea72c2e1ba,50200023535069,80249.73,60ec41ba55c00300382672d9,HDFC,Transfer in/Revenue-other,5eecc6d6449e4f7cfb1c2708,2023-04-11T00:00:00.000Z,NEFT CR-YESB0000001-EASEBUZZ PVT LTD NOD AL A/C-SLICK ORGANICS PVT LTD-YESB310108 29427,,Transfer from EASEBUZZ PVT LTD NOD AL A/C,net_banking_transfer,72979.67
645df614f8804aea72c2e1bc,50200023535069,83688.23,60ec41ba55c00300382672d9,HDFC,Revenue-Mktplace,5eecc6d6449e4f7cfb1c2708,2023-04-11T00:00:00.000Z,IMPS-310114071936-DREAMPLUGPAYTECHSO-UTI B-XXXXXXXXXXX7853-NA,,Transfer from DREAMPLUGPAYTECHSO,net_banking_transfer,3438.5
645df614f8804aea72c2e1be,50200023535069,85247.31,60ec41ba55c00300382672d9,HDFC,Transfer in/Revenue-other,5eecc6d6449e4f7cfb1c2708,2023-04-11T00:00:00.000Z,NEFT CR-UTIB0000114-ONE SIGMA TECHNOLOGI ES PRIVATE LIMI-SLICK ORGANICS PRIVATE L IMITED-AXISP00380753190,bnpl,Transfer from ONE SIGMA TECHNOLOGI ES PRIVATE LIMI,net_banking_transfer,1559.08
645df614f8804aea72c2e1c0,50200023535069,87129.29,60ec41ba55c00300382672d9,HDFC,Transfer in/Revenue-other,5eecc6d6449e4f7cfb1c2708,2023-04-11T00:00:00.000Z,EASEBUZZ PRIVA-A267110423PSX2XCQIYE,,,Other,1881.98
645df614f8804aea72c2e1c2,50200023535069,104867.34,60ec41ba55c00300382672d9,HDFC,Revenue-PG-split enabled,5eecc6d6449e4f7cfb1c2708,2023-04-11T00:00:00.000Z,NEFT CR-UTIB0001506-RAZORPAY SOFTWARE PR IVATE LIMITED --SLICK ORGANICS PVT LITD- AXISCN0234479607,,Transfer from RAZORPAY SOFTWARE PR IVATE LIMITED ,net_banking_transfer,17738.05
645df614f8804aea72c2e1c4,50200023535069,116984.11,60ec41ba55c00300382672d9,HDFC,Transfer in/Revenue-other,5eecc6d6449e4f7cfb1c2708,2023-04-11T00:00:00.000Z,4200001006-11 04 2023-HD08868902,,,Other,12116.77
645df614f8804aea72c2e1c6,50200023535069,2803.11,60ec41ba55c00300382672d9,HDFC,Salary/Emp/consultant Expense,5eecc6d6449e4f7cfb1c2708,2023-04-11T00:00:00.000Z,2108654842/EPFO,,,Other,-114181
645df614f8804aea72c2e1c8,50200023535069,6375.9,60ec41ba55c00300382672d9,HDFC,Transfer in/Revenue-other,5eecc6d6449e4f7cfb1c2708,2023-04-11T00:00:00.000Z,NEFT CR-YESB0000001-EASEBUZZ PVT LTD NOD AL A/C-SLICK ORGANICS PVT LTD-YESB310111 20908,,Transfer from EASEBUZZ PVT LTD NOD AL A/C,net_banking_transfer,3572.79
645df614f8804aea72c2e1ca,50200023535069,68263.8,60ec41ba55c00300382672d9,HDFC,Transfer in/Revenue-other,5eecc6d6449e4f7cfb1c2708,2023-04-11T00:00:00.000Z,NEFT CR-YESB0000001-EASEBUZZ PVT LTD NOD AL A/C-SLICK ORGANICS PVT LTD-YESB310111 23710,,Transfer from EASEBUZZ PVT LTD NOD AL A/C,net_banking_transfer,61887.9
645df614f8804aea72c2e1cc,50200023535069,68930.27,60ec41ba55c00300382672d9,HDFC,Transfer in/Revenue-other,5eecc6d6449e4f7cfb1c2708,2023-04-11T00:00:00.000Z,NEFT CR-YESB0000001-EASEBUZZ PVT LTD NOD AL A/C-SLICK ORGANICS PVT LTD-YESB310111,,Transfer from EASEBUZZ PVT LTD NOD AL A/C,net_banking_transfer,666.47
645df614f8804aea72c2e1ce,50200023535069,72257.95,60ec41ba55c00300382672d9,HDFC,Transfer in/Revenue-other,5eecc6d6449e4f7cfb1c2708,2023-04-12T00:00:00.000Z,IMPS-310204766260-EXCRO PAY ESCROW ACC-Y ESB-XXXXXXXXXXX1807-333112298023,,Transfer from EXCRO PAY ESCROW ACC,net_banking_transfer,3327.68
645df614f8804aea72c2e1d0,50200023535069,77226.31,60ec41ba55c00300382672d9,HDFC,Transfer in/Revenue-other,5eecc6d6449e4f7cfb1c2708,2023-04-12T00:00:00.000Z,IMPS-310207839520-EXCRO PAY ESCROW ACC-Y ESB-XXXXXXXXXXX1807-333112298023,,Transfer from EXCRO PAY ESCROW ACC,net_banking_transfer,4968.36
645df614f8804aea72c2e1d2,50200023535069,60576.31,60ec41ba55c00300382672d9,HDFC,direct expenses,5eecc6d6449e4f7cfb1c2708,2023-04-12T00:00:00.000Z,"NEFT DR-KKBK0000173-NITISH KUMAR MANDAL- NETBANK, MUM-N102232414873881-16650",,Transfer to N102232414873881,net_banking_transfer,-16650
645df614f8804aea72c2e1d4,50200023535069,62000.4,60ec41ba55c00300382672d9,HDFC,Revenue-Mktplace,5eecc6d6449e4f7cfb1c2708,2023-04-12T00:00:00.000Z,NEFT CR-DEUT0797BGL-MYNTRA DESIGNS PRIVA TE LIMITED-SLICK ORGANICS - SJIT-3102010 35GN00124,shopping,Transfer from MYNTRA DESIGNS PRIVA TE LIMITED,net_banking_transfer,1424.09
645df614f8804aea72c2e1d6,50200023535069,63835.06,60ec41ba55c00300382672d9,HDFC,Revenue-Mktplace,5eecc6d6449e4f7cfb1c2708,2023-04-12T00:00:00.000Z,NEFT CR-DEUT0797BGL-MYNTRA DESIGNS PRIVA TE LIMITED-SLICK ORGANICS PVT. LTD.-3102 01073GN00034,shopping,Transfer from MYNTRA DESIGNS PRIVA TE LIMITED,net_banking_transfer,1834.66
645df614f8804aea72c2e1d8,50200023535069,85399.06,60ec41ba55c00300382672d9,HDFC,Revenue-PG-split enabled,5eecc6d6449e4f7cfb1c2708,2023-04-12T00:00:00.000Z,NEFT CR-UTIB0001506-RAZORPAY SOFTWARE PR IVATE LIMITED --SLICK ORGANICS PVT LITD- AXISCN0234795267,,Transfer from RAZORPAY SOFTWARE PR IVATE LIMITED ,net_banking_transfer,21564
645df614f8804aea72c2e1da,50200023535069,84098.06,60ec41ba55c00300382672d9,HDFC,direct expenses,5eecc6d6449e4f7cfb1c2708,2023-04-12T00:00:00.000Z,POS 514834XXXXXX0472 PAYTM_PAYTMADDMO,ewallet,Transfer to PAYTM_PAYTMADDMO,debit_card,-1301
645df614f8804aea72c2e1dc,50200023535069,83558.06,60ec41ba55c00300382672d9,HDFC,direct expenses,5eecc6d6449e4f7cfb1c2708,2023-04-12T00:00:00.000Z,POS 514834XXXXXX0472 PAYTM_PAYTMADDMO,ewallet,Transfer to PAYTM_PAYTMADDMO,debit_card,-540
645df614f8804aea72c2e1de,50200023535069,78448.06,60ec41ba55c00300382672d9,HDFC,direct expenses,5eecc6d6449e4f7cfb1c2708,2023-04-12T00:00:00.000Z,POS 514834XXXXXX0472 PAYTM PAYMENTS S,ewallet,Transfer to PAYTM PAYMENTS S,debit_card,-5110
645df614f8804aea72c2e1e0,50200023535069,76419.06,60ec41ba55c00300382672d9,HDFC,direct expenses,5eecc6d6449e4f7cfb1c2708,2023-04-12T00:00:00.000Z,ME DC SI 514834XXXXXX0472 ADOBE SYSTEMS SOFTWARE,,,Other,-2029
645df614f8804aea72c2e1e2,50200023535069,81995.83,60ec41ba55c00300382672d9,HDFC,Transfer in/Revenue-other,5eecc6d6449e4f7cfb1c2708,2023-04-12T00:00:00.000Z,NEFT CR-UTIB0000114-ONE SIGMA TECHNOLOGI ES PRIVATE LIMI-SLICK ORGANICS PRIVATE L IMITED-AXISP00381140521,bnpl,Transfer from ONE SIGMA TECHNOLOGI ES PRIVATE LIMI,net_banking_transfer,5576.77
645df614f8804aea72c2e1e4,50200023535069,80567.83,60ec41ba55c00300382672d9,HDFC,direct expenses,5eecc6d6449e4f7cfb1c2708,2023-04-12T00:00:00.000Z,POS 514834XXXXXX0472 PAYTM_PAYTMADDMO,ewallet,Transfer to PAYTM_PAYTMADDMO,debit_card,-1428
645df614f8804aea72c2e1e6,50200023535069,86402.73,60ec41ba55c00300382672d9,HDFC,Revenue-Mktplace,5eecc6d6449e4f7cfb1c2708,2023-04-12T00:00:00.000Z,IMPS-310214500128-DREAMPLUGPAYTECHSO-UTI B-XXXXXXXXXXX7853-NA,,Transfer from DREAMPLUGPAYTECHSO,net_banking_transfer,5834.9
645df614f8804aea72c2e1e8,50200023535069,16531.73,60ec41ba55c00300382672d9,HDFC,direct expenses,5eecc6d6449e4f7cfb1c2708,2023-04-12T00:00:00.000Z,"NEFT DR-KKBK0004281-FDM DIGITAL SOLUTION S PVT LTD-NETBANK, MUM-N102232415489073- 69871",,Transfer to N102232415489073,net_banking_transfer,-69871
645df614f8804aea72c2e1ea,50200023535069,27382.36,60ec41ba55c00300382672d9,HDFC,Transfer in/Revenue-other,5eecc6d6449e4f7cfb1c2708,2023-04-12T00:00:00.000Z,EASEBUZZ PRIVA-A307120423PSOVE6LERU,,,Other,10850.63
645df614f8804aea72c2e1ec,50200023535069,28878.49,60ec41ba55c00300382672d9,HDFC,Transfer in/Revenue-other,5eecc6d6449e4f7cfb1c2708,2023-04-12T00:00:00.000Z,NEFT CR-YESB0000001-EASEBUZZ PVT LTD NOD,,Transfer from EASEBUZZ PVT LTD NOD,net_banking_transfer,1496.13
645df614f8804aea72c2e1ef,50200023535069,33246.49,60ec41ba55c00300382672d9,HDFC,Revenue-PG-split enabled,5eecc6d6449e4f7cfb1c2708,2023-04-12T00:00:00.000Z,NEFT CR-UTIB0001506-RAZORPAY SOFTWARE PR IVATE LIMITED --SLICK ORGANICS PVT LITD- AXISCN0235086028,,Transfer from RAZORPAY SOFTWARE PR IVATE LIMITED ,net_banking_transfer,4368
645df614f8804aea72c2e1f1,50200023535069,53778.73,60ec41ba55c00300382672d9,HDFC,Transfer in/Revenue-other,5eecc6d6449e4f7cfb1c2708,2023-04-12T00:00:00.000Z,NEFT CR-YESB0000001-EASEBUZZ PVT LTD NOD AL A/C-SLICK ORGANICS PVT LTD-YESB310240 48218,,Transfer from EASEBUZZ PVT LTD NOD AL A/C,net_banking_transfer,20532.24
645df614f8804aea72c2e1f3,50200023535069,66212.3,60ec41ba55c00300382672d9,HDFC,Revenue-Mktplace,5eecc6d6449e4f7cfb1c2708,2023-04-13T00:00:00.000Z,NEFT CR-DEUT0797BGL-MYNTRA DESIGNS PRIVA TE LIMITED-SLICK ORGANICS - SJIT-3103006 28GN00038,shopping,Transfer from MYNTRA DESIGNS PRIVA TE LIMITED,net_banking_transfer,12433.57
645df614f8804aea72c2e1f6,50200023535069,21212.3,60ec41ba55c00300382672d9,HDFC,direct expenses,5eecc6d6449e4f7cfb1c2708,2023-04-13T00:00:00.000Z,"NEFT DR-IOBA0001445-PRIYANKA GOPAL-NETBA NK, MUM-N103232416725486-45000",,Transfer to N103232416725486,net_banking_transfer,-45000
645df614f8804aea72c2e1f8,50200023535069,23163.97,60ec41ba55c00300382672d9,HDFC,Transfer in/Revenue-other,5eecc6d6449e4f7cfb1c2708,2023-04-13T00:00:00.000Z,NEFT CR-YESB0000001-EXCRO PAY ESCROW ACC OUNT-SLICKORGANICSPRIVATELIMITED-YESB310 36293494,,Transfer from EXCRO PAY ESCROW ACC OUNT,net_banking_transfer,1951.67
645df614f8804aea72c2e1fb,50200023535069,35729.61,60ec41ba55c00300382672d9,HDFC,Revenue-Mktplace,5eecc6d6449e4f7cfb1c2708,2023-04-13T00:00:00.000Z,NEFT CR-DEUT0797BGL-MYNTRA DESIGNS PRIVA TE LIMITED-SLICK ORGANICS PVT. LTD.-3103 00669GN00229,shopping,Transfer from MYNTRA DESIGNS PRIVA TE LIMITED,net_banking_transfer,12565.64
645df614f8804aea72c2e1fd,50200023535069,49661.31,60ec41ba55c00300382672d9,HDFC,Revenue-PG-split enabled,5eecc6d6449e4f7cfb1c2708,2023-04-13T00:00:00.000Z,NEFT CR-UTIB0001506-RAZORPAY SOFTWARE PR IVATE LIMITED --SLICK ORGANICS PVT LITD- AXISCN0235426110,,Transfer from RAZORPAY SOFTWARE PR IVATE LIMITED ,net_banking_transfer,13931.7
645df614f8804aea72c2e1ff,50200023535069,49533.31,60ec41ba55c00300382672d9,HDFC,direct expenses,5eecc6d6449e4f7cfb1c2708,2023-04-13T00:00:00.000Z,POS 514834XXXXXX0472 PAYTM_PAYTMADDMO,ewallet,Transfer to PAYTM_PAYTMADDMO,debit_card,-128
645df614f8804aea72c2e201,50200023535069,72995.31,60ec41ba55c00300382672d9,HDFC,Transfer in/Revenue-other,5eecc6d6449e4f7cfb1c2708,2023-04-13T00:00:00.000Z,NEFT CR-KKBK0000958-OCTAVOS ENTERPRISE S OLUTIONS PVT-SLICK ORGANICS PRIVATE LIMI TED-CMS1032350399240,,Transfer from OCTAVOS ENTERPRISE S OLUTIONS PVT,net_banking_transfer,23462
645df614f8804aea72c2e203,50200023535069,78901.6,60ec41ba55c00300382672d9,HDFC,Transfer in/Revenue-other,5eecc6d6449e4f7cfb1c2708,2023-04-13T00:00:00.000Z,NEFT CR-UTIB0000114-ONE SIGMA TECHNOLOGI ES PRIVATE LIMI-SLICK ORGANICS PRIVATE L IMITED-AXISP00381471791,bnpl,Transfer from ONE SIGMA TECHNOLOGI ES PRIVATE LIMI,net_banking_transfer,5906.29
645df614f8804aea72c2e205,50200023535069,93901.6,60ec41ba55c00300382672d9,HDFC,Internal Transfers,5eecc6d6449e4f7cfb1c2708,2023-04-13T00:00:00.000Z,IB FUNDS TRANSFER CR-50200035187206 -SL ICK ORGANICS PVT LTD,,,Other,15000
645df615f8804aea72c2e207,50200023535069,43901.6,60ec41ba55c00300382672d9,HDFC,direct expenses,5eecc6d6449e4f7cfb1c2708,2023-04-13T00:00:00.000Z,50200058892979-TPT-ARATA-HOT HAIR BALLOO,,Transfer to HOT HAIR BALLOO,net_banking_transfer,-50000
645df615f8804aea72c2e209,50200023535069,49991.6,60ec41ba55c00300382672d9,HDFC,Revenue-Mktplace,5eecc6d6449e4f7cfb1c2708,2023-04-13T00:00:00.000Z,IMPS-310314919870-DREAMPLUGPAYTECHSO-UTI B-XXXXXXXXXXX7853-NA,,Transfer from DREAMPLUGPAYTECHSO,net_banking_transfer,6090
645df615f8804aea72c2e20b,50200023535069,35516.6,60ec41ba55c00300382672d9,HDFC,direct expenses,5eecc6d6449e4f7cfb1c2708,2023-04-13T00:00:00.000Z,"NEFT DR-ICIC0007392-FORTITUDE INC-NETBAN K, MUM-N103232417353872-ARATA",,Transfer to N103232417353872,net_banking_transfer,-14475
645df615f8804aea72c2e20d,50200023535069,31183.6,60ec41ba55c00300382672d9,HDFC,direct expenses,5eecc6d6449e4f7cfb1c2708,2023-04-13T00:00:00.000Z,50100156335509-TPT-ARATA-CATHERINE REALT Y SHADAP,,Transfer to CATHERINE REALT Y SHADAP,net_banking_transfer,-4333
645df615f8804aea72c2e20f,50200023535069,41152.6,60ec41ba55c00300382672d9,HDFC,Revenue-Mktplace,5eecc6d6449e4f7cfb1c2708,2023-04-13T00:00:00.000Z,NEFT CR-ICIC0000105-MANASH LIFETYLE PVT LTD-SLICK ORGANICS PRIVATE LIMITED-ICIB2 31030035385,,Transfer from MANASH LIFETYLE PVT LTD,net_banking_transfer,9969
645df615f8804aea72c2e211,50200023535069,43038.6,60ec41ba55c00300382672d9,HDFC,Transfer in/Revenue-other,5eecc6d6449e4f7cfb1c2708,2023-04-13T00:00:00.000Z,NEFT CR-SCBL0036001-HEALTH GLOW PRIVATE LIMITED-SLICK ORGANICS PVT LTD-ARATA-IN 1ON23041302SCU,,Transfer from HEALTH GLOW PRIVATE LIMITED,net_banking_transfer,1886
645df615f8804aea72c2e213,50200023535069,46531.6,60ec41ba55c00300382672d9,HDFC,Revenue-PG-split enabled,5eecc6d6449e4f7cfb1c2708,2023-04-13T00:00:00.000Z,NEFT CR-UTIB0001506-RAZORPAY SOFTWARE PR IVATE LIMITED --SLICK ORGANICS PVT LITD- AXISCN0235664454,,Transfer from RAZORPAY SOFTWARE PR IVATE LIMITED ,net_banking_transfer,3493
645df615f8804aea72c2e215,50200023535069,61531.6,60ec41ba55c00300382672d9,HDFC,Internal Transfers,5eecc6d6449e4f7cfb1c2708,2023-04-13T00:00:00.000Z,IB FUNDS TRANSFER CR-50200050976833 -SL ICK ORGANICS PVT LTD,,,Other,15000
645df615f8804aea72c2e217,50200023535069,112049.64,60ec41ba55c00300382672d9,HDFC,Transfer in/Revenue-other,5eecc6d6449e4f7cfb1c2708,2023-04-13T00:00:00.000Z,NEFT CR-YESB0000001-EASEBUZZ PVT LTD NOD AL A/C-SLICK ORGANICS PVT LTD-YESB310366 46064,,Transfer from EASEBUZZ PVT LTD NOD AL A/C,net_banking_transfer,50518.04
645df615f8804aea72c2e219,50200023535069,117608.64,60ec41ba55c00300382672d9,HDFC,Transfer in/Revenue-other,5eecc6d6449e4f7cfb1c2708,2023-04-13T00:00:00.000Z,NEFT CR-YESB0000001-EASEBUZZ PVT LTD NOD AL A/C-SLICK ORGANICS PVT LTD-YESB310366 45663,,Transfer from EASEBUZZ PVT LTD NOD AL A/C,net_banking_transfer,5559
645df615f8804aea72c2e21c,50200023535069,122608.64,60ec41ba55c00300382672d9,HDFC,Internal Transfers,5eecc6d6449e4f7cfb1c2708,2023-04-13T00:00:00.000Z,IB FUNDS TRANSFER CR-50200035187206 -SL ICK ORGANICS PVT LTD,,,Other,5000
645df615f8804aea72c2e21e,50200023535069,127608.64,60ec41ba55c00300382672d9,HDFC,Internal Transfers,5eecc6d6449e4f7cfb1c2708,2023-04-13T00:00:00.000Z,IB FUNDS TRANSFER CR-50200050976833 -SL ICK ORGANICS PVT LTD,,,Other,5000
645df615f8804aea72c2e220,50200023535069,57608.64,60ec41ba55c00300382672d9,HDFC,direct expenses,5eecc6d6449e4f7cfb1c2708,2023-04-13T00:00:00.000Z,"NEFT DR-SBIN00CARDS-CC HEMANT GUPTA 1400 -NETBANK, MUM-N103232418019265-HEMANT SB I CC",,Transfer to N103232418019265,net_banking_transfer,-70000
645df615f8804aea72c2e224,50200023535069,59586.76,60ec41ba55c00300382672d9,HDFC,Transfer in/Revenue-other,5eecc6d6449e4f7cfb1c2708,2023-04-14T00:00:00.000Z,NEFT CR-YESB0000001-EXCRO PAY ESCROW ACC,,Transfer from EXCRO PAY ESCROW ACC,net_banking_transfer,1978.12
645df615f8804aea72c2e226,50200023535069,62367.9,60ec41ba55c00300382672d9,HDFC,Transfer in/Revenue-other,5eecc6d6449e4f7cfb1c2708,2023-04-15T00:00:00.000Z,NEFT CR-SCBL0036001-HEALTH GLOW PRIVATE LIMITED-SLICK ORGANICS PVT LTD-ARATA-IN 1ON23041500GKU,,Transfer from HEALTH GLOW PRIVATE LIMITED,net_banking_transfer,2781.14
645df615f8804aea72c2e228,50200023535069,64282.95,60ec41ba55c00300382672d9,HDFC,Transfer in/Revenue-other,5eecc6d6449e4f7cfb1c2708,2023-04-15T00:00:00.000Z,NEFT CR-YESB0000001-EXCRO PAY ESCROW ACC OUNT-SLICKORGANICSPRIVATELIMITED-YESB310 50904916,,Transfer from EXCRO PAY ESCROW ACC OUNT,net_banking_transfer,1915.05
645df615f8804aea72c2e22a,50200023535069,96898.35,60ec41ba55c00300382672d9,HDFC,Revenue-PG-split enabled,5eecc6d6449e4f7cfb1c2708,2023-04-15T00:00:00.000Z,NEFT CR-UTIB0001506-RAZORPAY SOFTWARE PR IVATE LIMITED --SLICK ORGANICS PVT LITD- AXISCN0236192624,,Transfer from RAZORPAY SOFTWARE PR IVATE LIMITED ,net_banking_transfer,32615.4
645df615f8804aea72c2e22d,50200023535069,139613.35,60ec41ba55c00300382672d9,HDFC,Transfer in/Revenue-other,5eecc6d6449e4f7cfb1c2708,2023-04-15T00:00:00.000Z,NEFT CR-HSBC0560002-INNOVATIVE RETAIL CO NCEPTS PRIVATE-SLICK ORGANICS PVT LTD-HS BCN23105189710,,Transfer from INNOVATIVE RETAIL CO NCEPTS PRIVATE,net_banking_transfer,42715
645df615f8804aea72c2e22f,50200023535069,152552.35,60ec41ba55c00300382672d9,HDFC,Revenue-Mktplace,5eecc6d6449e4f7cfb1c2708,2023-04-15T00:00:00.000Z,IMPS-310514089285-DREAMPLUGPAYTECHSO-UTI B-XXXXXXXXXXX7853-NA,,Transfer from DREAMPLUGPAYTECHSO,net_banking_transfer,12939
645df615f8804aea72c2e231,50200023535069,153722.79,60ec41ba55c00300382672d9,HDFC,Transfer in/Revenue-other,5eecc6d6449e4f7cfb1c2708,2023-04-15T00:00:00.000Z,EASEBUZZ PRIVA-A312150423PSOB7S97UT,,,Other,1170.44
645df615f8804aea72c2e233,50200023535069,159023.56,60ec41ba55c00300382672d9,HDFC,Revenue-PG-split enabled,5eecc6d6449e4f7cfb1c2708,2023-04-15T00:00:00.000Z,NEFT CR-UTIB0001506-RAZORPAY SOFTWARE PR IVATE LIMITED --SLICK ORGANICS PVT LITD- AXISCN0236370375,,Transfer from RAZORPAY SOFTWARE PR IVATE LIMITED ,net_banking_transfer,5300.77
645df615f8804aea72c2e235,50200023535069,244881.65,60ec41ba55c00300382672d9,HDFC,Transfer in/Revenue-other,5eecc6d6449e4f7cfb1c2708,2023-04-15T00:00:00.000Z,NEFT CR-YESB0000001-EASEBUZZ PVT LTD NOD AL A/C-SLICK ORGANICS PVT LTD-YESB310511 19552,,Transfer from EASEBUZZ PVT LTD NOD AL A/C,net_banking_transfer,85858.09
645df615f8804aea72c2e237,50200023535069,247263.51,60ec41ba55c00300382672d9,HDFC,Transfer in/Revenue-other,5eecc6d6449e4f7cfb1c2708,2023-04-15T00:00:00.000Z,NEFT CR-YESB0000001-EASEBUZZ PVT LTD NOD AL A/C-SLICK ORGANICS PVT LTD-YESB310511 68520,,Transfer from EASEBUZZ PVT LTD NOD AL A/C,net_banking_transfer,2381.86
645df615f8804aea72c2e239,50200023535069,275991.47,60ec41ba55c00300382672d9,HDFC,Transfer in/Revenue-other,5eecc6d6449e4f7cfb1c2708,2023-04-15T00:00:00.000Z,NEFT CR-YESB0000001-EASEBUZZ PVT LTD NOD AL A/C-SLICK ORGANICS PVT LTD-YESB310511 67905,,Transfer from EASEBUZZ PVT LTD NOD AL A/C,net_banking_transfer,28727.96
645df615f8804aea72c2e23b,50200023535069,25991.47,60ec41ba55c00300382672d9,HDFC,direct expenses,5eecc6d6449e4f7cfb1c2708,2023-04-15T00:00:00.000Z,"NEFT DR-SCBL0036020-AMERICAN EXPRESS-NET BANK, MUM-N105232420150032-250000",,Transfer to N105232420150032,net_banking_transfer,-250000
645df615f8804aea72c2e23d,50200023535069,23991.47,60ec41ba55c00300382672d9,HDFC,direct expenses,5eecc6d6449e4f7cfb1c2708,2023-04-15T00:00:00.000Z,POS 514834XXXXXX0472 SMARTSHIFT LOGIS,,Transfer to SMARTSHIFT LOGIS,debit_card,-2000
645df615f8804aea72c2e23f,50200023535069,25294.83,60ec41ba55c00300382672d9,HDFC,Transfer in/Revenue-other,5eecc6d6449e4f7cfb1c2708,2023-04-16T00:00:00.000Z,IMPS-310604739320-EXCRO PAY ESCROW ACC-Y ESB-XXXXXXXXXXX1807-333112298023,,Transfer from EXCRO PAY ESCROW ACC,net_banking_transfer,1303.36
645df615f8804aea72c2e241,50200023535069,120153.48,60ec41ba55c00300382672d9,HDFC,Revenue-Mktplace,5eecc6d6449e4f7cfb1c2708,2023-04-16T00:00:00.000Z,IMPS-310619102146-AMAZON SELLER SERVIC-H SBC-XXXXXXXX6004-5BQNW75GA9486G0LSLICK O RGANICS PVT LTD,shopping,Transfer from AMAZON SELLER SERVIC,net_banking_transfer,94858.65
645df615f8804aea72c2e243,50200023535069,70153.48,60ec41ba55c00300382672d9,HDFC,direct expenses,5eecc6d6449e4f7cfb1c2708,2023-04-16T00:00:00.000Z,"NEFT DR-SCBL0036020-AMERICAN EXPRESS-NET BANK, MUM-N106232420428525-50000",,Transfer to N106232420428525,net_banking_transfer,-50000
645df615f8804aea72c2e245,50200023535069,1885914.4,60ec41ba55c00300382672d9,HDFC,Revenue-Mktplace,5eecc6d6449e4f7cfb1c2708,2023-04-17T00:00:00.000Z,NEFT CR-DEUT0797BGL-INTERNAL AC FOR INTE RMEDIERY- AMAZON SELLER SERVIC-SLICK ORG ANICS PVT LTD-310601105GN00003,shopping,Transfer from INTERNAL AC FOR INTE RMEDIERY,net_banking_transfer,1815760.92
645df615f8804aea72c2e247,50200023535069,1888102.82,60ec41ba55c00300382672d9,HDFC,Transfer in/Revenue-other,5eecc6d6449e4f7cfb1c2708,2023-04-17T00:00:00.000Z,IMPS-310704669596-EXCRO PAY ESCROW ACC-Y ESB-XXXXXXXXXXX1807-333112298023,,Transfer from EXCRO PAY ESCROW ACC,net_banking_transfer,2188.42
645df615f8804aea72c2e249,50200023535069,1899725.96,60ec41ba55c00300382672d9,HDFC,Transfer in/Revenue-other,5eecc6d6449e4f7cfb1c2708,2023-04-17T00:00:00.000Z,NEFT CR-YESB0000001-EXCRO PAY ESCROW ACC OUNT-SLICKORGANICSPRIVATELIMITED-YESB310 74954346,,Transfer from EXCRO PAY ESCROW ACC OUNT,net_banking_transfer,11623.14
645df615f8804aea72c2e24b,50200023535069,1903200.21,60ec41ba55c00300382672d9,HDFC,Revenue-PG-split enabled,5eecc6d6449e4f7cfb1c2708,2023-04-17T00:00:00.000Z,NEFT CR-UTIB0001506-RAZORPAY SOFTWARE PR IVATE LIMITED --SLICK ORGANICS PVT LITD- AXISCN0236705184,,Transfer from RAZORPAY SOFTWARE PR IVATE LIMITED ,net_banking_transfer,3474.25
645df615f8804aea72c2e24d,50200023535069,1898371.21,60ec41ba55c00300382672d9,HDFC,direct expenses,5eecc6d6449e4f7cfb1c2708,2023-04-17T00:00:00.000Z,POS 514834XXXXXX0472 BLINKIT,,Transfer to BLINKIT,debit_card,-4829
645df615f8804aea72c2e24f,50200023535069,1897972.21,60ec41ba55c00300382672d9,HDFC,direct expenses,5eecc6d6449e4f7cfb1c2708,2023-04-17T00:00:00.000Z,"NEFT DR-ICIC0000020-RAJNISH CHOPRA-NETBA NK, MUM-N107232420624254-399",,Transfer to N107232420624254,net_banking_transfer,-399
645df615f8804aea72c2e251,50200023535069,1904354.05,60ec41ba55c00300382672d9,HDFC,Revenue-Mktplace,5eecc6d6449e4f7cfb1c2708,2023-04-17T00:00:00.000Z,NEFT CR-DEUT0797BGL-MYNTRA DESIGNS PRIVA TE LIMITED-SLICK ORGANICS - SJIT-3107011 15GN00170,shopping,Transfer from MYNTRA DESIGNS PRIVA TE LIMITED,net_banking_transfer,6381.84
645df615f8804aea72c2e254,50200023535069,1906684.19,60ec41ba55c00300382672d9,HDFC,Revenue-Mktplace,5eecc6d6449e4f7cfb1c2708,2023-04-17T00:00:00.000Z,NEFT CR-DEUT0797BGL-MYNTRA DESIGNS PRIVA TE LIMITED-SLICK ORGANICS PVT. LTD.-3107 01115GN00232,shopping,Transfer from MYNTRA DESIGNS PRIVA TE LIMITED,net_banking_transfer,2330.14
645df615f8804aea72c2e257,50200023535069,1905486.19,60ec41ba55c00300382672d9,HDFC,direct expenses,5eecc6d6449e4f7cfb1c2708,2023-04-17T00:00:00.000Z,"NEFT DR-UTIB0003290-DOLLY LAKHMANI-NETBA NK, MUM-N107232420634591-1198",,Transfer to N107232420634591,net_banking_transfer,-1198
645df615f8804aea72c2e259,50200023535069,1901986.19,60ec41ba55c00300382672d9,HDFC,direct expenses,5eecc6d6449e4f7cfb1c2708,2023-04-17T00:00:00.000Z,"NEFT DR-ICIC0004109-ASHRAFI ASSOCIATES-N ETBANK, MUM-N107232420641252-3500",,Transfer to N107232420641252,net_banking_transfer,-3500
645df615f8804aea72c2e25b,50200023535069,1900976.19,60ec41ba55c00300382672d9,HDFC,direct expenses,5eecc6d6449e4f7cfb1c2708,2023-04-17T00:00:00.000Z,POS 514834XXXXXX0472 RSP*GROFERS INDI,groceries,Transfer to RSP*GROFERS INDI,debit_card,-1010
645df615f8804aea72c2e25d,50200023535069,1899325.84,60ec41ba55c00300382672d9,HDFC,direct expenses,5eecc6d6449e4f7cfb1c2708,2023-04-17T00:00:00.000Z,POS 514834XXXXXX0472 RAZ*KNOWLARITY,,Transfer to RAZ*KNOWLARITY,debit_card,-1650.35
645df615f8804aea72c2e25f,50200023535069,1822325.84,60ec41ba55c00300382672d9,HDFC,direct expenses,5eecc6d6449e4f7cfb1c2708,2023-04-17T00:00:00.000Z,"NEFT DR-SRCB0000281-3D TECHNOPACK PRIVAT E LIMITED-NETBANK, MUM-N107232420814362- 77000",,Transfer to N107232420814362,net_banking_transfer,-77000
645df615f8804aea72c2e261,50200023535069,1824936.84,60ec41ba55c00300382672d9,HDFC,Revenue-Mktplace,5eecc6d6449e4f7cfb1c2708,2023-04-17T00:00:00.000Z,NEFT CR-ICIC0000105-MANASH LIFETYLE PVT LTD-SLICK ORGANICS PRIVATE LIMITED-ICIB2 31070010501,,Transfer from MANASH LIFETYLE PVT LTD,net_banking_transfer,2611
645df615f8804aea72c2e263,50200023535069,1787541.84,60ec41ba55c00300382672d9,HDFC,Tax,5eecc6d6449e4f7cfb1c2708,2023-04-17T00:00:00.000Z,GST/BANK REFERENCE NO: R2310742856717/CI N NO: HDFC23040700102964,tax,gst,Other,-37395
645df615f8804aea72c2e265,50200023535069,1751141.84,60ec41ba55c00300382672d9,HDFC,direct expenses,5eecc6d6449e4f7cfb1c2708,2023-04-17T00:00:00.000Z,50200058892979-TPT-36400-HOT HAIR BALLOO N,,Transfer to HOT HAIR BALLOO N,net_banking_transfer,-36400
645df615f8804aea72c2e267,50200023535069,1669414.84,60ec41ba55c00300382672d9,HDFC,direct expenses,5eecc6d6449e4f7cfb1c2708,2023-04-17T00:00:00.000Z,"NEFT DR-ICIC0003431-WAVICLE TECHNOLOGIES PVT LTD-NETBANK, MUM-N107232421048695-8 1727",,Transfer to N107232421048695,net_banking_transfer,-81727
645df615f8804aea72c2e269,50200023535069,1623077.84,60ec41ba55c00300382672d9,HDFC,agency/vendor expense,5eecc6d6449e4f7cfb1c2708,2023-04-17T00:00:00.000Z,"NEFT DR-KKBK0000298-ADMITAD MEDIA PRIVAT E LIMITED-NETBANK, MUM-N107232421049944- 46337",,Transfer to N107232421049944,net_banking_transfer,-46337
645df615f8804aea72c2e26b,50200023535069,1581043.84,60ec41ba55c00300382672d9,HDFC,agency/vendor expense,5eecc6d6449e4f7cfb1c2708,2023-04-17T00:00:00.000Z,"NEFT DR-KKBK0000298-ADMITAD MEDIA PRIVAT E LIMITED-NETBANK, MUM-N107232421056262- 42034",,Transfer to N107232421056262,net_banking_transfer,-42034
645df615f8804aea72c2e26d,50200023535069,1592148.74,60ec41ba55c00300382672d9,HDFC,Revenue-Mktplace,5eecc6d6449e4f7cfb1c2708,2023-04-17T00:00:00.000Z,IMPS-310714826522-DREAMPLUGPAYTECHSO-UTI B-XXXXXXXXXXX7853-NA,,Transfer from DREAMPLUGPAYTECHSO,net_banking_transfer,11104.9
645df615f8804aea72c2e26f,50200023535069,1585068.74,60ec41ba55c00300382672d9,HDFC,direct expenses,5eecc6d6449e4f7cfb1c2708,2023-04-17T00:00:00.000Z,"NEFT DR-UTIB0000032-SKUMAR MULTIPRODUCTS PVT LTD-NETBANK, MUM-N107232421103327-7 080",,Transfer to N107232421103327,net_banking_transfer,-7080
645df615f8804aea72c2e271,50200023535069,1587571.39,60ec41ba55c00300382672d9,HDFC,Transfer in/Revenue-other,5eecc6d6449e4f7cfb1c2708,2023-04-17T00:00:00.000Z,NEFT CR-UTIB0000114-ONE SIGMA TECHNOLOGI ES PRIVATE LIMI-SLICK ORGANICS PRIVATE L IMITED-AXISP00382339355,bnpl,Transfer from ONE SIGMA TECHNOLOGI ES PRIVATE LIMI,net_banking_transfer,2502.65
645df615f8804aea72c2e273,50200023535069,1592367.44,60ec41ba55c00300382672d9,HDFC,Transfer in/Revenue-other,5eecc6d6449e4f7cfb1c2708,2023-04-17T00:00:00.000Z,NEFT CR-UTIB0000114-ONE SIGMA TECHNOLOGI ES PRIVATE LIMI-SLICK ORGANICS PRIVATE L IMITED-AXISP00382338610,bnpl,Transfer from ONE SIGMA TECHNOLOGI ES PRIVATE LIMI,net_banking_transfer,4796.05
645df615f8804aea72c2e275,50200023535069,1597139.8,60ec41ba55c00300382672d9,HDFC,Transfer in/Revenue-other,5eecc6d6449e4f7cfb1c2708,2023-04-17T00:00:00.000Z,NEFT CR-UTIB0000114-ONE SIGMA TECHNOLOGI,bnpl,Transfer from ONE SIGMA TECHNOLOGI,net_banking_transfer,4772.36
645df616f8804aea72c2e277,50200023535069,1607206.3,60ec41ba55c00300382672d9,HDFC,Transfer in/Revenue-other,5eecc6d6449e4f7cfb1c2708,2023-04-17T00:00:00.000Z,NEFT CR-UTIB0000114-ONE SIGMA TECHNOLOGI ES PRIVATE LIMI-SLICK ORGANICS PRIVATE L IMITED-AXISP00382339518,bnpl,Transfer from ONE SIGMA TECHNOLOGI ES PRIVATE LIMI,net_banking_transfer,10066.5
645df616f8804aea72c2e279,50200023535069,1609766.35,60ec41ba55c00300382672d9,HDFC,Transfer in/Revenue-other,5eecc6d6449e4f7cfb1c2708,2023-04-17T00:00:00.000Z,EASEBUZZ PRIVA-A272170423PSCAIX1VVP,,,Other,2560.05
645df616f8804aea72c2e27c,50200023535069,1616919.31,60ec41ba55c00300382672d9,HDFC,Transfer in/Revenue-other,5eecc6d6449e4f7cfb1c2708,2023-04-17T00:00:00.000Z,NEFT CR-SCBL0036001-HEALTH GLOW PRIVATE LIMITED-SLICK ORGANICS PVT LTD-ARATA-IN 1ON230417015JC,,Transfer from HEALTH GLOW PRIVATE LIMITED,net_banking_transfer,7152.96
645df616f8804aea72c2e27f,50200023535069,1615926.31,60ec41ba55c00300382672d9,HDFC,direct expenses,5eecc6d6449e4f7cfb1c2708,2023-04-17T00:00:00.000Z,POS 514834XXXXXX0472 PAYTM PAYMENTS S,ewallet,Transfer to PAYTM PAYMENTS S,debit_card,-993
645df616f8804aea72c2e281,50200023535069,1616373.31,60ec41ba55c00300382672d9,HDFC,Transfer in/Revenue-other,5eecc6d6449e4f7cfb1c2708,2023-04-17T00:00:00.000Z,NEFT CR-SCBL0036001-HEALTH GLOW PRIVATE LIMITED-SLICK ORGANICS PVT LTD-ARATA-IN 1ON23041701XH9,,Transfer from HEALTH GLOW PRIVATE LIMITED,net_banking_transfer,447
645df616f8804aea72c2e283,50200023535069,1617499.85,60ec41ba55c00300382672d9,HDFC,Revenue-PG-split enabled,5eecc6d6449e4f7cfb1c2708,2023-04-17T00:00:00.000Z,NEFT CR-UTIB0001506-RAZORPAY SOFTWARE PR IVATE LIMITED --SLICK ORGANICS PVT LITD- AXISCN0236960152,,Transfer from RAZORPAY SOFTWARE PR IVATE LIMITED ,net_banking_transfer,1126.54
645df616f8804aea72c2e285,50200023535069,1667463.66,60ec41ba55c00300382672d9,HDFC,Transfer in/Revenue-other,5eecc6d6449e4f7cfb1c2708,2023-04-17T00:00:00.000Z,NEFT CR-YESB0000001-EASEBUZZ PVT LTD NOD AL A/C-SLICK ORGANICS PVT LTD-YESB310754 69577,,Transfer from EASEBUZZ PVT LTD NOD AL A/C,net_banking_transfer,49963.81
645df616f8804aea72c2e287,50200023535069,1673446.63,60ec41ba55c00300382672d9,HDFC,Transfer in/Revenue-other,5eecc6d6449e4f7cfb1c2708,2023-04-17T00:00:00.000Z,NEFT CR-YESB0000001-EASEBUZZ PVT LTD NOD AL A/C-SLICK ORGANICS PVT LTD-YESB310754 69094,,Transfer from EASEBUZZ PVT LTD NOD AL A/C,net_banking_transfer,5982.97
645df616f8804aea72c2e289,50200023535069,1754499.96,60ec41ba55c00300382672d9,HDFC,Transfer in/Revenue-other,5eecc6d6449e4f7cfb1c2708,2023-04-17T00:00:00.000Z,NEFT CR-ICIC0SF0002-WHITE WIZARD TECHNOL -SLICK ORGANICS PRIVATE LIMITED-31886517 231DC,,Transfer from WHITE WIZARD TECHNOL ,net_banking_transfer,81053.33
645df616f8804aea72c2e28b,50200023535069,1816838.66,60ec41ba55c00300382672d9,HDFC,Transfer in/Revenue-other,5eecc6d6449e4f7cfb1c2708,2023-04-17T00:00:00.000Z,NEFT CR-YESB0000001-EASEBUZZ PVT LTD NOD AL A/C-SLICK ORGANICS PVT LTD-YESB310754 96582,,Transfer from EASEBUZZ PVT LTD NOD AL A/C,net_banking_transfer,62338.7
645df616f8804aea72c2e28d,50200023535069,1792538.66,60ec41ba55c00300382672d9,HDFC,direct expenses,5eecc6d6449e4f7cfb1c2708,2023-04-17T00:00:00.000Z,50200056126662-TPT-24300-IRA LAW ATTORNE YS,,Transfer to IRA LAW ATTORNE YS,net_banking_transfer,-24300
645df616f8804aea72c2e28f,50200023535069,1795083.71,60ec41ba55c00300382672d9,HDFC,Transfer in/Revenue-other,5eecc6d6449e4f7cfb1c2708,2023-04-18T00:00:00.000Z,IMPS-310805825293-EXCRO PAY ESCROW ACC-Y ESB-XXXXXXXXXXX1807-333112298023,,Transfer from EXCRO PAY ESCROW ACC,net_banking_transfer,2545.05
645df616f8804aea72c2e292,50200023535069,1295083.71,60ec41ba55c00300382672d9,HDFC,Marketing Expense,5eecc6d6449e4f7cfb1c2708,2023-04-18T00:00:00.000Z,"NEFT DR-CITI0000006-FACEBOOK INDIA ONLIN E SERVICES PVT LTD-NETBANK, MUM-N1082324 22087173-500000",,Transfer to N1082324 22087173,net_banking_transfer,-500000
645df616f8804aea72c2e294,50200023535069,1253897.71,60ec41ba55c00300382672d9,HDFC,direct expenses,5eecc6d6449e4f7cfb1c2708,2023-04-18T00:00:00.000Z,50200056366495-TPT-41186-MJ ENTERPRISES,,Transfer to MJ ENTERPRISES,net_banking_transfer,-41186
645df616f8804aea72c2e296,50200023535069,1258847.1,60ec41ba55c00300382672d9,HDFC,Revenue-PG-split enabled,5eecc6d6449e4f7cfb1c2708,2023-04-18T00:00:00.000Z,NEFT CR-UTIB0001506-RAZORPAY SOFTWARE PR IVATE LIMITED --SLICK ORGANICS PVT LITD- AXISCN0237099282,,Transfer from RAZORPAY SOFTWARE PR IVATE LIMITED ,net_banking_transfer,4949.39
645df616f8804aea72c2e298,50200023535069,998504.1,60ec41ba55c00300382672d9,HDFC,direct expenses,5eecc6d6449e4f7cfb1c2708,2023-04-18T00:00:00.000Z,"NEFT DR-HSBC0560002-FLIPKART INTERNET PV T LTD-NETBANK, MUM-N108232422302588-2603 43",shopping,Transfer to N108232422302588,net_banking_transfer,-260343
645df616f8804aea72c2e29a,50200023535069,996704.1,60ec41ba55c00300382672d9,HDFC,direct expenses,5eecc6d6449e4f7cfb1c2708,2023-04-18T00:00:00.000Z,"NEFT DR-IDFB0080172-VOLOPAY INDIA PVT LT D-NETBANK, MUM-N108232422303859-1800",,Transfer to N108232422303859,net_banking_transfer,-1800
645df616f8804aea72c2e29c,50200023535069,995642.1,60ec41ba55c00300382672d9,HDFC,direct expenses,5eecc6d6449e4f7cfb1c2708,2023-04-18T00:00:00.000Z,POS 514834XXXXXX0472 PAYTM_PAYTMADDMO,ewallet,Transfer to PAYTM_PAYTMADDMO,debit_card,-1062
645df616f8804aea72c2e29e,50200023535069,965642.1,60ec41ba55c00300382672d9,HDFC,direct expenses,5eecc6d6449e4f7cfb1c2708,2023-04-18T00:00:00.000Z,50100156544069-TPT-30000-VISHAL AGGARWAL HUF,,Transfer to VISHAL AGGARWAL HUF,net_banking_transfer,-30000
645df616f8804aea72c2e2a0,50200023535069,970179.66,60ec41ba55c00300382672d9,HDFC,Transfer in/Revenue-other,5eecc6d6449e4f7cfb1c2708,2023-04-18T00:00:00.000Z,NEFT CR-UTIB0000114-ONE SIGMA TECHNOLOGI ES PRIVATE LIMI-SLICK ORGANICS PRIVATE L IMITED-AXISP00382567129,bnpl,Transfer from ONE SIGMA TECHNOLOGI ES PRIVATE LIMI,net_banking_transfer,4537.56
645df616f8804aea72c2e2a2,50200023535069,956006.44,60ec41ba55c00300382672d9,HDFC,OD/CC Repayment,5eecc6d6449e4f7cfb1c2708,2023-04-18T00:00:00.000Z,"NEFT DR-SBIN00CARDS-CC HEMANT GUPTA 1400 -NETBANK, MUM-N108232422398889-CREDIT CA RD HEMANT",,Transfer to N108232422398889,net_banking_transfer,-14173.22
645df616f8804aea72c2e2a5,50200023535069,966006.44,60ec41ba55c00300382672d9,HDFC,Transfer in/Revenue-other,5eecc6d6449e4f7cfb1c2708,2023-04-18T00:00:00.000Z,NEFT CR-UTIB0000540-DETLACMA PRIVATE LIM ITED-SLICK ORGANICS PVT LTD-AXIC23108352 7450,,Transfer from DETLACMA PRIVATE LIM ITED,net_banking_transfer,10000
645df616f8804aea72c2e2a7,50200023535069,955977.44,60ec41ba55c00300382672d9,HDFC,direct expenses,5eecc6d6449e4f7cfb1c2708,2023-04-18T00:00:00.000Z,"NEFT DR-YESB0000236-DELIGHT VACATION PVT LTD-NETBANK, MUM-N108232422508772-10029",,Transfer to N108232422508772,net_banking_transfer,-10029
645df616f8804aea72c2e2a9,50200023535069,959431.44,60ec41ba55c00300382672d9,HDFC,Revenue-Mktplace,5eecc6d6449e4f7cfb1c2708,2023-04-18T00:00:00.000Z,IMPS-310814940257-DREAMPLUGPAYTECHSO-UTI B-XXXXXXXXXXX7853-NA,,Transfer from DREAMPLUGPAYTECHSO,net_banking_transfer,3454
645df616f8804aea72c2e2ab,50200023535069,924431.44,60ec41ba55c00300382672d9,HDFC,direct expenses,5eecc6d6449e4f7cfb1c2708,2023-04-18T00:00:00.000Z,"NEFT DR-ICIC0002451-SOUTH COURT CONDOMIN IUM ASSOCIATION-NETBANK, MUM-N1082324225 32993-35000",,Transfer to N1082324225 32993,net_banking_transfer,-35000
645df616f8804aea72c2e2ad,50200023535069,964541.44,60ec41ba55c00300382672d9,HDFC,Revenue-Mktplace,5eecc6d6449e4f7cfb1c2708,2023-04-18T00:00:00.000Z,NEFT CR-SCBL0036001-DREAMPLUG TECHNOLOGI,,Transfer from DREAMPLUG TECHNOLOGI,net_banking_transfer,40110
645df616f8804aea72c2e2af,50200023535069,128772.44,60ec41ba55c00300382672d9,HDFC,Marketing Expense,5eecc6d6449e4f7cfb1c2708,2023-04-18T00:00:00.000Z,"NEFT DR-CITI0000006-FACEBOOK INDIA ONLIN E SERVICES PVT LTD-NETBANK, MUM-N1082324 22735552-835769",,Transfer to N1082324 22735552,net_banking_transfer,-835769
645df616f8804aea72c2e2b1,50200023535069,130479.24,60ec41ba55c00300382672d9,HDFC,Transfer in/Revenue-other,5eecc6d6449e4f7cfb1c2708,2023-04-18T00:00:00.000Z,EASEBUZZ PRIVA-A208180423PSP6ZM4YKQ,,,Other,1706.8
645df616f8804aea72c2e2b4,50200023535069,135554.84,60ec41ba55c00300382672d9,HDFC,Transfer in/Revenue-other,5eecc6d6449e4f7cfb1c2708,2023-04-18T00:00:00.000Z,NEFT CR-YESB0000001-EASEBUZZ PVT LTD NOD AL A/C-SLICK ORGANICS PVT LTD-YESB310881 02139,,Transfer from EASEBUZZ PVT LTD NOD AL A/C,net_banking_transfer,5075.6
645df616f8804aea72c2e2b6,50200023535069,200458.54,60ec41ba55c00300382672d9,HDFC,Transfer in/Revenue-other,5eecc6d6449e4f7cfb1c2708,2023-04-18T00:00:00.000Z,NEFT CR-YESB0000001-EASEBUZZ PVT LTD NOD AL A/C-SLICK ORGANICS PVT LTD-YESB310881 00333,,Transfer from EASEBUZZ PVT LTD NOD AL A/C,net_banking_transfer,64903.7
645df616f8804aea72c2e2b8,50200023535069,201191.87,60ec41ba55c00300382672d9,HDFC,Revenue-PG-split enabled,5eecc6d6449e4f7cfb1c2708,2023-04-18T00:00:00.000Z,NEFT CR-UTIB0001506-RAZORPAY SOFTWARE PR IVATE LIMITED --SLICK ORGANICS PVT LITD- AXISCN0237374244,,Transfer from RAZORPAY SOFTWARE PR IVATE LIMITED ,net_banking_transfer,733.33
645df616f8804aea72c2e2ba,50200023535069,10201191.87,60ec41ba55c00300382672d9,HDFC,Loan-in,5eecc6d6449e4f7cfb1c2708,2023-04-18T00:00:00.000Z,FT- TL007-50200029943037 - TRILLIONLOANS FINTECH PRIVATE LIMITED -,loans,lender_transaction,Other,10000000
645df616f8804aea72c2e2be,50200023535069,9711191.87,60ec41ba55c00300382672d9,HDFC,Marketing Expense,5eecc6d6449e4f7cfb1c2708,2023-04-18T00:00:00.000Z,"NEFT DR-CITI0000006-FACEBOOK INDIA ONLIN E SERVICES PVT LTD-NETBANK, MUM-N1082324 23253246-490000",,Transfer to N1082324 23253246,net_banking_transfer,-490000
645df616f8804aea72c2e2c0,50200023535069,9661191.87,60ec41ba55c00300382672d9,HDFC,direct expenses,5eecc6d6449e4f7cfb1c2708,2023-04-18T00:00:00.000Z,"NEFT DR-YESB0000551-VISTTA COSMETICS-NET BANK, MUM-N108232423254711-50000",,Transfer to N108232423254711,net_banking_transfer,-50000
645df616f8804aea72c2e2c2,50200023535069,9211191.87,60ec41ba55c00300382672d9,HDFC,direct expenses,5eecc6d6449e4f7cfb1c2708,2023-04-18T00:00:00.000Z,05892560000649-TPT-450000-DECORPAC INDIA PRIVATE LIMITED,,Transfer to DECORPAC INDIA PRIVATE LIMITED,net_banking_transfer,-450000
645df616f8804aea72c2e2c5,50200023535069,9212853.01,60ec41ba55c00300382672d9,HDFC,Transfer in/Revenue-other,5eecc6d6449e4f7cfb1c2708,2023-04-19T00:00:00.000Z,IMPS-310904955232-EXCRO PAY ESCROW ACC-Y ESB-XXXXXXXXXXX1807-333112298023,,Transfer from EXCRO PAY ESCROW ACC,net_banking_transfer,1661.14
645df616f8804aea72c2e2c8,50200023535069,9217406.02,60ec41ba55c00300382672d9,HDFC,Transfer in/Revenue-other,5eecc6d6449e4f7cfb1c2708,2023-04-19T00:00:00.000Z,IMPS-310907654601-EXCRO PAY ESCROW ACC-Y ESB-XXXXXXXXXXX1807-333112298023,,Transfer from EXCRO PAY ESCROW ACC,net_banking_transfer,4553.01
645df616f8804aea72c2e2ca,50200023535069,9225694.67,60ec41ba55c00300382672d9,HDFC,Revenue-Mktplace,5eecc6d6449e4f7cfb1c2708,2023-04-19T00:00:00.000Z,NEFT CR-DEUT0797BGL-MYNTRA DESIGNS PRIVA TE LIMITED-SLICK ORGANICS - SJIT-3109010 13GN00073,shopping,Transfer from MYNTRA DESIGNS PRIVA TE LIMITED,net_banking_transfer,8288.65
645df616f8804aea72c2e2cd,50200023535069,9227164.19,60ec41ba55c00300382672d9,HDFC,Revenue-Mktplace,5eecc6d6449e4f7cfb1c2708,2023-04-19T00:00:00.000Z,NEFT CR-DEUT0797BGL-MYNTRA DESIGNS PRIVA,shopping,Transfer from MYNTRA DESIGNS PRIVA,net_banking_transfer,1469.52
645df616f8804aea72c2e2cf,50200023535069,8810229.19,60ec41ba55c00300382672d9,HDFC,direct expenses,5eecc6d6449e4f7cfb1c2708,2023-04-19T00:00:00.000Z,"NEFT DR-ICIC0000369-BO INTERNATIONAL-NET BANK, MUM-N109232423953903-416935",,Transfer to N109232423953903,net_banking_transfer,-416935
645df616f8804aea72c2e2d1,50200023535069,8773379.19,60ec41ba55c00300382672d9,HDFC,direct expenses,5eecc6d6449e4f7cfb1c2708,2023-04-19T00:00:00.000Z,"NEFT DR-BKID0007124-MATRIX PRINTING SOLU TIONS PVT LTD-NETBANK, MUM-N109232423986 755-36850",,Transfer to N109232423986 755,net_banking_transfer,-36850
645df616f8804aea72c2e2d3,50200023535069,8664201.19,60ec41ba55c00300382672d9,HDFC,direct expenses,5eecc6d6449e4f7cfb1c2708,2023-04-19T00:00:00.000Z,00921000075586-TPT-109178-ROET BINDRA,,Transfer to ROET BINDRA,net_banking_transfer,-109178
645df616f8804aea72c2e2d5,50200023535069,8647461.19,60ec41ba55c00300382672d9,HDFC,direct expenses,5eecc6d6449e4f7cfb1c2708,2023-04-19T00:00:00.000Z,"NEFT DR-KKBK0000173-NITISH KUMAR MANDAL- NETBANK, MUM-N109232423993671-16740",,Transfer to N109232423993671,net_banking_transfer,-16740
645df616f8804aea72c2e2d7,50200023535069,8539461.19,60ec41ba55c00300382672d9,HDFC,direct expenses,5eecc6d6449e4f7cfb1c2708,2023-04-19T00:00:00.000Z,50200063961124-TPT-108000-BEYOND ADS,,Transfer to BEYOND ADS,net_banking_transfer,-108000
645df616f8804aea72c2e2d9,50200023535069,8304603.19,60ec41ba55c00300382672d9,HDFC,Marketing Expense,5eecc6d6449e4f7cfb1c2708,2023-04-19T00:00:00.000Z,"NEFT DR-CITI0100000-GOOGLE INDIA PVT LTD -NETBANK, MUM-N109232423982620-234858",,Transfer to N109232423982620,net_banking_transfer,-234858
645df616f8804aea72c2e2db,50200023535069,8064603.19,60ec41ba55c00300382672d9,HDFC,direct expenses,5eecc6d6449e4f7cfb1c2708,2023-04-19T00:00:00.000Z,"NEFT DR-IDFB0040101-ACTIVES ADDITIVES AP PLICATIONS LLP-NETBANK, MUM-N10923242398 2943-240000",,Transfer to N10923242398 2943,net_banking_transfer,-240000
645df616f8804aea72c2e2dd,50200023535069,7964603.19,60ec41ba55c00300382672d9,HDFC,Internal Transfers,5eecc6d6449e4f7cfb1c2708,2023-04-19T00:00:00.000Z,"NEFT DR-KKBK0000180-VEDIC COSMECEUTICALS PVT LTD-NETBANK, MUM-N109232424006299-1 00000",,Transfer to N109232424006299,net_banking_transfer,-100000
645df616f8804aea72c2e2df,50200023535069,7890263.19,60ec41ba55c00300382672d9,HDFC,direct expenses,5eecc6d6449e4f7cfb1c2708,2023-04-19T00:00:00.000Z,"NEFT DR-PUNB0062910-YADAVPACKAGING-NETBA NK, MUM-N109232423998486-74340",,Transfer to N109232423998486,net_banking_transfer,-74340
645df616f8804aea72c2e2e1,50200023535069,6317613.19,60ec41ba55c00300382672d9,HDFC,direct expenses,5eecc6d6449e4f7cfb1c2708,2023-04-19T00:00:00.000Z,"NEFT DR-RATN0VAAPIS-CR CARD COLLECTION P ARKING GL-NETBANK, MUM-N109232424022149- 1572650",,Transfer to N109232424022149,net_banking_transfer,-1572650
645df616f8804aea72c2e2e4,50200023535069,6315584.19,60ec41ba55c00300382672d9,HDFC,direct expenses,5eecc6d6449e4f7cfb1c2708,2023-04-19T00:00:00.000Z,ME DC SI 514834XXXXXX0472 ADOBE SYSTEMS SOFTWARE,,,Other,-2029
645df616f8804aea72c2e2e6,50200023535069,4051959.19,60ec41ba55c00300382672d9,HDFC,Marketing Expense,5eecc6d6449e4f7cfb1c2708,2023-04-19T00:00:00.000Z,"NEFT DR-CITI0000006-FACEBOOK INDIA ONLIN E SERVICES PVT LTD-NETBANK, MUM-N1092324 24065479-2263625",,Transfer to N1092324 24065479,net_banking_transfer,-2263625
645df616f8804aea72c2e2e9,50200023535069,3951959.19,60ec41ba55c00300382672d9,HDFC,direct expenses,5eecc6d6449e4f7cfb1c2708,2023-04-19T00:00:00.000Z,57500001065314-TPT-100000-KRAUTER HEALTH CARE LTD,,Transfer to KRAUTER HEALTH CARE LTD,net_banking_transfer,-100000
645df616f8804aea72c2e2eb,50200023535069,3876959.19,60ec41ba55c00300382672d9,HDFC,direct expenses,5eecc6d6449e4f7cfb1c2708,2023-04-19T00:00:00.000Z,NEFT DR-BARB0VJMATU-ARTISTO DESIGNZ-NETB,,Transfer to ARTISTO DESIGNZ,net_banking_transfer,-75000
645df617f8804aea72c2e2ed,50200023535069,3801959.19,60ec41ba55c00300382672d9,HDFC,direct expenses,5eecc6d6449e4f7cfb1c2708,2023-04-19T00:00:00.000Z,"NEFT DR-KKBK0005289-HILL GROOVE CONSULTI NG LLP-NETBANK, MUM-N109232424100484-750 00",,Transfer to N109232424100484,net_banking_transfer,-75000
645df617f8804aea72c2e2ef,50200023535069,3726959.19,60ec41ba55c00300382672d9,HDFC,direct expenses,5eecc6d6449e4f7cfb1c2708,2023-04-19T00:00:00.000Z,50200063349422-TPT-75000-COHORT E-COMMER CE CONSULTING LLP,,Transfer to COMMER CE CONSULTING LLP,net_banking_transfer,-75000
645df617f8804aea72c2e2f1,50200023535069,3699959.19,60ec41ba55c00300382672d9,HDFC,direct expenses,5eecc6d6449e4f7cfb1c2708,2023-04-19T00:00:00.000Z,"NEFT DR-CNRB0015170-SNEHAL TAYDE-NETBANK , MUM-N109232424116700-27000",,Transfer to N109232424116700,net_banking_transfer,-27000
645df617f8804aea72c2e2f3,50200023535069,3645959.19,60ec41ba55c00300382672d9,HDFC,direct expenses,5eecc6d6449e4f7cfb1c2708,2023-04-19T00:00:00.000Z,50200054531492-TPT-54000-ALETA PEOPLE SE RVICES,,Transfer to ALETA PEOPLE SE RVICES,net_banking_transfer,-54000
645df617f8804aea72c2e2f5,50200023535069,3545959.19,60ec41ba55c00300382672d9,HDFC,direct expenses,5eecc6d6449e4f7cfb1c2708,2023-04-19T00:00:00.000Z,"NEFT DR-KKBK0001381-BLC AND ASSOCIATES L LP-NETBANK, MUM-N109232424130423-100000",,Transfer to N109232424130423,net_banking_transfer,-100000
645df617f8804aea72c2e2f7,50200023535069,3470959.19,60ec41ba55c00300382672d9,HDFC,direct expenses,5eecc6d6449e4f7cfb1c2708,2023-04-19T00:00:00.000Z,50200032200524-TPT-75000-IRA LAW,,Transfer to IRA LAW,net_banking_transfer,-75000
645df617f8804aea72c2e2f9,50200023535069,2970959.19,60ec41ba55c00300382672d9,HDFC,Tax,5eecc6d6449e4f7cfb1c2708,2023-04-19T00:00:00.000Z,CBDT/BANK REFERENCE NO:K2310900601651/CI N NO:23041900054401HDFC/ONLINE,,,Other,-500000
645df617f8804aea72c2e2fb,50200023535069,2970027.19,60ec41ba55c00300382672d9,HDFC,direct expenses,5eecc6d6449e4f7cfb1c2708,2023-04-19T00:00:00.000Z,POS 514834XXXXXX0472 SMARTSHIFT LOGIS,,Transfer to SMARTSHIFT LOGIS,debit_card,-932
645df617f8804aea72c2e2fd,50200023535069,2975562.19,60ec41ba55c00300382672d9,HDFC,Transfer in/Revenue-other,5eecc6d6449e4f7cfb1c2708,2023-04-19T00:00:00.000Z,NEFT CR-KKBK0000958-FDM DIGITAL SOLUTION S PRIVATE LIMIT-SLICK ORGANICS PRIVATE L IMITED-KKBKH23109608863,,Transfer from FDM DIGITAL SOLUTION S PRIVATE LIMIT,net_banking_transfer,5535
645df617f8804aea72c2e2ff,50200023535069,2976696.58,60ec41ba55c00300382672d9,HDFC,Transfer in/Revenue-other,5eecc6d6449e4f7cfb1c2708,2023-04-19T00:00:00.000Z,NEFT CR-UTIB0000114-ONE SIGMA TECHNOLOGI ES PRIVATE LIMI-SLICK ORGANICS PRIVATE L IMITED-AXISP00382815215,bnpl,Transfer from ONE SIGMA TECHNOLOGI ES PRIVATE LIMI,net_banking_transfer,1134.39
645df617f8804aea72c2e301,50200023535069,2941696.58,60ec41ba55c00300382672d9,HDFC,direct expenses,5eecc6d6449e4f7cfb1c2708,2023-04-19T00:00:00.000Z,"NEFT DR-ICIC0006643-KRISHNA PACKAGING CO MPANY-NETBANK, MUM-N109232424380675-3500 0",,Transfer to N109232424380675,net_banking_transfer,-35000
645df617f8804aea72c2e303,50200023535069,2791696.58,60ec41ba55c00300382672d9,HDFC,direct expenses,5eecc6d6449e4f7cfb1c2708,2023-04-19T00:00:00.000Z,"NEFT DR-UBIN0820296-HITESH ARORA-NETBANK , MUM-N109232424386453-150000",,Transfer to N109232424386453,net_banking_transfer,-150000
645df617f8804aea72c2e305,50200023535069,2691696.58,60ec41ba55c00300382672d9,HDFC,direct expenses,5eecc6d6449e4f7cfb1c2708,2023-04-19T00:00:00.000Z,IB FUNDS TRANSFER DR-50200050976833 -SL ICK ORGANICS PVT LTD,,Transfer to SL ICK ORGANICS PVT LTD,net_banking_transfer,-100000
645df617f8804aea72c2e308,50200023535069,2693691.58,60ec41ba55c00300382672d9,HDFC,Revenue-Mktplace,5eecc6d6449e4f7cfb1c2708,2023-04-19T00:00:00.000Z,IMPS-310914042608-DREAMPLUGPAYTECHSO-UTI B-XXXXXXXXXXX7853-NA,,Transfer from DREAMPLUGPAYTECHSO,net_banking_transfer,1995
645df617f8804aea72c2e30b,50200023535069,2693692.58,60ec41ba55c00300382672d9,HDFC,Transfer in/Revenue-other,5eecc6d6449e4f7cfb1c2708,2023-04-19T00:00:00.000Z,NEFT CR-ICIC0SF0002-WHITE WIZARD TECHNOL,,Transfer from WHITE WIZARD TECHNOL,net_banking_transfer,1
645df617f8804aea72c2e30e,50200023535069,2693693.58,60ec41ba55c00300382672d9,HDFC,Transfer in/Revenue-other,5eecc6d6449e4f7cfb1c2708,2023-04-19T00:00:00.000Z,NEFT CR-ICIC0SF0002-WHITE WIZARD TECHNOL -SLICK ORGANICS PRIVATE LIMITED-31907569 671DC,,Transfer from WHITE WIZARD TECHNOL ,net_banking_transfer,1
645df617f8804aea72c2e310,50200023535069,2692494.58,60ec41ba55c00300382672d9,HDFC,direct expenses,5eecc6d6449e4f7cfb1c2708,2023-04-19T00:00:00.000Z,ME DC SI 514834XXXXXX0472 FRESHWORKS INC,,,Other,-1199
645df617f8804aea72c2e312,50200023535069,2691141.58,60ec41ba55c00300382672d9,HDFC,direct expenses,5eecc6d6449e4f7cfb1c2708,2023-04-19T00:00:00.000Z,POS 514834XXXXXX0472 ADOBE ACROPRO TR,,Transfer to ADOBE ACROPRO TR,debit_card,-1353
645df617f8804aea72c2e314,50200023535069,2693886.67,60ec41ba55c00300382672d9,HDFC,Transfer in/Revenue-other,5eecc6d6449e4f7cfb1c2708,2023-04-19T00:00:00.000Z,EASEBUZZ PRIVA-A241190423PSG4YGQE3E,,,Other,2745.09
645df617f8804aea72c2e317,50200023535069,2694346.67,60ec41ba55c00300382672d9,HDFC,cash/cheque deposit/transfer in,5eecc6d6449e4f7cfb1c2708,2023-04-19T00:00:00.000Z,CHQ DEP - TRANSFER OW 1 - NOIDA WBO,,,chq,460
645df617f8804aea72c2e319,50200023535069,2745755.09,60ec41ba55c00300382672d9,HDFC,Transfer in/Revenue-other,5eecc6d6449e4f7cfb1c2708,2023-04-19T00:00:00.000Z,NEFT CR-YESB0000001-EASEBUZZ PVT LTD NOD AL A/C-SLICK ORGANICS PVT LTD-YESB310906 60039,,Transfer from EASEBUZZ PVT LTD NOD AL A/C,net_banking_transfer,51408.42
645df617f8804aea72c2e31c,50200023535069,2748658.5,60ec41ba55c00300382672d9,HDFC,Transfer in/Revenue-other,5eecc6d6449e4f7cfb1c2708,2023-04-19T00:00:00.000Z,NEFT CR-YESB0000001-EASEBUZZ PVT LTD NOD AL A/C-SLICK ORGANICS PVT LTD-YESB310906 60381,,Transfer from EASEBUZZ PVT LTD NOD AL A/C,net_banking_transfer,2903.41
645df617f8804aea72c2e31e,50200023535069,2748745.97,60ec41ba55c00300382672d9,HDFC,Revenue-PG-split enabled,5eecc6d6449e4f7cfb1c2708,2023-04-19T00:00:00.000Z,NEFT CR-UTIB0001506-RAZORPAY SOFTWARE PR IVATE LIMITED --SLICK ORGANICS PVT LITD- AXISCN0237890410,,Transfer from RAZORPAY SOFTWARE PR IVATE LIMITED ,net_banking_transfer,87.47
645df617f8804aea72c2e320,50200023535069,2749001.7,60ec41ba55c00300382672d9,HDFC,Revenue-PG-split enabled,5eecc6d6449e4f7cfb1c2708,2023-04-20T00:00:00.000Z,NEFT CR-UTIB0001506-RAZORPAY SOFTWARE PR IVATE LIMITED --SLICK ORGANICS PVT LITD- AXISCN0238033433,,Transfer from RAZORPAY SOFTWARE PR IVATE LIMITED ,net_banking_transfer,255.73
645df617f8804aea72c2e322,50200023535069,2739001.7,60ec41ba55c00300382672d9,HDFC,Refund,5eecc6d6449e4f7cfb1c2708,2023-04-20T00:00:00.000Z,"NEFT DR-RATN0VAAPIS-RAZORPAY REFUND CRED ITS TOPUP-NETBANK, MUM-N110232425530808- 10000",,Transfer to N110232425530808,net_banking_transfer,-10000
645df617f8804aea72c2e325,50200023535069,2741837.66,60ec41ba55c00300382672d9,HDFC,Transfer in/Revenue-other,5eecc6d6449e4f7cfb1c2708,2023-04-20T00:00:00.000Z,NEFT CR-UTIB0000114-ONE SIGMA TECHNOLOGI ES PRIVATE LIMI-SLICK ORGANICS PRIVATE L IMITED-AXISP00383097828,bnpl,Transfer from ONE SIGMA TECHNOLOGI ES PRIVATE LIMI,net_banking_transfer,2835.96
645df617f8804aea72c2e328,50200023535069,2737804.67,60ec41ba55c00300382672d9,HDFC,direct expenses,5eecc6d6449e4f7cfb1c2708,2023-04-20T00:00:00.000Z,POS 514834XXXXXX0472 WWW.FAQPRIME.COM,,Transfer to WWW.FAQPRIME.COM,debit_card,-4032.99
645df617f8804aea72c2e32a,50200023535069,2707804.67,60ec41ba55c00300382672d9,HDFC,Marketing Expense,5eecc6d6449e4f7cfb1c2708,2023-04-20T00:00:00.000Z,"NEFT DR-CITI0000006-FACEBOOK INDIA ONLIN E SERVICES PVT LTD-NETBANK, MUM-N1102324 25774746-30000",,Transfer to N1102324 25774746,net_banking_transfer,-30000
645df617f8804aea72c2e32d,50200023535069,2714241.17,60ec41ba55c00300382672d9,HDFC,Revenue-Mktplace,5eecc6d6449e4f7cfb1c2708,2023-04-20T00:00:00.000Z,IMPS-311014103011-DREAMPLUGPAYTECHSO-UTI B-XXXXXXXXXXX7853-NA,,Transfer from DREAMPLUGPAYTECHSO,net_banking_transfer,6436.5
645df617f8804aea72c2e32f,50200023535069,2712241.17,60ec41ba55c00300382672d9,HDFC,direct expenses,5eecc6d6449e4f7cfb1c2708,2023-04-20T00:00:00.000Z,POS 514834XXXXXX0472 SMARTSHIFT LOGIS,,Transfer to SMARTSHIFT LOGIS,debit_card,-2000
645df617f8804aea72c2e331,50200023535069,2711932.17,60ec41ba55c00300382672d9,HDFC,direct expenses,5eecc6d6449e4f7cfb1c2708,2023-04-20T00:00:00.000Z,POS 514834XXXXXX0472 SMARTSHIFT LOGIS,,Transfer to SMARTSHIFT LOGIS,debit_card,-309
645df617f8804aea72c2e333,50200023535069,2709786.17,60ec41ba55c00300382672d9,HDFC,direct expenses,5eecc6d6449e4f7cfb1c2708,2023-04-20T00:00:00.000Z,POS 514834XXXXXX0472 SMARTSHIFT LOGIS,,Transfer to SMARTSHIFT LOGIS,debit_card,-2146
645df617f8804aea72c2e335,50200023535069,2711820.17,60ec41ba55c00300382672d9,HDFC,Revenue-Mktplace,5eecc6d6449e4f7cfb1c2708,2023-04-20T00:00:00.000Z,NEFT CR-ICIC0000105-MANASH LIFETYLE PVT LTD-SLICK ORGANICS PRIVATE LIMITED-ICIB2 31100041414,,Transfer from MANASH LIFETYLE PVT LTD,net_banking_transfer,2034
645df617f8804aea72c2e337,50200023535069,2712501.14,60ec41ba55c00300382672d9,HDFC,Revenue-PG-split enabled,5eecc6d6449e4f7cfb1c2708,2023-04-20T00:00:00.000Z,NEFT CR-UTIB0001506-RAZORPAY SOFTWARE PR IVATE LIMITED --SLICK ORGANICS PVT LITD- AXISCN0238323885,,Transfer from RAZORPAY SOFTWARE PR IVATE LIMITED ,net_banking_transfer,680.97
645df617f8804aea72c2e33b,50200023535069,2713672.28,60ec41ba55c00300382672d9,HDFC,Transfer in/Revenue-other,5eecc6d6449e4f7cfb1c2708,2023-04-20T00:00:00.000Z,NEFT CR-YESB0000001-EASEBUZZ PVT LTD NOD AL A/C-SLICK ORGANICS PVT LTD-YESB311030 95287,,Transfer from EASEBUZZ PVT LTD NOD AL A/C,net_banking_transfer,1171.14
645df617f8804aea72c2e33d,50200023535069,2743777.38,60ec41ba55c00300382672d9,HDFC,Transfer in/Revenue-other,5eecc6d6449e4f7cfb1c2708,2023-04-20T00:00:00.000Z,NEFT CR-YESB0000001-EASEBUZZ PVT LTD NOD AL A/C-SLICK ORGANICS PVT LTD-YESB311031 19622,,Transfer from EASEBUZZ PVT LTD NOD AL A/C,net_banking_transfer,30105.1
645df617f8804aea72c2e33f,50200023535069,2695177.38,60ec41ba55c00300382672d9,HDFC,direct expenses,5eecc6d6449e4f7cfb1c2708,2023-04-20T00:00:00.000Z,00918630000430-TPT-48600-UNICOMMERCE ESO LUTIONS PRIVATE LIMITED,,Transfer to UNICOMMERCE ESO LUTIONS PRIVATE LIMITED,net_banking_transfer,-48600
645df617f8804aea72c2e34f,50200023535069,2687977.38,60ec41ba55c00300382672d9,HDFC,direct expenses,5eecc6d6449e4f7cfb1c2708,2023-04-20T00:00:00.000Z,50100230430690-TPT-7200-HARSHITA MODI,,Transfer to HARSHITA MODI,net_banking_transfer,-7200
645df617f8804aea72c2e368,50200023535069,2786506.28,60ec41ba55c00300382672d9,HDFC,Revenue-Mktplace,5eecc6d6449e4f7cfb1c2708,2023-04-21T00:00:00.000Z,IMPS-311101009412-AMAZON SELLER SERVIC-H SBC-XXXXXXXX6004-4WOBVWH5I2SKWBTUSLICK O RGANICS PVT LTD,shopping,Transfer from AMAZON SELLER SERVIC,net_banking_transfer,98528.9
645df617f8804aea72c2e388,50200023535069,3067489.95,60ec41ba55c00300382672d9,HDFC,Revenue-Mktplace,5eecc6d6449e4f7cfb1c2708,2023-04-21T00:00:00.000Z,NEFT CR-DEUT0797BGL-INTERNAL AC FOR INTE RMEDIERY- AMAZON SELLER SERVIC-SLICK ORG ANICS PVT LTD-311100107GN00007,shopping,Transfer from INTERNAL AC FOR INTE RMEDIERY,net_banking_transfer,280983.67
645df617f8804aea72c2e398,50200023535069,3068907.22,60ec41ba55c00300382672d9,HDFC,Transfer in/Revenue-other,5eecc6d6449e4f7cfb1c2708,2023-04-21T00:00:00.000Z,IMPS-311103805260-EXCRO PAY ESCROW ACC-Y ESB-XXXXXXXXXXX1807-333112298023,,Transfer from EXCRO PAY ESCROW ACC,net_banking_transfer,1417.27
645df617f8804aea72c2e3a3,50200023535069,3072197.92,60ec41ba55c00300382672d9,HDFC,Transfer in/Revenue-other,5eecc6d6449e4f7cfb1c2708,2023-04-21T00:00:00.000Z,IMPS-311107900991-EXCRO PAY ESCROW ACC-Y ESB-XXXXXXXXXXX1807-333112298023,,Transfer from EXCRO PAY ESCROW ACC,net_banking_transfer,3290.7
645df617f8804aea72c2e3b0,50200023535069,3075740.5,60ec41ba55c00300382672d9,HDFC,Revenue-Mktplace,5eecc6d6449e4f7cfb1c2708,2023-04-21T00:00:00.000Z,NEFT CR-DEUT0797BGL-MYNTRA DESIGNS PRIVA,shopping,Transfer from MYNTRA DESIGNS PRIVA,net_banking_transfer,3542.58
645df617f8804aea72c2e3c2,50200023535069,3077090.89,60ec41ba55c00300382672d9,HDFC,Revenue-PG-split enabled,5eecc6d6449e4f7cfb1c2708,2023-04-21T00:00:00.000Z,NEFT CR-UTIB0001506-RAZORPAY SOFTWARE PR IVATE LIMITED --SLICK ORGANICS PVT LITD- AXISCN0238641811,,Transfer from RAZORPAY SOFTWARE PR IVATE LIMITED ,net_banking_transfer,1350.39
645df617f8804aea72c2e3c7,50200023535069,3078786.88,60ec41ba55c00300382672d9,HDFC,Transfer in/Revenue-other,5eecc6d6449e4f7cfb1c2708,2023-04-21T00:00:00.000Z,NEFT CR-UTIB0000114-ONE SIGMA TECHNOLOGI ES PRIVATE LIMI-SLICK ORGANICS PRIVATE L IMITED-AXISP00383355593,bnpl,Transfer from ONE SIGMA TECHNOLOGI ES PRIVATE LIMI,net_banking_transfer,1695.99
645df617f8804aea72c2e3d2,50200023535069,3077658.88,60ec41ba55c00300382672d9,HDFC,direct expenses,5eecc6d6449e4f7cfb1c2708,2023-04-21T00:00:00.000Z,POS 514834XXXXXX0472 SMARTSHIFT LOGIS,,Transfer to SMARTSHIFT LOGIS,debit_card,-1128
645df617f8804aea72c2e3df,50200023535069,2835658.88,60ec41ba55c00300382672d9,HDFC,direct expenses,5eecc6d6449e4f7cfb1c2708,2023-04-21T00:00:00.000Z,"NEFT DR-IDFB0040101-GETVANTAGE PROFECTUS COLLECTION ESCROW A-NETBANK, MUM-N11123 2427212243-SLICK ORGANICS PVT",loans,lender_transaction,net_banking_transfer,-242000
645df617f8804aea72c2e3e7,50200023535069,2694658.88,60ec41ba55c00300382672d9,HDFC,direct expenses,5eecc6d6449e4f7cfb1c2708,2023-04-21T00:00:00.000Z,"NEFT DR-IDFB0040101-GETVANTAGE PROFECTUS COLLECTION ESCROW A-NETBANK, MUM-N11123 2427193145-SLICK ORGANICS PVT",loans,lender_transaction,net_banking_transfer,-141000
645df617f8804aea72c2e3e9,50200023535069,2778866.58,60ec41ba55c00300382672d9,HDFC,Transfer in/Revenue-other,5eecc6d6449e4f7cfb1c2708,2023-04-21T00:00:00.000Z,NEFT CR-YESB0000001-EXCRO PAY ESCROW ACC OUNT-SLICKORGANICSPRIVATELIMITED-YESB311 15010025,,Transfer from EXCRO PAY ESCROW ACC OUNT,net_banking_transfer,84207.7
645df617f8804aea72c2e3eb,50200023535069,2782617.68,60ec41ba55c00300382672d9,HDFC,Revenue-Mktplace,5eecc6d6449e4f7cfb1c2708,2023-04-21T00:00:00.000Z,IMPS-311114310087-DREAMPLUGPAYTECHSO-UTI B-XXXXXXXXXXX7853-NA,,Transfer from DREAMPLUGPAYTECHSO,net_banking_transfer,3751.1
645df617f8804aea72c2e3ed,50200023535069,2782284.68,60ec41ba55c00300382672d9,HDFC,direct expenses,5eecc6d6449e4f7cfb1c2708,2023-04-21T00:00:00.000Z,POS 514834XXXXXX0472 SMARTSHIFT LOGIS,,Transfer to SMARTSHIFT LOGIS,debit_card,-333
645df617f8804aea72c2e3ef,50200023535069,2782536.53,60ec41ba55c00300382672d9,HDFC,Revenue-PG-split enabled,5eecc6d6449e4f7cfb1c2708,2023-04-21T00:00:00.000Z,NEFT CR-UTIB0001506-RAZORPAY SOFTWARE PR IVATE LIMITED --SLICK ORGANICS PVT LITD- AXISCN0238858008,,Transfer from RAZORPAY SOFTWARE PR IVATE LIMITED ,net_banking_transfer,251.85
645df618f8804aea72c2e3f1,50200023535069,2784702.53,60ec41ba55c00300382672d9,HDFC,Revenue-Mktplace,5eecc6d6449e4f7cfb1c2708,2023-04-21T00:00:00.000Z,NEFT CR-ICIC0000105-MANASH LIFESTYLE PRI VATE LIMITED NO-SLICK ORGANICS PRIVATE L IMITED-ICIJ231110005068,shopping,Transfer from MANASH LIFESTYLE PRI VATE LIMITED NO,net_banking_transfer,2166
645df618f8804aea72c2e3f3,50200023535069,2785873.67,60ec41ba55c00300382672d9,HDFC,Transfer in/Revenue-other,5eecc6d6449e4f7cfb1c2708,2023-04-21T00:00:00.000Z,NEFT CR-YESB0000001-EASEBUZZ PVT LTD NOD AL A/C-SLICK ORGANICS PVT LTD-YESB311152 27009,,Transfer from EASEBUZZ PVT LTD NOD AL A/C,net_banking_transfer,1171.14
645df618f8804aea72c2e3f5,50200023535069,2843385.71,60ec41ba55c00300382672d9,HDFC,Transfer in/Revenue-other,5eecc6d6449e4f7cfb1c2708,2023-04-21T00:00:00.000Z,NEFT CR-YESB0000001-EASEBUZZ PVT LTD NOD AL A/C-SLICK ORGANICS PVT LTD-YESB311152,,Transfer from EASEBUZZ PVT LTD NOD AL A/C,net_banking_transfer,57512.04
645df618f8804aea72c2e3f7,50200023535069,3175705.56,60ec41ba55c00300382672d9,HDFC,Investments-New,5eecc6d6449e4f7cfb1c2708,2023-04-21T00:00:00.000Z,RTGS CR-HSBC0400002-MOONSTONE VENTURES L LP-SLICK ORGANICS PRIVATE LIMITED-HSBCR2 2023042119948489,,Transfer from MOONSTONE VENTURES L LP,net_banking_transfer,332319.85
645df618f8804aea72c2e3f9,50200023535069,3145705.56,60ec41ba55c00300382672d9,HDFC,Marketing Expense,5eecc6d6449e4f7cfb1c2708,2023-04-22T00:00:00.000Z,NEFT DR-CITI0000006-FACEBOOK INDIA ONLIN E SERVICES PVT LTD-SANDOZ - MUM-N1122324 28105347-NET BANKING SI -30000,,Transfer to NET BANKING SI ,net_banking_transfer,-30000
645df618f8804aea72c2e3fb,50200023535069,3147104.56,60ec41ba55c00300382672d9,HDFC,Transfer in/Revenue-other,5eecc6d6449e4f7cfb1c2708,2023-04-22T00:00:00.000Z,IMPS-311204739537-EXCRO PAY ESCROW ACC-Y ESB-XXXXXXXXXXX1807-333112298023,,Transfer from EXCRO PAY ESCROW ACC,net_banking_transfer,1399
645df618f8804aea72c2e3fd,50200023535069,3047104.56,60ec41ba55c00300382672d9,HDFC,Salary/Emp/consultant Expense,5eecc6d6449e4f7cfb1c2708,2023-04-22T00:00:00.000Z,"NEFT DR-SCBL0036025-DHRUV MADHOK-NETBANK , MUM-N112232428270941-SALARY OF APRIL 2 3",,Transfer to N112232428270941,net_banking_transfer,-100000
645df618f8804aea72c2e3ff,50200023535069,2947104.56,60ec41ba55c00300382672d9,HDFC,direct expenses,5eecc6d6449e4f7cfb1c2708,2023-04-22T00:00:00.000Z,02711930004579-TPT-100000-DHRUV BHASIN,,Transfer to DHRUV BHASIN,net_banking_transfer,-100000
645df618f8804aea72c2e401,50200023535069,2946158.56,60ec41ba55c00300382672d9,HDFC,direct expenses,5eecc6d6449e4f7cfb1c2708,2023-04-22T00:00:00.000Z,POS 514834XXXXXX0472 SMARTSHIFT LOGIS,,Transfer to SMARTSHIFT LOGIS,debit_card,-946
645df618f8804aea72c2e403,50200023535069,2973457.32,60ec41ba55c00300382672d9,HDFC,Revenue-Mktplace,5eecc6d6449e4f7cfb1c2708,2023-04-22T00:00:00.000Z,IMPS-311220287370-AMAZON SELLER SERVIC-H SBC-XXXXXXXX6004-1RN0CBL8ORI506CYSLICK O RGANICS PVT LTD,shopping,Transfer from AMAZON SELLER SERVIC,net_banking_transfer,27298.76
645df618f8804aea72c2e406,50200023535069,2943457.32,60ec41ba55c00300382672d9,HDFC,Marketing Expense,5eecc6d6449e4f7cfb1c2708,2023-04-23T00:00:00.000Z,NEFT DR-CITI0000006-FACEBOOK INDIA ONLIN E SERVICES PVT LTD-SANDOZ - MUM-N1132324 28596332-NET BANKING SI -30000,,Transfer to NET BANKING SI ,net_banking_transfer,-30000
645df618f8804aea72c2e408,50200023535069,3010108.38,60ec41ba55c00300382672d9,HDFC,Revenue-Mktplace,5eecc6d6449e4f7cfb1c2708,2023-04-23T00:00:00.000Z,NEFT CR-DEUT0797BGL-INTERNAL AC FOR INTE RMEDIERY- AMAZON SELLER SERVIC-SLICK ORG ANICS PVT LTD-311201016GN00003,shopping,Transfer from INTERNAL AC FOR INTE RMEDIERY,net_banking_transfer,66651.06
645df618f8804aea72c2e40a,50200023535069,3015359.51,60ec41ba55c00300382672d9,HDFC,Revenue-Mktplace,5eecc6d6449e4f7cfb1c2708,2023-04-23T00:00:00.000Z,IMPS-311319388039-AMAZON SELLER SERVIC-H SBC-XXXXXXXX6004-2DETRF9A4OSR0CW5SLICK O RGANICS PVT LTD,shopping,Transfer from AMAZON SELLER SERVIC,net_banking_transfer,5251.13
645df618f8804aea72c2e40c,50200023535069,3078654.87,60ec41ba55c00300382672d9,HDFC,Revenue-Mktplace,5eecc6d6449e4f7cfb1c2708,2023-04-24T00:00:00.000Z,NEFT CR-DEUT0797BGL-INTERNAL AC FOR INTE RMEDIERY- AMAZON SELLER SERVIC-SLICK ORG ANICS PVT LTD-311301103GN00006,shopping,Transfer from INTERNAL AC FOR INTE RMEDIERY,net_banking_transfer,63295.36
645df618f8804aea72c2e40e,50200023535069,3079362.84,60ec41ba55c00300382672d9,HDFC,Transfer in/Revenue-other,5eecc6d6449e4f7cfb1c2708,2023-04-24T00:00:00.000Z,IMPS-311403608118-EXCRO PAY ESCROW ACC-Y ESB-XXXXXXXXXXX1807-333112298023,,Transfer from EXCRO PAY ESCROW ACC,net_banking_transfer,707.97
645df618f8804aea72c2e410,50200023535069,3065501.84,60ec41ba55c00300382672d9,HDFC,direct expenses,5eecc6d6449e4f7cfb1c2708,2023-04-24T00:00:00.000Z,POS 514834XXXXXX0472 PAYTM PAYMENTS S,ewallet,Transfer to PAYTM PAYMENTS S,debit_card,-13861
645df618f8804aea72c2e412,50200023535069,3069772.7,60ec41ba55c00300382672d9,HDFC,Transfer in/Revenue-other,5eecc6d6449e4f7cfb1c2708,2023-04-24T00:00:00.000Z,NEFT CR-YESB0000001-EXCRO PAY ESCROW ACC OUNT-SLICKORGANICSPRIVATELIMITED-YESB311 40330709,,Transfer from EXCRO PAY ESCROW ACC OUNT,net_banking_transfer,4270.86
645df618f8804aea72c2e414,50200023535069,3073678.11,60ec41ba55c00300382672d9,HDFC,Revenue-PG-split enabled,5eecc6d6449e4f7cfb1c2708,2023-04-24T00:00:00.000Z,NEFT CR-UTIB0001506-RAZORPAY SOFTWARE PR IVATE LIMITED --SLICK ORGANICS PVT LITD- AXISCN0239685336,,Transfer from RAZORPAY SOFTWARE PR IVATE LIMITED ,net_banking_transfer,3905.41
645df618f8804aea72c2e416,50200023535069,3082020.26,60ec41ba55c00300382672d9,HDFC,Revenue-Mktplace,5eecc6d6449e4f7cfb1c2708,2023-04-24T00:00:00.000Z,NEFT CR-DEUT0797BGL-MYNTRA DESIGNS PRIVA TE LIMITED-SLICK ORGANICS - SJIT-3114010 31GN00197,shopping,Transfer from MYNTRA DESIGNS PRIVA TE LIMITED,net_banking_transfer,8342.15
645df618f8804aea72c2e418,50200023535069,3081295.26,60ec41ba55c00300382672d9,HDFC,direct expenses,5eecc6d6449e4f7cfb1c2708,2023-04-24T00:00:00.000Z,50100312215410-TPT-725-VINIT VINI,,Transfer to VINIT VINI,net_banking_transfer,-725
645df618f8804aea72c2e41a,50200023535069,3078901.04,60ec41ba55c00300382672d9,HDFC,direct expenses,5eecc6d6449e4f7cfb1c2708,2023-04-24T00:00:00.000Z,ME DC SI 514834XXXXXX0472 ADOBE SYSTEMS SOFTWARE,,,Other,-2394.22
645df618f8804aea72c2e41c,50200023535069,3077976.04,60ec41ba55c00300382672d9,HDFC,direct expenses,5eecc6d6449e4f7cfb1c2708,2023-04-24T00:00:00.000Z,"NEFT DR-SBIN0070392-APARNA MOHANAN KONAT -NETBANK, MUM-N114232428979456-925",,Transfer to N114232428979456,net_banking_transfer,-925
645df618f8804aea72c2e41e,50200023535069,3027976.04,60ec41ba55c00300382672d9,HDFC,Internal Transfers,5eecc6d6449e4f7cfb1c2708,2023-04-24T00:00:00.000Z,IB FUNDS TRANSFER DR-50200035187206 -SL ICK ORGANICS PVT LTD,,Transfer to SL ICK ORGANICS PVT LTD,net_banking_transfer,-50000
645df618f8804aea72c2e420,50200023535069,2997976.04,60ec41ba55c00300382672d9,HDFC,Marketing Expense,5eecc6d6449e4f7cfb1c2708,2023-04-24T00:00:00.000Z,NEFT DR-CITI0000006-FACEBOOK INDIA ONLIN E SERVICES PVT LTD-SANDOZ - MUM-N1142324 29309338-NET BANKING SI -30000,,Transfer to NET BANKING SI ,net_banking_transfer,-30000
645df618f8804aea72c2e422,50200023535069,2996887.04,60ec41ba55c00300382672d9,HDFC,direct expenses,5eecc6d6449e4f7cfb1c2708,2023-04-24T00:00:00.000Z,POS 514834XXXXXX0472 PTM*PAYTM WALLET,ewallet,Transfer to PTM*PAYTM WALLET,debit_card,-1089
645df618f8804aea72c2e424,50200023535069,2823687.64,60ec41ba55c00300382672d9,HDFC,OD/CC Repayment,5eecc6d6449e4f7cfb1c2708,2023-04-24T00:00:00.000Z,"NEFT DR-RATN0VAAPIS-CC HEMANT GUPTA 3965 -NETBANK, MUM-N114232429349985-HEMANT CR EDIT CARD",,Transfer to N114232429349985,net_banking_transfer,-173199.4
645df618f8804aea72c2e433,50200023535069,2622231.41,60ec41ba55c00300382672d9,HDFC,OD/CC Repayment,5eecc6d6449e4f7cfb1c2708,2023-04-24T00:00:00.000Z,"NEFT DR-RATN0CRCARD-CC HEMANT GUPTA 9467 -NETBANK, MUM-N114232429355129-HEMANT CR EDIT CARD",,Transfer to N114232429355129,net_banking_transfer,-201456.23
645df618f8804aea72c2e438,50200023535069,1719476.41,60ec41ba55c00300382672d9,HDFC,direct expenses,5eecc6d6449e4f7cfb1c2708,2023-04-24T00:00:00.000Z,02711600008220-TPT-902755-VARUN SINGH,,Transfer to VARUN SINGH,net_banking_transfer,-902755
645df618f8804aea72c2e440,50200023535069,1726587.47,60ec41ba55c00300382672d9,HDFC,Revenue-Mktplace,5eecc6d6449e4f7cfb1c2708,2023-04-24T00:00:00.000Z,IMPS-311414070265-DREAMPLUGPAYTECHSO-UTI B-XXXXXXXXXXX7853-NA,,Transfer from DREAMPLUGPAYTECHSO,net_banking_transfer,7111.06
645df618f8804aea72c2e442,50200023535069,1726589.47,60ec41ba55c00300382672d9,HDFC,Revenue-Mktplace,5eecc6d6449e4f7cfb1c2708,2023-04-24T00:00:00.000Z,IMPS-311414175532-DREAMPLUGPAYTECHSO-UTI B-XXXXXXXXXXX7853-NA,,Transfer from DREAMPLUGPAYTECHSO,net_banking_transfer,2
645df618f8804aea72c2e444,50200023535069,1725507.47,60ec41ba55c00300382672d9,HDFC,direct expenses,5eecc6d6449e4f7cfb1c2708,2023-04-24T00:00:00.000Z,POS 514834XXXXXX0472 PTM*PAYTM WALLET,ewallet,Transfer to PTM*PAYTM WALLET,debit_card,-1082
645df618f8804aea72c2e446,50200023535069,1728533.77,60ec41ba55c00300382672d9,HDFC,Transfer in/Revenue-other,5eecc6d6449e4f7cfb1c2708,2023-04-24T00:00:00.000Z,NEFT CR-UTIB0000114-ONE SIGMA TECHNOLOGI ES PRIVATE LIMI-SLICK ORGANICS PRIVATE L IMITED-AXISP00383752342,bnpl,Transfer from ONE SIGMA TECHNOLOGI ES PRIVATE LIMI,net_banking_transfer,3026.3
645df618f8804aea72c2e448,50200023535069,1732694.46,60ec41ba55c00300382672d9,HDFC,Transfer in/Revenue-other,5eecc6d6449e4f7cfb1c2708,2023-04-24T00:00:00.000Z,NEFT CR-UTIB0000114-ONE SIGMA TECHNOLOGI ES PRIVATE LIMI-SLICK ORGANICS PRIVATE L IMITED-AXISP00383752844,bnpl,Transfer from ONE SIGMA TECHNOLOGI ES PRIVATE LIMI,net_banking_transfer,4160.69
645df618f8804aea72c2e44a,50200023535069,1734963.24,60ec41ba55c00300382672d9,HDFC,Transfer in/Revenue-other,5eecc6d6449e4f7cfb1c2708,2023-04-24T00:00:00.000Z,NEFT CR-UTIB0000114-ONE SIGMA TECHNOLOGI ES PRIVATE LIMI-SLICK ORGANICS PRIVATE L IMITED-AXISP00383753038,bnpl,Transfer from ONE SIGMA TECHNOLOGI ES PRIVATE LIMI,net_banking_transfer,2268.78
645df618f8804aea72c2e44c,50200023535069,1739839.24,60ec41ba55c00300382672d9,HDFC,Transfer in/Revenue-other,5eecc6d6449e4f7cfb1c2708,2023-04-24T00:00:00.000Z,NEFT CR-ICIC0000105-ICICI BANK NODAL AC T-SLICK ORGANICS PRIVATE LIMITED-ICIB231 140018690,,Transfer from ICICI BANK NODAL AC T,net_banking_transfer,4876
645df618f8804aea72c2e44e,50200023535069,1921828.33,60ec41ba55c00300382672d9,HDFC,Transfer in/Revenue-other,5eecc6d6449e4f7cfb1c2708,2023-04-24T00:00:00.000Z,4200004005-24 04 2023-HD08868902,,,Other,181989.09
645df618f8804aea72c2e450,50200023535069,1922148.96,60ec41ba55c00300382672d9,HDFC,Transfer in/Revenue-other,5eecc6d6449e4f7cfb1c2708,2023-04-24T00:00:00.000Z,EASEBUZZ PRIVA-A316240423PSDVECY5PS,,,Other,320.63
645df618f8804aea72c2e452,50200023535069,1928952.96,60ec41ba55c00300382672d9,HDFC,Transfer in/Revenue-other,5eecc6d6449e4f7cfb1c2708,2023-04-24T00:00:00.000Z,NEFT CR-UTIB0000020-EMIZA SUPPLY CHAIN S ERVICES PRIVATE-SLICK ORGANICS PRIVATE L IMITED-AXISP00383842781,,Transfer from EMIZA SUPPLY CHAIN S ERVICES PRIVATE,net_banking_transfer,6804
645df618f8804aea72c2e454,50200023535069,1929697.24,60ec41ba55c00300382672d9,HDFC,Transfer in/Revenue-other,5eecc6d6449e4f7cfb1c2708,2023-04-24T00:00:00.000Z,NEFT CR-YESB0000001-EASEBUZZ PVT LTD NOD AL A/C-SLICK ORGANICS PVT LTD-YESB311406 78362,,Transfer from EASEBUZZ PVT LTD NOD AL A/C,net_banking_transfer,744.28
645df618f8804aea72c2e456,50200023535069,1972615.89,60ec41ba55c00300382672d9,HDFC,Transfer in/Revenue-other,5eecc6d6449e4f7cfb1c2708,2023-04-24T00:00:00.000Z,NEFT CR-YESB0000001-EASEBUZZ PVT LTD NOD AL A/C-SLICK ORGANICS PVT LTD-YESB311406 78447,,Transfer from EASEBUZZ PVT LTD NOD AL A/C,net_banking_transfer,42918.65
645df618f8804aea72c2e458,50200023535069,1963215.89,60ec41ba55c00300382672d9,HDFC,direct expenses,5eecc6d6449e4f7cfb1c2708,2023-04-24T00:00:00.000Z,"NEFT DR-INDB0000023-MODULYSS-NETBANK, MU M-N114232429879185-9400",,Transfer to N114232429879185,net_banking_transfer,-9400
645df618f8804aea72c2e45a,50200023535069,1972615.89,60ec41ba55c00300382672d9,HDFC,Adjustments/Reversal,5eecc6d6449e4f7cfb1c2708,2023-04-24T00:00:00.000Z,NEFT RETURN-ACCOUNT DOES NOT EXIST-MODUL YSS-INDBN24046357341,,neft_return,refund,9400
645df618f8804aea72c2e45c,50200023535069,1939575.89,60ec41ba55c00300382672d9,HDFC,direct expenses,5eecc6d6449e4f7cfb1c2708,2023-04-24T00:00:00.000Z,"NEFT DR-UTIB0000032-SKUMAR MULTIPRODUCTS PVT LTD-NETBANK, MUM-N114232430026540-3 3040",,Transfer to N114232430026540,net_banking_transfer,-33040
645df618f8804aea72c2e45f,50200023535069,1940036.32,60ec41ba55c00300382672d9,HDFC,Revenue-PG-split enabled,5eecc6d6449e4f7cfb1c2708,2023-04-24T00:00:00.000Z,NEFT CR-UTIB0001506-RAZORPAY SOFTWARE PR IVATE LIMITED --SLICK ORGANICS PVT LITD-,,Transfer from RAZORPAY SOFTWARE PR IVATE LIMITED ,net_banking_transfer,460.43
645df618f8804aea72c2e461,50200023535069,2019330.13,60ec41ba55c00300382672d9,HDFC,Transfer in/Revenue-other,5eecc6d6449e4f7cfb1c2708,2023-04-24T00:00:00.000Z,NEFT CR-YESB0000001-EASEBUZZ PVT LTD NOD AL A/C-SLICK ORGANICS PVT LTD-YESB311407 17756,,Transfer from EASEBUZZ PVT LTD NOD AL A/C,net_banking_transfer,79293.81
645df618f8804aea72c2e463,50200023535069,2082108.13,60ec41ba55c00300382672d9,HDFC,Revenue-Mktplace,5eecc6d6449e4f7cfb1c2708,2023-04-24T00:00:00.000Z,NEFT CR-DEUT0797BGL-INTERNAL AC FOR INTE RMEDIERY- AMAZON SELLER SERVIC-SLICK ORG ANICS PVT LTD-311402502GN00003,shopping,Transfer from INTERNAL AC FOR INTE RMEDIERY,net_banking_transfer,62778
645df618f8804aea72c2e465,50200023535069,2097624.25,60ec41ba55c00300382672d9,HDFC,Revenue-Mktplace,5eecc6d6449e4f7cfb1c2708,2023-04-24T00:00:00.000Z,IMPS-311420115461-AMAZON SELLER SERVIC-H SBC-XXXXXXXX6004-UFG2LH3LX5IE4Z9GSLICK O RGANICS PVT LTD,shopping,Transfer from AMAZON SELLER SERVIC,net_banking_transfer,15516.12
645df618f8804aea72c2e467,50200023535069,2067624.25,60ec41ba55c00300382672d9,HDFC,Marketing Expense,5eecc6d6449e4f7cfb1c2708,2023-04-25T00:00:00.000Z,NEFT DR-CITI0000006-FACEBOOK INDIA ONLIN E SERVICES PVT LTD-SANDOZ - MUM-N1152324 30289717-NET BANKING SI -30000,,Transfer to NET BANKING SI ,net_banking_transfer,-30000
645df618f8804aea72c2e469,50200023535069,2069844.83,60ec41ba55c00300382672d9,HDFC,Transfer in/Revenue-other,5eecc6d6449e4f7cfb1c2708,2023-04-25T00:00:00.000Z,IMPS-311507761317-EXCRO PAY ESCROW ACC-Y ESB-XXXXXXXXXXX1807-333112298023,,Transfer from EXCRO PAY ESCROW ACC,net_banking_transfer,2220.58
645df618f8804aea72c2e46b,50200023535069,2060844.83,60ec41ba55c00300382672d9,HDFC,direct expenses,5eecc6d6449e4f7cfb1c2708,2023-04-25T00:00:00.000Z,"NEFT DR-ICIC0000715-GAJENDRA BAHADUR SIN GH-NETBANK, MUM-N115232430402716-9000",,Transfer to N115232430402716,net_banking_transfer,-9000
645df618f8804aea72c2e46d,50200023535069,2051244.83,60ec41ba55c00300382672d9,HDFC,direct expenses,5eecc6d6449e4f7cfb1c2708,2023-04-25T00:00:00.000Z,"NEFT DR-INDB0000023-MODULYSS-NETBANK, MU M-N115232430420326-9600",,Transfer to N115232430420326,net_banking_transfer,-9600
645df619f8804aea72c2e46f,50200023535069,2050011.83,60ec41ba55c00300382672d9,HDFC,direct expenses,5eecc6d6449e4f7cfb1c2708,2023-04-25T00:00:00.000Z,"NEFT DR-KKBK0004266-NIDHI PANDEY-NETBANK , MUM-N115232430430805-1233",,Transfer to N115232430430805,net_banking_transfer,-1233
645df619f8804aea72c2e471,50200023535069,2049539.83,60ec41ba55c00300382672d9,HDFC,direct expenses,5eecc6d6449e4f7cfb1c2708,2023-04-25T00:00:00.000Z,50100108772229-TPT-472-HEMANT GUPTA,,Transfer to HEMANT GUPTA,net_banking_transfer,-472
645df619f8804aea72c2e474,50200023535069,2050633.42,60ec41ba55c00300382672d9,HDFC,Revenue-PG-split enabled,5eecc6d6449e4f7cfb1c2708,2023-04-25T00:00:00.000Z,NEFT CR-UTIB0001506-RAZORPAY SOFTWARE PR IVATE LIMITED --SLICK ORGANICS PVT LITD- AXISCN0240262373,,Transfer from RAZORPAY SOFTWARE PR IVATE LIMITED ,net_banking_transfer,1093.59
645df619f8804aea72c2e479,50200023535069,2020633.42,60ec41ba55c00300382672d9,HDFC,direct expenses,5eecc6d6449e4f7cfb1c2708,2023-04-25T00:00:00.000Z,57500001065314-TPT-30000-KRAUTER HEALTHC ARE LTD,,Transfer to KRAUTER HEALTHC ARE LTD,net_banking_transfer,-30000
645df619f8804aea72c2e47b,50200023535069,2447551.52,60ec41ba55c00300382672d9,HDFC,Transfer in/Revenue-other,5eecc6d6449e4f7cfb1c2708,2023-04-25T00:00:00.000Z,RTGS CR-HSBC0400002-SUPERWELL COMTRADE P RIVATE LIMITED-SLICK ORGANICS PRIVATE LI MITED-HSBCR22023042519973371,,Transfer from SUPERWELL COMTRADE P RIVATE LIMITED,net_banking_transfer,426918.1
645df619f8804aea72c2e47e,50200023535069,2559538.89,60ec41ba55c00300382672d9,HDFC,Transfer in/Revenue-other,5eecc6d6449e4f7cfb1c2708,2023-04-25T00:00:00.000Z,NEFT CR-HSBC0110005-SUPERWELL COMTRADE P RIVATE LIMITED-SLICK ORGANICS PRIVATE LI,,Transfer from SUPERWELL COMTRADE P RIVATE LIMITED,net_banking_transfer,111987.37
645df619f8804aea72c2e481,50200023535069,2604041.23,60ec41ba55c00300382672d9,HDFC,Transfer in/Revenue-other,5eecc6d6449e4f7cfb1c2708,2023-04-25T00:00:00.000Z,NEFT CR-HSBC0110005-SUPERWELL COMTRADE P RIVATE LIMITED-SLICK ORGANICS PRIVATE LI MITED-HSBCN23115514099,,Transfer from SUPERWELL COMTRADE P RIVATE LIMITED,net_banking_transfer,44502.34
645df619f8804aea72c2e483,50200023535069,2609201.85,60ec41ba55c00300382672d9,HDFC,Transfer in/Revenue-other,5eecc6d6449e4f7cfb1c2708,2023-04-25T00:00:00.000Z,NEFT CR-UTIB0000114-ONE SIGMA TECHNOLOGI ES PRIVATE LIMI-SLICK ORGANICS PRIVATE L IMITED-AXISP00384102502,bnpl,Transfer from ONE SIGMA TECHNOLOGI ES PRIVATE LIMI,net_banking_transfer,5160.62
645df619f8804aea72c2e485,50200023535069,2609860.05,60ec41ba55c00300382672d9,HDFC,Revenue-Mktplace,5eecc6d6449e4f7cfb1c2708,2023-04-25T00:00:00.000Z,IMPS-311514758771-DREAMPLUGPAYTECHSO-UTI B-XXXXXXXXXXX7853-NA,,Transfer from DREAMPLUGPAYTECHSO,net_banking_transfer,658.2
645df619f8804aea72c2e487,50200023535069,2614652.05,60ec41ba55c00300382672d9,HDFC,Revenue-Mktplace,5eecc6d6449e4f7cfb1c2708,2023-04-25T00:00:00.000Z,IMPS-311514870171-DREAMPLUGPAYTECHSO-UTI B-XXXXXXXXXXX7853-NA,,Transfer from DREAMPLUGPAYTECHSO,net_banking_transfer,4792
645df619f8804aea72c2e489,50200023535069,2614284.05,60ec41ba55c00300382672d9,HDFC,direct expenses,5eecc6d6449e4f7cfb1c2708,2023-04-25T00:00:00.000Z,POS 514834XXXXXX0472 PAYTM_PAYTMADDMO,ewallet,Transfer to PAYTM_PAYTMADDMO,debit_card,-368
645df619f8804aea72c2e48b,50200023535069,2614992.05,60ec41ba55c00300382672d9,HDFC,Revenue-Mktplace,5eecc6d6449e4f7cfb1c2708,2023-04-25T00:00:00.000Z,NEFT CR-ICIC0000105-MANASH LIFETYLE PVT LTD-SLICK ORGANICS PRIVATE LIMITED-ICIB2 31150018441,,Transfer from MANASH LIFETYLE PVT LTD,net_banking_transfer,708
645df619f8804aea72c2e48e,50200023535069,2613685.05,60ec41ba55c00300382672d9,HDFC,direct expenses,5eecc6d6449e4f7cfb1c2708,2023-04-25T00:00:00.000Z,POS 514834XXXXXX0472 PAYTM_PAYTMADDMO,ewallet,Transfer to PAYTM_PAYTMADDMO,debit_card,-1307
645df619f8804aea72c2e490,50200023535069,2614451.75,60ec41ba55c00300382672d9,HDFC,Revenue-PG-split enabled,5eecc6d6449e4f7cfb1c2708,2023-04-25T00:00:00.000Z,NEFT CR-UTIB0001506-RAZORPAY SOFTWARE PR IVATE LIMITED --SLICK ORGANICS PVT LITD- AXISCN0240580155,,Transfer from RAZORPAY SOFTWARE PR IVATE LIMITED ,net_banking_transfer,766.7
645df619f8804aea72c2e492,50200023535069,2662295.76,60ec41ba55c00300382672d9,HDFC,Revenue-Mktplace,5eecc6d6449e4f7cfb1c2708,2023-04-25T00:00:00.000Z,NEFT CR-DEUT0797BGL-INTERNAL AC FOR INTE RMEDIERY- AMAZON SELLER SERVIC-SLICK ORG ANICS PVT LTD-311501460GN00003,shopping,Transfer from INTERNAL AC FOR INTE RMEDIERY,net_banking_transfer,47844.01
645df619f8804aea72c2e494,50200023535069,2562295.76,60ec41ba55c00300382672d9,HDFC,Salary/Emp/consultant Expense,5eecc6d6449e4f7cfb1c2708,2023-04-25T00:00:00.000Z,50100293329616-TPT-BONUS-SADIYA BANO,,Transfer to SADIYA BANO,net_banking_transfer,-100000
645df619f8804aea72c2e496,50200023535069,2617244.32,60ec41ba55c00300382672d9,HDFC,Revenue-Mktplace,5eecc6d6449e4f7cfb1c2708,2023-04-25T00:00:00.000Z,IMPS-311520247866-AMAZON SELLER SERVIC-H SBC-XXXXXXXX6004-12NNCD7MEYIV14X7SLICK O RGANICS PVT LTD,shopping,Transfer from AMAZON SELLER SERVIC,net_banking_transfer,54948.56
645df619f8804aea72c2e498,50200023535069,2587244.32,60ec41ba55c00300382672d9,HDFC,Marketing Expense,5eecc6d6449e4f7cfb1c2708,2023-04-26T00:00:00.000Z,NEFT DR-CITI0000006-FACEBOOK INDIA ONLIN E SERVICES PVT LTD-SANDOZ - MUM-N1162324 31818019-NET BANKING SI -30000,,Transfer to NET BANKING SI ,net_banking_transfer,-30000
645df619f8804aea72c2e49a,50200023535069,2590615.86,60ec41ba55c00300382672d9,HDFC,Revenue-Mktplace,5eecc6d6449e4f7cfb1c2708,2023-04-26T00:00:00.000Z,NEFT CR-DEUT0797BGL-MYNTRA DESIGNS PRIVA TE LIMITED-SLICK ORGANICS - SJIT-3116010 38GN00108,shopping,Transfer from MYNTRA DESIGNS PRIVA TE LIMITED,net_banking_transfer,3371.54
645df619f8804aea72c2e49c,50200023535069,2591678.06,60ec41ba55c00300382672d9,HDFC,Revenue-PG-split enabled,5eecc6d6449e4f7cfb1c2708,2023-04-26T00:00:00.000Z,NEFT CR-UTIB0001506-RAZORPAY SOFTWARE PR IVATE LIMITED --SLICK ORGANICS PVT LITD- AXISCN0240807750,,Transfer from RAZORPAY SOFTWARE PR IVATE LIMITED ,net_banking_transfer,1062.2
645df619f8804aea72c2e49e,50200023535069,2587067.06,60ec41ba55c00300382672d9,HDFC,direct expenses,5eecc6d6449e4f7cfb1c2708,2023-04-26T00:00:00.000Z,POS 514834XXXXXX0472 WWW HPSHOPPING I,,Transfer to WWW HPSHOPPING I,debit_card,-4611
645df619f8804aea72c2e4a1,50200023535069,2385137.76,60ec41ba55c00300382672d9,HDFC,direct expenses,5eecc6d6449e4f7cfb1c2708,2023-04-26T00:00:00.000Z,"NEFT DR-YESB0CMSNOC-CC MUKESH GOYAL 7736 -NETBANK, MUM-N116232432298230-CC MUKESH GOYAL",,Transfer to N116232432298230,net_banking_transfer,-201929.3
645df619f8804aea72c2e4a3,50200023535069,2384722.76,60ec41ba55c00300382672d9,HDFC,direct expenses,5eecc6d6449e4f7cfb1c2708,2023-04-26T00:00:00.000Z,POS 514834XXXXXX0472 SMARTSHIFT LOGIS,,Transfer to SMARTSHIFT LOGIS,debit_card,-415
645df619f8804aea72c2e4a5,50200023535069,2380052.71,60ec41ba55c00300382672d9,HDFC,Marketing Expense,5eecc6d6449e4f7cfb1c2708,2023-04-26T00:00:00.000Z,ME DC SI 514834XXXXXX0472 FACEBOOK SI,,,Other,-4670.05
645df619f8804aea72c2e4a8,50200023535069,2382391.45,60ec41ba55c00300382672d9,HDFC,Transfer in/Revenue-other,5eecc6d6449e4f7cfb1c2708,2023-04-26T00:00:00.000Z,NEFT CR-YESB0000001-EASEBUZZ PVT LTD NOD AL A/C-SLICK ORGANICS PVT LTD-YESB311627 64122,,Transfer from EASEBUZZ PVT LTD NOD AL A/C,net_banking_transfer,2338.74
645df619f8804aea72c2e4aa,50200023535069,2420710.35,60ec41ba55c00300382672d9,HDFC,Transfer in/Revenue-other,5eecc6d6449e4f7cfb1c2708,2023-04-26T00:00:00.000Z,NEFT CR-YESB0000001-EASEBUZZ PVT LTD NOD AL A/C-SLICK ORGANICS PVT LTD-YESB311627 64261,,Transfer from EASEBUZZ PVT LTD NOD AL A/C,net_banking_transfer,38318.9
645df619f8804aea72c2e4ac,50200023535069,2420415.35,60ec41ba55c00300382672d9,HDFC,direct expenses,5eecc6d6449e4f7cfb1c2708,2023-04-26T00:00:00.000Z,SI FAIL DUE TO INSUFF BAL 010323-CDT2311 115403586,,penalty_charge,bank_charge,-295
645df619f8804aea72c2e4ae,50200023535069,2422013.35,60ec41ba55c00300382672d9,HDFC,Revenue-Mktplace,5eecc6d6449e4f7cfb1c2708,2023-04-26T00:00:00.000Z,IMPS-311614370878-DREAMPLUGPAYTECHSO-UTI B-XXXXXXXXXXX7853-NA,,Transfer from DREAMPLUGPAYTECHSO,net_banking_transfer,1598
645df619f8804aea72c2e4b0,50200023535069,2420813.35,60ec41ba55c00300382672d9,HDFC,direct expenses,5eecc6d6449e4f7cfb1c2708,2023-04-26T00:00:00.000Z,"NEFT DR-SIBL0000555-JAIVEER KUMAR-NETBAN K, MUM-N116232432459127-1200",,Transfer to N116232432459127,net_banking_transfer,-1200
645df619f8804aea72c2e4b2,50200023535069,2416813.35,60ec41ba55c00300382672d9,HDFC,direct expenses,5eecc6d6449e4f7cfb1c2708,2023-04-26T00:00:00.000Z,"NEFT DR-SBIN0012831-MUDE MUKESH-NETBANK, MUM-N116232432480919-4000",,Transfer to N116232432480919,net_banking_transfer,-4000
645df619f8804aea72c2e4b4,50200023535069,2417161.85,60ec41ba55c00300382672d9,HDFC,Revenue-Mktplace,5eecc6d6449e4f7cfb1c2708,2023-04-26T00:00:00.000Z,IMPS-311614479312-DREAMPLUGPAYTECHSO-UTI B-XXXXXXXXXXX7853-NA,,Transfer from DREAMPLUGPAYTECHSO,net_banking_transfer,348.5
645df619f8804aea72c2e4b6,50200023535069,2418425.85,60ec41ba55c00300382672d9,HDFC,Revenue-Mktplace,5eecc6d6449e4f7cfb1c2708,2023-04-26T00:00:00.000Z,NEFT CR-ICIC0000105-MANASH LIFETYLE PVT LTD-SLICK ORGANICS PRIVATE LIMITED-ICIB2 31160009571,,Transfer from MANASH LIFETYLE PVT LTD,net_banking_transfer,1264
645df619f8804aea72c2e4b8,50200023535069,2418147.85,60ec41ba55c00300382672d9,HDFC,direct expenses,5eecc6d6449e4f7cfb1c2708,2023-04-26T00:00:00.000Z,POS 514834XXXXXX0472 PAYTM_PAYTMADDMO,ewallet,Transfer to PAYTM_PAYTMADDMO,debit_card,-278
645df619f8804aea72c2e4bc,50200023535069,2424413.11,60ec41ba55c00300382672d9,HDFC,Transfer in/Revenue-other,5eecc6d6449e4f7cfb1c2708,2023-04-26T00:00:00.000Z,NEFT CR-UTIB0000114-ONE SIGMA TECHNOLOGI ES PRIVATE LIMI-SLICK ORGANICS PRIVATE L,bnpl,Transfer from ONE SIGMA TECHNOLOGI ES PRIVATE LIMI,net_banking_transfer,6265.26
645df619f8804aea72c2e4be,50200023535069,2424412.11,60ec41ba55c00300382672d9,HDFC,direct expenses,5eecc6d6449e4f7cfb1c2708,2023-04-26T00:00:00.000Z,ME DC SI 514834XXXXXX0472 SHOPIFY LTD,,,Other,-1
645df619f8804aea72c2e4c0,50200023535069,2425449.51,60ec41ba55c00300382672d9,HDFC,Revenue-PG-split enabled,5eecc6d6449e4f7cfb1c2708,2023-04-26T00:00:00.000Z,NEFT CR-UTIB0001506-RAZORPAY SOFTWARE PR IVATE LIMITED --SLICK ORGANICS PVT LITD- AXISCN0241085335,,Transfer from RAZORPAY SOFTWARE PR IVATE LIMITED ,net_banking_transfer,1037.4
645df619f8804aea72c2e4c2,50200023535069,2447353.49,60ec41ba55c00300382672d9,HDFC,Transfer in/Revenue-other,5eecc6d6449e4f7cfb1c2708,2023-04-26T00:00:00.000Z,NEFT CR-YESB0000001-EASEBUZZ PVT LTD NOD AL A/C-SLICK ORGANICS PVT LTD-YESB311640 30917,,Transfer from EASEBUZZ PVT LTD NOD AL A/C,net_banking_transfer,21903.98
645df619f8804aea72c2e4c4,50200023535069,2469892.66,60ec41ba55c00300382672d9,HDFC,Revenue-Mktplace,5eecc6d6449e4f7cfb1c2708,2023-04-26T00:00:00.000Z,IMPS-311619001093-AMAZON SELLER SERVIC-H SBC-XXXXXXXX6004-YMP2QB236OXF50RDSLICK O RGANICS PVT LTD,shopping,Transfer from AMAZON SELLER SERVIC,net_banking_transfer,22539.17
645df619f8804aea72c2e4c7,50200023535069,2519939.21,60ec41ba55c00300382672d9,HDFC,Revenue-Mktplace,5eecc6d6449e4f7cfb1c2708,2023-04-26T00:00:00.000Z,NEFT CR-DEUT0797BGL-INTERNAL AC FOR INTE RMEDIERY- AMAZON SELLER SERVIC-SLICK ORG ANICS PVT LTD-311602227GN00001,shopping,Transfer from INTERNAL AC FOR INTE RMEDIERY,net_banking_transfer,50046.55
645df619f8804aea72c2e4c9,50200023535069,2489939.21,60ec41ba55c00300382672d9,HDFC,Marketing Expense,5eecc6d6449e4f7cfb1c2708,2023-04-27T00:00:00.000Z,NEFT DR-CITI0000006-FACEBOOK INDIA ONLIN E SERVICES PVT LTD-SANDOZ - MUM-N1172324 33186484-NET BANKING SI -30000,,Transfer to NET BANKING SI ,net_banking_transfer,-30000
645df619f8804aea72c2e4cb,50200023535069,2480939.21,60ec41ba55c00300382672d9,HDFC,agency/vendor expense,5eecc6d6449e4f7cfb1c2708,2023-04-27T00:00:00.000Z,"NEFT DR-UTIB0003557-INCOSEC LEGAL-NETBAN K, MUM-N117232433380119-9000",,Transfer to N117232433380119,net_banking_transfer,-9000
645df619f8804aea72c2e4cd,50200023535069,2481572.71,60ec41ba55c00300382672d9,HDFC,Revenue-PG-split enabled,5eecc6d6449e4f7cfb1c2708,2023-04-27T00:00:00.000Z,NEFT CR-UTIB0001506-RAZORPAY SOFTWARE PR IVATE LIMITED --SLICK ORGANICS PVT LITD- AXISCN0241348683,,Transfer from RAZORPAY SOFTWARE PR IVATE LIMITED ,net_banking_transfer,633.5
645df619f8804aea72c2e4cf,50200023535069,2481335.71,60ec41ba55c00300382672d9,HDFC,direct expenses,5eecc6d6449e4f7cfb1c2708,2023-04-27T00:00:00.000Z,POS 514834XXXXXX0472 PTM*PAYTM WALLET,ewallet,Transfer to PTM*PAYTM WALLET,debit_card,-237
645df619f8804aea72c2e4d1,50200023535069,2499420.67,60ec41ba55c00300382672d9,HDFC,Transfer in/Revenue-other,5eecc6d6449e4f7cfb1c2708,2023-04-27T00:00:00.000Z,NEFT CR-YESB0000001-EASEBUZZ PVT LTD NOD AL A/C-SLICK ORGANICS PVT LTD-YESB311744 67737,,Transfer from EASEBUZZ PVT LTD NOD AL A/C,net_banking_transfer,18084.96
645df619f8804aea72c2e4d3,50200023535069,2496119.97,60ec41ba55c00300382672d9,HDFC,direct expenses,5eecc6d6449e4f7cfb1c2708,2023-04-27T00:00:00.000Z,POS 514834XXXXXX0472 RAZ*KNOWLARITY,,Transfer to RAZ*KNOWLARITY,debit_card,-3300.7
645df619f8804aea72c2e4d5,50200023535069,2500042.97,60ec41ba55c00300382672d9,HDFC,Revenue-Mktplace,5eecc6d6449e4f7cfb1c2708,2023-04-27T00:00:00.000Z,IMPS-311714886449-DREAMPLUGPAYTECHSO-UTI B-XXXXXXXXXXX7853-NA,,Transfer from DREAMPLUGPAYTECHSO,net_banking_transfer,3923
645df619f8804aea72c2e4d7,50200023535069,2498981.97,60ec41ba55c00300382672d9,HDFC,direct expenses,5eecc6d6449e4f7cfb1c2708,2023-04-27T00:00:00.000Z,POS 514834XXXXXX0472 SMARTSHIFT LOGIS,,Transfer to SMARTSHIFT LOGIS,debit_card,-1061
645df619f8804aea72c2e4d9,50200023535069,2499380.47,60ec41ba55c00300382672d9,HDFC,Revenue-Mktplace,5eecc6d6449e4f7cfb1c2708,2023-04-27T00:00:00.000Z,IMPS-311714994336-DREAMPLUGPAYTECHSO-UTI,,Transfer from DREAMPLUGPAYTECHSO,net_banking_transfer,398.5
645df619f8804aea72c2e4dc,50200023535069,2498931.47,60ec41ba55c00300382672d9,HDFC,direct expenses,5eecc6d6449e4f7cfb1c2708,2023-04-27T00:00:00.000Z,POS 514834XXXXXX0472 PAYTM PAYMENTS S,ewallet,Transfer to PAYTM PAYMENTS S,debit_card,-449
645df619f8804aea72c2e4de,50200023535069,2502773.47,60ec41ba55c00300382672d9,HDFC,Revenue-Mktplace,5eecc6d6449e4f7cfb1c2708,2023-04-27T00:00:00.000Z,NEFT CR-ICIC0000105-MANASH LIFETYLE PVT LTD-SLICK ORGANICS PRIVATE LIMITED-ICIB2 31170015185,,Transfer from MANASH LIFETYLE PVT LTD,net_banking_transfer,3842
645df61af8804aea72c2e4e1,50200023535069,2503475.86,60ec41ba55c00300382672d9,HDFC,Transfer in/Revenue-other,5eecc6d6449e4f7cfb1c2708,2023-04-27T00:00:00.000Z,EASEBUZZ PRIVA-A218270423PS3UNHLWQW,,,Other,702.39
645df61af8804aea72c2e4e3,50200023535069,2506879.03,60ec41ba55c00300382672d9,HDFC,Transfer in/Revenue-other,5eecc6d6449e4f7cfb1c2708,2023-04-27T00:00:00.000Z,NEFT CR-UTIB0000114-ONE SIGMA TECHNOLOGI ES PRIVATE LIMI-SLICK ORGANICS PRIVATE L IMITED-AXISP00384668592,bnpl,Transfer from ONE SIGMA TECHNOLOGI ES PRIVATE LIMI,net_banking_transfer,3403.17
645df61af8804aea72c2e4e5,50200023535069,2505283.03,60ec41ba55c00300382672d9,HDFC,direct expenses,5eecc6d6449e4f7cfb1c2708,2023-04-27T00:00:00.000Z,POS 514834XXXXXX0472 SMARTSHIFT LOGIS,,Transfer to SMARTSHIFT LOGIS,debit_card,-1596
645df61af8804aea72c2e4e7,50200023535069,2539190.52,60ec41ba55c00300382672d9,HDFC,Transfer in/Revenue-other,5eecc6d6449e4f7cfb1c2708,2023-04-27T00:00:00.000Z,4200003043-27 04 2023-HD08868902,,,Other,33907.49
645df61af8804aea72c2e4e9,50200023535069,2540530.02,60ec41ba55c00300382672d9,HDFC,Revenue-PG-split enabled,5eecc6d6449e4f7cfb1c2708,2023-04-27T00:00:00.000Z,NEFT CR-UTIB0001506-RAZORPAY SOFTWARE PR IVATE LIMITED --SLICK ORGANICS PVT LITD- AXISCN0241596221,,Transfer from RAZORPAY SOFTWARE PR IVATE LIMITED ,net_banking_transfer,1339.5
645df61af8804aea72c2e4eb,50200023535069,2552063.69,60ec41ba55c00300382672d9,HDFC,Transfer in/Revenue-other,5eecc6d6449e4f7cfb1c2708,2023-04-27T00:00:00.000Z,NEFT CR-YESB0000001-EASEBUZZ PVT LTD NOD AL A/C-SLICK ORGANICS PVT LTD-YESB311764 53925,,Transfer from EASEBUZZ PVT LTD NOD AL A/C,net_banking_transfer,11533.67
645df61af8804aea72c2e4ed,50200023535069,2579018.78,60ec41ba55c00300382672d9,HDFC,Transfer in/Revenue-other,5eecc6d6449e4f7cfb1c2708,2023-04-27T00:00:00.000Z,NEFT CR-YESB0000001-EASEBUZZ PVT LTD NOD AL A/C-SLICK ORGANICS PVT LTD-YESB311764 54001,,Transfer from EASEBUZZ PVT LTD NOD AL A/C,net_banking_transfer,26955.09
645df61af8804aea72c2e4ef,50200023535069,2745551.99,60ec41ba55c00300382672d9,HDFC,Revenue-Mktplace,5eecc6d6449e4f7cfb1c2708,2023-04-27T00:00:00.000Z,IMPS-311719132398-AMAZON SELLER SERVIC-H SBC-XXXXXXXX6004-7BG24NH9DMN177TQSLICK O RGANICS PVT LTD,shopping,Transfer from AMAZON SELLER SERVIC,net_banking_transfer,166533.21
645df61af8804aea72c2e4f1,50200023535069,2785044.91,60ec41ba55c00300382672d9,HDFC,Revenue-Mktplace,5eecc6d6449e4f7cfb1c2708,2023-04-27T00:00:00.000Z,NEFT CR-DEUT0797BGL-INTERNAL AC FOR INTE RMEDIERY- AMAZON SELLER SERVIC-SLICK ORG ANICS PVT LTD-311701657GN00008,shopping,Transfer from INTERNAL AC FOR INTE RMEDIERY,net_banking_transfer,39492.92
645df61af8804aea72c2e4f3,50200023535069,2784752.27,60ec41ba55c00300382672d9,HDFC,Marketing Expense,5eecc6d6449e4f7cfb1c2708,2023-04-27T00:00:00.000Z,ME DC SI 514834XXXXXX0472 FACEBOOK SI,,,Other,-292.64
645df61af8804aea72c2e4f5,50200023535069,2754752.27,60ec41ba55c00300382672d9,HDFC,Marketing Expense,5eecc6d6449e4f7cfb1c2708,2023-04-28T00:00:00.000Z,NEFT DR-CITI0000006-FACEBOOK INDIA ONLIN E SERVICES PVT LTD-SANDOZ - MUM-N1182324 34851485-NET BANKING SI -30000,,Transfer to NET BANKING SI ,net_banking_transfer,-30000
645df61af8804aea72c2e4f7,50200023535069,2756282.74,60ec41ba55c00300382672d9,HDFC,Transfer in/Revenue-other,5eecc6d6449e4f7cfb1c2708,2023-04-28T00:00:00.000Z,IMPS-311805712954-EXCRO PAY ESCROW ACC-Y,,Transfer from EXCRO PAY ESCROW ACC,net_banking_transfer,1530.47
645df61af8804aea72c2e4f9,50200023535069,2759088.51,60ec41ba55c00300382672d9,HDFC,Transfer in/Revenue-other,5eecc6d6449e4f7cfb1c2708,2023-04-28T00:00:00.000Z,IMPS-311807746820-EXCRO PAY ESCROW ACC-Y ESB-XXXXXXXXXXX1807-333112298023,,Transfer from EXCRO PAY ESCROW ACC,net_banking_transfer,2805.77
645df61af8804aea72c2e4fb,50200023535069,2759333.51,60ec41ba55c00300382672d9,HDFC,Revenue-PG-split enabled,5eecc6d6449e4f7cfb1c2708,2023-04-28T00:00:00.000Z,NEFT CR-UTIB0001506-RAZORPAY SOFTWARE PR IVATE LIMITED --SLICK ORGANICS PVT LITD- AXISCN0241972669,,Transfer from RAZORPAY SOFTWARE PR IVATE LIMITED ,net_banking_transfer,245
645df61af8804aea72c2e4fd,50200023535069,2817131.51,60ec41ba55c00300382672d9,HDFC,Transfer in/Revenue-other,5eecc6d6449e4f7cfb1c2708,2023-04-28T00:00:00.000Z,NEFT CR-HSBC0560002-INNOVATIVE RETAIL CO NCEPTS PRIVATE-SLICK ORGANICS PVT LTD-HS BCN23118261098,,Transfer from INNOVATIVE RETAIL CO NCEPTS PRIVATE,net_banking_transfer,57798
645df61af8804aea72c2e4ff,50200023535069,2819369.89,60ec41ba55c00300382672d9,HDFC,Revenue-Mktplace,5eecc6d6449e4f7cfb1c2708,2023-04-28T00:00:00.000Z,NEFT CR-DEUT0797BGL-MYNTRA DESIGNS PRIVA TE LIMITED-SLICK ORGANICS - SJIT-3118010 16GN00015,shopping,Transfer from MYNTRA DESIGNS PRIVA TE LIMITED,net_banking_transfer,2238.38
645df61af8804aea72c2e501,50200023535069,2818997.89,60ec41ba55c00300382672d9,HDFC,direct expenses,5eecc6d6449e4f7cfb1c2708,2023-04-28T00:00:00.000Z,POS 514834XXXXXX0472 PAYTM PAYMENTS S,ewallet,Transfer to PAYTM PAYMENTS S,debit_card,-372
645df61af8804aea72c2e503,50200023535069,2818704.89,60ec41ba55c00300382672d9,HDFC,direct expenses,5eecc6d6449e4f7cfb1c2708,2023-04-28T00:00:00.000Z,POS 514834XXXXXX0472 PAYTM PAYMENTS S,ewallet,Transfer to PAYTM PAYMENTS S,debit_card,-293
645df61af8804aea72c2e505,50200023535069,2811204.89,60ec41ba55c00300382672d9,HDFC,direct expenses,5eecc6d6449e4f7cfb1c2708,2023-04-28T00:00:00.000Z,"NEFT DR-SBIN0004463-SHANKAR LAL-NETBANK, MUM-N118232435401346-7500",,Transfer to N118232435401346,net_banking_transfer,-7500
645df61af8804aea72c2e507,50200023535069,2767806.89,60ec41ba55c00300382672d9,HDFC,direct expenses,5eecc6d6449e4f7cfb1c2708,2023-04-28T00:00:00.000Z,"NEFT DR-HSBC0560002-FLIPKART INTERNET PV T LTD-NETBANK, MUM-N118232435407207-4339 8",shopping,Transfer to N118232435407207,net_banking_transfer,-43398
645df61af8804aea72c2e509,50200023535069,2688115.89,60ec41ba55c00300382672d9,HDFC,direct expenses,5eecc6d6449e4f7cfb1c2708,2023-04-28T00:00:00.000Z,"NEFT DR-ICIC0003431-WAVICLE TECHNOLOGIES PVT LTD-NETBANK, MUM-N118232435441025-7 9691",,Transfer to N118232435441025,net_banking_transfer,-79691
645df61af8804aea72c2e50b,50200023535069,2637882.89,60ec41ba55c00300382672d9,HDFC,direct expenses,5eecc6d6449e4f7cfb1c2708,2023-04-28T00:00:00.000Z,"NEFT DR-PUNB0062910-YADAVPACKAGING-NETBA NK, MUM-N118232435453039-50233",,Transfer to N118232435453039,net_banking_transfer,-50233
645df61af8804aea72c2e50d,50200023535069,2612882.89,60ec41ba55c00300382672d9,HDFC,direct expenses,5eecc6d6449e4f7cfb1c2708,2023-04-28T00:00:00.000Z,"NEFT DR-BARB0ABHAYK-GLOBAL COMPLIANCES-N ETBANK, MUM-N118232435503030-25000",,Transfer to N118232435503030,net_banking_transfer,-25000
645df61af8804aea72c2e50f,50200023535069,2828271.4,60ec41ba55c00300382672d9,HDFC,Transfer in/Revenue-other,5eecc6d6449e4f7cfb1c2708,2023-04-28T00:00:00.000Z,RTGS CR-HSBC0400002-SUPERWELL COMTRADE P RIVATE LIMITED-SLICK ORGANICS PRIVATE LI MITED-HSBCR22023042820026793,,Transfer from SUPERWELL COMTRADE P RIVATE LIMITED,net_banking_transfer,215388.51
645df61af8804aea72c2e511,50200023535069,2833387.9,60ec41ba55c00300382672d9,HDFC,Revenue-Mktplace,5eecc6d6449e4f7cfb1c2708,2023-04-28T00:00:00.000Z,IMPS-311814345744-DREAMPLUGPAYTECHSO-UTI B-XXXXXXXXXXX7853-NA,,Transfer from DREAMPLUGPAYTECHSO,net_banking_transfer,5116.5
645df61af8804aea72c2e513,50200023535069,2836152,60ec41ba55c00300382672d9,HDFC,Revenue-Mktplace,5eecc6d6449e4f7cfb1c2708,2023-04-28T00:00:00.000Z,IMPS-311814460427-DREAMPLUGPAYTECHSO-UTI,,Transfer from DREAMPLUGPAYTECHSO,net_banking_transfer,2764.1
645df61af8804aea72c2e515,50200023535069,2878850,60ec41ba55c00300382672d9,HDFC,Revenue-Mktplace,5eecc6d6449e4f7cfb1c2708,2023-04-28T00:00:00.000Z,NEFT CR-SCBL0036001-DREAMPLUG TECHNOLOGI ES PRIVATE LIMITED-SLICK ORGANICS PRIVAT E LIMITEDSLICK-IN1ON2304280AMXG,,Transfer from DREAMPLUG TECHNOLOGI ES PRIVATE LIMITED,net_banking_transfer,42698
645df61af8804aea72c2e518,50200023535069,2878572,60ec41ba55c00300382672d9,HDFC,direct expenses,5eecc6d6449e4f7cfb1c2708,2023-04-28T00:00:00.000Z,POS 514834XXXXXX0472 PAYTM PAYMENTS S,ewallet,Transfer to PAYTM PAYMENTS S,debit_card,-278
645df61af8804aea72c2e51a,50200023535069,2879385,60ec41ba55c00300382672d9,HDFC,Revenue-Mktplace,5eecc6d6449e4f7cfb1c2708,2023-04-28T00:00:00.000Z,NEFT CR-ICIC0000105-MANASH LIFETYLE PVT LTD-SLICK ORGANICS PRIVATE LIMITED-ICIB2 31180048607,,Transfer from MANASH LIFETYLE PVT LTD,net_banking_transfer,813
645df61af8804aea72c2e51c,50200023535069,2880898.15,60ec41ba55c00300382672d9,HDFC,Transfer in/Revenue-other,5eecc6d6449e4f7cfb1c2708,2023-04-28T00:00:00.000Z,NEFT CR-UTIB0000114-ONE SIGMA TECHNOLOGI ES PRIVATE LIMI-SLICK ORGANICS PRIVATE L IMITED-AXISP00385144227,bnpl,Transfer from ONE SIGMA TECHNOLOGI ES PRIVATE LIMI,net_banking_transfer,1513.15
645df61af8804aea72c2e51e,50200023535069,2881668.15,60ec41ba55c00300382672d9,HDFC,Revenue-PG-split enabled,5eecc6d6449e4f7cfb1c2708,2023-04-28T00:00:00.000Z,NEFT CR-UTIB0001506-RAZORPAY SOFTWARE PR IVATE LIMITED --SLICK ORGANICS PVT LITD- AXISCN0242285981,,Transfer from RAZORPAY SOFTWARE PR IVATE LIMITED ,net_banking_transfer,770
645df61af8804aea72c2e520,50200023535069,2882909.74,60ec41ba55c00300382672d9,HDFC,Transfer in/Revenue-other,5eecc6d6449e4f7cfb1c2708,2023-04-28T00:00:00.000Z,IMPS-311818913699-EXCRO PAY ESCROW ACC-Y ESB-XXXXXXXXXXX1807-333112298023,,Transfer from EXCRO PAY ESCROW ACC,net_banking_transfer,1241.59
645df61af8804aea72c2e522,50200023535069,2889282.18,60ec41ba55c00300382672d9,HDFC,Transfer in/Revenue-other,5eecc6d6449e4f7cfb1c2708,2023-04-28T00:00:00.000Z,IMPS-311818925685-EXCRO PAY ESCROW ACC-Y ESB-XXXXXXXXXXX1807-333112298023,,Transfer from EXCRO PAY ESCROW ACC,net_banking_transfer,6372.44
645df61af8804aea72c2e524,50200023535069,2910478.25,60ec41ba55c00300382672d9,HDFC,Transfer in/Revenue-other,5eecc6d6449e4f7cfb1c2708,2023-04-28T00:00:00.000Z,NEFT CR-HSBC0110005-SUPERWELL COMTRADE P RIVATE LIMITED-SLICK ORGANICS PRIVATE LI MITED-HSBCN23118612918,,Transfer from SUPERWELL COMTRADE P RIVATE LIMITED,net_banking_transfer,21196.07
645df61af8804aea72c2e526,50200023535069,2895478.25,60ec41ba55c00300382672d9,HDFC,direct expenses,5eecc6d6449e4f7cfb1c2708,2023-04-28T00:00:00.000Z,"NEFT DR-KKBK0000180-VEDIC COSMECEUTICALS PVT LTD-NETBANK, MUM-N118232436376518-1 5000",,Transfer to N118232436376518,net_banking_transfer,-15000
645df61af8804aea72c2e528,50200023535069,2883478.25,60ec41ba55c00300382672d9,HDFC,direct expenses,5eecc6d6449e4f7cfb1c2708,2023-04-28T00:00:00.000Z,50100159819386-TPT-12000-RIA MALHOTRA,,Transfer to RIA MALHOTRA,net_banking_transfer,-12000
645df61af8804aea72c2e52a,50200023535069,2888320.11,60ec41ba55c00300382672d9,HDFC,Transfer in/Revenue-other,5eecc6d6449e4f7cfb1c2708,2023-04-28T00:00:00.000Z,NEFT CR-YESB0000001-EASEBUZZ PVT LTD NOD AL A/C-SLICK ORGANICS PVT LTD-YESB311887 00629,,Transfer from EASEBUZZ PVT LTD NOD AL A/C,net_banking_transfer,4841.86
645df61af8804aea72c2e52d,50200023535069,2927661.77,60ec41ba55c00300382672d9,HDFC,Transfer in/Revenue-other,5eecc6d6449e4f7cfb1c2708,2023-04-28T00:00:00.000Z,NEFT CR-YESB0000001-EASEBUZZ PVT LTD NOD AL A/C-SLICK ORGANICS PVT LTD-YESB311887 00339,,Transfer from EASEBUZZ PVT LTD NOD AL A/C,net_banking_transfer,39341.66
645df61af8804aea72c2e52f,50200023535069,2944149.13,60ec41ba55c00300382672d9,HDFC,Revenue-Mktplace,5eecc6d6449e4f7cfb1c2708,2023-04-28T00:00:00.000Z,IMPS-311819270974-AMAZON SELLER SERVIC-H,shopping,Transfer from AMAZON SELLER SERVIC,net_banking_transfer,16487.36
645df61af8804aea72c2e531,50200023535069,2991587.9,60ec41ba55c00300382672d9,HDFC,Revenue-Mktplace,5eecc6d6449e4f7cfb1c2708,2023-04-28T00:00:00.000Z,NEFT CR-DEUT0797BGL-INTERNAL AC FOR INTE RMEDIERY- AMAZON SELLER SERVIC-SLICK ORG ANICS PVT LTD-311802429GN00003,shopping,Transfer from INTERNAL AC FOR INTE RMEDIERY,net_banking_transfer,47438.77
645df61af8804aea72c2e534,50200023535069,2961587.9,60ec41ba55c00300382672d9,HDFC,Marketing Expense,5eecc6d6449e4f7cfb1c2708,2023-04-29T00:00:00.000Z,NEFT DR-CITI0000006-FACEBOOK INDIA ONLIN E SERVICES PVT LTD-SANDOZ - MUM-N1192324 36513675-NET BANKING SI -30000,,Transfer to NET BANKING SI ,net_banking_transfer,-30000
645df61af8804aea72c2e538,50200023535069,2962793.26,60ec41ba55c00300382672d9,HDFC,Transfer in/Revenue-other,5eecc6d6449e4f7cfb1c2708,2023-04-29T00:00:00.000Z,IMPS-311907874445-EXCRO PAY ESCROW ACC-Y ESB-XXXXXXXXXXX1807-333112298023,,Transfer from EXCRO PAY ESCROW ACC,net_banking_transfer,1205.36
645df61af8804aea72c2e53a,50200023535069,2963170.26,60ec41ba55c00300382672d9,HDFC,Revenue-PG-split enabled,5eecc6d6449e4f7cfb1c2708,2023-04-29T00:00:00.000Z,NEFT CR-UTIB0001506-RAZORPAY SOFTWARE PR IVATE LIMITED --SLICK ORGANICS PVT LITD- AXISCN0242588476,,Transfer from RAZORPAY SOFTWARE PR IVATE LIMITED ,net_banking_transfer,377
645df61af8804aea72c2e53c,50200023535069,2965966.26,60ec41ba55c00300382672d9,HDFC,Revenue-Mktplace,5eecc6d6449e4f7cfb1c2708,2023-04-29T00:00:00.000Z,IMPS-311914333351-DREAMPLUGPAYTECHSO-UTI B-XXXXXXXXXXX7853-NA,,Transfer from DREAMPLUGPAYTECHSO,net_banking_transfer,2796
645df61af8804aea72c2e53f,50200023535069,2968762.26,60ec41ba55c00300382672d9,HDFC,Revenue-Mktplace,5eecc6d6449e4f7cfb1c2708,2023-04-29T00:00:00.000Z,IMPS-311914451850-DREAMPLUGPAYTECHSO-UTI B-XXXXXXXXXXX7853-NA,,Transfer from DREAMPLUGPAYTECHSO,net_banking_transfer,2796
645df61af8804aea72c2e541,50200023535069,2971493.93,60ec41ba55c00300382672d9,HDFC,Transfer in/Revenue-other,5eecc6d6449e4f7cfb1c2708,2023-04-29T00:00:00.000Z,EASEBUZZ PRIVA-A214290423PSPRBWIAWY,,,Other,2731.67
645df61af8804aea72c2e543,50200023535069,2972322.92,60ec41ba55c00300382672d9,HDFC,Revenue-PG-split enabled,5eecc6d6449e4f7cfb1c2708,2023-04-29T00:00:00.000Z,NEFT CR-UTIB0001506-RAZORPAY SOFTWARE PR IVATE LIMITED --SLICK ORGANICS PVT LITD- AXISCN0242804292,,Transfer from RAZORPAY SOFTWARE PR IVATE LIMITED ,net_banking_transfer,828.99
645df61af8804aea72c2e545,50200023535069,3023544.98,60ec41ba55c00300382672d9,HDFC,Transfer in/Revenue-other,5eecc6d6449e4f7cfb1c2708,2023-04-29T00:00:00.000Z,NEFT CR-YESB0000001-EASEBUZZ PVT LTD NOD AL A/C-SLICK ORGANICS PVT LTD-YESB311996 72010,,Transfer from EASEBUZZ PVT LTD NOD AL A/C,net_banking_transfer,51222.06
645df61af8804aea72c2e547,50200023535069,3042223.23,60ec41ba55c00300382672d9,HDFC,Revenue-Mktplace,5eecc6d6449e4f7cfb1c2708,2023-04-29T00:00:00.000Z,IMPS-311919396954-AMAZON SELLER SERVIC-H SBC-XXXXXXXX6004-5265X80S71VVZWD0SLICK O RGANICS PVT LTD,shopping,Transfer from AMAZON SELLER SERVIC,net_banking_transfer,18678.25
645df61af8804aea72c2e549,50200023535069,3042224.23,60ec41ba55c00300382672d9,HDFC,Transfer in/Revenue-other,5eecc6d6449e4f7cfb1c2708,2023-04-29T00:00:00.000Z,CRV POS 514834******0472 SHOPIFY LTD,,,refund,1
645df61af8804aea72c2e54b,50200023535069,3111516.08,60ec41ba55c00300382672d9,HDFC,Revenue-Mktplace,5eecc6d6449e4f7cfb1c2708,2023-04-29T00:00:00.000Z,NEFT CR-DEUT0797BGL-INTERNAL AC FOR INTE RMEDIERY- AMAZON SELLER SERVIC-SLICK ORG ANICS PVT LTD-311901191GN00003,shopping,Transfer from INTERNAL AC FOR INTE RMEDIERY,net_banking_transfer,69291.85
645df61bf8804aea72c2e54d,50200023535069,3112424.1,60ec41ba55c00300382672d9,HDFC,Transfer in/Revenue-other,5eecc6d6449e4f7cfb1c2708,2023-04-30T00:00:00.000Z,IMPS-312003835353-EXCRO PAY ESCROW ACC-Y,,Transfer from EXCRO PAY ESCROW ACC,net_banking_transfer,908.02
645df61bf8804aea72c2e54f,50200023535069,3082424.1,60ec41ba55c00300382672d9,HDFC,Marketing Expense,5eecc6d6449e4f7cfb1c2708,2023-04-30T00:00:00.000Z,NEFT DR-CITI0000006-FACEBOOK INDIA ONLIN E SERVICES PVT LTD-SANDOZ - MUM-N1202324 38089076-NET BANKING SI -30000,,Transfer to NET BANKING SI ,net_banking_transfer,-30000
645df61bf8804aea72c2e551,50200023535069,3071164.1,60ec41ba55c00300382672d9,HDFC,Utilities/bills,5eecc6d6449e4f7cfb1c2708,2023-04-30T00:00:00.000Z,IB BILLPAY DR-HDFCEB-361011XXXX4399,bills,,Other,-11260
645df61bf8804aea72c2e555,50200023535069,3133312.07,60ec41ba55c00300382672d9,HDFC,Revenue-Mktplace,5eecc6d6449e4f7cfb1c2708,2023-04-30T00:00:00.000Z,NEFT CR-DEUT0797BGL-INTERNAL AC FOR INTE RMEDIERY- AMAZON SELLER SERVIC-SLICK ORG ANICS PVT LTD-312001106GN00004,shopping,Transfer from INTERNAL AC FOR INTE RMEDIERY,net_banking_transfer,62147.97
645df61bf8804aea72c2e559,50200023535069,3147479.72,60ec41ba55c00300382672d9,HDFC,Revenue-Mktplace,5eecc6d6449e4f7cfb1c2708,2023-04-30T00:00:00.000Z,IMPS-312020114309-AMAZON SELLER SERVIC-H SBC-XXXXXXXX6004-5GQMPXCIY5L2LNKESLICK O RGANICS PVT LTD STATEMENT SUMMARY :-,shopping,Transfer from AMAZON SELLER SERVIC,net_banking_transfer,14167.65
645df6c1f8804aea72c3471c,50200050976833,313.79,60ec41a455c0030038267236,HDFC,Internal Transfers,5eecc6d6449e4f7cfb1c2708,2023-03-16T00:00:00.000Z,IB FUNDS TRANSFER DR-50200023535069 -SL ICK ORGANICS PVT LTD,,,net_banking_transfer,-25000
645df6c1f8804aea72c3471e,50200050976833,50313.79,60ec41a455c0030038267236,HDFC,Internal Transfers,5eecc6d6449e4f7cfb1c2708,2023-03-19T00:00:00.000Z,IB FUNDS TRANSFER CR-50200023535069 -SL ICK ORGANICS PVT LTD STATEMENT SUMMARY :-,,,Other,50000
645df6c1f8804aea72c34720,50200050976833,25313.79,60ec41a455c0030038267236,HDFC,Internal Transfers,5eecc6d6449e4f7cfb1c2708,2023-04-10T00:00:00.000Z,IB FUNDS TRANSFER DR-50200023535069 -SL ICK ORGANICS PVT LTD,,Transfer to SL ICK ORGANICS PVT LTD,net_banking_transfer,-25000
645df6c1f8804aea72c34722,50200050976833,10313.79,60ec41a455c0030038267236,HDFC,Internal Transfers,5eecc6d6449e4f7cfb1c2708,2023-04-13T00:00:00.000Z,IB FUNDS TRANSFER DR-50200023535069 -SL ICK ORGANICS PVT LTD,,Transfer to SL ICK ORGANICS PVT LTD,net_banking_transfer,-15000
645df6c1f8804aea72c34724,50200050976833,5313.79,60ec41a455c0030038267236,HDFC,Internal Transfers,5eecc6d6449e4f7cfb1c2708,2023-04-13T00:00:00.000Z,IB FUNDS TRANSFER DR-50200023535069 -SL ICK ORGANICS PVT LTD,,Transfer to SL ICK ORGANICS PVT LTD,net_banking_transfer,-5000
645df6c1f8804aea72c34726,50200050976833,105313.79,60ec41a455c0030038267236,HDFC,Internal Transfers,5eecc6d6449e4f7cfb1c2708,2023-04-19T00:00:00.000Z,IB FUNDS TRANSFER CR-50200023535069 -SL ICK ORGANICS PVT LTD STATEMENT SUMMARY :-,,,Other,100000